"id","whiteh","whitel","blackh","blackl","otherh","otherl","hisph","hispl","pop"
"01001020100",1432,129,104,28,54,30,0,0,1777
"01001020200",532,167,1222,165,106,6,49,0,2247
"01001020300",2146,178,380,172,70,69,55,0,3070
"01001020400",3795,128,130,0,348,2,303,0,4706
"01001020500",8028,391,1299,446,562,0,167,0,10893
"01001020600",2507,378,255,175,48,45,130,111,3649
"01001020700",1960,259,182,292,51,0,45,0,2789
"01001020801",2417,534,158,117,63,21,9,269,3588
"01001020802",7945,1065,846,130,162,17,78,77,10320
"01001020900",4704,533,479,45,67,0,30,14,5872
"01001021000",2401,22,637,312,18,0,26,0,3416
"01001021100",992,118,1734,641,70,0,0,0,3555
"01003010100",2166,370,691,68,112,0,0,0,3407
"01003010200",1777,608,157,104,107,27,55,0,2835
"01003010300",5278,262,644,287,123,0,26,0,6620
"01003010400",3929,470,138,38,108,110,19,110,4922
"01003010500",3457,397,97,258,122,0,0,0,4331
"01003010600",964,89,1469,812,0,0,79,0,3413
"01003010701",6904,398,215,5,390,7,402,0,8321
"01003010703",13243,392,447,147,306,111,568,0,15214
"01003010704",4505,87,287,0,36,65,239,12,5231
"01003010705",6079,1052,1111,42,354,0,250,14,8902
"01003010800",5208,331,1323,827,18,0,24,0,7731
"01003010903",3880,496,252,242,36,178,264,65,5413
"01003010904",5602,608,110,81,107,234,126,0,6868
"01003010905",5926,416,450,117,362,84,565,78,7998
"01003010906",3901,396,49,3,184,0,75,0,4608
"01003011000",2623,1182,127,3,66,17,72,97,4187
"01003011101",7892,817,64,175,214,122,304,46,9634
"01003011102",3545,454,53,0,89,19,108,0,4268
"01003011201",3638,273,149,44,174,12,22,12,4324
"01003011202",3643,185,690,273,132,81,109,4,5117
"01003011300",3516,597,135,121,27,0,24,210,4630
"01003011401",7734,1151,1225,65,275,0,419,350,11219
"01003011403",7380,513,118,28,285,596,434,611,9965
"01003011405",3318,201,5,2,229,0,156,0,3911
"01003011406",2892,335,0,0,60,229,240,0,3756
"01003011407",3629,1179,0,0,243,44,37,9,5141
"01003011408",737,0,0,0,0,0,0,0,737
"01003011501",4360,776,67,522,71,0,126,259,6181
"01003011502",5789,1166,610,1901,560,261,616,127,11030
"01003011601",5063,1238,30,12,172,178,505,303,7501
"01003011602",4365,683,196,0,159,78,111,5,5597
"01003990000",0,0,0,0,0,0,0,0,0
"01005950100",1330,131,1297,429,45,181,0,181,3594
"01005950200",788,46,1171,923,20,0,28,0,2976
"01005950300",496,164,396,509,14,54,12,54,1699
"01005950400",1535,166,602,184,281,60,305,114,3247
"01005950500",1815,550,439,319,306,88,148,26,3691
"01005950600",1047,222,297,322,50,131,40,131,2240
"01005950700",635,9,663,410,0,0,6,0,1723
"01005950800",1299,81,616,152,23,0,135,9,2315
"01005950900",1397,50,1188,1269,167,62,106,0,4239
"01007010001",2233,428,157,23,160,0,139,0,3140
"01007010002",4570,1155,126,65,20,16,187,93,6232
"01007010003",3560,261,763,421,61,18,0,0,5084
"01007010004",4306,568,1630,943,7,0,0,0,7454
"01009050101",5906,1181,73,158,256,16,978,373,8941
"01009050102",4881,1211,207,41,304,17,973,467,8101
"01009050200",2970,475,1,5,283,0,492,90,4316
"01009050300",4248,856,9,0,130,146,501,157,6047
"01009050400",3322,1260,0,0,165,18,93,81,4939
"01009050500",5183,1120,56,109,94,43,178,134,6917
"01009050601",3482,576,0,8,136,0,0,21,4223
"01009050602",8539,775,31,18,57,21,104,5,9550
"01009050700",7504,948,9,6,198,15,153,0,8833
"01011952100",78,0,1177,223,6,0,0,0,1484
"01011952200",1169,322,3055,880,61,0,404,201,6092
"01011952500",1216,41,1263,745,5,0,0,0,3270
"01013952700",1056,291,429,443,42,0,0,0,2261
"01013952800",1136,115,259,43,0,0,0,0,1553
"01013952900",857,84,692,413,64,0,93,0,2203
"01013953000",701,102,311,221,25,0,0,0,1360
"01013953100",586,86,1299,968,0,34,59,0,3032
"01013953200",2100,215,965,621,76,6,33,16,4032
"01013953300",1211,399,293,0,9,0,0,0,1912
"01013953400",573,422,768,799,9,7,0,0,2578
"01013953500",806,400,247,99,20,8,0,19,1599
"01015000200",1109,425,1183,818,152,19,15,0,3721
"01015000300",264,99,1131,853,0,0,37,0,2384
"01015000400",502,442,1424,414,14,40,30,0,2866
"01015000500",108,34,573,1100,0,7,0,57,1879
"01015000600",241,155,415,787,0,0,39,0,1637
"01015000700",1109,343,931,628,200,19,100,44,3374
"01015000800",407,120,519,202,0,0,1,2,1251
"01015000900",2439,140,551,89,113,0,25,0,3357
"01015001000",3668,295,1145,284,88,113,152,19,5764
"01015001100",5000,476,584,215,337,44,552,0,7208
"01015001201",1905,66,489,575,78,84,168,17,3382
"01015001202",2571,344,366,11,91,191,24,191,3789
"01015001300",1671,680,26,0,131,19,18,19,2564
"01015001400",2096,345,664,193,0,12,30,12,3352
"01015001500",3850,422,121,144,287,217,239,217,5497
"01015001600",2107,696,198,123,135,126,96,89,3570
"01015001700",3779,360,1399,182,696,9,450,0,6875
"01015001800",4095,1195,579,238,182,145,140,0,6574
"01015002000",5346,1129,18,341,251,27,213,282,7607
"01015002101",696,679,272,799,48,21,0,13,2528
"01015002102",2314,280,218,106,161,67,38,67,3251
"01015002103",3852,1697,669,729,264,37,329,0,7577
"01015002200",2829,551,74,39,84,6,0,0,3583
"01015002300",2413,973,292,82,21,77,12,0,3870
"01015002400",3859,499,0,0,31,0,61,0,4450
"01015002501",5535,1125,404,109,0,30,0,27,7230
"01015002502",4179,477,0,9,163,0,24,0,4852
"01015002600",3897,628,84,50,19,0,10,0,4688
"01015981901",4,0,0,0,0,0,0,0,4
"01015981902",0,0,0,0,0,0,0,0,0
"01015981903",0,0,0,0,0,0,0,0,0
"01017953800",1903,534,664,231,58,7,0,0,3397
"01017953900",1348,322,804,958,36,31,25,0,3524
"01017954000",2511,241,2268,1278,13,0,0,0,6311
"01017954200",2441,286,700,273,14,0,10,0,3724
"01017954300",2034,422,1169,691,156,0,17,0,4489
"01017954400",91,20,470,202,8,0,3,0,794
"01017954500",1405,182,1009,986,24,45,52,67,3770
"01017954600",2337,314,357,419,0,8,0,0,3435
"01017954700",2749,425,866,239,106,0,0,0,4385
"01019955701",2322,584,307,54,71,20,19,4,3381
"01019955702",2848,1315,27,0,0,23,94,0,4307
"01019955800",3843,1002,89,32,116,14,32,140,5268
"01019955900",3468,537,96,179,29,0,29,0,4338
"01019956000",3084,511,145,57,97,100,39,0,4033
"01019956100",3355,936,181,14,54,37,0,0,4577
"01021060101",2855,768,946,296,123,31,104,314,5437
"01021060102",3809,972,182,370,184,27,263,13,5820
"01021060200",2252,430,49,0,30,0,0,0,2761
"01021060300",3109,367,13,0,70,0,160,21,3740
"01021060401",4503,731,246,94,170,47,321,132,6244
"01021060402",6386,1200,474,166,341,491,468,796,10322
"01021060500",2093,156,618,159,5,12,126,0,3169
"01021060600",1838,698,197,35,187,44,138,55,3192
"01021060700",3837,1044,129,305,171,0,295,150,5931
"01023956700",571,59,1574,851,8,0,0,0,3063
"01023956800",2422,396,924,505,54,0,6,23,4330
"01023956900",2740,297,761,79,39,4,0,4,3924
"01023957000",806,228,702,416,4,69,6,0,2231
"01025957500",1027,157,166,51,0,0,0,0,1401
"01025957601",587,118,159,38,0,0,48,0,950
"01025957602",2293,273,1562,698,87,41,0,0,4954
"01025957700",735,342,352,373,0,0,0,0,1802
"01025957800",1828,539,1473,1687,48,2,0,21,5598
"01025957901",2122,459,726,491,26,16,0,16,3856
"01025957902",1793,144,981,841,53,163,0,27,4002
"01025958001",447,241,324,147,0,0,0,0,1159
"01025958002",466,74,613,521,3,0,0,0,1677
"01027958900",3739,325,900,354,143,15,134,0,5610
"01027959000",1739,557,286,167,110,12,119,162,3152
"01027959100",2118,576,0,33,0,93,0,0,2820
"01027959200",1559,381,258,27,0,0,0,0,2225
"01029959500",1720,415,0,1,3,0,7,0,2146
"01029959600",2497,645,290,104,21,107,17,118,3799
"01029959700",3066,422,64,8,60,25,153,25,3823
"01029959800",4266,1001,15,0,56,0,0,0,5338
"01031010100",1446,395,69,7,193,82,10,46,2248
"01031010200",1455,260,150,4,74,30,6,0,1979
"01031010300",3661,460,202,316,233,39,36,3,4950
"01031010400",1386,264,303,54,127,4,44,0,2182
"01031010500",2396,370,643,498,5,73,77,79,4141
"01031010600",1119,260,27,7,58,14,0,5,1490
"01031010700",1811,207,53,4,104,70,232,11,2492
"01031010800",2206,303,38,16,107,7,34,56,2767
"01031010900",1221,294,538,209,63,16,60,53,2454
"01031011000",2531,428,439,225,107,39,395,85,4249
"01031011100",1093,152,184,211,18,0,51,57,1766
"01031011201",6461,314,319,123,608,78,415,78,8396
"01031011202",5015,982,1078,715,594,98,393,466,9341
"01031011300",1356,651,967,914,103,45,275,242,4553
"01033020100",2325,446,460,297,88,113,161,0,3890
"01033020200",1099,420,272,230,31,5,30,5,2092
"01033020300",667,243,372,374,23,56,0,0,1735
"01033020400",1256,26,10,0,75,0,4,0,1371
"01033020500",3705,769,290,104,106,0,0,0,4974
"01033020600",2049,395,982,239,232,20,81,0,3998
"01033020701",3857,311,798,618,87,26,0,0,5697
"01033020703",3595,455,1173,19,87,6,44,166,5545
"01033020704",3322,463,393,46,54,21,0,26,4325
"01033020801",3170,517,811,112,42,443,24,443,5562
"01033020802",2528,420,397,130,62,0,76,14,3627
"01033020901",3422,862,51,0,115,5,12,0,4467
"01033020902",2812,564,172,17,116,0,0,0,3681
"01033021000",2794,795,298,66,85,18,67,41,4164
"01035960200",911,55,559,189,121,0,38,0,1873
"01035960300",1129,352,286,240,68,0,0,0,2075
"01035960400",995,438,1111,737,24,4,3,89,3401
"01035960500",679,131,738,221,60,115,61,0,2005
"01035960600",1769,344,306,1438,20,0,0,0,3877
"01037961000",1397,341,1489,673,117,10,69,43,4139
"01037961100",2902,596,196,63,36,0,0,0,3793
"01037961200",1976,220,495,377,24,0,102,15,3209
"01039961600",3178,318,47,69,0,0,0,0,3612
"01039961700",3109,619,420,79,47,23,4,0,4301
"01039961800",1583,356,277,243,53,27,53,9,2601
"01039961900",2015,280,251,76,0,75,99,0,2796
"01039962000",2086,674,463,176,43,34,113,0,3589
"01039962100",669,161,580,512,60,27,5,0,2014
"01039962300",2684,222,10,5,82,0,4,0,3007
"01039962400",3075,365,0,0,37,0,0,0,3477
"01039962500",1058,420,0,0,79,0,0,0,1557
"01039962600",715,395,0,221,0,0,0,0,1331
"01039962700",835,160,314,342,4,0,5,0,1660
"01039962800",1219,175,0,0,93,4,2,2,1495
"01039962900",1295,293,122,0,98,0,8,0,1816
"01039963000",2633,925,377,94,181,76,168,48,4502
"01041963400",847,130,484,265,57,0,0,0,1783
"01041963500",1288,89,90,71,61,18,0,0,1617
"01041963600",2211,357,588,171,107,3,45,3,3485
"01041963700",2078,522,407,242,244,91,126,42,3752
"01041963800",867,150,502,124,34,29,2,13,1721
"01041963900",1149,282,111,77,8,0,0,0,1627
"01043964100",4313,738,25,4,80,86,53,0,5299
"01043964200",5478,1165,70,87,322,47,240,157,7566
"01043964300",4004,360,3,6,61,42,76,8,4560
"01043964400",3376,532,0,0,37,0,18,12,3975
"01043964500",3528,806,0,0,72,31,0,13,4450
"01043964600",3308,513,0,0,197,0,191,31,4240
"01043964700",4017,553,0,51,50,29,37,214,4951
"01043964800",3374,729,6,14,129,158,116,159,4685
"01043964900",4791,1131,7,58,126,2,230,268,6613
"01043965000",4425,1510,0,0,25,126,209,419,6714
"01043965100",2530,893,0,0,218,0,146,177,3964
"01043965200",2164,211,0,4,28,45,0,20,2472
"01043965300",3724,1263,3,0,37,8,294,146,5475
"01043965401",1743,547,36,11,85,64,0,25,2511
"01043965402",3261,789,19,0,81,35,12,0,4197
"01043965500",4320,1239,259,55,130,28,16,73,6120
"01043965600",1868,348,0,0,25,0,0,17,2258
"01043965700",2124,585,0,0,4,0,40,0,2753
"01045020000",3004,142,347,99,364,0,476,23,4455
"01045020100",2421,457,365,112,42,15,18,25,3455
"01045020200",1919,139,49,0,46,9,59,0,2221
"01045020300",1655,230,417,81,9,0,0,0,2392
"01045020400",1744,262,126,33,66,12,33,0,2276
"01045020500",1256,219,250,229,26,19,52,60,2111
"01045020700",925,284,929,787,53,29,29,18,3054
"01045020801",2364,139,843,181,174,51,99,124,3975
"01045020802",2858,192,580,172,158,132,39,121,4252
"01045021101",2997,569,475,212,195,226,354,347,5375
"01045021102",2076,543,912,301,288,138,96,157,4511
"01045021200",1762,363,223,166,76,22,66,13,2691
"01045021300",3348,342,237,61,201,19,91,0,4299
"01045021400",3502,793,708,519,221,149,252,38,6182
"01047956100",3005,568,1593,978,65,82,0,0,6291
"01047956201",1098,182,537,422,12,0,17,0,2268
"01047956202",1422,219,476,175,12,0,0,0,2304
"01047956300",348,125,1586,871,55,0,0,0,2985
"01047956400",50,24,1235,2171,0,70,0,0,3550
"01047956500",35,105,1804,2073,6,0,0,0,4023
"01047956600",350,37,1956,1580,0,96,35,0,4054
"01047956701",1316,50,580,162,18,0,108,0,2234
"01047956702",450,134,482,251,101,0,96,0,1514
"01047956800",761,113,616,438,159,0,0,51,2138
"01047956900",514,25,949,1034,0,0,0,0,2522
"01047957000",547,25,404,596,0,0,0,0,1572
"01047957100",432,17,643,176,150,0,0,0,1418
"01047957200",18,2,1275,767,0,0,0,0,2062
"01047957300",376,65,2074,1498,0,12,0,12,4037
"01049960100",4818,1356,0,0,509,66,5,0,6754
"01049960200",2704,724,65,0,404,0,340,65,4302
"01049960300",5200,1584,10,13,187,25,302,501,7822
"01049960400",5451,404,0,0,305,0,178,0,6338
"01049960500",4470,1097,19,3,254,17,80,325,6265
"01049960600",5629,656,26,0,286,28,739,3,7367
"01049960700",5233,1533,0,0,856,0,999,207,8828
"01049960800",2563,1080,127,281,286,264,453,796,5850
"01049960900",2427,756,182,35,57,81,455,294,4287
"01049961000",3082,789,40,20,57,266,582,627,5463
"01049961100",1766,413,128,7,138,0,104,42,2598
"01049961200",1707,105,0,0,70,22,102,0,2006
"01049961300",3711,1300,132,59,192,442,1127,1371,8334
"01049961400",2992,522,8,4,208,14,80,4,3832
"01051030100",5098,1107,306,41,82,0,47,72,6753
"01051030200",3548,347,304,168,70,23,0,0,4460
"01051030300",2098,75,36,11,0,0,38,0,2258
"01051030400",4903,317,1804,282,524,46,77,0,7953
"01051030500",3568,413,278,82,27,21,8,0,4397
"01051030600",3719,666,1048,570,532,16,566,53,7170
"01051030701",5745,313,603,15,147,11,20,0,6854
"01051030702",3152,330,292,37,148,0,46,0,4005
"01051030800",3622,389,928,365,223,54,149,0,5730
"01051030901",4759,264,640,150,70,35,256,0,6174
"01051030902",2023,227,885,206,203,78,95,112,3829
"01051031000",4144,426,639,962,230,9,92,102,6604
"01051031100",3192,712,599,11,98,66,75,182,4935
"01051031200",694,71,662,216,23,3,2,0,1671
"01051031300",1995,264,608,505,65,26,62,26,3551
"01053969800",2859,1021,642,721,144,66,133,30,5616
"01053969900",2673,568,645,118,18,109,36,0,4167
"01053970100",2420,647,743,41,116,0,0,0,3967
"01053970200",379,44,865,553,23,25,33,0,1922
"01053970300",2187,663,442,264,59,0,17,29,3661
"01053970400",1615,450,197,148,838,154,146,74,3622
"01053970500",2999,754,1003,756,165,0,0,159,5836
"01053970600",497,122,2034,1184,43,21,17,0,3918
"01053970700",2468,486,462,95,83,77,54,0,3725
"01055000200",1227,755,929,376,39,35,0,23,3384
"01055000300",105,234,1083,1280,0,0,0,0,2702
"01055000400",3549,302,25,0,122,0,56,0,4054
"01055000500",1128,279,172,0,50,7,235,7,1878
"01055000600",966,581,124,83,35,83,105,124,2101
"01055000700",720,108,118,187,0,49,0,0,1182
"01055000800",161,206,391,330,0,23,11,32,1154
"01055000900",1465,606,215,152,78,161,78,114,2869
"01055001000",221,203,542,749,7,22,6,73,1823
"01055001100",4143,256,89,79,209,0,79,6,4861
"01055001200",1644,364,640,226,44,30,88,6,3042
"01055001300",1050,229,756,522,12,96,116,0,2781
"01055001600",813,108,1737,673,118,0,205,0,3654
"01055001700",599,121,426,123,15,4,0,0,1288
"01055010100",1233,397,222,176,13,3,0,0,2044
"01055010200",3735,847,312,22,99,97,351,9,5472
"01055010300",2341,241,92,23,58,18,0,0,2773
"01055010401",2181,506,379,0,97,18,0,30,3211
"01055010402",4565,936,78,0,167,0,66,1,5813
"01055010501",7562,351,42,63,119,1,557,0,8695
"01055010502",3973,483,186,17,18,33,0,0,4710
"01055010601",5446,329,0,0,16,0,0,0,5791
"01055010602",3294,414,0,0,166,0,54,0,3928
"01055010700",2833,463,222,103,93,0,14,6,3734
"01055010800",2032,521,0,0,71,14,48,14,2700
"01055010900",1423,196,22,19,8,28,82,0,1778
"01055011001",4054,540,19,0,68,16,57,48,4802
"01055011002",5023,706,83,0,55,5,350,14,6236
"01055011100",3426,932,15,0,97,30,23,9,4532
"01055011200",449,602,792,413,133,302,73,413,3177
"01057020000",1364,257,9,0,0,3,0,0,1633
"01057020100",2629,477,86,6,13,90,12,32,3345
"01057020200",3247,492,424,233,34,13,96,13,4552
"01057020300",2229,574,468,496,87,13,8,13,3888
"01057020400",2808,617,60,38,50,40,48,0,3661
"01059972900",2727,478,161,0,0,0,88,0,3454
"01059973000",3083,867,407,103,219,614,1429,672,7394
"01059973100",2287,418,0,0,15,16,21,130,2887
"01059973200",2617,594,245,382,213,180,613,112,4956
"01059973300",1850,568,66,0,613,175,1243,370,4885
"01059973400",2080,507,0,53,0,0,0,0,2640
"01059973500",1880,371,5,0,26,0,5,0,2287
"01059973600",1632,448,3,7,18,5,36,0,2149
"01059973700",4192,1011,0,0,71,51,27,17,5369
"01061050100",3315,758,247,253,67,72,106,34,4852
"01061050200",1555,185,131,199,52,31,0,0,2153
"01061050300",3657,1246,330,123,183,171,0,0,5710
"01061050400",3873,863,358,261,127,77,77,235,5871
"01061050500",3340,503,351,86,29,48,67,103,4527
"01061050600",3013,637,127,17,10,61,254,47,4166
"01063060000",181,17,862,601,0,0,0,0,1661
"01063060100",752,119,2120,1010,119,0,47,0,4167
"01063060200",354,151,1566,1025,14,0,0,0,3110
"01065040000",1843,163,815,153,74,0,49,0,3097
"01065040100",773,142,369,170,13,0,0,0,1467
"01065040200",789,24,427,236,0,8,0,0,1484
"01065040300",228,75,1057,791,0,0,0,0,2151
"01065040400",1235,99,2293,1639,28,0,0,0,5294
"01065040500",613,70,670,454,0,41,0,3,1851
"01067030100",896,198,590,165,12,0,0,0,1861
"01067030200",1019,173,1055,409,338,0,111,0,3105
"01067030300",1948,277,329,124,25,0,28,0,2731
"01067030400",1185,283,296,115,43,21,154,21,2118
"01067030500",4328,136,1162,268,52,0,0,25,5971
"01067030600",1187,207,144,22,19,54,19,50,1702
"01069040100",4105,441,195,75,56,200,245,113,5430
"01069040201",7473,287,608,52,443,5,128,9,9005
"01069040202",7164,321,635,115,323,15,240,24,8837
"01069040301",2064,165,860,422,160,42,99,0,3812
"01069040302",1351,324,1146,571,170,31,129,41,3763
"01069040400",1888,130,203,183,50,15,54,0,2523
"01069040500",2575,234,381,215,136,6,8,64,3619
"01069040600",107,105,757,941,9,67,31,45,2062
"01069040700",1268,331,646,342,54,12,3,18,2674
"01069040800",5687,819,708,308,253,145,199,199,8318
"01069040900",3015,343,918,334,174,28,105,37,4954
"01069041000",1478,358,1920,1144,129,96,61,9,5195
"01069041100",2008,434,841,344,342,34,198,82,4283
"01069041200",630,179,729,573,86,51,96,8,2352
"01069041400",403,72,1175,1123,127,31,21,2,2954
"01069041500",890,52,2008,1328,31,39,24,2,4374
"01069041600",2931,424,1102,441,146,81,142,23,5290
"01069041700",971,115,196,89,40,23,33,14,1481
"01069041800",1304,138,428,133,21,6,14,0,2044
"01069041900",5343,801,609,293,286,97,41,80,7550
"01069042000",4533,668,325,152,131,20,61,11,5901
"01069042100",5767,1121,306,25,83,129,67,342,7840
"01071950100",4577,939,0,0,220,26,217,0,5979
"01071950200",2502,317,244,169,132,25,30,13,3432
"01071950300",4270,781,291,58,64,83,109,79,5735
"01071950400",1771,279,1,0,48,13,1,15,2128
"01071950500",2933,790,1,16,76,16,56,12,3900
"01071950600",4302,1009,450,126,227,121,123,13,6371
"01071950700",3950,266,2,15,151,0,35,0,4419
"01071950800",2818,749,76,11,84,62,57,136,3993
"01071950900",5367,290,139,0,146,0,147,0,6089
"01071951000",3071,670,7,0,393,17,0,0,4158
"01071951100",5513,1290,19,6,372,253,82,232,7767
"01073000100",215,232,1642,651,12,73,13,81,2919
"01073000300",245,367,1184,570,261,0,240,315,3182
"01073000400",203,87,1689,1636,24,10,26,0,3675
"01073000500",69,166,1791,1592,24,18,23,0,3683
"01073000700",0,1,908,1455,27,0,0,5,2396
"01073000800",9,56,2873,1094,65,30,51,0,4178
"01073001100",0,1,3617,1178,28,0,0,0,4824
"01073001200",242,40,1866,755,72,0,188,36,3199
"01073001400",206,1,1384,533,0,126,139,56,2445
"01073001500",164,28,1494,1395,35,0,0,0,3116
"01073001600",160,99,1357,1230,124,60,100,52,3182
"01073001902",123,124,1172,585,21,9,38,57,2129
"01073002000",334,461,1943,905,0,0,45,11,3699
"01073002100",378,247,1624,670,0,0,0,0,2919
"01073002200",192,29,1434,1054,28,17,0,36,2790
"01073002303",90,13,1497,2061,25,0,0,0,3686
"01073002305",1816,69,667,298,56,0,66,0,2972
"01073002306",2461,256,746,167,194,0,80,0,3904
"01073002400",711,232,917,1642,167,22,270,8,3969
"01073002700",860,333,673,753,19,17,36,30,2721
"01073002900",0,32,954,912,12,21,0,0,1931
"01073003001",250,28,1546,192,56,0,72,0,2144
"01073003002",0,202,1376,940,7,0,0,108,2633
"01073003100",63,28,2025,1107,0,9,0,9,3241
"01073003200",0,10,586,296,0,0,0,0,892
"01073003300",0,2,527,492,0,0,0,0,1021
"01073003400",114,42,1444,1168,7,0,16,5,2796
"01073003500",247,110,1884,869,0,10,18,0,3138
"01073003600",202,0,3293,472,0,0,0,0,3967
"01073003700",195,5,3382,1134,207,10,121,0,5054
"01073003802",291,91,3989,1647,0,10,16,0,6044
"01073003803",60,16,2090,1492,0,24,0,0,3682
"01073003900",42,24,968,767,0,0,42,24,1867
"01073004000",41,0,2276,1602,17,0,31,0,3967
"01073004200",1,7,1415,522,0,0,0,0,1945
"01073004500",237,216,316,1141,168,102,0,0,2180
"01073004701",2853,518,229,32,157,0,248,35,4072
"01073004702",2687,214,109,182,6,20,7,10,3235
"01073004800",1680,158,95,28,79,7,79,0,2126
"01073004901",704,173,166,11,51,47,20,9,1181
"01073004902",1257,618,286,328,259,204,143,79,3174
"01073005000",1592,401,612,214,611,234,737,326,4727
"01073005101",22,4,903,941,11,12,11,6,1910
"01073005103",126,272,1823,128,25,88,69,243,2774
"01073005104",724,335,1515,655,449,38,700,107,4523
"01073005200",37,0,2705,1231,58,46,0,0,4077
"01073005302",1583,139,1762,183,190,0,0,0,3857
"01073005500",296,165,1169,527,9,0,18,11,2195
"01073005600",3171,478,288,391,57,54,67,0,4506
"01073005701",72,0,1874,657,0,0,12,0,2615
"01073005702",60,24,2743,935,0,2,0,2,3766
"01073005800",925,386,1226,741,304,165,444,146,4337
"01073005903",1366,183,2715,607,42,0,17,137,5067
"01073005905",841,308,2982,889,89,0,24,0,5133
"01073005907",518,34,1450,78,82,0,60,0,2222
"01073005908",753,269,1794,498,38,0,94,146,3592
"01073005909",262,11,2040,311,44,0,0,0,2668
"01073005910",298,21,4143,874,6,53,0,29,5424
"01073010001",2993,290,922,318,67,69,37,0,4696
"01073010002",3122,464,1437,17,166,0,54,33,5293
"01073010100",0,21,914,902,0,0,0,0,1837
"01073010200",465,330,961,672,0,224,0,224,2876
"01073010301",433,51,1288,694,0,10,0,0,2476
"01073010302",54,95,2229,2094,10,22,33,53,4590
"01073010401",645,144,1489,555,56,0,109,0,2998
"01073010402",471,209,1170,397,107,0,97,0,2451
"01073010500",254,31,1025,263,9,15,0,0,1597
"01073010602",130,28,3610,1834,174,97,154,0,6027
"01073010603",211,7,1631,371,62,0,38,0,2320
"01073010701",896,234,368,184,165,0,183,97,2127
"01073010702",3578,402,364,59,24,0,211,25,4663
"01073010703",2014,81,0,0,119,0,10,0,2224
"01073010704",1818,203,692,19,131,8,298,22,3191
"01073010705",2884,458,88,21,121,53,5,53,3683
"01073010706",2447,750,1179,221,193,57,0,0,4847
"01073010801",5050,285,139,0,263,0,150,0,5887
"01073010802",3388,114,0,13,10,5,36,5,3571
"01073010803",3041,237,2331,319,124,1,211,0,6264
"01073010804",2838,30,2,3,5,1,34,0,2913
"01073010805",6745,253,219,4,278,9,190,0,7698
"01073010900",1344,253,1796,1483,177,117,337,53,5560
"01073011001",4367,819,357,93,201,19,300,267,6423
"01073011002",840,137,538,405,8,6,21,6,1961
"01073011104",3589,265,3334,396,146,0,156,0,7886
"01073011107",9761,147,608,0,206,68,13,0,10803
"01073011108",3680,222,657,13,141,0,0,0,4713
"01073011109",3067,386,132,0,50,66,0,0,3701
"01073011110",4407,332,678,0,102,0,0,0,5519
"01073011111",6666,114,646,56,295,0,266,0,8043
"01073011205",1681,84,367,41,12,0,0,0,2185
"01073011206",4567,517,813,0,69,13,20,0,5999
"01073011207",1405,177,2707,967,59,0,49,0,5364
"01073011208",2762,198,686,75,40,0,33,94,3888
"01073011209",520,66,1691,1133,89,0,0,0,3499
"01073011210",1196,198,1625,584,237,22,238,0,4100
"01073011301",2152,338,313,104,324,0,321,0,3552
"01073011302",5556,631,35,21,100,1,81,0,6425
"01073011400",5181,1078,445,153,82,30,52,141,7162
"01073011500",4652,533,1,2,76,0,0,0,5264
"01073011600",3267,637,107,63,37,0,57,38,4206
"01073011703",6882,492,1113,218,173,6,64,6,8954
"01073011704",3823,152,1,0,72,0,0,0,4048
"01073011705",6167,345,444,14,98,350,284,350,8052
"01073011706",1790,199,21,99,65,0,99,0,2273
"01073011802",2409,159,3088,1337,115,39,18,0,7165
"01073011803",1261,41,2812,937,311,0,308,0,5670
"01073011804",362,177,1623,397,62,67,21,67,2776
"01073011901",1137,618,247,255,135,73,120,197,2782
"01073011904",32,19,1667,435,6,76,0,76,2311
"01073012001",1790,163,1661,284,30,0,0,0,3928
"01073012002",3769,262,1678,704,502,39,463,0,7417
"01073012103",1721,377,1906,252,10,30,253,30,4579
"01073012104",1615,186,543,135,36,523,37,523,3598
"01073012200",2102,345,6,0,21,5,10,2,2491
"01073012302",3427,249,72,8,32,0,20,0,3808
"01073012304",1352,121,897,159,25,12,0,0,2566
"01073012305",3017,187,4508,140,48,0,30,0,7930
"01073012401",217,20,3342,416,0,27,0,0,4022
"01073012402",1117,210,1424,186,0,61,13,0,3011
"01073012403",1654,288,1302,96,113,35,0,35,3523
"01073012500",2135,485,1069,399,16,57,14,0,4175
"01073012602",1824,310,633,148,72,11,80,30,3108
"01073012701",2025,539,526,71,213,253,538,672,4837
"01073012703",4926,214,152,41,258,48,290,114,6043
"01073012704",1800,202,27,0,59,0,55,0,2143
"01073012802",2210,251,19,17,23,7,64,0,2591
"01073012803",3546,432,109,121,128,3,58,0,4397
"01073012905",3503,183,269,5,134,6,32,0,4132
"01073012906",4985,517,408,0,364,71,20,278,6643
"01073012907",3515,345,310,112,370,0,200,0,4852
"01073012908",2228,187,1141,161,1217,447,1410,500,7291
"01073012910",2649,34,526,0,107,17,31,10,3374
"01073012911",5338,196,0,0,177,0,20,0,5731
"01073012912",1271,169,1724,595,577,1005,613,724,6678
"01073012913",1264,186,1379,245,959,87,750,180,5050
"01073012914",1582,336,113,4,169,0,104,0,2308
"01073012915",4994,151,438,75,537,0,45,0,6240
"01073013002",0,6,797,895,0,0,0,0,1698
"01073013100",139,0,2492,1669,0,0,7,0,4307
"01073013200",237,77,1559,506,0,0,0,0,2379
"01073013300",283,180,1683,597,171,241,289,366,3810
"01073013400",395,60,3320,554,54,0,0,0,4383
"01073013601",490,22,2468,543,13,100,299,82,4017
"01073013801",145,54,971,704,27,15,88,15,2019
"01073013901",389,32,893,405,5,0,0,0,1724
"01073013902",1399,113,575,33,6,12,0,14,2152
"01073014001",3545,409,0,30,31,13,18,0,4046
"01073014002",2802,275,441,0,66,24,0,0,3608
"01073014102",4152,284,310,156,53,38,31,0,5024
"01073014104",1447,123,939,500,121,9,58,0,3197
"01073014105",915,100,2593,370,146,10,49,0,4183
"01073014203",8843,288,2718,0,616,19,183,0,12667
"01073014204",7609,135,1340,55,695,0,280,0,10114
"01073014301",1457,207,791,132,39,11,9,11,2657
"01073014302",2794,294,1775,328,271,61,50,72,5645
"01073014404",3859,196,765,121,420,122,236,87,5806
"01073014405",2870,83,347,5,528,10,46,0,3889
"01073014406",4961,88,316,34,359,0,172,0,5930
"01073014408",1482,320,796,38,572,4,176,30,3418
"01073014409",2583,165,123,16,231,132,43,147,3440
"01073014410",3658,96,451,17,660,97,62,55,5096
"01073014412",3781,137,63,0,566,0,350,0,4897
"01073014413",7150,125,756,53,644,17,60,0,8805
"01075030000",3385,961,461,328,37,9,13,71,5265
"01075030100",3973,935,393,99,17,16,60,37,5530
"01075030200",2562,669,202,134,47,19,1,6,3640
"01077010100",348,394,160,169,8,21,83,0,1183
"01077010200",815,487,223,142,31,16,50,6,1770
"01077010300",0,57,633,566,0,18,0,0,1274
"01077010400",1366,547,387,96,119,20,11,0,2546
"01077010600",1245,773,364,168,114,168,55,27,2914
"01077010700",931,602,164,368,9,73,0,19,2166
"01077010800",2363,831,292,421,63,116,58,57,4201
"01077010900",4948,917,492,258,236,20,208,41,7120
"01077011000",2445,712,955,537,43,28,53,9,4782
"01077011101",4345,482,661,1,310,20,174,0,5993
"01077011102",3306,410,379,69,69,0,105,0,4338
"01077011200",2925,402,354,74,56,0,33,113,3957
"01077011300",1601,396,0,0,36,0,30,0,2063
"01077011400",5481,1093,8,0,69,9,118,207,6985
"01077011501",5484,329,261,0,252,0,66,0,6392
"01077011502",3777,878,35,11,82,87,0,0,4870
"01077011602",4850,525,0,5,0,0,16,0,5396
"01077011603",4485,322,113,0,39,0,424,0,5383
"01077011604",6094,536,199,26,197,0,0,0,7052
"01077011700",3975,324,48,6,88,0,11,0,4452
"01077011801",3872,602,0,28,66,2,25,0,4595
"01077011802",2627,356,132,64,61,12,65,0,3317
"01079979100",636,140,673,224,81,0,35,0,1789
"01079979200",2016,269,1419,313,63,85,37,4,4206
"01079979300",2978,558,0,0,786,107,62,20,4511
"01079979400",2372,630,272,271,431,124,98,72,4270
"01079979500",4221,777,123,1,464,205,0,0,5791
"01079979600",3971,696,213,10,834,161,115,89,6089
"01079979700",1795,280,57,27,194,35,0,0,2388
"01079979800",2712,450,9,0,101,0,40,37,3349
"01079979900",1233,479,0,40,178,41,0,18,1989
"01081040200",2802,1210,562,184,288,218,265,97,5626
"01081040300",1118,642,97,134,149,27,52,3,2222
"01081040400",3663,1871,719,358,473,98,63,15,7260
"01081040500",5455,172,993,66,757,10,152,27,7632
"01081040602",1596,496,1278,920,118,51,57,0,4516
"01081040603",506,228,285,152,0,44,0,0,1215
"01081040604",1750,2786,372,475,180,41,173,286,6063
"01081040700",224,452,36,19,0,59,0,0,790
"01081040800",787,1844,0,282,257,236,11,73,3490
"01081040901",2299,323,585,116,84,0,29,20,3456
"01081040902",2301,1089,682,119,1185,36,511,55,5978
"01081041000",3895,594,1646,705,469,28,33,4,7374
"01081041100",4255,867,1659,1014,581,672,609,771,10428
"01081041200",3776,244,437,57,54,0,38,0,4606
"01081041300",1864,101,426,572,87,72,61,5,3188
"01081041400",316,135,1723,1303,126,19,138,33,3793
"01081041600",653,69,986,1354,167,6,69,21,3325
"01081041700",4306,828,2674,418,41,175,47,34,8523
"01081041800",5285,773,809,149,296,19,0,0,7331
"01081041900",6509,842,726,328,60,0,16,72,8553
"01081042002",4237,172,805,7,232,0,86,14,5553
"01081042003",3060,128,207,106,16,0,76,0,3593
"01081042004",7127,949,1849,120,434,66,642,90,11277
"01081042005",2810,635,855,171,57,18,41,0,4587
"01081042006",1141,280,244,11,258,0,13,0,1947
"01081042101",2464,164,768,600,52,0,66,0,4114
"01081042102",5307,682,853,347,58,47,0,17,7311
"01083020101",3210,552,189,0,72,377,51,377,4828
"01083020102",4987,799,121,0,285,157,23,0,6372
"01083020201",3782,1149,249,21,149,38,271,452,6111
"01083020202",3666,818,90,20,140,20,81,338,5173
"01083020300",3734,270,0,10,23,0,5,0,4042
"01083020401",4444,1135,146,61,247,79,97,0,6209
"01083020402",4385,366,230,139,196,187,397,196,6096
"01083020500",1535,188,347,208,166,12,143,0,2599
"01083020600",2779,808,386,192,336,124,684,427,5736
"01083020700",853,483,419,108,91,5,50,144,2153
"01083020801",4336,441,566,21,177,0,127,50,5718
"01083020802",5787,426,652,134,380,0,87,0,7466
"01083020900",3519,179,360,96,140,104,68,104,4570
"01083021000",1227,99,633,183,26,66,119,66,2419
"01083021100",3845,569,886,391,144,64,95,48,6042
"01083021200",6750,360,1731,209,775,265,214,50,10354
"01085780800",1129,51,1370,796,14,17,43,39,3459
"01085781000",839,46,1673,816,0,0,0,0,3374
"01085781100",119,19,850,668,15,0,0,0,1671
"01085781200",618,0,1423,524,0,0,0,0,2565
"01087231400",545,45,501,91,76,0,96,0,1354
"01087231500",1050,308,1044,672,21,12,5,0,3112
"01087231601",151,0,706,156,0,0,0,0,1013
"01087231602",99,6,652,496,97,5,0,0,1355
"01087231603",79,0,691,349,86,30,12,0,1247
"01087231700",27,6,150,239,21,0,0,10,453
"01087231800",5,9,942,231,0,0,0,0,1187
"01087231900",11,0,985,451,3,29,9,0,1488
"01087232000",66,0,1087,413,15,0,8,10,1599
"01087232100",0,0,1340,384,0,0,0,0,1724
"01087232200",609,22,1508,457,0,0,0,0,2596
"01087232300",74,0,832,651,42,4,0,0,1603
"01089000201",24,14,528,364,20,6,11,0,967
"01089000202",410,186,822,590,66,37,7,22,2140
"01089000301",811,300,2073,453,180,17,401,169,4404
"01089000302",321,50,2470,584,245,0,281,0,3951
"01089000403",679,32,3597,562,211,38,188,0,5307
"01089000501",407,23,1261,250,80,24,117,24,2186
"01089000502",232,119,1429,473,72,26,56,6,2413
"01089000503",322,11,1229,180,0,0,0,0,1742
"01089000601",370,248,648,216,74,5,87,67,1715
"01089000602",527,19,1119,361,64,58,28,58,2234
"01089000701",260,120,1787,712,121,567,20,276,3863
"01089000702",504,274,1414,118,175,0,110,0,2595
"01089000901",3722,272,290,40,156,26,58,26,4590
"01089000902",1662,285,93,24,121,24,54,0,2263
"01089001000",1898,302,227,22,74,66,67,41,2697
"01089001200",69,169,944,1804,81,252,92,19,3430
"01089001301",515,278,1271,1087,151,7,114,23,3446
"01089001302",517,28,898,550,151,23,64,0,2231
"01089001401",1311,70,135,0,197,23,71,0,1807
"01089001402",2109,357,1269,625,597,200,165,11,5333
"01089001500",1335,296,1160,504,162,136,220,27,3840
"01089001700",2003,10,0,0,35,0,26,0,2074
"01089001801",3795,88,18,0,45,0,131,0,4077
"01089001901",3171,27,16,0,127,8,54,0,3403
"01089001902",1243,88,16,0,3,0,51,0,1401
"01089001903",2310,57,57,0,118,5,41,0,2588
"01089002000",2030,53,0,0,35,0,24,13,2155
"01089002100",776,640,702,798,91,74,32,98,3211
"01089002200",762,447,286,81,84,14,113,220,2007
"01089002300",3027,643,604,807,182,60,448,85,5856
"01089002400",1723,730,924,733,346,34,525,446,5461
"01089002501",1087,752,738,507,129,245,674,715,4847
"01089002502",1065,308,614,384,94,179,498,107,3249
"01089002600",3152,251,162,28,293,75,86,0,4047
"01089002701",1806,93,226,7,77,23,29,8,2269
"01089002721",3749,145,63,21,100,33,130,11,4252
"01089002722",2788,7,60,0,158,53,37,0,3103
"01089002801",3216,136,426,153,254,59,120,0,4364
"01089002802",4895,517,307,0,419,67,129,0,6334
"01089002911",4031,194,151,0,190,10,387,0,4963
"01089002912",2286,95,0,0,224,0,98,0,2703
"01089002921",4927,492,234,19,301,22,85,0,6080
"01089002922",4036,123,48,0,350,0,103,0,4660
"01089003000",1076,388,582,382,131,54,59,7,2679
"01089003100",1437,281,146,194,18,5,37,16,2134
"01089010100",6413,291,1406,54,521,246,198,0,9129
"01089010200",4697,210,441,1,148,0,125,0,5622
"01089010301",6420,626,364,34,251,45,63,0,7803
"01089010302",3063,322,433,29,37,0,12,0,3896
"01089010401",4502,976,240,424,252,145,20,0,6559
"01089010402",3890,457,1361,226,373,258,125,110,6800
"01089010501",7511,245,2942,386,489,85,371,135,12164
"01089010502",1930,73,741,353,223,25,7,0,3352
"01089010612",2504,157,1474,27,195,170,176,63,4766
"01089010621",4524,104,1422,36,477,0,157,0,6720
"01089010622",3063,412,2771,1508,847,173,221,0,8995
"01089010623",4595,110,1200,0,305,24,424,0,6658
"01089010624",6399,144,1116,42,305,8,199,0,8213
"01089010701",5124,803,1585,143,240,120,302,0,8317
"01089010702",4328,616,1986,109,322,59,580,80,8080
"01089010800",7822,556,1012,128,293,51,337,0,10199
"01089010901",12623,217,64,0,706,0,554,0,14164
"01089010902",1876,293,316,128,69,36,33,0,2751
"01089011011",7209,28,815,19,918,86,161,0,9236
"01089011012",5039,90,460,0,724,0,222,13,6548
"01089011013",4034,297,562,81,129,62,155,25,5345
"01089011014",5843,451,1076,590,887,17,212,0,9076
"01089011021",2277,257,958,77,411,160,219,33,4392
"01089011022",5142,179,944,0,478,97,397,84,7321
"01089011100",470,62,223,17,56,0,47,0,875
"01089011200",4495,263,2034,418,879,25,201,197,8512
"01089011300",4236,628,55,26,291,239,116,107,5698
"01089011400",3909,480,7,0,140,25,26,0,4587
"01091972900",1244,224,1333,1651,0,0,0,22,4474
"01091973000",2104,48,1408,907,66,7,80,97,4717
"01091973100",556,56,866,299,0,0,0,0,1777
"01091973200",1024,61,1260,632,0,0,0,0,2977
"01091973300",1199,79,716,514,0,0,6,0,2514
"01091973400",2848,61,723,350,177,24,160,24,4367
"01093964000",3089,1473,0,0,50,17,0,19,4648
"01093964100",2001,758,0,11,6,17,0,0,2793
"01093964200",1289,180,50,4,4,0,0,0,1527
"01093964300",3266,737,28,61,159,60,316,27,4654
"01093964400",3854,657,223,192,80,0,0,0,5006
"01093964500",2044,468,0,0,54,12,63,0,2641
"01093964600",2169,656,89,68,25,55,6,0,3068
"01093964700",4887,674,71,94,41,2,212,20,6001
"01095030100",2010,650,0,0,35,26,219,139,3079
"01095030201",4472,907,0,0,109,40,22,0,5550
"01095030202",4173,616,0,9,29,8,0,0,4835
"01095030300",4945,682,68,4,144,37,93,0,5973
"01095030401",3419,647,0,0,145,17,38,111,4377
"01095030402",3058,222,0,0,4,0,58,0,3342
"01095030500",6412,1027,0,0,81,128,29,55,7732
"01095030600",4622,1218,288,180,158,55,215,196,6932
"01095030701",2561,834,88,38,263,63,226,99,4172
"01095030702",2761,534,202,3,84,230,20,202,4036
"01095030801",3341,1179,119,2,198,130,440,374,5783
"01095030802",5159,1665,49,6,111,274,1301,1054,9619
"01095030902",3484,650,14,3,115,10,413,83,4772
"01095030903",3860,1801,0,156,142,242,1221,1194,8616
"01095030904",3993,830,23,1,171,64,678,280,6040
"01095031000",4029,1080,0,0,769,119,848,145,6990
"01095031100",2942,1157,100,0,523,84,894,361,6061
"01095031200",4971,267,0,0,287,151,400,171,6247
"01097000200",364,113,276,108,11,10,0,0,882
"01097000401",0,13,752,573,0,0,0,0,1338
"01097000402",0,0,279,171,0,0,0,0,450
"01097000500",0,13,1410,1031,12,5,11,9,2491
"01097000600",12,5,1111,1259,0,14,5,15,2421
"01097000701",0,0,845,895,0,5,7,0,1752
"01097000702",0,0,1594,544,0,58,0,0,2196
"01097000800",7,9,3380,993,15,0,7,0,4411
"01097000901",1023,67,359,154,8,16,69,0,1696
"01097000902",1588,122,59,53,11,42,0,5,1880
"01097000903",807,123,659,318,6,0,104,11,2028
"01097001001",596,205,317,421,14,0,30,0,1583
"01097001002",773,62,882,404,0,19,60,0,2200
"01097001100",10,0,1177,528,8,0,5,0,1728
"01097001200",5,0,907,988,0,41,0,77,2018
"01097001302",28,47,1399,1398,8,0,0,39,2919
"01097001400",22,0,1411,986,0,0,4,0,2423
"01097001501",0,0,746,1109,0,18,0,0,1873
"01097001502",0,0,255,1206,20,0,0,0,1481
"01097001800",687,241,933,171,121,9,115,115,2392
"01097001901",844,264,762,322,54,10,0,0,2256
"01097001902",1308,228,1056,683,58,163,35,100,3631
"01097002000",1109,38,495,230,4,0,21,0,1897
"01097002100",645,167,2737,1050,0,9,0,0,4608
"01097002200",333,200,1391,772,97,0,26,0,2819
"01097002301",150,53,1105,745,9,0,29,0,2091
"01097002302",17,29,1515,967,0,0,0,0,2528
"01097002400",651,37,2084,629,21,93,96,85,3696
"01097002501",3110,190,297,34,36,11,159,0,3837
"01097002502",2046,171,180,0,1,0,12,0,2410
"01097002600",276,45,1139,1185,13,39,1,0,2698
"01097002700",183,54,1158,869,15,36,15,0,2330
"01097002800",1983,629,1393,837,20,70,103,17,5052
"01097002900",1734,181,942,853,101,17,189,26,4043
"01097003000",1717,210,600,85,10,12,40,0,2674
"01097003100",3516,197,279,59,58,1,63,8,4181
"01097003202",959,72,634,513,0,20,35,0,2233
"01097003203",1603,419,898,621,129,31,0,66,3767
"01097003204",1049,169,924,456,528,140,172,0,3438
"01097003205",664,9,1189,988,298,132,105,121,3506
"01097003301",1668,239,326,109,113,39,99,0,2593
"01097003302",3154,407,283,22,28,0,248,121,4263
"01097003402",715,56,2458,492,88,13,8,0,3830
"01097003404",419,99,1213,793,0,0,32,0,2556
"01097003405",1052,47,669,43,7,20,0,20,1858
"01097003406",1250,96,959,261,45,0,84,0,2695
"01097003407",3657,531,2731,406,99,170,14,322,7930
"01097003408",1020,462,1916,313,110,14,124,0,3959
"01097003501",2956,277,354,166,0,68,0,0,3821
"01097003502",2321,210,42,14,2,0,12,0,2601
"01097003602",82,122,372,278,0,26,15,0,895
"01097003605",0,0,0,0,0,0,0,0,0
"01097003606",2131,371,557,245,95,97,38,7,3541
"01097003607",1164,642,1160,762,136,0,130,0,3994
"01097003608",323,34,819,27,48,0,5,0,1256
"01097003703",2102,189,823,5,114,73,191,23,3520
"01097003704",3197,304,503,57,216,37,117,0,4431
"01097003705",2369,157,618,42,235,0,35,0,3456
"01097003706",2197,165,510,101,108,11,143,86,3321
"01097003707",1862,293,1282,339,758,21,88,0,4643
"01097003708",2730,102,788,0,364,0,122,0,4106
"01097003709",4089,318,733,172,253,0,164,0,5729
"01097003710",2786,365,1046,50,114,0,78,0,4439
"01097003800",508,188,459,197,34,0,0,0,1386
"01097003901",13,7,1352,773,14,1,0,2,2162
"01097003902",0,0,562,191,0,0,0,0,753
"01097004000",10,0,1080,1411,39,13,15,12,2580
"01097004100",61,1,439,434,0,0,19,0,954
"01097004800",44,5,606,466,0,0,0,0,1121
"01097004900",91,85,2027,1292,0,0,0,0,3495
"01097005000",425,292,1135,207,28,0,0,0,2087
"01097005100",569,184,349,578,16,33,62,33,1824
"01097005200",853,170,290,202,14,6,2,1,1538
"01097005300",941,242,246,212,9,0,0,0,1650
"01097005400",3352,339,326,109,232,91,431,0,4880
"01097005500",1746,263,461,22,102,252,8,23,2877
"01097005600",5658,281,447,420,122,28,8,0,6964
"01097005700",5341,619,575,152,223,11,0,0,6921
"01097005800",1202,349,1471,387,595,441,0,41,4486
"01097005900",3327,192,832,480,36,10,10,0,4887
"01097006000",2887,430,568,152,324,29,296,0,4686
"01097006102",1724,478,94,83,101,16,32,0,2528
"01097006103",1417,482,2170,627,87,77,60,18,4938
"01097006104",3485,351,546,8,76,122,273,0,4861
"01097006105",3802,630,1518,115,193,49,111,14,6432
"01097006200",4126,1105,161,14,44,67,36,0,5553
"01097006301",8806,1463,550,1,180,16,529,0,11545
"01097006302",5393,314,715,0,67,122,16,51,6678
"01097006402",2858,683,707,270,96,86,46,0,4746
"01097006403",978,211,588,84,54,0,108,0,2023
"01097006404",7431,616,2203,231,754,102,266,0,11603
"01097006405",5716,483,707,237,419,76,37,76,7751
"01097006406",5900,427,700,72,478,0,259,254,8090
"01097006407",5554,467,210,37,78,0,0,0,6346
"01097006501",3996,216,493,198,182,21,91,0,5197
"01097006502",9944,1085,376,0,337,14,223,26,12005
"01097006600",4105,317,440,91,49,136,119,0,5257
"01097006701",3902,827,481,406,197,152,411,11,6387
"01097006702",1843,499,343,51,444,22,0,0,3202
"01097006801",6491,189,866,147,787,20,112,1,8613
"01097006802",2524,243,322,163,43,0,12,8,3315
"01097006901",4451,1747,391,851,307,281,79,111,8218
"01097006902",2787,467,305,136,527,88,337,0,4647
"01097007000",4125,168,127,0,159,9,39,6,4633
"01097007101",3415,507,271,184,371,41,219,62,5070
"01097007102",754,184,1711,298,106,83,84,0,3220
"01097007103",2876,623,126,164,93,33,0,0,3915
"01097007201",1749,322,119,0,248,371,0,0,2809
"01097007202",1967,134,43,0,97,12,36,12,2301
"01097007300",2097,708,199,190,696,285,103,5,4283
"01097007400",1290,369,1125,853,103,23,15,0,3778
"01097007500",0,6,1077,564,0,6,0,0,1653
"01097007600",59,2,1235,927,6,0,0,0,2229
"01097007700",0,0,746,687,54,22,0,0,1509
"01097990000",0,0,0,0,0,0,0,0,0
"01099075600",170,15,572,485,13,0,0,0,1255
"01099075700",515,102,569,462,23,0,0,0,1671
"01099075800",385,103,583,369,0,0,0,0,1440
"01099075900",2392,210,1523,1696,167,0,224,0,6212
"01099076000",1393,286,795,788,24,0,5,0,3291
"01099076100",4519,1271,801,472,180,42,4,0,7289
"01099076200",946,128,305,23,235,0,0,0,1637
"01101000100",58,34,54,380,0,68,0,14,608
"01101000200",84,59,564,204,15,2,0,0,928
"01101000300",184,0,559,389,66,0,13,0,1211
"01101000400",1291,225,1056,1539,49,14,82,0,4256
"01101000500",1381,492,505,396,165,57,432,312,3740
"01101000600",5,0,438,793,97,0,0,0,1333
"01101000700",257,59,480,319,5,0,15,0,1135
"01101000900",718,24,115,13,64,0,24,0,958
"01101001000",132,40,246,697,4,0,0,0,1119
"01101001100",3,0,1612,1543,0,7,3,0,3168
"01101001200",5,0,828,722,0,31,0,0,1586
"01101001300",718,50,851,386,139,22,128,0,2294
"01101001400",2200,414,430,38,47,1,17,1,3148
"01101001500",497,15,870,747,58,192,46,0,2425
"01101001600",979,816,959,553,104,13,73,461,3958
"01101001700",3949,387,126,614,44,0,72,0,5192
"01101001800",1757,395,573,106,68,27,11,74,3011
"01101001900",2483,269,303,92,63,0,169,0,3379
"01101002000",3220,136,1017,249,75,0,52,0,4749
"01101002100",858,86,2776,841,10,0,0,0,4571
"01101002201",109,9,2797,1167,19,33,0,22,4156
"01101002202",13,0,516,578,8,0,0,0,1115
"01101002300",7,0,1938,612,21,18,0,0,2596
"01101002400",14,7,1126,610,18,0,14,0,1789
"01101002500",789,63,757,834,367,126,127,62,3125
"01101002600",4423,344,483,147,125,66,57,0,5645
"01101002700",2861,74,868,504,93,11,123,0,4534
"01101002800",976,38,2154,849,25,0,76,127,4245
"01101002900",247,0,5106,2200,363,15,376,0,8307
"01101003000",394,313,1281,1643,49,0,49,251,3980
"01101003100",361,29,2924,937,49,56,0,0,4356
"01101003200",457,86,4247,1591,0,0,138,0,6519
"01101003301",2241,114,798,89,77,0,21,0,3340
"01101003302",2287,163,2598,772,305,72,277,0,6474
"01101005101",1020,31,2120,375,242,0,0,0,3788
"01101005102",266,106,3032,1218,44,2,3,2,4673
"01101005301",346,18,118,42,108,39,15,15,701
"01101005302",775,128,787,220,110,33,55,31,2139
"01101005402",1616,234,2764,901,320,47,107,24,6013
"01101005403",943,137,1954,972,253,6,0,0,4265
"01101005406",6552,98,1576,364,839,222,93,0,9744
"01101005407",2616,182,929,48,350,0,41,0,4166
"01101005408",4633,595,2457,89,357,0,168,7,8306
"01101005409",945,30,983,177,17,12,0,25,2189
"01101005410",1466,179,2603,226,231,16,40,0,4761
"01101005501",539,19,809,218,4,0,130,0,1719
"01101005502",277,0,425,36,0,0,0,0,738
"01101005503",2853,54,906,318,320,0,38,0,4489
"01101005504",629,0,122,36,4,0,0,0,791
"01101005603",726,379,3156,2392,401,357,1010,568,8989
"01101005604",2161,56,1231,30,9,0,29,0,3516
"01101005605",930,91,2866,58,347,1,17,1,4311
"01101005606",430,0,3091,1583,0,48,16,0,5168
"01101005607",2835,14,518,45,576,10,168,0,4166
"01101005608",878,0,208,0,91,0,0,0,1177
"01101005609",1522,76,2161,551,336,113,183,0,4942
"01101005610",622,50,545,62,123,0,20,9,1431
"01101005611",1525,0,686,60,289,335,0,0,2895
"01101005612",993,10,152,0,140,0,0,0,1295
"01101005700",726,63,524,104,5,0,0,0,1422
"01101005800",1263,105,452,162,20,0,0,0,2002
"01101005901",2527,196,1438,534,92,51,173,0,5011
"01101005902",26,64,2313,1262,0,0,0,0,3665
"01101006000",1469,872,1301,239,63,124,84,754,4906
"01101006100",54,30,1500,574,34,0,26,10,2228
"01103000100",1931,874,290,595,73,124,281,412,4580
"01103000200",3371,131,0,110,91,0,27,0,3730
"01103000300",1897,375,228,140,158,10,95,10,2913
"01103000400",1689,652,506,146,300,54,280,13,3640
"01103000600",444,251,816,735,101,94,285,257,2983
"01103000700",1029,423,2029,671,346,73,654,163,5388
"01103000800",1444,436,425,267,173,0,297,285,3327
"01103000900",3266,1583,387,192,552,260,1629,872,8741
"01103001000",1863,272,503,124,234,0,245,106,3347
"01103005101",4172,432,312,97,239,132,378,66,5828
"01103005103",810,178,151,4,134,4,121,0,1402
"01103005105",1891,235,79,4,42,17,28,0,2296
"01103005106",3783,250,610,179,293,13,163,0,5291
"01103005107",3871,93,88,0,308,11,87,0,4458
"01103005108",2751,14,375,461,63,0,100,0,3764
"01103005109",1954,566,1384,603,151,185,546,225,5614
"01103005200",5712,717,50,14,309,75,100,0,6977
"01103005301",7467,747,160,185,143,111,138,36,8987
"01103005302",3329,244,101,1,141,3,131,0,3950
"01103005303",3161,533,140,23,89,0,49,0,3995
"01103005304",4651,432,98,0,25,53,0,17,5276
"01103005404",4511,240,39,0,79,6,7,57,4939
"01103005405",4190,495,69,72,150,0,53,0,5029
"01103005500",3953,581,51,1,273,23,188,17,5087
"01103005600",4837,515,15,0,85,7,117,0,5576
"01103005701",2599,407,38,0,148,0,42,0,3234
"01103005702",4796,964,126,1,231,44,15,507,6684
"01105686800",494,0,462,217,0,0,0,0,1173
"01105687000",1403,162,2418,805,90,0,0,0,4878
"01105687100",547,53,1753,1232,12,0,0,0,3597
"01107050000",3145,486,505,261,66,0,66,0,4529
"01107050100",2397,347,514,363,23,0,149,0,3793
"01107050200",1187,189,296,139,60,0,34,0,1905
"01107050300",1308,144,1190,717,10,72,71,16,3528
"01107050400",1629,199,1590,2279,56,17,12,0,5782
"01109188600",1546,135,159,154,30,0,3,0,2027
"01109188700",834,217,460,135,38,80,113,18,1895
"01109188800",1332,392,358,120,0,23,6,0,2231
"01109188900",1187,415,2037,1247,33,0,125,37,5081
"01109189000",4047,591,1422,1099,354,64,162,21,7760
"01109189100",2377,1447,902,690,78,243,96,0,5833
"01109189200",1800,237,401,245,131,27,74,0,2915
"01109189300",1597,239,1261,597,89,166,59,6,4014
"01111000100",2685,597,76,43,15,227,56,241,3940
"01111000200",2335,481,200,35,65,45,63,0,3224
"01111000300",2602,768,559,115,16,0,16,8,4084
"01111000400",2534,849,652,503,76,80,18,63,4775
"01111000500",2293,540,1116,852,0,54,14,76,4945
"01111000600",1383,101,130,140,44,7,50,6,1861
"01113030200",642,324,432,727,0,46,0,130,2301
"01113030300",2205,382,528,338,84,0,110,0,3647
"01113030401",3385,556,1127,248,424,7,135,0,5882
"01113030402",1976,125,413,25,43,0,0,0,2582
"01113030500",1518,260,314,155,21,2,81,0,2351
"01113030600",1367,281,3174,1724,161,239,262,231,7439
"01113030700",1010,217,1546,1229,22,17,307,40,4388
"01113030800",54,25,2587,693,0,4,57,0,3420
"01113030901",4236,1327,629,44,456,54,216,0,6962
"01113030902",3491,451,3152,572,431,125,405,38,8665
"01113031000",2446,479,502,105,44,69,163,0,3808
"01113031100",246,13,932,413,5,6,6,0,1621
"01113031200",2045,364,1002,405,106,25,59,114,4120
"01115040103",7121,724,621,214,201,135,7,138,9161
"01115040104",5230,186,15,0,15,0,44,0,5490
"01115040105",2806,969,7,71,218,16,195,277,4559
"01115040106",4815,545,200,326,182,0,26,0,6094
"01115040201",3986,1037,11,37,35,14,29,191,5340
"01115040203",3297,1188,1313,454,56,14,29,35,6386
"01115040204",5554,626,618,2,161,0,18,0,6979
"01115040205",4508,785,175,0,154,10,33,18,5683
"01115040300",3849,1147,364,108,73,64,0,0,5605
"01115040401",2783,981,532,130,130,75,220,58,4909
"01115040402",2958,472,174,0,48,79,3,63,3797
"01115040501",9959,614,281,84,87,58,0,0,11083
"01115040502",6156,1362,735,0,312,0,338,61,8964
"01117030102",2796,456,591,241,34,33,6,80,4237
"01117030103",807,43,0,57,70,0,11,1,989
"01117030211",2435,121,348,9,68,0,15,2,2998
"01117030212",1558,198,1048,27,564,116,262,127,3900
"01117030213",3615,127,462,85,235,22,231,43,4820
"01117030214",6599,228,356,20,282,0,293,0,7778
"01117030215",3371,34,236,0,248,21,105,0,4015
"01117030216",4941,135,513,0,347,0,97,0,6033
"01117030217",4898,134,434,0,195,0,174,0,5835
"01117030303",5691,252,486,67,608,430,113,104,7751
"01117030304",4983,272,269,0,234,0,41,0,5799
"01117030305",3893,61,93,0,103,5,7,0,4162
"01117030306",2623,151,185,102,386,65,327,65,3904
"01117030314",2119,184,616,129,147,0,176,0,3371
"01117030315",4236,720,233,22,893,0,1488,519,8111
"01117030316",4362,240,560,81,384,0,401,123,6151
"01117030317",3095,87,404,0,164,0,56,0,3806
"01117030319",1073,39,895,273,227,407,247,407,3568
"01117030320",4238,276,696,28,94,11,157,54,5554
"01117030330",4426,200,340,76,413,11,40,0,5506
"01117030331",3810,332,93,0,156,43,55,11,4500
"01117030332",927,14,104,0,35,0,14,0,1094
"01117030333",3819,127,330,0,645,0,0,39,4960
"01117030334",3426,120,115,36,281,222,54,222,4476
"01117030336",5070,106,424,26,141,23,54,72,5916
"01117030337",1137,181,129,0,315,0,289,72,2123
"01117030340",4553,215,495,124,70,0,114,8,5579
"01117030341",1351,178,305,12,72,0,72,62,2052
"01117030342",2394,21,20,28,324,0,322,5,3114
"01117030344",2055,58,446,0,167,0,84,12,2822
"01117030345",2338,114,161,0,146,17,9,0,2785
"01117030405",643,70,393,75,19,0,0,0,1200
"01117030406",2240,407,367,238,256,118,462,256,4344
"01117030407",555,361,151,83,0,0,51,79,1280
"01117030408",2174,227,646,143,92,0,27,0,3309
"01117030501",4920,581,848,87,497,192,669,378,8172
"01117030502",1719,70,240,0,3,0,37,0,2069
"01117030604",4811,217,785,52,484,299,613,312,7573
"01117030605",5187,193,853,206,100,45,119,45,6748
"01117030607",4616,252,544,0,314,132,189,229,6276
"01117030608",2360,159,401,0,266,0,135,0,3321
"01117030609",5747,211,1165,16,79,0,46,92,7356
"01117030701",2685,393,118,155,42,27,74,95,3589
"01117030703",2873,487,309,370,59,26,97,68,4289
"01117030704",3117,447,156,0,55,0,99,0,3874
"01117030800",2804,564,74,71,100,40,28,0,3681
"01117030900",2147,224,47,0,14,7,14,0,2453
"01117980000",26,0,0,0,0,0,0,0,26
"01119011300",1164,473,2135,1950,12,0,0,8,5742
"01119011400",302,23,467,653,79,0,18,0,1542
"01119011500",493,26,2321,1655,37,28,55,0,4615
"01119011600",640,35,428,115,5,0,12,0,1235
"01121010101",3692,290,613,119,145,5,176,0,5040
"01121010102",2916,552,783,314,28,16,33,6,4648
"01121010201",2584,357,813,130,13,0,13,0,3910
"01121010202",3005,591,308,168,183,0,0,0,4255
"01121010301",1507,715,184,711,8,0,41,0,3166
"01121010302",2232,407,970,332,0,0,0,0,3941
"01121010400",1942,507,333,48,52,13,40,2,2937
"01121010500",879,97,1022,703,183,27,128,0,3039
"01121010600",294,130,1059,1292,0,0,0,27,2802
"01121010700",124,14,690,485,0,0,33,0,1346
"01121010900",1695,516,622,149,55,0,55,31,3123
"01121011000",2104,166,297,47,235,0,0,0,2849
"01121011100",1709,418,1941,520,86,0,50,0,4724
"01121011200",515,105,996,213,10,0,0,0,1839
"01121011300",2697,503,951,1458,84,44,20,0,5757
"01121011400",1101,372,819,538,32,6,82,60,3010
"01121011500",4466,527,310,179,195,0,23,0,5700
"01121011600",3150,688,1006,494,0,87,0,0,5425
"01121011700",3108,555,473,265,17,144,279,89,4930
"01121011800",846,646,307,319,4,40,40,55,2257
"01121011900",1751,323,348,199,12,0,23,0,2656
"01121012000",1146,85,780,322,0,38,64,0,2435
"01123961900",1769,245,252,346,5,0,4,14,2635
"01123962000",1926,192,1518,624,32,35,35,0,4362
"01123962100",1586,254,856,977,130,8,58,0,3869
"01123962200",2462,813,638,402,156,33,229,188,4921
"01123962300",4267,1174,790,284,47,0,36,299,6897
"01123962400",2511,456,970,357,54,79,0,0,4427
"01123962501",3013,352,601,51,29,0,12,0,4058
"01123962502",2332,226,262,28,18,16,42,54,2978
"01123962600",458,73,864,425,21,0,56,0,1897
"01123962700",4680,219,482,402,16,0,0,0,5799
"01125010101",3465,141,66,0,511,0,115,0,4298
"01125010102",2781,136,15,8,54,0,0,0,2994
"01125010103",4858,474,179,25,58,19,42,0,5655
"01125010201",3374,127,115,0,0,0,94,13,3723
"01125010202",8092,262,1253,69,194,0,648,0,10518
"01125010203",2399,68,256,0,96,31,22,0,2872
"01125010204",3166,640,731,83,127,52,113,0,4912
"01125010301",4417,283,700,327,123,50,43,0,5943
"01125010302",2593,567,55,89,32,0,23,12,3371
"01125010303",1706,141,787,49,28,0,0,0,2711
"01125010403",1766,365,939,228,54,0,88,106,3546
"01125010404",854,68,535,705,46,0,0,0,2208
"01125010405",2041,331,271,15,187,115,0,79,3039
"01125010406",4113,315,55,74,214,51,260,0,5082
"01125010407",1856,177,467,187,39,93,44,0,2863
"01125010500",901,426,609,540,58,6,238,255,3033
"01125010601",3917,487,240,21,46,4,86,6,4807
"01125010602",9131,1076,512,0,186,0,18,0,10923
"01125010701",4208,596,1055,247,21,35,66,0,6228
"01125010702",5944,904,454,13,90,3,190,3,7601
"01125010703",2140,442,113,9,37,9,8,0,2758
"01125010802",3228,125,839,87,113,0,95,0,4487
"01125010803",1139,426,552,571,8,0,129,355,3180
"01125010804",2058,238,354,110,68,17,309,18,3172
"01125011200",260,155,0,49,0,0,0,0,464
"01125011401",633,575,7,172,32,117,0,18,1554
"01125011402",534,1394,4,53,49,34,0,44,2112
"01125011600",385,115,1302,470,49,9,9,0,2339
"01125011701",0,0,1396,904,0,0,0,0,2300
"01125011703",181,18,3440,1297,0,0,0,12,4948
"01125011800",3,3,1894,1275,0,0,0,0,3175
"01125011901",1013,740,288,538,67,0,15,0,2661
"01125011902",155,178,918,416,18,25,0,102,1812
"01125012000",1498,883,105,42,24,12,169,13,2746
"01125012100",2532,1144,937,436,415,0,303,0,5767
"01125012303",3712,313,2063,1266,289,0,54,122,7819
"01125012304",712,186,1372,850,90,13,110,13,3346
"01125012305",1538,162,2365,533,88,23,135,33,4877
"01125012403",1801,281,1186,436,86,0,0,0,3790
"01125012404",527,279,1177,327,28,0,0,0,2338
"01125012405",1225,557,4198,2084,42,43,272,43,8464
"01125012501",298,96,1295,207,0,0,30,0,1926
"01125012502",4472,226,1358,302,327,0,22,0,6707
"01125012503",2938,303,761,15,179,5,19,122,4342
"01125012600",548,629,122,309,27,11,41,9,1696
"01125012700",1817,398,1559,448,24,54,288,86,4674
"01125012800",247,225,1268,847,24,54,126,120,2911
"01127020100",2038,677,586,357,340,33,226,0,4257
"01127020200",3183,569,19,46,90,34,46,0,3987
"01127020300",4669,1013,451,200,50,26,116,224,6749
"01127020400",1384,431,394,50,46,7,15,72,2399
"01127020600",2094,410,48,14,65,0,39,42,2712
"01127020700",2853,379,0,17,119,160,155,149,3832
"01127020800",4528,528,148,51,59,139,17,29,5499
"01127020900",3135,1083,1,1,30,3,0,0,4253
"01127021000",2544,1041,0,9,7,49,0,7,3657
"01127021100",2555,857,134,68,68,1,0,0,3683
"01127021200",2758,774,1,0,11,55,0,28,3627
"01127021300",2792,597,49,45,143,27,0,0,3653
"01127021400",2697,819,153,73,88,50,0,9,3889
"01127021500",2315,455,34,60,67,44,57,26,3058
"01127021600",1081,140,109,0,34,11,13,11,1399
"01127021700",3422,607,225,52,63,41,31,9,4450
"01127021800",2340,769,52,4,41,123,0,49,3378
"01127021900",1641,678,12,0,22,11,0,0,2364
"01129043900",1842,305,324,276,150,8,75,0,2980
"01129044000",2424,261,645,332,17,0,0,7,3686
"01129044100",2170,401,776,106,47,0,0,0,3500
"01129044200",1379,309,862,353,1267,84,2,0,4256
"01129044300",1798,312,138,277,48,108,0,99,2780
"01131034700",48,14,315,708,0,0,0,0,1085
"01131034800",1229,105,1496,1850,5,12,5,7,4709
"01131035100",1153,103,1169,1120,0,0,0,0,3545
"01131035200",289,39,1119,449,0,0,0,0,1896
"01133965501",1797,751,0,0,66,47,0,18,2679
"01133965502",2046,340,0,0,17,0,4,0,2407
"01133965503",2340,513,0,0,16,25,13,0,2907
"01133965600",3813,1010,3,1,45,96,81,0,5049
"01133965700",3192,1099,0,0,124,64,133,123,4735
"01133965800",2899,1231,18,0,21,105,72,137,4483
"01133965900",1621,338,0,35,41,44,0,61,2140
"02013000100",632,85,231,152,1749,286,344,79,3558
"02016000100",120,18,18,0,701,94,25,2,978
"02016000200",1427,91,241,56,2307,229,504,34,4889
"02020000101",5141,251,0,0,781,42,266,1,6482
"02020000102",4143,73,0,1,928,21,419,19,5604
"02020000201",2999,76,132,0,897,23,228,0,4355
"02020000202",4432,422,14,0,1144,89,429,12,6542
"02020000203",9294,143,643,0,976,43,1163,0,12262
"02020000204",2996,113,24,0,389,8,103,2,3635
"02020000300",3925,333,1212,0,1016,16,621,119,7242
"02020000400",3534,211,681,25,544,89,425,50,5559
"02020000500",809,82,286,0,869,64,340,53,2503
"02020000600",1771,411,568,240,2780,1431,565,166,7932
"02020000701",2434,114,697,45,2474,243,935,26,6968
"02020000702",2787,189,844,0,1083,230,408,0,5541
"02020000703",2267,168,431,80,2218,414,274,59,5911
"02020000801",2482,88,554,70,3232,1186,1068,103,8783
"02020000802",1919,277,506,44,1044,664,243,111,4808
"02020000901",1422,222,324,225,2208,552,429,199,5581
"02020000902",1252,146,145,162,732,173,136,131,2877
"02020001000",1606,371,336,18,868,275,202,97,3773
"02020001100",420,59,57,11,69,10,17,3,646
"02020001200",2867,63,81,0,482,27,201,0,3721
"02020001300",2471,66,10,0,344,13,227,0,3131
"02020001400",3033,113,210,157,1103,341,299,11,5267
"02020001500",3480,161,110,55,750,372,205,0,5133
"02020001601",2417,48,244,5,1417,45,332,40,4548
"02020001602",2459,173,207,21,890,51,251,0,4052
"02020001701",3452,258,964,48,2096,114,223,40,7195
"02020001702",3255,262,359,14,966,170,344,34,5404
"02020001731",3303,249,240,88,1494,357,255,9,5995
"02020001732",3915,111,366,0,1333,265,273,14,6277
"02020001801",3177,152,312,70,1146,74,200,94,5225
"02020001802",2578,280,318,26,1451,464,555,136,5808
"02020001900",1289,217,161,25,1758,546,294,8,4298
"02020002000",1631,280,247,0,1212,223,610,212,4415
"02020002100",2275,150,107,0,1139,14,99,23,3807
"02020002201",3285,195,85,27,1248,117,294,0,5251
"02020002202",1704,328,92,0,794,185,100,342,3545
"02020002301",5345,462,92,0,1621,23,422,16,7981
"02020002302",3617,291,10,10,1172,13,199,43,5355
"02020002303",4892,390,277,267,2231,516,588,0,9161
"02020002400",1950,229,72,0,651,80,270,23,3275
"02020002501",3223,83,323,0,1235,236,383,63,5546
"02020002502",3574,122,203,36,1531,155,543,0,6164
"02020002601",2649,143,254,42,2076,57,505,19,5745
"02020002602",3580,150,257,30,1667,265,268,109,6326
"02020002603",4340,124,86,0,1710,79,519,13,6871
"02020002702",7700,76,73,18,2163,34,664,38,10766
"02020002711",4926,30,106,0,1033,46,293,0,6434
"02020002712",5422,214,602,34,2654,254,887,79,10146
"02020002811",3239,69,91,29,2580,236,460,51,6755
"02020002812",6316,161,479,8,744,5,271,10,7994
"02020002813",4245,88,0,0,398,31,112,0,4874
"02020002821",4202,112,129,36,597,8,165,0,5249
"02020002822",3717,55,26,0,396,16,103,5,4318
"02020002823",4550,86,108,0,536,13,86,78,5457
"02020002900",2143,95,0,0,260,54,276,0,2828
"02050000100",220,23,7,0,6609,2738,34,9,9640
"02050000200",1408,64,84,0,3703,657,144,26,6086
"02050000300",189,9,2,0,913,389,6,0,1508
"02060000100",505,13,1,0,348,60,49,1,977
"02068000100",1599,126,9,0,94,93,35,13,1969
"02070000100",162,4,2,4,1969,603,15,22,2781
"02070000200",683,31,12,0,1182,244,69,7,2228
"02090000100",1123,161,38,38,413,78,93,23,1967
"02090000200",1849,294,206,43,387,121,39,6,2945
"02090000300",1876,313,697,80,1151,316,241,0,4674
"02090000400",3122,175,82,25,1174,271,362,0,5211
"02090000500",2042,105,64,0,573,77,458,11,3330
"02090000600",2692,396,65,10,1033,109,140,0,4445
"02090000700",2607,211,406,89,650,196,471,56,4686
"02090000800",3594,257,383,0,1583,230,516,37,6600
"02090000900",4878,179,33,0,1140,0,673,0,6903
"02090001000",1061,112,0,0,153,157,45,1,1529
"02090001100",3787,933,1139,21,885,84,973,195,8017
"02090001200",5447,55,0,0,1040,126,244,0,6912
"02090001300",4005,362,0,0,560,62,64,0,5053
"02090001400",6518,272,21,0,707,105,316,27,7966
"02090001500",9115,490,216,0,1103,0,252,0,11176
"02090001600",3526,297,259,0,649,164,257,0,5152
"02090001700",875,157,0,0,54,9,25,0,1120
"02090001800",1698,33,328,0,202,3,267,8,2539
"02090001900",8890,675,0,6,758,95,302,6,10732
"02100000100",1907,109,7,3,394,84,19,2,2525
"02105000200",21,0,0,0,85,4,3,0,113
"02105000300",916,104,9,0,783,210,32,14,2068
"02110000100",3996,92,0,0,563,25,152,8,4836
"02110000200",4906,81,27,0,2013,172,612,38,7849
"02110000300",3272,180,87,0,1670,363,217,88,5877
"02110000400",2264,179,99,5,1838,106,158,8,4657
"02110000500",2681,116,14,0,813,144,172,48,3988
"02110000600",3970,204,108,0,1123,264,192,48,5909
"02122000100",152,3,0,0,163,80,0,0,398
"02122000200",4471,287,16,0,546,34,317,23,5694
"02122000300",863,57,0,0,7,39,21,12,999
"02122000400",5208,503,0,0,263,91,62,1,6128
"02122000500",4973,291,8,0,1145,37,253,2,6709
"02122000600",5103,579,141,0,1301,98,153,24,7399
"02122000700",8501,418,23,9,1337,149,528,0,10965
"02122000800",2894,450,2,0,258,65,74,10,3753
"02122000900",1593,139,0,0,126,9,11,0,1878
"02122001000",3324,365,21,0,307,70,119,43,4249
"02122001100",2490,425,9,1,141,27,73,22,3188
"02122001200",372,23,6,11,340,159,3,4,918
"02122001300",3011,214,12,0,1003,95,45,0,4380
"02130000100",2871,31,0,0,501,67,136,0,3606
"02130000200",2517,321,22,0,1506,283,202,0,4851
"02130000300",1398,244,8,0,994,232,145,32,3053
"02130000400",1617,52,0,0,530,133,35,17,2384
"02150000100",888,36,8,26,785,267,142,29,2181
"02150000200",3566,378,15,0,2097,482,398,14,6950
"02150000300",617,167,0,0,1788,105,207,42,2926
"02150000400",468,46,0,3,387,16,44,6,970
"02150000500",1148,50,7,1,149,0,165,0,1520
"02164000100",323,15,7,0,808,290,17,1,1461
"02170000101",542,212,0,0,6,10,0,10,780
"02170000102",1763,250,0,0,73,57,1,0,2144
"02170000200",881,217,0,0,100,47,25,0,1270
"02170000300",5123,232,37,0,507,28,379,0,6306
"02170000401",1299,261,8,0,243,53,5,33,1902
"02170000402",1507,247,0,0,115,4,30,0,1903
"02170000501",1362,243,25,21,559,0,127,21,2358
"02170000502",1516,188,0,0,228,0,53,0,1985
"02170000601",3409,367,23,0,654,69,9,27,4558
"02170000603",5163,333,50,0,918,45,395,0,6904
"02170000604",3181,386,15,0,345,73,70,21,4091
"02170000701",2436,161,0,0,278,0,117,0,2992
"02170000703",2231,395,10,0,525,61,120,7,3349
"02170000705",3274,297,0,8,452,36,399,0,4466
"02170000706",3928,978,50,0,635,69,191,0,5851
"02170000800",3327,507,34,47,703,116,160,31,4925
"02170000900",2167,144,68,7,328,206,97,7,3024
"02170001001",2875,94,41,0,565,80,102,21,3778
"02170001003",2629,245,2,0,609,116,129,46,3776
"02170001004",4087,308,41,0,771,66,201,15,5489
"02170001100",4534,270,55,22,560,23,126,7,5597
"02170001201",3646,294,19,27,645,135,227,23,5016
"02170001202",3818,304,59,3,762,118,244,14,5322
"02170001300",4763,349,129,0,396,68,134,12,5851
"02180000100",210,13,3,0,3365,2232,31,3,5857
"02180000200",1308,62,77,0,1852,307,86,0,3692
"02185000100",745,20,34,0,2882,477,175,0,4333
"02185000200",206,2,2,0,2207,344,14,2,2777
"02185000300",1975,104,0,0,305,17,70,0,2471
"02188000100",226,19,2,0,2978,1137,13,12,4387
"02188000200",611,37,42,0,2034,469,61,0,3254
"02195000200",2389,328,58,2,826,179,158,43,3983
"02198000100",880,162,0,0,413,76,1,0,1532
"02198000200",1336,250,5,0,649,156,89,8,2493
"02198000300",77,4,0,0,0,0,0,0,81
"02198940100",94,6,6,0,1305,196,46,4,1657
"02220000100",2361,140,17,14,950,270,82,0,3834
"02220000200",2930,324,29,0,1603,131,351,24,5392
"02230000100",795,47,0,0,224,12,12,0,1090
"02240000100",1192,213,0,0,649,184,0,9,2247
"02240000400",3731,502,102,0,372,25,182,66,4980
"02261000100",1663,140,17,0,613,231,32,0,2696
"02261000200",1826,17,0,0,720,8,15,0,2586
"02261000300",3099,252,17,0,779,139,288,33,4607
"02270000100",254,17,15,0,4976,2381,12,5,7660
"02275000300",1497,84,0,2,622,137,54,0,2396
"02282000100",212,3,39,0,320,33,11,0,618
"02290000100",146,27,0,0,678,339,0,13,1203
"02290000200",552,112,2,4,615,190,12,39,1526
"02290000300",238,7,0,0,1189,451,8,0,1893
"02290000400",154,12,2,0,677,217,2,5,1069
"04001942600",0,0,0,0,733,785,0,0,1518
"04001942700",63,0,0,0,3106,1940,11,7,5127
"04001944000",201,32,0,30,3213,2478,31,68,6053
"04001944100",92,8,7,0,2730,2694,59,56,5646
"04001944201",331,45,29,8,2278,1453,16,139,4299
"04001944202",24,0,21,0,1983,1988,26,11,4053
"04001944300",62,20,6,0,4376,2891,51,10,7416
"04001944901",65,74,10,31,2230,1428,5,34,3877
"04001944902",109,27,18,0,2680,2357,34,62,5287
"04001945001",104,104,10,0,2806,1462,10,9,4505
"04001945002",85,24,0,6,2531,1554,124,29,4353
"04001945100",121,51,11,7,1355,939,45,17,2546
"04001970200",3849,913,16,0,208,66,526,48,5626
"04001970300",1904,333,0,0,561,146,643,173,3760
"04001970501",3947,691,0,0,365,151,999,221,6374
"04001970502",2581,501,0,0,259,336,292,146,4115
"04003000100",1177,271,14,0,229,112,396,174,2373
"04003000201",2637,272,0,0,515,0,1519,83,5026
"04003000202",2527,754,0,4,439,95,1697,387,5903
"04003000203",1967,423,16,0,152,82,186,16,2842
"04003000301",2321,827,1,0,435,274,960,371,5189
"04003000302",4710,321,17,0,310,1,401,137,5897
"04003000303",2972,245,0,0,21,40,117,47,3442
"04003000400",1382,518,0,0,205,54,427,188,2774
"04003000500",2299,404,45,45,206,20,453,44,3516
"04003000600",1295,474,0,0,606,296,1576,661,4908
"04003000700",2355,1134,16,5,667,578,2541,1697,8993
"04003000800",2104,797,0,0,1065,309,2699,1105,8079
"04003000901",1073,554,0,0,810,792,1682,1310,6221
"04003000902",1135,360,34,15,612,246,1634,594,4630
"04003001000",893,213,24,15,164,45,184,5,1543
"04003001100",2150,851,0,0,354,208,1313,648,5524
"04003001200",1977,503,7,20,265,261,969,587,4589
"04003001300",3553,852,99,84,870,167,698,318,6641
"04003001401",1431,415,147,0,477,32,318,45,2865
"04003001402",711,13,211,0,83,0,124,11,1153
"04003001501",2003,521,115,0,594,95,796,179,4303
"04003001502",2519,758,24,27,689,74,966,426,5483
"04003001601",3047,419,287,9,1176,0,1151,0,6089
"04003001602",2089,535,35,71,370,54,702,141,3997
"04003001701",2466,262,318,0,452,546,694,514,5252
"04003001702",2550,663,239,43,666,42,667,288,5158
"04003001703",3183,231,106,0,711,93,747,38,5109
"04003001800",6512,177,818,12,1346,30,1181,51,10127
"04003001900",5231,191,481,16,818,22,820,16,7595
"04003002001",3525,691,0,0,246,187,783,191,5623
"04003002002",3604,502,14,26,177,7,766,161,5257
"04003002100",4222,186,73,0,199,295,527,153,5655
"04005000100",2880,192,11,4,567,99,369,39,4161
"04005000200",2638,563,34,0,456,162,293,222,4368
"04005000300",2361,736,184,63,1240,1777,1245,1344,8950
"04005000400",3427,447,125,0,1195,289,878,281,6642
"04005000500",2498,399,38,0,1278,777,1004,427,6421
"04005000600",4462,332,132,0,627,133,331,36,6053
"04005000700",2512,357,0,2,413,132,365,12,3793
"04005000800",1472,1393,94,44,724,411,398,229,4765
"04005000900",4435,799,72,61,940,367,676,306,7656
"04005001000",321,808,0,6,73,619,51,129,2007
"04005001101",3140,521,63,41,961,175,526,30,5457
"04005001102",2972,1559,0,1,1227,889,1139,830,8617
"04005001200",1684,536,20,38,220,34,261,178,2971
"04005001301",4756,171,61,0,838,398,474,171,6869
"04005001302",4847,239,230,0,274,24,862,108,6584
"04005001500",2285,450,0,0,188,20,110,0,3053
"04005001600",2598,267,0,0,137,10,73,15,3100
"04005001700",2253,473,34,5,477,270,684,350,4546
"04005002000",1264,255,0,0,268,93,28,16,1924
"04005002100",4575,379,0,0,1308,912,534,137,7845
"04005002200",4572,387,0,7,793,546,538,363,7206
"04005002300",3155,922,16,40,539,274,432,177,5555
"04005942201",31,5,0,3,2815,1088,53,0,3995
"04005942202",40,0,37,0,2307,1506,12,14,3916
"04005944900",174,13,0,0,2939,1721,100,7,4954
"04005945000",103,10,0,0,2444,1465,99,23,4144
"04005945100",21,4,2,0,2198,1204,60,25,3514
"04005945200",211,0,0,0,3510,1244,53,0,5018
"04007000100",1761,166,0,0,62,0,0,0,1989
"04007000200",1753,348,0,0,52,0,141,0,2294
"04007000301",4781,891,10,0,373,40,269,455,6819
"04007000302",2368,341,0,20,9,20,101,118,2977
"04007000400",3610,505,0,0,177,16,216,16,4540
"04007000500",4216,601,0,0,112,36,173,0,5138
"04007000600",952,220,0,0,35,0,25,0,1232
"04007000700",1300,279,0,1,0,0,0,2,1582
"04007000800",1416,364,0,0,42,15,434,64,2335
"04007000900",2242,736,0,0,310,31,1307,234,4860
"04007001000",3762,1300,0,0,370,9,1341,95,6877
"04007001100",2800,471,0,36,549,121,1608,356,5941
"04007001200",3075,345,64,42,440,182,1115,160,5423
"04007001300",751,187,0,0,112,138,698,261,2147
"04007940200",14,0,0,0,641,910,0,0,1565
"04007940400",140,19,47,13,2756,2898,128,50,6051
"04009940500",13,43,5,6,2277,2472,142,97,5055
"04009961100",3540,585,10,0,232,127,885,239,5618
"04009961201",2279,344,0,19,39,68,225,204,3178
"04009961202",3051,376,27,0,356,0,1366,77,5253
"04009961300",2430,1029,38,0,230,143,1248,440,5558
"04009961400",3513,476,8,0,631,29,1695,284,6636
"04009961500",3094,1070,3,0,279,7,1250,326,6029
"04009961600",718,135,10,0,6,14,72,32,987
"04009961700",2683,284,16,8,303,167,887,231,4579
"04011960100",2024,293,11,0,252,48,1346,211,4185
"04011960200",2625,248,58,0,238,108,1479,294,5050
"04011960300",1706,575,0,0,242,94,476,278,3371
"04012020100",1612,500,0,39,310,167,581,444,3653
"04012020201",1790,329,0,0,8,0,43,24,2194
"04012020202",591,53,0,0,0,3,17,0,664
"04012020501",1162,221,0,0,549,32,620,27,2611
"04012020502",3814,372,0,97,13,53,104,12,4465
"04012020602",723,262,0,0,177,0,183,0,1345
"04012940200",1218,161,19,0,1178,291,878,182,3927
"04012940300",1274,334,9,0,1793,1007,1265,469,6151
"04012980000",0,0,0,0,0,0,0,0,0
"04013010101",4604,287,0,0,142,0,163,0,5196
"04013010102",3944,289,0,2,253,0,71,2,4561
"04013030401",3301,243,0,0,79,2,46,22,3693
"04013030402",3167,285,15,0,286,16,106,30,3905
"04013040502",3662,1213,71,0,191,13,505,230,5885
"04013040506",4981,297,0,1,46,2,29,0,5356
"04013040507",5719,307,0,0,94,0,15,0,6135
"04013040512",1485,54,5,0,79,0,27,0,1650
"04013040513",2912,21,37,0,8,0,0,0,2978
"04013040514",2771,85,29,0,41,0,39,0,2965
"04013040515",3613,446,0,22,118,5,693,324,5221
"04013040516",2378,171,23,0,100,0,201,18,2891
"04013040517",4935,1506,0,15,209,84,955,643,8347
"04013040518",5477,519,544,148,509,0,1292,447,8936
"04013040519",3421,209,38,0,100,0,69,0,3837
"04013040520",3813,61,42,18,135,19,836,0,4924
"04013040521",4045,146,105,0,901,0,327,0,5524
"04013040522",4297,74,0,0,83,0,0,0,4454
"04013040523",2817,62,0,0,158,0,17,0,3054
"04013040524",1349,39,17,0,9,0,18,0,1432
"04013040525",2942,90,42,0,36,8,46,0,3164
"04013040526",2240,62,50,0,0,0,13,0,2365
"04013040527",3551,396,131,0,37,121,111,4,4351
"04013040528",5831,391,27,22,140,0,45,32,6488
"04013040529",2831,55,57,0,50,0,112,0,3105
"04013040530",3145,491,67,0,243,32,501,13,4492
"04013040531",2617,406,178,64,74,0,331,142,3812
"04013050603",2883,517,74,1,324,34,1186,292,5311
"04013050604",2600,498,26,0,163,26,894,380,4587
"04013050605",4536,313,114,20,960,82,1663,134,7822
"04013050606",5642,737,206,60,333,191,1321,405,8895
"04013050607",4563,1174,369,22,409,145,1935,604,9221
"04013050608",3775,957,439,0,1522,132,1617,529,8971
"04013050609",3274,294,125,205,602,230,1830,242,6802
"04013050610",5618,347,788,183,1412,324,3235,450,12357
"04013050611",3225,54,53,32,1256,40,1861,40,6561
"04013050701",3022,908,329,0,735,387,1755,1072,8208
"04013050702",2608,1290,352,22,694,278,1955,924,8123
"04013060801",2766,2122,118,26,680,405,2191,1683,9991
"04013060802",1384,188,239,35,255,12,487,85,2685
"04013060901",2913,632,565,0,340,65,1580,353,6448
"04013060902",1909,631,49,0,312,339,1775,870,5885
"04013060903",3337,1242,145,68,443,360,2441,935,8971
"04013060904",1768,677,16,7,293,401,864,744,4770
"04013061009",6151,280,473,1,1017,0,2410,0,10332
"04013061010",4230,227,0,45,169,0,788,93,5552
"04013061011",3119,1155,357,415,817,118,1132,594,7707
"04013061012",4988,373,484,230,997,186,1365,376,8999
"04013061013",3688,381,701,5,885,61,1661,257,7639
"04013061014",3273,342,910,139,515,30,990,252,6451
"04013061015",4266,380,647,201,729,19,1700,57,7999
"04013061016",3339,142,275,0,736,78,897,65,5532
"04013061017",0,0,0,0,0,0,0,0,0
"04013061018",4028,403,71,0,58,0,60,23,4643
"04013061019",2480,85,189,0,376,22,1117,41,4310
"04013061020",3182,38,454,0,537,44,1268,0,5523
"04013061021",1119,22,385,0,280,45,330,23,2204
"04013061022",7420,1256,408,158,935,73,4121,626,14997
"04013061023",8087,42,893,0,1033,103,3071,86,13315
"04013061024",1720,166,76,204,82,0,945,58,3251
"04013061025",5388,172,344,0,423,294,1491,22,8134
"04013061026",4171,339,66,0,298,73,681,30,5658
"04013061027",4335,172,28,0,224,14,1388,40,6201
"04013061028",1725,78,155,117,238,0,389,59,2761
"04013061029",4517,189,387,0,354,6,673,2,6128
"04013061030",6295,147,321,0,766,119,1267,122,9037
"04013061031",2330,203,136,0,432,9,986,94,4190
"04013061032",3900,992,346,0,571,62,841,108,6820
"04013061033",4800,258,164,51,482,251,664,109,6779
"04013061034",4367,544,417,20,348,130,944,86,6856
"04013061035",4874,170,348,19,1418,0,1836,0,8665
"04013061036",2093,96,619,1,182,10,181,15,3197
"04013061037",3385,548,314,0,271,0,405,325,5248
"04013061038",3168,16,634,11,693,17,1298,17,5854
"04013061039",2977,292,112,0,387,104,820,89,4781
"04013061040",2596,343,96,0,720,23,1219,87,5084
"04013061041",1837,599,314,0,1343,320,1474,632,6519
"04013061042",1596,467,30,0,13,36,256,124,2522
"04013061043",1767,472,34,39,314,0,1033,315,3974
"04013061044",4850,214,432,0,571,55,1154,24,7300
"04013061045",4013,209,49,0,864,128,795,136,6194
"04013061046",3225,577,990,59,655,97,1214,560,7377
"04013061047",2413,51,396,19,417,1,701,3,4001
"04013061100",1400,121,92,74,144,8,429,24,2292
"04013061200",2934,1821,261,299,436,116,2399,2025,10291
"04013061300",1275,257,89,35,374,93,804,250,3177
"04013061401",705,837,192,12,150,168,783,912,3759
"04013061402",2391,1625,54,77,661,371,2479,1729,9387
"04013071503",4241,195,40,0,55,14,78,0,4623
"04013071504",3238,259,14,0,0,30,30,0,3571
"04013071505",5288,463,132,50,131,0,238,0,6302
"04013071506",3664,210,12,0,96,7,187,32,4208
"04013071509",4158,537,144,50,760,17,458,60,6184
"04013071510",3607,92,127,80,311,27,500,0,4744
"04013071511",2215,344,301,18,319,77,381,76,3731
"04013071512",5034,242,22,17,568,36,926,36,6881
"04013071513",1628,38,42,0,121,1,189,7,2026
"04013071514",3137,243,49,0,565,159,478,10,4641
"04013071515",2999,204,24,1,296,30,268,56,3878
"04013071516",2384,288,113,49,82,1,230,20,3167
"04013071517",2994,199,208,3,557,60,545,178,4744
"04013071600",2244,638,69,24,267,133,978,335,4688
"04013071701",2023,371,27,0,223,142,675,253,3714
"04013071702",2927,328,22,20,42,2,193,16,3550
"04013071801",3714,750,80,0,48,77,148,29,4846
"04013071802",3034,217,99,14,108,0,71,17,3560
"04013071903",4762,329,143,0,938,0,1791,101,8064
"04013071906",3920,474,87,180,602,225,1717,421,7626
"04013071909",3366,322,36,10,187,156,837,82,4996
"04013071910",4624,1079,224,2,836,463,2314,569,10111
"04013071911",2127,412,196,0,494,155,876,291,4551
"04013071912",1361,731,176,0,372,45,929,422,4036
"04013071913",2949,1014,637,62,301,76,1498,399,6936
"04013071914",1997,680,77,15,547,351,1467,396,5530
"04013071915",2529,631,308,38,297,0,1524,484,5811
"04013082002",3721,629,489,82,643,134,2294,625,8617
"04013082007",2134,1002,64,9,640,58,1873,749,6529
"04013082008",3061,1081,219,40,683,131,2792,1064,9071
"04013082009",2584,1512,486,18,576,123,2239,1224,8762
"04013082010",1700,906,99,124,568,190,1628,939,6154
"04013082012",4196,408,519,0,839,84,3221,463,9730
"04013082016",1797,240,34,14,479,74,1190,203,4031
"04013082017",2477,672,782,171,450,114,1800,574,7040
"04013082018",2626,386,744,18,863,0,2640,374,7651
"04013082019",1976,115,186,0,150,11,637,19,3094
"04013082020",2509,236,436,0,520,26,886,94,4707
"04013082021",1483,95,166,5,142,0,618,22,2531
"04013082022",2371,324,417,0,476,15,1392,196,5191
"04013082023",3711,530,467,45,588,77,2054,515,7987
"04013082024",2847,728,398,0,428,223,1674,801,7099
"04013082025",1566,245,121,58,266,0,854,215,3325
"04013082026",4139,576,608,17,556,65,2949,335,9245
"04013082027",2684,247,474,0,643,125,1838,287,6298
"04013082028",1990,955,444,144,830,23,1739,787,6912
"04013082203",4594,720,714,0,1035,159,4770,864,12856
"04013082204",4163,211,481,345,642,131,3768,182,9923
"04013082205",3044,769,930,33,664,60,2703,780,8983
"04013082206",2181,58,145,96,522,127,1856,111,5096
"04013082207",1982,112,152,110,333,36,1480,136,4341
"04013082208",2335,795,11,15,115,30,2233,746,6280
"04013082209",1898,724,0,0,260,100,1953,762,5697
"04013082210",2955,306,236,290,534,106,2193,267,6887
"04013082211",3036,162,336,92,994,33,2525,129,7307
"04013083000",4221,1358,80,69,800,101,4336,1286,12251
"04013092305",2753,434,101,0,636,78,922,20,4944
"04013092306",4425,523,391,26,1201,144,1587,194,8491
"04013092307",3711,855,312,15,1289,18,1784,656,8640
"04013092308",4379,888,193,9,497,440,1008,844,8258
"04013092309",3876,122,381,86,456,0,1179,40,6140
"04013092311",1351,522,43,15,98,34,343,88,2494
"04013092312",2875,838,177,89,341,335,1162,202,6019
"04013092401",1807,884,243,97,638,364,1391,765,6189
"04013092402",1826,386,166,26,664,18,1126,84,4296
"04013092500",2490,995,206,37,858,261,2116,865,7828
"04013092600",1071,893,11,69,658,813,831,1183,5529
"04013092705",1654,613,313,99,793,327,938,774,5511
"04013092708",1026,253,146,40,437,21,474,210,2607
"04013092709",3449,587,166,81,429,48,1472,352,6584
"04013092710",3114,364,249,0,639,9,1513,79,5967
"04013092711",1445,1066,100,117,448,231,753,756,4916
"04013092712",2843,679,377,128,763,24,1995,614,7423
"04013092713",3001,798,80,17,527,91,1988,581,7083
"04013092715",2225,902,242,342,679,243,1789,1146,7568
"04013092716",2423,988,209,15,717,48,2246,911,7557
"04013092717",2115,648,779,51,1100,301,2265,933,8192
"04013092718",2032,810,80,55,604,385,1404,1031,6401
"04013092719",2897,279,538,104,487,48,1469,48,5870
"04013092720",3119,227,379,0,844,427,1809,169,6974
"04013092721",1733,111,445,0,511,0,857,0,3657
"04013092723",3052,328,204,35,105,70,974,173,4941
"04013092724",2656,243,13,80,435,0,515,80,4022
"04013092801",1889,1490,0,63,676,963,2168,2093,9342
"04013092802",1847,1057,69,324,1051,657,1973,1579,8557
"04013092900",1181,775,35,5,420,659,1342,1265,5682
"04013093001",2443,563,579,166,552,675,1648,949,7575
"04013093002",1614,1360,132,161,706,112,1269,869,6223
"04013093101",1875,1277,174,181,648,407,1662,1406,7630
"04013093104",1467,1406,154,269,514,343,1436,1317,6906
"04013093105",1777,1647,207,251,1017,720,1981,1996,9596
"04013093106",1882,844,80,62,1019,330,2001,841,7059
"04013093200",1327,891,262,71,312,360,710,823,4756
"04013103205",2631,80,20,0,162,0,146,2,3041
"04013103206",2304,94,31,0,85,4,157,10,2685
"04013103207",2383,56,56,5,14,7,72,0,2593
"04013103208",3082,401,258,0,216,183,708,0,4848
"04013103209",4316,549,38,0,125,58,248,224,5558
"04013103210",4933,851,131,28,362,54,363,295,7017
"04013103211",3793,316,0,0,156,9,350,0,4624
"04013103212",3789,163,10,0,172,21,205,0,4360
"04013103214",3414,98,41,16,109,10,73,0,3761
"04013103215",2340,59,14,0,102,0,176,0,2691
"04013103216",4583,141,128,64,295,76,77,53,5417
"04013103217",5277,328,175,0,662,111,362,0,6915
"04013103219",2480,203,11,0,212,8,26,20,2960
"04013103220",2307,78,4,0,399,82,150,0,3020
"04013103302",4653,1113,240,139,471,127,1427,505,8675
"04013103303",2700,414,113,0,115,14,306,143,3805
"04013103304",1802,1635,281,211,458,775,1555,2234,8951
"04013103305",1609,739,90,0,701,284,1590,794,5807
"04013103306",1697,829,140,61,433,422,1062,789,5433
"04013103400",3532,446,11,128,475,53,835,108,5588
"04013103501",2667,483,20,44,321,86,760,264,4645
"04013103502",4779,795,41,12,256,126,415,391,6815
"04013103604",2469,569,69,64,505,165,544,357,4742
"04013103605",5500,54,14,0,298,21,463,0,6350
"04013103606",2937,602,94,275,222,109,366,161,4766
"04013103607",4044,404,42,0,225,4,462,286,5467
"04013103608",2756,302,101,11,521,0,794,7,4492
"04013103609",3077,888,209,43,727,152,722,376,6194
"04013103611",4808,231,62,12,389,0,259,0,5761
"04013103612",3381,480,194,171,464,60,395,293,5438
"04013103614",2688,101,30,0,458,14,453,29,3773
"04013103615",2027,1098,249,277,362,341,1220,982,6556
"04013103701",2488,795,55,38,437,126,569,121,4629
"04013103702",2326,275,98,6,334,0,471,46,3556
"04013103900",3503,1255,220,20,1021,279,1112,482,7892
"04013104000",4154,560,123,130,781,83,1115,123,7069
"04013104100",4608,766,13,9,596,169,706,60,6927
"04013104202",4365,791,100,0,179,65,713,209,6422
"04013104203",4205,503,72,0,754,98,1130,34,6796
"04013104204",2612,292,17,68,276,121,925,86,4397
"04013104205",3115,469,63,26,1224,368,1458,346,7069
"04013104206",2200,669,9,0,672,332,858,290,5030
"04013104207",3815,261,91,0,261,316,730,40,5514
"04013104212",4759,787,154,103,680,14,1005,235,7737
"04013104214",2065,190,9,0,73,10,277,39,2663
"04013104215",3328,349,234,52,180,124,400,192,4859
"04013104216",3320,556,120,7,370,99,615,141,5228
"04013104217",4053,450,206,35,337,80,762,17,5940
"04013104218",2723,297,44,77,335,83,518,25,4102
"04013104219",2495,494,26,0,260,4,627,75,3981
"04013104221",4238,504,371,41,596,234,1187,246,7417
"04013104222",4241,563,350,237,850,11,886,293,7431
"04013104223",1643,103,72,0,156,65,428,0,2467
"04013104224",4332,465,0,0,826,78,788,100,6589
"04013104225",3485,192,30,0,109,157,329,130,4432
"04013104226",3293,278,241,30,294,131,542,93,4902
"04013104227",1577,83,44,141,214,16,552,180,2807
"04013104301",2293,682,93,11,308,160,655,473,4675
"04013104302",2012,375,246,45,320,12,693,54,3757
"04013104401",2929,552,278,218,351,55,1046,248,5677
"04013104402",1224,351,112,34,1024,247,504,150,3646
"04013104501",1390,982,181,66,260,221,1022,877,4999
"04013104502",2334,2319,0,85,322,190,1889,1981,9120
"04013104600",2403,1254,71,26,234,208,932,1033,6161
"04013104701",1609,407,51,0,283,138,413,357,3258
"04013104702",2353,905,109,57,125,244,819,667,5279
"04013104801",2770,355,9,0,220,5,211,198,3768
"04013104802",4442,565,203,3,252,126,256,69,5916
"04013104900",3667,209,33,0,246,14,458,15,4642
"04013105002",2155,241,68,2,41,0,126,131,2764
"04013105003",4381,293,1,5,58,0,328,16,5082
"04013105004",2471,343,132,0,340,86,298,50,3720
"04013105101",4129,130,7,0,88,6,238,0,4598
"04013105102",3092,300,23,0,402,49,141,15,4022
"04013105103",2749,39,3,3,254,0,278,2,3328
"04013105200",3866,1029,506,666,595,570,1592,557,9381
"04013105300",4092,657,16,86,220,83,1123,262,6539
"04013105400",2807,235,132,38,446,6,436,29,4129
"04013105501",781,924,39,89,525,383,636,776,4153
"04013105502",503,305,251,61,302,137,339,126,2024
"04013105503",1036,419,384,413,463,170,535,199,3619
"04013105601",2233,477,31,105,660,308,1631,556,6001
"04013105602",3097,1344,724,124,1222,432,1484,938,9365
"04013105701",2711,315,54,35,353,0,957,218,4643
"04013105702",1879,454,102,2,1175,236,1063,520,5431
"04013105800",3788,655,17,14,1500,474,2612,651,9711
"04013105900",3242,1477,60,372,714,68,1183,765,7881
"04013106001",708,601,124,28,3,158,220,579,2421
"04013106002",1196,519,75,37,114,31,330,329,2631
"04013106003",1694,536,114,76,301,175,547,406,3849
"04013106100",4088,589,205,133,432,50,855,378,6730
"04013106200",3052,126,90,0,293,16,284,60,3921
"04013106300",3133,934,33,56,299,59,690,211,5415
"04013106400",2009,232,300,70,420,28,73,94,3226
"04013106501",2331,374,10,0,307,85,350,179,3636
"04013106502",2333,650,142,82,243,15,363,112,3940
"04013106600",2904,99,0,0,210,72,453,14,3752
"04013106701",1008,799,297,668,259,232,391,216,3870
"04013106702",823,155,95,30,8,287,194,24,1616
"04013106703",1743,109,38,0,268,4,408,4,2574
"04013106801",994,1076,253,242,305,496,806,1045,5217
"04013106802",2117,625,59,37,656,20,953,273,4740
"04013106900",3993,1627,338,147,1385,604,2549,1852,12495
"04013107000",3479,1114,80,185,1082,448,2467,1130,9985
"04013107101",2345,1358,94,214,416,233,1860,1017,7537
"04013107102",1909,2064,258,95,254,536,1561,2149,8826
"04013107201",908,1290,128,38,343,713,765,1682,5867
"04013107202",2591,809,61,15,1032,406,2246,1147,8307
"04013107300",2161,992,557,249,2079,432,2299,939,9708
"04013107400",3269,1550,332,248,811,1168,1518,1588,10484
"04013107500",2874,176,240,85,142,59,277,21,3874
"04013107601",1786,521,287,131,199,155,465,132,3676
"04013107602",2336,147,65,21,239,72,535,46,3461
"04013107700",2529,260,176,37,446,86,167,46,3747
"04013107800",2246,67,10,0,87,0,180,0,2590
"04013107900",3541,81,0,34,348,136,201,0,4341
"04013108000",2961,204,10,0,94,0,210,0,3479
"04013108100",1582,114,26,0,67,64,116,39,2008
"04013108200",2873,258,20,0,155,61,546,85,3998
"04013108301",3176,374,0,0,101,21,446,106,4224
"04013108302",2572,206,59,22,130,0,555,0,3544
"04013108400",2949,701,123,117,410,255,675,338,5568
"04013108501",1914,280,102,0,374,57,1040,231,3998
"04013108502",2486,279,133,17,504,82,517,78,4096
"04013108601",829,1314,69,58,452,141,524,1202,4589
"04013108602",1904,600,216,59,806,386,1239,734,5944
"04013108802",931,261,22,60,361,66,276,108,2085
"04013108901",1312,758,154,181,452,106,442,673,4078
"04013108902",2345,988,200,344,528,606,1007,837,6855
"04013109001",1107,1495,194,361,750,871,909,1765,7452
"04013109002",1511,1220,378,259,868,399,1319,1240,7194
"04013109003",2047,2143,39,220,962,950,2552,2724,11637
"04013109101",1147,1152,36,130,901,526,1500,1497,6889
"04013109102",2578,2040,59,299,895,203,3157,2058,11289
"04013109200",1230,1578,50,231,405,401,993,1537,6425
"04013109300",2519,1688,112,94,226,46,2334,1501,8520
"04013109400",2726,2916,87,316,1098,545,2757,2882,13327
"04013109500",2782,1001,156,133,889,178,2594,1092,8825
"04013109601",2530,1264,374,237,860,275,2633,1204,9377
"04013109602",3052,1765,90,234,609,536,2820,1899,11005
"04013109603",2871,950,240,0,402,476,2607,1208,8754
"04013109604",1768,632,95,346,472,213,1741,818,6085
"04013109701",2828,2335,176,151,1276,681,3588,2812,13847
"04013109702",2054,970,163,186,564,567,1946,1338,7788
"04013109703",1330,795,58,29,541,150,1395,813,5111
"04013109704",1275,577,90,20,307,582,1345,1058,5254
"04013109705",1310,306,42,0,182,51,1281,341,3513
"04013109801",1612,1368,50,105,529,179,1718,1495,7056
"04013109802",2187,1499,47,43,1028,428,2686,1651,9569
"04013109900",3822,1924,230,94,643,569,3928,2273,13483
"04013110001",2620,1185,84,53,408,135,2422,1158,8065
"04013110002",1131,1248,75,270,795,660,1536,1716,7431
"04013110100",3087,3002,70,0,720,155,3380,2943,13357
"04013110400",2915,556,85,85,1135,208,1412,211,6607
"04013110501",1939,476,103,54,434,36,241,268,3551
"04013110502",1132,333,145,117,672,102,502,45,3048
"04013110600",2421,698,554,5,352,215,788,425,5458
"04013110701",1259,580,190,70,296,314,769,640,4118
"04013110702",1933,799,48,161,281,104,979,505,4810
"04013110801",2329,974,449,64,644,466,886,670,6482
"04013110802",1690,219,0,11,219,38,740,85,3002
"04013110901",1882,633,41,95,188,248,934,372,4393
"04013110902",2203,1270,132,120,431,870,859,1401,7286
"04013111000",3193,280,358,18,593,130,1216,184,5972
"04013111100",3383,363,33,102,245,54,327,170,4677
"04013111201",2547,1390,520,135,801,626,1362,1490,8871
"04013111202",770,493,52,68,130,119,362,488,2482
"04013111203",433,244,292,193,155,69,135,11,1532
"04013111204",1116,322,283,25,243,46,352,238,2625
"04013111300",3471,723,256,214,598,356,1321,735,7674
"04013111401",2731,891,83,0,621,118,2547,704,7695
"04013111402",2160,923,325,60,359,305,1558,1013,6703
"04013111501",803,702,29,0,223,420,830,1089,4096
"04013111502",2274,1329,58,59,1199,313,2586,1220,9038
"04013111601",1240,1101,145,36,467,93,1193,1002,5277
"04013111602",1295,1691,35,327,624,677,1583,2094,8326
"04013111700",3527,1368,253,81,189,16,1411,899,7744
"04013111800",2731,298,98,89,337,12,310,35,3910
"04013111900",1737,161,0,3,155,66,182,55,2359
"04013112100",1545,1736,6,19,461,228,1790,1938,7723
"04013112201",2240,1341,29,71,334,238,2396,1584,8233
"04013112202",2322,1344,225,10,293,430,2065,1670,8359
"04013112301",2064,1248,93,213,1462,215,3325,1349,9969
"04013112302",1960,2542,546,164,1323,635,2451,3006,12627
"04013112401",2844,1462,212,94,1402,570,3911,2024,12519
"04013112402",2820,1226,33,21,700,236,3293,1367,9696
"04013112502",2420,2038,114,0,681,613,2793,2511,11170
"04013112503",4082,2193,114,81,1276,577,4404,2552,15279
"04013112504",1498,1085,149,34,266,216,1484,1085,5817
"04013112505",3504,2243,115,33,1074,656,3867,2759,14251
"04013112507",679,1474,75,53,155,97,795,1481,4809
"04013112508",1274,416,0,17,208,69,990,433,3407
"04013112509",3030,1436,555,250,911,902,2958,2095,12137
"04013112510",3275,401,125,68,399,0,2710,373,7351
"04013112511",4344,860,352,49,723,107,3689,806,10930
"04013112512",767,425,67,6,135,17,489,402,2308
"04013112513",5150,479,790,185,803,381,4903,504,13195
"04013112514",1649,470,697,129,481,248,996,637,5307
"04013112601",1123,1257,38,118,289,161,1020,1203,5209
"04013112602",2241,4133,0,131,412,743,2217,4585,14462
"04013112700",2360,2780,124,145,294,396,2479,3111,11689
"04013112900",2424,1798,126,355,308,59,1550,1174,7794
"04013113000",1363,489,103,9,81,0,338,261,2644
"04013113100",874,521,356,76,181,70,248,112,2438
"04013113201",763,1341,10,35,147,331,690,1448,4765
"04013113202",439,846,227,0,123,422,410,1135,3602
"04013113203",754,957,18,55,102,217,518,1058,3679
"04013113300",1702,2370,43,131,200,722,1437,2567,9172
"04013113400",0,15,0,0,0,0,0,15,30
"04013113501",1931,865,260,148,490,173,1972,945,6784
"04013113502",774,303,51,190,398,505,985,774,3980
"04013113601",1505,841,315,52,475,59,1192,752,5191
"04013113602",784,800,360,183,674,444,1172,1146,5563
"04013113700",2565,1175,601,1597,795,582,1718,1219,10252
"04013113801",730,397,48,0,139,281,229,418,2242
"04013113802",0,0,0,0,0,0,0,0,0
"04013113900",164,329,68,224,140,190,229,459,1803
"04013114000",531,224,217,179,229,367,352,363,2462
"04013114100",325,140,34,13,33,5,64,44,658
"04013114200",488,652,15,173,46,91,383,537,2385
"04013114301",201,562,96,88,94,77,193,180,1491
"04013114302",498,980,442,406,73,156,537,1040,4132
"04013114401",556,482,276,31,134,88,658,497,2722
"04013114402",635,827,33,137,80,246,657,979,3594
"04013114500",1555,1692,136,26,371,95,1776,1638,7289
"04013114600",1044,917,2,3,202,81,1202,940,4391
"04013114703",558,743,0,0,46,75,520,741,2683
"04013114800",1545,1065,271,119,54,230,1432,1097,5813
"04013114900",482,1678,55,130,244,106,620,1606,4921
"04013115200",659,521,367,300,191,90,426,466,3020
"04013115300",1141,454,265,246,226,407,1086,814,4639
"04013115400",787,1008,10,9,441,126,1067,996,4444
"04013115500",1804,1352,48,0,554,128,1956,1402,7244
"04013115600",1328,768,882,708,487,127,1370,814,6484
"04013115700",3150,1596,407,309,994,320,3570,1726,12072
"04013115801",1658,1514,110,163,234,524,1503,1752,7458
"04013115802",1287,995,251,240,384,180,1566,1076,5979
"04013115900",1382,977,684,181,796,518,1714,1412,7664
"04013116000",1661,538,932,750,628,276,1560,563,6908
"04013116100",1448,1516,464,185,158,272,1503,1496,7042
"04013116202",2370,1137,416,314,885,289,2647,1288,9346
"04013116203",1770,463,757,105,636,291,933,493,5448
"04013116204",1635,233,148,273,1059,168,1660,210,5386
"04013116205",1526,1153,407,104,774,527,707,1253,6451
"04013116300",2180,1329,1305,105,1302,812,2442,1948,11423
"04013116400",2252,766,860,298,953,626,2935,1332,10022
"04013116500",2669,795,278,103,1002,141,3251,820,9059
"04013116602",3972,1021,1355,247,1110,365,4076,1278,13424
"04013116603",3714,175,790,49,1097,361,2390,297,8873
"04013116604",1885,89,610,514,424,187,1360,170,5239
"04013116605",2993,333,730,154,1222,36,2480,144,8092
"04013116606",2456,992,1221,278,1128,388,2576,1206,10245
"04013116607",1646,402,962,21,167,56,1523,429,5206
"04013116608",2216,257,113,87,708,77,1162,218,4838
"04013116609",1997,124,666,0,645,12,878,0,4322
"04013116610",2918,111,992,221,869,184,2137,283,7715
"04013116611",2696,18,245,27,316,40,1174,12,4528
"04013116612",2959,523,724,31,752,48,2126,276,7439
"04013116613",2644,1434,750,304,1065,0,1796,1383,9376
"04013116702",2751,1295,616,200,1586,769,3149,1760,12126
"04013116703",1971,373,428,56,767,265,1763,610,6233
"04013116704",3807,124,964,40,1290,87,1644,117,8073
"04013116707",2319,73,16,0,244,0,333,0,2985
"04013116708",4614,240,318,165,305,28,724,51,6445
"04013116709",1355,97,77,6,270,24,227,2,2058
"04013116710",3785,123,236,11,507,16,477,21,5176
"04013116711",1197,57,359,7,285,44,184,7,2140
"04013116712",4644,498,631,34,854,105,1110,92,7968
"04013116713",5214,80,361,27,555,190,1065,27,7519
"04013116714",2663,227,137,12,520,0,301,33,3893
"04013116715",1768,96,12,0,258,2,314,0,2450
"04013116717",2166,288,528,115,848,207,856,136,5144
"04013116718",1832,114,358,3,206,98,372,38,3021
"04013116719",5342,178,225,40,758,25,937,12,7517
"04013116720",2335,136,294,26,806,23,590,68,4278
"04013116721",2914,164,35,0,416,50,401,13,3993
"04013116725",4342,214,172,0,433,12,347,12,5532
"04013116727",3300,109,40,7,491,11,378,0,4336
"04013116728",3841,151,125,0,557,32,218,0,4924
"04013116729",3654,82,135,0,512,28,364,44,4819
"04013116730",1039,38,228,0,824,0,101,0,2230
"04013116731",2793,130,63,0,453,0,383,18,3840
"04013116732",1945,752,137,0,530,181,1164,884,5593
"04013116733",331,0,0,0,10,0,23,0,364
"04013116800",1974,669,105,0,114,141,1148,594,4745
"04013116900",827,783,19,46,201,238,825,942,3881
"04013117000",2770,958,465,176,838,1447,2067,1423,10144
"04013117100",1578,203,347,17,499,82,597,74,3397
"04013117200",560,166,0,0,387,149,752,280,2294
"04013117300",381,709,12,12,64,224,358,926,2686
"04013216806",2584,182,0,11,116,39,91,0,3023
"04013216807",4810,202,9,0,269,0,406,0,5696
"04013216809",4324,180,131,0,441,101,87,0,5264
"04013216810",772,90,16,127,165,26,52,0,1248
"04013216813",3957,196,61,0,140,0,19,0,4373
"04013216816",4876,305,0,0,396,13,345,53,5988
"04013216818",5701,216,212,65,284,58,162,1,6699
"04013216819",6136,127,0,4,167,0,207,0,6641
"04013216820",3753,429,0,0,163,49,236,122,4752
"04013216821",4671,247,57,61,297,53,139,24,5549
"04013216822",3421,151,99,0,232,0,211,27,4141
"04013216826",3888,393,55,0,135,32,173,16,4692
"04013216829",4077,154,91,25,278,0,39,0,4664
"04013216830",2588,319,106,0,109,11,182,11,3326
"04013216831",2378,130,25,0,71,60,176,117,2957
"04013216832",1681,119,26,0,0,0,46,0,1872
"04013216833",3185,716,0,0,345,40,179,44,4509
"04013216834",2014,180,21,0,0,0,45,0,2260
"04013216835",1833,27,84,22,178,15,123,33,2315
"04013216836",2872,232,23,0,78,0,92,0,3297
"04013216837",4357,202,85,0,746,91,392,106,5979
"04013216838",3648,200,192,0,586,0,273,3,4902
"04013216839",3262,129,8,0,370,0,191,3,3963
"04013216840",4538,168,19,0,150,5,86,15,4981
"04013216841",2993,78,64,0,287,25,179,25,3651
"04013216842",3182,217,0,0,409,22,231,0,4061
"04013216843",2971,103,0,0,152,0,115,0,3341
"04013216844",2828,220,0,0,404,4,153,17,3626
"04013216845",1415,47,249,42,100,0,119,0,1972
"04013216846",6014,158,146,0,593,21,335,0,7267
"04013216847",4975,524,34,0,498,15,467,0,6513
"04013216848",5399,172,0,1,336,0,295,0,6203
"04013216849",5368,271,0,0,637,0,124,12,6412
"04013216850",3358,36,140,0,483,63,703,0,4783
"04013216851",3021,244,60,0,101,197,162,46,3831
"04013216852",2882,87,12,27,174,23,322,0,3527
"04013216853",3562,460,91,0,522,83,170,0,4888
"04013216901",2515,72,0,0,46,8,69,8,2718
"04013216902",3251,227,55,0,121,8,173,12,3847
"04013217001",3855,451,14,0,202,0,475,0,4997
"04013217002",4655,380,144,5,247,72,625,16,6144
"04013217101",2232,184,0,0,134,0,263,0,2813
"04013217102",2219,112,42,2,27,138,290,2,2832
"04013217201",714,300,116,23,128,7,67,100,1455
"04013217203",2662,216,170,0,139,47,317,142,3693
"04013217204",1874,543,135,29,246,120,297,148,3392
"04013217300",2552,132,84,21,127,12,183,0,3111
"04013217400",2643,316,25,13,204,0,410,12,3623
"04013217501",2039,935,109,30,41,150,535,901,4740
"04013217502",2228,435,93,155,195,35,716,91,3948
"04013217600",3266,409,115,1,500,36,958,196,5481
"04013217700",3946,243,126,27,161,41,514,14,5072
"04013217800",4561,1121,445,0,815,171,612,787,8512
"04013217900",2998,433,20,142,186,42,347,103,4271
"04013218000",4320,725,30,0,223,213,1277,213,7001
"04013218100",1451,283,113,0,162,0,416,131,2556
"04013218200",3371,573,61,0,876,596,1811,547,7835
"04013218300",2696,595,6,7,319,20,167,94,3904
"04013318400",1821,1331,169,43,373,161,722,604,5224
"04013318501",2386,355,16,0,388,62,638,62,3907
"04013318700",364,186,6,17,11,55,0,40,679
"04013318800",2914,1524,266,161,616,566,980,940,7967
"04013318900",3786,1387,165,110,545,415,1110,431,7949
"04013319000",1241,523,34,17,187,75,94,33,2204
"04013319101",581,667,8,84,257,671,252,350,2870
"04013319103",852,1750,80,145,661,1039,208,654,5389
"04013319104",2487,1511,26,145,588,772,1164,659,7352
"04013319201",2003,1444,158,102,831,277,1128,632,6575
"04013319202",1223,770,229,312,256,501,228,492,4011
"04013319300",1015,532,48,140,291,361,457,261,3105
"04013319401",4170,480,215,129,615,262,832,104,6807
"04013319402",3155,292,175,6,211,120,521,126,4606
"04013319403",2915,739,151,20,654,283,482,296,5540
"04013319404",2479,256,107,18,391,76,678,139,4144
"04013319500",3725,797,177,26,1037,32,1143,36,6973
"04013319600",3933,943,131,3,679,150,801,446,7086
"04013319703",2364,423,70,120,916,411,690,198,5192
"04013319704",1007,225,104,0,330,35,422,56,2179
"04013319705",2507,240,73,137,319,90,722,138,4226
"04013319706",2878,1373,240,51,855,253,1638,1335,8623
"04013319800",3984,1135,130,55,721,380,916,488,7809
"04013319902",2008,223,26,9,169,10,540,58,3043
"04013319903",4410,434,333,13,511,55,407,76,6239
"04013319904",3678,310,199,0,350,99,634,216,5486
"04013319905",3851,398,69,0,790,255,1087,136,6586
"04013319906",2335,135,72,29,672,42,413,6,3704
"04013319907",2030,32,58,0,218,0,221,0,2559
"04013319908",1358,162,99,243,319,14,559,66,2820
"04013319909",1918,9,47,1,269,37,220,12,2513
"04013319910",3201,144,9,13,920,132,479,81,4979
"04013320001",2692,512,997,208,1641,340,909,322,7621
"04013320002",848,724,36,1,3102,1081,2409,1163,9364
"04013320007",3815,750,416,0,2263,554,2097,635,10530
"04013320100",1510,345,12,46,440,116,157,87,2713
"04013420104",4456,220,28,0,130,0,648,0,5482
"04013420105",4459,197,0,7,427,19,411,41,5561
"04013420107",5835,77,122,0,468,0,437,0,6939
"04013420108",1161,128,0,0,18,0,21,0,1328
"04013420109",3146,136,8,0,137,23,329,16,3795
"04013420110",4980,419,39,0,91,30,982,188,6729
"04013420111",3606,412,10,0,377,50,1033,100,5588
"04013420112",2799,168,0,169,91,12,394,74,3707
"04013420113",1914,954,50,22,380,135,353,485,4293
"04013420114",2108,952,57,28,518,75,529,339,4606
"04013420115",1701,602,48,0,117,0,525,87,3080
"04013420116",1899,441,23,12,202,35,246,211,3069
"04013420202",3979,576,135,62,523,121,523,238,6157
"04013420206",3157,385,0,0,39,0,81,11,3673
"04013420207",2231,175,0,0,252,67,115,0,2840
"04013420208",4267,531,62,34,410,132,1074,280,6790
"04013420209",3733,154,88,0,141,9,375,28,4528
"04013420210",4116,358,47,0,439,212,449,160,5781
"04013420211",3607,290,6,0,434,11,506,0,4854
"04013420212",2558,130,10,2,77,3,166,8,2954
"04013420213",2420,220,0,0,22,0,16,0,2678
"04013420214",2762,414,42,0,136,406,186,425,4371
"04013420215",1361,88,28,0,160,0,530,22,2189
"04013420216",3083,459,232,248,82,91,598,84,4877
"04013420301",1845,35,0,7,200,5,123,6,2221
"04013420302",3995,573,27,0,255,89,304,43,5286
"04013420303",3162,254,9,31,237,47,413,237,4390
"04013420304",843,4,4,0,161,43,10,0,1065
"04013420401",2828,1056,5,59,185,392,960,824,6309
"04013420402",1446,225,0,0,62,5,188,53,1979
"04013420501",4610,565,178,86,629,381,1964,212,8625
"04013420503",2112,219,352,92,248,55,331,10,3419
"04013420504",2169,367,82,18,256,10,401,84,3387
"04013420602",3910,398,226,168,260,7,628,279,5876
"04013420603",2811,227,93,0,292,0,290,39,3752
"04013420604",3420,173,20,0,297,18,581,18,4527
"04013420704",4189,500,190,12,287,267,838,313,6596
"04013420705",3157,107,66,3,413,36,195,46,4023
"04013420706",3262,327,51,13,414,135,485,149,4836
"04013420707",2298,256,92,0,241,0,344,7,3238
"04013420708",3198,396,116,0,609,71,580,42,5012
"04013420709",2750,389,30,0,202,62,121,133,3687
"04013420710",2322,302,149,13,97,109,352,83,3427
"04013420800",3194,410,59,4,272,40,726,337,5042
"04013420901",2478,660,96,0,99,259,898,460,4950
"04013420902",2279,539,24,53,330,86,675,279,4265
"04013421001",2091,1007,59,16,105,81,536,769,4664
"04013421002",1494,288,29,10,244,66,482,135,2748
"04013421101",2012,931,250,57,703,258,856,610,5677
"04013421102",3769,784,304,0,577,240,1304,474,7452
"04013421201",2652,1137,79,177,509,335,549,539,5977
"04013421202",2859,735,64,30,543,92,1428,367,6118
"04013421302",3397,1228,54,62,953,452,2081,1509,9736
"04013421303",2770,616,206,258,929,359,1792,490,7420
"04013421304",1234,518,195,89,199,278,398,130,3041
"04013421400",1444,416,82,184,295,136,725,156,3438
"04013421501",1971,522,0,19,640,150,1556,482,5340
"04013421502",2096,709,62,16,72,137,998,641,4731
"04013421601",2232,758,9,2,230,18,1063,474,4786
"04013421602",2023,976,27,26,386,326,1235,1135,6134
"04013421701",2892,963,211,10,494,129,1175,446,6320
"04013421702",2662,760,81,0,279,18,1424,569,5793
"04013421801",1562,247,0,40,489,374,905,456,4073
"04013421802",2331,970,0,32,640,387,1521,1093,6974
"04013421901",2399,408,55,15,441,217,1801,373,5709
"04013421902",2380,1397,87,66,1071,432,2316,1571,9320
"04013422001",1770,2178,0,0,83,350,918,2284,7583
"04013422002",2327,1051,38,45,156,115,1678,924,6334
"04013422102",3296,534,52,72,638,93,2169,238,7092
"04013422103",1415,797,166,149,1020,576,365,626,5114
"04013422104",2715,1003,97,531,514,696,1175,955,7686
"04013422105",2195,626,51,0,275,189,948,415,4699
"04013422106",2303,1412,421,331,337,416,1227,1073,7520
"04013422107",1754,698,223,180,490,301,776,288,4710
"04013422203",2850,1178,195,20,638,176,822,597,6476
"04013422204",2077,398,150,92,443,148,476,151,3935
"04013422205",1230,29,0,0,30,0,283,13,1585
"04013422209",5061,668,336,0,477,135,1522,185,8384
"04013422210",4333,332,515,0,456,146,1104,9,6895
"04013422211",2161,176,0,0,182,10,174,73,2776
"04013422212",3120,297,111,0,466,48,500,155,4697
"04013422213",2036,154,93,3,232,39,451,31,3039
"04013422215",1441,281,62,35,242,76,492,234,2863
"04013422216",4468,447,65,0,534,99,1032,177,6822
"04013422217",2846,203,92,20,305,5,459,18,3948
"04013422218",2101,264,124,25,305,76,885,70,3850
"04013422219",2134,250,237,12,270,62,359,119,3443
"04013422220",1805,21,20,0,93,0,277,0,2216
"04013422221",2444,291,101,0,599,32,558,68,4093
"04013422222",1121,418,212,0,332,0,390,84,2557
"04013422301",2951,1577,135,0,855,105,2331,1475,9429
"04013422302",3646,482,87,0,957,242,1921,305,7640
"04013422304",2132,118,58,193,368,16,709,186,3780
"04013422305",4655,210,112,0,784,112,443,56,6372
"04013422307",3369,346,286,0,502,103,1045,16,5667
"04013422308",4170,469,169,21,829,36,1105,239,7038
"04013422309",4075,280,201,42,1179,33,898,0,6708
"04013422401",1834,285,263,46,519,67,898,155,4067
"04013422402",3606,725,77,0,408,111,896,471,6294
"04013422403",4129,613,60,117,610,13,927,183,6652
"04013422404",4106,89,67,0,368,0,430,0,5060
"04013422501",4674,365,98,0,649,3,1434,263,7486
"04013422502",3829,1058,116,24,969,30,1173,849,8048
"04013422503",4309,722,181,0,583,251,1291,583,7920
"04013422504",3717,431,100,10,579,174,834,265,6110
"04013422506",4627,397,259,27,452,62,807,13,6644
"04013422507",3618,362,65,0,238,0,308,85,4676
"04013422508",2887,529,31,0,327,125,220,61,4180
"04013422509",4042,262,196,1,499,0,649,121,5770
"04013422510",2794,32,93,16,521,92,445,14,4007
"04013422511",2406,78,229,12,244,0,417,23,3409
"04013422512",4861,128,42,0,425,0,883,0,6339
"04013422513",3679,226,226,31,204,45,469,24,4904
"04013422514",3052,353,113,115,370,12,737,48,4800
"04013422606",8335,218,0,1,1160,0,296,4,10014
"04013422607",3428,194,75,0,183,0,404,41,4325
"04013422609",2356,379,0,2,606,55,716,56,4170
"04013422610",2356,232,53,0,8,0,0,0,2649
"04013422615",5004,436,207,0,1348,41,1204,92,8332
"04013422616",3935,708,166,1,553,0,727,0,6090
"04013422617",5037,204,363,19,264,148,384,36,6455
"04013422618",2855,112,8,0,31,0,88,0,3094
"04013422620",3115,32,8,6,344,9,490,0,4004
"04013422621",3440,377,75,0,775,0,541,0,5208
"04013422622",3938,77,71,41,439,60,485,0,5111
"04013422623",3159,793,117,29,873,136,445,16,5568
"04013422624",2618,408,12,12,77,63,85,63,3338
"04013422625",2223,604,64,3,363,58,88,110,3513
"04013422626",2286,311,0,5,279,8,342,22,3253
"04013422627",2373,884,0,0,138,58,499,25,3977
"04013422628",2112,1253,99,19,245,15,616,369,4728
"04013422629",2173,282,33,1,289,0,618,0,3396
"04013422630",3347,819,0,0,276,293,330,507,5572
"04013422631",3010,129,387,0,572,46,680,35,4859
"04013422632",3322,446,258,0,226,1,934,1,5188
"04013422633",2052,499,43,29,315,30,636,115,3719
"04013422634",3296,615,44,0,578,0,1610,233,6376
"04013422635",1712,93,0,0,111,0,317,0,2233
"04013422636",1558,65,167,0,154,303,142,193,2582
"04013422637",2795,88,34,0,325,0,317,12,3571
"04013422638",2232,580,59,79,700,94,1052,0,4796
"04013422639",3413,364,0,0,107,0,0,0,3884
"04013422640",3917,283,275,0,473,75,517,105,5645
"04013422641",4319,363,211,17,1012,84,1140,182,7328
"04013422642",3893,511,92,44,1109,0,959,1,6609
"04013422643",4688,154,131,4,991,0,1180,0,7148
"04013422644",6338,469,139,10,442,0,898,138,8434
"04013422646",5939,128,562,75,1143,253,877,253,9230
"04013522800",807,449,8,12,73,43,91,110,1593
"04013522901",3460,277,174,0,284,89,1169,114,5567
"04013522903",2956,936,306,213,209,407,2377,1283,8687
"04013522904",2367,1824,565,8,736,150,2041,1879,9570
"04013523002",4250,1425,32,21,377,248,2589,1367,10309
"04013523003",4400,651,314,1,924,132,1766,469,8657
"04013523005",3761,339,104,98,768,72,940,57,6139
"04013523006",3970,459,342,88,858,198,1194,261,7370
"04013523102",3136,919,112,153,643,338,1797,992,8090
"04013523103",3942,107,476,323,984,172,1241,88,7333
"04013523104",2883,786,362,210,651,320,1644,881,7737
"04013610000",5525,178,60,0,653,0,466,0,6882
"04013610100",904,21,8,0,205,0,211,0,1349
"04013610200",6680,444,423,0,304,13,1402,57,9323
"04013610300",7938,338,31,0,1079,0,1182,119,10687
"04013610400",5585,136,93,0,227,38,967,24,7070
"04013610500",6022,140,0,0,261,0,278,0,6701
"04013610600",4588,188,123,0,354,14,158,16,5441
"04013610700",6214,917,16,0,48,31,600,95,7921
"04013610800",2927,18,38,0,675,33,384,0,4075
"04013610900",5434,76,57,76,333,1,408,1,6386
"04013611000",2170,25,11,81,281,4,363,29,2964
"04013611100",3078,62,14,0,215,0,178,0,3547
"04013611200",4806,77,52,16,586,0,606,10,6153
"04013611300",4065,125,21,0,375,42,747,21,5396
"04013611400",5381,180,177,0,242,298,550,0,6828
"04013611500",5091,134,44,0,709,0,184,2,6164
"04013611600",2699,110,0,0,343,0,309,0,3461
"04013611700",4736,319,377,50,261,59,419,23,6244
"04013611800",6374,437,60,0,482,14,472,0,7839
"04013611900",1976,307,14,0,320,9,225,0,2851
"04013612000",2532,31,16,0,192,0,110,0,2881
"04013612200",3146,331,48,0,259,0,431,27,4242
"04013612300",6250,301,99,17,1501,9,1136,65,9378
"04013612400",5839,373,26,0,708,32,502,44,7524
"04013612500",3885,296,38,0,255,63,298,166,5001
"04013612600",1951,75,11,0,59,11,112,0,2219
"04013612700",2209,77,11,0,78,18,113,0,2506
"04013612800",1973,22,0,0,187,0,139,0,2321
"04013612900",2154,51,13,0,87,1,24,1,2331
"04013613000",2869,251,9,0,95,2,283,0,3509
"04013613100",2423,94,29,0,180,0,45,0,2771
"04013613200",3375,56,0,0,164,55,293,0,3943
"04013613300",6841,217,71,0,163,0,449,0,7741
"04013613400",3583,188,0,0,87,0,215,0,4073
"04013613500",3573,456,281,0,419,0,431,0,5160
"04013613600",3805,152,21,0,305,35,668,2,4988
"04013613700",4583,293,72,0,366,0,591,96,6001
"04013613800",3695,40,58,2,123,0,168,0,4086
"04013613900",4981,437,18,0,526,0,542,0,6504
"04013614000",3816,243,64,0,213,0,470,0,4806
"04013614100",4315,141,404,11,737,0,361,26,5995
"04013614200",4135,158,95,0,307,66,390,0,5151
"04013614300",2225,41,75,2,454,30,173,0,3000
"04013614400",2992,274,64,0,252,0,437,0,4019
"04013614500",3487,365,217,7,325,110,703,50,5264
"04013614600",4676,381,208,127,966,0,623,87,7068
"04013614700",1589,528,62,80,46,0,213,37,2555
"04013614800",2964,530,39,9,522,121,789,50,5024
"04013614900",2657,251,11,7,652,38,255,0,3871
"04013615000",5695,364,86,0,1025,0,468,104,7742
"04013615100",3024,364,15,0,190,0,121,13,3727
"04013615200",4964,265,123,0,470,15,382,0,6219
"04013615300",2119,199,9,0,18,1,32,1,2379
"04013615400",2332,158,0,0,54,23,0,9,2576
"04013615500",2663,73,20,0,31,0,39,13,2839
"04013615600",3229,273,72,0,95,0,417,1,4087
"04013615700",2490,23,90,0,183,16,336,16,3154
"04013615800",3997,273,82,0,515,3,458,1,5329
"04013615900",3137,564,110,0,286,58,369,54,4578
"04013616000",1309,119,39,15,131,12,175,12,1812
"04013616100",2911,144,107,0,594,23,620,23,4422
"04013616200",2834,112,77,1,373,8,685,3,4093
"04013616300",1420,144,0,0,485,0,337,2,2388
"04013616400",3094,310,202,92,1463,208,294,8,5671
"04013616500",2614,163,288,59,334,19,929,91,4497
"04013616600",4784,293,103,0,628,342,1032,326,7508
"04013616700",3296,261,194,0,488,0,610,0,4849
"04013616800",4884,322,119,0,338,63,550,127,6403
"04013616900",3558,517,46,56,205,154,479,0,5015
"04013617000",4759,473,95,0,591,115,574,165,6772
"04013617100",1753,188,21,0,198,0,71,0,2231
"04013617200",2374,41,55,0,202,0,50,24,2746
"04013617300",2727,92,88,1,393,1,374,1,3677
"04013617400",5999,506,152,49,117,0,394,16,7233
"04013617500",2845,416,63,0,65,0,298,0,3687
"04013617600",4149,360,185,13,961,18,859,18,6563
"04013617700",2139,455,245,0,534,92,294,73,3832
"04013617800",2412,120,28,0,80,6,286,16,2948
"04013617900",2384,234,35,0,370,59,521,106,3709
"04013618000",3897,487,0,24,556,53,525,163,5705
"04013618100",3616,229,47,0,404,10,425,67,4798
"04013618200",2944,276,98,34,259,182,483,52,4328
"04013618300",2569,79,198,0,139,78,224,5,3292
"04013618400",2830,484,79,0,190,34,498,239,4354
"04013618500",3213,390,49,32,171,51,676,171,4753
"04013618600",2629,1237,107,0,567,76,630,545,5791
"04013618700",2377,327,9,0,133,0,515,165,3526
"04013618800",3077,1070,132,31,250,108,791,630,6089
"04013618900",4505,696,153,76,468,40,503,105,6546
"04013619000",2482,220,54,35,152,0,186,35,3164
"04013619100",1703,524,180,26,94,116,539,186,3368
"04013619200",3430,1292,431,29,460,216,1673,566,8097
"04013619300",2984,704,0,19,409,12,705,217,5050
"04013619400",2597,620,95,128,627,34,734,403,5238
"04013619500",4710,856,99,0,324,54,1026,471,7540
"04013619600",1647,84,52,0,293,11,460,0,2547
"04013619700",3280,207,144,16,289,0,832,84,4852
"04013619800",3389,237,152,2,741,56,309,17,4903
"04013619900",4671,167,72,0,525,39,106,23,5603
"04013723303",24,0,0,0,0,0,0,0,24
"04013723304",2874,682,13,83,242,31,1444,395,5764
"04013723305",1645,476,18,0,151,332,1334,522,4478
"04013723306",67,39,0,0,0,0,3,39,148
"04013723307",1787,78,74,0,231,0,221,0,2391
"04013723308",6013,114,364,0,602,127,1088,140,8448
"04013810000",1443,7,2,0,385,67,212,47,2163
"04013810100",5420,158,181,7,796,27,553,44,7186
"04013810200",2138,166,117,0,706,7,318,63,3515
"04013810300",4051,301,285,83,1051,98,1115,151,7135
"04013810400",3158,170,412,28,928,101,682,84,5563
"04013810500",3995,58,377,0,777,39,820,0,6066
"04013810600",5190,81,253,1,1086,0,950,1,7562
"04013810700",4187,179,525,0,1400,307,858,193,7649
"04013810800",3359,235,39,46,991,8,491,81,5250
"04013810900",3957,321,332,0,685,136,884,0,6315
"04013811000",2252,87,11,1,381,0,472,0,3204
"04013811100",1846,64,7,71,208,65,379,0,2640
"04013811200",1462,108,209,131,888,112,775,34,3719
"04013811300",2240,169,202,33,418,15,626,70,3773
"04013811400",4279,125,148,0,645,8,1069,53,6327
"04013811500",1711,81,228,7,373,78,315,21,2814
"04013811600",2693,498,146,3,716,12,576,425,5069
"04013811700",3814,280,151,39,561,14,1376,187,6422
"04013811800",1493,1,172,0,290,0,119,1,2076
"04013811900",4358,104,221,0,1213,25,1425,68,7414
"04013812000",2078,504,67,0,592,283,610,403,4537
"04013812100",4297,224,237,1,461,65,809,1,6095
"04013812200",5619,143,136,2,1419,50,1280,99,8748
"04013812300",2958,151,315,14,780,0,246,77,4541
"04013812400",2663,447,27,0,459,0,362,0,3958
"04013812500",1481,8,0,222,848,0,284,0,2843
"04013812600",3455,117,323,0,207,33,408,31,4574
"04013812700",4903,26,219,27,882,0,653,27,6737
"04013812800",2989,242,71,0,1023,18,451,0,4794
"04013812900",2056,53,69,11,612,8,317,0,3126
"04013813000",3055,56,103,0,598,74,318,12,4216
"04013813100",1594,0,57,0,835,0,287,0,2773
"04013813200",2881,41,120,8,929,28,383,3,4393
"04013813300",3861,31,14,0,1396,0,598,19,5919
"04013813400",2575,89,171,0,724,2,471,39,4071
"04013813500",3325,13,57,0,254,0,233,0,3882
"04013813600",2326,97,126,0,640,60,179,10,3438
"04013813700",2101,69,14,0,62,0,107,0,2353
"04013813800",2584,237,0,0,32,0,70,0,2923
"04013813900",4120,234,501,0,972,30,1219,0,7076
"04013814000",2104,180,9,0,34,0,123,0,2450
"04013814100",4080,321,149,0,1175,20,1332,32,7109
"04013814200",1872,45,183,36,442,15,135,23,2751
"04013814300",3538,117,260,0,350,63,628,0,4956
"04013814400",4108,118,59,10,586,47,535,27,5490
"04013814500",4172,138,137,0,882,100,1047,120,6596
"04013814600",3609,210,99,44,662,105,796,77,5602
"04013814700",3465,133,407,0,305,0,632,81,5023
"04013814800",5055,293,11,0,372,0,1239,95,7065
"04013814900",2417,35,69,0,392,38,563,25,3539
"04013815000",3690,46,222,18,353,0,381,0,4710
"04013815100",3436,201,74,0,220,22,522,57,4532
"04013815200",5509,556,298,0,184,2,758,129,7436
"04013815300",3087,201,29,0,525,0,378,0,4220
"04013815400",5082,516,185,0,651,0,1303,155,7892
"04013815500",3680,107,434,0,1324,0,736,62,6343
"04013815600",3684,81,442,32,1300,13,310,14,5876
"04013815700",4232,494,284,33,1095,0,611,428,7177
"04013815800",3851,285,140,42,241,37,1023,0,5619
"04013815900",4615,111,83,0,1043,0,637,29,6518
"04013816000",6722,244,397,2,703,438,750,182,9438
"04013816100",5913,333,242,9,646,33,1079,14,8269
"04013816200",3307,321,12,13,732,121,1052,32,5590
"04013816300",2644,145,35,0,31,0,27,0,2882
"04013816400",5559,662,40,0,685,0,1169,0,8115
"04013816500",3359,108,146,14,185,54,404,0,4270
"04013816600",4344,230,99,13,238,13,530,13,5480
"04013816700",1744,104,83,0,448,6,535,1,2921
"04013816800",1942,99,153,0,798,0,861,0,3853
"04013816900",2953,198,137,0,569,0,583,0,4440
"04013817000",3273,152,19,0,154,15,120,0,3733
"04013817100",4920,695,140,40,842,181,1344,775,8937
"04013817200",5279,178,165,0,683,175,1274,185,7939
"04013817300",4746,336,59,0,154,14,104,14,5427
"04013817400",2738,180,0,0,51,0,78,0,3047
"04013817500",2270,72,14,0,90,0,0,0,2446
"04013817600",561,152,0,0,189,89,286,185,1462
"04013940700",0,0,0,0,6,88,0,0,94
"04013941000",77,158,4,1,1056,1452,164,225,3137
"04013941100",0,0,0,0,0,0,0,0,0
"04013941200",27,15,21,0,712,276,86,19,1156
"04013941300",1561,467,0,0,2812,1587,757,217,7401
"04013980100",0,0,0,0,0,0,0,0,0
"04013980400",0,4,0,5,0,2,0,0,11
"04013980500",30,0,0,0,36,0,66,0,132
"04013980600",0,0,0,0,0,0,0,0,0
"04013980700",0,0,0,0,0,0,0,0,0
"04015940400",54,16,0,0,497,277,28,43,915
"04015940501",1954,512,0,0,225,10,78,119,2898
"04015950100",5815,3753,11,0,375,74,499,151,10678
"04015950401",1655,386,0,0,83,0,190,0,2314
"04015950402",2705,553,27,0,287,36,103,40,3751
"04015950500",658,382,0,17,33,65,20,48,1223
"04015950600",6241,1324,17,9,678,191,401,84,8945
"04015950703",2553,1206,0,14,174,46,270,164,4427
"04015950704",4090,867,0,11,241,33,353,42,5637
"04015950705",2655,1050,17,0,224,88,450,352,4836
"04015950706",2566,1450,0,0,110,339,408,653,5526
"04015951401",3021,400,31,158,122,36,270,199,4237
"04015951402",2742,693,10,0,300,16,349,208,4318
"04015951501",2942,364,16,30,59,471,419,485,4786
"04015951502",4538,533,0,0,286,70,408,268,6103
"04015951601",1739,361,0,150,478,123,652,244,3747
"04015951602",3023,741,137,0,209,68,781,142,5101
"04015951700",3340,1807,7,6,398,154,1300,763,7775
"04015951800",1958,957,78,21,529,22,750,345,4660
"04015951900",3419,420,0,0,254,235,417,461,5206
"04015952001",1519,114,26,59,145,74,54,48,2039
"04015952002",5582,374,0,0,455,64,614,15,7104
"04015952003",3819,516,23,50,564,73,728,258,6031
"04015952004",2219,636,0,27,453,42,899,174,4450
"04015952400",1366,478,0,0,59,559,39,562,3063
"04015952500",4585,406,9,12,258,0,737,0,6007
"04015952600",2271,557,0,0,163,0,340,143,3474
"04015952700",3268,819,0,0,219,113,479,106,5004
"04015952800",5283,635,61,0,534,74,348,0,6935
"04015952900",3431,708,52,15,104,201,457,215,5183
"04015953000",4833,814,0,0,154,2,484,118,6405
"04015953100",2325,473,0,52,89,0,307,228,3474
"04015953200",2179,117,0,0,4,11,130,0,2441
"04015953300",5946,308,21,26,146,2,422,10,6881
"04015953401",4218,909,141,1,134,75,328,262,6068
"04015953402",5081,504,0,0,450,0,805,50,6890
"04015953601",7006,1183,0,10,930,168,1117,136,10550
"04015953602",1548,368,0,0,143,28,147,224,2458
"04015953800",4351,872,10,0,515,73,466,223,6510
"04015953900",4685,991,51,37,599,105,575,73,7116
"04015954800",4427,742,44,20,270,172,309,97,6081
"04015954900",2672,780,38,0,181,64,204,124,4063
"04015955000",2679,1203,0,2,893,381,1022,466,6646
"04017940008",0,0,0,0,653,447,0,0,1100
"04017940010",8,3,0,0,1264,1797,0,18,3090
"04017940011",77,13,0,0,1531,970,20,33,2644
"04017940012",43,0,0,0,2088,1089,35,11,3266
"04017940013",88,47,0,0,2482,1466,27,39,4149
"04017940014",38,27,3,0,1317,1229,60,53,2727
"04017940015",21,12,0,0,2243,1922,105,38,4341
"04017940100",278,22,17,22,2149,1874,108,138,4608
"04017940301",37,17,2,0,2070,2124,0,2,4252
"04017940302",57,1,0,0,1865,1566,0,0,3489
"04017942300",21,30,0,0,1121,738,4,23,1937
"04017942400",0,0,0,0,961,1145,10,0,2116
"04017942500",295,16,0,0,2124,2548,170,27,5180
"04017960100",976,213,0,0,355,331,254,35,2164
"04017960200",1465,348,8,7,1149,270,638,177,4062
"04017960400",1943,417,56,27,762,285,681,165,4336
"04017960500",1308,286,0,0,399,657,359,259,3268
"04017960600",1672,251,27,19,1896,719,1064,176,5824
"04017961300",2736,382,0,17,459,213,682,70,4559
"04017961700",4828,1140,18,0,366,9,503,331,7195
"04017962500",2159,782,2,0,482,0,515,215,4155
"04017963300",3651,502,0,0,341,0,432,83,5009
"04017963400",2636,299,15,0,355,32,173,104,3614
"04017963700",1230,122,0,0,9,16,76,51,1504
"04017963800",3245,407,0,0,368,92,652,137,4901
"04017964201",961,627,0,0,542,0,0,137,2267
"04017964202",961,562,0,0,197,171,178,54,2123
"04017964800",4138,374,0,0,144,3,260,0,4919
"04017964900",2203,262,0,0,101,0,95,0,2661
"04017965200",2750,958,0,2,298,281,69,326,4684
"04017965300",2651,1068,11,0,238,401,273,351,4993
"04019000100",284,157,0,13,14,19,152,42,681
"04019000200",2129,738,0,30,514,563,1935,852,6761
"04019000300",819,386,41,7,199,87,421,211,2171
"04019000400",1574,1244,33,29,189,242,417,303,4031
"04019000500",983,1143,50,24,417,240,353,351,3561
"04019000600",3215,1108,66,29,343,77,404,274,5516
"04019000700",3140,777,131,44,301,128,1283,476,6280
"04019000800",995,170,10,47,320,113,597,146,2398
"04019000900",1205,959,63,13,322,318,538,1028,4446
"04019001000",492,173,41,138,127,51,499,178,1699
"04019001100",1084,532,0,34,743,268,1606,722,4989
"04019001200",1508,673,332,211,702,488,1771,881,6566
"04019001302",703,604,27,57,316,364,511,226,2808
"04019001303",1233,1064,162,32,223,102,991,683,4490
"04019001304",1562,1868,83,16,735,596,1436,1045,7341
"04019001400",1945,1769,328,50,531,429,879,569,6500
"04019001500",2332,1523,39,12,117,529,519,250,5321
"04019001600",2749,609,21,0,409,79,667,66,4600
"04019001700",2063,569,26,5,210,29,440,100,3442
"04019001801",2205,1407,373,170,1000,504,456,457,6572
"04019001802",1572,380,31,9,333,195,468,122,3110
"04019001900",2827,650,6,8,287,69,604,144,4595
"04019002000",4131,1062,361,57,1026,284,3211,788,10920
"04019002100",2068,1764,624,31,941,481,2475,2091,10475
"04019002201",1473,357,316,0,824,408,1995,677,6050
"04019002202",1796,541,164,162,526,167,2033,688,6077
"04019002300",2060,2172,37,100,664,601,2386,2324,10344
"04019002400",2023,1787,39,16,1213,602,2829,2150,10659
"04019002501",2522,751,11,41,473,626,2771,629,7824
"04019002503",2257,957,9,0,840,423,2028,1135,7649
"04019002504",2687,1338,65,0,1145,375,2853,1488,9951
"04019002505",2969,1593,384,0,1268,407,3421,1713,11755
"04019002506",4501,986,107,42,1327,438,4220,1039,12660
"04019002602",2288,1209,0,48,629,501,925,1060,6660
"04019002603",870,1126,99,262,132,381,525,771,4166
"04019002604",1035,1406,159,201,447,496,716,1072,5532
"04019002702",2774,1109,107,0,488,165,873,390,5906
"04019002703",1734,1148,52,69,319,281,489,455,4547
"04019002704",1260,639,55,0,90,24,326,270,2664
"04019002801",889,551,46,13,48,34,401,125,2107
"04019002802",2368,862,61,315,451,225,868,423,5573
"04019002803",1228,515,65,9,212,70,237,197,2533
"04019002901",3326,1519,484,278,838,151,699,483,7778
"04019002904",2808,464,0,0,309,13,696,214,4504
"04019002905",2587,1315,258,147,185,204,395,494,5585
"04019002906",1658,247,0,0,467,32,585,61,3050
"04019003002",2761,877,56,24,306,36,372,259,4691
"04019003003",1961,848,93,235,170,134,384,238,4063
"04019003004",1391,142,43,0,215,41,349,23,2204
"04019003101",3503,1872,327,124,473,181,1418,926,8824
"04019003102",2074,654,309,272,300,219,543,298,4669
"04019003200",4002,1019,231,14,421,208,1329,289,7513
"04019003302",3013,519,219,0,386,74,803,153,5167
"04019003303",2433,538,85,59,383,111,701,327,4637
"04019003304",1909,373,211,0,365,375,624,414,4271
"04019003400",3797,465,113,3,835,165,1782,375,7535
"04019003501",3230,1678,401,348,1322,663,2310,1574,11526
"04019003502",2398,830,48,236,644,480,1389,697,6722
"04019003503",1900,1290,68,85,523,893,1202,1658,7619
"04019003504",1588,460,140,16,123,114,689,162,3292
"04019003600",3098,323,450,172,714,98,685,207,5747
"04019003702",2106,1769,125,9,780,2119,2593,3048,12549
"04019003704",1495,1393,13,0,1221,755,2339,1881,9097
"04019003705",2551,909,16,69,1219,653,3212,1524,10153
"04019003706",1979,1812,55,74,714,403,2170,2090,9297
"04019003707",1448,852,0,0,656,765,1742,1513,6976
"04019003801",1650,567,0,0,429,356,2010,821,5833
"04019003802",2397,1062,10,1,1348,937,3378,1842,10975
"04019003901",1127,425,47,35,356,336,1399,746,4471
"04019003902",1399,444,0,4,566,306,1838,572,5129
"04019003903",2358,276,0,0,429,96,2563,283,6005
"04019004008",3167,429,196,27,678,228,1080,145,5950
"04019004010",1833,712,40,24,612,30,436,366,4053
"04019004011",4244,1177,349,20,1223,481,1637,631,9762
"04019004022",5008,433,212,94,672,107,846,180,7552
"04019004025",5668,245,14,0,279,85,416,72,6779
"04019004026",4495,211,48,0,312,11,616,18,5711
"04019004029",2511,619,229,18,480,301,1152,361,5671
"04019004030",1684,41,0,0,115,0,219,3,2062
"04019004031",3396,236,186,69,255,98,440,113,4793
"04019004032",2700,277,226,14,404,117,765,29,4532
"04019004033",2214,480,244,149,333,172,804,234,4630
"04019004034",1816,545,260,235,530,143,854,306,4689
"04019004035",2384,624,443,0,236,92,665,272,4716
"04019004036",1903,497,275,0,249,27,446,280,3677
"04019004037",1908,186,166,200,564,17,816,112,3969
"04019004038",1694,308,158,47,518,41,606,44,3416
"04019004039",1864,230,50,2,178,98,232,40,2694
"04019004042",3576,419,177,41,757,126,668,30,5794
"04019004043",3277,126,310,2,538,30,808,48,5139
"04019004044",3518,235,28,10,244,24,416,37,4512
"04019004046",3235,700,13,66,286,119,683,67,5169
"04019004047",2611,214,23,0,94,9,273,59,3283
"04019004048",3775,234,103,0,307,57,841,57,5374
"04019004049",2074,118,125,1,61,47,240,43,2709
"04019004050",1756,123,0,1,163,0,197,0,2240
"04019004051",4359,167,14,0,376,6,270,61,5253
"04019004052",1747,34,29,0,103,44,100,0,2057
"04019004053",2784,77,0,0,170,0,390,0,3421
"04019004054",1213,100,19,0,108,18,135,0,1593
"04019004055",2602,146,101,62,336,87,581,98,4013
"04019004056",1842,213,68,63,130,61,544,90,3011
"04019004057",3464,416,311,83,442,81,849,305,5951
"04019004058",3134,339,442,0,685,95,845,219,5759
"04019004061",3624,242,224,0,330,0,740,119,5279
"04019004062",3984,165,148,56,599,36,1343,150,6481
"04019004063",3834,150,461,76,560,6,1298,0,6385
"04019004064",6292,381,28,1,502,92,1158,92,8546
"04019004065",2889,86,99,8,588,0,636,32,4338
"04019004066",2207,210,227,0,390,28,856,175,4093
"04019004067",2036,631,225,30,259,148,907,488,4724
"04019004068",3340,561,97,20,497,84,1091,172,5862
"04019004069",2329,928,90,92,521,226,584,781,5551
"04019004070",1883,298,82,15,729,8,1003,167,4185
"04019004071",3103,540,281,66,636,15,670,131,5442
"04019004072",1896,216,64,0,335,20,244,109,2884
"04019004073",4427,201,158,0,460,54,1178,17,6495
"04019004074",1467,166,20,12,142,3,258,71,2139
"04019004107",7257,244,835,1,774,82,1465,77,10735
"04019004109",4591,410,120,0,178,0,683,114,6096
"04019004110",2150,214,7,5,1301,105,2994,289,7065
"04019004112",1591,429,62,27,864,59,1642,317,4991
"04019004113",0,0,0,0,0,0,0,0,0
"04019004114",1945,1688,0,0,740,173,1715,1760,8021
"04019004115",1919,2716,193,14,756,1196,1927,3693,12414
"04019004116",1056,357,93,117,614,291,1091,554,4173
"04019004117",3022,729,411,4,1474,557,3743,1170,11110
"04019004118",3385,338,91,0,336,181,1346,320,5997
"04019004119",5402,223,225,0,336,0,1322,40,7548
"04019004120",716,62,4,0,49,0,253,0,1084
"04019004121",4182,508,340,0,832,0,3046,250,9158
"04019004122",2401,784,14,0,737,416,2166,1148,7666
"04019004125",4119,146,359,11,401,17,1366,17,6436
"04019004307",2991,158,37,0,114,10,158,58,3526
"04019004310",1307,214,55,0,233,92,1160,158,3219
"04019004311",3202,649,0,0,827,25,2907,500,8110
"04019004312",3016,1076,0,0,873,402,2869,1108,9344
"04019004313",2613,1614,10,0,244,6,823,779,6089
"04019004316",2874,289,44,24,196,23,792,119,4361
"04019004317",2619,231,0,0,20,25,130,32,3057
"04019004320",1384,1025,30,0,258,166,1107,865,4835
"04019004321",2468,602,90,0,778,291,2303,349,6881
"04019004322",4664,1004,41,0,868,884,4189,897,12547
"04019004323",2541,98,66,0,1206,39,913,53,4916
"04019004324",2455,51,0,0,57,0,23,0,2586
"04019004325",1850,39,0,0,0,0,59,0,1948
"04019004326",2609,148,106,0,357,1,1349,37,4607
"04019004327",3321,678,101,20,463,4,1268,237,6092
"04019004328",3613,157,0,0,0,12,22,0,3804
"04019004329",7987,442,278,37,898,58,3416,154,13270
"04019004330",1560,46,0,0,64,0,32,0,1702
"04019004331",3444,183,18,0,20,16,439,41,4161
"04019004332",1069,43,6,0,19,26,0,32,1195
"04019004333",2563,379,213,141,585,114,2285,391,6671
"04019004334",4748,810,331,14,2082,219,4754,847,13805
"04019004404",2771,314,32,20,95,17,274,21,3544
"04019004407",3487,647,298,154,1666,797,4051,1186,12286
"04019004411",3917,1636,52,100,1375,452,2673,714,10919
"04019004412",2336,456,27,37,549,143,1136,207,4891
"04019004413",2380,135,134,0,687,50,1485,123,4994
"04019004414",1975,311,133,199,536,54,1730,220,5158
"04019004415",1008,123,38,97,268,143,669,306,2652
"04019004418",2492,221,13,0,423,59,620,48,3876
"04019004419",3940,540,0,63,715,142,846,147,6393
"04019004421",5128,1372,122,0,1055,180,2475,864,11196
"04019004422",4327,256,197,0,579,33,2569,140,8101
"04019004423",3189,381,0,0,228,138,340,78,4354
"04019004424",2436,354,159,0,402,83,1394,156,4984
"04019004425",4185,953,16,0,346,62,1073,299,6934
"04019004426",2187,33,205,50,324,0,711,0,3510
"04019004427",6464,246,226,0,1269,0,1433,24,9662
"04019004428",2729,93,52,13,205,14,435,29,3570
"04019004429",5102,427,578,0,1369,1,1284,59,8820
"04019004430",1697,219,65,14,190,127,664,229,3205
"04019004431",2540,298,31,0,518,332,810,368,4897
"04019004504",3246,2262,95,140,412,232,1969,1841,10197
"04019004505",2314,805,26,51,527,109,991,660,5483
"04019004506",3108,1004,130,8,456,390,1346,629,7071
"04019004508",2831,762,16,0,824,271,1086,567,6357
"04019004510",1056,1659,60,155,326,419,467,571,4713
"04019004511",2012,1125,241,38,1089,103,1167,727,6502
"04019004512",2760,762,47,0,396,71,1061,285,5382
"04019004513",1653,779,17,9,367,85,811,364,4085
"04019004610",4440,452,63,27,541,72,1097,342,7034
"04019004613",3153,357,53,0,401,77,761,118,4920
"04019004614",2396,162,22,0,215,43,342,13,3193
"04019004615",2032,169,37,27,582,37,532,41,3457
"04019004616",2358,304,56,0,588,40,719,118,4183
"04019004617",2239,259,9,0,81,13,258,47,2906
"04019004618",2315,336,7,11,465,70,726,119,4049
"04019004619",2593,167,93,0,676,14,469,64,4076
"04019004620",1126,288,12,5,170,4,305,107,2017
"04019004621",1916,98,0,0,209,0,230,1,2454
"04019004622",2654,235,33,4,161,70,361,27,3545
"04019004623",3994,553,0,0,211,196,429,158,5541
"04019004624",5149,901,73,22,540,0,1908,8,8601
"04019004625",1288,330,15,0,178,71,286,168,2336
"04019004626",2000,571,142,54,747,206,850,144,4714
"04019004627",2373,153,21,27,214,133,785,53,3759
"04019004628",1195,35,13,1,70,3,253,15,1585
"04019004630",1313,324,0,0,124,62,269,255,2347
"04019004631",3200,105,48,0,176,0,654,49,4232
"04019004632",2103,247,29,0,226,1,309,27,2942
"04019004633",2434,102,11,0,173,33,277,33,3063
"04019004634",698,32,36,3,182,0,142,0,1093
"04019004635",4191,193,87,0,510,93,286,0,5360
"04019004636",6333,115,16,0,732,99,995,39,8329
"04019004638",7222,393,110,0,869,0,1343,40,9977
"04019004639",3399,10,175,0,397,0,860,0,4841
"04019004640",4201,154,139,0,438,16,615,8,5571
"04019004641",3129,72,0,1,398,197,967,225,4989
"04019004642",2531,90,29,0,198,0,132,20,3000
"04019004643",4282,240,0,0,34,0,63,33,4652
"04019004644",2140,141,9,0,346,5,660,5,3306
"04019004645",3703,138,133,0,936,121,1516,106,6653
"04019004646",3604,530,0,0,242,0,654,23,5053
"04019004647",3738,255,81,0,347,29,1284,48,5782
"04019004710",2769,464,172,20,333,98,799,68,4723
"04019004711",3686,512,16,0,409,0,199,70,4892
"04019004712",2357,198,157,28,282,99,142,94,3357
"04019004713",2996,258,0,11,90,15,156,114,3640
"04019004714",4416,371,71,27,523,63,391,201,6063
"04019004715",3336,525,0,0,564,210,1087,315,6037
"04019004716",5020,301,46,0,355,23,615,77,6437
"04019004717",1947,64,31,0,79,0,275,0,2396
"04019004718",1620,170,0,2,176,0,129,31,2128
"04019004719",4848,109,35,0,390,21,240,0,5643
"04019004720",1209,33,28,0,105,0,137,10,1522
"04019004721",2922,181,43,0,277,18,682,22,4145
"04019004722",2076,97,0,0,199,27,236,0,2635
"04019004723",3646,186,238,0,600,106,599,48,5423
"04019004724",2243,41,0,0,294,4,243,0,2825
"04019004725",1902,218,14,0,378,31,447,47,3037
"04019004726",3394,90,0,0,573,25,288,8,4378
"04019005200",2057,694,52,0,556,338,982,654,5333
"04019005300",2749,142,53,36,237,13,703,51,3984
"04019940600",10,11,0,0,561,497,18,18,1115
"04019940700",32,0,0,49,430,928,7,47,1493
"04019940800",96,0,0,0,2278,1467,32,0,3873
"04019940900",370,126,15,0,739,825,334,124,2533
"04019941000",57,89,10,0,2062,1766,479,474,4937
"04021000201",4661,342,40,0,409,5,598,45,6100
"04021000204",5187,165,598,31,353,29,1154,0,7517
"04021000205",11668,2022,364,1052,2098,103,4100,1044,22451
"04021000206",3200,446,109,0,369,0,458,138,4720
"04021000207",7286,961,122,0,936,175,2204,333,12017
"04021000208",1225,77,69,0,360,0,1038,0,2769
"04021000209",7069,508,662,38,1117,78,1883,143,11498
"04021000210",6592,387,452,135,1728,1474,2089,336,13193
"04021000211",3204,182,116,0,630,357,946,227,5662
"04021000212",3788,227,106,36,795,54,1254,0,6260
"04021000213",7594,1115,572,13,2308,172,1756,277,13807
"04021000214",6515,588,281,213,1802,34,1883,196,11512
"04021000215",1794,234,0,0,458,0,421,25,2932
"04021000307",1568,178,0,0,33,57,29,0,1865
"04021000308",3283,1318,0,0,55,19,656,342,5673
"04021000309",1420,639,0,0,157,0,78,18,2312
"04021000310",2173,954,97,0,102,20,105,99,3550
"04021000311",2585,195,0,0,43,0,254,11,3088
"04021000312",2081,967,9,50,81,0,403,497,4088
"04021000313",3283,774,47,0,199,40,590,18,4951
"04021000314",4447,422,87,0,576,331,851,60,6774
"04021000315",3071,1393,0,0,532,243,461,514,6214
"04021000316",6569,241,52,0,269,0,466,156,7753
"04021000317",2027,57,22,0,30,0,73,0,2209
"04021000318",5265,404,137,131,517,34,614,34,7136
"04021000319",1074,112,0,0,0,0,0,0,1186
"04021000400",1865,453,26,0,442,144,1296,419,4645
"04021000603",4442,350,10,15,142,16,598,42,5615
"04021000604",4422,118,0,0,13,0,76,0,4629
"04021000700",3093,603,0,2,159,0,1662,275,5794
"04021000801",9276,1141,279,0,224,370,1533,528,13351
"04021000802",3236,381,0,0,86,25,604,61,4393
"04021000803",734,77,0,0,43,0,116,38,1008
"04021000901",728,37,9,31,24,136,378,0,1343
"04021000902",1861,664,106,0,583,133,1254,729,5330
"04021001000",2395,1436,85,93,323,340,1063,976,6711
"04021001100",4454,983,308,42,911,177,1862,494,9231
"04021001200",3053,917,106,0,780,136,1432,668,7092
"04021001301",5730,393,415,2,650,29,2649,240,10108
"04021001303",756,211,8,4,151,11,280,168,1589
"04021001304",5979,407,396,5,933,324,1569,198,9811
"04021001305",4553,239,148,14,1040,281,2732,273,9280
"04021001306",2832,712,365,34,474,29,1080,236,5762
"04021001403",2550,337,137,161,460,232,949,218,5044
"04021001404",2794,519,0,0,452,9,1002,235,5011
"04021001405",3538,383,57,93,46,25,934,48,5124
"04021001406",1653,1458,623,0,1178,43,1703,1031,7689
"04021001407",1312,147,16,0,378,52,609,120,2634
"04021001408",1349,137,64,0,209,0,84,0,1843
"04021001500",1782,981,192,176,360,773,1597,941,6802
"04021001600",4585,519,124,1,436,92,2063,266,8086
"04021001701",476,239,0,0,17,38,110,256,1136
"04021001702",1904,195,37,0,596,0,487,178,3397
"04021001703",1569,23,10,0,174,0,624,0,2400
"04021001704",5250,190,527,76,627,67,1629,93,8459
"04021001705",5069,309,420,0,440,154,1135,251,7778
"04021001706",3466,109,529,0,774,0,740,30,5648
"04021001707",2630,186,1249,95,1195,93,918,20,6386
"04021001708",4438,424,415,0,542,32,812,165,6828
"04021001709",1659,179,148,0,754,36,906,0,3682
"04021001710",4084,168,234,65,66,0,785,24,5426
"04021001711",1261,38,307,0,518,6,578,10,2718
"04021001900",1855,567,26,12,408,173,1292,601,4934
"04021002001",2191,1098,0,41,180,62,1153,944,5669
"04021002002",392,253,0,0,20,10,168,227,1070
"04021002003",1890,1497,0,140,836,287,2473,1617,8740
"04021002101",4379,597,622,3,459,356,1668,468,8552
"04021002102",746,5,183,0,0,0,221,0,1155
"04021002103",2417,435,187,0,300,48,936,161,4484
"04021002200",3944,768,0,0,368,134,2132,522,7868
"04021002300",1848,517,0,0,354,17,959,202,3897
"04021002400",1247,305,0,0,340,16,821,217,2946
"04021941200",114,67,13,0,2803,3390,141,243,6771
"04021941300",97,15,0,0,2027,1618,111,149,4017
"04021941400",3743,1636,23,0,1634,971,1723,1619,11349
"04023966000",2311,345,0,0,196,12,499,134,3497
"04023966101",1732,205,0,0,469,16,850,67,3339
"04023966103",586,193,0,0,193,142,779,332,2225
"04023966104",6142,1214,120,0,2040,688,6743,1690,18637
"04023966105",5566,1741,88,0,2075,190,6791,1733,18184
"04023966200",2660,1040,0,0,805,664,3325,1644,10138
"04023966301",2428,822,0,0,556,449,2824,1246,8325
"04023966302",1338,830,1,0,378,720,1463,1493,6223
"04023966401",2130,630,6,0,306,440,2208,992,6712
"04023966402",1767,1236,0,23,602,685,2227,1656,8196
"04025000202",6334,1220,15,0,432,55,499,265,8820
"04025000203",4632,550,11,13,74,13,298,102,5693
"04025000204",5253,1531,39,34,304,201,1019,669,9050
"04025000300",4184,830,0,33,186,307,187,109,5836
"04025000401",4954,763,0,0,446,10,257,174,6604
"04025000402",4249,161,22,0,401,6,214,3,5056
"04025000500",4266,605,54,0,308,65,420,46,5764
"04025000604",3818,572,36,0,396,72,486,196,5576
"04025000605",5903,1952,55,0,1616,220,1593,1143,12482
"04025000606",3836,1261,0,0,486,95,923,597,7198
"04025000607",5072,579,22,0,147,68,416,145,6449
"04025000608",3110,526,0,0,91,25,368,182,4302
"04025000609",3542,531,43,0,226,18,996,97,5453
"04025000610",3260,830,39,0,48,49,464,272,4962
"04025000700",3004,300,0,0,32,3,62,48,3449
"04025000801",2908,403,43,4,107,87,401,148,4101
"04025000802",2834,291,0,11,95,47,129,50,3457
"04025000900",2297,1149,17,23,287,171,367,279,4590
"04025001001",3497,659,0,0,104,21,205,64,4550
"04025001002",2864,547,0,0,80,59,413,296,4259
"04025001101",3432,331,14,0,43,12,51,0,3883
"04025001102",2914,418,0,24,227,21,282,59,3945
"04025001200",5878,739,0,2,201,6,262,10,7098
"04025001300",1982,72,36,0,110,0,387,0,2587
"04025001401",1574,337,0,0,8,19,45,10,1993
"04025001402",2411,208,4,0,52,0,96,5,2776
"04025001403",2849,544,13,0,41,9,184,120,3760
"04025001500",4620,1234,0,0,169,31,531,2,6587
"04025001601",4041,886,0,14,627,200,727,163,6658
"04025001602",2408,996,0,0,101,96,193,2,3796
"04025001603",4651,1183,0,0,376,90,349,98,6747
"04025001701",4818,320,95,0,224,39,521,0,6017
"04025001702",3688,697,0,1,139,20,297,55,4897
"04025001703",2267,169,6,14,269,28,260,45,3058
"04025001801",3213,280,17,0,125,0,368,53,4056
"04025001802",3465,200,0,0,103,466,489,1,4724
"04025001900",11366,918,98,2,714,322,1065,248,14733
"04025002001",2723,1077,69,55,356,122,989,760,6151
"04025002002",3375,1105,17,0,587,0,1291,242,6617
"04025002003",3701,401,21,0,200,431,947,442,6143
"04025002004",7020,853,84,0,858,109,1510,99,10533
"04025002100",1043,890,0,11,316,54,386,251,2951
"04027000100",1190,296,4,33,98,206,895,369,3091
"04027000200",1594,193,89,28,874,483,2046,615,5922
"04027000301",1566,466,82,0,607,636,1606,944,5907
"04027000302",1111,850,157,81,1704,616,2552,1339,8410
"04027000402",1190,600,35,0,1256,178,2210,745,6214
"04027000403",789,283,6,27,427,268,714,330,2844
"04027000404",1397,328,42,0,917,956,1505,1129,6274
"04027000501",1582,125,54,0,564,187,1007,121,3640
"04027000502",1805,338,0,0,389,229,590,411,3762
"04027000600",3676,466,71,24,463,87,2846,396,8029
"04027000700",2621,1101,0,16,316,321,2500,1165,8040
"04027000800",3456,802,128,0,365,110,2008,593,7462
"04027000901",1633,445,56,6,1117,25,1345,384,5011
"04027000902",1929,380,32,23,185,73,804,343,3769
"04027000903",1691,250,84,0,537,336,861,473,4232
"04027000905",3821,333,228,72,3237,251,5759,465,14166
"04027000907",3436,724,438,61,1787,763,3401,1308,11918
"04027000908",1736,7,6,0,1018,89,1267,88,4211
"04027001001",2248,230,31,6,92,36,629,77,3349
"04027001003",857,62,11,0,231,98,697,113,2069
"04027001004",1092,556,31,65,469,99,987,302,3601
"04027001100",2703,478,169,33,1259,167,2168,213,7190
"04027001200",2617,224,8,0,917,132,1712,286,5896
"04027010905",2087,217,14,11,455,455,580,455,4274
"04027010907",4521,229,39,0,624,0,1283,98,6794
"04027010910",1458,200,0,0,65,0,199,12,1934
"04027010911",4273,543,244,22,991,310,2377,801,9561
"04027010913",347,80,0,0,269,192,445,254,1587
"04027010914",184,291,0,0,118,0,210,153,956
"04027011000",979,164,0,0,434,229,564,316,2686
"04027011104",2658,313,60,0,831,307,1456,458,6083
"04027011106",3859,469,251,0,761,275,1599,394,7608
"04027011107",1715,59,0,1,375,421,727,433,3731
"04027011108",2326,184,25,0,369,70,922,70,3966
"04027011110",2295,242,0,0,85,13,262,0,2897
"04027011111",2346,872,67,0,229,0,335,100,3949
"04027011112",2469,140,0,0,62,0,178,0,2849
"04027011114",1494,221,18,0,208,33,203,83,2260
"04027011115",2984,139,18,0,239,55,338,0,3773
"04027011201",2468,243,36,125,928,75,1053,90,5018
"04027011202",747,149,10,0,592,102,670,138,2408
"04027011403",3177,1358,0,0,302,1,3479,1357,9674
"04027011405",3734,1382,0,0,43,114,3707,1496,10476
"04027011406",5390,2584,0,0,393,16,5743,2600,16726
"04027011501",1046,610,13,8,336,336,860,591,3800
"04027011503",3048,1771,0,0,167,277,3131,1812,10206
"04027011504",5583,2426,0,0,417,121,5795,2534,16876
"04027011600",5787,2543,0,0,1,0,5784,2541,16656
"04027011700",849,151,6,0,59,71,226,112,1474
"04027011800",4082,450,19,0,867,79,3640,504,9641
"04027012100",559,140,35,10,449,74,573,161,2001
"04027980003",0,0,0,0,0,0,0,0,0
"04027980004",0,0,0,0,0,0,0,0,0
"04027980005",0,0,0,0,0,0,0,0,0
"04027980006",1376,59,225,0,432,213,368,213,2886
"05001480100",1184,113,148,21,0,0,0,0,1466
"05001480200",1174,138,118,32,5,11,0,0,1478
"05001480300",1543,222,691,498,29,51,46,83,3163
"05001480400",548,109,1139,430,40,10,115,0,2391
"05001480500",3501,160,380,244,104,0,105,7,4501
"05001480600",1195,157,19,0,54,0,35,0,1460
"05001480700",1794,351,629,157,100,9,5,52,3097
"05001480800",1161,163,43,0,7,48,0,78,1500
"05003960100",1119,161,477,242,41,13,23,31,2107
"05003960200",1545,470,215,26,305,15,198,0,2774
"05003960300",3266,393,453,593,153,171,236,212,5477
"05003960400",993,256,294,66,36,0,8,12,1665
"05003960500",1940,279,142,245,90,35,94,0,2825
"05003960600",3101,401,1482,512,15,0,202,48,5761
"05003960700",1066,41,611,125,8,0,0,0,1851
"05005950100",3581,547,0,0,184,29,291,69,4701
"05005950200",3707,665,0,1,99,38,0,6,4516
"05005950300",3780,889,0,0,94,51,42,0,4856
"05005950400",2234,523,0,0,142,50,0,0,2949
"05005950500",3870,802,48,0,90,23,134,56,5023
"05005950600",3661,469,0,0,63,26,0,0,4219
"05005950700",2667,562,0,0,85,0,0,0,3314
"05005950800",5011,623,35,0,106,34,10,6,5825
"05005950900",4722,928,0,0,30,18,83,29,5810
"05007020101",4509,912,7,36,141,161,227,20,6013
"05007020102",4114,535,51,34,797,0,594,157,6282
"05007020201",2790,856,38,21,426,61,866,380,5438
"05007020203",2621,317,9,13,247,0,261,34,3502
"05007020205",3222,599,0,0,1201,194,2195,323,7734
"05007020206",4324,459,5,0,1160,144,2932,449,9473
"05007020301",1650,1366,29,32,605,277,994,936,5889
"05007020302",3347,721,0,0,280,49,1089,597,6083
"05007020304",2305,645,0,95,345,47,130,434,4001
"05007020305",3239,550,0,0,394,287,838,634,5942
"05007020401",4655,1160,27,27,240,40,950,524,7623
"05007020402",2888,367,0,0,741,97,1082,119,5294
"05007020404",3996,220,77,0,304,178,1334,386,6495
"05007020405",2783,83,108,26,276,0,236,0,3512
"05007020501",4107,322,171,8,760,106,254,15,5743
"05007020503",2327,465,116,181,916,0,476,0,4481
"05007020504",2199,568,0,0,138,198,497,142,3742
"05007020603",4165,269,166,31,1330,0,259,23,6243
"05007020604",3381,445,19,3,492,9,372,54,4775
"05007020605",3493,260,78,23,359,1,240,23,4477
"05007020606",3696,64,35,0,413,0,236,0,4444
"05007020701",5013,173,0,0,252,14,155,0,5607
"05007020703",4502,89,0,0,119,22,86,0,4818
"05007020704",3344,145,0,0,65,0,62,0,3616
"05007020801",3589,152,50,0,111,0,89,0,3991
"05007020803",3096,284,0,0,123,13,37,0,3553
"05007020805",4504,124,21,0,119,25,286,0,5079
"05007020806",4086,76,29,26,27,22,211,0,4477
"05007020901",5525,118,270,85,1025,0,858,0,7881
"05007020902",5455,287,44,0,390,180,338,27,6721
"05007021001",3064,1033,8,0,329,164,231,38,4867
"05007021002",4777,1311,0,5,322,177,511,377,7480
"05007021101",2929,986,1,2,455,214,891,201,5679
"05007021102",2206,671,206,0,548,158,284,413,4486
"05007021201",2507,408,34,36,506,68,619,199,4377
"05007021202",2202,214,6,0,515,54,434,93,3518
"05007021301",5371,1033,0,1,604,239,545,633,8426
"05007021304",3536,292,42,29,738,161,277,71,5146
"05007021305",3093,367,19,0,662,110,297,153,4701
"05007021306",3150,36,7,0,324,13,284,0,3814
"05007021308",3076,54,34,0,258,0,127,0,3549
"05007021310",6173,351,0,0,403,0,923,88,7938
"05007021311",3987,438,55,0,463,125,261,163,5492
"05007021404",2627,499,3,14,442,88,376,12,4061
"05007021405",1717,161,49,0,93,0,1,0,2021
"05007021406",4556,504,4,0,572,451,1590,94,7771
"05007021407",3952,378,17,0,90,19,146,0,4602
"05007021408",3640,779,25,18,459,142,1034,561,6658
"05007021409",2136,123,0,0,95,4,8,4,2370
"05009790100",5685,755,0,4,108,29,34,44,6659
"05009790200",4453,1316,0,7,127,22,78,83,6086
"05009790300",4503,742,3,0,87,75,16,15,5441
"05009790400",5390,437,0,0,127,4,64,0,6022
"05009790501",2945,437,0,0,246,0,21,0,3649
"05009790502",2438,972,0,57,68,150,36,37,3758
"05009790600",4241,1003,0,0,50,46,267,39,5646
"05011950100",1140,285,251,63,188,133,170,143,2373
"05011950200",931,131,401,323,10,17,0,11,1824
"05011950300",1100,433,456,580,81,203,224,292,3369
"05011950400",634,188,375,203,272,50,375,57,2154
"05011950500",1510,542,208,292,187,79,150,128,3096
"05013480100",1692,126,754,188,2,8,15,3,2788
"05013480200",1658,417,312,38,16,0,27,0,2468
"05015950100",2053,477,6,0,103,35,26,18,2718
"05015950200",5697,675,0,2,199,95,115,40,6823
"05015950300",4673,1586,0,0,340,45,1008,376,8028
"05015950400",3868,446,1,0,325,61,302,46,5049
"05015950500",4167,1404,7,2,566,273,1097,659,8175
"05017080100",2220,79,374,80,106,115,97,141,3212
"05017080200",406,61,802,886,35,0,0,17,2207
"05017080300",1086,169,769,694,22,186,69,206,3201
"05017080400",292,80,1150,1236,16,6,20,0,2800
"05019953601",1859,560,685,743,46,0,64,0,3957
"05019953602",1967,559,190,80,26,0,257,0,3079
"05019953700",3049,702,452,57,144,32,0,8,4444
"05019953800",1599,557,767,437,46,35,120,158,3719
"05019953900",3221,661,1178,424,40,65,174,94,5857
"05021950100",1597,413,0,0,31,5,12,0,2058
"05021950200",1834,280,0,0,29,0,4,0,2147
"05021950300",1551,371,0,0,46,45,68,0,2081
"05021950400",2565,725,0,0,35,0,22,0,3347
"05021950500",1717,435,14,0,17,14,31,19,2247
"05021950600",2974,803,5,1,87,68,79,0,4017
"05023480100",3446,568,0,0,68,0,12,0,4094
"05023480201",1064,158,0,0,38,0,13,0,1273
"05023480202",3341,371,0,27,36,27,49,0,3851
"05023480300",4015,1341,0,0,32,11,0,104,5503
"05023480400",3154,692,40,1,32,7,0,115,4041
"05023480501",2548,382,0,0,95,0,54,50,3129
"05023480502",3275,384,0,0,140,34,129,32,3994
"05025970100",3673,568,461,426,74,16,3,0,5221
"05025970200",2701,369,103,117,33,24,28,20,3395
"05027950100",2714,313,634,323,108,2,80,0,4174
"05027950200",2037,213,917,924,52,327,0,298,4768
"05027950300",3429,361,864,295,13,0,21,96,5079
"05027950400",3363,668,985,594,90,109,20,0,5829
"05027950500",574,157,1334,1531,8,14,0,64,3682
"05029950100",3905,748,129,6,101,66,18,0,4973
"05029950200",2742,410,115,12,143,0,21,0,3443
"05029950300",2928,1250,384,541,76,15,185,219,5598
"05029950400",1360,442,147,200,66,9,0,59,2283
"05029950500",1226,713,755,163,0,0,39,106,3002
"05029950600",1834,421,0,17,24,24,91,12,2423
"05031000101",2146,805,364,743,147,29,311,0,4545
"05031000102",2703,305,338,133,30,30,221,0,3760
"05031000200",2322,617,772,68,34,9,87,269,4178
"05031000300",4497,822,610,247,210,20,27,78,6511
"05031000401",4063,821,558,35,0,119,216,161,5973
"05031000402",4234,1205,632,1105,268,27,353,49,7873
"05031000501",5298,732,186,0,150,0,99,0,6465
"05031000502",2856,1353,542,167,101,135,16,47,5217
"05031000601",2283,466,801,1250,33,247,27,165,5272
"05031000602",805,863,433,1327,208,368,511,462,4977
"05031000700",5726,1143,674,372,81,23,375,78,8472
"05031000801",6256,84,160,0,290,0,0,0,6790
"05031000802",5902,351,219,461,184,22,104,28,7271
"05031000900",4244,700,132,9,152,0,148,55,5440
"05031001000",3171,644,0,4,29,19,118,74,4059
"05031001100",6220,912,61,28,85,0,11,0,7317
"05031001200",3875,673,0,46,208,3,213,31,5049
"05033020100",4488,1127,2,1,168,55,15,0,5856
"05033020201",4687,934,0,0,298,81,35,19,6054
"05033020203",6404,654,235,0,458,199,311,50,8311
"05033020204",3319,908,0,34,385,25,36,68,4775
"05033020301",2874,885,14,0,249,156,93,0,4271
"05033020302",3760,455,30,0,318,7,282,84,4936
"05033020401",3950,375,18,0,463,17,134,5,4962
"05033020402",3326,985,3,10,104,41,20,68,4557
"05033020501",1728,1170,70,115,593,333,673,749,5431
"05033020502",2431,1773,45,0,159,109,373,350,5240
"05033020600",7950,1622,124,87,198,192,298,204,10675
"05035030101",73,15,1036,1606,8,11,0,0,2749
"05035030102",393,45,1553,985,0,0,11,0,2987
"05035030201",3353,876,441,212,157,0,56,64,5159
"05035030202",2323,44,682,82,274,82,8,0,3495
"05035030301",716,44,1333,893,9,0,0,0,2995
"05035030302",305,97,1109,881,16,0,0,0,2408
"05035030501",10,34,678,303,3,0,13,0,1041
"05035030502",42,0,478,389,0,0,0,21,930
"05035030600",1431,208,1333,1319,51,77,107,4,4530
"05035030701",641,232,528,116,16,6,36,182,1757
"05035030702",162,5,318,490,7,65,0,0,1047
"05035030703",1438,364,166,18,69,52,105,7,2219
"05035030803",1525,0,485,23,60,0,39,0,2132
"05035030804",1808,171,641,112,158,0,0,0,2890
"05035030805",1858,117,979,239,232,82,221,82,3810
"05035030806",2355,117,532,243,140,0,71,0,3458
"05035030807",916,33,415,156,31,0,10,0,1561
"05035031000",721,2,356,99,34,27,32,0,1271
"05035031100",371,96,1160,1198,14,0,0,0,2839
"05035031200",0,26,767,830,0,0,0,0,1623
"05037950100",555,60,622,417,5,0,0,0,1659
"05037950200",2311,605,127,20,5,32,3,0,3103
"05037950300",1238,135,0,0,33,0,5,0,1411
"05037950400",2336,250,71,0,36,0,9,0,2702
"05037950500",1872,570,1569,809,73,19,97,0,5009
"05037950600",3167,113,219,12,235,0,151,0,3897
"05039970100",819,49,559,103,32,0,48,0,1610
"05039970200",1242,155,213,90,5,17,46,87,1855
"05039970300",1465,361,1578,723,195,0,0,0,4322
"05041950100",1012,142,368,59,98,0,93,2,1774
"05041950200",2126,234,931,981,37,10,17,0,4336
"05041950300",74,7,716,723,66,135,73,115,1909
"05041950400",1038,114,844,887,17,52,0,50,3002
"05041950500",1129,203,370,251,21,11,165,59,2209
"05043490100",2066,273,238,122,9,20,34,22,2784
"05043490200",846,311,799,778,109,83,51,0,2977
"05043490300",2713,956,534,854,130,6,87,76,5356
"05043490400",1564,479,408,382,0,23,141,27,3024
"05043490500",2499,471,645,241,0,0,10,0,3866
"05045030101",2214,433,306,61,82,103,10,1,3210
"05045030102",4149,408,18,0,252,40,152,5,5024
"05045030103",3078,298,5,0,53,88,195,0,3717
"05045030104",3949,561,21,7,43,0,30,0,4611
"05045030200",4591,988,32,0,86,64,34,162,5957
"05045030301",4118,369,255,0,169,10,270,0,5191
"05045030302",5151,783,4,0,114,0,119,0,6171
"05045030303",3626,571,45,18,83,32,54,16,4445
"05045030401",1915,114,231,0,10,0,165,0,2435
"05045030402",2812,187,0,0,132,36,20,36,3223
"05045030403",1581,581,630,187,96,4,28,30,3137
"05045030404",1723,141,529,187,42,17,27,82,2748
"05045030501",8593,659,1002,205,761,25,219,48,11512
"05045030502",3010,495,708,113,64,26,147,46,4609
"05045030600",4338,382,395,77,316,0,211,0,5719
"05045030701",1352,474,392,282,45,23,46,15,2629
"05045030702",2092,245,473,426,94,139,0,27,3496
"05045030800",3078,488,297,112,157,44,144,67,4387
"05045030900",1303,1142,290,422,111,153,232,238,3891
"05045031001",2842,328,743,57,129,7,110,45,4261
"05045031003",1651,317,116,228,127,0,268,0,2707
"05045031005",4990,714,417,159,416,108,218,247,7269
"05045031006",2500,640,514,98,84,26,82,0,3944
"05045031101",3968,550,409,133,91,90,295,90,5626
"05045031102",4055,434,641,38,118,0,73,0,5359
"05047950100",2592,752,33,89,150,2,10,46,3674
"05047950200",5144,1936,0,5,69,103,182,121,7560
"05047950300",5721,731,23,7,360,7,64,1,6914
"05049550100",4632,1045,0,0,222,5,0,12,5916
"05049550200",4852,1142,0,0,53,49,88,24,6208
"05051010300",3484,1126,250,35,137,152,160,143,5487
"05051010400",5287,1786,62,0,198,182,46,8,7569
"05051010500",5076,582,51,148,117,0,87,0,6061
"05051010600",1802,410,635,711,401,189,441,99,4688
"05051010700",896,564,176,266,87,69,47,26,2131
"05051010800",1064,352,140,315,138,61,22,8,2100
"05051010900",1886,606,369,130,248,56,91,46,3432
"05051011000",3293,820,37,49,248,159,339,123,5068
"05051011100",6624,1537,47,0,409,336,192,157,9302
"05051011200",5838,890,65,209,513,0,159,0,7674
"05051011300",2964,335,535,483,340,336,381,336,5710
"05051011400",1781,399,95,478,372,296,360,231,4012
"05051011500",718,408,512,347,35,10,51,13,2094
"05051011601",4275,713,227,172,146,151,61,121,5866
"05051011602",3690,387,259,4,45,99,56,117,4657
"05051011700",3134,921,167,153,355,13,216,73,5032
"05051011800",2888,252,329,13,297,0,177,43,3999
"05051011900",4759,693,30,56,36,0,221,0,5795
"05051012001",4311,848,0,0,103,0,0,11,5273
"05051012002",2884,230,8,21,36,0,64,0,3243
"05053470100",4173,346,144,151,87,0,0,0,4901
"05053470200",2923,186,0,0,45,23,19,0,3196
"05053470300",3377,589,88,21,132,35,321,68,4631
"05053470400",4915,398,0,3,69,0,0,0,5385
"05055480100",2175,578,0,0,20,0,3,0,2776
"05055480200",4073,448,0,0,27,0,71,6,4625
"05055480300",2698,519,1,0,162,0,66,0,3446
"05055480400",5459,1222,36,0,71,16,152,13,6969
"05055480500",4491,1486,23,40,110,0,189,33,6372
"05055480600",5491,1193,0,15,42,45,0,15,6801
"05055480700",1724,555,50,56,46,31,44,21,2527
"05055480801",4852,237,0,7,152,13,247,0,5508
"05055480802",2925,590,0,1,99,103,21,96,3835
"05057480100",3543,797,431,289,27,65,121,149,5422
"05057480200",1192,193,786,142,93,29,27,0,2462
"05057480300",1829,896,1486,1215,157,90,413,612,6698
"05057480400",2862,756,204,46,73,12,0,264,4217
"05057480500",1914,651,1338,666,199,233,549,592,6142
"05059020100",6336,630,14,3,85,21,165,32,7286
"05059020200",1373,235,1050,364,0,18,16,0,3056
"05059020300",1147,220,484,62,22,27,87,0,2049
"05059020400",3430,722,960,238,218,12,132,101,5813
"05059020500",3662,411,23,0,63,13,85,117,4374
"05059020600",3241,413,0,0,33,0,2,10,3699
"05059020700",4647,1051,32,6,129,12,129,20,6026
"05061950100",2976,446,67,27,50,231,0,165,3962
"05061950200",2847,504,1209,385,170,13,128,53,5309
"05061950300",1944,552,764,467,352,512,434,592,5617
"05063490100",4560,1285,0,29,159,0,52,53,6138
"05063490200",1809,577,21,62,124,13,109,57,2772
"05063490300",3811,1189,101,365,12,0,88,276,5842
"05063490400",3449,915,27,4,30,64,65,3,4557
"05063490500",2044,181,0,0,0,0,193,28,2446
"05063490600",1606,602,165,48,117,112,330,215,3195
"05063490700",4979,1709,0,0,172,89,387,84,7420
"05063490800",3883,1172,0,1,50,0,23,61,5190
"05065960100",2600,748,0,20,68,50,47,23,3556
"05065960200",3887,656,1,0,31,42,25,0,4642
"05065960300",1974,488,0,0,26,2,67,38,2595
"05065960400",1687,396,0,0,146,0,0,0,2229
"05067480100",2600,826,134,124,59,14,62,0,3819
"05067480200",1383,628,460,386,7,78,11,11,2964
"05067480300",2151,741,380,499,169,74,48,144,4206
"05067480400",1962,516,81,0,61,0,30,0,2650
"05067480500",1172,311,42,21,15,19,13,0,1593
"05069000102",29,9,8,0,0,0,0,0,46
"05069000301",2415,419,401,76,34,0,19,9,3373
"05069000302",4294,611,446,0,274,0,186,0,5811
"05069000303",1667,245,997,314,130,33,62,0,3448
"05069000502",51,55,1534,1109,0,0,0,49,2798
"05069000900",491,16,1845,556,0,0,12,0,2920
"05069001000",20,6,858,547,117,8,110,0,1666
"05069001200",97,60,638,1213,13,14,0,0,2035
"05069001300",13,0,1118,728,6,23,0,0,1888
"05069001401",422,94,663,583,28,59,0,9,1858
"05069001402",178,0,1816,952,37,0,15,0,2998
"05069001501",714,63,2411,742,11,0,182,0,4123
"05069001502",450,131,2027,693,25,34,19,0,3379
"05069001600",185,154,1774,1692,35,48,59,23,3970
"05069001700",60,0,1532,831,0,3,0,3,2429
"05069001800",1017,109,1338,590,124,0,26,0,3204
"05069001901",496,118,540,426,36,0,11,7,1634
"05069001903",106,0,1431,647,82,0,9,0,2275
"05069002000",3032,220,1722,21,361,0,33,0,5389
"05069002103",2600,433,524,161,96,8,45,0,3867
"05069002104",2779,333,733,55,93,0,26,11,4030
"05069002300",1321,202,980,328,30,32,143,0,3036
"05069002400",2839,367,134,107,56,0,15,0,3518
"05069002500",573,41,317,390,0,7,0,0,1328
"05071951700",4365,474,0,0,133,0,331,51,5354
"05071951800",3190,1068,0,0,113,164,40,145,4720
"05071951900",2713,348,21,0,80,14,685,159,4020
"05071952000",2442,784,141,133,280,49,554,258,4641
"05071952100",2111,724,64,3,149,52,263,153,3519
"05071952200",4080,1082,0,0,44,104,347,159,5816
"05073470100",2291,365,1190,795,27,19,108,20,4815
"05073470200",1607,254,419,333,22,0,10,0,2645
"05075470100",1050,353,0,2,4,0,0,0,1409
"05075470200",3293,932,0,0,22,10,0,5,4262
"05075470300",1851,331,0,0,5,6,19,2,2214
"05075470400",1120,557,0,30,19,30,2,0,1758
"05075470501",1840,704,23,0,134,50,17,11,2779
"05075470502",2892,1170,24,0,0,16,0,105,4207
"05077470100",670,179,398,91,6,0,24,0,1368
"05077470200",1152,134,380,282,0,50,45,50,2093
"05077470300",771,152,1744,1575,9,13,0,35,4299
"05077470400",574,89,335,214,20,1,20,0,1253
"05079960300",1726,539,238,305,8,108,0,0,2924
"05079960400",2397,651,133,20,88,20,123,0,3432
"05079960500",1682,306,103,173,18,6,47,0,2335
"05079960600",633,67,650,503,67,171,50,155,2296
"05081030101",947,188,647,87,71,0,53,0,1993
"05081030102",3077,522,1015,107,132,141,78,141,5213
"05081030200",2053,201,227,178,102,4,0,0,2765
"05081030300",2238,288,230,43,237,29,91,0,3156
"05083950100",3117,752,0,1,224,13,84,0,4191
"05083950200",2926,492,55,0,79,47,152,36,3787
"05083950300",2864,524,12,125,43,74,0,0,3642
"05083950400",2803,225,0,0,219,25,0,75,3347
"05083950500",3188,974,27,82,8,54,10,77,4420
"05083950600",2143,343,33,22,93,47,43,3,2727
"05085020101",6009,329,200,0,280,23,77,0,6918
"05085020102",5007,605,11,0,79,0,43,0,5745
"05085020103",4739,473,10,0,6,82,125,0,5435
"05085020104",6328,475,0,0,171,285,227,211,7697
"05085020201",3519,37,0,0,0,0,86,0,3642
"05085020202",2788,714,44,122,337,90,289,128,4512
"05085020204",4476,900,38,0,127,37,179,227,5984
"05085020205",4173,790,52,1,305,59,128,111,5619
"05085020206",3133,348,0,0,203,0,43,6,3733
"05085020301",2841,410,374,131,226,86,106,15,4189
"05085020302",2929,651,162,0,95,0,57,0,3894
"05085020400",2197,144,204,72,0,0,0,5,2622
"05085020500",2789,367,627,349,223,0,167,6,4528
"05085020600",1173,71,357,81,7,0,63,0,1752
"05085020700",1495,515,445,436,28,12,39,0,2970
"05085020800",997,111,217,269,10,1,3,35,1643
"05087960100",2393,957,0,0,171,0,39,0,3560
"05087960200",2330,755,14,0,79,115,123,117,3533
"05087960300",4198,1122,0,10,124,32,195,134,5815
"05087960400",2542,501,0,0,167,26,138,23,3397
"05089960100",3282,675,0,0,115,44,42,65,4223
"05089960201",2402,971,0,23,76,16,48,7,3543
"05089960202",3005,804,0,0,118,8,53,35,4023
"05089960300",4208,496,0,0,98,61,65,6,4934
"05091020100",2053,577,797,336,95,0,124,58,4040
"05091020200",1630,188,730,431,44,47,13,0,3083
"05091020400",701,385,473,368,132,71,47,0,2177
"05091020500",950,165,691,488,75,122,96,13,2600
"05091020600",162,112,623,800,30,7,85,4,1823
"05091020701",2083,119,857,106,140,0,253,0,3558
"05091020702",1902,282,1271,690,62,0,0,0,4207
"05091020801",1353,347,709,18,115,127,34,67,2770
"05091020802",2187,265,19,6,53,24,34,0,2588
"05091020900",6527,579,393,213,107,8,249,0,8076
"05091021000",6681,1245,93,122,353,9,0,0,8503
"05091980000",0,0,0,0,0,0,0,0,0
"05093010100",430,27,754,395,44,0,0,0,1650
"05093010200",1713,907,2293,1023,155,0,97,83,6271
"05093010300",203,272,1448,1252,27,22,55,0,3279
"05093010600",3755,714,1669,443,31,21,272,0,6905
"05093010700",3379,285,195,0,104,0,98,4,4065
"05093010800",5223,1249,7,0,281,20,435,20,7235
"05093010900",1152,464,272,333,69,22,74,28,2414
"05093011000",1004,338,1557,1379,135,0,27,0,4440
"05093011100",1423,358,655,403,56,0,0,0,2895
"05093011200",1288,356,137,116,28,0,24,81,2030
"05093011300",1421,282,311,139,40,10,154,52,2409
"05093011400",1765,341,671,17,72,0,148,14,3028
"05095950100",1253,342,1081,885,73,0,0,34,3668
"05095950200",1126,404,262,225,7,58,21,89,2192
"05095950300",1261,73,551,281,0,0,0,0,2166
"05097953000",2505,686,10,8,92,58,6,41,3406
"05097953100",1690,425,20,0,38,6,38,2,2219
"05097953200",2740,737,0,0,102,111,171,95,3956
"05099090100",1202,319,365,233,16,7,23,14,2179
"05099090200",2254,858,1140,646,117,0,0,201,5216
"05099090300",1078,202,275,58,26,9,10,0,1658
"05101180100",3119,684,0,0,50,58,0,0,3911
"05101180200",2936,1013,17,2,104,159,28,4,4263
"05103950100",3733,550,1289,300,79,49,75,15,6090
"05103950200",1350,356,558,333,22,8,0,0,2627
"05103950300",3486,435,1002,394,74,0,44,0,5435
"05103950400",1162,272,1374,674,49,0,24,0,3555
"05103950500",1635,571,1123,581,92,90,54,49,4195
"05103950600",776,189,1566,1045,89,0,25,146,3836
"05105952700",4270,694,40,6,65,59,66,6,5206
"05105952800",2431,337,0,22,100,23,100,0,3013
"05105952900",1603,379,72,65,0,2,79,0,2200
"05107480100",1423,85,665,775,9,0,19,0,2976
"05107480200",2896,338,1803,913,50,47,0,23,6070
"05107480300",1191,169,2691,1775,0,0,24,0,5850
"05107480400",377,52,523,947,5,0,45,11,1960
"05107480500",262,74,865,1127,18,7,0,0,2353
"05107480600",552,144,593,494,24,94,160,12,2073
"05109953300",2710,1135,23,9,172,338,219,348,4954
"05109953400",1865,478,0,0,15,88,0,0,2446
"05109953500",3259,425,197,98,80,166,16,152,4393
"05111490100",2461,960,179,201,47,21,55,0,3924
"05111490200",1182,222,51,0,21,0,0,0,1476
"05111490300",2096,1285,25,161,8,255,19,190,4039
"05111490400",2978,558,87,280,12,0,22,0,3937
"05111490500",4443,1749,15,82,45,14,0,94,6442
"05111490600",1627,172,4,0,39,2,58,1,1903
"05111490700",1393,358,372,307,0,38,6,72,2546
"05113950100",3186,564,12,0,150,50,123,40,4125
"05113950200",4019,1428,0,0,237,100,127,0,5911
"05113950300",1979,665,0,0,148,15,11,25,2843
"05113950400",2460,386,0,0,166,33,92,10,3147
"05113950500",1466,826,0,0,40,7,11,1,2351
"05113950600",1612,361,0,0,207,276,437,346,3239
"05115950700",3074,687,0,0,92,12,36,0,3901
"05115950800",3741,548,43,1,47,3,28,0,4411
"05115950900",5063,888,75,2,401,5,137,29,6600
"05115951000",3222,847,0,0,127,0,67,0,4263
"05115951100",3287,597,43,0,91,6,34,0,4058
"05115951200",7510,1005,36,0,245,0,756,220,9772
"05115951300",4292,2070,138,46,259,363,472,530,8170
"05115951400",1536,509,70,52,60,66,65,139,2497
"05115951501",3196,246,0,0,429,0,123,0,3994
"05115951502",4420,1556,108,287,370,77,212,315,7345
"05115951600",4921,973,595,268,439,341,846,422,8805
"05117460100",2480,720,114,49,77,21,45,35,3541
"05117460200",1939,358,281,84,3,0,0,0,2665
"05117460300",1445,317,294,241,7,0,0,0,2304
"05119000200",256,38,551,146,0,0,77,0,1068
"05119000500",79,41,1632,913,0,164,14,0,2843
"05119001100",30,59,1615,468,38,48,0,0,2258
"05119001200",151,66,581,371,33,74,104,74,1454
"05119001300",141,382,1263,652,0,37,0,0,2475
"05119001501",2730,378,106,28,318,20,0,47,3627
"05119001502",2311,584,298,84,203,50,63,53,3646
"05119001600",5024,238,75,248,138,61,106,80,5970
"05119001800",544,232,1799,1493,6,7,7,65,4153
"05119001900",284,200,1673,785,41,59,13,32,3087
"05119002001",1480,412,2628,498,389,0,527,88,6022
"05119002002",1005,300,2094,1012,459,51,741,202,5864
"05119002102",1347,112,1284,572,425,0,297,92,4129
"05119002103",1457,174,1451,222,200,0,79,0,3583
"05119002104",4015,51,305,0,499,179,251,0,5300
"05119002203",3315,312,1217,381,203,30,145,17,5620
"05119002204",5240,127,1391,512,169,117,18,0,7574
"05119002206",1951,111,738,140,219,62,77,40,3338
"05119002208",1840,84,370,75,40,0,292,0,2701
"05119002209",1421,82,1304,579,197,22,317,0,3922
"05119002403",753,173,2343,509,29,219,276,317,4619
"05119002405",1062,295,2204,308,329,47,163,186,4594
"05119002406",1056,281,1690,354,15,114,313,158,3981
"05119002407",1323,46,585,5,41,0,46,0,2046
"05119002408",1106,279,3571,1936,63,14,80,0,7049
"05119002500",682,120,476,117,13,0,27,0,1435
"05119002600",100,19,751,187,0,0,17,0,1074
"05119002700",1484,188,3640,1510,147,19,0,0,6988
"05119002800",6,4,1134,1260,35,58,0,0,2497
"05119002900",291,97,629,480,69,4,72,13,1655
"05119003001",256,619,861,1074,14,0,27,88,2939
"05119003002",832,176,919,1704,0,47,53,62,3793
"05119003100",67,16,409,111,0,0,0,0,603
"05119003202",3609,1078,2173,388,476,0,715,669,9108
"05119003205",0,0,0,0,0,0,0,0,0
"05119003207",1283,132,502,4,17,0,27,0,1965
"05119003208",2296,784,1411,669,24,9,755,614,6562
"05119003303",3938,237,160,96,107,56,0,2,4596
"05119003304",4721,211,1073,21,120,0,191,0,6337
"05119003305",2460,367,168,106,38,147,411,114,3811
"05119003306",1369,222,1029,340,95,55,97,0,3207
"05119003402",4565,650,726,0,120,0,154,75,6290
"05119003403",1942,451,0,0,330,0,249,0,2972
"05119003404",3973,1006,249,14,339,36,53,0,5670
"05119003500",1532,33,235,0,408,18,247,17,2490
"05119003604",4093,368,1228,318,280,55,253,0,6595
"05119003605",2691,439,1584,532,348,19,368,30,6011
"05119003606",1017,358,964,328,72,35,71,0,2845
"05119003607",2073,259,1882,609,271,53,325,0,5472
"05119003608",2817,334,947,633,277,22,598,0,5628
"05119003609",2465,384,400,568,218,0,43,0,4078
"05119003703",5917,120,344,279,360,0,400,0,7420
"05119003704",1952,440,605,111,145,8,269,0,3530
"05119003706",989,52,27,40,37,0,17,0,1162
"05119003707",2879,62,1015,244,160,0,90,0,4450
"05119003710",2322,182,323,28,91,13,429,0,3388
"05119003711",2670,270,990,431,249,61,250,61,4982
"05119003712",3522,113,504,0,49,70,98,0,4356
"05119003713",2637,239,366,0,78,0,54,19,3393
"05119003800",1029,307,1648,621,85,0,217,173,4080
"05119003900",1878,346,1195,92,43,50,0,15,3619
"05119004001",363,45,1629,674,32,0,54,1,2798
"05119004004",2671,249,440,6,22,16,15,119,3538
"05119004005",399,139,928,259,54,20,0,5,1804
"05119004006",2993,436,229,25,43,73,356,94,4249
"05119004007",648,159,1882,142,39,6,108,13,2997
"05119004103",885,334,2077,362,84,13,328,293,4376
"05119004104",972,422,303,46,75,17,17,287,2139
"05119004105",1457,326,2319,1016,188,0,271,215,5792
"05119004106",909,503,3745,1203,47,33,354,340,7134
"05119004107",1009,465,834,893,42,344,394,732,4713
"05119004108",851,892,1883,897,43,343,412,958,6279
"05119004201",2074,378,63,23,95,12,14,0,2659
"05119004202",3016,216,1,9,219,0,32,0,3493
"05119004205",2576,140,524,297,135,0,21,9,3702
"05119004207",5301,521,1204,264,713,0,65,201,8269
"05119004212",4583,67,494,55,474,99,27,0,5799
"05119004213",3523,117,163,0,326,0,115,0,4244
"05119004214",2526,61,369,170,104,0,111,0,3341
"05119004215",3963,22,778,99,476,198,42,109,5687
"05119004216",3335,65,1172,857,790,0,59,0,6278
"05119004218",1625,217,450,245,220,25,39,122,2943
"05119004219",4587,173,509,0,767,93,82,0,6211
"05119004220",1958,96,2672,638,179,183,226,183,6135
"05119004221",2500,240,1373,227,379,18,109,33,4879
"05119004302",3500,561,538,65,283,12,103,41,5103
"05119004303",6425,497,2136,174,728,71,153,0,10184
"05119004305",5761,180,839,63,0,0,124,0,6967
"05119004306",3496,289,690,319,349,19,111,0,5273
"05119004400",1119,111,182,110,28,0,58,0,1608
"05119004500",131,27,1146,765,25,48,0,0,2142
"05119004600",876,238,1100,767,13,23,23,0,3040
"05119004700",904,154,1054,526,36,22,24,0,2720
"05119004800",1777,292,456,202,94,21,196,24,3062
"05119004900",5679,180,249,153,147,55,169,0,6632
"05121960100",2810,1153,0,3,49,11,24,15,4065
"05121960200",4973,1165,40,4,176,56,0,46,6460
"05121960301",3002,663,1,2,50,51,123,0,3892
"05121960302",2554,631,2,3,9,67,12,67,3345
"05123960100",1191,248,1042,845,31,41,52,120,3570
"05123960200",3349,553,1321,485,10,9,56,23,5806
"05123960300",1662,273,505,139,19,6,0,15,2619
"05123960400",403,364,2296,1334,50,10,32,6,4495
"05123960500",1255,203,891,608,231,82,125,0,3395
"05123960600",762,444,2018,1172,170,0,175,21,4762
"05125010101",2796,239,179,96,314,2,369,0,3995
"05125010102",6969,761,250,9,442,136,135,118,8820
"05125010103",5017,959,606,230,272,26,90,26,7226
"05125010301",3162,226,90,36,65,27,493,0,4099
"05125010302",2822,304,60,0,76,0,16,0,3278
"05125010303",3540,199,27,0,49,0,88,0,3903
"05125010404",6418,254,667,31,307,0,144,0,7821
"05125010405",3398,312,259,0,68,11,50,0,4098
"05125010406",5293,295,65,0,640,21,256,1,6571
"05125010407",4118,292,47,0,222,0,332,0,5011
"05125010408",4359,493,474,118,328,0,457,89,6318
"05125010409",2010,266,191,38,126,7,14,5,2657
"05125010503",4900,904,17,19,47,0,83,188,6158
"05125010506",6276,237,74,0,121,0,50,16,6774
"05125010507",2798,93,14,0,69,0,28,0,3002
"05125010508",3994,230,52,0,56,26,37,42,4437
"05125010509",2930,188,11,0,31,15,75,0,3250
"05125010510",7521,636,597,0,222,0,458,112,9546
"05125010511",4233,372,208,0,288,11,52,0,5164
"05125010512",2846,45,38,0,71,0,23,0,3023
"05125010600",5110,862,510,205,157,84,419,10,7357
"05127950100",3841,568,0,0,418,6,183,0,5016
"05127950200",2151,1118,0,0,383,189,365,211,4417
"05127950300",1790,307,0,0,149,0,31,0,2277
"05129970100",1964,475,1,0,47,0,0,0,2487
"05129970200",2583,925,0,7,47,93,34,55,3744
"05129970300",1241,505,0,0,42,85,0,0,1873
"05131000100",1617,2007,537,294,977,457,887,1481,8257
"05131000200",2084,1340,176,296,652,299,764,1024,6635
"05131000300",621,678,87,208,284,147,179,395,2599
"05131000400",1058,860,247,228,297,314,815,334,4153
"05131000501",2221,1708,399,180,720,181,1456,1102,7967
"05131000502",1412,662,272,17,546,85,509,444,3947
"05131000600",4011,409,460,24,138,55,173,3,5273
"05131000700",2645,1145,313,346,138,213,607,475,5882
"05131000800",2504,1310,88,118,461,194,589,729,5993
"05131001001",3055,927,118,390,470,30,141,324,5455
"05131001002",1860,37,97,0,44,150,45,13,2246
"05131001101",2857,413,176,69,161,30,191,0,3897
"05131001102",1800,367,79,5,512,33,59,13,2868
"05131001201",2693,301,120,21,141,144,91,39,3550
"05131001202",2147,1223,92,1,253,92,299,65,4172
"05131001301",1866,131,34,89,444,47,83,41,2735
"05131001302",5987,1157,155,181,1363,152,608,24,9627
"05131001303",3829,1260,301,218,745,206,307,27,6893
"05131001304",5937,584,313,85,229,236,157,73,7614
"05131001305",4466,285,2,1,573,0,246,0,5573
"05131010101",5773,450,30,0,261,51,268,0,6833
"05131010102",5644,473,10,0,56,41,52,0,6276
"05131010201",3996,839,34,0,321,174,100,96,5560
"05131010202",2958,304,0,0,132,0,20,0,3414
"05131010301",4962,488,0,0,565,117,351,6,6489
"05131010302",5371,858,0,0,186,19,40,49,6523
"05133080100",2674,374,0,0,774,304,646,417,5189
"05133080200",2643,671,12,8,429,251,512,385,4911
"05133080300",1928,754,401,25,1975,1099,2043,1327,9552
"05133080400",1756,484,139,138,38,17,36,17,2625
"05135470100",1219,351,0,7,87,102,18,12,1796
"05135470200",4001,1067,4,0,129,59,176,5,5441
"05135470300",2782,1158,0,5,103,9,1,20,4078
"05135470400",4502,1246,5,12,70,46,60,10,5951
"05137950100",2986,782,0,0,39,119,37,0,3963
"05137950201",1204,432,0,0,83,0,8,9,1736
"05137950202",4807,1831,0,0,106,0,59,59,6862
"05139950100",1543,244,1184,256,2,4,0,47,3280
"05139950200",2778,616,495,104,117,108,129,39,4386
"05139950300",1867,190,310,162,70,12,34,8,2653
"05139950400",3932,468,554,239,177,180,171,267,5988
"05139950500",5128,752,399,77,0,0,58,0,6414
"05139950600",1801,239,673,624,17,6,219,57,3636
"05139950700",2212,527,1366,752,97,26,172,99,5251
"05139950800",2231,296,599,173,160,1,0,0,3460
"05139950900",528,194,953,1022,72,10,103,27,2909
"05139951000",585,31,2044,1413,65,8,0,0,4146
"05141460100",2595,936,0,0,26,97,6,10,3670
"05141460200",2413,1280,0,32,167,27,155,90,4164
"05141460301",1641,189,0,0,29,0,4,0,1863
"05141460302",2742,701,0,90,0,0,51,0,3584
"05141460400",2890,744,30,0,172,24,112,38,4010
"05143010101",2969,802,6,0,486,362,448,232,5305
"05143010102",6468,731,61,2,645,9,403,206,8525
"05143010104",4851,371,175,45,358,89,95,44,6028
"05143010105",6620,852,153,0,515,62,403,35,8640
"05143010106",3861,385,277,94,762,76,405,0,5860
"05143010107",4580,425,240,8,281,0,223,0,5757
"05143010200",2631,548,13,0,1934,1611,1907,1594,10238
"05143010301",4486,1087,209,74,1627,1608,2400,2221,13712
"05143010302",5209,1590,380,304,3461,2236,3022,1847,18049
"05143010401",3050,298,6,13,1878,901,1760,846,8752
"05143010402",2559,475,76,10,1304,438,1000,546,6408
"05143010403",3668,614,223,117,1544,1475,1602,1059,10302
"05143010501",4347,470,25,0,163,106,83,106,5300
"05143010503",6058,570,70,94,939,128,744,118,8721
"05143010504",4880,658,0,62,940,132,394,77,7143
"05143010506",6728,1615,76,0,558,183,635,0,9795
"05143010507",4904,1052,164,102,265,26,35,0,6548
"05143010508",4465,667,464,10,394,64,288,114,6466
"05143010509",5760,425,32,0,1081,0,930,94,8322
"05143010510",2737,111,28,40,1183,285,1246,192,5822
"05143010600",3466,2363,288,290,548,221,236,196,7608
"05143010701",2537,2358,183,73,609,872,356,228,7216
"05143010702",2876,1522,243,85,323,191,324,138,5702
"05143011001",6323,1027,23,0,674,54,494,75,8670
"05143011002",3461,566,9,0,446,114,59,11,4666
"05143011003",4074,508,23,220,181,87,62,38,5193
"05143011004",2969,402,1,0,262,26,47,0,3707
"05143011101",2745,1882,120,220,443,366,523,34,6333
"05143011102",5221,862,26,176,446,110,627,262,7730
"05143011103",3178,643,14,0,117,27,17,40,4036
"05143011200",935,262,28,0,644,196,679,274,3018
"05143011300",1262,1128,20,3,178,165,40,21,2817
"05145070100",3799,741,8,12,150,156,182,92,5140
"05145070200",4097,469,0,0,45,9,145,19,4784
"05145070300",4294,471,4,164,64,68,57,27,5149
"05145070401",4677,560,208,54,100,1,29,21,5650
"05145070402",3752,806,0,52,124,19,31,95,4879
"05145070500",4795,809,258,15,226,65,431,139,6738
"05145070600",2968,934,99,0,25,108,27,129,4290
"05145070700",2787,339,222,98,104,118,0,44,3712
"05145070800",2310,899,202,90,77,247,54,164,4043
"05145070900",7288,922,404,32,181,16,449,52,9344
"05145071000",5601,543,128,2,276,88,58,22,6718
"05145071100",3808,1249,110,146,357,104,288,250,6312
"05145071200",6822,2085,339,367,165,56,36,51,9921
"05147490100",2766,543,583,344,43,30,18,9,4336
"05147490200",1295,284,578,479,69,28,9,6,2748
"05149952301",1272,1323,205,0,285,32,403,432,3952
"05149952302",2065,608,36,0,449,30,481,130,3799
"05149952401",2136,423,16,0,586,51,749,44,4005
"05149952402",4711,448,0,66,31,73,47,52,5428
"05149952500",1894,746,66,16,1233,493,1174,659,6281
"05149952600",1732,595,0,18,20,5,18,5,2393
"06001400100",1912,108,150,0,462,10,102,0,2744
"06001400200",1429,55,40,0,403,17,198,16,2158
"06001400300",3403,332,613,152,785,51,370,0,5706
"06001400400",2676,224,553,49,543,103,437,10,4595
"06001400500",1845,249,860,140,427,97,355,176,4149
"06001400600",557,58,634,23,366,41,193,27,1899
"06001400700",1197,227,1507,478,633,20,442,13,4517
"06001400800",1368,70,1023,89,427,62,535,23,3597
"06001400900",1008,96,642,231,182,19,82,8,2268
"06001401000",1326,250,1267,878,1159,114,1121,47,6162
"06001401100",1978,383,781,141,703,68,525,66,4645
"06001401200",1263,65,397,73,537,103,263,16,2717
"06001401300",876,354,638,613,977,233,485,276,4452
"06001401400",695,516,1155,747,730,452,539,397,5231
"06001401500",521,183,789,275,202,110,87,103,2270
"06001401600",295,244,634,319,235,148,107,160,2142
"06001401700",889,297,410,210,626,98,700,245,3475
"06001401800",499,194,572,553,127,167,283,75,2470
"06001402200",922,110,699,327,366,72,619,33,3148
"06001402400",155,103,1513,750,299,268,55,105,3248
"06001402500",188,96,745,604,172,221,175,203,2404
"06001402600",139,4,177,61,377,197,37,0,992
"06001402700",331,199,652,252,72,49,137,133,1825
"06001402800",559,318,727,594,422,352,176,82,3230
"06001402900",294,44,113,72,474,196,113,6,1312
"06001403000",111,70,40,53,1545,549,12,22,2402
"06001403100",346,55,91,19,490,225,60,0,1286
"06001403300",1087,31,278,18,1795,793,312,1,4315
"06001403400",1287,232,848,88,1467,383,595,46,4946
"06001403501",1125,256,879,411,991,516,377,22,4577
"06001403502",1016,133,283,156,401,34,164,41,2228
"06001403600",1550,41,1162,152,1061,273,446,5,4690
"06001403701",1434,73,339,137,433,49,220,20,2705
"06001403702",1217,58,190,22,392,90,106,25,2100
"06001403800",2198,159,473,51,630,12,472,24,4019
"06001403900",2135,117,657,112,837,70,235,35,4198
"06001404000",1485,136,253,90,725,76,354,62,3181
"06001404101",1971,132,19,0,586,91,96,1,2896
"06001404102",1335,99,235,8,573,222,118,25,2615
"06001404200",2267,37,298,73,603,76,226,0,3580
"06001404300",2411,40,151,21,781,32,211,21,3668
"06001404400",3535,55,148,20,1163,88,347,0,5356
"06001404501",1298,42,67,0,403,0,43,0,1853
"06001404502",4167,110,92,0,1139,30,208,0,5746
"06001404600",3218,94,345,16,849,14,130,0,4666
"06001404700",1510,46,136,0,281,0,66,0,2039
"06001404800",1146,89,633,83,751,44,244,33,3023
"06001404900",2285,128,470,24,1282,106,308,93,4696
"06001405000",2228,77,289,1,732,22,288,17,3654
"06001405100",2919,42,392,20,601,0,153,10,4137
"06001405200",2096,58,504,14,1860,115,505,2,5154
"06001405301",1293,22,444,110,682,37,385,0,2973
"06001405302",624,190,601,44,547,444,374,82,2906
"06001405401",592,241,470,376,1614,738,818,477,5326
"06001405402",486,174,465,78,1059,554,326,158,3300
"06001405500",818,109,525,197,1411,510,444,194,4208
"06001405600",646,331,833,144,1178,120,166,305,3723
"06001405700",398,76,850,183,1299,160,518,0,3484
"06001405800",491,88,594,127,1734,1241,217,397,4889
"06001405901",194,289,215,150,1577,994,807,204,4430
"06001405902",580,144,313,244,1428,708,549,436,4402
"06001406000",583,97,398,212,1099,930,284,410,4013
"06001406100",1464,456,307,52,1975,210,2467,511,7442
"06001406201",845,435,461,220,1473,559,1278,623,5894
"06001406202",1345,461,211,191,987,1027,1845,756,6823
"06001406300",843,263,492,389,1680,683,849,399,5598
"06001406400",416,100,523,222,835,100,491,87,2774
"06001406500",1625,556,1101,241,1857,487,1779,743,8389
"06001406601",816,63,1235,532,1908,283,689,47,5573
"06001406602",529,290,289,84,830,119,428,214,2783
"06001406700",2798,59,550,26,1228,222,431,83,5397
"06001406800",1444,60,458,186,1451,30,555,39,4223
"06001406900",1719,283,530,143,951,171,741,157,4695
"06001407000",1211,182,856,527,2036,446,1131,191,6580
"06001407101",791,841,392,41,1084,574,799,1039,5561
"06001407102",1493,229,509,188,1042,803,1628,430,6322
"06001407200",1612,921,212,219,2254,723,3028,1353,10322
"06001407300",996,466,377,45,779,113,1204,556,4536
"06001407400",1399,340,438,118,1337,739,2323,890,7584
"06001407500",391,178,703,697,1102,502,1041,432,5046
"06001407600",1090,272,2163,498,1027,276,1105,132,6563
"06001407700",1279,57,1781,382,587,9,462,22,4579
"06001407800",545,89,765,53,486,12,480,31,2461
"06001407900",1309,117,357,18,679,9,211,0,2700
"06001408000",1351,71,278,25,781,37,271,0,2814
"06001408100",2896,26,1638,127,1676,103,428,0,6894
"06001408200",809,19,1592,455,668,59,566,27,4195
"06001408300",1085,439,1965,388,932,150,680,42,5681
"06001408400",530,189,1213,586,784,382,942,433,5059
"06001408500",700,277,1475,658,1191,981,1286,1057,7625
"06001408600",1000,497,1450,1138,1189,620,1666,1010,8570
"06001408700",1551,984,2271,505,1422,509,2237,1386,10865
"06001408800",1191,285,774,1613,1885,486,2418,538,9190
"06001408900",540,467,547,493,649,426,1044,743,4909
"06001409000",751,170,1298,292,995,473,1373,598,5950
"06001409100",397,71,591,232,745,197,680,208,3121
"06001409200",661,157,1130,332,683,92,1030,155,4240
"06001409300",1177,423,901,288,2192,366,2818,577,8742
"06001409400",853,618,750,365,1391,532,1904,822,7235
"06001409500",1050,359,373,387,1739,419,2263,583,7173
"06001409600",1423,246,1280,471,1198,859,2490,978,8945
"06001409700",1430,306,1433,828,646,325,1734,543,7245
"06001409800",180,52,1447,408,515,35,367,3,3007
"06001409900",1063,72,1539,58,527,0,498,0,3757
"06001410000",1006,41,1226,89,809,57,494,11,3733
"06001410100",775,246,1282,348,427,16,340,82,3516
"06001410200",462,279,1581,311,725,6,765,254,4383
"06001410300",919,338,846,448,783,312,1397,464,5507
"06001410400",1088,130,1256,237,1252,195,1799,133,6090
"06001410500",91,110,652,669,470,411,78,72,2553
"06001420100",1774,85,44,0,443,63,192,22,2623
"06001420200",1696,106,102,12,985,114,303,30,3348
"06001420300",2058,154,306,0,2059,111,421,21,5130
"06001420400",1086,385,81,60,1497,578,369,294,4350
"06001420500",1166,81,140,50,624,35,74,0,2170
"06001420600",1820,111,122,0,739,39,253,17,3101
"06001421100",1507,129,17,0,353,39,48,0,2093
"06001421200",2783,122,0,0,668,60,175,19,3827
"06001421300",3257,123,187,0,611,10,176,10,4374
"06001421400",1462,50,30,0,239,0,100,9,1890
"06001421500",3197,71,28,16,356,10,146,23,3847
"06001421600",2682,166,51,13,526,68,105,5,3616
"06001421700",2185,208,221,9,963,227,368,82,4263
"06001421800",1740,88,61,2,275,45,127,23,2361
"06001421900",2263,143,268,12,803,218,63,13,3783
"06001422000",645,125,185,193,310,133,196,141,1928
"06001422100",1249,148,222,126,507,28,520,95,2895
"06001422200",1947,210,230,2,649,144,234,66,3482
"06001422300",2054,466,104,19,960,250,226,116,4195
"06001422400",2117,289,84,16,1165,814,169,54,4708
"06001422500",1531,477,132,52,521,415,237,51,3416
"06001422600",29,11,0,0,0,10,0,0,50
"06001422700",1136,288,69,25,446,594,187,44,2789
"06001422800",898,506,27,103,487,892,134,81,3128
"06001422900",1250,657,190,204,936,824,123,38,4222
"06001423000",3039,362,71,327,895,94,452,18,5258
"06001423100",1683,612,243,196,892,220,280,113,4239
"06001423200",1610,162,402,41,572,155,984,152,4078
"06001423300",1662,88,1294,108,563,105,498,15,4333
"06001423400",2061,658,533,155,1379,382,286,232,5686
"06001423500",1629,271,429,82,508,132,145,42,3238
"06001423601",1889,208,13,14,388,103,222,23,2860
"06001423602",1590,1016,1,37,1382,1437,313,134,5910
"06001423700",1819,504,20,12,305,325,184,10,3179
"06001423800",2493,43,33,0,602,26,281,8,3486
"06001423901",1264,89,214,145,190,38,176,0,2116
"06001423902",974,139,116,5,116,4,117,19,1490
"06001424001",1308,314,860,368,772,174,724,147,4667
"06001424002",560,221,698,158,516,84,310,128,2675
"06001425101",909,83,113,0,416,37,35,0,1593
"06001425102",912,124,284,85,1279,46,95,0,2825
"06001425103",1098,99,339,50,962,158,239,0,2945
"06001425104",1406,154,808,71,667,85,235,16,3442
"06001426100",4249,268,72,0,1472,81,273,36,6451
"06001426200",3322,64,20,0,1252,29,309,0,4996
"06001427100",2504,67,92,17,712,24,254,20,3690
"06001427200",1742,51,151,98,2037,456,762,55,5352
"06001427300",1897,5,534,13,1709,289,299,25,4771
"06001427600",976,407,422,430,2503,585,637,26,5986
"06001427700",2143,172,147,289,1836,168,370,71,5196
"06001427800",2799,356,310,89,1300,246,837,122,6059
"06001427900",2840,155,160,21,1304,101,563,81,5225
"06001428000",1286,145,90,26,1654,332,475,144,4152
"06001428100",2795,304,70,30,1442,63,693,11,5408
"06001428200",3507,42,379,73,2123,300,946,15,7385
"06001428301",2244,137,221,0,3356,224,486,34,6702
"06001428302",3120,75,169,2,3589,29,298,13,7295
"06001428400",2136,142,151,31,1440,329,488,89,4806
"06001428500",1266,206,164,64,1456,236,405,29,3826
"06001428600",1134,93,252,1,1198,128,180,0,2986
"06001428700",985,72,132,294,1704,175,341,101,3804
"06001430101",2691,264,286,1,3505,50,288,0,7085
"06001430102",1397,8,94,0,559,0,252,1,2311
"06001430200",5153,0,64,0,1555,74,857,20,7723
"06001430300",2142,151,669,1,635,7,332,9,3946
"06001430400",1317,9,61,0,628,15,248,0,2278
"06001430500",2364,413,1148,118,1146,236,968,298,6691
"06001430600",2922,123,184,1,1916,137,941,0,6224
"06001430700",2571,158,56,10,724,156,354,19,4048
"06001430800",3668,256,90,0,1596,137,1062,69,6878
"06001430900",2324,527,274,148,1012,86,966,103,5440
"06001431000",1579,372,71,8,604,153,734,228,3749
"06001431100",1843,183,296,50,851,83,950,36,4292
"06001431200",3010,731,301,19,981,205,857,488,6592
"06001432100",1990,56,603,94,970,52,740,34,4539
"06001432200",2085,245,555,70,668,73,1009,144,4849
"06001432300",1587,295,432,19,1936,77,1360,276,5982
"06001432400",2236,332,587,120,2091,227,1555,245,7393
"06001432501",2112,108,140,23,2101,294,1675,226,6679
"06001432502",1286,291,758,15,1996,49,934,186,5515
"06001432600",2661,225,950,268,2407,263,1901,59,8734
"06001432700",1556,69,86,23,645,7,589,0,2975
"06001432800",1692,178,264,0,952,48,610,12,3756
"06001433000",2023,75,323,0,1030,163,1026,22,4662
"06001433102",1435,208,198,44,2261,40,1069,134,5389
"06001433103",1931,319,666,136,905,410,1659,531,6557
"06001433104",1626,330,563,90,1325,77,831,308,5150
"06001433200",2261,397,600,569,2799,433,1071,343,8473
"06001433300",2478,152,424,5,3202,479,1531,35,8306
"06001433400",2004,45,795,30,3247,331,1030,13,7495
"06001433500",2159,152,139,1,2445,26,1480,123,6525
"06001433600",1840,98,709,14,3103,396,1020,58,7238
"06001433700",1601,116,264,50,956,136,1368,209,4700
"06001433800",2879,595,1184,122,3161,233,2544,326,11044
"06001433900",2307,739,1406,469,1364,299,2130,789,9503
"06001434000",2218,510,408,520,1234,133,2243,490,7756
"06001435102",1618,288,594,59,1128,249,423,21,4380
"06001435103",2201,73,370,38,3502,108,489,0,6781
"06001435104",1802,393,319,91,2708,304,1682,336,7635
"06001435200",1325,302,1199,14,1382,108,829,77,5236
"06001435300",1461,135,647,389,1118,332,1213,326,5621
"06001435400",1980,248,688,219,916,59,1076,187,5373
"06001435500",1438,278,180,70,1023,317,981,449,4736
"06001435601",1559,1299,221,42,1790,629,2171,1408,9119
"06001435602",2063,569,221,57,1216,512,1781,726,7145
"06001435700",1888,58,409,153,1803,168,1791,44,6314
"06001435800",2669,291,88,0,1905,277,1553,317,7100
"06001435900",2950,82,234,0,1934,136,1505,0,6841
"06001436000",2490,236,146,64,1490,78,1663,136,6303
"06001436100",2104,463,348,26,2408,134,1917,358,7758
"06001436200",1217,344,302,233,1400,221,1978,365,6060
"06001436300",2454,126,662,323,2646,553,3149,712,10625
"06001436401",3538,650,615,226,2614,427,1985,654,10709
"06001436402",1510,150,482,0,864,108,623,56,3793
"06001436500",1344,402,772,131,1677,346,1307,335,6314
"06001436601",1890,297,635,142,2811,603,2998,865,10241
"06001436602",1053,353,701,265,2310,285,1911,387,7265
"06001436700",1381,171,82,93,1490,607,1562,622,6008
"06001436800",1671,137,606,33,1683,130,1530,106,5896
"06001436900",2278,635,276,77,2762,506,3351,812,10697
"06001437000",1180,61,482,9,1303,45,771,41,3892
"06001437101",1935,61,248,33,3706,75,896,10,6964
"06001437102",904,166,583,31,2316,329,1011,293,5633
"06001437200",2145,61,572,385,3249,555,1513,225,8705
"06001437300",797,114,301,117,1512,237,784,233,4095
"06001437400",1606,34,30,0,1571,80,1637,57,5015
"06001437500",1407,596,66,61,1562,777,1578,1218,7265
"06001437600",1181,247,293,43,1215,451,1418,404,5252
"06001437701",765,499,329,23,1768,700,1445,983,6512
"06001437702",936,877,321,99,1616,841,1689,1414,7793
"06001437800",862,53,463,108,3147,88,2105,50,6876
"06001437900",627,124,285,0,1142,69,1197,153,3597
"06001438000",1703,118,8,0,1292,105,1097,44,4367
"06001438100",2701,224,675,194,3547,128,2866,263,10598
"06001438201",1835,117,152,105,1926,290,1925,263,6613
"06001438203",732,92,274,8,3041,227,1043,145,5562
"06001438204",1852,60,238,6,3152,241,1257,38,6844
"06001438300",1222,47,355,45,2067,215,1399,87,5437
"06001438400",1025,1,256,65,1251,24,883,3,3508
"06001440100",774,87,131,8,1080,75,480,27,2662
"06001440200",914,438,166,4,3699,542,3419,778,9960
"06001440301",2474,34,550,380,3410,102,2220,80,9250
"06001440304",716,11,271,21,3672,111,644,21,5467
"06001440305",531,26,176,19,2848,259,412,8,4279
"06001440306",450,83,194,60,2786,399,288,41,4301
"06001440307",1241,204,30,75,2382,247,663,73,4915
"06001440308",1373,233,292,16,3701,306,1890,162,7973
"06001440331",467,29,196,27,2824,79,674,20,4316
"06001440332",265,13,76,0,3202,27,231,3,3817
"06001440333",424,0,102,0,1972,93,171,4,2766
"06001440334",608,95,186,0,3168,339,718,163,5277
"06001440335",1206,159,69,0,4752,67,262,55,6570
"06001440336",1099,306,270,78,2799,404,959,120,6035
"06001441100",1931,49,53,0,1642,268,730,134,4807
"06001441200",2664,207,211,334,3761,50,1352,63,8642
"06001441301",933,117,165,117,1739,17,292,7,3387
"06001441302",2064,203,109,59,3057,163,745,109,6509
"06001441401",2454,89,74,0,3824,156,695,0,7292
"06001441402",1420,80,107,61,3318,271,587,139,5983
"06001441501",779,62,337,152,5318,162,434,1,7245
"06001441503",399,35,163,0,4968,184,55,15,5819
"06001441521",1106,126,227,2,4573,144,249,20,6447
"06001441522",1181,277,188,18,3491,22,505,134,5816
"06001441523",533,115,164,0,3152,176,105,0,4245
"06001441524",294,18,196,0,3410,308,163,0,4389
"06001441601",1877,278,85,0,2272,49,1050,49,5660
"06001441602",2093,133,364,29,4937,142,2156,74,9928
"06001441700",2534,134,432,68,3691,618,1634,313,9424
"06001441800",2716,157,81,57,3712,25,1020,10,7778
"06001441921",1021,48,185,1,2347,46,1101,7,4756
"06001441923",713,199,143,101,3813,225,409,157,5760
"06001441924",1783,607,50,0,4189,165,653,315,7762
"06001441925",1202,60,120,0,4273,44,672,0,6371
"06001441926",780,67,176,95,3008,37,1404,0,5567
"06001441927",528,75,371,23,2775,91,225,12,4100
"06001442000",830,35,2,0,2413,78,134,0,3492
"06001442100",1000,28,31,0,3921,183,168,6,5337
"06001442200",1531,153,37,0,4607,46,118,20,6512
"06001442301",1530,112,231,82,2492,233,847,14,5541
"06001442302",1340,196,316,27,3098,341,846,87,6251
"06001442400",2532,241,226,167,3405,448,1840,355,9214
"06001442500",2390,144,377,0,3813,106,1418,68,8316
"06001442601",1740,25,104,8,1697,24,648,1,4247
"06001442602",2125,282,122,0,2317,504,1042,244,6636
"06001442700",1752,86,34,0,1198,31,551,41,3693
"06001442800",1467,72,54,54,1429,198,826,34,4134
"06001442900",2761,73,405,13,3702,188,1100,0,8242
"06001443001",1393,45,177,0,1481,67,1037,23,4223
"06001443002",1683,237,19,5,3833,138,1603,0,7518
"06001443102",960,23,51,0,4199,26,491,0,5750
"06001443103",373,79,73,0,3358,208,44,22,4157
"06001443104",1179,70,0,6,4342,122,290,22,6031
"06001443105",724,15,115,0,3343,7,0,0,4204
"06001443200",756,11,11,0,2844,104,77,9,3812
"06001443301",1111,57,47,0,2715,128,212,10,4280
"06001443321",657,33,0,60,2381,194,189,5,3519
"06001443322",814,14,134,2,2400,19,199,5,3587
"06001444100",3823,111,78,31,3181,186,1830,182,9422
"06001444200",2208,141,269,13,3865,173,2394,38,9101
"06001444301",1417,52,52,0,2354,37,1382,63,5357
"06001444302",914,346,200,33,2684,270,1752,441,6640
"06001444400",1621,141,154,123,2644,40,2364,119,7206
"06001444500",2094,363,448,379,3127,175,1773,307,8666
"06001444601",2323,265,293,20,2079,176,1238,62,6456
"06001444602",1004,29,160,0,2722,206,596,0,4717
"06001450101",2130,98,197,0,2121,29,504,14,5093
"06001450102",1476,8,90,0,2025,57,884,0,4540
"06001450200",2948,92,257,22,1426,140,564,0,5449
"06001450300",2815,161,372,12,1296,83,479,151,5369
"06001450400",4463,145,74,5,1398,119,656,33,6893
"06001450501",2492,52,138,6,645,9,420,45,3807
"06001450502",3314,58,0,1,1454,13,410,0,5250
"06001450601",2225,15,113,0,777,55,171,0,3356
"06001450602",5648,245,141,153,2328,61,887,25,9488
"06001450603",3184,132,8,0,1338,50,580,28,5320
"06001450604",3733,162,117,0,841,18,543,5,5419
"06001450605",2678,117,1,2,1241,2,213,15,4269
"06001450606",3803,97,146,7,1617,44,368,35,6117
"06001450607",3385,125,0,195,1154,13,742,214,5828
"06001450701",4950,323,16,9,2966,77,466,60,8867
"06001450741",3434,319,146,0,989,91,1046,200,6225
"06001450742",3141,43,58,0,1250,13,495,13,5013
"06001450743",2092,198,169,145,2824,35,711,96,6270
"06001450744",2814,116,58,0,1771,111,603,57,5530
"06001450745",2886,80,132,0,2616,217,490,0,6421
"06001450746",2363,164,25,0,378,32,417,14,3393
"06001450750",1640,223,228,41,1451,167,373,58,4181
"06001450751",1131,0,240,0,972,16,141,0,2500
"06001450752",2130,28,97,0,3291,49,298,9,5902
"06001451101",5187,171,79,128,1470,0,793,81,7909
"06001451102",3650,36,11,12,623,53,409,0,4794
"06001451201",4339,192,99,112,1580,60,1022,132,7536
"06001451202",2699,293,30,3,886,0,795,0,4706
"06001451300",5846,106,108,35,677,74,1009,20,7875
"06001451401",3907,692,47,35,1380,139,1106,411,7717
"06001451403",1678,136,0,0,333,19,651,60,2877
"06001451404",4666,419,126,15,788,119,2916,388,9437
"06001451501",3474,178,74,0,663,12,728,11,5140
"06001451503",4190,94,0,0,869,201,1242,0,6596
"06001451504",1322,41,41,0,285,0,135,0,1824
"06001451505",3168,33,0,0,237,30,242,11,3721
"06001451506",2330,256,144,92,440,0,743,163,4168
"06001451601",3985,151,0,8,691,7,571,22,5435
"06001451602",5073,185,0,11,1271,0,658,18,7216
"06001451701",2128,244,64,0,480,0,413,101,3430
"06001451703",3001,222,80,0,1032,25,593,23,4976
"06001451704",3872,103,0,0,167,45,810,0,4997
"06001981900",43,0,0,0,0,0,0,0,43
"06001982000",52,0,0,0,19,34,16,34,155
"06001983200",209,15,55,14,119,4,24,5,445
"06001990000",0,0,0,0,0,0,0,0,0
"06003010000",716,111,0,0,210,73,52,35,1197
"06005000101",3819,217,47,7,102,154,182,32,4560
"06005000102",1358,168,0,0,131,62,157,44,1920
"06005000200",3652,600,0,0,540,35,551,3,5381
"06005000301",1822,113,58,0,37,0,138,10,2178
"06005000303",3643,730,2,2,334,50,272,56,5089
"06005000304",3223,523,0,0,187,233,260,421,4847
"06005000401",3442,393,16,0,279,45,349,92,4616
"06005000402",3655,527,1,28,351,48,278,27,4915
"06005000500",2158,206,0,0,34,9,120,16,2543
"06007000102",2601,492,18,0,269,191,302,244,4117
"06007000103",3188,128,76,0,619,32,563,55,4661
"06007000104",4064,511,75,14,1251,124,785,271,7095
"06007000201",3212,741,0,0,289,166,548,364,5320
"06007000202",2273,498,176,0,304,95,246,32,3624
"06007000300",2601,561,24,64,529,277,735,319,5110
"06007000401",1344,128,23,0,161,132,412,117,2317
"06007000402",6079,567,15,0,695,110,980,49,8495
"06007000501",2203,993,69,8,355,110,341,173,4252
"06007000502",1480,1510,38,0,403,408,399,376,4614
"06007000601",2901,389,0,0,234,25,453,92,4094
"06007000603",1139,790,0,9,179,223,41,222,2603
"06007000604",1396,1660,0,162,103,410,91,522,4344
"06007000700",3486,944,118,13,450,183,169,156,5519
"06007000800",3651,566,22,3,996,42,677,185,6142
"06007000901",2231,149,0,0,30,0,177,37,2624
"06007000903",3767,855,82,87,955,234,980,332,7292
"06007000904",4404,384,94,79,688,0,726,63,6438
"06007001000",2676,1476,35,120,410,63,270,203,5253
"06007001100",1994,1348,30,93,106,298,55,418,4342
"06007001200",1933,1002,55,9,328,208,330,193,4058
"06007001300",2053,1020,4,43,380,499,675,447,5121
"06007001400",4795,548,0,0,308,39,363,145,6198
"06007001500",4645,450,0,22,236,48,320,169,5890
"06007001600",4285,450,5,21,448,20,494,89,5812
"06007001702",4054,715,0,0,211,86,343,96,5505
"06007001703",2384,207,0,0,208,81,246,9,3135
"06007001704",2677,675,0,0,190,0,119,76,3737
"06007001800",4088,891,4,0,406,9,276,56,5730
"06007001900",2749,503,0,11,210,25,302,136,3936
"06007002000",4194,1002,0,0,476,82,286,109,6149
"06007002100",3602,497,0,60,285,57,170,85,4756
"06007002200",3827,707,26,0,113,39,127,56,4895
"06007002300",3678,1088,26,0,178,48,294,28,5340
"06007002400",3051,1253,33,0,545,108,324,105,5419
"06007002500",2634,546,60,123,948,335,306,103,5055
"06007002601",1876,276,58,0,311,10,194,0,2725
"06007002602",3060,198,25,0,123,0,74,0,3480
"06007002700",3449,613,98,5,737,284,445,25,5656
"06007002800",2258,871,34,6,560,264,477,214,4684
"06007002900",1439,583,0,0,498,366,83,99,3068
"06007003001",1450,531,20,74,529,613,165,243,3625
"06007003002",2018,631,36,9,540,365,680,201,4480
"06007003100",3149,340,119,0,577,37,342,26,4590
"06007003200",2526,732,7,30,589,297,681,302,5164
"06007003300",3305,476,191,0,524,34,533,54,5117
"06007003400",1883,405,22,9,225,306,528,517,3895
"06007003501",1703,350,0,0,707,7,746,137,3650
"06007003502",3283,578,0,10,604,265,2303,622,7665
"06007003600",2100,408,19,0,532,327,612,349,4347
"06007003700",2619,727,26,0,586,913,158,203,5232
"06009000120",4067,451,80,0,202,53,353,43,5249
"06009000121",3607,521,0,0,137,63,483,67,4878
"06009000122",3411,504,0,0,150,0,88,154,4307
"06009000210",8292,849,105,18,702,78,1329,88,11461
"06009000220",4920,328,2,0,736,133,689,129,6937
"06009000300",4827,442,103,0,378,76,511,132,6469
"06009000400",2656,837,2,0,326,36,188,109,4154
"06009000501",2895,263,0,0,65,9,119,0,3351
"06009000503",1242,123,0,0,66,41,15,0,1487
"06009000504",558,24,0,0,45,0,74,3,704
"06011000100",3384,704,0,0,1117,151,2844,489,8689
"06011000200",3635,203,53,33,1023,123,2163,139,7372
"06011000300",4181,509,33,10,989,199,3546,628,10095
"06011000400",1842,195,16,1,96,63,587,154,2954
"06011000500",1516,301,7,26,579,117,984,273,3803
"06013301000",3121,234,140,11,356,185,709,192,4948
"06013302005",3408,755,127,281,1676,242,2162,326,8977
"06013302006",3294,1,95,52,644,10,1657,1,5754
"06013302007",3732,521,273,136,1137,107,2176,532,8614
"06013302008",4653,283,1033,0,2454,55,3316,179,11973
"06013302009",1651,131,1748,325,2085,453,1146,358,7897
"06013302010",7197,557,391,38,1846,241,2993,183,13446
"06013303102",4680,648,554,23,1715,190,2370,547,10727
"06013303103",7169,388,451,57,1647,388,3592,440,14132
"06013303201",5204,112,839,430,3075,179,1882,173,11894
"06013303202",5422,101,79,0,1207,184,1595,189,8777
"06013303203",6091,315,709,123,1608,0,1456,4,10306
"06013303204",3979,148,18,0,495,8,1827,4,6479
"06013303205",6174,219,79,0,988,0,1176,0,8636
"06013304001",2482,249,15,15,1096,131,719,37,4744
"06013304002",1072,158,32,0,34,0,438,0,1734
"06013304003",3100,71,28,234,172,0,284,9,3898
"06013304004",3648,89,13,0,116,0,217,0,4083
"06013304005",4746,347,84,0,1139,137,1037,232,7722
"06013305000",2545,1183,473,498,1455,316,2051,953,9474
"06013306002",1751,125,224,0,682,221,587,176,3766
"06013306003",2093,657,765,320,1251,170,1443,419,7118
"06013306004",1792,469,270,136,241,121,716,392,4137
"06013307101",2713,232,181,83,844,167,1622,312,6154
"06013307102",3229,693,216,39,577,318,2007,749,7828
"06013307201",1369,216,245,277,727,143,902,201,4080
"06013307202",619,413,995,378,1057,325,817,423,5027
"06013307204",2222,286,271,199,941,119,1452,211,5701
"06013307205",3067,342,824,332,1480,386,2228,112,8771
"06013308001",4266,423,547,350,1531,77,2127,191,9512
"06013308002",2686,137,381,1,1022,0,1174,94,5495
"06013309000",741,179,942,211,366,214,384,198,3235
"06013310000",1437,328,932,355,2638,834,2759,865,10148
"06013311000",1387,249,1011,250,1828,391,2053,382,7551
"06013312000",599,274,628,211,176,215,475,365,2943
"06013313101",2361,387,1225,224,2199,1028,1363,1133,9920
"06013313102",1738,108,1063,80,966,69,1418,103,5545
"06013313103",3222,90,1447,14,2562,500,2203,196,10234
"06013313203",1347,191,185,8,1302,147,1088,130,4398
"06013313204",1791,315,417,264,2426,172,2119,322,7826
"06013313205",815,112,63,0,923,46,841,117,2917
"06013313206",1786,1178,1361,214,1347,348,2444,1358,10036
"06013314102",2112,458,518,158,1866,520,2105,718,8455
"06013314103",1352,570,727,453,1998,522,2095,850,8567
"06013314104",2513,1241,388,477,1674,673,2655,1295,10916
"06013314200",2467,1457,136,153,2159,551,3108,1849,11880
"06013315000",1981,238,114,34,649,121,527,107,3771
"06013316000",509,72,59,0,62,14,107,0,823
"06013317000",1612,113,154,0,306,0,245,0,2430
"06013318000",2310,225,41,2,451,78,523,49,3679
"06013319000",5388,602,122,57,801,174,1256,312,8712
"06013320001",2171,702,97,21,821,41,939,300,5092
"06013320003",1940,123,87,0,661,0,269,28,3108
"06013320004",5119,267,106,21,836,140,984,42,7515
"06013321101",4884,307,268,17,978,65,1019,0,7538
"06013321102",4606,175,0,17,1503,184,726,72,7283
"06013321103",3603,126,201,2,732,14,668,8,5354
"06013321200",3034,352,115,40,1280,638,555,129,6143
"06013322000",4802,169,183,0,777,335,906,0,7172
"06013323000",3598,169,14,15,899,85,618,49,5447
"06013324001",2722,322,89,1,1464,262,590,93,5543
"06013324002",3296,401,91,0,869,57,620,63,5397
"06013325000",4904,274,13,6,545,20,712,13,6487
"06013326000",2820,474,76,6,329,0,227,288,4220
"06013327000",4973,520,93,0,1295,355,2258,268,9762
"06013328000",1094,260,254,41,517,205,384,87,2842
"06013329000",4219,725,363,14,1197,118,1466,450,8552
"06013330000",3798,518,174,49,847,145,1391,268,7190
"06013331000",5173,248,216,41,1681,56,1378,20,8813
"06013332000",5554,517,6,0,1716,136,1592,341,9862
"06013333101",2826,70,114,55,914,27,642,1,4649
"06013333102",3018,217,129,5,804,12,538,46,4769
"06013333200",4247,190,37,25,1365,10,1490,76,7440
"06013334001",2456,206,240,2,760,42,660,97,4463
"06013334004",4085,436,401,1,1897,238,1182,0,8240
"06013334006",3204,174,104,0,1180,120,395,52,5229
"06013334200",5732,195,45,28,1298,0,792,0,8090
"06013335000",2452,153,63,6,566,204,705,114,4263
"06013336101",1950,680,234,23,1047,422,1899,778,7033
"06013336102",3462,703,206,295,2185,546,3561,723,11681
"06013336201",2239,223,0,0,1239,326,1843,450,6320
"06013336202",2053,1389,288,0,1210,720,2357,1592,9609
"06013337100",2257,227,77,6,669,0,766,93,4095
"06013337200",4679,748,150,185,1282,117,1439,543,9143
"06013337300",4074,66,180,3,1634,0,772,30,6759
"06013338101",2073,773,112,99,990,544,1147,796,6534
"06013338102",2484,267,77,0,1027,0,724,19,4598
"06013338201",2442,144,0,0,730,79,313,13,3721
"06013338203",3248,212,131,0,1100,79,346,0,5116
"06013338204",4210,123,8,30,1520,56,320,0,6267
"06013338301",2092,235,0,7,564,24,142,0,3064
"06013338302",4826,141,195,10,882,126,768,3,6951
"06013339001",2458,197,86,6,615,166,746,90,4364
"06013339002",3735,244,356,0,1040,32,572,32,6011
"06013340001",4013,445,103,22,845,13,555,165,6161
"06013340002",5624,179,0,0,1100,32,459,50,7444
"06013341000",3690,365,203,0,587,17,324,0,5186
"06013343001",3819,273,28,1,717,160,533,64,5595
"06013343002",3647,207,0,7,659,58,687,7,5272
"06013343003",3526,52,1,1,351,0,144,0,4075
"06013345101",3661,148,275,9,1409,46,451,0,5999
"06013345102",2581,261,33,1,998,15,327,25,4241
"06013345103",3473,32,0,0,1264,66,355,12,5202
"06013345105",5143,298,40,0,611,330,354,65,6841
"06013345108",4620,59,94,0,2662,8,692,8,8143
"06013345111",2271,73,65,0,2957,8,470,0,5844
"06013345112",3335,31,115,0,2430,207,897,30,7045
"06013345113",3010,229,151,0,830,0,215,12,4447
"06013345114",5765,97,13,1,693,4,335,3,6911
"06013345115",3613,18,30,0,1721,52,412,20,5866
"06013345116",1750,24,0,0,1285,14,155,18,3246
"06013345202",4543,231,667,0,2582,0,490,0,8513
"06013345203",4950,32,29,0,1345,38,315,0,6709
"06013345204",3625,36,0,0,111,0,29,0,3801
"06013346101",2918,31,0,2,671,16,86,0,3724
"06013346102",4794,46,51,0,610,16,195,20,5732
"06013346201",6167,574,32,0,785,59,391,0,8008
"06013346203",3019,313,0,1,359,0,104,0,3796
"06013346204",5819,239,9,16,1565,20,384,0,8052
"06013347000",4884,131,89,0,1079,23,239,0,6445
"06013348000",3652,192,9,1,681,16,236,3,4790
"06013349000",3561,228,120,0,687,47,438,58,5139
"06013350000",4574,182,262,26,954,33,542,21,6594
"06013351101",1965,51,0,0,289,0,51,0,2356
"06013351102",2808,193,0,0,558,36,40,62,3697
"06013351103",1706,108,0,0,147,1,292,9,2263
"06013351200",4991,57,0,0,842,0,267,0,6157
"06013352101",1599,39,0,0,405,49,37,4,2133
"06013352102",4076,60,0,0,975,10,215,21,5357
"06013352201",4682,257,0,0,1004,62,625,0,6630
"06013352202",1855,69,52,18,447,15,182,24,2662
"06013353001",2552,26,160,0,759,0,47,0,3544
"06013353002",3211,83,0,1,899,1,482,16,4693
"06013354001",1422,20,25,0,248,0,15,4,1734
"06013354002",4897,166,39,0,1275,0,253,3,6633
"06013355107",2973,35,347,9,1336,15,925,15,5655
"06013355108",4095,172,3537,86,5383,506,3799,234,17812
"06013355109",3192,441,833,252,1911,1047,1543,837,10056
"06013355110",1575,77,586,312,1529,45,1683,6,5813
"06013355111",3474,54,883,421,1639,266,1550,120,8407
"06013355112",3938,172,0,41,643,162,360,0,5316
"06013355113",2586,27,448,0,1558,18,279,0,4916
"06013355114",5394,26,233,58,5152,204,951,0,12018
"06013355115",1624,418,247,226,2386,100,448,256,5705
"06013355116",1375,0,61,0,5038,140,282,0,6896
"06013355117",944,35,53,0,5751,123,167,0,7073
"06013355200",1828,104,549,26,4021,198,1513,43,8282
"06013355301",5025,299,395,1,1961,138,903,77,8799
"06013355302",2780,23,54,0,804,18,126,20,3825
"06013355304",6087,250,190,33,1138,23,511,74,8306
"06013355306",4624,109,15,7,364,19,522,57,5717
"06013356001",1507,255,422,123,1712,57,911,21,5008
"06013356002",2437,97,916,40,2205,58,961,14,6728
"06013357000",2566,237,23,0,415,24,540,43,3848
"06013358000",3034,221,458,98,1015,125,917,143,6011
"06013359102",1920,295,741,76,1990,373,1048,102,6545
"06013359103",2057,156,561,123,1909,143,538,96,5583
"06013359104",575,62,143,150,965,68,409,0,2372
"06013359105",1541,36,931,20,2167,47,634,0,5376
"06013359202",3371,237,460,0,1990,44,1283,115,7500
"06013359203",2006,309,1228,206,3140,115,1022,265,8291
"06013359204",1110,89,506,46,2916,6,676,34,5383
"06013360101",2648,120,611,79,1627,48,1084,4,6221
"06013360102",2255,76,338,43,1452,70,730,1,4965
"06013360200",2317,257,531,103,1412,192,1138,9,5959
"06013361000",2017,253,582,114,1394,151,788,127,5426
"06013362000",1668,219,287,137,593,75,524,73,3576
"06013363000",3286,206,1966,90,1670,60,1627,22,8927
"06013364002",2735,343,458,154,1220,338,1796,203,7247
"06013365002",1672,706,946,421,1409,50,2214,696,8114
"06013365003",1321,125,1329,135,1545,164,777,30,5426
"06013366001",2034,579,212,65,1505,130,1895,400,6820
"06013366002",2591,657,584,241,1774,294,3082,605,9828
"06013367100",1084,253,1626,557,1138,195,970,198,6021
"06013367200",1981,380,795,176,1682,437,1848,467,7766
"06013368001",3134,697,232,207,649,121,3326,738,9104
"06013368002",1442,473,158,53,823,46,1774,341,5110
"06013369001",2298,798,871,638,1442,503,2143,617,9310
"06013369002",1158,200,480,45,659,96,646,45,3329
"06013370000",1627,56,239,70,810,46,458,0,3306
"06013371000",2123,423,898,80,1762,284,1667,433,7670
"06013372000",3314,810,610,82,2412,157,3073,818,11276
"06013373000",1673,593,602,39,893,242,2194,810,7046
"06013374000",2198,479,487,129,1007,529,1667,658,7154
"06013375000",1986,917,323,197,1464,341,3187,1235,9650
"06013376000",2008,878,1163,575,1048,697,2511,1152,10032
"06013377000",2861,1212,767,664,1218,65,3246,1189,11222
"06013378000",2355,302,120,9,302,24,500,156,3768
"06013379000",1415,749,1798,434,1243,366,2496,1048,9549
"06013380000",2031,444,1211,528,1159,240,1027,383,7023
"06013381000",1723,613,2399,419,900,349,1879,715,8997
"06013382000",1738,315,2136,1087,1453,310,1859,249,9147
"06013383000",2537,140,413,142,1591,283,435,110,5651
"06013384000",2373,108,256,10,1043,91,375,38,4294
"06013385100",1449,34,202,0,806,61,167,2,2721
"06013385200",633,0,57,0,472,40,127,0,1329
"06013386000",1134,94,499,54,1186,331,447,41,3786
"06013387000",1555,34,217,0,815,97,181,22,2921
"06013388000",1593,96,116,4,881,151,350,20,3211
"06013389100",1267,94,65,0,591,98,471,39,2625
"06013389200",570,162,57,51,613,135,261,147,1996
"06013390100",1322,88,63,7,582,168,223,0,2453
"06013390200",1182,40,20,3,422,14,72,0,1753
"06013391000",2008,64,22,1,355,19,45,7,2521
"06013392000",1960,86,26,0,588,7,121,0,2788
"06013392200",4230,625,1800,153,3071,375,2850,585,13689
"06013392300",257,14,508,64,1791,37,136,19,2826
"06013990000",0,0,0,0,0,0,0,0,0
"06015000101",2356,892,91,12,522,226,98,135,4332
"06015000102",2543,578,0,0,518,243,282,27,4191
"06015000104",1267,581,0,10,553,240,297,210,3158
"06015000105",4671,760,28,0,793,427,768,473,7920
"06015000201",2500,276,0,37,195,126,114,85,3333
"06015000202",2194,506,0,0,357,92,337,237,3723
"06015000203",377,200,16,3,362,197,85,46,1286
"06015990000",0,0,0,0,0,0,0,0,0
"06017030200",2720,644,38,46,926,419,1370,811,6974
"06017030301",1401,292,0,0,311,0,555,74,2633
"06017030302",1852,331,8,0,326,321,409,346,3593
"06017030401",3408,289,0,0,361,135,697,107,4997
"06017030402",2290,566,83,0,438,42,548,253,4220
"06017030502",2030,143,0,0,114,0,180,0,2467
"06017030504",2217,187,0,0,311,17,203,70,3005
"06017030505",1616,154,0,29,220,83,219,52,2373
"06017030601",4611,262,12,0,205,5,128,5,5228
"06017030602",5553,403,0,17,466,19,341,82,6881
"06017030603",2662,333,11,1,267,1,128,10,3413
"06017030701",5745,188,19,0,615,0,382,0,6949
"06017030704",4640,621,257,16,860,68,480,134,7076
"06017030706",5073,118,159,0,492,26,383,17,6268
"06017030709",4253,10,0,0,603,1,500,0,5367
"06017030710",4487,58,200,0,611,0,334,6,5696
"06017030801",3786,103,0,0,299,1,331,3,4523
"06017030803",6869,325,19,1,334,83,601,11,8243
"06017030804",5445,633,50,17,285,236,375,297,7338
"06017030807",3270,235,14,42,447,44,380,58,4490
"06017030808",6315,56,19,0,996,61,1039,0,8486
"06017030809",2265,179,12,0,139,0,235,28,2858
"06017030810",2517,260,9,0,240,30,463,156,3675
"06017030901",2515,178,0,0,76,6,108,4,2887
"06017030902",4096,188,11,0,299,24,273,0,4891
"06017031000",3689,1391,53,0,415,53,632,740,6973
"06017031100",3903,703,5,0,905,90,805,231,6642
"06017031200",3483,252,15,13,501,27,383,30,4704
"06017031301",3097,331,5,0,61,0,131,0,3625
"06017031302",3883,683,0,0,94,66,313,65,5104
"06017031402",4357,347,13,0,276,0,176,0,5169
"06017031404",1938,242,18,0,55,0,117,18,2388
"06017031405",2007,157,0,1,186,5,67,1,2424
"06017031406",4964,585,0,3,181,0,494,16,6243
"06017031502",5011,532,44,95,281,346,546,399,7254
"06017031503",2606,141,0,0,124,0,272,0,3143
"06017031504",4547,266,0,0,351,41,445,14,5664
"06017031600",1358,403,12,11,1925,303,1705,265,5982
"06017031700",2329,34,19,19,392,16,67,0,2876
"06017031800",4816,218,236,0,1982,199,655,0,8106
"06017031900",49,24,0,0,1,0,1,6,81
"06017032000",468,62,0,0,83,0,3,0,616
"06017990000",0,0,0,0,0,0,0,0,0
"06019000100",117,204,28,52,34,129,34,200,798
"06019000200",692,679,258,327,328,845,906,1375,5410
"06019000300",319,234,691,467,735,995,787,1182,5410
"06019000400",1148,1362,111,381,1364,1382,2366,2231,10345
"06019000501",443,310,11,174,721,1169,946,1142,4916
"06019000502",514,729,33,97,1145,384,1323,893,5118
"06019000600",1238,999,165,248,642,2023,1314,2527,9156
"06019000700",543,444,830,507,913,366,1033,664,5300
"06019000800",152,153,75,29,189,346,234,417,1595
"06019000901",436,180,464,243,1025,465,908,389,4110
"06019000902",1101,413,723,637,790,1675,1447,1055,7841
"06019001000",534,151,714,336,676,1039,867,864,5181
"06019001100",494,602,321,156,619,881,1068,1371,5512
"06019001201",1134,1144,99,417,1620,1206,2382,1969,9971
"06019001202",1165,317,222,266,1485,680,2252,774,7161
"06019001301",1416,1417,12,129,1198,1143,2338,2091,9744
"06019001303",677,552,73,40,781,454,1170,715,4462
"06019001304",783,959,192,214,1805,1729,1634,1842,9158
"06019001407",588,549,465,517,1264,1066,1422,1220,7091
"06019001408",866,237,151,66,532,327,692,285,3156
"06019001409",926,68,153,17,714,110,535,77,2600
"06019001410",1798,1084,304,239,5218,1880,3824,2431,16778
"06019001411",1537,290,243,247,1721,1360,1259,1028,7685
"06019001412",1353,91,91,0,1034,189,679,186,3623
"06019001413",1976,196,56,0,2079,487,1331,582,6707
"06019001414",2732,147,254,90,3153,670,2370,322,9738
"06019001500",855,268,0,4,158,659,726,756,3426
"06019001600",2103,480,25,0,1628,991,2537,1242,9006
"06019001700",2362,667,50,0,2046,446,2612,843,9026
"06019001800",2214,579,55,21,1300,484,2195,680,7528
"06019001900",1535,443,20,55,546,190,1247,435,4471
"06019002000",1463,1259,219,323,1293,786,1605,1539,8487
"06019002100",2962,1188,61,14,903,327,2016,842,8313
"06019002200",1941,492,48,36,430,454,865,647,4913
"06019002300",1408,594,53,319,515,297,1064,678,4928
"06019002400",1086,625,42,142,1127,1226,1606,1210,7064
"06019002501",1045,814,198,26,1052,1881,1642,1849,8507
"06019002502",1032,721,0,190,1683,2018,1580,2058,9282
"06019002601",1433,1148,164,24,1342,1185,2725,2273,10294
"06019002602",1101,386,53,7,1007,673,1359,1004,5590
"06019002701",1475,535,90,31,1592,971,2413,1217,8324
"06019002702",1127,1139,88,46,1858,1283,2578,1760,9879
"06019002800",557,843,87,316,1754,1391,1678,1589,8215
"06019002903",755,666,122,215,1389,1558,1120,1435,7260
"06019002904",832,239,97,142,1248,607,1102,620,4887
"06019002905",786,257,174,154,1086,498,1058,579,4592
"06019002906",1342,511,188,286,1687,1513,1797,717,8041
"06019003001",643,212,115,133,1081,935,896,893,4908
"06019003003",776,467,111,106,1449,1017,984,979,5889
"06019003004",850,221,138,25,915,456,903,467,3975
"06019003102",3706,1015,266,58,1768,670,2150,481,10114
"06019003103",2423,949,222,69,1048,506,1339,572,7128
"06019003104",1973,221,177,33,858,526,848,391,5027
"06019003201",1693,582,312,78,1372,967,1779,1126,7909
"06019003202",1759,650,350,169,1782,1512,1728,1527,9477
"06019003301",928,227,20,72,1170,1445,792,766,5420
"06019003302",1382,1147,114,40,1242,612,1653,1343,7533
"06019003400",1499,1056,173,185,1021,1205,1218,1759,8116
"06019003500",1466,1562,110,337,1034,702,1635,1675,8521
"06019003600",2531,705,53,8,523,129,914,595,5458
"06019003701",1004,640,49,146,798,878,1117,742,5374
"06019003702",1929,319,603,333,1071,457,1723,557,6992
"06019003803",3971,656,349,66,2903,249,3295,624,12113
"06019003804",2110,796,731,84,2069,41,1889,687,8407
"06019003805",2642,1283,261,197,1495,1281,2539,1758,11456
"06019003807",1573,184,111,14,1080,208,1681,75,4926
"06019003808",2333,421,323,44,2371,350,2774,502,9118
"06019003809",2083,259,472,16,935,346,1858,247,6216
"06019003810",3111,589,227,4,1213,996,2611,496,9247
"06019003900",2768,1186,0,24,303,284,1662,1260,7487
"06019004001",4024,722,0,0,2228,393,3897,1027,12291
"06019004002",3285,1703,0,1,1733,654,3460,2187,13023
"06019004100",1520,236,25,0,266,255,1104,169,3575
"06019004205",2446,766,598,192,938,1112,1685,1112,8849
"06019004207",3097,704,199,381,2772,486,2550,1090,11279
"06019004208",4755,331,241,0,2049,0,1069,0,8445
"06019004210",1980,217,236,63,707,320,1140,238,4901
"06019004211",4333,112,488,167,1145,99,2622,101,9067
"06019004212",5503,865,1063,422,2990,842,3528,1100,16313
"06019004213",2108,376,107,13,741,15,1232,114,4706
"06019004214",3557,264,10,66,1328,45,1289,44,6603
"06019004215",2408,2,358,11,1663,113,1581,37,6173
"06019004216",1548,86,153,251,275,199,670,134,3316
"06019004301",3092,180,283,22,472,23,486,23,4581
"06019004302",4082,54,22,0,951,232,686,222,6249
"06019004303",2941,106,177,35,543,3,654,61,4520
"06019004404",1118,821,8,21,1165,480,1616,787,6016
"06019004405",2941,198,50,1,732,80,836,0,4838
"06019004406",3903,618,92,0,617,19,1228,171,6648
"06019004408",2118,434,98,0,903,128,799,204,4684
"06019004409",2813,243,0,0,578,25,806,123,4588
"06019004503",3657,137,52,0,800,59,993,57,5755
"06019004504",3410,178,104,47,1417,146,2207,119,7628
"06019004505",1545,841,114,248,909,864,1121,874,6516
"06019004506",2283,265,0,0,347,47,470,68,3480
"06019004601",1942,253,154,131,167,78,497,171,3393
"06019004602",1756,509,13,0,165,202,285,261,3191
"06019004701",3209,861,604,283,1122,579,2540,1056,10254
"06019004703",1853,600,284,148,732,689,1467,907,6680
"06019004704",1530,1185,364,541,608,668,1268,1566,7730
"06019004801",1998,1442,120,551,530,570,1429,1798,8438
"06019004802",2082,1543,24,66,1017,702,1944,1696,9074
"06019004901",1463,835,48,40,851,433,961,933,5564
"06019004902",759,146,0,0,578,547,590,347,2967
"06019005000",1797,782,65,323,751,221,1113,563,5615
"06019005100",1851,1038,258,234,1204,592,1590,1068,7835
"06019005202",1068,473,146,48,1649,703,1408,720,6215
"06019005203",2183,237,153,129,911,804,2011,478,6906
"06019005204",1710,1175,247,55,705,377,929,830,6028
"06019005301",2194,647,234,116,1849,600,1977,756,8373
"06019005302",2432,875,200,232,1241,690,1415,1011,8096
"06019005304",2201,602,221,167,1761,621,1526,939,8038
"06019005305",1810,539,16,0,856,114,1230,318,4883
"06019005403",951,1160,593,381,499,511,691,879,5665
"06019005405",2805,393,260,35,570,39,947,269,5318
"06019005406",2582,341,220,11,657,228,945,291,5275
"06019005407",2633,60,44,5,509,146,838,35,4270
"06019005408",422,445,14,116,19,145,154,125,1440
"06019005409",1433,848,122,128,909,625,760,498,5323
"06019005410",1542,471,46,106,941,138,930,148,4322
"06019005503",3319,193,16,0,1191,44,666,25,5454
"06019005504",1768,109,43,0,437,81,318,21,2777
"06019005505",3843,22,82,10,2372,241,853,39,7462
"06019005507",3468,220,281,0,1797,121,1419,13,7319
"06019005508",4139,122,163,0,1410,61,949,0,6844
"06019005509",2945,289,130,0,1278,268,1416,216,6542
"06019005510",3259,184,290,0,551,223,648,188,5343
"06019005512",3636,102,53,15,976,10,981,37,5810
"06019005513",1901,157,10,18,621,13,432,66,3218
"06019005514",2519,267,0,0,946,18,446,45,4241
"06019005515",1308,64,0,0,210,0,130,0,1712
"06019005516",3881,299,115,0,1035,110,1352,0,6792
"06019005517",6318,448,120,0,1360,0,1344,0,9590
"06019005518",2519,59,216,0,340,18,582,45,3779
"06019005520",1787,91,16,0,772,0,311,9,2986
"06019005522",3021,200,365,0,1032,0,680,0,5298
"06019005524",3214,250,87,0,661,0,709,21,4942
"06019005525",1059,180,0,3,43,21,124,116,1546
"06019005602",2595,711,20,0,1360,472,1459,401,7018
"06019005605",1026,29,101,2,144,28,147,15,1492
"06019005606",2478,171,354,7,769,412,890,20,5101
"06019005607",2109,661,56,43,503,566,471,552,4961
"06019005608",2080,147,0,0,443,212,610,192,3684
"06019005701",2085,735,31,0,504,244,977,311,4887
"06019005702",4139,181,35,0,660,13,805,2,5835
"06019005703",3437,357,179,0,899,50,726,41,5689
"06019005704",2751,365,59,0,1423,883,1597,846,7924
"06019005801",3067,539,159,29,774,288,1184,160,6200
"06019005802",2508,266,168,10,659,197,529,75,4412
"06019005804",2876,956,214,13,1983,644,2128,516,9330
"06019005805",2137,151,103,12,909,138,797,10,4257
"06019005904",2412,222,53,0,1423,151,974,274,5509
"06019005905",5288,222,62,0,1156,250,641,170,7789
"06019005906",1601,162,16,14,512,0,585,112,3002
"06019005907",2222,127,48,0,670,31,782,31,3911
"06019005909",3185,274,323,0,1628,112,1124,40,6686
"06019005911",2235,105,18,0,1187,0,770,0,4315
"06019005912",2804,85,9,0,301,93,636,15,3943
"06019006000",4971,1046,62,31,2546,511,5466,1237,15870
"06019006100",3449,593,184,42,2432,980,4591,1579,13850
"06019006201",1200,829,0,0,480,311,1527,1121,5468
"06019006202",3360,1690,15,0,1239,578,3972,2223,13077
"06019006300",4590,805,0,0,1830,110,3478,578,11391
"06019006402",2474,116,0,0,536,171,199,54,3550
"06019006403",4446,377,0,13,390,188,812,146,6372
"06019006404",4220,214,124,0,373,67,340,17,5355
"06019006405",3181,350,0,0,402,28,349,188,4498
"06019006501",2212,1813,0,34,1649,928,3540,2748,12924
"06019006502",1230,1944,29,0,762,636,1807,2517,8925
"06019006602",1419,1065,40,7,1490,1462,2492,2460,10435
"06019006603",1211,85,0,0,332,21,891,53,2593
"06019006604",3373,921,8,5,2434,1713,5269,2517,16240
"06019006700",3918,110,0,0,1553,449,3256,444,9730
"06019006802",1490,694,2,4,1009,890,2023,1548,7660
"06019006900",947,408,14,0,1178,517,1375,863,5302
"06019007002",2269,567,0,3,923,374,2458,861,7455
"06019007003",3952,718,48,28,2503,886,4580,1456,14171
"06019007004",2591,197,144,0,2084,454,3021,554,9045
"06019007100",2610,1591,104,17,2327,1259,4421,2697,15026
"06019007201",4867,443,0,1,1470,919,2364,855,10919
"06019007202",2870,876,0,0,1276,168,2300,787,8277
"06019007300",2313,532,126,5,1298,595,1644,1006,7519
"06019007400",1588,356,11,0,1081,138,1687,255,5116
"06019007500",2392,816,64,0,1873,541,2912,1127,9725
"06019007600",1752,845,15,26,1203,1036,1652,1717,8246
"06019007700",2780,409,85,83,1628,1157,3048,1457,10647
"06019007801",1690,339,0,11,381,235,2020,563,5239
"06019007802",1671,1547,0,70,1078,1035,2652,2487,10540
"06019007901",0,0,0,0,0,0,0,0,0
"06019007902",1535,880,61,82,1116,521,1930,920,7045
"06019008000",3400,756,84,19,932,566,1904,1054,8715
"06019008100",3557,737,19,196,1445,508,2572,1015,10049
"06019008200",3115,2873,0,0,564,297,3256,2957,13062
"06019008301",3244,1653,49,14,655,314,3775,1954,11658
"06019008302",2230,3279,0,53,617,169,2683,3430,12461
"06019008401",4125,2160,29,12,1184,580,4739,2510,15339
"06019008402",656,348,0,0,147,83,454,424,2112
"06019008501",1965,1175,0,0,741,517,2483,1587,8468
"06019008502",3455,1204,63,0,1713,867,5060,2054,14416
"06021010100",4837,1808,37,16,1258,234,2562,1091,11843
"06021010200",3692,830,0,4,365,59,1437,424,6811
"06021010300",1388,158,0,3,166,64,176,4,1959
"06021010400",4977,842,48,0,1314,301,1989,323,9794
"06021010501",2320,434,20,20,366,309,1684,579,5732
"06021010502",1495,100,0,1,100,15,280,13,2004
"06023000100",2550,1084,4,38,333,97,501,337,4944
"06023000200",3871,1021,8,132,813,352,438,232,6867
"06023000300",3529,1146,64,0,623,474,208,117,6161
"06023000400",2631,727,0,8,418,162,503,234,4683
"06023000500",2111,822,71,23,497,153,343,69,4089
"06023000600",3389,603,44,42,357,301,101,29,4866
"06023000700",4486,505,57,19,200,196,145,64,5672
"06023000800",3836,266,0,2,670,134,269,12,5189
"06023000900",4005,641,13,33,241,183,523,209,5848
"06023001000",2357,1715,65,47,628,141,485,209,5647
"06023001101",3437,1296,0,36,493,554,527,211,6554
"06023001200",2888,1031,38,22,238,174,281,67,4739
"06023001300",964,261,6,4,174,15,119,31,1574
"06023010102",1266,404,22,0,572,289,185,18,2756
"06023010200",1738,349,0,1,231,117,57,12,2505
"06023010300",2783,528,27,12,358,25,85,90,3908
"06023010400",2674,311,0,9,620,89,624,14,4341
"06023010501",5716,909,133,0,857,159,469,111,8354
"06023010502",4510,641,0,0,482,142,222,11,6008
"06023010600",1616,85,29,0,178,2,242,0,2152
"06023010700",5017,859,45,18,776,266,486,70,7537
"06023010800",2543,691,17,34,594,134,268,159,4440
"06023010901",2401,844,0,0,571,606,601,674,5697
"06023010902",3238,415,32,0,358,36,334,11,4424
"06023011000",3651,321,20,0,364,97,309,98,4860
"06023011100",3936,352,115,0,292,83,507,38,5323
"06023011200",2830,308,13,48,191,7,267,48,3712
"06023011500",2308,845,0,0,266,104,118,115,3756
"06023011600",2322,868,7,0,218,104,175,48,3742
"06023940000",275,98,0,7,1704,923,82,33,3122
"06023990100",0,0,0,0,0,0,0,0,0
"06025010101",207,10,0,0,13,11,96,11,348
"06025010102",4470,1639,75,4,1019,475,4822,1931,14435
"06025010200",1212,529,12,6,139,74,1089,544,3605
"06025010300",692,31,0,0,62,84,387,104,1360
"06025010400",3858,2151,137,139,884,207,4618,2048,14042
"06025010500",4601,887,193,17,642,334,4077,1182,11933
"06025010600",4735,630,0,0,516,64,3033,495,9473
"06025010700",2389,1217,27,0,964,364,3243,1553,9757
"06025010800",1002,11,31,0,364,155,614,166,2343
"06025010900",3958,1195,8,11,1113,474,3546,1619,11924
"06025011000",8224,974,325,0,1581,408,7288,1248,20048
"06025011100",1895,374,97,8,576,24,1640,311,4925
"06025011201",4683,674,79,0,988,176,4389,801,11790
"06025011202",2612,901,49,43,942,745,2955,1623,9870
"06025011300",4976,878,8,43,2693,685,7023,1530,17836
"06025011400",1200,976,155,21,1448,785,2529,1736,8850
"06025011500",2157,1671,134,26,1085,703,3067,2261,11104
"06025011600",2774,1252,0,0,1351,847,3420,2005,11649
"06025011700",3117,486,32,0,1018,430,3407,889,9379
"06025011801",2548,134,106,0,759,13,1968,146,5674
"06025011802",2801,870,49,100,1208,184,2953,893,9058
"06025011803",3978,86,299,0,1828,160,3801,206,10358
"06025011900",6484,725,46,0,2877,1280,9031,1974,22417
"06025012001",1798,834,0,18,1298,478,3090,1271,8787
"06025012002",4591,664,3,0,2345,875,6687,1381,16546
"06025012100",2134,2813,0,0,1606,749,3649,3554,14505
"06025012200",4480,883,0,0,1772,491,6056,1326,15008
"06025012301",467,303,17,0,98,54,88,139,1166
"06025012302",1987,1138,77,0,1058,424,2061,1046,7791
"06025012400",426,205,0,0,4,0,28,0,663
"06025940000",673,188,3,3,945,765,557,365,3499
"06027000100",2082,202,0,0,161,0,501,75,3021
"06027000200",1526,77,0,2,122,42,157,2,1928
"06027000300",2350,86,90,0,169,31,382,26,3134
"06027000400",3224,621,5,0,1314,457,994,293,6908
"06027000500",1688,135,8,0,370,157,137,33,2528
"06027000800",2343,375,28,0,237,124,669,185,3961
"06029000101",9027,1494,188,135,1579,360,2285,501,15569
"06029000102",2284,514,0,1,164,247,204,0,3414
"06029000200",3353,3241,75,8,378,373,649,462,8539
"06029000300",2227,1180,0,29,318,400,320,495,4969
"06029000400",1920,1979,0,62,337,99,479,488,5364
"06029000503",4914,421,158,0,1323,40,751,41,7648
"06029000504",3041,958,25,50,279,54,875,577,5859
"06029000505",3033,112,0,59,262,36,333,25,3860
"06029000506",1755,249,149,37,540,31,558,167,3486
"06029000507",2981,134,9,0,541,37,1168,99,4969
"06029000600",2448,974,235,945,982,994,2002,1435,10015
"06029000700",2997,706,7,8,1080,136,1596,544,7074
"06029000800",2875,807,33,82,835,144,2006,323,7105
"06029000902",2334,555,98,0,751,145,1405,389,5677
"06029000903",2108,380,13,80,1168,319,1658,645,6371
"06029000904",2351,394,40,10,941,324,2086,378,6524
"06029000905",1294,769,0,62,744,36,1261,679,4845
"06029000906",2336,85,32,0,1169,298,2045,353,6318
"06029000907",1451,150,14,11,544,316,1217,421,4124
"06029000908",3381,192,112,146,1644,116,2410,221,8222
"06029000909",1718,49,9,0,403,0,619,0,2798
"06029000910",5978,1029,159,201,2153,576,3583,1101,14780
"06029001000",5390,1212,127,0,3134,296,6366,999,17524
"06029001101",2318,792,1,133,799,246,2147,834,7270
"06029001102",1972,1905,101,113,2022,613,3414,2306,12446
"06029001103",1175,1468,63,161,1514,904,2475,2028,9788
"06029001201",992,904,0,31,759,255,1618,1041,5600
"06029001202",1068,1923,93,190,1215,1023,1944,2663,10119
"06029001300",1720,968,318,569,1903,1426,3209,2274,12387
"06029001400",2281,2506,75,333,1249,1701,2917,3772,14834
"06029001500",590,748,103,154,501,498,993,1072,4659
"06029001600",350,182,136,72,180,319,238,369,1846
"06029001700",2347,667,62,0,624,121,916,153,4890
"06029001801",3341,1077,470,18,1188,118,2068,741,9021
"06029001802",3760,603,347,5,453,41,1415,249,6873
"06029001901",1994,464,92,0,981,208,1294,389,5422
"06029001902",1797,722,319,279,1067,869,1486,1059,7598
"06029002000",1096,1324,1428,486,1245,1776,1979,2272,11606
"06029002100",1126,801,153,272,560,191,1586,973,5662
"06029002200",1097,2259,574,387,912,667,1832,2811,10539
"06029002301",4454,2284,451,365,1699,401,5232,2364,17250
"06029002302",1273,893,0,15,647,446,1885,1255,6414
"06029002400",2926,1266,604,86,2069,794,3673,1799,13217
"06029002500",3238,3055,497,295,1266,685,3831,3517,16384
"06029002600",1337,460,440,328,662,395,1769,709,6100
"06029002700",2210,1050,174,137,2064,356,2843,1168,10002
"06029002804",2282,113,20,20,90,22,560,60,3167
"06029002806",1170,55,46,0,278,50,328,0,1927
"06029002807",3035,26,63,18,292,61,726,24,4245
"06029002808",4670,937,558,117,1505,344,1347,826,10304
"06029002811",2546,33,94,0,698,17,355,0,3743
"06029002812",2669,1133,168,576,261,575,1573,1107,8062
"06029002813",2249,493,252,265,674,175,1483,200,5791
"06029002814",2082,838,404,80,818,107,1618,708,6655
"06029002815",2694,591,444,408,437,202,1563,501,6840
"06029002816",3512,715,369,313,802,141,2558,473,8883
"06029002817",2359,699,497,81,723,300,1408,697,6764
"06029002818",2521,541,204,13,478,34,612,391,4794
"06029002819",2696,609,199,31,789,46,1038,175,5583
"06029002820",4064,238,200,17,1559,45,1777,71,7971
"06029002821",3606,168,108,1,517,272,1291,287,6250
"06029002900",2756,577,502,426,1742,1074,2893,1166,11136
"06029003000",2661,2484,361,117,1951,377,3418,2671,14040
"06029003103",1808,836,70,2,767,302,1861,1007,6653
"06029003112",2915,563,644,181,1251,236,2319,366,8475
"06029003113",1700,600,399,71,1529,599,2181,538,7617
"06029003114",3403,1246,445,464,1656,297,2360,1275,11146
"06029003115",1817,697,491,243,1548,756,2356,907,8815
"06029003121",3538,2955,439,333,745,641,3215,2711,14577
"06029003122",4280,1709,372,272,1458,429,4244,1990,14754
"06029003123",9021,829,1229,96,5160,328,6407,754,23824
"06029003124",2942,347,428,38,1470,106,2015,251,7597
"06029003202",8821,1901,333,381,4040,1164,9790,2509,28939
"06029003203",1669,34,51,1,322,21,517,0,2615
"06029003204",5606,268,614,0,1995,171,1651,206,10511
"06029003205",4804,765,789,325,2814,675,4571,1116,15859
"06029003206",5069,1574,426,210,4989,1008,4982,1761,20019
"06029003303",985,368,2,0,181,52,200,149,1937
"06029003304",1863,314,0,0,111,11,518,134,2951
"06029003305",2815,373,0,0,198,23,361,0,3770
"06029003306",3830,231,24,0,287,96,392,66,4926
"06029003400",2484,1251,0,0,302,68,942,785,5832
"06029003500",4516,964,0,0,643,149,1433,78,7783
"06029003600",3571,797,101,14,430,23,1037,361,6334
"06029003700",2578,699,38,51,395,155,1618,726,6260
"06029003803",3969,191,17,0,561,84,1144,11,5977
"06029003804",11811,466,299,11,2232,207,3449,152,18627
"06029003805",7730,168,151,0,949,68,2694,36,11796
"06029003806",3074,132,106,22,1111,109,867,115,5536
"06029003807",2086,113,38,0,486,0,392,0,3115
"06029003808",2834,385,86,0,670,53,1139,269,5436
"06029003809",8563,868,438,0,1217,38,2360,145,13629
"06029003810",1938,179,66,12,255,47,243,15,2755
"06029003811",2143,154,0,0,182,55,398,55,2987
"06029003812",3071,256,323,0,986,65,794,19,5514
"06029003813",5854,25,269,0,1397,34,1591,3,9173
"06029003900",374,243,6,6,78,0,230,187,1124
"06029004000",5146,968,0,8,993,203,5263,993,13574
"06029004101",3167,651,46,25,758,244,2449,821,8161
"06029004102",3166,959,0,0,822,383,3477,1305,10112
"06029004200",727,351,5,23,51,122,494,473,2246
"06029004301",4558,1814,319,18,840,360,4615,2041,14565
"06029004302",0,0,0,0,0,0,0,0,0
"06029004401",4729,1478,0,23,727,230,4302,1583,13072
"06029004402",2041,1781,116,187,277,526,2072,2288,9288
"06029004500",2222,1148,18,0,224,29,2245,1146,7032
"06029004601",0,0,0,0,0,0,0,0,0
"06029004603",0,0,0,0,0,0,0,0,0
"06029004604",6799,2112,8,0,3162,391,8171,2261,22904
"06029004701",4687,2148,0,8,908,261,5077,2283,15372
"06029004702",1965,1410,0,0,543,139,2450,1413,7920
"06029004800",3764,3938,21,150,1782,557,4844,4137,19193
"06029004901",2277,1061,1,6,1236,600,2639,1224,9044
"06029004902",3811,1316,14,0,2722,851,4475,1504,14693
"06029005003",1257,870,134,134,601,90,1460,902,5448
"06029005004",3020,1496,41,0,1759,463,3495,1777,12051
"06029005103",1998,113,0,0,63,32,245,0,2451
"06029005104",2880,153,50,0,251,0,467,6,3807
"06029005201",3935,934,6,0,168,14,71,33,5161
"06029005203",2948,1010,0,0,215,230,153,0,4556
"06029005204",3699,1249,13,57,246,76,380,336,6056
"06029005300",1202,483,70,143,133,7,453,141,2632
"06029005401",4559,503,149,29,967,86,936,170,7399
"06029005402",4019,161,114,16,610,47,412,26,5405
"06029005403",4996,624,509,150,1257,173,1206,213,9128
"06029005404",4268,733,194,383,1056,331,785,526,8276
"06029005501",4269,946,52,0,435,164,287,238,6391
"06029005506",3840,723,124,28,846,93,1386,367,7407
"06029005507",3923,360,781,957,933,414,1167,322,8857
"06029005508",3118,854,130,172,682,267,1081,611,6915
"06029005600",1455,336,28,263,138,96,225,96,2637
"06029005700",1465,61,147,5,231,0,246,19,2174
"06029005801",4064,336,774,88,1197,131,1801,209,8600
"06029005802",3178,1618,249,299,1915,335,1817,1324,10735
"06029005900",1442,450,58,269,666,565,1304,682,5436
"06029006002",281,95,0,0,0,0,76,57,509
"06029006003",3781,980,0,32,355,115,1264,433,6960
"06029006004",1093,425,0,0,215,14,99,130,1976
"06029006006",2520,129,80,0,251,69,381,155,3585
"06029006007",5768,707,18,0,99,55,1483,264,8394
"06029006008",5147,351,43,0,584,0,459,0,6584
"06029006100",6711,971,87,1,566,73,1971,482,10862
"06029006201",1937,458,19,0,511,260,1763,613,5561
"06029006202",3107,1711,129,3,1183,248,4123,1780,12284
"06029006301",2316,1030,16,16,536,214,2672,1041,7841
"06029006303",3872,2160,127,20,693,242,4429,2085,13628
"06029006304",2334,1054,95,0,144,91,2267,1085,7070
"06029006401",4836,2175,5,9,1077,709,5651,2772,17234
"06029006403",3661,1253,0,0,1258,104,4686,1232,12194
"06029006404",1615,1283,7,0,342,251,1723,1522,6743
"06029006500",1180,660,51,73,299,102,262,234,2861
"06031000100",2950,297,42,0,304,121,966,271,4951
"06031000200",1593,249,24,3,330,56,684,216,3155
"06031000300",3033,345,399,274,1147,74,891,109,6272
"06031000402",3114,630,746,66,573,58,1263,430,6880
"06031000403",2871,348,316,101,1132,590,1308,580,7246
"06031000404",6778,736,398,16,1839,175,3241,665,13848
"06031000405",2934,752,245,57,1223,276,1868,696,8051
"06031000500",3132,554,48,82,979,449,2373,773,8390
"06031000601",5619,988,401,25,2047,534,2365,715,12694
"06031000602",4729,265,465,0,189,153,718,290,6809
"06031000701",4120,460,230,0,870,17,1546,224,7467
"06031000702",3388,597,0,7,491,0,1612,239,6334
"06031000800",3050,906,199,2,345,217,1801,904,7424
"06031000900",4092,1858,410,117,888,519,2759,1959,12602
"06031001001",3115,131,52,1,771,86,1601,75,5832
"06031001002",2373,1402,86,16,663,174,2140,1174,8028
"06031001003",3571,1094,183,39,720,71,3058,974,9710
"06031001100",2399,1235,446,366,1172,402,2574,1548,10142
"06031001200",2195,230,16,9,305,17,1119,132,4023
"06031001300",2404,1277,207,132,267,150,2244,1183,7864
"06031001401",2019,558,25,0,366,94,2150,582,5794
"06031001402",1012,623,18,0,448,47,1179,446,3773
"06031001500",2806,790,24,41,483,208,2316,921,7589
"06031001601",2143,818,33,5,883,522,2116,993,7513
"06031001602",0,0,0,0,0,0,0,0,0
"06031001701",3899,3604,96,10,2658,893,5962,4278,21400
"06031981800",0,0,0,0,0,0,0,0,0
"06033000100",1757,414,15,0,310,121,284,150,3051
"06033000300",2500,483,0,0,258,107,510,145,4003
"06033000400",3988,699,50,34,440,92,657,58,6018
"06033000501",1621,668,30,69,272,598,250,89,3597
"06033000502",1606,489,0,7,80,96,99,63,2440
"06033000600",2291,1118,70,17,135,113,68,93,3905
"06033000701",2795,943,216,311,254,122,190,198,5029
"06033000702",1753,859,18,172,642,283,722,75,4524
"06033000801",1300,447,255,0,277,290,326,211,3106
"06033000802",1512,1489,84,16,454,562,476,961,5554
"06033000900",5086,1217,28,18,290,45,562,146,7392
"06033001000",3710,595,59,0,1100,1125,1291,1186,9066
"06033001100",2798,742,0,0,281,61,203,216,4301
"06033001200",2589,375,0,0,513,82,500,71,4130
"06033001300",5445,951,0,0,633,30,981,308,8348
"06035040100",1027,103,0,0,65,20,40,20,1275
"06035040200",1645,450,0,1,102,49,31,32,2310
"06035040302",2921,522,79,14,352,38,313,40,4279
"06035040303",2182,894,0,132,206,132,167,133,3846
"06035040304",1071,390,29,10,226,32,156,19,1933
"06035040305",3245,505,46,0,553,112,395,27,4883
"06035040400",807,74,12,0,75,26,106,23,1123
"06035040500",2880,222,0,10,58,20,31,14,3235
"06035040600",1405,158,140,39,335,0,94,12,2183
"06037101110",3104,491,26,10,871,432,1068,467,6469
"06037101122",2420,57,30,0,901,91,449,91,4039
"06037101210",3511,805,157,178,1299,644,2338,940,9872
"06037101220",1660,461,95,8,723,168,780,152,4047
"06037101300",3387,194,20,0,578,23,625,10,4837
"06037101400",2476,511,101,78,749,117,566,51,4649
"06037102103",1523,16,0,0,211,5,406,0,2161
"06037102104",2347,95,14,0,515,0,446,0,3417
"06037102105",1194,239,0,0,351,63,1153,222,3222
"06037102107",2339,421,0,55,376,212,650,352,4405
"06037103101",2111,165,6,1,419,84,644,140,3570
"06037103102",3532,367,32,0,1158,25,1380,120,6614
"06037103200",3963,560,128,21,769,394,1595,613,8043
"06037103300",2441,391,10,2,380,22,274,217,3737
"06037103400",4578,473,144,11,1316,113,1260,57,7952
"06037104103",1797,101,462,37,1036,38,2348,118,5937
"06037104105",1688,1049,371,140,1745,614,2821,1628,10056
"06037104108",2404,281,302,162,1397,841,3502,1033,9922
"06037104124",2383,453,462,90,630,26,1797,370,6211
"06037104201",2735,347,606,30,372,490,3113,837,8530
"06037104203",1604,1032,275,28,1233,326,2609,1302,8409
"06037104204",1033,716,138,95,1240,133,1836,779,5970
"06037104310",2112,723,287,20,1356,163,3404,856,8921
"06037104320",1864,607,195,25,2823,239,4627,774,11154
"06037104401",2091,618,17,0,516,0,2566,613,6421
"06037104403",1240,524,5,0,886,595,2021,1059,6330
"06037104404",1292,573,29,0,721,159,1851,721,5346
"06037104500",1762,565,0,0,592,106,2263,653,5941
"06037104610",1470,731,0,0,856,497,2316,1213,7083
"06037104620",1600,358,0,0,1157,287,2732,645,6779
"06037104701",1208,1041,215,99,1099,418,2302,1465,7847
"06037104703",768,419,14,26,680,193,1421,612,4133
"06037104704",1756,403,350,227,1250,109,2624,495,7214
"06037104810",2718,653,52,1,1203,600,3751,1169,10147
"06037104821",1997,306,47,17,845,208,2740,526,6686
"06037104822",854,458,0,5,528,186,1264,574,3869
"06037106010",1419,278,48,8,852,26,1574,196,4401
"06037106020",2388,204,64,214,2870,147,4204,232,10323
"06037106111",2440,321,125,0,1259,201,2281,385,7012
"06037106112",3120,722,52,0,1565,223,3586,690,9958
"06037106113",1983,57,52,50,1133,203,2622,221,6321
"06037106114",2242,1129,104,167,1611,233,3343,1067,9896
"06037106403",2108,140,0,0,840,49,2515,171,5823
"06037106405",1291,213,127,66,1228,277,2048,445,5695
"06037106406",2202,362,210,68,2166,34,3036,345,8423
"06037106407",981,429,146,21,512,391,1142,728,4350
"06037106408",1655,590,36,6,1162,316,2596,793,7154
"06037106510",2680,406,175,0,1286,22,2933,341,7843
"06037106520",3146,871,14,2,928,308,3373,1112,9754
"06037106603",1996,54,152,6,957,16,616,0,3797
"06037106604",2374,646,129,0,1355,141,3187,764,8596
"06037106641",1475,22,5,0,607,18,198,3,2328
"06037106642",2204,206,163,28,799,70,794,89,4353
"06037106643",2746,95,538,3,938,13,512,2,4847
"06037106645",2459,38,211,0,713,63,303,62,3849
"06037106646",2472,220,43,0,752,37,1211,47,4782
"06037106648",2390,910,19,14,613,449,2757,1320,8472
"06037106649",1547,195,18,0,853,88,1539,193,4433
"06037107010",1789,286,0,0,966,123,2481,372,6017
"06037107020",2953,644,16,0,1122,629,3335,1266,9965
"06037108101",1411,41,93,2,705,39,265,19,2575
"06037108102",2203,25,140,0,1210,189,366,18,4151
"06037108103",2089,16,151,0,1018,26,231,0,3531
"06037108104",1282,114,5,0,469,0,200,0,2070
"06037108201",2357,121,341,38,2613,112,295,18,5895
"06037108202",2788,228,36,16,2377,121,482,0,6048
"06037109100",1513,112,0,0,591,0,1310,63,3589
"06037109200",1447,237,5,15,1052,0,1127,133,4016
"06037109300",1812,100,251,13,1191,13,1544,7,4931
"06037109400",2085,15,74,0,1306,222,2616,222,6540
"06037109500",3029,410,6,0,1063,226,3767,578,9079
"06037109601",2409,160,421,0,1858,309,2899,403,8459
"06037109603",1930,189,170,0,1482,137,1888,281,6077
"06037109604",1479,291,49,7,1088,61,1578,309,4862
"06037109700",2058,245,0,3,1964,109,1513,193,6085
"06037109800",2400,240,37,14,1394,228,1793,195,6301
"06037111100",1439,103,203,9,1203,97,1120,77,4251
"06037111201",2365,108,1,0,696,18,679,0,3867
"06037111202",3182,272,89,3,1423,210,1449,174,6802
"06037111204",3757,275,331,0,1586,134,829,136,7048
"06037111205",1397,212,454,67,1650,77,609,0,4466
"06037111206",2657,235,285,27,1285,122,853,133,5597
"06037111301",3454,692,463,99,2534,339,2061,157,9799
"06037111302",2321,266,221,91,1580,149,936,75,5639
"06037111400",4502,1088,286,19,1795,326,2191,918,11125
"06037113101",2605,138,93,3,807,113,537,4,4300
"06037113102",2187,41,9,0,590,104,545,28,3504
"06037113211",2607,122,151,7,1114,38,528,17,4584
"06037113212",1641,50,176,0,1121,35,758,22,3803
"06037113213",2268,307,102,27,1578,147,1151,215,5795
"06037113231",1498,82,12,0,551,28,307,64,2542
"06037113232",2861,119,4,12,995,38,487,33,4549
"06037113233",2254,291,22,28,3288,1012,3326,1112,11333
"06037113234",1381,237,103,80,1944,997,1431,1126,7299
"06037113235",1287,151,67,0,109,23,253,0,1890
"06037113237",2319,148,225,0,1006,149,446,153,4446
"06037113301",1533,71,132,0,561,7,410,24,2738
"06037113303",2796,141,63,0,1130,54,1256,41,5481
"06037113321",2308,285,291,42,2325,575,1621,600,8047
"06037113322",2563,119,123,31,1053,235,657,233,5014
"06037113401",2796,360,208,0,1689,173,2106,229,7561
"06037113421",1893,431,308,111,2310,1516,2161,1556,10286
"06037113422",2908,223,392,153,2343,550,2650,480,9699
"06037115101",3942,102,210,0,998,0,687,3,5942
"06037115103",24,65,0,0,53,27,0,9,178
"06037115104",1377,518,205,191,899,479,590,277,4536
"06037115201",2809,759,577,49,2379,430,1820,335,9158
"06037115202",2315,676,332,44,1279,300,1297,458,6701
"06037115301",1877,402,89,43,1266,213,965,129,4984
"06037115302",866,427,145,11,1930,628,2112,1005,7124
"06037115401",2746,343,445,12,1585,825,1653,891,8500
"06037115403",1426,445,194,15,1071,378,1369,704,5602
"06037115404",1499,172,27,77,613,490,1016,483,4377
"06037117101",1750,457,99,0,2568,233,2072,660,7839
"06037117102",1341,75,19,4,1201,22,1637,56,4355
"06037117201",1658,679,57,14,1293,1200,1811,1759,8471
"06037117202",1258,50,92,0,1072,17,917,12,3418
"06037117301",2471,54,195,55,1293,56,1184,70,5378
"06037117302",3177,124,91,14,1549,139,1566,115,6775
"06037117303",2014,129,155,0,1248,54,1265,24,4889
"06037117404",2399,132,193,30,1306,34,1588,52,5734
"06037117405",802,1043,0,20,1067,817,1767,1787,7303
"06037117407",1046,804,42,0,967,618,1853,1389,6719
"06037117408",887,737,147,62,737,652,1459,1341,6022
"06037117510",1465,831,86,59,970,503,2164,1255,7333
"06037117520",898,811,116,68,1146,492,1645,1241,6417
"06037117530",1578,963,68,69,2078,847,2858,1599,10060
"06037119001",2334,227,0,0,1242,46,2402,111,6362
"06037119002",3761,611,66,32,1670,806,4674,1239,12859
"06037119201",2566,130,8,2,1156,193,3360,302,7717
"06037119202",1552,499,79,1,1873,239,3070,629,7942
"06037119310",1763,438,104,22,1175,112,2237,465,6316
"06037119320",1145,638,142,47,1894,785,2044,1167,7862
"06037119340",993,904,27,19,1412,558,2238,1420,7571
"06037119341",812,269,40,17,1193,207,1162,307,4007
"06037119342",814,368,74,16,1412,812,1797,1011,6304
"06037119400",3293,541,29,0,1365,120,3771,604,9723
"06037119700",1958,327,73,0,1800,384,1542,429,6513
"06037119800",2856,266,35,3,2760,135,4507,238,10800
"06037119900",2701,244,9,0,1854,203,3014,360,8385
"06037120010",1044,263,24,0,1516,146,1911,383,5287
"06037120020",1398,659,64,59,2065,938,2595,1536,9314
"06037120030",760,299,0,52,1056,758,1565,1036,5526
"06037120103",600,670,46,138,1219,824,1791,1509,6797
"06037120104",449,596,159,53,1065,342,974,812,4450
"06037120105",1096,199,80,0,907,694,1276,763,5015
"06037120106",1148,448,82,0,1555,1011,2337,1162,7743
"06037120107",569,711,54,172,1315,921,1649,1504,6895
"06037120108",1647,604,0,105,1425,816,2600,1151,8348
"06037120300",2402,41,16,2,2524,441,2954,232,8612
"06037120400",1461,777,384,70,3363,820,2491,1053,10419
"06037121010",2712,550,27,2,1384,236,2463,596,7970
"06037121020",1517,478,17,39,1094,186,1634,514,5479
"06037121101",1490,711,64,3,732,39,1462,575,5076
"06037121102",1631,385,10,2,487,34,1093,305,3947
"06037121210",1269,420,13,11,788,257,1455,558,4771
"06037121221",1247,131,84,13,553,77,1657,155,3917
"06037121222",2355,1229,283,0,544,53,2279,1208,7951
"06037121600",1584,200,91,4,948,63,1087,19,3996
"06037121801",1460,502,88,49,1214,448,2036,660,6457
"06037121802",1669,340,41,184,872,191,1846,233,5376
"06037121900",1846,523,47,0,1692,67,2744,520,7439
"06037122000",2420,610,109,11,2255,156,2431,202,8194
"06037122120",3033,719,84,3,1011,98,3021,707,8676
"06037122121",1638,497,0,16,846,37,1985,473,5492
"06037122122",1138,445,23,112,374,0,1369,285,3746
"06037122200",2719,769,0,0,532,210,2704,948,7882
"06037122410",1145,385,70,127,1099,739,1924,960,6449
"06037122420",1790,926,107,7,1642,557,2859,1443,9331
"06037123010",2291,917,34,25,1071,314,2866,1210,8728
"06037123020",1920,387,4,4,789,266,2322,534,6226
"06037123103",2333,259,67,39,1691,198,2546,366,7499
"06037123104",1952,228,51,37,1439,573,2266,700,7246
"06037123203",1356,469,29,82,1302,586,1981,1004,6809
"06037123204",1372,591,30,2,929,438,1446,952,5760
"06037123205",882,431,104,12,1033,428,1552,818,5260
"06037123206",840,188,86,0,910,716,1496,844,5080
"06037123301",1814,232,365,60,1717,356,1513,439,6496
"06037123303",1519,377,19,65,1077,316,1520,356,5249
"06037123304",1944,751,93,271,1510,142,1708,653,7072
"06037123410",1781,771,270,34,891,210,1404,771,6132
"06037123420",1972,879,78,23,1189,308,1660,958,7067
"06037123510",1849,412,54,55,1814,636,1829,620,7269
"06037123520",1370,493,238,157,294,165,1206,356,4279
"06037123601",3180,478,70,201,1271,268,1701,361,7530
"06037123602",1911,364,241,138,446,312,633,431,4476
"06037123700",2277,594,86,19,938,98,1007,222,5241
"06037123800",3110,440,437,396,712,115,1203,245,6658
"06037123901",2012,423,63,74,1652,257,2081,527,7089
"06037123902",1709,206,74,0,406,215,560,160,3330
"06037124000",3690,277,55,14,576,70,511,107,5300
"06037124102",1966,298,323,27,714,410,1271,489,5498
"06037124103",314,497,16,0,992,204,784,669,3476
"06037124104",781,187,259,61,1052,438,1429,408,4615
"06037124105",1068,609,61,0,618,242,958,581,4137
"06037124201",1472,131,118,11,1624,118,1866,165,5505
"06037124203",1140,417,119,74,630,279,1434,536,4629
"06037124204",1722,754,142,33,383,176,1151,704,5065
"06037124300",2375,429,22,7,950,99,2389,222,6493
"06037124400",2944,534,235,25,195,108,501,226,4768
"06037124500",1986,240,135,0,680,14,907,16,3978
"06037124600",2337,181,79,0,683,26,545,26,3877
"06037124700",3537,212,210,15,471,170,561,1,5177
"06037124902",2033,246,77,0,519,18,835,63,3791
"06037124903",1851,568,298,122,313,17,602,155,3926
"06037125100",3799,296,377,0,856,93,1064,51,6536
"06037125200",2610,402,66,29,673,140,1053,305,5278
"06037125310",2092,670,426,129,618,314,1073,528,5850
"06037125320",2843,602,385,49,1076,279,1295,218,6747
"06037125401",1739,529,415,53,825,124,639,426,4750
"06037125402",2605,299,315,42,602,29,908,100,4900
"06037125501",1851,284,437,7,503,88,1000,182,4352
"06037125502",1677,432,221,40,487,173,341,238,3609
"06037125600",2028,142,181,0,290,14,261,0,2916
"06037127102",2005,922,138,39,1750,828,2392,1210,9284
"06037127103",756,269,26,31,1588,384,1766,492,5312
"06037127104",1479,692,98,10,1393,477,1249,786,6184
"06037127210",2457,725,186,59,1449,598,1946,1080,8500
"06037127220",1325,687,157,89,1955,986,2125,1411,8735
"06037127300",1732,584,106,106,1539,426,1840,472,6805
"06037127400",1537,647,218,59,2425,1092,2992,1443,10413
"06037127520",615,243,200,55,1901,894,2165,999,7072
"06037127603",1090,282,170,6,983,468,1380,534,4913
"06037127604",1176,495,195,29,748,279,1239,270,4431
"06037127605",734,307,215,0,1635,433,1739,731,5794
"06037127606",1285,249,164,99,1620,321,1814,367,5919
"06037127711",1747,138,366,0,1009,361,1634,364,5619
"06037127712",822,469,104,0,801,533,1062,601,4392
"06037127803",1308,415,148,15,1553,298,1727,446,5910
"06037127804",1397,295,220,16,1453,395,1282,470,5528
"06037127805",1034,400,337,22,1940,429,1828,698,6688
"06037127806",1652,563,149,0,848,328,1843,631,6014
"06037127910",1934,274,117,93,1805,1139,2729,1066,9157
"06037127920",1958,519,35,10,703,359,1157,690,5431
"06037128101",1916,335,28,38,1046,84,1250,269,4966
"06037128102",1773,485,153,65,1156,873,1721,1180,7406
"06037128210",1190,858,188,52,1608,1315,2308,2083,9602
"06037128220",1256,339,111,12,1021,166,1150,118,4173
"06037128302",2185,1199,119,11,953,621,2551,1409,9048
"06037128303",1169,963,77,48,833,375,1622,1297,6384
"06037128400",2957,203,214,0,687,33,1294,36,5424
"06037128500",2792,376,417,17,509,152,885,94,5242
"06037128601",1865,586,59,101,767,635,955,1008,5976
"06037128602",2285,218,43,8,326,0,344,114,3338
"06037128702",3530,490,177,0,1032,147,724,255,6355
"06037128801",2391,272,175,60,395,62,336,106,3797
"06037128802",3755,166,63,1,688,39,993,22,5727
"06037128910",2747,169,150,1,479,19,224,17,3806
"06037131010",2712,1505,174,15,1668,312,2656,1317,10359
"06037131020",3101,636,176,31,1418,209,3091,626,9288
"06037131100",1938,118,116,0,1263,175,1351,89,5050
"06037131200",1728,318,311,0,789,111,940,51,4248
"06037131300",2762,322,0,0,1752,201,2301,368,7706
"06037131400",3148,457,357,70,1403,117,2354,311,8217
"06037131600",2872,311,109,1,1973,117,2297,195,7875
"06037131701",2757,441,167,51,1098,355,1791,309,6969
"06037131702",1284,583,171,67,1359,10,1421,501,5396
"06037131800",3166,779,8,0,1778,188,2997,675,9591
"06037131900",2953,530,32,0,1091,199,2520,422,7747
"06037132001",1870,183,37,3,1078,29,1180,16,4396
"06037132002",1545,165,62,17,1379,93,941,164,4366
"06037132101",2014,229,361,70,1168,280,1870,338,6330
"06037132102",2276,843,230,9,1477,196,1437,577,7045
"06037132300",3924,1207,20,76,1371,473,3248,873,11192
"06037132501",1846,172,0,21,955,87,1078,67,4226
"06037132502",1869,197,347,0,841,438,1409,240,5341
"06037132700",2916,1220,0,0,860,314,1933,1100,8343
"06037132900",2860,229,71,1,453,170,770,229,4783
"06037133000",2747,408,27,2,1488,31,2671,357,7731
"06037133100",3567,660,212,2,1054,86,2369,306,8256
"06037134001",1566,576,139,29,1316,214,2369,745,6954
"06037134002",1323,430,57,30,1705,147,1854,429,5975
"06037134101",2473,369,135,23,2258,762,1992,786,8798
"06037134103",1435,387,447,8,1748,349,1214,609,6197
"06037134104",1001,115,288,104,2157,487,1164,479,5795
"06037134201",1755,108,156,4,2049,377,2026,320,6795
"06037134302",2435,80,52,23,1084,1,839,1,4515
"06037134303",3335,404,282,0,1336,75,1743,294,7469
"06037134304",1274,162,128,59,964,339,602,333,3861
"06037134305",471,926,51,0,1927,1215,1871,1881,8342
"06037134306",1001,107,82,44,1629,461,1309,336,4969
"06037134421",2936,198,117,2,659,9,269,0,4190
"06037134422",2764,426,164,13,1348,38,321,63,5137
"06037134423",2502,199,200,0,604,25,196,117,3843
"06037134424",2048,3,141,0,645,0,239,0,3076
"06037134520",2102,845,172,9,1676,433,2929,1067,9233
"06037134521",1311,290,60,20,548,200,1533,481,4443
"06037134522",1442,556,58,0,1351,346,2152,721,6626
"06037134710",1183,291,94,31,2670,1489,2543,1648,9949
"06037134720",1489,224,205,22,2506,457,2100,265,7268
"06037134800",2727,357,282,47,2216,290,2162,368,8449
"06037134901",1943,327,128,18,399,141,646,144,3746
"06037134903",2642,213,192,26,1416,128,1925,47,6589
"06037134904",2147,379,164,0,1680,231,1984,465,7050
"06037134905",1751,139,376,2,560,43,463,15,3349
"06037135102",2054,460,36,0,948,181,335,164,4178
"06037135111",1909,150,195,30,613,76,588,18,3579
"06037135113",1239,146,536,199,734,37,218,51,3160
"06037135114",1822,369,211,41,1777,144,356,113,4833
"06037135201",1901,149,112,50,420,17,285,12,2946
"06037135202",3080,266,38,4,955,17,557,0,4917
"06037135203",4688,387,85,186,1892,60,1633,19,8950
"06037137000",3885,77,239,41,597,31,351,17,5238
"06037137103",2468,237,84,8,1521,0,904,8,5230
"06037137104",2067,79,144,0,288,142,239,15,2974
"06037137201",3474,405,422,22,1151,135,501,66,6176
"06037137301",1530,58,12,0,602,82,173,33,2490
"06037137302",3848,277,142,0,294,10,254,8,4833
"06037137401",3113,177,14,17,688,132,490,7,4638
"06037137402",3916,601,392,50,892,0,759,19,6629
"06037137501",2429,234,112,0,704,135,629,84,4327
"06037137502",2884,131,223,24,572,12,680,41,4567
"06037137504",1701,55,13,0,116,0,11,8,1904
"06037138000",3872,248,100,0,344,8,174,20,4766
"06037139001",3175,495,139,37,891,170,810,460,6177
"06037139200",3485,657,242,1,931,77,859,395,6647
"06037139301",4023,404,22,49,552,0,409,0,5459
"06037139302",1907,508,398,98,1146,114,1066,260,5497
"06037139303",1814,844,131,49,1357,293,1026,332,5846
"06037139401",1802,166,48,56,651,238,697,219,3877
"06037139402",2542,470,11,16,122,22,163,54,3400
"06037139502",2240,233,9,0,248,123,140,0,2993
"06037139503",3020,1118,291,84,609,75,353,32,5582
"06037139504",2641,436,83,0,185,100,217,0,3662
"06037139600",3993,582,237,14,277,28,272,106,5509
"06037139701",4199,197,39,1,460,0,69,0,4965
"06037139702",5144,296,64,0,313,46,276,18,6157
"06037139703",2176,189,9,2,349,5,91,41,2862
"06037139801",2704,67,59,0,380,0,163,0,3373
"06037139802",3177,128,12,0,393,81,188,24,4003
"06037141101",3280,344,103,19,546,39,628,116,5075
"06037141102",2277,88,172,0,433,77,157,51,3255
"06037141201",2572,415,142,0,487,149,716,58,4539
"06037141202",2204,169,51,0,334,0,123,0,2881
"06037141302",3509,682,423,14,902,139,492,81,6242
"06037141303",2320,453,30,0,550,6,105,96,3560
"06037141304",2364,135,118,55,419,47,314,9,3461
"06037141400",3366,415,39,0,652,28,348,50,4898
"06037141500",2545,90,0,0,401,0,226,0,3262
"06037141600",3167,92,138,41,264,0,73,0,3775
"06037141700",2641,180,39,0,327,10,159,10,3366
"06037143100",3428,167,112,111,334,97,295,34,4578
"06037143200",2648,263,228,1,879,40,936,20,5015
"06037143300",4553,279,583,22,798,68,720,24,7047
"06037143400",4877,358,255,56,784,72,591,91,7084
"06037143500",3625,297,194,0,290,83,378,88,4955
"06037143602",2957,257,139,0,413,151,271,53,4241
"06037143603",1430,178,167,11,400,37,340,62,2625
"06037143604",1993,136,268,68,498,60,306,53,3382
"06037143700",2971,111,161,0,449,15,157,0,3864
"06037143800",4011,257,210,22,559,55,818,21,5953
"06037143901",3454,120,11,4,302,54,125,1,4071
"06037143902",2239,83,108,14,229,32,218,33,2956
"06037181000",3141,388,101,1,2507,0,1990,351,8479
"06037181300",1903,154,10,0,1696,116,1589,153,5621
"06037181400",2090,539,70,88,1678,220,1632,191,6508
"06037181500",1789,149,25,2,1514,12,1158,102,4751
"06037181600",1829,110,13,0,797,122,1576,137,4584
"06037183101",2454,73,31,33,1292,166,2567,170,6786
"06037183103",1346,259,207,29,1763,230,1968,392,6194
"06037183104",1103,72,13,6,825,39,881,72,3011
"06037183220",1940,473,9,11,1599,392,2534,790,7748
"06037183221",2024,296,8,1,666,205,1748,449,5397
"06037183222",1430,499,130,15,1024,136,1267,384,4885
"06037183300",1664,356,13,0,1187,406,1951,560,6137
"06037183401",676,182,30,22,1741,132,1270,188,4241
"06037183402",1143,331,0,1,1025,346,945,354,4145
"06037183510",1382,134,16,0,870,182,1771,252,4607
"06037183520",1880,452,56,73,819,306,2261,725,6572
"06037183610",1169,442,29,59,1156,311,1726,660,5552
"06037183620",1542,214,32,10,898,315,1658,470,5139
"06037183701",1097,289,205,35,832,528,1544,812,5342
"06037183702",1388,318,113,0,1234,75,1528,297,4953
"06037183810",1930,578,0,13,925,750,2381,1164,7741
"06037183820",1232,589,81,21,1047,681,2122,1186,6959
"06037185100",2999,732,216,14,1779,523,2234,796,9293
"06037185202",1306,407,121,48,1223,829,1826,1075,6835
"06037185203",1253,237,17,0,1401,235,2148,393,5684
"06037185204",789,283,54,0,819,16,485,270,2716
"06037185310",1151,354,57,0,1264,733,2055,1051,6665
"06037185320",1099,231,0,0,1290,256,2235,379,5490
"06037186100",1710,351,49,0,2319,182,1327,256,6194
"06037186201",1339,264,0,0,1103,253,1112,231,4302
"06037186202",622,134,143,0,1008,64,670,102,2743
"06037186203",1569,311,25,0,525,275,821,284,3810
"06037186301",789,246,60,11,1112,419,1441,653,4731
"06037186302",1476,160,88,16,2067,351,1621,435,6214
"06037186401",1058,358,68,5,1560,632,2053,892,6626
"06037186403",844,100,23,31,1701,338,1998,191,5226
"06037186404",899,206,5,7,749,495,1415,659,4435
"06037187101",1341,402,21,1,1264,109,861,133,4132
"06037187102",1357,98,0,0,1346,38,1619,89,4547
"06037187200",1135,189,36,21,1329,329,1853,466,5358
"06037187300",1758,174,52,12,1128,50,501,49,3724
"06037188100",1391,583,60,17,1416,256,1536,697,5956
"06037188201",2107,220,49,1,805,58,347,37,3624
"06037188202",1362,78,68,50,861,31,142,57,2649
"06037188300",1760,176,38,0,1187,149,897,233,4440
"06037189101",1645,384,56,0,613,78,439,128,3343
"06037189102",2028,212,16,0,539,101,457,8,3361
"06037189201",2038,422,36,54,745,70,468,11,3844
"06037189202",2033,79,22,18,474,19,352,10,3007
"06037189300",2347,129,26,0,609,66,177,49,3403
"06037189400",2555,242,79,0,375,116,82,0,3449
"06037189500",3151,285,244,0,607,64,589,84,5024
"06037189600",2247,283,386,16,412,180,318,62,3904
"06037189701",2383,623,154,37,568,162,372,158,4457
"06037189702",1806,111,38,0,115,65,114,27,2276
"06037189800",2806,386,208,102,539,120,386,49,4596
"06037189902",3297,546,310,0,707,177,577,92,5706
"06037189903",1371,315,90,22,232,30,176,14,2250
"06037189904",1558,380,85,0,376,66,127,13,2605
"06037189905",1673,350,64,0,357,7,189,0,2640
"06037190100",2457,738,401,68,753,273,764,153,5607
"06037190201",998,569,0,21,494,366,594,314,3356
"06037190202",1161,533,231,141,536,477,356,279,3714
"06037190301",2624,583,128,120,934,167,951,217,5724
"06037190401",1712,598,85,21,774,180,408,118,3896
"06037190402",921,888,61,11,274,139,195,174,2663
"06037190510",1367,752,187,64,1522,656,1196,655,6399
"06037190520",1058,796,37,31,1155,588,1095,610,5370
"06037190700",1225,652,124,0,851,347,942,417,4558
"06037190801",696,476,72,230,661,384,607,480,3606
"06037190802",1141,313,19,22,980,361,1175,329,4340
"06037190901",1177,451,63,162,1587,792,2366,829,7427
"06037190902",999,355,110,110,1926,539,1926,566,6531
"06037191000",1303,199,65,60,983,716,1137,712,5175
"06037191110",1679,478,119,0,625,332,620,390,4243
"06037191120",1644,559,125,75,1240,570,1751,733,6697
"06037191201",1856,758,192,62,1129,537,877,625,6036
"06037191203",855,358,41,9,917,419,684,540,3823
"06037191204",805,200,55,14,552,118,695,103,2542
"06037191301",849,244,142,41,1038,170,1118,260,3862
"06037191302",706,137,32,6,1223,373,963,336,3776
"06037191410",1079,329,76,105,2252,1064,2350,1189,8444
"06037191420",1162,283,163,27,1439,913,1815,886,6688
"06037191500",1270,727,8,26,2443,1157,2031,1629,9291
"06037191610",1345,213,100,29,2249,663,2624,791,8014
"06037191620",662,311,31,7,1238,558,1432,666,4905
"06037191710",609,377,64,24,1278,446,1320,599,4717
"06037191720",517,348,156,80,2216,954,1884,1164,7319
"06037191810",814,305,165,37,1559,1020,1487,1128,6515
"06037191820",804,224,180,0,1099,316,1029,325,3977
"06037191901",2251,481,322,23,400,314,500,344,4635
"06037191902",1854,250,84,0,730,26,616,26,3586
"06037192001",1369,351,44,22,387,127,193,54,2547
"06037192002",1730,267,49,79,364,43,245,35,2812
"06037192300",1664,147,84,31,758,87,336,32,3139
"06037192410",1623,206,29,43,1524,182,895,48,4550
"06037192420",902,369,106,15,1947,612,1086,839,5876
"06037192510",457,206,0,7,2787,398,1502,265,5622
"06037192520",743,355,52,18,2596,1236,2585,1257,8842
"06037192610",1270,486,64,42,2236,870,2850,965,8783
"06037192620",630,280,35,8,1984,809,1534,870,6150
"06037192700",638,586,42,102,1028,504,1020,667,4587
"06037194101",1972,256,137,15,357,207,268,217,3429
"06037194102",2939,170,78,0,272,0,128,0,3587
"06037194200",2739,270,71,13,476,52,102,13,3736
"06037194300",2738,343,41,0,521,57,190,46,3936
"06037194401",1465,107,75,0,545,114,414,74,2794
"06037194402",2392,462,72,5,395,182,339,114,3961
"06037194500",1611,155,63,0,273,39,131,12,2284
"06037195100",3101,283,187,0,629,116,338,61,4715
"06037195201",1878,203,29,0,706,79,498,62,3455
"06037195202",2479,53,148,0,655,19,427,0,3781
"06037195300",1653,266,41,2,1090,290,868,209,4419
"06037195400",2765,205,50,100,682,151,903,155,5011
"06037195500",3000,619,220,0,1139,46,1243,426,6693
"06037195600",1482,663,13,1,969,137,1249,689,5203
"06037195710",2139,996,202,84,1193,333,2660,1095,8702
"06037195720",1449,297,17,3,299,184,1376,321,3946
"06037195802",879,385,46,25,1136,233,1203,515,4422
"06037195803",1352,400,29,20,679,255,569,509,3813
"06037195804",1449,291,97,31,438,159,1024,222,3711
"06037195901",1042,224,12,96,854,214,794,328,3564
"06037195902",1067,299,46,8,244,260,168,396,2488
"06037195903",883,303,105,44,751,142,736,192,3156
"06037197200",980,253,0,23,2166,383,1662,372,5839
"06037197300",2048,358,20,13,1223,275,1654,401,5992
"06037197410",2065,370,48,10,1022,207,1003,403,5128
"06037197420",1603,584,58,0,1024,127,1545,433,5374
"06037197500",2472,422,40,0,936,138,1992,373,6373
"06037197600",1218,221,13,0,826,245,776,303,3602
"06037197700",1024,484,129,0,2158,1602,782,534,6713
"06037199000",1169,565,0,11,1828,1290,1706,1185,7754
"06037199110",1553,189,71,0,688,282,1917,434,5134
"06037199120",914,339,22,64,1043,1624,1528,1529,7063
"06037199201",1028,421,0,0,2046,900,2017,844,7256
"06037199202",1046,180,6,0,897,520,1460,650,4759
"06037199300",1404,433,176,0,1655,505,2221,830,7224
"06037199400",1189,275,18,55,2115,1092,2627,918,8289
"06037199700",1159,543,0,44,839,773,1416,1000,5774
"06037199800",800,571,1,0,2819,1171,1888,1168,8418
"06037199900",1003,99,31,42,856,850,1564,829,5274
"06037201110",1339,211,0,0,1123,94,2179,199,5145
"06037201120",1260,895,100,0,1703,329,2334,1083,7704
"06037201200",1684,486,7,0,498,230,2043,716,5664
"06037201301",956,305,87,2,1621,258,2146,458,5833
"06037201302",1220,119,423,0,1571,297,705,241,4576
"06037201401",1728,310,101,135,1736,927,2712,1182,8831
"06037201402",2719,381,34,0,1367,179,3036,525,8241
"06037201501",2462,347,35,9,1810,533,3483,819,9498
"06037201503",1815,726,0,2,561,229,2184,860,6377
"06037201504",1018,129,4,0,853,207,1633,317,4161
"06037201601",1334,88,11,0,721,341,1715,384,4594
"06037201602",1195,102,61,0,1387,185,1962,278,5170
"06037201700",2042,702,7,2,1323,342,2535,880,7833
"06037203100",1498,937,0,1,978,1437,2420,2061,9332
"06037203200",1802,844,0,0,1749,684,3499,1520,10098
"06037203300",459,333,108,9,477,56,663,372,2477
"06037203500",1289,516,13,0,1295,324,2041,793,6271
"06037203600",1192,837,5,22,2110,531,3180,1332,9209
"06037203710",1447,617,23,24,775,297,2172,908,6263
"06037203720",1677,893,53,0,1212,546,2863,1439,8683
"06037203800",2226,653,42,0,1568,199,3802,852,9342
"06037203900",1136,517,0,0,952,254,2067,734,5660
"06037204110",1090,488,48,12,1261,309,2297,777,6282
"06037204120",738,253,0,11,1367,234,2062,495,5160
"06037204200",1116,407,0,0,833,421,1744,743,5264
"06037204300",1189,1182,0,0,1904,751,2970,1823,9819
"06037204410",630,505,0,0,377,585,1001,1071,4169
"06037204420",826,436,25,45,675,887,1487,1255,5636
"06037204600",1586,392,0,0,2025,683,3504,1075,9265
"06037204700",1604,549,8,0,1542,738,2918,1260,8619
"06037204810",1059,327,83,18,1678,918,2664,1198,7945
"06037204820",1371,370,0,0,687,187,1929,524,5068
"06037204910",1037,340,0,2,726,861,1710,1151,5827
"06037204920",1003,388,0,0,882,310,1858,670,5111
"06037205110",977,596,6,58,1126,859,2099,1429,7150
"06037205120",916,396,0,23,1079,1031,1908,1369,6722
"06037206010",378,125,0,125,1208,1027,984,814,4661
"06037206020",135,11,60,0,203,10,20,9,448
"06037206031",1110,223,174,90,982,461,136,131,3307
"06037206032",1652,906,62,45,1544,941,2413,1548,9111
"06037206050",1044,620,11,81,237,517,1170,1087,4767
"06037206200",277,436,159,348,898,591,201,387,3297
"06037206300",274,904,581,2125,159,830,158,982,6013
"06037207101",478,149,44,76,1131,1000,229,339,3446
"06037207102",21,28,14,31,1012,1189,100,223,2618
"06037207103",68,24,18,1,1265,708,124,19,2227
"06037207301",1635,568,407,686,757,303,415,314,5085
"06037207302",1386,244,557,232,718,212,389,110,3848
"06037207400",1,5,0,0,1,14,1,4,26
"06037207501",722,88,81,0,956,123,252,19,2241
"06037207502",506,113,48,0,1018,596,197,60,2538
"06037207710",1162,166,217,23,521,505,153,131,2878
"06037207900",1418,423,273,114,1532,602,794,492,5648
"06037208000",2591,1417,139,86,1764,1012,3146,2106,12261
"06037208301",1207,598,0,0,150,272,1342,826,4395
"06037208302",2644,497,68,479,740,290,2654,755,8127
"06037208401",641,269,31,44,2489,1619,2469,1593,9155
"06037208402",1121,620,60,11,1137,221,1470,823,5463
"06037208501",965,298,5,0,1145,255,977,452,4097
"06037208502",390,365,196,140,1765,821,1410,1083,6170
"06037208610",550,286,84,18,2403,628,1238,545,5752
"06037208620",892,292,142,205,2540,744,1879,494,7188
"06037208710",535,234,106,118,2123,710,758,404,4988
"06037208720",458,669,132,78,1748,1322,1753,1738,7898
"06037208801",265,567,80,120,1627,612,1050,994,5315
"06037208802",521,101,127,20,1141,618,925,567,4020
"06037208902",342,318,0,0,907,611,1239,918,4335
"06037208903",557,281,24,144,1773,728,2086,892,6485
"06037208904",481,515,48,11,797,1691,1149,2000,6692
"06037209102",372,502,106,165,1689,2122,1404,2415,8775
"06037209103",364,409,20,9,895,1738,1186,2123,6744
"06037209104",309,338,70,52,588,762,811,935,3865
"06037209200",477,270,76,93,1076,531,748,517,3788
"06037209300",821,813,110,302,1726,1038,1890,1352,8052
"06037209401",708,497,92,87,1425,838,1437,1232,6316
"06037209402",542,427,37,50,1752,964,2057,1353,7182
"06037209403",108,234,59,83,1178,1832,785,1720,5999
"06037209510",549,189,26,9,1251,689,1233,586,4532
"06037209520",496,101,59,10,1122,705,1389,765,4647
"06037209810",288,374,59,27,943,598,1131,946,4366
"06037209820",475,283,30,14,1052,782,1467,1031,5134
"06037210010",929,137,17,74,1148,820,1746,752,5623
"06037211000",2737,107,72,16,1261,141,249,69,4652
"06037211120",517,146,423,30,3594,629,959,262,6560
"06037211121",721,40,91,17,884,612,688,464,3517
"06037211122",390,270,118,67,1524,334,849,479,4031
"06037211201",320,347,24,33,1610,555,1382,808,5079
"06037211202",640,180,81,13,1099,478,1125,564,4180
"06037211310",511,526,137,4,2063,1004,1622,1356,7223
"06037211320",510,301,25,89,1705,573,1437,740,5380
"06037211410",245,256,107,8,1927,302,678,327,3850
"06037211420",533,201,152,65,1769,518,987,512,4737
"06037211500",2037,97,24,207,2252,407,1061,74,6159
"06037211701",919,65,16,0,2017,133,196,50,3396
"06037211703",908,66,254,26,3182,748,1781,350,7315
"06037211704",325,102,44,0,2059,409,707,87,3733
"06037211802",702,385,192,26,2530,594,1001,633,6063
"06037211803",394,78,395,51,2298,592,472,233,4513
"06037211804",437,103,200,21,1799,654,294,124,3632
"06037211910",977,354,274,63,2383,757,2226,818,7852
"06037211921",304,363,34,0,1254,258,464,404,3081
"06037211922",781,138,145,8,2253,354,2006,133,5818
"06037212101",206,255,150,22,1184,358,198,367,2740
"06037212102",466,101,86,0,956,583,603,401,3196
"06037212202",125,271,69,28,1714,1294,1306,1499,6306
"06037212203",469,152,31,0,1627,651,1738,586,5254
"06037212204",355,330,88,18,1897,1149,1877,1218,6932
"06037212303",599,255,140,41,1448,676,1610,714,5483
"06037212304",335,234,37,7,1040,259,982,444,3338
"06037212305",691,127,82,86,1479,529,1850,568,5412
"06037212306",200,331,8,3,2258,551,911,725,4987
"06037212410",477,190,76,42,2318,1031,1173,742,6049
"06037212420",322,306,74,87,1658,803,1047,957,5254
"06037212501",822,146,48,25,954,159,998,186,3338
"06037212502",644,140,109,23,1709,337,904,258,4124
"06037212610",553,116,112,50,2526,799,764,494,5414
"06037212620",516,252,241,51,2636,880,1358,772,6706
"06037212701",461,87,140,4,1398,190,511,91,2882
"06037212702",969,40,339,0,2023,271,347,72,4061
"06037212800",991,640,223,84,1445,332,931,773,5419
"06037212900",659,806,280,106,2046,415,1543,1078,6933
"06037213100",452,370,172,45,1622,316,528,501,4006
"06037213201",464,176,67,57,2536,993,1217,888,6398
"06037213202",301,137,40,34,2326,1038,1545,800,6221
"06037213310",256,37,49,22,2419,913,1904,884,6484
"06037213320",337,261,101,26,1021,433,834,481,3494
"06037213401",353,233,55,9,3979,846,3427,857,9759
"06037213402",563,248,186,22,2777,822,2508,904,8030
"06037214000",3055,231,14,0,269,10,38,1,3618
"06037214100",3535,149,72,0,276,10,277,0,4319
"06037214400",2021,381,38,11,421,89,295,59,3315
"06037214501",1609,206,128,39,632,178,86,10,2888
"06037214502",1598,864,346,108,1695,526,141,361,5639
"06037214503",1406,129,54,23,1700,107,150,0,3569
"06037214600",1663,192,38,8,396,19,148,10,2474
"06037214700",1932,114,29,0,355,11,159,14,2614
"06037214800",2178,134,93,0,263,65,128,37,2898
"06037214901",1686,320,78,0,616,55,123,18,2896
"06037214902",1817,185,12,0,478,115,143,45,2795
"06037215101",1273,184,161,5,633,114,347,26,2743
"06037215102",1639,342,233,32,891,134,224,91,3586
"06037216100",1039,29,659,45,680,85,242,86,2865
"06037216200",1645,283,893,146,1784,129,659,73,5612
"06037216300",2766,401,402,38,1126,49,396,39,5217
"06037216401",3333,361,32,0,898,161,275,53,5113
"06037216402",1771,293,82,23,523,48,314,0,3054
"06037216700",1342,88,1183,272,979,102,795,50,4811
"06037216800",2138,356,300,9,501,103,537,264,4208
"06037216900",2210,133,1128,52,958,259,847,299,5886
"06037217001",1801,191,81,3,494,13,216,2,2801
"06037217002",3110,257,535,68,1102,47,681,64,5864
"06037217100",2055,284,1612,397,1013,239,1338,349,7287
"06037217200",1006,438,1186,96,1095,63,880,426,5190
"06037218110",778,220,766,67,1316,355,1580,518,5600
"06037218120",1379,628,333,255,1306,920,2071,1126,8018
"06037218210",1313,429,516,132,914,375,2161,739,6579
"06037218220",1158,411,1296,245,1136,317,1752,642,6957
"06037218300",1213,356,1751,576,1239,340,1880,572,7927
"06037218400",976,243,967,616,1044,303,1882,510,6541
"06037218500",540,60,604,386,1253,309,1642,311,5105
"06037218600",684,89,735,448,1147,459,1660,483,5705
"06037218701",298,73,1031,24,374,299,387,351,2837
"06037218702",160,7,872,317,547,402,521,370,3196
"06037218800",352,213,634,198,969,176,1019,342,3903
"06037218900",571,347,1689,517,1900,422,1919,625,7990
"06037219010",455,128,601,201,818,436,1113,556,4308
"06037219020",479,153,950,201,1631,454,2010,576,6454
"06037219300",322,84,1117,532,1627,572,1570,616,6440
"06037219500",224,12,937,57,560,27,363,0,2180
"06037219700",922,162,969,321,1827,66,2476,178,6921
"06037219800",821,237,389,313,968,284,1845,518,5375
"06037219901",974,494,589,374,1664,601,2551,1107,8354
"06037219902",1551,199,754,154,1209,150,2494,299,6810
"06037220000",998,854,1997,372,1257,136,1777,957,8348
"06037220100",144,14,961,248,318,428,252,265,2630
"06037221110",658,314,45,0,1628,962,1968,1113,6688
"06037221120",596,280,42,50,1654,698,2121,977,6418
"06037221210",556,188,107,183,1541,549,1801,640,5565
"06037221220",557,354,25,14,1888,692,2111,876,6517
"06037221302",725,1298,344,202,1651,591,1493,1620,7924
"06037221303",103,146,105,224,1205,859,967,969,4578
"06037221304",902,411,232,289,1267,543,1654,800,6098
"06037221401",428,138,848,481,631,529,815,550,4420
"06037221402",283,167,484,375,1219,420,1191,358,4497
"06037221500",527,117,624,506,642,965,937,1081,5399
"06037221601",753,175,332,90,1543,711,2058,800,6462
"06037221602",765,260,24,100,1198,648,1861,845,5701
"06037221710",360,275,166,62,955,1020,1140,923,4901
"06037221810",421,551,96,125,728,875,711,487,3994
"06037221820",573,998,38,221,567,695,237,213,3542
"06037221900",418,449,201,53,512,940,663,449,3685
"06037222001",534,37,498,447,1111,501,1408,490,5026
"06037222002",869,51,1316,139,1860,387,2499,435,7556
"06037222100",583,177,744,463,1537,291,1957,440,6192
"06037222200",505,389,478,294,1937,611,2206,854,7274
"06037222500",369,278,690,337,2475,960,2552,1146,8807
"06037222600",794,571,719,432,1462,1165,1859,926,7928
"06037222700",65,168,25,31,4,237,12,11,553
"06037224010",288,260,212,147,716,568,848,622,3661
"06037224020",297,414,32,56,1266,482,1419,860,4826
"06037224200",733,234,55,0,990,358,1707,592,4669
"06037224310",559,307,67,0,818,479,1141,690,4061
"06037224320",157,571,28,144,1383,702,1462,1217,5664
"06037224410",590,248,42,49,1317,1009,1103,706,5064
"06037224420",208,274,40,43,593,729,744,967,3598
"06037224600",896,301,25,35,978,1199,1822,1479,6735
"06037224700",313,791,23,72,269,866,88,210,2632
"06037226001",432,153,86,30,910,377,1366,528,3882
"06037226002",464,215,56,110,376,205,425,353,2204
"06037226410",638,530,12,32,1142,1115,1748,1494,6711
"06037226420",905,925,76,174,1882,1605,2569,2472,10608
"06037226700",1026,493,56,267,2211,1800,3237,2263,11353
"06037227010",664,291,171,79,1706,1951,2370,2242,9474
"06037227020",643,403,88,68,1042,899,1648,1274,6065
"06037228100",744,548,140,146,1544,1453,2291,1978,8844
"06037228210",289,169,334,102,1350,1274,1587,1446,6551
"06037228220",781,280,332,210,1233,1096,1953,1348,7233
"06037228310",363,360,149,54,1915,1117,2218,1389,7565
"06037228320",613,45,136,125,1412,1089,2000,1128,6548
"06037228410",972,281,11,10,1444,971,2369,1236,7294
"06037228420",486,242,121,102,1007,982,1454,1233,5627
"06037228500",898,368,419,228,1553,1273,2404,1682,8825
"06037228600",573,495,138,65,1549,1873,1952,2368,9013
"06037228710",802,220,124,34,780,2287,1571,2487,8305
"06037228720",1231,290,220,147,1452,1177,2632,1462,8611
"06037228800",1221,809,338,256,1526,1211,2774,1994,10129
"06037228900",633,396,179,136,477,1372,911,1815,5919
"06037229100",872,260,189,151,1765,997,2624,1179,8037
"06037229200",608,622,484,301,1091,686,1657,1285,6734
"06037229300",1011,742,207,150,1560,2099,2529,2816,11114
"06037229410",418,470,369,244,1098,602,1504,1027,5732
"06037229420",1036,346,169,207,1842,931,2797,1277,8605
"06037231100",616,334,157,467,348,899,858,1128,4807
"06037231210",237,328,493,398,1555,532,1716,784,6043
"06037231220",402,250,483,227,1485,1393,1731,1545,7516
"06037231300",632,134,880,455,1674,1147,2257,1249,8428
"06037231400",661,568,979,259,1983,340,2586,889,8265
"06037231500",714,44,1288,352,1562,341,1979,334,6614
"06037231600",601,491,1335,541,3049,1513,3448,1786,12764
"06037231710",390,258,541,509,1554,1489,1885,1703,8329
"06037231720",522,169,373,183,1973,1541,2418,1577,8756
"06037231800",587,459,327,258,1325,1975,1883,2302,9116
"06037231900",697,525,361,180,1883,2011,2484,2456,10597
"06037232110",273,81,342,348,941,701,1191,781,4658
"06037232120",440,358,541,564,2058,1239,2466,1588,9254
"06037232200",597,122,616,291,636,698,1121,820,4901
"06037232300",501,16,1057,287,1078,672,1532,683,5826
"06037232400",785,278,1765,1151,2284,591,2827,830,10511
"06037232500",550,219,1555,422,1045,1116,1526,1305,7738
"06037232600",666,134,1230,460,2465,1085,2920,1208,10168
"06037232700",952,196,944,663,2399,914,3306,1085,10459
"06037232800",143,333,481,200,1988,1032,2131,1325,7633
"06037234000",314,90,2889,1037,1449,69,1571,180,7599
"06037234200",98,2,1569,379,448,28,227,18,2769
"06037234300",56,0,2710,1088,266,144,151,28,4443
"06037234501",327,60,1083,327,492,266,768,134,3457
"06037234502",455,45,1129,317,219,35,550,59,2809
"06037234600",623,50,2309,731,872,406,1139,447,6577
"06037234700",850,199,1826,494,326,179,1149,373,5396
"06037234800",992,80,1459,428,378,100,1310,81,4828
"06037234901",177,281,1144,420,579,460,780,620,4461
"06037234902",555,43,1223,920,543,401,990,454,5129
"06037235100",233,2,2948,288,1059,191,825,132,5678
"06037235201",431,23,1378,427,125,297,499,299,3479
"06037235202",155,192,1621,828,882,389,887,562,5516
"06037236000",923,1,2374,160,770,12,617,0,4857
"06037236100",454,144,2388,1078,790,362,687,457,6360
"06037236202",429,291,1248,1302,893,1075,1144,1215,7597
"06037236203",208,308,2319,456,447,49,570,341,4698
"06037236204",116,760,1047,473,558,449,580,1151,5134
"06037236400",237,11,3284,307,401,131,112,8,4491
"06037237101",933,588,788,153,828,539,1671,1118,6618
"06037237102",545,283,564,155,543,788,1128,1055,5061
"06037237201",871,402,731,237,942,492,1789,850,6314
"06037237202",908,315,1103,582,1577,231,2467,546,7729
"06037237300",629,0,2331,836,930,158,1469,109,6462
"06037237401",849,183,500,357,1503,62,2352,245,6051
"06037237402",1200,65,898,451,614,138,1775,197,5338
"06037237500",515,82,637,149,681,496,982,578,4120
"06037237600",921,452,505,379,1076,559,1944,978,6814
"06037237710",865,591,580,150,706,574,1306,1107,5879
"06037237720",877,282,309,319,613,989,1487,1188,6064
"06037237800",426,103,2464,780,740,133,1105,210,5961
"06037237900",138,44,2445,734,278,59,463,73,4234
"06037238000",537,311,3790,726,313,20,654,316,6667
"06037238100",459,78,3033,868,599,29,916,69,6051
"06037238200",433,46,3296,799,539,92,776,101,6082
"06037238310",536,609,590,498,1054,1279,1668,1883,8117
"06037238320",564,377,475,443,677,660,1199,1037,5432
"06037238400",315,150,3236,533,245,93,474,220,5266
"06037239201",368,260,389,182,922,1079,1303,1337,5840
"06037239202",1170,385,415,359,1677,961,2768,1338,9073
"06037239310",723,308,550,169,1580,776,2287,1039,7432
"06037239320",713,343,281,414,1328,363,2017,713,6172
"06037239330",507,272,383,242,1235,311,1742,583,5275
"06037239501",831,626,657,364,622,308,1432,934,5774
"06037239502",1361,420,276,256,273,799,1616,1254,6255
"06037239601",718,402,211,507,717,902,1435,1279,6171
"06037239602",845,273,192,420,1005,793,1816,1081,6425
"06037239701",906,813,524,779,737,953,1610,1748,8070
"06037239702",597,303,910,531,932,459,1507,754,5993
"06037239801",766,612,392,416,893,523,1659,1153,6414
"06037239802",1113,361,437,239,1218,972,2292,1333,7965
"06037240010",899,544,434,528,779,607,1674,1116,6581
"06037240020",1913,713,739,255,1526,481,3394,1183,10204
"06037240200",420,317,989,644,1766,1314,2097,1631,9178
"06037240300",965,204,850,438,1250,851,2178,1020,7756
"06037240401",833,477,716,458,1451,600,2211,1043,7789
"06037240402",637,461,1138,292,781,549,1328,998,6184
"06037240500",918,214,1235,963,1174,1095,2055,1283,8937
"06037240600",783,142,917,316,1403,605,2105,728,6999
"06037240700",1648,749,2080,697,545,374,2097,896,9086
"06037240800",1246,754,1035,720,469,720,1598,1377,7919
"06037240900",2003,534,794,404,997,777,3011,1303,9823
"06037241001",599,561,725,819,689,525,1240,1086,6244
"06037241002",907,520,933,420,1316,135,2230,695,7156
"06037241110",661,463,344,459,588,208,1200,678,4601
"06037241120",1037,813,707,550,775,971,1780,1642,8275
"06037241201",756,52,841,393,363,170,1099,222,3896
"06037241202",893,111,1461,477,1104,934,1802,1038,7820
"06037241300",183,52,653,436,398,409,506,436,3073
"06037241400",1071,312,992,405,419,155,1461,463,5278
"06037242000",968,639,863,401,653,176,1628,803,6131
"06037242100",511,1154,275,527,51,196,568,1345,4627
"06037242200",2091,942,878,699,873,678,2925,1618,10704
"06037242300",2026,621,561,830,774,198,2799,726,8535
"06037242600",707,1134,480,1131,279,848,984,1959,7522
"06037242700",1354,1008,615,386,928,338,2263,1344,8236
"06037243000",2939,873,237,672,827,232,3601,1103,10484
"06037243100",2195,1415,686,769,690,601,2832,1994,11182
"06037261101",3383,168,50,9,229,0,167,8,4014
"06037261102",3215,354,30,0,684,0,338,21,4642
"06037261200",3274,108,59,9,515,15,308,15,4303
"06037262100",2833,121,34,0,144,0,71,0,3203
"06037262200",3547,53,50,25,716,21,208,7,4627
"06037262301",1963,127,6,0,335,17,110,6,2564
"06037262302",2777,31,0,0,135,0,167,17,3127
"06037262303",2691,131,0,0,270,0,93,27,3212
"06037262400",2843,45,0,15,238,47,124,43,3355
"06037262501",3045,174,31,0,215,7,82,18,3572
"06037262601",3253,225,29,0,329,54,271,15,4176
"06037262604",5234,197,0,13,459,32,275,36,6246
"06037262704",2951,142,19,0,241,20,188,7,3568
"06037262706",2883,128,114,0,292,0,168,11,3596
"06037262802",3135,36,70,14,287,0,175,8,3725
"06037264000",2645,282,0,0,308,14,104,0,3353
"06037264102",2410,260,12,0,231,61,210,23,3207
"06037264103",1493,134,20,0,503,28,196,0,2374
"06037264301",3574,390,78,0,675,114,297,54,5182
"06037264302",4215,399,0,0,818,67,250,48,5797
"06037265100",2004,216,47,0,226,43,11,0,2547
"06037265201",1681,128,9,0,309,171,180,0,2478
"06037265202",2358,398,100,0,440,492,181,28,3997
"06037265301",0,0,0,0,0,0,0,0,0
"06037265303",874,1577,83,151,454,1779,174,659,5751
"06037265304",326,1286,0,51,246,954,81,237,3181
"06037265305",836,1513,32,153,542,1046,99,157,4378
"06037265410",1233,22,26,0,181,4,91,0,1557
"06037265420",1297,127,6,0,251,152,63,8,1904
"06037265510",1706,411,16,2,675,1061,91,37,3999
"06037265520",2930,240,99,0,645,460,193,15,4582
"06037265601",2127,93,41,0,541,30,126,0,2958
"06037265602",2242,259,14,0,367,184,68,0,3134
"06037265700",3996,259,51,0,826,62,150,12,5356
"06037267100",3917,410,157,55,1531,164,554,58,6846
"06037267200",3479,436,75,0,1111,86,415,17,5619
"06037267300",1811,347,56,1,1576,565,550,426,5332
"06037267402",2699,306,180,17,1135,98,506,56,4997
"06037267403",1597,244,108,0,794,259,288,0,3290
"06037267404",1724,223,68,14,745,64,280,42,3160
"06037267501",2573,500,64,19,2472,322,2046,399,8395
"06037267502",1765,131,109,0,925,159,565,54,3708
"06037267600",1385,46,40,0,1284,199,780,0,3734
"06037267700",1327,183,105,0,1724,76,735,29,4179
"06037267800",2045,63,88,13,671,23,197,25,3125
"06037267901",1806,149,0,0,360,26,43,9,2393
"06037267902",2658,128,58,0,462,132,54,8,3500
"06037269000",4206,260,109,0,669,61,252,67,5624
"06037269100",3290,389,85,0,649,0,182,7,4602
"06037269300",3447,208,116,0,571,0,247,0,4589
"06037269500",3010,251,35,0,441,21,92,0,3850
"06037269601",1052,436,581,241,442,89,843,446,4130
"06037269602",1693,313,332,125,485,301,955,521,4725
"06037269700",2223,272,377,65,735,52,1233,206,5163
"06037269800",1789,213,278,0,1121,160,647,74,4282
"06037269903",1256,400,337,91,1438,88,833,282,4725
"06037269904",1248,548,550,60,1011,313,786,322,4838
"06037269905",1957,119,294,37,470,239,1568,139,4823
"06037269906",1429,150,37,93,1028,157,552,33,3479
"06037269907",1260,551,250,49,616,64,486,277,3553
"06037270100",2226,461,408,26,1225,264,804,293,5707
"06037270200",2292,699,194,0,663,242,1796,811,6697
"06037270300",560,109,755,86,688,129,693,213,3233
"06037271100",1362,333,15,2,591,86,300,159,2848
"06037271200",1258,393,96,0,747,110,725,259,3588
"06037271300",2652,302,243,18,1243,141,1031,110,5740
"06037271400",2740,325,0,0,558,13,363,53,4052
"06037271500",2212,178,34,0,606,12,331,73,3446
"06037271600",2369,269,204,240,1399,174,466,26,5147
"06037271701",3419,377,59,1,1837,216,517,2,6428
"06037271702",1632,306,103,11,1628,741,255,144,4820
"06037271801",1825,632,268,17,786,276,895,264,4963
"06037271802",3183,741,569,16,1666,302,1383,211,8071
"06037271901",1867,147,280,111,895,131,1069,74,4574
"06037271902",2703,272,100,2,1069,36,716,120,5018
"06037272100",2903,311,17,0,912,97,793,151,5184
"06037272201",1340,84,94,14,564,192,508,200,2996
"06037272202",1848,245,184,76,1179,151,1368,196,5247
"06037272301",1939,153,152,31,673,131,695,175,3949
"06037272302",2347,163,249,0,936,446,1542,417,6100
"06037273100",1525,164,10,1,327,20,377,6,2430
"06037273200",2296,386,261,150,472,60,695,310,4630
"06037273300",2394,257,219,156,516,159,707,300,4708
"06037273402",2151,227,115,0,214,52,158,10,2927
"06037273502",2022,208,114,16,346,154,353,89,3302
"06037273600",1688,265,17,69,225,45,282,114,2705
"06037273700",2012,345,117,0,310,7,500,205,3496
"06037273800",2176,217,170,12,502,157,432,222,3888
"06037273902",3016,247,11,61,382,129,408,87,4341
"06037274100",3124,425,249,119,548,34,411,68,4978
"06037274202",3218,186,57,58,313,15,556,15,4418
"06037275101",772,20,76,0,433,0,406,7,1714
"06037275102",2219,173,75,0,1623,135,2514,214,6953
"06037275200",2038,371,151,29,1337,592,1947,762,7227
"06037275302",3327,325,58,145,939,177,350,83,5404
"06037275311",2999,237,143,0,2471,83,1771,186,7890
"06037275400",2046,92,67,30,886,119,792,100,4132
"06037275500",1823,835,133,254,1857,394,2775,986,9057
"06037275602",3742,191,792,152,2129,359,695,170,8230
"06037275603",1686,269,66,0,790,82,1005,319,4217
"06037276000",3792,119,135,0,1489,85,1249,42,6911
"06037276100",1555,371,2509,624,781,173,336,76,6425
"06037276400",2841,449,45,35,851,68,612,24,4925
"06037276500",1320,86,24,0,273,8,105,6,1822
"06037276601",2525,245,64,13,841,38,414,26,4166
"06037276603",3373,287,493,61,1299,132,867,38,6550
"06037276604",2266,356,526,95,576,257,382,14,4472
"06037277000",4323,246,42,0,826,22,893,0,6352
"06037277100",1916,295,36,1,767,52,676,165,3908
"06037277200",532,78,996,52,687,108,635,72,3160
"06037277400",326,64,606,192,297,93,232,47,1857
"06037278001",1479,220,63,0,514,35,538,88,2937
"06037278102",2306,110,110,8,410,54,353,27,3378
"06037291110",186,134,1536,358,704,350,737,484,4489
"06037291120",273,95,452,174,757,386,925,477,3539
"06037291130",961,85,658,274,1294,301,1921,282,5776
"06037291210",1255,302,789,183,2081,925,2007,1163,8705
"06037291220",743,275,224,90,1484,505,1464,782,5567
"06037291300",841,59,117,7,1127,104,396,53,2704
"06037292000",1511,407,679,439,2852,875,2679,1076,10518
"06037293201",1515,197,282,40,3848,330,3036,332,9580
"06037293202",1458,748,177,254,2123,1314,2206,1735,10015
"06037293301",1161,135,58,21,1420,48,733,15,3591
"06037293302",2641,360,191,9,1914,82,2230,380,7807
"06037293304",1872,555,258,52,1395,299,2149,659,7239
"06037293306",1380,283,186,0,467,38,709,245,3308
"06037293307",993,77,378,77,890,169,1275,152,4011
"06037294110",2864,477,61,0,978,304,3431,639,8754
"06037294120",1192,660,141,11,569,23,1753,623,4972
"06037294200",3398,531,9,0,1170,105,3804,577,9594
"06037294301",1754,326,17,0,504,24,1865,284,4774
"06037294302",3101,707,122,25,840,435,3627,1058,9915
"06037294410",2169,424,671,137,1151,439,1691,632,7314
"06037294421",1453,374,263,4,533,165,1547,445,4784
"06037294510",2165,1061,1,0,1038,180,3053,1207,8705
"06037294520",2005,818,8,27,626,293,2514,1097,7388
"06037294610",1959,808,104,45,529,476,2381,1252,7554
"06037294620",2594,937,27,0,776,342,3196,1269,9141
"06037294701",1460,687,115,42,430,231,1798,854,5617
"06037294810",2091,1398,132,0,508,287,2540,1670,8626
"06037294820",1536,1572,0,44,349,158,1769,1693,7121
"06037294830",1550,1366,97,9,647,394,2135,1687,7885
"06037294900",1419,1239,67,43,456,70,1614,1262,6170
"06037295103",3812,247,49,0,1002,34,1245,145,6534
"06037296210",1273,916,33,103,305,276,1323,1030,5259
"06037296220",1689,947,269,305,522,352,1535,901,6520
"06037296300",2759,91,66,0,919,304,1161,217,5517
"06037296401",2286,137,39,22,420,127,637,28,3696
"06037296402",1876,174,146,8,604,22,1205,136,4171
"06037296500",1957,1113,252,129,701,139,1871,1123,7285
"06037296600",2761,1145,409,30,706,501,2639,1239,9430
"06037296901",2224,455,191,37,1005,142,2542,459,7055
"06037296902",2487,541,103,82,492,151,1668,488,6012
"06037297000",3732,98,157,0,615,13,1136,29,5780
"06037297110",2353,868,332,442,543,450,1916,934,7838
"06037297120",1881,612,175,37,718,245,2112,670,6450
"06037297201",1473,694,439,39,570,63,1063,478,4819
"06037297202",2765,91,122,0,631,445,1102,402,5558
"06037297300",1715,76,208,0,149,13,424,7,2592
"06037297400",2633,273,50,4,597,37,532,184,4310
"06037297500",3523,235,262,57,546,102,1027,121,5873
"06037297601",2115,202,170,0,88,0,442,117,3134
"06037297602",2474,113,250,61,926,30,1401,42,5297
"06037300100",3838,124,81,0,1775,135,586,19,6558
"06037300200",3040,226,21,0,2406,184,722,83,6682
"06037300301",4866,201,36,0,1393,116,401,0,7013
"06037300400",3377,151,0,2,1913,116,784,2,6345
"06037300501",1787,226,26,0,984,108,504,19,3654
"06037300502",3325,343,60,1,2156,141,717,183,6926
"06037300600",4772,479,28,0,3444,198,1047,28,9996
"06037300701",5804,224,2,0,349,2,837,2,7220
"06037300702",4532,209,0,0,640,0,229,20,5630
"06037300800",4229,783,101,0,1410,300,329,165,7317
"06037300901",3666,131,71,0,2203,13,577,0,6661
"06037300902",1248,242,0,0,537,44,383,14,2468
"06037301000",3567,159,86,0,1096,102,737,103,5850
"06037301100",4646,341,0,7,1737,125,853,0,7709
"06037301203",3063,243,52,0,1102,29,398,56,4943
"06037301204",3253,724,131,0,678,131,311,62,5290
"06037301205",1461,26,67,7,495,0,285,0,2341
"06037301206",3059,506,35,2,1310,431,644,44,6031
"06037301300",1769,38,0,0,225,7,127,0,2166
"06037301400",3306,90,0,0,455,0,341,0,4192
"06037301501",1415,54,0,0,213,0,178,0,1860
"06037301502",4463,1248,98,0,1420,112,560,55,7956
"06037301601",4578,1060,88,0,561,142,1414,184,8027
"06037301602",2183,260,87,0,1050,270,1302,316,5468
"06037301701",2007,280,17,0,470,10,475,0,3259
"06037301702",4108,457,15,0,913,164,950,126,6733
"06037301801",2559,413,50,0,903,18,563,83,4589
"06037301802",1796,672,23,157,771,32,452,51,3954
"06037301900",4854,1015,95,13,1284,319,975,122,8677
"06037302002",2034,665,120,0,591,160,376,151,4097
"06037302003",2771,444,0,0,494,19,305,6,4039
"06037302004",2884,497,11,42,841,31,512,11,4829
"06037302102",3871,766,33,0,1304,186,1052,291,7503
"06037302103",3229,811,81,1,1283,202,916,83,6606
"06037302104",1728,302,232,18,1462,142,812,205,4901
"06037302201",2208,849,184,56,455,96,319,67,4234
"06037302202",2994,1189,32,7,908,119,677,333,6259
"06037302301",2452,487,75,0,846,84,534,195,4673
"06037302302",2487,907,44,0,1146,98,1521,294,6497
"06037302401",2918,1135,48,37,1217,256,1542,472,7625
"06037302503",2132,1200,22,0,945,315,568,328,5510
"06037302504",1792,1470,69,49,890,125,941,685,6021
"06037302505",1989,833,211,0,778,99,1482,387,5779
"06037302506",2084,632,104,26,604,9,1115,112,4686
"06037310100",4764,214,7,1,781,0,539,26,6332
"06037310201",3861,460,109,0,1049,114,1543,36,7172
"06037310202",3507,366,127,25,691,211,474,251,5652
"06037310300",2228,168,0,0,457,24,268,0,3145
"06037310400",2394,300,7,3,556,78,404,156,3898
"06037310501",2123,222,165,12,675,50,1601,173,5021
"06037310601",3659,369,40,29,1756,218,2168,81,8320
"06037310602",1472,102,177,12,644,9,487,11,2914
"06037310701",1445,488,42,1,477,18,246,64,2781
"06037310702",4658,713,84,0,1548,118,939,20,8080
"06037310703",3699,949,92,0,583,160,944,211,6638
"06037310800",3237,170,133,0,1372,135,1352,130,6529
"06037310900",4402,165,14,0,1624,95,2157,120,8577
"06037311000",2775,106,12,1,1006,52,1340,42,5334
"06037311100",2479,353,34,11,885,0,1292,130,5184
"06037311200",2398,177,64,0,521,8,1009,73,4250
"06037311300",2594,213,84,0,602,141,630,176,4440
"06037311400",1792,104,0,28,309,30,261,15,2539
"06037311500",3888,453,64,6,1224,52,927,260,6874
"06037311600",5262,400,208,15,1856,118,1336,138,9333
"06037311700",3860,331,173,1,1184,62,968,89,6668
"06037311801",1836,312,18,0,1017,31,1424,191,4829
"06037311802",1617,621,84,0,1195,85,1348,562,5512
"06037320000",0,0,0,0,0,0,0,0,0
"06037320100",4564,680,141,9,1800,553,5506,1176,14429
"06037320201",2149,144,16,0,629,234,2347,378,5897
"06037320202",3719,213,239,0,1760,223,4888,342,11384
"06037320300",3199,1305,17,0,1446,643,4373,1931,12914
"06037400204",4995,121,78,9,1406,24,1091,22,7746
"06037400205",1868,104,224,11,991,51,263,23,3535
"06037400206",4196,71,33,0,996,33,821,3,6153
"06037400207",3711,161,45,14,666,38,985,22,5642
"06037400302",1817,88,95,4,821,113,951,46,3935
"06037400304",4337,267,343,0,1164,605,1463,120,8299
"06037400402",2963,353,76,0,890,17,791,16,5106
"06037400403",2415,106,244,1,1112,45,1279,20,5222
"06037400404",4059,33,58,1,295,2,607,22,5077
"06037400501",1772,19,39,4,369,11,327,11,2552
"06037400602",1762,241,7,0,1315,819,2016,894,7054
"06037400603",1871,250,319,22,2361,150,2197,166,7336
"06037400604",1076,184,122,12,1039,455,949,485,4322
"06037400800",1218,153,23,15,595,69,315,14,2402
"06037400900",2843,131,60,55,721,182,1147,141,5280
"06037401001",2663,72,8,0,340,0,664,0,3747
"06037401002",2957,274,65,137,573,12,1017,12,5047
"06037401101",3501,321,78,1,711,136,842,247,5837
"06037401102",1950,188,11,0,834,127,906,267,4283
"06037401201",2629,34,71,0,495,4,894,14,4141
"06037401202",2905,304,23,8,1147,317,1377,353,6434
"06037401203",3571,431,123,0,1237,67,2065,302,7796
"06037401303",1567,0,56,0,783,41,482,0,2929
"06037401304",4181,179,48,0,1407,161,1472,34,7482
"06037401311",4284,177,190,2,1500,190,1795,189,8327
"06037401312",3462,263,28,0,1386,57,1901,165,7262
"06037401500",3549,336,311,37,759,106,1851,218,7167
"06037401601",3430,175,238,2,1258,86,1644,85,6918
"06037401602",3382,600,431,113,909,176,1804,477,7892
"06037401603",2244,331,54,11,199,7,808,12,3666
"06037401701",2928,245,167,62,491,9,978,70,4950
"06037401703",2375,271,387,168,613,102,1383,172,5471
"06037401704",3269,739,511,118,1055,206,2673,523,9094
"06037401800",5280,370,138,7,1157,193,1322,151,8618
"06037401901",243,14,0,0,141,4,211,4,617
"06037401902",3746,109,148,2,1051,47,1127,18,6248
"06037402001",1444,227,273,30,1031,270,969,240,4484
"06037402002",2101,289,371,14,1019,196,1253,167,5410
"06037402101",2628,608,614,148,934,19,3196,547,8694
"06037402102",2368,595,684,81,942,160,2355,551,7736
"06037402200",2543,368,679,51,2292,354,2782,646,9715
"06037402301",1652,596,231,0,2934,659,3412,1198,10682
"06037402303",1813,732,272,97,659,870,2140,1330,7913
"06037402304",719,479,176,35,1523,1231,2115,1705,7983
"06037402402",3414,696,374,43,1657,190,3433,451,10258
"06037402403",1996,182,195,0,1502,156,2632,234,6897
"06037402404",13,0,0,0,0,0,0,0,13
"06037402405",1025,242,293,67,1390,77,2278,246,5618
"06037402406",965,282,330,37,2037,377,2623,626,7277
"06037402501",3516,1050,17,45,704,225,3667,1198,10422
"06037402502",3569,1345,86,124,1348,232,4227,1353,12284
"06037402600",4587,1645,262,309,1116,173,3803,1523,13418
"06037402702",2687,2212,227,50,348,471,2746,2550,11291
"06037402703",2739,405,389,156,558,241,2554,481,7523
"06037402705",2120,289,383,47,678,18,1920,199,5654
"06037402706",2203,280,496,0,1066,135,2559,264,7003
"06037402801",2848,1106,0,0,753,531,3338,1569,10145
"06037402803",1897,780,19,0,575,255,2224,953,6703
"06037402804",1744,1187,91,61,855,345,2122,1396,7801
"06037402902",3254,966,400,42,801,571,3535,1207,10776
"06037402903",2411,453,326,203,931,119,2723,506,7672
"06037402904",2083,436,73,0,473,201,2256,559,6081
"06037403000",4498,1166,260,33,1169,219,4474,1076,12895
"06037403200",61,52,16,21,58,48,9,40,305
"06037403303",872,9,95,5,1371,81,810,14,3257
"06037403304",1241,81,40,0,3400,141,642,49,5594
"06037403305",533,0,9,0,1469,147,84,12,2254
"06037403312",1802,284,305,18,2606,149,1833,210,7207
"06037403316",3101,91,819,0,3331,187,1967,49,9545
"06037403317",1893,53,481,58,1574,243,1075,186,5563
"06037403318",2886,176,582,8,2160,239,1925,149,8125
"06037403319",1584,127,147,33,2199,153,834,8,5085
"06037403320",1119,109,19,0,3750,205,739,53,5994
"06037403321",2048,55,247,77,3295,215,1360,69,7366
"06037403322",1322,43,132,33,1953,114,772,3,4372
"06037403323",1434,49,24,0,3171,454,589,63,5784
"06037403324",1489,95,99,0,4880,332,630,2,7527
"06037403325",1585,34,228,0,2871,132,877,30,5757
"06037403401",1330,129,40,0,3314,210,1271,122,6416
"06037403402",801,0,191,1,2461,165,752,1,4372
"06037403403",974,20,226,0,3520,288,599,0,5627
"06037403404",593,19,82,0,1816,153,304,13,2980
"06037403405",438,9,0,0,1319,5,189,0,1960
"06037403406",796,84,43,0,1697,258,462,31,3371
"06037403407",497,43,35,0,1499,169,194,43,2480
"06037403408",1033,22,425,0,4575,268,1199,59,7581
"06037403500",1129,72,27,0,457,29,487,15,2216
"06037403600",4159,303,158,2,2220,98,2969,114,10023
"06037403702",1855,133,125,30,1319,22,1464,133,5081
"06037403703",2888,155,90,61,1380,69,1767,121,6531
"06037403721",2905,236,83,0,1610,157,2179,236,7406
"06037403722",2057,383,64,62,2344,604,2873,834,9221
"06037403801",3020,656,311,0,1635,111,2069,294,8096
"06037403802",3163,440,39,49,1942,265,2671,410,8979
"06037403901",2073,108,72,8,998,125,1695,102,5181
"06037403902",3150,272,96,12,698,85,1702,144,6159
"06037404000",1970,214,52,64,2569,178,2632,243,7922
"06037404100",2677,291,82,0,2022,401,3916,603,9992
"06037404201",1224,247,7,0,1298,1028,1971,1154,6929
"06037404202",686,454,71,26,1358,360,1352,378,4685
"06037404301",1792,368,184,6,2412,1066,3695,1360,10883
"06037404302",894,71,26,0,787,64,1400,86,3328
"06037404401",1378,280,0,12,1691,373,2606,615,6955
"06037404402",1787,28,0,9,2629,466,3233,489,8641
"06037404501",751,95,63,23,1633,172,2139,228,5104
"06037404503",913,24,126,0,1920,402,1983,424,5792
"06037404504",1836,457,17,64,2445,451,3619,839,9728
"06037404600",697,122,18,9,626,25,1255,147,2899
"06037404701",2061,406,26,0,2622,338,4270,689,10412
"06037404702",1388,403,11,113,3359,1191,3831,1365,11661
"06037404703",873,153,111,0,1788,503,2474,652,6554
"06037404801",2112,282,190,6,3900,823,4356,914,12583
"06037404802",1407,222,0,5,2438,489,3020,633,8214
"06037404803",518,72,4,0,962,196,1219,215,3186
"06037404901",1431,274,101,0,3385,867,3854,998,10910
"06037404902",1372,280,11,0,2127,623,2177,872,7462
"06037404903",1027,267,8,9,787,254,1361,416,4129
"06037405001",2304,527,1,3,2893,407,4518,834,11487
"06037405002",1164,130,0,0,1706,380,2539,500,6419
"06037405101",1547,348,6,17,2872,279,3681,606,9356
"06037405102",1649,165,93,0,2311,707,3023,738,8686
"06037405201",1671,337,9,22,2604,633,3486,835,9597
"06037405202",1565,289,8,139,2795,190,3288,569,8843
"06037405203",1085,109,8,0,1360,405,1436,399,4802
"06037405301",1215,179,273,60,1423,452,1772,579,5953
"06037405302",1670,31,207,16,3953,524,4071,543,11015
"06037405400",1984,216,38,0,2481,412,2940,567,8638
"06037405500",2577,286,198,71,2954,389,3836,340,10651
"06037405600",2209,233,133,0,2454,149,2939,181,8298
"06037405701",1902,102,48,20,1761,20,2507,108,6468
"06037405702",1815,341,60,35,2672,198,2914,305,8340
"06037405800",2111,642,279,17,2130,299,3013,829,9320
"06037405900",1955,79,189,62,1457,114,2255,143,6254
"06037406000",2722,547,153,34,1798,357,2542,523,8676
"06037406101",1394,198,129,0,1273,160,1666,164,4984
"06037406102",2873,257,193,7,2093,362,2853,451,9089
"06037406200",2157,326,168,98,1951,631,2591,752,8674
"06037406300",2134,460,115,1,2434,249,2107,531,8031
"06037406402",1066,17,51,2,783,11,922,3,2855
"06037406411",889,96,0,0,820,120,866,89,2880
"06037406412",969,110,159,1,1187,28,1146,80,3680
"06037406500",2449,296,437,26,2811,294,3694,467,10474
"06037406601",1910,192,206,40,2827,116,3127,39,8457
"06037406602",1966,118,32,2,2514,353,2630,426,8041
"06037406701",1379,58,253,4,1879,25,1994,47,5639
"06037406702",2088,378,212,15,3563,455,3205,562,10478
"06037406800",1909,36,159,0,2350,230,2670,234,7588
"06037406901",1642,582,78,0,1762,359,3003,728,8154
"06037406902",1353,107,41,56,1844,42,2777,124,6344
"06037407001",1752,614,17,38,2899,322,3977,856,10475
"06037407002",1148,52,41,0,2026,360,2630,377,6634
"06037407101",2980,214,0,1,1853,263,4409,472,10192
"06037407102",1839,656,77,0,2876,323,4130,745,10646
"06037407200",3739,335,33,9,2232,376,5517,574,12815
"06037407301",3215,150,8,1,1475,27,3953,157,8986
"06037407302",2125,324,135,0,702,262,2476,544,6568
"06037407400",448,145,114,9,1217,103,1065,174,3275
"06037407501",3291,259,136,0,653,142,3145,295,7921
"06037407502",1875,367,0,0,1498,163,2824,491,7218
"06037407601",2313,256,27,0,1251,543,2855,736,7981
"06037407602",2767,442,27,0,1014,119,3365,446,8180
"06037407701",2344,823,57,258,1176,332,3064,1070,9124
"06037407702",3521,275,73,40,2450,128,4837,394,11718
"06037407801",2346,281,62,8,2067,111,3348,325,8548
"06037407802",1963,253,26,2,1268,47,2616,249,6424
"06037407900",2332,586,174,0,2612,608,3475,901,10688
"06037408003",2506,339,114,0,1745,138,2453,404,7699
"06037408004",707,0,110,12,1574,130,939,100,3572
"06037408005",1294,29,436,0,2811,255,1685,197,6707
"06037408006",859,111,313,212,2197,77,1416,116,5301
"06037408133",1044,106,201,27,3662,541,2377,522,8480
"06037408134",579,116,226,25,1564,36,756,102,3404
"06037408135",461,57,443,13,3109,397,1419,326,6225
"06037408136",1258,257,76,0,1789,151,1502,243,5276
"06037408137",1103,275,269,34,2475,185,1313,267,5921
"06037408138",3778,1023,156,0,665,257,3913,1107,10899
"06037408139",2522,453,3,0,992,24,3294,416,7704
"06037408140",1728,296,36,0,1015,596,2581,853,7105
"06037408141",2785,538,79,2,1586,71,3700,584,9345
"06037408202",714,67,0,0,898,239,1206,283,3407
"06037408211",1333,290,50,2,3839,714,2050,468,8746
"06037408212",1174,143,0,0,3211,371,1259,50,6208
"06037408301",1984,414,0,0,1946,664,3231,972,9211
"06037408302",1539,339,23,33,1797,19,2620,361,6731
"06037408303",1826,199,27,0,2045,92,3143,256,7588
"06037408401",2668,480,34,0,1629,107,2997,538,8453
"06037408402",3013,101,107,60,1933,161,2460,189,8024
"06037408501",1918,269,22,0,918,98,2180,296,5701
"06037408503",2862,23,27,0,2996,400,2215,1,8524
"06037408504",3040,112,0,0,1666,314,2963,240,8335
"06037408505",1417,62,12,13,1351,61,1160,16,4092
"06037408623",1071,0,29,0,1892,109,865,44,4010
"06037408624",1127,13,23,0,2126,223,1021,0,4533
"06037408625",1744,67,0,0,2186,77,1387,35,5496
"06037408626",922,43,12,3,3172,608,782,107,5649
"06037408627",821,47,0,13,1846,160,428,0,3315
"06037408628",1315,76,18,10,3502,393,1019,45,6378
"06037408629",826,32,122,0,1837,132,420,10,3379
"06037408630",1259,289,0,0,1103,55,1738,289,4733
"06037408631",2662,382,0,39,1899,353,2838,364,8537
"06037408703",897,106,25,0,5595,250,415,12,7300
"06037408704",779,84,45,11,1936,344,971,34,4204
"06037408705",1011,114,31,10,3895,388,1468,189,7106
"06037408706",594,30,8,0,1294,10,301,9,2246
"06037408722",1323,91,20,0,2738,346,1554,94,6166
"06037408723",582,58,0,0,2113,122,606,21,3502
"06037408724",649,77,0,20,3666,739,2670,634,8455
"06037408800",1325,569,180,207,711,659,1429,839,5919
"06037430002",3475,445,456,0,1680,753,1873,757,9439
"06037430003",2577,114,213,0,1680,14,749,10,5357
"06037430101",2103,343,218,239,1657,212,1776,294,6842
"06037430102",1786,319,188,1,2286,384,3308,585,8857
"06037430200",610,59,22,0,321,41,107,44,1204
"06037430301",3478,191,19,0,753,19,708,0,5168
"06037430302",4185,148,238,2,1374,60,1472,112,7591
"06037430400",1795,34,62,7,2596,285,530,10,5319
"06037430501",3233,186,18,0,1024,16,747,15,5239
"06037430502",4686,297,82,14,1022,401,559,364,7425
"06037430600",2105,80,28,0,2256,188,723,35,5415
"06037430701",2128,131,95,0,2657,223,600,36,5870
"06037430721",992,87,11,2,1752,306,332,16,3498
"06037430723",827,66,0,0,2853,350,338,66,4500
"06037430724",958,135,128,0,3535,573,617,89,6035
"06037430801",1733,167,24,0,4182,509,1086,188,7889
"06037430802",1163,333,0,0,2787,83,132,0,4498
"06037430803",1725,39,12,11,2965,441,562,199,5954
"06037430901",1622,79,110,63,1844,408,1804,255,6185
"06037430902",1733,91,191,19,2245,200,2004,82,6565
"06037431001",3449,606,192,155,2003,502,2466,874,10247
"06037431002",1729,304,322,30,719,40,1001,148,4293
"06037431100",2586,216,670,121,3116,349,3485,435,10978
"06037431200",2061,501,345,46,2313,488,3158,788,9700
"06037431300",1681,31,72,0,940,25,835,22,3606
"06037431400",1709,63,46,0,1879,101,813,85,4696
"06037431501",1302,298,188,0,1685,724,1017,354,5568
"06037431502",1428,190,9,0,2494,229,1163,171,5684
"06037431600",1112,31,11,0,2475,195,187,13,4024
"06037431700",1580,120,23,0,4119,456,276,0,6574
"06037431800",1506,376,215,52,3251,453,785,237,6875
"06037431900",749,197,11,0,2786,255,836,108,4942
"06037432000",2287,68,61,0,4400,384,880,0,8080
"06037432101",1137,111,0,32,2875,224,755,159,5293
"06037432102",1541,255,6,0,3324,337,403,48,5914
"06037432201",988,74,39,0,2749,501,613,90,5054
"06037432202",1031,219,0,0,2652,418,1528,294,6142
"06037432300",1297,83,0,11,2506,149,2062,64,6172
"06037432401",1043,899,36,0,1748,427,1316,943,6412
"06037432402",1784,718,78,39,2697,1146,2598,895,9955
"06037432500",3107,462,93,0,3847,743,3536,587,12375
"06037432601",1930,872,0,0,3204,670,2470,1012,10158
"06037432602",818,220,13,2,2901,404,1728,440,6526
"06037432700",1974,724,10,0,2232,345,3227,959,9471
"06037432801",905,302,0,0,1581,280,1692,380,5140
"06037432802",1388,712,12,0,2455,952,2699,1160,9378
"06037432901",812,74,0,10,3164,798,1194,192,6244
"06037432902",809,101,0,0,2332,280,1221,239,4982
"06037433101",1021,204,0,3,1289,129,985,204,3835
"06037433102",1354,801,9,0,1772,710,1719,1153,7518
"06037433200",1966,676,21,0,2549,626,3208,962,10008
"06037433302",469,225,0,0,856,334,981,555,3420
"06037433304",992,342,19,0,2504,600,2172,508,7137
"06037433305",913,1085,0,0,1937,975,1743,1937,8590
"06037433306",1089,444,25,21,1426,431,1728,626,5790
"06037433307",1032,508,47,0,1382,146,1397,543,5055
"06037433401",1428,364,0,0,797,204,1613,352,4758
"06037433402",1532,1209,40,2,1482,246,1943,1321,7775
"06037433403",1591,851,0,0,1513,718,2600,1394,8667
"06037433501",685,671,0,0,570,91,1187,699,3903
"06037433503",2212,289,0,0,711,177,2364,382,6135
"06037433504",2504,648,3,0,1040,485,2790,882,8352
"06037433601",783,365,0,0,3147,384,721,520,5920
"06037433602",406,68,0,0,1356,616,574,177,3197
"06037433700",2369,283,12,0,984,106,2807,366,6927
"06037433801",3022,985,0,3,1080,582,3776,1470,10918
"06037433802",1617,334,0,7,825,0,2105,293,5181
"06037433901",1629,657,11,21,2303,863,2837,1203,9524
"06037433902",1562,475,0,13,1271,110,2344,537,6312
"06037434001",2163,816,17,0,1480,241,3061,1046,8824
"06037434003",2060,345,0,3,1497,805,2918,722,8350
"06037434004",1891,408,4,0,507,12,2162,420,5404
"06037460000",3117,275,182,0,991,44,589,33,5231
"06037460100",3972,460,585,32,914,122,653,166,6904
"06037460200",2566,61,1545,146,761,128,476,38,5721
"06037460301",1944,125,1599,135,740,9,737,115,5404
"06037460302",2120,462,1037,555,374,98,1665,446,6757
"06037460401",275,138,475,35,219,0,131,126,1399
"06037460501",3633,109,2,0,1996,0,264,1,6005
"06037460502",2781,170,0,2,1239,0,204,0,4396
"06037460600",3359,0,0,0,1140,14,327,7,4847
"06037460700",3472,42,40,0,1472,36,168,9,5239
"06037460800",2605,72,37,11,452,0,311,0,3488
"06037460900",3215,462,1430,441,900,80,3297,483,10308
"06037461000",3041,446,1613,133,974,224,3346,601,10378
"06037461100",2694,394,1014,173,1162,67,1926,270,7700
"06037461200",3407,211,463,45,517,57,966,129,5795
"06037461300",4702,415,331,13,1098,197,941,312,8009
"06037461400",1957,198,489,46,310,153,532,232,3917
"06037461501",2264,153,589,164,588,175,1701,162,5796
"06037461502",3190,1027,826,357,861,304,3175,833,10573
"06037461600",2245,522,1117,255,984,209,2099,674,8105
"06037461700",1023,83,202,91,162,0,282,0,1843
"06037461901",2215,749,547,73,1060,177,2275,727,7823
"06037461902",717,125,89,19,284,102,262,36,1634
"06037462001",2029,426,626,127,831,256,2089,537,6921
"06037462002",1949,352,727,10,915,140,2360,351,6804
"06037462100",2982,543,525,80,910,67,2599,481,8187
"06037462201",1785,414,303,109,683,421,977,439,5131
"06037462202",1267,320,326,0,628,362,70,18,2991
"06037462301",2525,714,581,28,944,260,2067,457,7576
"06037462302",1093,212,202,13,768,185,611,35,3119
"06037462400",2874,389,152,63,880,54,1272,211,5895
"06037462500",3851,435,489,2,1086,48,846,47,6804
"06037462600",1789,109,86,10,282,57,474,4,2811
"06037462700",2858,256,402,51,1561,59,1796,98,7081
"06037462800",1462,159,159,101,667,179,773,202,3702
"06037462900",2270,139,400,21,844,189,901,80,4844
"06037463000",1352,170,206,0,586,20,407,135,2876
"06037463101",1267,85,32,13,722,143,798,97,3157
"06037463102",1657,579,20,2,1380,146,1005,553,5342
"06037463200",2062,331,125,10,935,57,909,214,4643
"06037463300",1496,52,111,0,476,12,307,0,2454
"06037463400",3036,146,286,48,1605,161,854,63,6199
"06037463500",2410,162,111,73,1887,458,894,66,6061
"06037463601",3108,344,193,59,2114,144,885,56,6903
"06037463602",2905,487,329,191,1274,434,613,121,6354
"06037463700",1634,233,127,47,550,31,286,92,3000
"06037463800",2659,68,138,0,795,33,349,33,4075
"06037463900",2758,53,107,0,320,94,441,29,3802
"06037464000",3988,70,162,0,1418,236,865,15,6754
"06037464100",3638,172,0,0,3234,161,610,36,7851
"06037464200",1884,101,0,0,3739,276,382,95,6477
"06037480002",1238,50,0,1,2085,57,570,8,4009
"06037480011",1628,92,73,0,3128,558,1355,29,6863
"06037480012",1543,44,0,0,3130,343,739,45,5844
"06037480101",946,72,0,0,3075,256,874,115,5338
"06037480102",1214,45,0,2,3022,233,1240,41,5797
"06037480201",1837,11,6,0,2187,29,1168,0,5238
"06037480202",1236,12,17,0,1341,31,698,0,3335
"06037480302",1346,224,233,14,2151,460,1342,199,5969
"06037480303",594,148,140,0,2630,741,1399,379,6031
"06037480304",732,182,117,8,2377,770,1031,277,5494
"06037480400",2342,127,0,0,2681,354,1682,308,7494
"06037480500",3335,149,160,0,1703,72,790,47,6256
"06037480600",4076,318,223,13,2356,421,1581,419,9407
"06037480702",2325,93,32,24,2211,70,920,44,5719
"06037480703",1714,97,8,0,1359,27,580,0,3785
"06037480704",1956,188,44,10,2347,229,760,50,5584
"06037480802",894,29,50,11,1946,196,1547,25,4698
"06037480803",1768,89,0,0,1568,77,1735,82,5319
"06037480804",1289,136,84,0,3493,658,1977,261,7898
"06037480901",1046,75,27,1,2668,478,1388,120,5803
"06037480902",681,189,0,0,2320,618,1166,244,5218
"06037480903",613,11,134,0,1590,416,725,21,3510
"06037481001",707,16,38,6,2594,523,1201,192,5277
"06037481002",768,179,63,0,3971,652,2075,160,7868
"06037481101",737,127,19,8,2607,324,1331,89,5242
"06037481102",441,51,82,0,2229,678,710,325,4516
"06037481103",912,82,8,0,3451,417,1639,74,6583
"06037481201",572,165,90,0,2690,123,420,115,4175
"06037481202",998,77,52,27,3393,707,1485,291,7030
"06037481300",619,78,0,1,2305,424,822,245,4494
"06037481401",648,140,0,0,4584,760,857,145,7134
"06037481402",1167,14,49,2,4814,1158,977,32,8213
"06037481500",660,144,0,0,2969,479,771,100,5123
"06037481603",653,27,9,18,2663,504,788,17,4679
"06037481604",873,16,84,0,2472,462,1180,52,5139
"06037481605",511,8,0,0,2210,505,870,67,4171
"06037481606",771,57,50,0,2830,967,853,195,5723
"06037481711",210,93,39,0,3060,938,195,74,4609
"06037481712",178,182,0,7,3311,1135,548,428,5789
"06037481713",68,0,0,0,2083,520,72,133,2876
"06037481714",127,53,50,0,1621,810,279,81,3021
"06037481800",750,15,7,0,1747,176,581,31,3307
"06037481901",1965,203,8,16,3277,241,2133,193,8036
"06037481902",1175,13,26,0,2006,326,1532,95,5173
"06037482001",371,89,0,0,2137,160,251,0,3008
"06037482002",1109,60,0,2,4638,1058,1884,490,9241
"06037482101",1077,0,0,0,3276,622,1644,101,6720
"06037482102",746,27,57,0,1976,184,854,89,3933
"06037482201",313,43,0,0,3089,543,963,35,4986
"06037482202",495,24,35,0,3739,671,892,112,5968
"06037482301",429,188,0,0,3658,1084,589,376,6324
"06037482303",1058,399,0,0,3760,939,1785,440,8381
"06037482304",555,402,0,0,2150,351,1161,387,5006
"06037482401",754,215,0,0,2436,471,1465,222,5563
"06037482402",1252,230,0,0,4977,604,2104,222,9389
"06037482502",308,69,0,0,1712,751,316,183,3339
"06037482503",672,526,0,0,2528,776,866,526,5894
"06037482521",1339,262,71,40,3039,538,1837,481,7607
"06037482522",1442,88,31,8,2388,315,1722,233,6227
"06037482600",1676,237,48,2,4420,370,1546,224,8523
"06037482701",1156,147,30,0,3015,169,2440,235,7192
"06037482702",799,93,2,0,1289,193,1013,116,3505
"06037482800",1410,170,16,0,2295,319,1895,286,6391
"06037500100",2441,98,21,4,779,9,677,47,4076
"06037500201",4133,233,0,0,1584,0,2167,0,8117
"06037500202",3289,69,33,0,1429,149,2003,166,7138
"06037500300",1638,170,76,0,1240,105,1627,123,4979
"06037500402",1803,288,35,19,1638,310,3263,617,7973
"06037500403",2421,150,80,0,1297,421,3338,520,8227
"06037500404",2297,132,9,0,2023,487,3504,599,9051
"06037500500",1345,58,22,0,1449,145,2566,154,5739
"06037500600",2371,896,35,0,2135,615,4080,1490,11622
"06037500700",3525,366,0,0,2417,299,5535,580,12722
"06037500800",2632,480,78,27,1901,245,4311,628,10302
"06037500900",2138,598,20,48,2084,649,3805,1210,10552
"06037501001",1273,36,25,0,1212,109,2456,136,5247
"06037501002",2318,176,17,0,2329,121,3810,212,8983
"06037501200",2438,156,50,40,2032,318,3505,335,8874
"06037501300",3946,183,42,25,2629,641,4697,694,12857
"06037501400",1244,460,59,0,1997,322,2887,744,7713
"06037501501",1393,109,33,0,678,14,1097,35,3359
"06037501503",1798,381,186,0,2139,348,2791,650,8293
"06037501504",1330,397,0,36,1316,549,1966,805,6399
"06037501600",3938,161,0,17,2142,308,3062,362,9990
"06037501700",2758,342,0,0,696,90,1834,412,6132
"06037501802",1999,179,6,0,1070,263,2094,332,5943
"06037501803",768,771,58,30,2227,733,2671,1420,8678
"06037501804",844,363,16,0,683,113,1213,300,3532
"06037501900",2171,239,0,0,1656,50,2657,93,6866
"06037502003",1173,29,38,49,1188,489,1937,508,5411
"06037502004",1247,203,48,6,1959,442,2851,614,7370
"06037502005",2121,171,90,0,1889,158,2799,314,7542
"06037502100",2833,248,76,0,1834,186,4027,368,9572
"06037502200",3148,351,0,7,2559,210,4834,438,11547
"06037502301",2766,465,13,0,2890,322,5250,697,12403
"06037502302",549,408,5,13,1058,398,1485,761,4677
"06037502401",1948,241,48,0,2348,0,4073,241,8899
"06037502402",1786,269,0,6,1353,230,2891,496,7031
"06037502500",1694,178,0,7,1379,516,2713,682,7169
"06037502601",4163,314,0,0,3037,63,6645,297,14519
"06037502602",2371,95,50,0,2154,189,4072,264,9195
"06037502700",3340,331,108,6,2316,270,4970,529,11870
"06037502801",3362,187,393,0,2639,96,4645,203,11525
"06037502802",713,148,224,15,793,106,1189,188,3376
"06037502901",2648,118,84,0,2213,147,3938,76,9224
"06037502902",1714,782,24,15,1310,402,2630,1070,7947
"06037503000",2582,714,0,0,1917,718,4171,1392,11494
"06037503103",2712,443,16,0,1971,56,4040,451,9689
"06037503104",953,317,116,0,1035,274,1766,543,5004
"06037503105",3125,342,1,0,423,86,2659,309,6945
"06037503106",2287,116,44,0,1182,124,2612,167,6532
"06037503201",3021,165,17,0,963,10,2679,65,6920
"06037503202",2595,309,9,0,1312,479,2669,694,8067
"06037503301",1889,100,0,0,1231,0,2325,86,5631
"06037503302",3455,319,21,7,2380,401,4127,661,11371
"06037503401",3952,316,153,13,1871,182,3147,215,9849
"06037503402",3313,98,79,0,995,83,2232,92,6892
"06037503501",3334,623,73,17,2277,236,3811,548,10919
"06037503502",2765,236,9,0,1001,116,2334,183,6644
"06037503601",2763,141,32,0,980,11,1606,72,5605
"06037503602",2194,135,95,0,1045,163,1267,221,5120
"06037503701",3883,226,7,0,1085,48,2884,110,8243
"06037503702",3621,193,2,0,1330,70,2459,174,7849
"06037503703",2777,121,234,0,4049,324,1531,18,9054
"06037503801",2567,431,29,0,1244,47,1596,374,6288
"06037503802",2411,189,158,12,2019,250,1711,317,7067
"06037503901",1857,137,29,0,1001,49,1220,112,4405
"06037503902",2457,111,77,0,1793,49,2001,68,6556
"06037504001",1970,160,43,0,1119,0,1228,28,4548
"06037504002",3245,231,116,0,1554,114,2103,149,7512
"06037504101",2712,217,32,2,2310,352,3337,488,9450
"06037504102",0,0,0,0,0,0,0,0,0
"06037530003",2005,67,9,0,771,90,1614,77,4633
"06037530004",2506,450,0,0,1039,63,2492,440,6990
"06037530005",1709,111,35,0,2713,175,1447,74,6264
"06037530006",2443,307,0,0,980,30,2202,293,6255
"06037530101",2696,616,68,58,1651,534,4024,906,10553
"06037530102",2817,488,6,11,943,301,2910,452,7928
"06037530202",2099,225,34,0,1760,35,3205,146,7504
"06037530203",1854,115,0,2,983,227,2232,277,5690
"06037530204",1991,516,158,0,995,179,2715,685,7239
"06037530301",1663,286,0,0,444,83,2092,360,4928
"06037530302",3821,897,0,10,1671,587,5233,1458,13677
"06037530400",1610,938,0,88,1093,280,2021,1078,7108
"06037530500",2365,702,8,0,1118,501,3452,1191,9337
"06037530601",1530,353,0,0,1285,742,2628,1060,7598
"06037530602",605,28,0,0,506,249,1079,277,2744
"06037530700",870,196,0,0,596,437,1404,614,4117
"06037530801",1544,734,0,0,2359,1270,3752,1946,11605
"06037530802",851,421,32,4,1624,412,2407,805,6556
"06037530901",1360,201,0,0,1756,764,3082,944,8107
"06037530902",756,483,0,2,2283,1126,2916,1573,9139
"06037531000",2819,523,0,0,1257,552,3962,1024,10137
"06037531101",1791,321,32,0,1611,732,3353,984,8824
"06037531102",804,171,0,0,1307,604,2093,762,5741
"06037531201",2102,222,0,0,1774,1173,3853,1395,10519
"06037531202",1204,561,0,0,1658,533,2855,1059,7870
"06037531301",1803,703,30,4,1731,1275,3516,1978,11040
"06037531302",1590,912,59,0,2709,1641,4293,2553,13757
"06037531502",1623,751,0,0,1021,341,2602,1092,7430
"06037531503",1293,866,0,61,907,368,2194,1268,6957
"06037531504",1994,450,0,0,1442,775,3377,1225,9263
"06037531602",2380,1111,58,0,1268,177,3647,1279,9920
"06037531603",2037,583,0,16,949,228,2917,775,7505
"06037531604",1854,758,0,10,688,458,2505,1226,7499
"06037531701",2746,864,0,0,1425,383,4084,1225,10727
"06037531702",2949,709,0,0,857,264,3771,962,9512
"06037531800",2463,756,0,0,1152,297,3560,1016,9244
"06037531901",4063,1384,7,0,1295,295,5225,1679,13948
"06037531902",2082,469,0,0,1010,286,3052,733,7632
"06037532001",1916,548,146,25,572,175,2367,645,6394
"06037532002",2126,369,0,0,392,222,2335,543,5987
"06037532101",3514,978,63,2,1323,596,4622,1550,12648
"06037532102",2268,365,9,1,814,38,2660,340,6495
"06037532200",3772,1001,108,81,1228,455,4501,1477,12623
"06037532302",2590,305,0,0,1109,390,3623,666,8683
"06037532303",2698,331,0,0,1117,309,3637,625,8717
"06037532304",2358,736,95,232,782,440,3020,995,8658
"06037532400",12,2,0,0,36,10,39,12,111
"06037532500",2120,618,74,0,687,274,2660,892,7325
"06037532603",1403,624,0,0,740,675,2137,1299,6878
"06037532604",1634,453,0,0,710,185,2309,628,5919
"06037532605",2193,725,19,0,973,395,3127,1061,8493
"06037532606",2208,1198,10,0,821,234,2986,1419,8876
"06037532700",1356,470,54,0,604,246,1943,707,5380
"06037532800",1393,1149,171,82,894,463,2255,1612,8019
"06037532900",2896,1724,201,106,961,571,3866,2283,12608
"06037533001",1503,679,36,0,1168,493,2671,1113,7663
"06037533002",1589,623,0,0,547,150,2106,773,5788
"06037533103",1190,925,0,9,724,453,1874,1387,6562
"06037533104",1866,1491,10,0,717,529,2513,2014,9140
"06037533105",1383,757,0,0,262,177,1620,911,5110
"06037533106",1039,494,0,0,226,161,1248,655,3823
"06037533107",2152,801,82,11,455,143,2599,955,7198
"06037533201",1340,431,0,0,601,193,1908,624,5097
"06037533202",1264,354,0,0,772,54,2026,404,4874
"06037533203",674,387,0,0,458,58,1057,444,3078
"06037533300",1701,723,0,0,613,528,2264,1232,7061
"06037533401",2793,1456,10,0,610,107,3347,1563,9886
"06037533402",2365,825,0,0,907,90,3272,915,8374
"06037533403",1555,703,0,7,626,27,2132,731,5781
"06037533501",1620,743,0,0,393,419,2013,1152,6340
"06037533502",1486,263,0,0,572,20,2026,283,4650
"06037533503",1215,257,0,0,244,286,1449,538,3989
"06037533601",1652,1292,0,24,990,643,2605,1817,9023
"06037533602",2871,819,0,0,1258,467,3907,1217,10539
"06037533603",2550,1243,19,43,2043,646,4000,1713,12257
"06037533701",2157,917,14,12,632,182,2662,1094,7670
"06037533702",1622,648,0,37,952,317,2547,948,7071
"06037533703",2079,862,9,24,932,277,2949,1136,8268
"06037533803",2926,1248,57,0,1439,368,4055,1596,11689
"06037533804",1940,544,11,2,1289,317,2911,821,7835
"06037533805",1924,827,0,0,1014,230,2778,1041,7814
"06037533806",2023,937,18,0,599,441,2438,1378,7834
"06037533901",3059,1103,16,0,1231,493,4200,1596,11698
"06037533902",1895,591,0,49,1240,172,3039,812,7798
"06037534001",2567,1420,0,2,1127,419,3661,1763,10959
"06037534002",1842,586,68,36,1636,395,3372,1011,8946
"06037534101",1241,317,0,14,501,80,1564,393,4110
"06037534102",3313,1136,56,108,1106,787,4352,1957,12815
"06037534201",1925,1023,10,0,833,320,2733,1277,8121
"06037534202",2920,1364,0,62,1280,487,4137,1811,12061
"06037534203",1928,475,0,43,703,124,2535,631,6439
"06037534301",1771,1028,0,22,1084,548,2703,1561,8717
"06037534302",1824,965,17,0,872,443,2713,1408,8242
"06037534403",1344,424,35,55,871,226,2220,705,5880
"06037534404",1348,652,58,0,960,385,2181,1032,6616
"06037534405",1551,626,22,0,1415,426,2902,1045,7987
"06037534406",2071,1187,12,0,975,586,3028,1755,9614
"06037534501",2906,519,145,2,1012,255,3843,706,9388
"06037534502",2588,851,0,0,522,267,3041,1118,8387
"06037534700",3241,618,9,0,813,56,3994,643,9374
"06037534802",1782,252,0,0,588,184,2249,423,5478
"06037534803",2548,825,0,0,820,308,3253,1133,8887
"06037534804",1921,866,0,0,880,380,2761,1206,8014
"06037534900",3099,1067,19,11,1596,778,4685,1823,13078
"06037535001",1892,801,149,100,1043,659,2935,1404,8983
"06037535002",1455,699,154,24,359,331,1762,958,5742
"06037535101",2654,773,1082,251,1770,785,4322,1573,13210
"06037535102",1619,734,546,236,814,324,2428,1040,7741
"06037535200",2411,886,786,269,1043,411,3460,1215,10481
"06037535300",3196,1204,204,198,1000,399,4117,1591,11909
"06037535400",1985,754,168,203,313,297,2302,1040,7062
"06037535501",1318,333,37,0,1628,520,2911,853,7600
"06037535502",1345,311,0,41,2723,533,4035,871,9859
"06037535503",1000,323,0,0,627,467,1613,783,4813
"06037535603",1290,424,56,13,1104,559,2374,983,6803
"06037535604",1011,377,0,0,2053,928,3051,1305,8725
"06037535605",1501,396,45,19,1690,655,3158,1046,8510
"06037535606",566,187,9,0,609,534,1139,721,3765
"06037535607",1890,175,15,9,1909,321,3774,494,8587
"06037535701",2631,842,0,0,2210,806,4567,1641,12697
"06037535702",1383,360,70,0,1866,834,3152,1189,8854
"06037535802",2565,513,31,0,3079,1017,5492,1508,14205
"06037535803",1454,436,0,0,1407,838,2822,1274,8231
"06037535804",1373,432,15,19,2402,705,3703,1137,9786
"06037535901",2247,226,89,0,2525,361,4742,581,10771
"06037535902",3972,384,0,0,3104,279,6711,646,15096
"06037536000",1375,311,43,4,2070,366,3353,673,8195
"06037536102",1843,435,94,0,549,230,2040,603,5794
"06037536103",2643,238,12,4,2255,596,4639,834,11221
"06037536104",2019,495,11,28,1208,397,3057,856,8071
"06037536200",3403,954,73,8,2313,711,4850,1547,13859
"06037540000",1614,591,243,202,3475,799,5043,1442,13409
"06037540101",2447,508,466,23,2540,481,4743,966,12174
"06037540102",2327,242,625,103,2858,586,5209,825,12775
"06037540201",554,273,28,23,577,553,1137,763,3908
"06037540202",1589,540,113,189,2179,2034,3641,2398,12683
"06037540203",1626,365,209,32,2426,947,3980,1288,10873
"06037540300",1480,601,45,26,2442,558,3799,1157,10108
"06037540400",848,449,174,107,470,378,1287,823,4536
"06037540501",1325,350,381,9,1971,1707,3248,2056,11047
"06037540502",1921,658,559,113,2298,1015,4068,1615,12247
"06037540600",624,310,900,374,784,597,1318,758,5665
"06037540700",615,138,1044,395,647,180,1174,222,4415
"06037540800",703,138,3504,395,721,195,1363,321,7340
"06037540901",959,160,1396,378,926,305,1815,434,6373
"06037540902",927,249,2383,562,606,123,1501,342,6693
"06037541001",155,46,337,37,399,119,350,152,1595
"06037541002",803,16,1408,53,524,145,736,148,3833
"06037541100",525,60,1346,263,631,195,1046,217,4283
"06037541200",655,404,3306,394,870,146,1132,535,7442
"06037541300",1604,349,1456,611,1511,330,2927,659,9447
"06037541400",1359,1849,741,395,1997,955,3309,2779,13384
"06037541500",2895,583,392,171,860,635,3691,1194,10421
"06037541603",857,659,293,138,507,702,1331,1349,5836
"06037541604",1878,1381,552,367,1069,1097,2893,2436,11673
"06037541605",1130,659,943,222,2156,484,3269,1128,9991
"06037541606",761,500,248,116,660,202,1351,702,4540
"06037541700",1474,304,514,30,2745,765,4094,1038,10964
"06037541801",1058,506,642,263,1779,474,2756,972,8450
"06037541802",1241,521,385,93,2430,467,3640,996,9773
"06037542000",954,515,1313,139,1701,611,2581,955,8769
"06037542103",1211,424,397,95,1271,241,2470,657,6766
"06037542104",1200,238,300,11,1273,341,2334,576,6273
"06037542105",1790,525,158,95,1399,1065,3026,1564,9622
"06037542106",1295,399,260,97,883,233,2073,583,5823
"06037542200",1754,838,1414,380,2322,497,4015,1345,12565
"06037542401",1052,391,1589,284,829,345,1721,748,6959
"06037542402",1194,130,1271,87,536,162,1697,266,5343
"06037542501",641,351,1674,634,565,614,1064,915,6458
"06037542502",864,330,1064,213,620,883,1454,1197,6625
"06037542601",1233,252,138,214,764,332,1914,583,5430
"06037542602",1257,1028,1236,318,1782,346,3112,1291,10370
"06037542700",1569,889,1041,137,1556,416,3110,1272,9990
"06037542800",868,36,1182,182,1057,26,1760,68,5179
"06037542900",848,379,541,197,716,256,1600,586,5123
"06037543000",379,116,2096,209,1389,52,1561,166,5968
"06037543100",1876,335,2862,209,1018,600,2615,697,10212
"06037543201",640,487,1072,311,1356,152,1738,623,6379
"06037543202",1173,490,854,338,1199,574,2340,915,7883
"06037543304",541,33,4290,297,1039,155,713,52,7120
"06037543305",1135,418,799,25,391,134,778,340,4020
"06037543306",2015,180,1212,99,2953,372,2016,105,8952
"06037543321",660,210,2655,215,1255,113,364,292,5764
"06037543322",225,46,3968,443,1970,94,295,26,7067
"06037543400",1259,303,616,62,1821,140,1953,386,6540
"06037543501",1510,525,400,208,3779,416,1844,445,9127
"06037543502",1665,247,100,2,1782,163,1624,179,5762
"06037543503",1342,65,312,66,2720,278,1081,14,5878
"06037543601",1579,104,294,10,2097,115,1974,155,6328
"06037543602",2164,500,739,21,3547,431,2098,681,10181
"06037543603",1621,56,830,43,1058,26,736,6,4376
"06037543604",1480,572,141,0,3583,170,2237,465,8648
"06037543701",912,58,6,0,1845,170,1126,92,4209
"06037543702",2597,347,121,21,3776,209,3506,353,10930
"06037543703",1657,49,132,1,1606,128,1973,44,5590
"06037543801",1484,165,89,25,3400,232,2289,222,7906
"06037543802",1485,136,501,79,4398,355,1864,224,9042
"06037543903",1313,315,50,44,1870,178,1410,316,5496
"06037543905",1866,420,380,164,1489,212,2777,588,7896
"06037544001",1704,280,149,19,1814,255,2687,402,7310
"06037544002",1509,26,56,0,1127,15,1848,7,4588
"06037550000",179,130,126,53,176,20,184,61,929
"06037550100",4814,243,126,11,2240,352,5920,167,13873
"06037550201",1578,44,0,0,1070,148,2020,64,4924
"06037550202",2864,426,219,135,2014,60,3635,400,9753
"06037550300",3485,430,25,0,2968,122,5046,393,12469
"06037550400",993,50,124,0,495,10,961,55,2688
"06037550500",5529,495,252,0,1232,33,5146,386,13073
"06037550601",3020,449,231,0,1632,91,3416,407,9246
"06037550602",2906,175,13,0,1248,0,2806,12,7160
"06037550700",5266,184,58,2,1451,192,4907,243,12303
"06037550800",4008,508,31,1,2542,0,4511,403,12004
"06037550901",1653,378,182,42,1467,92,2308,356,6478
"06037550902",2693,550,505,0,2018,97,3651,474,9988
"06037551000",4353,416,0,0,2015,293,4124,563,11764
"06037551101",1276,591,220,43,1526,448,2357,897,7358
"06037551102",1451,708,374,29,2159,357,3166,1005,9249
"06037551201",2198,29,108,46,1322,8,2493,72,6276
"06037551202",3801,196,436,147,1994,221,4595,275,11665
"06037551300",2980,650,146,49,1432,181,3473,680,9591
"06037551401",2302,858,21,49,1491,486,2607,1252,9066
"06037551402",2475,113,117,0,1514,91,2738,116,7164
"06037551501",1933,224,276,0,2145,272,2748,294,7892
"06037551502",1810,1027,0,0,1258,125,2007,567,6794
"06037551600",0,0,0,0,0,0,0,0,0
"06037551700",2957,243,357,0,2214,644,4263,768,11446
"06037551800",2971,365,323,35,3448,407,4775,741,13065
"06037551900",2392,420,201,97,2198,212,3495,583,9598
"06037552001",1707,270,149,4,1673,37,2298,264,6402
"06037552002",1525,81,243,16,1360,485,2061,513,6284
"06037552100",2699,238,191,31,2572,568,3789,393,10481
"06037552200",1814,504,482,68,2342,815,3661,1256,10942
"06037552301",2106,210,248,17,2003,34,2891,242,7751
"06037552302",1099,117,278,22,1408,520,1476,554,5474
"06037552400",1035,49,46,0,1406,170,2270,173,5149
"06037552601",2803,357,0,2,2106,265,4472,536,10541
"06037552602",1286,561,43,0,2160,232,1387,662,6331
"06037552700",3621,393,123,30,2354,335,4221,550,11627
"06037552800",2677,686,207,35,2022,547,3585,1016,10775
"06037552900",2801,557,117,151,3034,518,3622,859,11659
"06037553000",2357,33,406,0,2065,206,3514,203,8784
"06037553100",2725,281,871,207,2324,563,2573,658,10202
"06037553200",2771,384,405,129,3180,256,3845,555,11525
"06037553300",1256,116,132,3,1099,759,1467,822,5654
"06037553400",1794,173,36,28,1384,277,2623,373,6688
"06037553502",1514,388,400,9,1208,402,2534,768,7223
"06037553503",1025,130,346,150,1123,196,1735,319,5024
"06037553504",2072,522,271,171,2428,506,4028,834,10832
"06037553601",1853,283,405,192,2011,217,3561,499,9021
"06037553602",1019,255,926,147,1853,362,2511,593,7666
"06037553701",1112,325,57,0,1672,731,2501,1038,7436
"06037553702",898,530,209,39,2330,599,3152,1106,8863
"06037553801",1413,230,735,62,1193,555,2339,810,7337
"06037553802",1583,600,617,277,1993,1290,2946,1725,11031
"06037553901",2149,578,361,62,2992,536,4089,1083,11850
"06037553902",1294,425,451,139,2488,989,3183,1356,10325
"06037554001",1495,62,133,66,2041,299,2275,344,6715
"06037554002",1504,456,465,2,2373,606,2719,638,8763
"06037554101",1187,408,31,20,1835,417,2056,790,6744
"06037554103",429,16,194,15,976,16,909,16,2571
"06037554104",1462,79,211,118,388,21,827,65,3171
"06037554105",955,692,769,446,1338,234,1599,569,6602
"06037554201",1521,170,525,44,1144,224,1195,358,5181
"06037554203",1448,477,403,24,1099,170,1254,480,5355
"06037554204",1293,436,628,137,1218,545,1594,634,6485
"06037554301",1213,130,486,263,1523,169,2213,283,6280
"06037554302",759,120,828,61,1657,494,1690,560,6169
"06037554403",1095,299,755,179,2601,839,2301,810,8879
"06037554404",918,145,744,179,1925,379,1413,362,6065
"06037554405",1134,250,708,118,843,111,927,216,4307
"06037554406",2059,183,596,50,1605,208,1318,131,6150
"06037554511",759,47,273,0,2948,57,341,0,4425
"06037554512",1150,10,268,0,4423,80,457,9,6397
"06037554513",448,2,289,1,2061,48,404,0,3253
"06037554514",1059,38,411,12,2723,262,648,24,5177
"06037554515",817,128,250,0,2356,100,237,45,3933
"06037554516",714,110,344,0,2382,229,524,36,4339
"06037554517",718,54,180,1,3524,344,311,52,5184
"06037554518",951,209,334,24,3642,163,491,12,5826
"06037554519",759,71,137,0,2261,182,360,0,3770
"06037554521",1945,137,633,3,2772,192,835,7,6524
"06037554522",1156,94,405,41,3461,78,953,123,6311
"06037554600",1373,468,36,51,2119,273,1583,616,6519
"06037554700",1900,434,145,8,2237,281,3506,618,9129
"06037554801",1214,186,74,4,1571,266,2213,432,5960
"06037554802",2012,102,188,104,3320,371,1299,201,7597
"06037554900",2468,193,162,23,2953,932,1347,300,8378
"06037555001",1443,709,362,15,2610,306,1593,690,7728
"06037555002",1515,294,352,42,871,272,1200,373,4919
"06037555102",1843,456,573,150,3133,970,2641,1135,10901
"06037555103",1185,9,445,0,2608,458,1022,222,5949
"06037555104",1527,311,161,0,2145,14,1079,233,5470
"06037555202",2379,132,108,0,679,41,658,2,3999
"06037555211",3311,913,2,12,825,369,3640,1149,10221
"06037555212",2731,1233,110,24,919,79,2725,1133,8954
"06037570001",2379,57,123,1,1526,36,1015,1,5138
"06037570002",1452,119,65,8,1220,21,1123,33,4041
"06037570003",2414,309,430,0,1560,90,1394,108,6305
"06037570100",867,139,746,245,845,39,300,7,3188
"06037570202",1469,368,823,179,2705,892,3014,836,10286
"06037570203",517,158,633,414,1906,203,1937,252,6020
"06037570204",1033,142,606,122,1146,595,1258,567,5469
"06037570301",2195,666,840,365,2057,762,3513,1110,11508
"06037570303",1034,412,438,476,1593,307,2011,601,6872
"06037570304",1099,678,611,307,1792,701,2570,1233,8991
"06037570402",692,95,1091,122,1109,205,1353,255,4922
"06037570403",745,837,901,29,1683,527,2264,1239,8225
"06037570404",1184,278,467,247,922,126,1866,376,5466
"06037570501",2570,312,1269,344,3461,283,4287,391,12917
"06037570502",1892,385,926,59,2843,549,2848,491,9993
"06037570601",1582,155,625,309,1927,573,2391,488,8050
"06037570602",1898,512,536,248,2878,538,2598,426,9634
"06037570603",513,254,1457,775,951,501,936,373,5760
"06037570701",2225,265,884,55,2692,315,1144,434,8014
"06037570702",1214,89,162,22,849,0,873,28,3237
"06037570800",3483,257,233,0,1943,46,1813,13,7788
"06037570901",3398,110,230,16,1725,70,1689,62,7300
"06037570902",2749,120,210,0,646,169,666,134,4694
"06037571000",4216,200,168,14,1114,32,1484,52,7280
"06037571101",2879,52,138,0,1215,255,1139,255,5933
"06037571102",2804,196,0,0,727,23,713,102,4565
"06037571200",4939,282,451,18,2284,49,2249,90,10362
"06037571300",2206,164,377,23,1057,0,963,9,4799
"06037571400",2791,77,430,28,1199,34,1477,49,6085
"06037571502",1504,114,817,206,1853,100,923,75,5592
"06037571503",1179,178,634,174,1233,85,883,227,4593
"06037571504",1584,186,681,168,2077,181,1366,343,6586
"06037571600",205,121,348,769,178,347,213,357,2538
"06037571701",1970,326,456,652,2713,413,3289,759,10578
"06037571703",579,365,728,142,1126,200,993,465,4598
"06037571704",816,240,680,309,1565,367,1371,310,5658
"06037571800",2120,198,212,24,594,13,301,4,3466
"06037571900",2689,378,696,21,1989,15,1434,190,7412
"06037572001",3010,113,296,19,1693,205,1373,221,6930
"06037572002",1691,150,673,88,1458,85,798,33,4976
"06037572100",283,4,174,0,563,24,224,0,1272
"06037572201",1838,98,988,62,3678,109,2516,34,9323
"06037572202",1012,159,621,9,1675,81,864,104,4525
"06037572301",946,507,502,85,1331,260,1442,685,5758
"06037572302",1207,256,539,30,1483,288,1520,280,5603
"06037572400",216,10,193,85,504,41,279,0,1328
"06037572500",567,545,284,307,878,524,412,555,4072
"06037572600",1884,215,385,229,2382,185,2434,293,8007
"06037572700",1097,60,717,301,3240,223,1376,99,7113
"06037572800",99,203,133,238,240,159,51,135,1258
"06037572900",2020,932,425,205,1651,158,2581,989,8961
"06037573002",1352,1042,284,240,668,412,1589,1441,7028
"06037573003",677,703,160,18,206,99,444,730,3037
"06037573004",1257,901,548,309,1130,896,1685,1337,8063
"06037573100",2179,336,1636,121,2459,720,3071,756,11278
"06037573201",1518,902,781,242,1225,485,2027,1216,8396
"06037573202",1543,458,473,398,2309,1170,2206,970,9527
"06037573300",597,373,158,153,1785,1268,1246,701,6281
"06037573401",732,143,102,8,424,26,440,130,2005
"06037573402",2555,218,605,365,2071,523,2166,500,9003
"06037573403",1702,91,346,35,1111,145,753,71,4254
"06037573601",4920,85,492,18,1032,63,1117,31,7758
"06037573700",3472,52,163,16,1041,72,956,46,5818
"06037573800",3477,234,103,7,668,40,832,48,5409
"06037573902",1503,22,291,0,542,5,343,0,2706
"06037574000",4283,112,24,3,1001,42,945,54,6464
"06037574100",3859,320,115,12,1043,0,924,0,6273
"06037574201",1987,69,260,0,732,24,721,1,3794
"06037574202",1267,120,57,4,390,48,520,37,2443
"06037574300",4143,226,125,122,1129,1,1025,10,6781
"06037574400",4223,127,82,2,975,3,1048,11,6471
"06037574500",4044,285,433,6,1082,189,844,0,6883
"06037574601",0,0,0,0,0,0,0,0,0
"06037574602",927,4,69,0,287,0,183,0,1470
"06037574700",10,11,0,0,0,0,0,0,21
"06037574800",1912,213,195,0,632,23,252,0,3227
"06037574901",3290,270,0,0,420,78,786,41,4885
"06037574902",2104,727,329,106,848,420,746,199,5479
"06037575001",1900,247,333,42,1098,341,908,70,4939
"06037575002",2477,269,131,99,1374,141,1014,52,5557
"06037575101",1153,809,637,51,1344,635,1485,1040,7154
"06037575102",1039,990,65,145,1489,662,1631,1084,7105
"06037575103",1907,705,1171,328,545,447,1177,661,6941
"06037575201",1375,717,357,241,1722,646,1774,939,7771
"06037575202",1825,1051,78,90,1314,551,1905,1360,8174
"06037575300",1644,641,346,149,1639,795,2347,948,8509
"06037575401",2179,1092,322,250,905,500,2771,1430,9449
"06037575402",1414,772,458,140,546,512,1682,1225,6749
"06037575500",18,0,0,0,22,0,22,0,62
"06037575801",1040,434,217,8,257,487,1118,829,4390
"06037575802",1496,1156,325,192,1381,387,1975,1248,8160
"06037575803",1158,534,185,84,507,261,1451,493,4673
"06037575901",911,536,465,216,516,436,845,717,4642
"06037575902",1557,855,898,411,653,461,740,783,6358
"06037576001",2839,398,577,166,1204,224,786,320,6514
"06037576200",2142,1296,528,332,1189,370,1746,1126,8729
"06037576301",2030,525,410,240,666,545,1589,754,6759
"06037576302",914,884,244,444,1376,382,1538,1029,6811
"06037576401",1253,1143,337,151,1383,773,1792,1744,8576
"06037576402",1303,1016,265,134,952,678,1800,1205,7353
"06037576403",1756,1030,416,444,921,775,1696,1233,8271
"06037576501",1379,336,409,205,539,121,1118,269,4376
"06037576502",1564,355,716,405,1613,342,1967,487,7449
"06037576503",1370,1049,517,92,606,395,1018,1098,6145
"06037576601",2605,467,505,154,615,167,928,312,5753
"06037576602",2398,348,326,50,699,46,706,115,4688
"06037576700",3525,221,73,0,472,17,576,31,4915
"06037576801",1709,722,507,96,607,84,854,468,5047
"06037576802",2409,319,220,64,648,98,854,240,4852
"06037576901",2205,1114,364,249,1510,782,2876,1287,10387
"06037576903",1550,415,492,141,1294,312,1872,426,6502
"06037576904",1423,273,253,255,405,142,867,118,3736
"06037577000",3553,686,558,151,1247,313,1706,356,8570
"06037577100",4695,257,704,58,804,355,1397,316,8586
"06037577200",3959,345,79,0,689,137,959,57,6225
"06037577300",3738,471,63,29,630,92,773,54,5850
"06037577400",2263,135,0,0,328,34,366,34,3160
"06037577501",2959,260,9,0,277,125,222,24,3876
"06037577504",1016,55,5,0,97,0,151,0,1324
"06037577602",2320,215,177,63,458,26,267,22,3548
"06037577603",6220,573,223,0,874,298,858,296,9342
"06037577604",1088,51,69,0,61,21,125,4,1419
"06037599000",2698,431,13,0,387,14,1997,376,5916
"06037599100",251,32,0,11,49,20,79,22,464
"06037600100",1273,895,1635,936,864,1284,2081,1921,10889
"06037600201",958,554,798,372,1509,450,2469,1019,8129
"06037600202",640,248,2393,1203,1197,986,1842,1114,9623
"06037600302",265,85,1691,467,400,138,564,253,3863
"06037600303",233,92,873,937,740,664,995,732,5266
"06037600304",390,122,657,667,681,164,1071,210,3962
"06037600400",304,39,2888,481,159,9,348,32,4260
"06037600501",122,3,1853,253,436,113,174,88,3042
"06037600502",254,2,1233,73,619,50,807,52,3090
"06037600601",45,7,2046,140,189,43,117,0,2587
"06037600602",268,214,369,245,723,652,904,866,4241
"06037600702",599,151,2776,320,249,49,411,164,4719
"06037600703",84,0,1376,50,254,5,62,0,1831
"06037600704",189,11,2329,424,216,19,261,23,3472
"06037600801",202,56,2325,272,97,58,253,119,3382
"06037600802",39,0,2022,249,278,45,231,25,2889
"06037600902",1390,680,2675,479,1372,446,2306,1157,10505
"06037600911",1169,354,1034,58,444,356,1475,631,5521
"06037600912",1990,310,963,124,1485,531,3213,873,9489
"06037601001",183,152,1271,135,104,3,130,133,2111
"06037601002",799,164,2675,701,879,234,1584,395,7431
"06037601100",1353,780,1771,292,1202,861,2350,1453,10062
"06037601202",1467,497,330,0,1283,388,2599,885,7449
"06037601211",498,320,710,245,957,282,1352,566,4930
"06037601212",1654,500,1068,436,1933,1184,3403,1547,11725
"06037601301",426,14,1121,71,177,53,371,30,2263
"06037601302",618,453,4596,389,650,428,699,825,8658
"06037601303",1063,226,2639,595,448,159,1123,292,6545
"06037601401",1737,298,1089,379,940,204,2342,322,7311
"06037601402",1999,363,273,52,1678,254,3279,576,8474
"06037601501",822,406,271,295,1620,761,2218,1095,7488
"06037601502",757,355,53,112,1888,852,2516,1168,7701
"06037601600",769,524,31,7,2139,1160,2804,1652,9086
"06037601700",1122,684,232,77,1738,1629,2825,2013,10320
"06037601801",1000,556,147,0,1190,994,2193,1550,7630
"06037601802",1189,366,406,37,1527,693,2791,1051,8060
"06037601900",941,658,388,242,1839,1150,2588,1808,9614
"06037602002",1330,428,271,82,618,236,1661,657,5283
"06037602003",1322,672,664,95,1595,783,2783,1423,9337
"06037602004",1435,214,611,224,1177,505,2617,793,7576
"06037602103",2291,460,1031,151,1852,729,3511,968,10993
"06037602104",2192,586,854,491,1399,378,2751,858,9509
"06037602105",1812,539,677,257,822,165,2356,717,7345
"06037602106",2629,94,837,278,1652,101,2882,103,8576
"06037602200",4267,515,969,167,1398,264,3166,642,11388
"06037602301",4051,243,184,19,1208,200,2621,256,8782
"06037602302",2778,107,68,0,616,8,766,39,4382
"06037602402",3792,632,536,79,1498,120,3240,496,10393
"06037602403",2369,449,796,173,1442,237,2739,500,8705
"06037602404",2410,527,1127,349,1568,130,2794,525,9430
"06037602504",671,408,1411,271,1171,201,1187,572,5892
"06037602505",789,506,936,277,1021,691,1268,945,6433
"06037602506",841,382,1484,446,904,93,1266,338,5754
"06037602507",768,639,1214,538,634,240,1031,846,5910
"06037602508",2026,720,1864,369,1628,321,2918,894,10740
"06037602509",1293,316,411,432,1055,417,1906,488,6318
"06037602600",650,0,4967,536,1726,553,1334,461,10227
"06037602700",336,35,2242,189,355,249,546,239,4191
"06037602801",917,344,620,457,869,707,1700,808,6422
"06037602802",890,58,1703,389,543,419,1330,476,5808
"06037602900",1016,108,440,17,1706,784,2225,872,7168
"06037603001",950,71,1501,454,2912,949,2129,915,9881
"06037603004",171,24,367,64,695,156,305,188,1970
"06037603005",833,161,1181,526,1863,712,1558,684,7518
"06037603006",330,57,285,7,1173,125,214,55,2246
"06037603101",891,8,992,86,1491,1001,919,509,5897
"06037603102",784,89,210,209,2216,400,1152,322,5382
"06037603200",722,62,366,0,1983,119,1013,70,4335
"06037603301",492,129,55,18,2491,162,681,135,4163
"06037603302",1005,111,178,18,2427,336,1312,175,5562
"06037603400",1023,409,557,36,1755,114,965,363,5222
"06037603500",1252,81,370,0,1482,62,1237,81,4565
"06037603600",1637,102,311,0,1953,174,1007,50,5234
"06037603702",2332,268,238,2,1842,316,1470,270,6738
"06037603703",1539,197,146,0,780,0,1053,185,3900
"06037603704",997,521,1594,281,2264,920,2729,1250,10556
"06037603801",1630,244,660,74,1578,386,2288,434,7294
"06037603802",1986,517,109,146,1151,312,2324,584,7129
"06037603900",3435,481,350,53,2973,204,4094,538,12128
"06037604001",2191,942,176,104,844,308,2343,906,7814
"06037604002",2280,278,359,112,1450,202,2366,260,7307
"06037604100",2527,540,351,61,3333,515,3946,741,12014
"06037609900",1494,18,36,8,288,9,1258,17,3128
"06037620001",3202,116,78,8,375,62,510,21,4372
"06037620002",2691,235,20,3,621,38,500,157,4265
"06037620101",4178,222,49,0,976,37,1231,48,6741
"06037620102",2879,61,10,17,787,9,517,18,4298
"06037620201",1005,146,24,21,202,7,65,0,1470
"06037620301",4130,26,22,0,840,66,683,0,5767
"06037620303",3931,92,39,0,470,18,257,0,4807
"06037620305",4847,233,0,0,633,0,559,0,6272
"06037620400",3982,95,0,0,1149,137,395,34,5792
"06037620501",4073,216,418,1,1234,28,657,0,6627
"06037620521",2184,319,227,0,1176,34,826,65,4831
"06037620522",2653,220,256,0,1148,154,655,46,5132
"06037620601",3793,203,247,0,1416,432,1223,301,7615
"06037620602",3738,134,74,0,1417,81,1122,86,6652
"06037620701",5066,188,78,0,1433,0,1112,28,7905
"06037620702",4638,170,215,0,1393,100,804,106,7426
"06037620800",6031,173,98,1,1803,48,865,8,9027
"06037620901",2231,16,11,3,432,0,144,5,2842
"06037620904",2127,116,0,0,68,0,91,0,2402
"06037621001",3645,93,13,0,769,32,440,0,4992
"06037621002",908,6,0,0,137,6,112,0,1169
"06037621004",4018,183,0,0,436,29,289,14,4969
"06037621102",2700,89,44,1,324,39,235,30,3462
"06037621104",5067,157,60,0,806,28,645,32,6795
"06037621201",4887,184,126,0,1166,63,1081,92,7599
"06037621204",1900,79,23,0,668,27,580,10,3287
"06037621301",4756,342,249,3,1557,80,1207,104,8298
"06037621324",3082,104,207,4,486,76,658,20,4637
"06037621326",2317,77,39,0,771,40,185,9,3438
"06037621400",3440,184,66,0,726,91,369,36,4912
"06037650001",2049,111,93,0,3379,124,800,36,6592
"06037650003",954,66,197,29,1214,284,644,63,3451
"06037650004",1185,246,418,47,1987,181,631,155,4850
"06037650101",1412,134,164,5,3770,41,487,0,6013
"06037650102",862,51,87,0,1230,58,329,53,2670
"06037650200",2855,168,154,15,2555,231,1485,25,7488
"06037650300",2816,278,221,6,3008,177,1503,48,8057
"06037650401",2279,117,47,0,2158,10,699,41,5351
"06037650501",1886,184,11,4,1035,80,561,122,3883
"06037650502",2626,176,97,0,1541,100,535,89,5164
"06037650602",2667,195,131,120,4021,625,1127,51,8937
"06037650603",1965,401,26,0,1512,253,289,7,4453
"06037650604",1842,354,585,17,2406,359,850,37,6450
"06037650605",1148,139,113,4,1618,33,306,34,3395
"06037650701",1414,39,6,0,835,39,148,6,2487
"06037650702",3214,43,29,0,1390,72,514,43,5305
"06037650800",1430,77,228,34,4708,368,593,0,7438
"06037650901",2997,314,94,0,1919,477,1502,596,7899
"06037650902",2773,290,247,0,3345,225,1864,183,8927
"06037651001",2949,432,291,0,2050,88,1580,224,7614
"06037651002",2045,84,158,0,2246,90,970,61,5654
"06037651101",2644,60,19,0,2372,99,499,23,5716
"06037651102",1945,113,61,2,1495,233,781,71,4701
"06037651201",3612,20,0,0,1166,33,405,7,5243
"06037651221",1362,274,57,0,1196,76,347,29,3341
"06037651222",2978,149,0,0,3006,200,714,0,7047
"06037651302",4122,235,206,1,1387,138,604,41,6734
"06037651304",3921,134,17,0,515,28,510,63,5188
"06037651401",1324,218,31,0,466,77,110,0,2226
"06037651402",3209,108,125,0,2472,418,518,0,6850
"06037670001",2320,157,3,4,875,151,1332,151,4993
"06037670002",2612,299,0,4,1066,110,1707,105,5903
"06037670003",2872,396,29,35,1640,457,1710,445,7584
"06037670100",3257,352,320,59,2305,364,1512,362,8531
"06037670201",2865,9,53,0,697,54,167,0,3845
"06037670202",2110,91,47,0,609,12,217,16,3102
"06037670324",4072,121,195,2,643,0,131,0,5164
"06037670326",2473,62,66,14,1113,0,283,2,4013
"06037670328",3087,88,96,1,1316,139,149,0,4876
"06037670403",1466,98,0,23,969,11,86,6,2659
"06037670405",1409,25,256,0,1109,129,101,25,3054
"06037670406",960,15,0,0,791,20,27,0,1813
"06037670407",2938,20,158,0,2693,393,622,0,6824
"06037670411",2563,45,37,0,1594,17,211,17,4484
"06037670413",2391,152,56,103,2073,134,251,13,5173
"06037670416",2330,156,86,2,1617,22,163,38,4414
"06037670500",1128,19,30,5,464,0,67,3,1716
"06037670602",4677,236,359,0,1799,54,238,0,7363
"06037670701",4664,139,142,53,1828,72,1435,37,8370
"06037670702",4115,165,20,63,796,0,641,55,5855
"06037700101",3206,1119,151,71,717,204,448,349,6265
"06037700102",2204,846,104,0,514,88,366,121,4243
"06037700200",4607,769,32,58,963,77,513,109,7128
"06037700300",4294,442,182,133,375,30,524,0,5980
"06037700400",3814,560,111,0,676,94,544,140,5939
"06037700501",2445,369,186,36,747,52,481,37,4353
"06037700502",3124,488,179,0,568,54,575,58,5046
"06037700600",4359,142,16,0,272,18,329,18,5154
"06037700700",2913,284,142,0,271,1,240,3,3854
"06037700801",4362,541,104,41,495,126,240,88,5997
"06037700802",2357,279,40,18,639,19,46,0,3398
"06037700901",2641,582,102,0,724,6,326,6,4387
"06037700902",5033,456,178,69,1035,134,368,12,7285
"06037701000",4525,185,177,0,919,112,326,68,6312
"06037701100",108,140,106,232,19,54,17,74,750
"06037701201",3361,170,25,0,495,11,116,60,4238
"06037701202",2658,173,120,8,345,62,352,32,3750
"06037701302",3817,314,34,0,478,52,196,36,4927
"06037701304",5103,429,44,15,822,68,462,26,6969
"06037701402",5038,698,176,0,455,107,222,59,6755
"06037701501",3850,369,20,14,702,66,405,50,5476
"06037701502",2297,249,48,102,796,52,418,37,3999
"06037701601",3534,89,133,11,700,26,223,14,4730
"06037701602",2892,484,143,0,495,53,326,124,4517
"06037701701",2107,200,82,0,548,123,540,25,3625
"06037701702",2168,380,62,51,357,162,745,237,4162
"06037701801",2543,582,407,69,1765,353,1782,476,7977
"06037701802",1848,408,446,97,1163,297,1059,279,5597
"06037701902",2442,406,95,60,535,129,611,41,4319
"06037702002",3950,496,498,21,478,130,542,70,6185
"06037702102",4742,633,157,13,1096,13,547,189,7390
"06037702201",3505,461,112,32,771,142,963,23,6009
"06037702202",3028,246,66,0,365,118,620,52,4495
"06037702300",4674,342,184,31,1082,409,836,25,7583
"06037702400",2519,121,232,53,901,40,975,62,4903
"06037702501",3400,237,304,51,1036,78,1093,20,6219
"06037702502",2831,118,745,15,678,66,536,14,5003
"06037702600",3786,119,469,18,1588,52,1152,15,7199
"06037702700",2500,54,47,18,856,26,388,42,3931
"06037702801",3406,410,250,13,970,181,1695,375,7300
"06037702802",1185,125,124,15,705,36,673,84,2947
"06037702803",1591,152,127,38,935,193,1015,227,4278
"06037702901",6187,714,503,32,1301,129,677,20,9563
"06037703001",2397,148,1279,160,1313,216,514,42,6069
"06037703002",731,17,5850,244,461,75,219,30,7627
"06037703100",276,269,3963,236,457,6,215,270,5692
"06037703200",504,50,4219,257,540,81,430,19,6100
"06037800101",4548,98,205,0,517,0,160,0,5528
"06037800102",6554,336,39,0,412,110,455,78,7984
"06037800202",4821,362,229,0,922,16,379,16,6745
"06037800203",4246,305,0,0,681,20,548,30,5830
"06037800204",3647,147,165,0,689,38,337,25,5048
"06037800324",4988,236,273,0,1154,74,527,18,7270
"06037800325",3093,175,0,6,169,3,214,4,3664
"06037800326",4164,216,12,0,665,1,477,25,5560
"06037800327",3490,563,0,2,644,417,784,449,6349
"06037800328",2270,175,24,50,155,17,120,0,2811
"06037800329",5408,285,36,0,814,164,786,0,7493
"06037800330",747,150,0,0,20,1,124,30,1072
"06037800331",681,21,0,0,81,24,68,24,899
"06037800332",5932,115,25,0,637,18,471,18,7216
"06037800406",1924,111,12,0,203,38,78,65,2431
"06037800408",5398,636,87,18,676,141,487,90,7533
"06037800410",1389,42,44,20,184,0,79,0,1758
"06037800504",1799,202,0,5,253,48,92,24,2423
"06037800506",2550,203,26,3,326,104,81,54,3347
"06037900102",528,235,14,7,37,39,266,132,1258
"06037900103",3531,1397,222,165,741,230,2281,1353,9920
"06037900104",2361,708,816,53,1261,694,2068,1049,9010
"06037900201",866,245,5,0,97,46,221,160,1640
"06037900300",2015,409,476,24,605,80,1428,147,5184
"06037900501",2851,942,1387,444,712,301,2048,1019,9704
"06037900504",3083,201,1181,272,974,106,2071,250,8138
"06037900505",1634,473,832,441,424,55,1147,189,5195
"06037900506",2367,733,838,344,351,6,1770,509,6918
"06037900507",4302,1134,1046,430,886,250,3272,370,11690
"06037900508",2007,341,260,162,797,194,1205,352,5318
"06037900602",2436,1431,359,311,615,239,2356,1218,8965
"06037900605",4378,902,780,320,713,125,2624,851,10693
"06037900606",1539,652,650,345,246,552,991,972,5947
"06037900607",1831,768,502,391,158,400,1112,639,5801
"06037900608",2005,441,600,157,163,152,1420,459,5397
"06037900609",2380,1049,401,887,597,131,1870,796,8111
"06037900701",1813,1012,389,444,1003,97,1014,566,6338
"06037900703",1815,569,222,152,462,382,553,540,4695
"06037900704",1375,466,415,52,526,128,897,168,4027
"06037900705",2965,548,557,273,369,23,862,157,5754
"06037900803",3724,835,1363,585,2582,298,3271,572,13230
"06037900804",1355,628,540,550,401,48,1207,495,5224
"06037900805",2241,372,365,456,876,70,1158,173,5711
"06037900806",1272,631,552,577,180,270,555,430,4467
"06037900900",2426,431,25,10,702,54,678,189,4515
"06037901003",0,0,0,0,0,0,0,0,0
"06037901004",7164,811,1388,415,1692,312,2901,164,14847
"06037901007",1630,205,45,0,71,39,431,54,2475
"06037901008",1611,132,328,58,753,99,892,107,3980
"06037901009",3129,662,958,3,532,241,1023,245,6793
"06037901010",3335,1096,284,485,663,166,1520,922,8471
"06037901011",3470,188,373,400,691,11,1517,78,6728
"06037901101",3232,855,517,233,332,54,1217,212,6652
"06037901102",3575,563,625,123,559,74,1173,543,7235
"06037901205",7417,308,878,120,1505,84,2209,216,12737
"06037901209",861,181,79,1,68,3,191,0,1384
"06037901210",1216,93,0,0,102,5,165,0,1581
"06037901213",3168,111,224,0,364,70,389,28,4354
"06037910001",1566,372,381,43,3663,213,4243,495,10976
"06037910002",2762,458,504,80,1872,963,2383,1235,10257
"06037910101",375,240,112,0,437,181,644,348,2337
"06037910201",1441,123,382,136,953,1255,1292,1074,6656
"06037910202",4084,256,516,12,850,18,1394,64,7194
"06037910205",811,22,31,0,303,31,232,32,1462
"06037910206",1245,171,720,7,1330,32,1506,70,5081
"06037910207",3029,222,501,60,1919,254,2192,110,8287
"06037910208",3075,343,570,72,2256,238,3074,365,9993
"06037910209",2367,250,469,0,1117,0,912,105,5220
"06037910210",3929,144,838,143,1797,0,1974,14,8839
"06037910301",3020,417,140,27,822,45,708,138,5317
"06037910302",3737,166,399,0,1354,188,1195,29,7068
"06037910401",3143,274,466,92,2419,75,2622,142,9233
"06037910402",622,579,300,410,824,764,1114,1133,5746
"06037910403",313,171,86,175,613,1040,811,1088,4297
"06037910404",1164,502,183,266,1016,619,1330,1029,6109
"06037910501",451,579,656,1015,813,2040,655,2460,8669
"06037910502",893,428,243,473,1520,455,1974,566,6552
"06037910504",725,549,384,215,2317,961,2638,1291,9080
"06037910505",919,142,115,98,1170,462,1285,521,4712
"06037910601",1968,719,228,224,2172,1331,3084,1461,11187
"06037910602",723,293,236,481,1302,402,1259,540,5236
"06037910603",2175,492,669,186,2846,675,3481,974,11498
"06037910605",1659,540,474,76,1236,825,1972,1278,8060
"06037910606",874,213,342,241,926,264,1422,400,4682
"06037910705",4841,470,2329,298,3144,547,5741,894,18264
"06037910706",1813,394,232,337,2813,271,4002,658,10520
"06037910707",1366,338,722,239,1167,545,1629,738,6744
"06037910709",1250,55,128,0,270,111,360,91,2265
"06037910711",2595,595,758,375,2562,748,3709,741,12083
"06037910712",1048,70,216,192,816,73,1103,125,3643
"06037910713",1759,255,605,166,2487,633,3641,666,10212
"06037910714",1079,382,335,46,1530,515,1975,828,6690
"06037910715",2119,47,684,572,2447,412,3231,390,9902
"06037910716",2075,135,538,231,2387,445,2723,580,9114
"06037910804",2343,203,0,0,320,185,461,167,3679
"06037910805",3250,447,35,22,506,250,794,50,5354
"06037910807",4144,221,151,0,1421,49,1546,71,7603
"06037910808",2798,188,54,0,575,13,818,181,4627
"06037910809",1869,70,16,0,245,99,390,99,2788
"06037910810",1926,203,61,7,495,22,645,149,3508
"06037910811",177,17,13,0,32,0,39,0,278
"06037910812",373,37,0,0,42,6,89,6,553
"06037910813",2685,53,0,0,702,63,728,23,4254
"06037911001",2755,279,225,2,453,112,775,106,4707
"06037920011",147,9,0,0,9,0,18,0,183
"06037920012",814,79,0,0,141,0,47,0,1081
"06037920013",3766,130,75,14,653,10,1157,0,5805
"06037920015",4813,225,199,2,1264,9,1356,159,8027
"06037920016",3539,331,70,0,1212,11,781,0,5944
"06037920017",3544,214,11,0,739,108,1516,195,6327
"06037920018",1568,106,45,40,687,0,515,49,3010
"06037920020",5410,301,39,28,1443,88,1772,63,9144
"06037920023",1592,230,78,7,862,65,1373,146,4353
"06037920026",363,20,0,0,18,0,27,5,433
"06037920028",3632,219,278,34,1859,89,1699,111,7921
"06037920029",2354,123,83,0,623,18,823,0,4024
"06037920030",3374,230,163,31,1599,153,1465,107,7122
"06037920031",3567,273,176,27,891,62,1020,17,6033
"06037920032",2026,39,45,0,869,0,811,20,3810
"06037920033",482,51,0,3,76,17,184,14,827
"06037920034",1860,531,128,17,777,90,836,204,4443
"06037920035",5014,764,46,1,1940,187,3701,618,12271
"06037920036",2107,266,15,49,750,203,1675,399,5464
"06037920037",3432,1046,663,18,1779,309,3266,906,11419
"06037920038",2015,491,272,16,1043,213,1619,402,6071
"06037920039",1385,60,14,0,498,0,289,32,2278
"06037920040",1814,158,132,0,1012,218,695,268,4297
"06037920041",1616,192,289,0,721,49,862,145,3874
"06037920042",4041,498,287,53,1608,355,1468,394,8704
"06037920043",2957,114,228,0,2422,110,1372,39,7242
"06037920044",2250,46,0,1,878,0,483,14,3672
"06037920045",3471,269,128,0,896,0,884,0,5648
"06037920102",3746,519,302,15,750,210,1281,507,7330
"06037920104",2057,257,28,0,515,96,505,113,3571
"06037920106",1917,417,67,0,429,201,1276,433,4740
"06037920107",2247,41,555,29,1544,10,665,10,5101
"06037920108",2167,80,35,0,1311,46,347,0,3986
"06037920109",3027,90,151,0,1066,32,814,0,5180
"06037920110",3833,122,6,0,1052,65,612,0,5690
"06037920111",2113,104,278,0,656,27,548,15,3741
"06037920112",3306,151,64,2,365,56,479,18,4441
"06037920114",3739,354,215,0,1860,328,983,22,7501
"06037920115",2935,146,49,8,561,69,1003,77,4848
"06037920116",3075,114,39,0,1174,485,431,485,5803
"06037920118",4088,82,216,22,1487,64,1612,64,7635
"06037920119",1572,9,24,0,375,30,581,0,2591
"06037920200",0,0,0,0,0,0,0,0,0
"06037920303",663,37,58,21,447,69,42,60,1397
"06037920312",3725,372,30,97,1062,133,1700,328,7447
"06037920313",4267,376,18,0,1162,96,1768,272,7959
"06037920314",1895,86,5,0,726,17,714,47,3490
"06037920322",2335,22,89,0,496,38,824,0,3804
"06037920326",4077,366,113,1,1982,115,1117,90,7861
"06037920328",1232,91,17,0,482,9,134,0,1965
"06037920329",3612,219,0,21,1586,93,957,33,6521
"06037920330",4041,313,22,0,877,72,1056,122,6503
"06037920331",3082,184,45,0,570,81,630,8,4600
"06037920332",1261,101,38,0,389,5,406,84,2284
"06037920334",4228,566,14,6,830,136,915,262,6957
"06037920336",2919,1119,47,14,1636,553,3151,1503,10942
"06037920337",3342,1505,481,18,1856,507,3736,1865,13310
"06037920338",4420,80,303,0,1095,59,977,0,6934
"06037920339",4154,151,196,0,2550,0,962,0,8013
"06037930101",138,0,0,0,55,0,47,0,240
"06037930200",313,35,0,12,192,37,229,33,851
"06037930301",555,66,0,0,110,0,128,0,859
"06037980001",0,0,0,0,0,0,0,0,0
"06037980002",0,0,0,0,0,0,0,0,0
"06037980003",0,0,0,0,0,0,0,0,0
"06037980004",7,0,0,0,3,12,7,12,41
"06037980005",0,0,0,0,0,0,0,0,0
"06037980006",0,0,0,0,0,0,0,0,0
"06037980007",0,1,0,0,2,1,0,0,4
"06037980008",33,42,0,0,22,4,22,27,150
"06037980009",0,0,0,0,0,0,0,0,0
"06037980010",52,1,0,1,18,54,34,1,161
"06037980013",0,0,0,0,0,0,0,0,0
"06037980014",69,33,0,0,0,0,0,0,102
"06037980015",80,146,122,0,2,22,52,155,579
"06037980018",1,0,0,0,1,0,1,0,3
"06037980019",213,0,7,0,0,0,37,0,257
"06037980020",0,0,0,0,0,0,0,0,0
"06037980021",0,0,0,0,0,0,0,0,0
"06037980022",0,0,0,0,0,0,0,0,0
"06037980023",0,0,0,0,9,0,9,0,18
"06037980024",63,0,11,0,79,0,0,0,153
"06037980025",0,0,0,0,0,0,0,0,0
"06037980026",25,0,0,0,0,0,0,0,25
"06037980028",0,0,0,0,0,0,0,0,0
"06037980030",0,0,0,0,0,0,0,0,0
"06037980031",0,0,49,0,0,0,0,0,49
"06037980033",0,0,0,0,0,0,0,0,0
"06037990100",0,0,0,0,0,0,0,0,0
"06037990200",0,0,0,0,0,0,0,0,0
"06037990300",0,0,0,0,0,0,0,0,0
"06039000102",2805,467,24,0,694,43,331,0,4364
"06039000103",3667,880,28,0,201,0,141,193,5110
"06039000104",3576,264,0,0,152,23,317,0,4332
"06039000106",3812,522,8,0,204,25,631,98,5300
"06039000108",5149,1319,21,0,662,9,398,26,7584
"06039000109",1481,59,0,0,194,67,184,32,2017
"06039000201",901,220,35,33,341,238,925,96,2789
"06039000202",4416,554,177,0,785,124,2282,459,8797
"06039000300",4298,2628,110,199,1546,314,1789,1384,12268
"06039000400",730,185,0,0,139,4,567,136,1761
"06039000502",6481,2670,107,141,1618,356,6377,2891,20641
"06039000503",6321,997,105,169,1548,211,4473,804,14628
"06039000506",4834,874,56,73,688,32,4072,798,11427
"06039000507",6529,1926,404,35,1112,472,5220,1806,17504
"06039000508",4236,1176,75,11,958,141,2881,963,10441
"06039000509",4296,546,141,0,338,19,1114,300,6754
"06039000602",2595,1645,76,15,520,193,2915,1764,9723
"06039000603",2765,1932,29,70,357,76,2777,1756,9762
"06039000604",3094,1857,57,79,451,477,3300,2320,11635
"06039000700",8577,426,525,117,1539,354,5494,642,17674
"06039000800",3477,2457,36,92,525,278,3339,2481,12685
"06039000900",4511,2617,75,53,931,667,4734,2864,16452
"06039001000",3957,1117,30,0,559,56,2254,1121,9094
"06041101100",2296,191,0,0,269,0,45,0,2801
"06041101200",1875,357,13,0,468,10,553,67,3343
"06041102100",1926,89,37,0,403,4,269,9,2737
"06041102202",4601,140,63,0,1443,12,1489,0,7748
"06041102203",3045,142,319,24,1249,79,1770,51,6679
"06041103100",6582,313,0,7,747,22,317,31,8019
"06041103200",4239,498,73,24,975,19,600,286,6714
"06041104101",6011,559,47,0,1240,0,1025,181,9063
"06041104102",3066,203,160,124,1482,114,1255,123,6527
"06041104200",4490,148,40,20,797,310,1081,351,7237
"06041104300",1327,13,0,2,178,9,107,0,1636
"06041105000",4163,557,227,29,1059,303,909,552,7799
"06041106001",2437,141,124,25,986,135,644,121,4613
"06041106002",3950,413,50,51,1346,57,1185,225,7277
"06041107000",4969,292,26,25,970,0,307,0,6589
"06041108100",5675,104,34,0,680,19,457,0,6969
"06041108200",4556,363,77,61,1715,245,994,235,8246
"06041109001",2139,259,56,16,1009,149,754,159,4541
"06041109002",3499,204,257,0,186,12,263,18,4439
"06041110100",3925,356,164,31,420,164,357,155,5572
"06041110200",4617,145,0,0,562,0,287,41,5652
"06041111000",3906,292,201,18,1106,274,991,279,7067
"06041112100",2952,565,31,2,1103,228,1473,462,6816
"06041112201",1265,1187,145,290,3365,1031,4350,2180,13813
"06041112202",1481,51,22,0,2261,361,2431,336,6943
"06041113000",3336,174,185,0,387,6,429,17,4534
"06041114100",4449,269,41,45,243,115,266,34,5462
"06041114200",2668,163,6,0,233,34,163,42,3309
"06041115000",6267,110,107,0,752,66,493,0,7795
"06041116000",2593,144,0,8,217,125,142,0,3229
"06041117000",3687,426,13,15,385,37,96,37,4696
"06041118100",1800,189,0,0,146,0,147,0,2282
"06041119100",4185,138,15,5,290,46,263,0,4942
"06041119201",2637,162,69,8,383,37,275,7,3578
"06041119202",2887,74,15,46,179,0,159,0,3360
"06041120000",5413,184,83,5,449,23,188,0,6345
"06041121100",4078,95,15,0,1160,0,663,0,6011
"06041121200",4474,44,102,0,603,217,246,50,5736
"06041122000",0,0,0,0,0,0,0,0,0
"06041123000",1711,48,5,0,139,14,136,0,2053
"06041124100",4668,209,22,0,475,24,320,36,5754
"06041124200",4991,306,0,17,359,49,281,83,6086
"06041125000",3052,229,119,0,706,186,72,25,4389
"06041126100",5319,78,62,0,370,21,96,21,5967
"06041126200",3590,226,0,0,513,55,430,17,4831
"06041127000",4048,49,0,0,300,19,326,0,4742
"06041128100",5134,256,118,0,867,131,306,0,6812
"06041128200",3620,196,60,0,405,0,212,9,4502
"06041129000",639,82,618,367,233,363,260,206,2768
"06041130201",3269,140,54,1,81,18,172,20,3755
"06041130202",3426,224,58,0,265,98,147,0,4218
"06041131100",799,34,8,0,125,30,21,0,1017
"06041132100",1382,209,54,0,9,48,39,62,1803
"06041132200",1416,184,17,56,212,16,272,18,2191
"06041133000",2325,238,26,2,507,0,539,59,3696
"06041990100",0,0,0,0,0,0,0,0,0
"06043000101",2413,641,4,0,292,372,187,459,4368
"06043000102",2077,370,28,0,155,86,27,55,2798
"06043000200",2530,452,19,0,191,5,280,41,3518
"06043000301",3084,479,0,0,512,0,329,2,4406
"06043000302",2047,109,8,0,139,29,79,29,2440
"06043000400",1388,281,51,21,94,31,150,31,2047
"06045010100",1024,511,7,0,588,500,219,271,3120
"06045010200",2347,556,11,1,405,303,357,96,4076
"06045010300",3349,500,0,0,142,88,438,39,4556
"06045010400",2350,458,0,7,210,357,385,506,4273
"06045010500",2819,860,0,0,521,78,1313,397,5988
"06045010600",5110,632,0,0,321,60,275,121,6519
"06045010700",3899,1289,4,0,405,354,108,331,6390
"06045010801",4164,835,88,1,828,193,716,178,7003
"06045010802",1762,299,0,0,120,18,439,140,2778
"06045010900",2943,380,53,1,835,339,941,342,5834
"06045011001",1323,309,0,4,26,15,69,23,1769
"06045011002",4044,619,0,0,404,68,267,15,5417
"06045011102",2551,279,13,3,476,143,730,120,4315
"06045011200",1897,598,28,0,319,338,933,706,4819
"06045011300",4401,1231,34,31,878,385,1486,839,9285
"06045011400",2963,231,9,0,537,134,383,0,4257
"06045011500",3805,1024,15,61,757,219,1192,231,7304
"06045011600",3300,1349,22,9,1507,527,2250,1171,10135
"06045011700",3015,365,86,5,632,203,922,133,5361
"06045011800",1191,240,0,0,366,211,369,116,2493
"06045990100",0,0,0,0,0,0,0,0,0
"06047000201",2244,315,50,4,848,288,1406,534,5689
"06047000202",795,469,14,4,262,204,641,601,2990
"06047000203",4021,707,339,0,3188,500,5935,871,15561
"06047000301",1823,350,43,16,2220,557,2744,820,8573
"06047000303",1163,474,50,0,149,98,516,294,2744
"06047000304",3108,1057,1,0,4398,716,5463,1505,16248
"06047000401",1003,473,0,0,19,101,398,196,2190
"06047000402",6611,919,20,0,432,69,816,352,9219
"06047000503",1276,372,0,0,373,180,698,417,3316
"06047000504",3024,1005,50,0,1552,756,3718,1278,11383
"06047000505",3001,772,201,9,2471,548,3118,763,10883
"06047000601",2776,813,92,31,964,442,1991,823,7932
"06047000602",1913,654,149,19,546,117,1122,291,4811
"06047000603",2896,1575,244,24,885,388,2161,1211,9384
"06047000701",1223,875,38,13,597,327,1101,759,4933
"06047000702",3148,166,26,0,1506,184,1741,43,6814
"06047000801",2968,918,296,33,1040,55,2049,613,7972
"06047000802",2075,440,143,1,1504,85,1445,284,5977
"06047000901",2127,357,76,58,598,204,1191,316,4927
"06047000902",4347,1248,302,0,1888,889,3082,1386,13142
"06047001002",6053,1379,525,255,4502,591,3764,790,17859
"06047001003",1316,833,199,99,1120,475,1485,743,6270
"06047001004",2091,835,210,94,516,193,1234,561,5734
"06047001005",1057,284,13,193,537,198,973,272,3527
"06047001101",3062,1062,232,22,969,270,1147,612,7376
"06047001200",3208,217,150,76,963,324,1285,304,6527
"06047001301",1354,517,135,41,494,167,990,511,4209
"06047001302",1296,794,53,53,390,490,523,584,4183
"06047001401",2022,779,107,57,781,269,1318,382,5715
"06047001402",2535,483,117,287,682,412,974,702,6192
"06047001501",1145,399,126,0,920,530,1186,606,4912
"06047001502",810,808,138,16,658,415,1305,1030,5180
"06047001503",1135,802,172,163,1337,1266,1419,1402,7696
"06047001601",599,734,139,133,1319,1070,1645,1749,7388
"06047001602",2376,1464,146,213,2232,1388,3326,1797,12942
"06047001700",2477,1518,38,103,1177,1157,1851,1984,10305
"06047001801",1929,174,222,0,479,0,489,91,3384
"06047001901",2486,931,52,0,1470,910,3504,1652,11005
"06047001902",1197,434,0,4,609,266,1200,616,4326
"06047002000",4949,2469,7,25,627,100,2745,1961,12883
"06047002100",2392,698,151,8,349,37,1524,450,5609
"06047002201",3163,1457,39,98,433,497,2371,1728,9786
"06047002202",5677,2015,131,0,1719,465,5339,2354,17700
"06047002301",4165,745,41,0,1073,297,2495,757,9573
"06047002302",9142,2491,389,303,1438,624,7349,2762,24498
"06047002401",900,424,0,0,118,0,277,330,2049
"06047002402",4003,2393,63,152,802,576,3262,2688,13939
"06047002500",1328,185,13,1,537,120,523,145,2852
"06047002600",3068,592,353,0,888,192,1203,523,6819
"06049000100",2203,696,0,16,152,122,203,189,3581
"06049000200",1745,404,0,3,22,40,372,142,2728
"06049000300",1844,281,0,33,214,136,183,95,2786
"06049000400",951,141,0,2,65,43,37,13,1252
"06051000101",2813,185,0,0,184,14,260,0,3456
"06051000102",2025,52,17,0,489,139,455,76,3253
"06051000200",6443,462,0,25,942,320,2613,380,11185
"06053000101",1398,119,0,2,685,16,1483,75,3778
"06053000102",5432,742,193,2,3260,348,6179,916,17072
"06053000103",1562,273,155,6,1778,58,2252,283,6367
"06053000104",2474,236,61,0,970,55,2203,207,6206
"06053000200",3567,890,114,0,1707,452,4173,1184,12087
"06053000300",2414,489,201,0,1250,147,2445,482,7428
"06053000400",3623,729,33,3,1836,592,3716,1195,11727
"06053000501",1648,1988,0,0,777,266,2206,2247,9132
"06053000502",2407,575,0,0,957,334,2801,880,7954
"06053000600",3751,1728,25,0,935,147,4360,1858,12804
"06053000701",2893,2118,12,0,462,267,3219,2378,11349
"06053000702",2576,2662,0,0,712,377,3277,3028,12632
"06053000800",3144,1103,5,0,753,199,3712,1287,10203
"06053000900",3291,1450,0,0,540,103,3610,1480,10474
"06053001200",2111,331,42,0,460,14,951,184,4093
"06053001300",850,1087,107,0,475,137,1167,1129,4952
"06053001400",1642,247,27,10,401,48,777,268,3420
"06053001500",4458,415,13,0,684,295,2119,472,8456
"06053001600",2044,395,103,22,318,6,1090,315,4293
"06053001700",2287,586,63,15,599,58,1887,343,5838
"06053001801",1932,745,86,4,1331,125,2006,667,6896
"06053001802",2274,572,0,21,1118,524,2281,957,7747
"06053010101",3010,1143,12,17,477,214,3102,1309,9284
"06053010102",2837,187,0,0,591,48,1692,180,5535
"06053010202",2989,352,8,11,979,115,1956,352,6762
"06053010305",3410,221,12,0,762,76,1329,228,6038
"06053010306",717,233,0,0,264,49,492,117,1872
"06053010400",3068,1258,29,0,1370,233,4094,1426,11478
"06053010501",5150,436,20,0,542,70,2035,334,8587
"06053010504",3114,602,21,37,1124,104,3307,508,8817
"06053010505",2854,637,65,0,1546,119,3363,716,9300
"06053010506",2443,1160,96,11,840,474,2459,1401,8884
"06053010603",4695,66,53,225,1954,286,3916,188,11383
"06053010604",3248,941,111,11,1713,32,3998,914,10968
"06053010605",3095,217,25,0,916,142,3422,359,8176
"06053010606",4368,834,68,2,1538,101,4347,824,12082
"06053010607",2261,1295,41,6,631,104,2720,1399,8457
"06053010608",1676,384,34,0,661,0,2256,362,5373
"06053010701",5417,48,91,0,780,120,897,0,7353
"06053010702",3383,97,40,0,338,0,244,0,4102
"06053010804",3608,1544,16,0,213,0,3333,1544,10258
"06053010900",17,7,0,0,10,0,7,0,41
"06053011000",4710,585,0,0,548,36,422,289,6590
"06053011101",2800,1280,47,0,522,197,2820,1440,9106
"06053011102",7435,1722,113,8,2055,196,8431,1897,21857
"06053011202",4004,975,5,0,1163,883,4568,1823,13421
"06053011203",3876,1220,34,0,852,465,4187,1449,12083
"06053011204",2016,564,54,0,1095,11,2349,537,6626
"06053011302",3556,1567,0,0,357,98,3414,1583,10575
"06053011303",2597,233,36,0,783,91,1992,206,5938
"06053011304",4408,863,128,34,1253,104,5150,971,12911
"06053011400",2311,267,22,3,249,93,690,167,3802
"06053011502",961,269,1,17,21,26,100,126,1521
"06053011602",5522,208,61,0,207,13,448,0,6459
"06053011604",1482,92,0,0,126,0,18,0,1718
"06053011700",3208,278,6,16,279,13,220,0,4020
"06053011801",1559,151,0,0,195,0,65,1,1971
"06053011802",1500,89,0,0,266,0,275,0,2130
"06053011900",3510,433,12,8,463,7,245,4,4682
"06053012000",2337,489,159,61,585,86,235,11,3963
"06053012100",1607,112,6,0,230,5,241,4,2205
"06053012200",2379,184,0,0,177,18,115,36,2909
"06053012302",1502,122,0,0,92,43,119,33,1911
"06053012401",1505,65,48,0,96,0,109,7,1830
"06053012402",2600,144,22,0,452,0,445,23,3686
"06053012502",3878,273,70,57,877,16,857,52,6080
"06053012600",116,10,0,0,37,4,44,0,211
"06053012700",2224,396,48,19,407,201,260,2,3557
"06053012800",4442,276,9,0,593,100,635,74,6129
"06053013000",2525,266,98,0,531,142,557,55,4174
"06053013100",1560,55,94,0,304,124,67,65,2269
"06053013200",3199,103,19,0,514,0,342,12,4189
"06053013300",4106,489,249,6,1497,344,1527,403,8621
"06053013400",1344,69,5,0,315,37,280,32,2082
"06053013500",2088,400,657,94,1146,303,583,545,5816
"06053013600",1809,580,126,50,1395,207,1533,727,6427
"06053013700",2055,785,95,226,1258,476,2383,1119,8397
"06053013800",2401,379,636,173,2019,168,2260,264,8300
"06053013900",1033,265,227,11,1080,85,964,284,3949
"06053014000",1376,350,92,22,569,47,1025,203,3684
"06053014102",943,430,45,96,525,190,561,259,3049
"06053014104",0,0,0,0,0,0,0,0,0
"06053014105",1115,580,288,15,531,139,352,219,3239
"06053014107",4724,230,621,172,1448,348,951,132,8626
"06053014201",1925,687,155,104,1931,449,1018,670,6939
"06053014202",1519,274,362,119,1321,516,795,254,5160
"06053014301",2285,124,302,5,991,78,914,9,4708
"06053014302",1676,245,203,117,1577,303,856,211,5188
"06053014500",2880,296,77,0,746,125,1796,307,6227
"06053014601",3271,496,0,0,1062,33,3485,445,8792
"06053014700",5122,800,66,0,1054,113,3468,765,11388
"06053014800",4120,583,3,0,922,27,4060,562,10277
"06053980000",0,0,0,0,0,37,0,37,74
"06053990000",0,0,0,0,0,0,0,0,0
"06055200201",2454,284,0,3,395,65,1144,120,4465
"06055200202",1484,484,7,25,339,91,700,210,3340
"06055200203",1836,138,9,15,260,28,849,27,3162
"06055200301",3562,637,39,0,843,54,2248,507,7890
"06055200302",2182,107,149,0,383,9,815,22,3667
"06055200400",2840,284,85,2,295,16,621,2,4145
"06055200501",3896,298,60,0,1182,59,2812,233,8540
"06055200503",1217,263,34,0,223,26,718,209,2690
"06055200504",4832,897,0,1,667,73,2441,865,9776
"06055200505",1806,267,0,4,276,31,710,203,3297
"06055200601",3813,204,0,0,816,0,1688,65,6586
"06055200602",3274,236,29,0,364,17,637,37,4594
"06055200703",2687,14,0,0,144,0,317,6,3168
"06055200704",3656,557,0,0,646,271,1839,566,7535
"06055200705",2343,699,3,0,275,11,1073,600,5004
"06055200706",2486,240,7,0,467,9,844,83,4136
"06055200707",2420,243,15,0,452,18,726,154,4028
"06055200802",3837,250,136,12,867,153,1065,58,6378
"06055200803",1581,130,1,2,116,79,239,128,2276
"06055200804",3457,1036,32,22,908,158,3113,816,9542
"06055200900",29,386,0,94,22,48,20,52,651
"06055201003",998,209,239,0,2820,105,694,189,5254
"06055201004",2243,198,513,179,3079,145,1864,22,8243
"06055201005",1467,98,9,0,827,43,666,76,3186
"06055201006",1488,330,212,35,901,13,815,45,3839
"06055201007",1920,149,295,20,1579,187,1136,151,5437
"06055201101",1719,10,0,0,258,6,165,0,2158
"06055201102",1629,132,0,0,33,0,106,16,1916
"06055201200",3605,223,0,0,630,133,1236,29,5856
"06055201300",2156,120,35,13,155,0,337,20,2836
"06055201401",2783,87,0,0,142,18,76,31,3137
"06055201402",2366,340,4,0,354,2,152,124,3342
"06055201403",841,8,16,0,78,0,139,0,1082
"06055201500",1503,93,0,0,728,44,919,47,3334
"06055201601",1560,192,88,29,568,44,854,72,3407
"06055201602",2862,119,51,0,265,10,302,55,3664
"06055201700",3581,221,128,18,482,70,964,72,5536
"06055201800",1356,75,0,0,194,10,393,3,2031
"06055201900",965,120,5,11,180,0,446,0,1727
"06055202000",4189,582,52,0,263,72,1692,375,7225
"06057000102",6105,142,0,0,387,0,361,24,7019
"06057000103",6970,552,0,0,304,0,407,0,8233
"06057000104",2672,178,60,0,133,0,144,34,3221
"06057000105",2117,471,0,0,65,1,14,1,2669
"06057000200",2273,172,0,0,111,2,77,12,2647
"06057000300",1917,172,0,0,58,28,39,36,2250
"06057000401",5076,510,30,0,463,7,626,49,6761
"06057000402",5979,566,28,0,756,76,419,108,7932
"06057000501",4120,1514,6,0,348,0,540,419,6947
"06057000502",3605,665,0,0,327,275,342,245,5459
"06057000600",3969,1444,0,3,226,171,247,334,6394
"06057000701",6327,588,25,2,461,122,327,36,7888
"06057000702",3137,261,45,0,175,6,71,0,3695
"06057000801",3884,679,0,0,257,127,207,0,5154
"06057000802",5463,468,58,4,466,0,535,4,6998
"06057000900",2648,802,18,67,253,77,64,36,3965
"06057001203",2466,487,0,0,142,0,187,33,3315
"06057001204",2505,152,0,0,9,0,225,0,2891
"06057001205",4075,340,0,0,275,0,349,0,5039
"06057001206",4439,563,0,2,781,0,1592,319,7696
"06059001101",2705,427,17,0,729,156,1116,475,5625
"06059001102",1447,150,30,0,1079,252,1191,252,4401
"06059001103",1549,732,147,0,1802,110,2347,632,7319
"06059001201",3184,539,0,18,1606,522,3761,945,10575
"06059001202",1723,142,10,0,1322,600,2489,722,7008
"06059001301",4125,220,171,0,1613,174,2528,133,8964
"06059001303",2755,463,52,9,1869,273,3037,475,8933
"06059001304",2073,94,24,0,1455,240,2665,327,6878
"06059001401",3026,366,128,19,1588,323,2813,538,8801
"06059001402",3439,482,65,1,1319,200,2865,422,8793
"06059001403",2759,26,27,0,378,8,1093,8,4299
"06059001404",1782,540,38,0,1569,42,2526,486,6983
"06059001501",4237,149,0,0,1977,67,660,15,7105
"06059001503",3840,767,24,0,843,136,1530,697,7837
"06059001504",3789,108,58,0,799,47,2311,69,7181
"06059001505",4484,596,117,0,1736,38,1236,320,8527
"06059001506",2576,159,7,0,844,228,651,78,4543
"06059001507",2724,66,43,0,1474,237,995,175,5714
"06059001601",4283,303,14,0,2788,44,967,106,8505
"06059001602",2949,123,106,0,1277,154,632,0,5241
"06059001704",1947,134,41,0,4393,637,639,24,7815
"06059001705",2089,489,52,0,1519,511,1529,853,7042
"06059001706",2352,166,19,0,907,63,349,12,3868
"06059001707",2327,29,346,0,4492,462,1136,0,8792
"06059001708",1649,71,79,2,1420,266,518,24,4029
"06059001801",2031,555,654,18,1247,630,2035,698,7868
"06059001802",2612,1352,355,106,2463,1661,3311,2586,14446
"06059001901",1780,116,22,0,1212,0,1634,38,4802
"06059001902",1547,240,47,0,1091,130,1228,195,4478
"06059001903",1829,305,72,0,953,224,1349,460,5192
"06059011000",3534,125,113,0,1900,305,1455,106,7538
"06059011101",1787,347,64,171,1418,422,1701,703,6613
"06059011102",2379,484,40,0,1520,68,1930,406,6827
"06059011200",2223,268,57,29,1052,219,1105,267,5220
"06059011300",2799,383,149,4,1022,235,924,84,5600
"06059011401",1469,138,10,8,172,8,220,75,2100
"06059011402",1833,98,31,0,332,7,402,6,2709
"06059011403",3278,567,135,0,1389,745,2021,695,8830
"06059011502",1943,345,16,0,1560,275,1776,362,6277
"06059011503",1101,68,57,0,407,18,219,22,1892
"06059011504",1873,941,114,21,1379,480,1271,352,6431
"06059011601",2007,780,328,54,3611,1173,4046,1754,13753
"06059011602",2763,955,18,0,1320,203,2850,1018,9127
"06059011707",3952,284,144,0,1602,197,1044,94,7317
"06059011708",1800,440,147,62,864,303,821,217,4654
"06059011709",3267,70,0,0,605,45,895,0,4882
"06059011710",2773,87,0,0,612,35,585,5,4097
"06059011711",2937,1221,46,71,2116,789,1816,1534,10530
"06059011712",2718,447,160,8,1354,111,1909,307,7014
"06059011714",538,42,4,0,99,14,399,16,1112
"06059011715",5238,102,100,19,1152,53,1480,63,8207
"06059011716",2303,517,0,0,2411,88,1071,403,6793
"06059011717",2274,219,18,4,423,0,729,66,3733
"06059011718",2397,125,8,0,661,25,722,2,3940
"06059011720",2874,1920,124,52,1280,332,3603,2014,12199
"06059011721",2549,1312,35,0,941,271,2431,1386,8925
"06059011722",1970,180,57,0,398,72,789,90,3556
"06059021802",4881,649,13,0,1425,80,1214,427,8689
"06059021807",3221,65,76,77,514,140,967,81,5141
"06059021809",2291,168,8,0,266,17,552,1,3303
"06059021810",3231,120,44,0,373,77,991,41,4877
"06059021812",5023,112,75,17,966,10,1279,0,7482
"06059021813",7,0,0,0,4,0,0,0,11
"06059021814",4769,114,63,0,2034,84,1250,52,8366
"06059021815",4654,178,136,0,2786,259,1340,123,9476
"06059021816",4011,141,0,0,727,25,828,41,5773
"06059021817",2708,190,0,0,594,93,711,68,4364
"06059021820",3090,88,15,0,1292,63,794,20,5362
"06059021821",3891,256,161,1,1799,360,1559,286,8313
"06059021822",5020,128,105,0,2891,12,902,0,9058
"06059021823",2694,55,0,0,711,71,590,0,4121
"06059021824",2167,48,79,0,364,12,276,11,2957
"06059021825",2719,9,0,0,562,0,414,0,3704
"06059021826",1787,58,0,0,655,0,643,2,3145
"06059021827",2090,118,18,0,785,31,384,113,3539
"06059021828",2966,0,32,0,1264,7,510,0,4779
"06059021829",3780,83,156,0,1197,24,494,16,5750
"06059021830",4412,7,13,0,1336,0,678,0,6446
"06059021903",2830,251,136,0,837,99,1339,202,5694
"06059021905",4347,48,15,0,1058,36,917,0,6421
"06059021912",2975,138,37,0,1544,0,583,0,5277
"06059021913",4311,168,43,73,3735,1290,5068,1409,16097
"06059021914",2257,310,40,0,1244,43,1095,185,5174
"06059021915",2781,87,0,38,1079,46,636,50,4717
"06059021916",2278,53,39,0,1144,1,164,0,3679
"06059021917",2466,24,0,0,554,44,629,1,3718
"06059021918",2862,263,0,0,1418,344,1241,287,6415
"06059021919",2182,34,31,0,441,120,618,7,3433
"06059021920",3932,183,35,0,2206,72,747,26,7201
"06059021921",3271,13,88,0,1173,39,518,0,5102
"06059021922",3449,85,17,0,1129,94,637,21,5432
"06059021923",4467,86,182,15,2029,0,673,0,7452
"06059021924",2551,49,51,0,1748,56,904,8,5367
"06059032002",5175,315,113,16,448,17,1003,19,7106
"06059032003",4014,228,0,0,750,133,530,182,5837
"06059032011",1459,55,0,2,123,4,77,0,1720
"06059032012",2975,196,44,35,492,0,565,0,4307
"06059032013",3877,325,75,0,707,67,578,23,5652
"06059032014",3351,434,225,0,1441,485,2574,709,9219
"06059032015",4605,648,42,0,1077,37,1068,102,7579
"06059032020",5182,20,0,0,695,15,786,0,6698
"06059032022",4343,831,23,68,1751,97,2543,710,10366
"06059032023",10218,554,170,0,1288,290,1242,266,14028
"06059032027",3468,365,134,9,2578,230,2637,401,9822
"06059032028",2438,112,10,0,703,20,696,37,4016
"06059032029",3018,97,24,16,1214,122,972,0,5463
"06059032030",3129,138,124,0,509,3,768,38,4709
"06059032031",2367,328,0,0,650,0,677,1,4023
"06059032032",2518,165,6,0,452,0,286,0,3427
"06059032033",2528,159,76,0,438,134,387,0,3722
"06059032034",5098,44,64,0,854,0,511,0,6571
"06059032035",1859,71,214,0,229,6,166,0,2545
"06059032036",2654,234,0,0,511,0,600,81,4080
"06059032037",4473,180,75,0,398,0,206,0,5332
"06059032038",4572,189,15,0,1477,72,746,122,7193
"06059032039",5077,150,233,0,1587,16,939,67,8069
"06059032040",2107,99,38,0,316,79,199,69,2907
"06059032041",750,35,10,0,78,3,11,0,887
"06059032042",5265,245,0,0,480,0,1068,44,7102
"06059032043",3650,108,73,0,419,37,471,9,4767
"06059032044",4824,80,12,11,748,24,539,57,6295
"06059032045",2660,134,0,0,257,0,332,0,3383
"06059032046",5165,148,194,0,665,0,433,0,6605
"06059032047",2530,163,122,0,886,14,898,0,4613
"06059032048",4024,154,60,0,1024,0,689,11,5962
"06059032049",6986,355,50,2,1976,60,1061,158,10648
"06059032050",4249,82,13,0,721,0,904,8,5977
"06059032051",3016,302,148,0,906,19,1222,46,5659
"06059032053",6336,132,189,0,1467,108,1326,0,9558
"06059032054",3703,155,37,0,1126,19,982,13,6035
"06059032055",2595,264,0,10,875,110,966,216,5036
"06059032056",5813,286,135,0,1479,59,1214,0,8986
"06059032057",6092,405,28,0,949,49,1239,0,8762
"06059032058",4362,157,27,0,1199,37,1058,35,6875
"06059032059",7706,99,128,0,1823,49,1243,49,11097
"06059032061",3362,93,0,0,82,0,198,8,3743
"06059042103",6044,291,16,32,487,188,840,0,7898
"06059042106",1139,146,0,0,11,13,36,0,1345
"06059042107",1999,384,10,8,1016,776,1349,941,6483
"06059042108",3856,593,0,0,771,23,1086,125,6454
"06059042109",3595,304,46,19,1110,16,810,0,5900
"06059042111",5170,257,62,0,726,37,593,54,6899
"06059042112",5607,292,0,0,828,100,874,100,7801
"06059042113",3925,232,54,0,593,134,590,94,5622
"06059042114",3670,29,0,0,706,114,851,46,5416
"06059042201",4083,566,86,0,328,199,506,268,6036
"06059042203",5602,509,0,99,743,67,790,167,7977
"06059042205",4847,331,61,0,1214,176,1094,218,7941
"06059042206",2582,230,0,0,130,0,255,10,3207
"06059042305",3229,132,0,0,177,10,141,10,3699
"06059042307",4165,426,0,0,2224,202,1513,51,8581
"06059042310",6115,626,0,0,1924,212,2938,347,12162
"06059042311",4623,220,0,0,931,236,913,200,7123
"06059042312",2989,506,0,0,3937,2073,4829,2157,16491
"06059042313",5446,382,51,17,564,540,1213,565,8778
"06059042315",4876,228,223,6,609,17,1004,0,6963
"06059042317",2678,131,17,0,212,9,94,37,3178
"06059042319",2559,76,20,0,587,6,312,0,3560
"06059042320",3027,500,289,0,1298,347,740,104,6305
"06059042323",3933,95,0,0,132,18,222,0,4400
"06059042324",3626,205,86,0,496,83,431,40,4967
"06059042325",2510,240,98,0,673,7,390,0,3918
"06059042326",3553,221,63,0,586,282,382,241,5328
"06059042327",3828,143,27,0,892,16,336,8,5250
"06059042328",1790,84,0,0,258,0,143,0,2275
"06059042329",2961,262,16,0,648,0,533,0,4420
"06059042330",3981,304,398,13,1819,117,1667,218,8517
"06059042331",3769,273,0,227,1117,46,868,0,6300
"06059042332",4867,238,19,0,510,39,377,17,6067
"06059042333",2773,37,11,0,970,0,140,0,3931
"06059042334",3559,142,79,0,1133,321,836,140,6210
"06059042335",3666,291,17,0,1539,84,874,0,6471
"06059042336",3679,16,80,12,695,39,354,3,4878
"06059042337",2905,213,0,0,615,33,355,0,4121
"06059042338",4275,190,0,0,377,29,638,18,5527
"06059042339",2473,251,65,0,631,47,416,41,3924
"06059052404",3,0,0,5,97,0,4,0,109
"06059052408",5006,181,18,18,1195,14,462,48,6942
"06059052410",3317,101,171,0,1947,50,1467,66,7119
"06059052411",2442,510,58,0,2032,139,1450,505,7136
"06059052415",3414,69,133,0,608,33,446,13,4716
"06059052416",2557,32,168,5,1263,47,1246,14,5332
"06059052417",3749,110,10,19,3080,118,463,13,7562
"06059052418",5010,303,191,211,6785,543,1443,81,14567
"06059052419",1902,69,12,0,1265,58,259,58,3623
"06059052420",8166,332,470,132,12343,424,1542,73,23482
"06059052421",3186,380,60,0,1641,168,607,0,6042
"06059052422",2771,53,15,0,1327,40,630,12,4848
"06059052423",3192,182,100,0,1837,146,1075,165,6697
"06059052424",2851,329,163,0,1065,67,763,102,5340
"06059052425",3732,262,72,0,1032,291,679,269,6337
"06059052426",4747,174,0,52,2957,351,620,57,8958
"06059052427",3767,36,41,0,1393,16,627,15,5895
"06059052428",5108,80,91,0,1280,64,878,41,7542
"06059052502",3948,173,107,0,2168,136,1494,57,8083
"06059052505",2338,252,27,8,1825,364,538,197,5549
"06059052506",1636,42,182,0,672,58,246,24,2860
"06059052511",3874,167,68,34,1357,136,306,93,6035
"06059052513",3646,278,82,15,1641,550,281,56,6549
"06059052514",3335,666,0,29,1457,212,426,55,6180
"06059052515",2919,264,254,11,4976,443,907,123,9897
"06059052517",5038,94,88,0,4024,696,826,63,10829
"06059052518",2025,368,21,7,847,87,293,6,3654
"06059052519",2228,417,0,0,1578,126,418,46,4813
"06059052520",2128,83,0,0,1105,52,316,0,3684
"06059052521",2151,467,356,0,1977,311,579,182,6023
"06059052522",1557,89,185,15,2136,214,385,0,4581
"06059052523",1707,437,36,0,1927,92,259,46,4504
"06059052524",4384,311,176,0,2712,1217,1377,540,10717
"06059052525",6381,722,502,18,8072,558,1090,92,17435
"06059052526",2364,195,79,0,1880,42,399,53,5012
"06059052527",3585,534,268,0,4166,120,801,276,9750
"06059052528",2141,61,105,0,1296,188,618,18,4427
"06059062604",8630,443,11,0,4863,522,717,0,15186
"06059062605",2661,289,0,0,245,19,344,25,3583
"06059062610",3118,476,204,0,1987,645,580,29,7039
"06059062611",1686,703,78,26,1089,875,530,144,5131
"06059062612",5185,402,0,0,1787,547,481,50,8452
"06059062614",3188,1684,61,14,2353,2893,724,690,11607
"06059062619",3783,233,24,4,116,8,343,15,4526
"06059062620",4159,252,32,12,447,0,173,14,5089
"06059062621",3468,225,27,0,1115,23,991,30,5879
"06059062622",3024,385,32,0,747,90,325,73,4676
"06059062625",2554,515,22,38,1135,170,1377,450,6261
"06059062626",890,361,51,0,279,1412,235,97,3325
"06059062627",1165,331,0,0,560,1144,180,243,3623
"06059062628",1272,8,0,0,1285,202,126,15,2908
"06059062629",1846,169,32,0,796,59,86,52,3040
"06059062630",1101,67,6,0,380,19,47,0,1620
"06059062631",2303,83,52,0,826,43,70,0,3377
"06059062632",3335,261,25,0,535,34,377,23,4590
"06059062633",4419,234,0,0,1416,63,312,28,6472
"06059062634",3729,51,298,0,1374,55,724,0,6231
"06059062635",3341,130,31,0,1098,0,790,20,5410
"06059062636",2051,37,272,24,1285,0,536,0,4205
"06059062637",2882,339,71,0,1156,0,778,15,5241
"06059062638",4086,121,164,0,1713,0,1022,0,7106
"06059062639",5023,130,250,120,1834,73,623,13,8066
"06059062640",2464,20,36,0,836,90,522,57,4025
"06059062641",3036,176,98,0,1540,184,1164,289,6487
"06059062642",2323,209,0,0,155,142,49,143,3021
"06059062643",5273,179,0,0,1368,122,310,67,7319
"06059062644",6023,777,116,0,965,136,598,94,8709
"06059062645",4889,95,0,0,1124,256,295,0,6659
"06059062646",2642,396,21,0,344,15,105,14,3537
"06059062647",2434,182,29,0,969,80,575,43,4312
"06059062648",2162,190,0,0,300,9,51,9,2721
"06059062649",2468,199,36,0,355,15,218,13,3304
"06059062701",2189,230,0,0,188,20,166,69,2862
"06059062702",4148,258,0,0,205,0,394,14,5019
"06059062800",3596,352,27,16,145,140,249,47,4572
"06059062900",1479,49,0,0,88,25,113,11,1765
"06059063004",4998,327,60,42,379,19,389,53,6267
"06059063005",1036,90,5,0,59,21,8,0,1219
"06059063006",2712,116,19,0,53,0,221,0,3121
"06059063007",5133,152,0,0,1033,239,342,45,6944
"06059063008",564,106,0,0,90,22,29,0,811
"06059063009",1420,23,0,0,152,19,175,0,1789
"06059063010",6317,331,151,0,703,66,766,15,8349
"06059063101",2007,86,34,7,431,150,255,127,3097
"06059063102",4512,391,37,2,1034,36,827,15,6854
"06059063103",2147,219,0,0,172,23,274,0,2835
"06059063201",2745,126,8,0,839,128,647,9,4502
"06059063202",3033,135,12,0,395,145,622,158,4500
"06059063301",2173,276,0,6,394,148,356,141,3494
"06059063302",3381,254,36,0,414,11,420,21,4537
"06059063400",4103,319,0,0,190,16,160,0,4788
"06059063500",5906,704,22,58,788,112,435,65,8090
"06059063601",2690,155,23,0,948,276,1107,276,5475
"06059063603",3994,486,0,0,1125,166,1063,194,7028
"06059063604",1618,509,0,0,1123,908,1358,1216,6732
"06059063605",1495,162,102,0,1698,1470,2278,1523,8728
"06059063701",1923,676,36,0,2114,850,2921,1283,9803
"06059063702",2238,411,14,11,1400,875,1598,871,7418
"06059063802",2541,76,28,0,221,0,593,2,3461
"06059063803",2898,298,10,13,1107,90,940,167,5523
"06059063805",1670,120,0,0,440,149,140,64,2583
"06059063806",3267,83,9,0,439,23,879,26,4726
"06059063807",2617,430,189,43,955,346,823,69,5472
"06059063808",2275,263,15,0,1919,1324,2721,1413,9930
"06059063902",4223,1091,140,19,1119,281,2136,477,9486
"06059063903",2764,164,118,0,881,138,1318,249,5632
"06059063904",2541,358,82,0,1177,631,1123,714,6626
"06059063905",3436,378,0,0,698,154,742,211,5619
"06059063906",2913,546,98,0,1750,649,1934,953,8843
"06059063907",4694,311,132,83,3114,208,1261,131,9934
"06059063908",3466,208,140,15,1714,65,1890,19,7517
"06059074003",1330,335,15,11,1782,352,2335,438,6598
"06059074004",2833,75,406,3,4208,457,3623,442,12047
"06059074005",2061,357,11,0,4225,670,5083,837,13244
"06059074006",2045,251,277,16,2551,342,3186,484,9152
"06059074102",3579,150,22,0,2066,569,4903,672,11961
"06059074103",1465,178,8,0,2763,625,3915,723,9677
"06059074106",2939,520,133,23,2076,227,2933,650,9501
"06059074107",2532,464,291,0,1644,98,1141,216,6386
"06059074108",2354,535,89,65,1958,317,3900,818,10036
"06059074109",2060,408,0,0,1526,166,3298,505,7963
"06059074110",1775,65,121,31,2096,165,1635,137,6025
"06059074111",3088,349,62,0,2022,300,3502,453,9776
"06059074200",2150,415,43,0,4610,1143,6190,1510,16061
"06059074300",1099,321,26,0,2129,597,3145,869,8186
"06059074403",1955,1004,0,0,2190,722,3822,1716,11409
"06059074405",1303,1133,35,13,2034,963,3047,2059,10587
"06059074406",1517,418,2,26,929,343,2352,653,6240
"06059074407",2687,1083,145,68,2011,938,4108,1952,12992
"06059074408",2033,649,129,12,2341,387,3489,859,9899
"06059074501",1786,1493,0,0,2134,1840,3239,3201,13693
"06059074502",1276,329,0,0,3471,616,4423,925,11040
"06059074601",3274,714,0,16,3525,1035,6362,1678,16604
"06059074602",3164,807,58,0,3249,1796,6288,2603,17965
"06059074701",4306,537,134,0,1896,396,5651,907,13827
"06059074702",1733,809,14,0,2820,563,4163,1332,11434
"06059074801",1824,769,76,0,2149,1131,3819,1725,11493
"06059074802",2270,1378,17,0,2394,746,4341,1934,13080
"06059074803",4504,244,177,159,3100,875,5932,765,15756
"06059074805",2228,1102,62,6,1341,506,3348,1576,10169
"06059074806",1866,902,67,0,1707,566,3350,1445,9903
"06059074901",2838,1081,19,0,4213,1369,6936,2222,18678
"06059074902",2139,1051,3,0,2528,672,4521,1719,12633
"06059075002",2266,945,131,12,3359,1542,5228,2208,15691
"06059075003",1891,1021,35,0,2465,1815,4213,2811,14251
"06059075004",852,1173,0,0,2240,1452,2942,2566,11225
"06059075100",1694,656,0,0,4338,1519,4923,2103,15233
"06059075201",1749,176,0,0,2972,917,4086,1086,10986
"06059075202",1489,246,77,0,3545,594,4831,627,11409
"06059075301",1984,484,60,0,2692,459,2435,775,8889
"06059075302",1789,267,21,18,1542,341,2772,537,7287
"06059075303",2312,114,32,0,774,120,1232,183,4767
"06059075401",1964,361,23,25,1276,70,1832,273,5824
"06059075403",3661,825,148,0,2512,482,4023,1054,12705
"06059075404",3556,448,27,0,1197,315,2714,638,8895
"06059075405",2091,151,64,0,740,29,1515,117,4707
"06059075504",3052,103,161,0,817,37,1168,35,5373
"06059075505",2076,174,81,27,1167,156,1344,146,5171
"06059075506",2177,161,21,0,888,32,883,49,4211
"06059075507",2577,432,231,0,2013,430,2070,560,8313
"06059075512",1219,72,198,3,1521,94,1550,65,4722
"06059075513",2578,416,20,51,2154,145,2733,412,8509
"06059075514",1142,547,118,90,1652,405,1866,864,6684
"06059075515",5084,731,222,106,7623,805,4145,874,19590
"06059075603",2938,210,0,0,727,45,533,46,4499
"06059075604",5922,62,22,4,1374,161,471,18,8034
"06059075605",3602,189,41,0,1667,64,784,17,6364
"06059075606",4858,52,79,5,2252,54,544,20,7864
"06059075607",3282,335,58,0,1947,146,730,40,6538
"06059075701",4518,292,275,232,2196,227,3388,172,11300
"06059075702",2885,112,28,0,386,0,665,8,4084
"06059075703",3101,103,0,0,778,0,376,0,4358
"06059075805",2329,535,7,0,1231,81,1631,457,6271
"06059075806",3266,373,37,0,2243,299,2968,391,9577
"06059075807",2210,428,92,10,787,221,826,574,5148
"06059075808",3026,249,28,0,286,33,1046,88,4756
"06059075809",2395,38,9,0,588,19,219,0,3268
"06059075810",2347,63,49,0,768,0,464,13,3704
"06059075811",1746,344,27,0,543,522,893,802,4877
"06059075812",2983,951,43,0,1723,791,1877,1539,9907
"06059075813",2979,454,40,0,1467,65,910,241,6156
"06059075814",2147,74,42,0,835,142,236,0,3476
"06059075815",3023,260,44,0,1561,177,1695,103,6863
"06059075816",1875,382,32,0,1331,128,1406,309,5463
"06059075901",2327,732,50,15,826,321,1320,358,5949
"06059075902",4115,397,42,0,1472,489,2327,558,9400
"06059076000",4350,222,118,2,3213,249,3529,176,11859
"06059076101",3609,316,73,39,4878,596,4211,367,14089
"06059076102",1401,194,40,21,2445,352,1900,162,6515
"06059076103",4062,419,131,0,3712,512,4983,480,14299
"06059076201",3841,323,144,35,1979,42,1633,135,8132
"06059076202",4576,608,291,12,790,43,1567,314,8201
"06059076204",1346,300,30,0,1616,723,1686,754,6455
"06059076205",2880,459,0,0,1454,394,2021,316,7524
"06059076206",3155,207,8,10,900,120,1507,148,6055
"06059076208",3541,428,33,16,1017,130,1255,280,6700
"06059086301",5674,1045,64,10,981,34,5245,1045,14098
"06059086303",3373,506,187,0,2440,330,2628,397,9861
"06059086304",2800,283,294,17,1183,85,1963,229,6854
"06059086305",3215,315,92,0,770,168,2106,104,6770
"06059086306",2637,141,76,6,1333,99,2243,94,6629
"06059086402",3470,1019,92,0,1076,96,2917,951,9621
"06059086404",4416,664,3,7,1448,40,4633,690,11901
"06059086405",4144,1572,187,125,828,92,4185,1557,12690
"06059086406",2909,470,53,18,735,143,2213,496,7037
"06059086407",4700,995,48,44,1167,182,3560,910,11606
"06059086501",2919,1096,0,17,370,124,2554,1122,8202
"06059086502",3455,1512,61,236,1022,533,4197,1969,12985
"06059086601",2645,1760,222,79,3432,1447,4973,3018,17576
"06059086602",2558,1126,127,6,1924,600,2742,1412,10495
"06059086701",4083,335,38,38,3500,566,3295,643,12498
"06059086702",2460,391,242,0,2697,1033,3767,1201,11791
"06059086801",1877,36,4,0,1275,155,1182,121,4650
"06059086802",2503,192,120,40,2380,601,2638,492,8966
"06059086803",3042,419,672,0,3347,993,2028,526,11027
"06059086901",2088,555,342,310,2916,1504,2259,1159,11133
"06059086902",2227,450,47,40,2205,408,1426,257,7060
"06059086903",2607,599,59,15,2988,451,3320,712,10751
"06059087001",1899,394,203,81,1986,301,2044,552,7460
"06059087002",2746,500,119,11,3382,377,2796,340,10271
"06059087101",1785,156,237,40,2061,523,1541,311,6654
"06059087102",1553,276,78,176,2441,518,2193,656,7891
"06059087103",3340,206,162,0,3784,783,3516,158,11949
"06059087105",1985,264,96,0,1752,214,1766,149,6226
"06059087106",3201,232,44,0,1102,314,2989,364,8246
"06059087200",5194,973,125,0,1467,189,4009,733,12690
"06059087300",5575,1942,159,0,1799,229,4799,1892,16395
"06059087401",2630,418,207,8,638,80,2351,404,6736
"06059087403",1620,935,67,0,401,180,1831,1025,6059
"06059087404",2407,592,36,32,459,158,2620,741,7045
"06059087405",3559,1232,31,22,944,292,3850,1328,11258
"06059087503",3023,1052,42,0,2063,346,2339,1254,10119
"06059087504",3241,1677,78,8,1641,787,3947,2334,13713
"06059087505",2446,391,126,124,1755,657,2421,855,8775
"06059087601",2515,681,76,31,1242,336,1607,762,7250
"06059087602",3702,475,96,102,2811,515,3007,896,11604
"06059087701",2912,148,50,0,2278,327,2242,110,8067
"06059087703",2013,361,45,0,2571,361,2558,453,8362
"06059087704",1818,266,62,0,2052,495,1335,209,6237
"06059087801",1980,616,248,2,2279,229,1624,384,7362
"06059087802",3145,490,432,0,2683,320,2245,549,9864
"06059087803",1250,1131,142,0,2197,1022,1953,1728,9423
"06059087805",2225,814,158,0,3126,563,3200,926,11012
"06059087806",1107,799,8,0,2950,709,2254,905,8732
"06059087901",1114,198,17,0,1941,239,1091,288,4888
"06059087902",1802,719,71,4,2223,1341,2557,1532,10249
"06059088001",1840,524,23,31,1872,238,1464,451,6443
"06059088002",1622,270,86,4,1599,177,980,188,4926
"06059088101",1217,14,52,4,784,50,716,39,2876
"06059088104",1715,266,59,0,2344,402,1282,383,6451
"06059088105",1259,165,39,0,1979,341,806,0,4589
"06059088106",2251,294,57,0,2110,453,1439,428,7032
"06059088107",1603,439,5,0,3441,770,1367,363,7988
"06059088201",1714,567,33,0,1349,486,1288,401,5838
"06059088202",1280,72,11,0,1550,234,910,76,4133
"06059088203",2407,458,14,17,1864,191,1304,449,6704
"06059088301",2866,582,26,0,2923,553,2472,709,10131
"06059088302",2401,118,118,0,2705,469,1186,163,7160
"06059088401",2714,181,39,0,1794,407,1801,367,7303
"06059088402",2634,222,154,6,1144,705,2340,519,7724
"06059088403",3543,336,109,53,2936,372,3880,556,11785
"06059088501",2254,849,20,18,2828,400,2562,760,9691
"06059088502",1595,320,45,0,2317,308,2073,367,7025
"06059088601",2398,161,57,16,3040,579,2118,141,8510
"06059088602",1788,190,135,35,2229,232,1439,108,6156
"06059088701",1662,393,0,0,3348,1031,1805,644,8883
"06059088702",1343,558,4,0,3182,1068,1191,551,7897
"06059088801",1244,903,64,0,5079,1245,1741,1054,11330
"06059088802",1516,618,70,9,2574,810,996,752,7345
"06059088901",1335,239,31,0,3936,1013,690,61,7305
"06059088902",1165,237,0,0,2462,927,1324,300,6415
"06059088903",1502,225,104,0,5389,1183,1597,287,10287
"06059088904",704,278,0,0,3665,948,264,199,6058
"06059088905",917,69,2,0,3563,737,744,76,6108
"06059089001",1181,113,8,0,4611,1254,2572,402,10141
"06059089003",1339,515,3,0,1542,744,1661,756,6560
"06059089004",2080,468,11,16,3548,1333,3288,1516,12260
"06059089102",2532,379,7,0,3745,328,4516,422,11929
"06059089104",1386,942,24,1,1628,1042,2196,1325,8544
"06059089105",1459,160,136,0,3272,1264,4157,1281,11729
"06059089106",1158,289,69,0,1340,535,1712,572,5675
"06059089107",2304,200,0,28,2854,315,2864,271,8836
"06059099202",3205,794,21,17,3179,784,3315,991,12306
"06059099203",1418,110,66,0,3970,484,1331,48,7427
"06059099204",1227,52,18,17,2233,542,303,72,4464
"06059099212",2767,643,26,0,894,403,764,484,5981
"06059099214",2420,252,16,0,460,0,389,15,3552
"06059099215",3758,136,24,25,1248,22,1144,11,6368
"06059099216",2909,103,134,0,497,98,547,19,4307
"06059099217",2028,64,14,0,302,11,319,8,2746
"06059099220",4384,231,0,0,624,63,861,50,6213
"06059099222",1358,331,32,0,2839,778,732,197,6267
"06059099223",1408,147,20,0,2914,660,1211,166,6526
"06059099224",1511,32,0,0,1689,167,251,23,3673
"06059099225",1246,66,0,0,1742,135,377,23,3589
"06059099226",1417,140,14,0,2514,113,473,12,4683
"06059099227",2843,143,5,0,2918,594,1667,423,8593
"06059099229",3349,129,113,0,2103,530,750,256,7230
"06059099230",2989,214,115,0,951,121,480,0,4870
"06059099231",3672,98,7,0,1795,103,642,0,6317
"06059099232",3803,350,0,0,1340,9,804,96,6402
"06059099233",2033,89,0,0,1319,51,266,0,3758
"06059099234",1693,74,33,0,1324,100,456,0,3680
"06059099235",3212,338,42,2,686,220,745,173,5418
"06059099237",2533,78,35,0,857,115,387,43,4048
"06059099238",2809,95,26,0,673,295,202,53,4153
"06059099239",2876,132,79,0,769,25,300,16,4197
"06059099240",4285,360,48,0,667,0,790,61,6211
"06059099241",2396,282,82,26,1448,122,694,152,5202
"06059099242",2279,212,0,0,1106,47,1209,53,4906
"06059099243",3232,99,85,0,895,0,600,0,4911
"06059099244",2912,144,0,0,448,0,258,7,3769
"06059099245",2515,221,0,0,403,0,420,23,3582
"06059099246",2800,49,0,0,811,2,422,14,4098
"06059099247",880,378,29,0,1502,523,935,463,4710
"06059099248",1352,605,37,38,2592,705,2472,1013,8814
"06059099249",1105,1160,0,0,1570,742,2010,1851,8438
"06059099250",1473,85,143,89,946,93,498,4,3331
"06059099251",2039,271,200,0,2466,446,1743,59,7224
"06059099305",5070,489,0,12,1208,657,1832,678,9946
"06059099306",5122,236,136,0,547,112,893,81,7127
"06059099307",2078,130,0,0,246,53,253,25,2785
"06059099308",4715,73,16,0,791,35,462,0,6092
"06059099309",3498,412,144,0,589,26,462,80,5211
"06059099310",3032,269,0,0,860,55,548,15,4779
"06059099311",3155,310,14,0,334,7,445,86,4351
"06059099402",4199,1066,40,0,1581,2003,3778,2628,15295
"06059099404",3754,80,68,0,580,141,417,35,5075
"06059099405",3549,256,19,0,796,38,639,63,5360
"06059099406",3082,171,72,14,1173,130,589,43,5274
"06059099407",1661,151,9,11,555,38,239,29,2693
"06059099408",3115,169,16,0,978,2,507,72,4859
"06059099410",2272,439,92,0,1295,172,798,293,5361
"06059099411",3235,191,45,0,1277,275,1297,197,6517
"06059099412",3181,263,21,0,1082,46,500,112,5205
"06059099413",5192,860,0,0,1715,353,1087,437,9644
"06059099415",4561,113,14,0,805,5,535,4,6037
"06059099416",3537,458,0,0,983,122,849,160,6109
"06059099417",3018,191,12,0,791,174,490,73,4749
"06059099502",341,0,67,0,138,0,181,0,727
"06059099504",2090,162,0,0,568,12,392,16,3240
"06059099506",818,146,25,0,122,33,213,12,1369
"06059099508",3000,449,55,0,632,14,600,290,5040
"06059099509",2808,227,0,0,500,66,331,64,3996
"06059099510",2832,662,0,1,339,145,232,50,4261
"06059099511",2451,214,11,0,538,16,567,9,3806
"06059099512",2226,317,45,0,376,149,392,83,3588
"06059099513",1857,180,0,0,392,11,233,11,2684
"06059099514",3928,112,23,0,1059,0,287,22,5431
"06059099601",2202,376,84,109,2823,1096,1434,595,8719
"06059099602",1925,223,0,0,888,185,766,11,3998
"06059099603",4036,227,51,0,2278,95,1055,15,7757
"06059099604",2919,69,0,0,506,2,437,30,3963
"06059099605",2533,192,0,0,906,18,492,32,4173
"06059099701",1235,186,0,0,3963,992,603,89,7068
"06059099702",3091,441,0,12,3817,826,2169,272,10628
"06059099703",1855,287,0,16,2802,207,508,30,5705
"06059099801",1767,550,23,0,2971,896,1618,790,8615
"06059099802",1597,221,9,0,2124,754,1014,113,5832
"06059099803",1917,150,42,0,2716,680,1340,178,7023
"06059099902",1976,269,69,0,1931,263,718,166,5392
"06059099903",1673,436,65,0,3069,871,1392,673,8179
"06059099904",1675,398,9,0,3028,1203,1489,581,8383
"06059099905",1797,179,27,0,1220,278,1014,258,4773
"06059099906",3272,89,99,0,1709,142,819,0,6130
"06059110001",3075,245,99,0,868,45,533,122,4987
"06059110003",2271,158,37,0,858,25,649,79,4077
"06059110004",3522,95,162,0,950,8,678,0,5415
"06059110005",2507,55,0,0,747,29,648,0,3986
"06059110006",2363,178,103,0,439,8,323,15,3429
"06059110007",3919,191,0,0,709,13,575,13,5420
"06059110008",3570,72,0,0,945,0,504,8,5099
"06059110010",2961,186,198,0,1335,215,783,29,5707
"06059110011",1848,29,0,0,898,138,403,38,3354
"06059110012",3648,161,17,7,1056,20,776,0,5685
"06059110014",2814,249,110,100,1461,186,1430,204,6554
"06059110015",2620,167,0,0,559,20,472,10,3848
"06059110102",2450,260,117,0,2458,441,754,86,6566
"06059110104",2941,111,72,68,2382,250,1095,96,7015
"06059110106",2622,75,166,0,1297,125,952,12,5249
"06059110108",1486,148,22,0,946,70,408,7,3087
"06059110109",2515,243,185,0,2076,47,580,63,5709
"06059110110",3292,361,66,130,1738,386,1740,114,7827
"06059110111",2638,198,97,8,2652,164,942,105,6804
"06059110113",1281,141,31,29,786,40,258,40,2606
"06059110114",3333,189,157,33,1124,80,842,36,5794
"06059110115",1212,16,176,0,1753,86,417,59,3719
"06059110116",1763,26,132,71,2470,333,451,13,5259
"06059110117",3357,71,173,0,2116,239,1163,0,7119
"06059110118",953,4,39,0,1675,5,201,4,2881
"06059110201",4041,655,537,0,2268,413,1920,397,10231
"06059110202",3187,220,261,174,3195,431,1965,313,9746
"06059110203",3284,154,101,35,1400,353,1003,339,6669
"06059110301",4405,539,180,13,2149,148,2238,484,10156
"06059110302",2844,273,5,22,1995,187,1993,238,7557
"06059110303",2739,135,99,12,1666,150,1467,125,6393
"06059110304",2460,59,99,0,1796,126,1231,22,5793
"06059110401",3401,148,63,0,1586,27,1928,119,7272
"06059110402",2706,717,38,10,1857,47,2229,658,8262
"06059110500",4123,1294,432,248,1412,690,3498,1327,13024
"06059110603",4437,906,566,0,2412,373,4329,870,13893
"06059110604",2279,236,261,18,4981,172,1208,79,9234
"06059110605",1548,31,133,11,3763,989,322,53,6850
"06059110606",1878,888,228,226,1630,9,2157,873,7889
"06059110607",1749,205,148,0,1968,234,992,100,5396
"06059980000",0,0,0,0,0,0,0,0,0
"06059990100",0,0,0,0,0,0,0,0,0
"06061020104",882,157,0,0,0,1,109,13,1162
"06061020105",1136,50,0,0,0,0,207,16,1409
"06061020106",1481,134,0,0,82,21,398,13,2129
"06061020107",2395,599,7,0,323,21,1933,485,5763
"06061020200",4817,860,0,0,311,27,344,55,6414
"06061020300",3276,539,18,16,426,83,388,64,4810
"06061020401",1204,305,85,40,152,69,69,26,1950
"06061020402",3222,235,0,0,174,0,16,25,3672
"06061020501",2454,378,12,1,228,21,338,12,3444
"06061020502",3433,326,0,39,204,0,49,5,4056
"06061020601",6822,98,0,1,770,39,397,38,8165
"06061020602",6333,295,37,0,527,41,581,26,7840
"06061020604",4626,292,46,20,766,269,428,0,6447
"06061020605",4945,85,206,1,880,9,488,0,6614
"06061020606",3347,80,19,0,828,14,186,45,4519
"06061020710",3496,197,0,6,612,0,365,0,4676
"06061020711",3551,196,8,0,485,32,422,9,4703
"06061020712",2942,424,40,0,234,0,757,33,4430
"06061020713",2315,495,25,5,257,15,291,70,3473
"06061020714",3017,306,120,0,389,15,280,14,4141
"06061020715",2043,218,6,8,717,13,627,4,3636
"06061020717",2133,99,0,0,1017,14,616,0,3879
"06061020805",3000,210,28,0,648,141,478,117,4622
"06061020806",2504,127,57,0,507,114,823,116,4248
"06061020901",1362,324,31,32,588,364,870,431,4002
"06061020908",4647,500,0,139,1086,190,1542,185,8289
"06061021003",5065,393,69,18,862,37,1164,184,7792
"06061021034",3281,460,70,0,794,10,407,0,5022
"06061021035",5037,161,14,0,1538,330,818,60,7958
"06061021037",1569,48,91,0,380,18,154,0,2260
"06061021038",5662,352,59,94,778,248,1154,218,8565
"06061021039",1481,32,0,0,124,0,0,0,1637
"06061021040",2667,331,0,0,142,0,166,0,3306
"06061021043",2550,101,83,0,445,28,247,50,3504
"06061021044",4562,431,99,0,790,302,865,0,7049
"06061021045",2305,367,0,2,567,12,988,127,4368
"06061021046",3436,192,0,0,763,152,463,118,5124
"06061021103",3041,198,48,8,438,40,558,32,4363
"06061021106",1699,65,9,5,169,12,38,0,1997
"06061021108",2306,177,0,0,177,14,241,0,2915
"06061021109",3823,363,111,102,475,38,374,38,5324
"06061021122",3159,67,41,7,228,0,289,0,3791
"06061021123",6530,181,29,3,1111,23,741,13,8631
"06061021128",2001,104,230,0,477,89,250,15,3166
"06061021129",2243,297,10,0,277,194,167,143,3331
"06061021130",1819,128,14,14,486,167,418,62,3108
"06061021131",3667,492,8,16,894,154,402,11,5644
"06061021203",4973,304,28,2,528,51,314,20,6220
"06061021204",2109,230,0,0,273,0,313,0,2925
"06061021304",4510,442,0,3,345,128,736,121,6285
"06061021309",7393,230,118,0,2122,425,1222,559,12069
"06061021322",7382,706,126,89,2378,142,918,81,11822
"06061021401",1777,350,0,0,196,33,420,172,2948
"06061021403",4288,1700,40,0,945,261,2090,1155,10479
"06061021501",4409,573,53,11,560,81,447,409,6543
"06061021502",3075,307,28,0,191,45,217,61,3924
"06061021603",3542,643,0,1,607,158,832,518,6301
"06061021604",3247,171,0,0,115,0,246,19,3798
"06061021801",3932,359,19,0,240,67,300,67,4984
"06061021802",4496,497,27,33,657,90,537,42,6379
"06061021901",2114,279,19,3,241,17,108,20,2801
"06061021902",3992,144,0,0,292,0,207,0,4635
"06061022002",5845,748,43,67,143,88,469,88,7491
"06061022011",1440,124,0,0,0,0,44,46,1654
"06061022013",2050,333,0,0,80,29,73,7,2572
"06061022014",1020,80,0,0,11,24,52,24,1211
"06061022100",819,34,0,0,62,0,34,0,949
"06061022200",882,21,2,0,45,14,240,0,1204
"06061022300",710,70,0,0,35,0,29,0,844
"06061022400",2949,281,83,0,992,51,432,10,4798
"06061022500",2752,144,149,44,683,13,98,0,3883
"06061022600",4014,462,25,0,796,18,215,92,5622
"06061022800",2714,268,9,35,888,69,528,10,4521
"06061022900",3391,489,146,0,1232,70,634,412,6374
"06061023000",2446,174,26,73,573,43,319,132,3786
"06061023100",4949,53,294,0,1776,22,490,22,7606
"06061023200",3656,10,36,1,1306,140,767,139,6055
"06061023300",3101,254,74,0,811,9,482,65,4796
"06061023400",3711,78,0,2,470,0,638,11,4910
"06061023500",4062,330,50,0,996,67,523,38,6066
"06061023600",3837,255,15,0,319,0,178,0,4604
"06061023700",2890,185,51,0,149,52,66,0,3393
"06061023800",2912,269,79,0,85,6,107,0,3458
"06061023900",2265,234,12,15,689,0,663,0,3878
"06061990000",0,0,0,0,0,0,0,0,0
"06063000100",3358,984,94,30,430,70,119,35,5120
"06063000201",1184,71,0,2,16,16,74,16,1379
"06063000202",879,103,8,0,0,0,39,0,1029
"06063000300",3783,617,60,0,433,82,909,127,6011
"06063000400",2008,495,0,0,155,62,140,6,2866
"06063000501",1658,220,0,1,11,0,20,41,1951
"06063000502",2086,117,0,0,97,47,14,0,2361
"06065030101",673,55,72,20,84,125,558,175,1762
"06065030103",1849,327,49,15,142,272,1613,386,4653
"06065030104",3266,863,478,53,1478,1741,3065,1795,12739
"06065030200",2708,365,172,64,901,161,1312,315,5998
"06065030300",1267,793,314,99,520,135,889,474,4491
"06065030400",1808,1966,587,210,1622,445,2998,2266,11902
"06065030501",1285,1229,752,113,1018,516,1912,1479,8304
"06065030502",1147,239,25,38,600,108,1677,287,4121
"06065030503",1597,1148,63,34,474,319,1940,1305,6880
"06065030601",3896,107,258,31,945,0,936,0,6173
"06065030602",2600,199,76,0,442,0,527,65,3909
"06065030603",2479,250,0,167,52,87,170,111,3316
"06065030700",3871,1771,186,116,366,251,1724,1458,9743
"06065030800",4673,691,221,4,983,358,2470,600,10000
"06065030900",2630,230,246,6,337,22,2041,170,5682
"06065031001",4216,384,243,86,681,19,2194,93,7916
"06065031002",2766,552,227,24,465,218,2440,635,7327
"06065031100",3517,411,175,48,341,179,1469,272,6412
"06065031200",4508,642,304,0,701,247,2214,648,9264
"06065031300",1196,545,100,150,446,321,1557,859,5174
"06065031401",4081,767,390,174,986,372,2815,657,10242
"06065031402",4739,266,313,196,772,98,3009,195,9588
"06065031501",2919,862,122,3,1496,233,2291,762,8688
"06065031502",3581,1303,155,22,2789,409,3277,1385,12921
"06065031601",1893,634,41,88,1685,294,2483,336,7454
"06065031602",2673,706,136,75,1984,440,3040,1121,10175
"06065031701",1364,794,194,33,398,322,907,901,4913
"06065031702",1642,40,110,3,805,8,1045,26,3679
"06065031703",2490,138,84,12,1165,284,2329,297,6799
"06065031704",3558,628,208,13,760,34,1982,403,7586
"06065040101",1431,462,310,137,1376,364,2336,816,7232
"06065040102",1726,335,8,51,1880,647,2516,836,7999
"06065040201",2607,400,193,133,3064,417,4058,671,11543
"06065040202",1937,355,229,5,582,166,1501,358,5133
"06065040203",1175,938,14,97,1584,758,2553,1624,8743
"06065040204",1037,252,130,43,1206,680,1987,894,6229
"06065040301",2980,445,78,47,3781,973,5015,1177,14496
"06065040302",5098,114,277,91,2222,64,4020,78,11964
"06065040303",1765,183,17,0,949,140,1824,272,5150
"06065040402",2177,226,0,0,884,344,2104,441,6176
"06065040403",3297,433,178,0,1389,391,3389,725,9802
"06065040404",1670,31,3,0,1033,129,1588,0,4454
"06065040405",3645,246,113,3,1040,156,2305,47,7555
"06065040501",3635,856,248,9,2157,347,4082,905,12239
"06065040502",2154,851,283,47,2436,881,3850,1614,12116
"06065040503",2337,245,302,55,876,134,1919,186,6054
"06065040603",1313,172,18,0,823,87,1478,241,4132
"06065040604",4084,479,84,0,1038,206,2801,532,9224
"06065040605",1562,205,0,1,1089,107,2220,225,5409
"06065040606",1465,264,36,0,1045,111,2025,241,5187
"06065040607",4560,41,790,82,3403,491,4635,482,14484
"06065040609",5315,265,902,110,4410,315,3894,152,15363
"06065040611",3858,48,423,64,2951,98,2324,39,9805
"06065040613",6832,242,870,47,6289,122,5441,174,20017
"06065040615",5559,471,915,80,3164,124,4404,435,15152
"06065040616",3393,149,1236,41,4865,95,3285,73,13137
"06065040701",1754,78,23,0,621,14,620,1,3111
"06065040702",2154,362,19,2,181,39,627,96,3480
"06065040703",2578,210,17,23,170,27,562,96,3683
"06065040806",2144,42,37,0,548,4,724,13,3512
"06065040807",2233,308,218,0,536,9,981,304,4589
"06065040808",3576,1282,129,166,1483,360,2306,847,10149
"06065040809",1924,307,364,3,1149,13,1713,258,5731
"06065040812",2938,230,14,0,343,7,1101,7,4640
"06065040813",3529,455,429,0,1759,177,1576,223,8148
"06065040814",2674,334,518,177,1072,107,1328,180,6390
"06065040815",1706,119,485,16,1047,46,1121,71,4611
"06065040816",1789,227,293,62,609,13,933,0,3926
"06065040821",3652,217,251,68,1665,91,2948,151,9043
"06065040901",3952,451,677,2,1703,498,2945,661,10889
"06065040902",2869,745,447,11,885,73,1549,523,7102
"06065040903",1617,394,88,16,291,171,769,401,3747
"06065040904",2097,831,68,13,875,56,2321,608,6869
"06065041001",1529,511,137,92,644,254,1689,639,5495
"06065041002",1763,600,55,0,614,593,1622,1098,6345
"06065041003",1904,213,60,38,370,14,1237,160,3996
"06065041004",2685,675,72,0,1108,429,2554,683,8206
"06065041101",2112,1481,6,257,1782,295,3475,1611,11019
"06065041102",2289,351,16,22,918,265,2576,504,6941
"06065041201",1615,422,84,34,1070,383,1808,570,5986
"06065041202",2378,590,7,0,1767,265,3653,832,9492
"06065041203",1598,239,130,15,1118,616,1982,713,6411
"06065041301",2183,235,25,0,1138,201,2794,288,6864
"06065041302",2545,701,23,0,965,440,3050,960,8684
"06065041403",1707,92,148,31,735,80,1303,106,4202
"06065041404",1958,269,125,0,1564,411,1956,526,6809
"06065041405",1565,292,153,0,1625,255,1870,302,6062
"06065041406",3809,407,622,24,1085,56,2543,275,8821
"06065041407",2697,1037,180,31,1029,262,2448,978,8662
"06065041408",2480,73,263,247,1044,7,2042,57,6213
"06065041409",9357,556,862,155,4600,688,4606,455,21279
"06065041410",1503,513,0,0,604,391,1880,867,5758
"06065041411",1682,748,66,3,454,82,1686,752,5473
"06065041412",2304,392,183,0,1479,306,1836,483,6983
"06065041500",1055,398,4,13,349,270,1077,653,3819
"06065041600",3259,1130,170,9,1047,819,3402,1621,11457
"06065041702",3536,283,0,0,1043,54,2491,239,7646
"06065041703",2982,1595,241,80,702,228,2800,1618,10246
"06065041704",2197,960,0,0,595,356,2438,1239,7785
"06065041803",3928,81,183,39,2013,14,1216,3,7477
"06065041804",2506,136,240,0,833,93,1100,88,4996
"06065041805",3829,487,353,20,981,37,1912,204,7823
"06065041806",2966,138,269,0,1042,62,1311,127,5915
"06065041807",1765,129,0,7,458,0,1067,129,3555
"06065041808",4509,116,183,133,1838,87,1922,18,8806
"06065041809",4063,325,455,0,663,109,1968,101,7684
"06065041810",3580,66,616,47,1641,50,1132,20,7152
"06065041812",2448,116,90,0,428,154,1358,108,4702
"06065041813",3984,1284,56,61,1323,167,3493,1251,11619
"06065041904",3273,295,54,12,1162,96,1947,254,7093
"06065041905",1590,233,119,0,717,96,1128,142,4025
"06065041906",4090,692,328,10,1235,30,3493,618,10496
"06065041909",3878,291,78,0,755,153,2355,309,7819
"06065041910",4241,535,239,0,1122,12,2185,143,8477
"06065041911",8340,334,429,10,2001,116,2754,289,14273
"06065041912",3713,204,0,181,1609,26,1411,18,7162
"06065041913",3363,359,91,0,1624,69,1399,228,7133
"06065042003",4367,587,219,0,826,83,1512,32,7626
"06065042004",3128,238,27,0,674,25,1217,165,5474
"06065042005",3546,64,559,0,878,116,1203,5,6371
"06065042007",2673,386,137,2,716,280,1015,386,5595
"06065042008",4615,274,864,19,965,46,1837,216,8836
"06065042009",4205,741,353,172,1220,1054,3394,1325,12464
"06065042010",2514,1015,345,56,1395,865,3041,1550,10781
"06065042012",3671,800,710,82,1072,206,1831,67,8439
"06065042013",5553,385,834,0,1699,42,2602,245,11360
"06065042014",6433,178,1496,0,1940,159,2882,41,13129
"06065042206",2561,937,396,147,807,372,1060,690,6970
"06065042207",2396,161,97,10,265,0,580,31,3540
"06065042208",2076,99,74,1,328,0,406,6,2990
"06065042209",1357,844,194,170,302,554,890,568,4879
"06065042210",1361,680,343,148,675,644,982,631,5464
"06065042212",3978,315,398,422,1135,143,2474,313,9178
"06065042213",2124,239,112,50,1133,521,841,190,5210
"06065042214",3707,426,449,92,1160,462,2180,565,9041
"06065042217",3533,65,307,85,1024,91,926,54,6085
"06065042300",4082,1010,113,4,1613,413,4024,1073,12332
"06065042401",1358,55,24,16,371,87,881,89,2881
"06065042402",2516,259,575,10,1188,501,1940,666,7655
"06065042403",2785,411,371,114,694,79,2268,368,7090
"06065042404",776,585,257,173,505,64,837,566,3763
"06065042405",1724,934,791,866,746,168,1736,821,7786
"06065042406",2364,232,439,102,857,0,1955,188,6137
"06065042407",1536,442,570,192,612,108,1330,318,5108
"06065042408",1652,405,286,0,633,40,1539,398,4953
"06065042409",1397,127,206,401,685,346,1388,372,4922
"06065042410",2828,339,936,22,563,73,1856,371,6988
"06065042411",1295,165,617,133,437,10,861,129,3647
"06065042412",3622,142,622,3,1073,16,1674,132,7284
"06065042505",1338,1063,154,145,660,475,1452,1365,6652
"06065042506",3883,522,2038,807,1903,423,3310,466,13352
"06065042507",2182,97,477,683,1400,72,2547,159,7617
"06065042508",1725,447,393,102,1044,696,2251,1000,7658
"06065042509",1643,421,403,16,316,59,1505,321,4684
"06065042510",2428,677,395,353,1076,268,2924,651,8772
"06065042511",1423,760,334,82,576,540,1503,886,6104
"06065042512",1350,439,408,298,640,225,1534,513,5407
"06065042513",1742,306,284,31,492,316,1618,474,5263
"06065042514",1323,245,303,118,492,463,1183,590,4717
"06065042515",1910,858,384,36,395,344,1947,1136,7010
"06065042516",2046,581,498,103,649,261,2191,666,6995
"06065042517",1693,677,222,15,561,286,1648,685,5787
"06065042518",1473,642,319,444,1060,197,1654,721,6510
"06065042519",516,325,223,210,86,178,401,512,2451
"06065042520",2105,753,381,109,676,677,2059,1316,8076
"06065042521",1763,835,551,307,1124,18,1888,779,7265
"06065042617",3483,1659,664,576,3880,1548,5982,3063,20855
"06065042618",3012,1057,357,151,2712,1302,5008,1671,15270
"06065042619",4593,396,1532,139,4042,252,6080,451,17485
"06065042620",3302,1033,912,295,4387,977,5462,1768,18136
"06065042621",2723,671,1310,204,1568,116,2684,593,9869
"06065042622",1708,144,717,4,1536,237,1541,297,6184
"06065042623",2043,184,638,88,654,157,1002,194,4960
"06065042624",2100,360,603,0,705,206,1326,312,5612
"06065042706",2843,1202,482,756,2541,796,4519,1848,14987
"06065042708",3185,432,183,3,857,188,1464,219,6531
"06065042709",3377,626,163,29,544,29,1425,315,6508
"06065042711",3439,236,274,15,398,157,438,198,5155
"06065042714",2952,276,31,0,119,35,279,53,3745
"06065042715",8521,345,1134,38,3619,495,4286,250,18688
"06065042716",4228,453,0,0,359,41,1035,403,6519
"06065042717",2487,601,132,75,1317,212,1729,440,6993
"06065042719",2969,921,155,85,753,268,1797,1142,8090
"06065042720",3028,876,0,1,507,125,1551,755,6843
"06065042723",2811,1328,48,0,1235,184,1680,1072,8358
"06065042724",2151,146,271,8,614,29,889,118,4226
"06065042726",3681,330,416,0,1101,144,1330,122,7124
"06065042728",1262,368,79,0,392,46,749,132,3028
"06065042729",6850,995,341,147,1445,105,2294,584,12761
"06065042730",3204,652,284,0,913,82,2345,639,8119
"06065042731",3906,226,303,65,792,236,2426,381,8335
"06065042732",4230,62,361,25,1143,44,2441,69,8375
"06065042733",3225,340,382,0,630,19,1144,262,6002
"06065042737",1820,95,9,38,343,76,413,34,2828
"06065042738",4308,534,355,52,1139,0,1492,5,7885
"06065042739",4875,414,881,15,1254,94,2408,165,10106
"06065042740",1663,155,45,90,59,14,89,0,2115
"06065042741",1676,199,131,0,120,13,189,30,2358
"06065042742",3496,125,130,2,801,8,1190,81,5833
"06065042743",1207,42,0,0,610,51,736,10,2656
"06065042744",2436,171,35,0,606,18,1531,106,4903
"06065042745",3180,758,161,0,1206,181,1350,400,7236
"06065042800",2503,1446,415,166,2650,1822,4173,2775,15950
"06065042901",2739,928,307,226,2167,1231,4055,1997,13650
"06065042902",1315,970,192,60,924,1072,1320,1893,7746
"06065042903",2003,736,387,26,1543,734,2534,1263,9226
"06065042904",2158,1718,204,159,3060,1215,4261,2525,15300
"06065043001",1728,828,295,47,1626,476,2314,805,8119
"06065043003",2981,849,35,18,1495,800,3027,1313,10518
"06065043005",2762,364,103,57,1744,439,2575,651,8695
"06065043006",1336,892,88,10,1875,764,2083,1531,8579
"06065043007",4825,317,649,1,1070,15,1654,176,8707
"06065043008",3430,412,138,90,1485,492,2523,612,9182
"06065043009",2568,333,101,0,1831,115,1703,321,6972
"06065043010",3860,169,147,28,1608,93,2650,222,8777
"06065043206",4121,453,491,0,2263,228,2165,495,10216
"06065043211",3984,213,245,0,714,88,1433,59,6736
"06065043216",4946,1126,122,167,1324,172,1876,575,10308
"06065043217",2188,86,408,0,628,45,697,12,4064
"06065043218",4410,206,91,6,976,99,1279,127,7194
"06065043220",2251,307,238,50,632,276,1086,333,5173
"06065043222",3086,259,15,0,555,46,890,122,4973
"06065043227",4279,290,635,0,1840,192,1980,192,9408
"06065043228",2736,354,236,118,1194,10,1158,207,6013
"06065043229",4349,207,174,0,380,0,886,47,6043
"06065043235",3375,99,226,0,1192,0,822,82,5796
"06065043239",4821,419,51,0,784,0,1378,204,7657
"06065043240",6489,293,76,0,2188,9,2007,31,11093
"06065043242",5554,297,528,28,2170,185,2383,313,11458
"06065043244",4317,101,315,0,2184,73,2011,11,9012
"06065043246",3963,229,44,0,1068,15,1010,41,6370
"06065043247",5105,376,627,0,2324,37,2184,80,10733
"06065043248",3481,190,83,0,838,250,939,51,5832
"06065043250",5361,388,633,71,1700,523,1158,544,10378
"06065043252",3866,176,250,9,2950,375,1372,54,9052
"06065043254",3020,426,179,0,1064,143,1154,224,6210
"06065043256",1661,134,160,0,1217,104,1138,67,4481
"06065043257",4840,113,226,53,1656,151,458,80,7577
"06065043262",4373,241,34,45,385,48,576,30,5732
"06065043264",5222,236,254,0,1555,217,1779,138,9401
"06065043265",4673,34,95,0,1522,42,1297,14,7677
"06065043266",2926,511,372,0,1247,229,1856,266,7407
"06065043267",4963,193,106,0,1141,0,1417,0,7820
"06065043270",3664,285,114,15,1102,56,1317,3,6556
"06065043271",2285,336,99,0,748,336,1173,498,5475
"06065043272",4065,126,0,0,756,121,1249,76,6393
"06065043274",1261,81,43,7,595,318,606,367,3278
"06065043276",1667,185,1000,0,616,23,512,9,4012
"06065043278",4566,589,319,76,1045,62,1367,0,8024
"06065043279",3926,392,248,0,372,16,1672,44,6670
"06065043291",5231,281,215,0,1799,226,1814,36,9602
"06065043304",5127,684,5,0,688,76,1319,104,8003
"06065043306",2868,538,324,205,868,82,1341,331,6557
"06065043307",3433,999,284,86,1028,700,1634,811,8975
"06065043308",1473,626,101,134,388,164,788,320,3994
"06065043309",1452,595,169,71,454,112,893,360,4106
"06065043310",1632,404,110,45,562,389,800,448,4390
"06065043311",1282,494,0,0,238,116,457,234,2821
"06065043312",2559,352,112,170,1009,202,1931,391,6726
"06065043313",1940,268,78,170,801,308,1523,372,5460
"06065043314",2411,277,68,103,290,69,913,114,4245
"06065043315",1313,77,0,0,264,67,345,99,2165
"06065043316",2686,220,275,0,664,131,321,247,4544
"06065043317",4436,972,229,189,1531,309,2369,953,10988
"06065043401",1906,1474,25,194,1110,676,2192,1216,8793
"06065043403",1173,403,209,233,547,330,939,417,4251
"06065043404",1552,561,15,74,263,21,296,339,3121
"06065043405",1783,1143,121,544,544,489,906,1082,6612
"06065043503",2202,714,87,190,440,172,746,235,4786
"06065043504",4796,578,208,163,1444,171,2178,292,9830
"06065043505",2041,384,181,54,324,72,655,63,3774
"06065043506",3806,478,66,18,1241,291,1596,404,7900
"06065043507",3591,1049,322,225,819,769,2022,1334,10131
"06065043508",4164,718,347,5,1088,363,1638,470,8793
"06065043509",3745,487,9,139,733,182,2131,432,7858
"06065043512",3566,541,487,137,1403,252,2392,265,9043
"06065043513",1587,94,142,15,966,113,1658,42,4617
"06065043517",4009,484,696,326,1566,129,3335,434,10979
"06065043601",1624,656,27,263,1015,395,1761,695,6436
"06065043602",1243,507,77,105,1527,289,2143,577,6468
"06065043701",2247,865,75,41,46,90,635,314,4313
"06065043702",3276,747,119,26,649,222,676,664,6379
"06065043703",1646,210,3,0,393,473,451,316,3492
"06065043802",4307,798,0,0,431,105,929,403,6973
"06065043807",3502,485,150,0,1213,319,1910,564,8143
"06065043809",2335,249,0,9,228,31,378,60,3290
"06065043810",2901,191,115,35,1304,0,1273,15,5834
"06065043811",3125,168,26,45,357,65,876,76,4738
"06065043812",5547,285,164,0,162,0,195,0,6353
"06065043813",1810,374,51,0,1514,456,1324,401,5930
"06065043814",836,44,0,0,21,0,43,0,944
"06065043818",2367,76,332,0,1008,101,1135,78,5097
"06065043820",2356,163,125,137,1408,119,1663,145,6116
"06065043821",1482,349,187,100,778,176,919,378,4369
"06065043822",1364,244,24,24,876,22,584,112,3250
"06065043823",5019,188,327,0,1821,25,2014,59,9453
"06065043900",3960,640,113,30,722,556,2282,685,8988
"06065044000",902,432,51,0,388,191,830,415,3209
"06065044101",1215,597,138,43,397,214,861,581,4046
"06065044102",1496,181,94,87,658,184,1229,269,4198
"06065044103",3842,619,509,0,545,174,958,334,6981
"06065044104",2245,394,63,1,360,77,986,297,4423
"06065044200",1744,706,534,403,1012,622,1597,1169,7787
"06065044300",2236,534,317,0,1131,161,1930,300,6609
"06065044402",4284,313,47,0,501,108,1251,136,6640
"06065044403",2436,470,24,7,650,43,968,4,4602
"06065044404",902,268,0,0,37,19,212,36,1474
"06065044405",1081,44,0,0,34,18,46,18,1241
"06065044505",3377,713,55,1,1839,312,3097,791,10185
"06065044507",2224,1625,227,78,1180,901,2206,2019,10460
"06065044509",1355,875,50,187,985,839,1412,1356,7059
"06065044510",1693,904,80,472,1935,728,2081,1224,9117
"06065044515",1165,560,28,1,1835,60,2093,363,6105
"06065044516",3090,724,425,313,1386,546,3299,813,10596
"06065044517",1623,201,111,10,251,50,211,72,2529
"06065044518",3132,717,89,42,1154,411,1584,328,7457
"06065044520",779,47,37,0,468,204,579,222,2336
"06065044521",330,79,6,76,138,15,162,14,820
"06065044522",2389,828,156,28,1356,304,1594,791,7446
"06065044602",2193,452,109,4,234,23,626,74,3715
"06065044604",3029,549,43,13,1284,174,1519,213,6824
"06065044605",2329,739,248,294,823,305,1231,777,6746
"06065044606",1688,258,83,0,118,178,510,228,3063
"06065044701",1864,258,275,12,641,138,549,74,3811
"06065044702",1554,318,27,0,244,195,1606,481,4425
"06065044804",1486,427,12,0,941,11,909,347,4133
"06065044805",1077,189,0,130,168,22,133,22,1741
"06065044806",1447,933,14,0,131,56,270,651,3502
"06065044807",1093,139,44,0,191,5,187,23,1682
"06065044904",3132,353,87,191,1027,130,1817,302,7039
"06065044907",2722,676,143,101,763,212,3261,761,8639
"06065044911",3474,252,66,0,990,219,1240,223,6464
"06065044915",2883,1402,58,23,1349,940,3687,2260,12602
"06065044916",2854,932,133,244,516,120,1339,929,7067
"06065044917",3316,458,0,0,411,18,321,35,4559
"06065044918",2342,179,11,0,27,29,103,0,2691
"06065044919",3547,258,55,0,194,0,210,0,4264
"06065044921",1827,232,33,0,121,32,248,61,2554
"06065044922",3423,123,93,0,1117,51,873,32,5712
"06065044923",2180,300,76,243,937,16,1653,231,5636
"06065044924",2732,355,32,0,1261,157,2576,444,7557
"06065044925",2143,444,12,16,381,150,1400,459,5005
"06065044926",2228,1293,195,9,915,76,1987,1171,7874
"06065044927",2399,281,25,0,721,148,569,62,4205
"06065044928",2765,93,13,0,211,19,124,21,3246
"06065044929",3662,469,104,0,326,0,693,68,5322
"06065044930",2089,381,0,0,236,53,653,249,3661
"06065044931",1720,340,61,7,504,100,1377,350,4459
"06065044932",2294,62,32,13,675,10,1060,33,4179
"06065045000",1540,834,8,0,524,351,906,901,5064
"06065045103",3120,792,6,0,108,5,373,434,4838
"06065045108",3390,118,152,18,1684,66,2653,89,8170
"06065045109",2803,484,31,0,609,18,1468,259,5672
"06065045110",3603,345,293,0,650,96,2450,209,7646
"06065045114",1628,183,16,0,39,0,127,22,2015
"06065045115",1714,42,0,1,204,0,62,19,2042
"06065045116",979,128,0,0,70,8,74,15,1274
"06065045117",3585,323,34,0,209,137,622,159,5069
"06065045118",1299,867,29,0,496,176,627,640,4134
"06065045119",2162,190,14,5,591,103,1202,138,4405
"06065045120",2912,642,36,0,1092,171,2204,545,7602
"06065045121",4428,383,82,1,560,241,715,431,6841
"06065045122",1280,61,6,0,53,0,23,0,1423
"06065045123",1696,199,29,18,274,27,310,27,2580
"06065045124",1158,65,0,0,41,4,88,26,1382
"06065045125",2043,145,0,0,344,29,354,90,3005
"06065045207",1824,746,190,21,1953,1041,3115,1743,10633
"06065045209",2062,788,87,52,1350,807,2834,1556,9536
"06065045212",1659,141,80,0,335,0,331,0,2546
"06065045213",2709,598,100,0,1340,1042,2888,1057,9734
"06065045214",4112,283,32,0,618,3,691,0,5739
"06065045215",7131,466,92,58,1386,58,2440,264,11895
"06065045216",1705,68,0,0,165,0,203,0,2141
"06065045217",2121,488,125,0,2863,807,3749,1189,11342
"06065045222",1111,26,117,17,304,1,154,3,1733
"06065045224",2824,372,24,25,1711,151,3026,204,8337
"06065045226",2591,384,184,0,2812,670,5135,1014,12790
"06065045228",2726,85,98,21,1493,82,1790,121,6416
"06065045233",3198,459,448,63,317,44,1853,156,6538
"06065045302",1537,641,43,32,1220,607,2478,1195,7753
"06065045303",582,739,87,0,839,756,1296,1419,5718
"06065045304",4673,160,316,7,2576,555,4415,619,13321
"06065045501",1183,602,110,0,1721,1415,2584,1846,9461
"06065045502",1740,891,34,16,1120,749,2615,1516,8681
"06065045604",2724,2535,122,13,4050,3044,6579,5494,24561
"06065045605",2593,1389,20,56,2964,2444,4033,3733,17232
"06065045606",1604,107,15,0,652,167,1175,169,3889
"06065045608",2762,145,53,0,165,0,132,0,3257
"06065045609",1385,572,133,0,1735,1913,2837,2425,11000
"06065045703",1546,664,41,9,2623,1158,4136,1805,11982
"06065045704",591,440,97,6,1269,351,1944,797,5495
"06065045705",1541,1335,20,0,2511,3370,4061,4685,17523
"06065045706",1465,722,58,62,1797,594,3241,1307,9246
"06065045707",2928,277,33,0,1778,972,4487,1249,11724
"06065045900",819,289,73,29,397,127,790,368,2892
"06065046101",2475,320,365,12,527,231,1605,390,5925
"06065046102",783,273,47,78,330,241,870,417,3039
"06065046103",1806,206,62,0,575,9,1204,9,3871
"06065046200",1375,559,122,295,960,183,1694,627,5815
"06065046401",2608,163,0,0,509,246,1023,300,4849
"06065046402",2000,927,7,100,816,273,1069,554,5746
"06065046403",3853,436,225,0,2253,416,2951,452,10586
"06065046404",2855,484,78,88,1253,568,1704,937,7967
"06065046405",2377,585,77,0,469,205,1014,332,5059
"06065046500",591,978,186,187,440,1173,280,753,4588
"06065046601",321,20,0,0,8,16,76,12,453
"06065046602",2565,109,84,2,977,244,1094,253,5328
"06065046700",1715,766,458,304,571,327,1674,970,6785
"06065046800",3385,432,1039,86,1073,207,3124,344,9690
"06065046900",1010,246,33,112,497,231,856,354,3339
"06065047000",922,216,129,18,333,52,367,103,2140
"06065047201",1636,268,0,0,162,181,234,240,2721
"06065047202",1005,394,51,0,224,26,362,151,2213
"06065047900",8424,47,756,34,2674,181,2715,82,14913
"06065048100",4211,265,203,0,1704,63,1777,93,8316
"06065048200",2834,51,288,66,1273,14,1514,50,6090
"06065048300",2581,379,1572,278,2168,30,2882,341,10231
"06065048700",2045,17,409,77,1517,61,1756,28,5910
"06065048800",1512,90,577,175,1523,250,2170,331,6628
"06065048901",2450,176,293,11,542,225,2007,261,5965
"06065048902",3346,1062,765,148,1747,296,3914,1021,12299
"06065049000",2651,370,2633,29,1687,867,2888,345,11470
"06065049100",2973,236,2,0,839,12,1294,34,5390
"06065049400",2138,423,20,0,378,0,825,339,4123
"06065049500",3795,685,54,6,2745,1554,6238,1713,16790
"06065049600",4081,217,283,68,1967,58,1568,50,8292
"06065049700",7600,284,63,0,1453,17,2008,0,11425
"06065049800",1962,359,180,6,653,474,1017,301,4952
"06065050300",4379,278,1349,55,3738,0,3023,54,12876
"06065050400",6710,469,227,107,2363,51,3278,390,13595
"06065050500",7102,844,681,339,5039,837,5034,513,20389
"06065050600",5091,177,112,17,1069,280,953,299,7998
"06065050700",5742,114,1577,0,3633,119,2444,47,13676
"06065050900",2215,397,248,217,970,138,1171,218,5574
"06065051100",2151,480,1467,303,1738,185,2716,597,9637
"06065051200",2654,340,95,0,358,60,1005,239,4751
"06065051300",6264,625,151,78,1556,402,2847,613,12536
"06065051400",5878,354,12,0,212,27,193,0,6676
"06065940100",109,4,0,0,17,0,0,0,130
"06065940400",2058,822,10,0,2540,954,4509,1745,12638
"06065940500",1876,176,21,0,84,7,139,2,2305
"06065940600",2740,121,9,0,164,20,163,24,3241
"06065940700",2182,179,34,11,245,34,340,77,3102
"06065940800",2187,346,26,1,133,33,144,27,2897
"06065940900",1597,165,28,1,79,5,108,18,2001
"06065941000",2814,615,51,10,120,41,295,167,4113
"06065941100",1615,191,7,0,53,4,70,30,1970
"06065941200",1555,141,25,44,224,52,301,29,2371
"06065941300",2138,394,82,94,369,25,441,154,3697
"06065941400",1809,585,148,70,287,246,551,562,4258
"06065941500",2492,573,142,47,726,267,1092,297,5636
"06065980004",0,0,0,0,0,0,0,0,0
"06065981000",0,0,0,0,0,0,0,0,0
"06067000100",3134,194,0,0,427,59,358,38,4210
"06067000200",2971,64,76,7,381,0,469,9,3977
"06067000300",2360,182,38,0,480,56,262,8,3386
"06067000400",2752,535,20,0,447,135,862,252,5003
"06067000500",2024,768,209,129,493,187,768,262,4840
"06067000600",479,272,41,209,183,53,143,79,1459
"06067000700",130,38,50,25,194,113,24,0,574
"06067000800",891,129,24,0,332,0,133,12,1521
"06067001101",1019,548,76,95,188,105,127,151,2309
"06067001200",1916,386,117,152,458,156,374,79,3638
"06067001300",1696,361,39,77,576,161,337,98,3345
"06067001400",1664,319,84,18,399,78,447,16,3025
"06067001500",3677,182,25,0,387,26,414,1,4712
"06067001600",4196,513,109,0,699,49,361,78,6005
"06067001700",2944,789,39,340,689,527,483,347,6158
"06067001800",2178,653,733,126,892,634,793,340,6349
"06067001900",1782,263,240,45,332,158,495,84,3399
"06067002000",964,176,40,33,608,372,225,52,2470
"06067002100",827,303,32,18,682,398,335,340,2935
"06067002200",1773,438,167,676,570,332,386,401,4743
"06067002300",2580,58,18,0,469,104,212,34,3475
"06067002400",3294,230,20,8,745,129,503,36,4965
"06067002500",1438,33,71,5,182,0,164,5,1898
"06067002600",1660,436,100,53,254,89,256,329,3177
"06067002700",1279,399,297,765,683,294,583,270,4570
"06067002800",693,331,530,247,576,501,594,449,3921
"06067002900",3110,680,354,194,986,127,1282,211,6944
"06067003000",3760,313,228,14,986,477,1614,290,7682
"06067003101",1742,133,57,112,850,327,1152,303,4676
"06067003102",1444,463,196,25,790,211,1280,573,4982
"06067003202",1913,271,403,161,1452,668,1285,186,6339
"06067003203",353,188,423,89,1539,623,492,246,3953
"06067003204",1245,309,61,148,1579,1922,960,871,7095
"06067003300",2363,73,110,8,1119,212,558,24,4467
"06067003400",2172,249,451,239,1245,59,915,129,5459
"06067003501",1438,439,25,100,492,144,555,289,3482
"06067003502",1487,136,38,113,849,101,626,70,3420
"06067003600",1674,256,80,63,557,162,1170,208,4170
"06067003700",663,524,542,269,1346,675,975,811,5805
"06067003800",1841,932,1047,296,1352,196,1066,652,7382
"06067003900",1924,93,224,16,1212,34,745,13,4261
"06067004001",2379,119,397,237,1727,352,784,256,6251
"06067004004",3305,161,336,0,2247,89,881,15,7034
"06067004005",2092,195,642,119,1048,153,545,54,4848
"06067004006",2130,252,1040,79,1328,100,837,271,6037
"06067004008",1865,16,186,11,1123,267,381,22,3871
"06067004009",1902,87,950,1,1856,122,736,41,5695
"06067004010",2003,136,769,205,1645,106,714,72,5650
"06067004011",1182,32,409,58,1508,47,409,0,3645
"06067004012",1508,34,306,10,1588,53,461,11,3971
"06067004100",829,1112,371,205,1148,863,516,990,6034
"06067004201",1882,632,838,426,1227,465,1215,681,7366
"06067004202",1358,927,621,190,1835,421,1438,741,7531
"06067004203",571,1229,516,331,1610,673,713,1012,6655
"06067004300",2085,626,1813,392,3066,1586,1703,435,11706
"06067004401",1129,222,380,228,757,687,847,408,4658
"06067004402",1103,888,224,314,948,1095,1332,1346,7250
"06067004501",601,387,279,159,870,883,683,406,4268
"06067004502",1349,1248,362,300,834,729,971,1230,7023
"06067004601",2250,1294,191,570,1942,1153,2402,1100,10902
"06067004602",1650,858,489,165,1122,476,1330,977,7067
"06067004701",916,1004,155,322,399,828,565,1266,5455
"06067004702",1769,584,412,332,1691,665,2057,455,7965
"06067004801",1004,191,839,167,2076,1392,701,256,6626
"06067004802",1357,695,414,159,1019,1044,779,767,6234
"06067004903",1523,517,819,669,1646,1396,1274,226,8070
"06067004904",2866,539,519,141,1745,160,1488,528,7986
"06067004905",1817,1769,1429,398,1195,621,1821,1946,10996
"06067004906",542,175,873,269,891,222,367,179,3518
"06067005001",2914,495,749,475,2943,1200,2454,829,12059
"06067005002",1924,733,821,337,1414,748,997,507,7481
"06067005101",1648,504,316,488,973,596,1097,231,5853
"06067005102",2069,377,569,70,1537,281,1167,258,6328
"06067005201",492,397,99,83,376,184,425,208,2264
"06067005202",2189,594,184,51,481,193,605,187,4484
"06067005204",3428,59,182,44,659,219,800,161,5552
"06067005205",914,352,135,186,167,240,99,307,2400
"06067005301",91,296,128,204,50,196,58,286,1309
"06067005402",1317,516,169,81,405,191,404,167,3250
"06067005403",1716,93,25,16,120,156,81,20,2227
"06067005404",3590,444,145,0,602,288,445,208,5722
"06067005502",2742,275,237,345,1069,635,1807,512,7622
"06067005505",1681,590,459,255,929,707,782,630,6033
"06067005506",1100,423,306,317,813,183,692,429,4263
"06067005508",1747,445,175,191,514,82,291,99,3544
"06067005509",561,501,156,97,467,106,387,193,2468
"06067005510",2562,341,438,79,667,261,939,243,5530
"06067005601",2706,269,288,459,422,270,390,64,4868
"06067005605",1762,151,70,37,509,717,592,591,4429
"06067005606",2990,221,99,201,617,54,320,177,4679
"06067005701",1947,113,193,43,447,19,110,43,2915
"06067005702",4144,52,0,0,540,0,384,0,5120
"06067005801",4512,227,109,0,529,61,245,7,5690
"06067005803",2836,62,0,6,444,5,230,0,3583
"06067005804",2271,59,29,0,282,8,110,16,2775
"06067005901",4335,331,211,144,713,44,558,0,6336
"06067005903",1245,245,228,0,498,118,235,116,2685
"06067005904",2995,683,93,0,749,52,257,183,5012
"06067006002",2833,696,99,72,329,323,614,361,5327
"06067006003",2968,601,175,0,711,271,889,377,5992
"06067006004",1860,131,45,2,255,42,204,26,2565
"06067006101",2334,786,289,335,377,263,368,234,4986
"06067006102",1769,627,472,251,512,166,216,164,4177
"06067006201",2373,583,297,820,438,712,773,769,6765
"06067006202",1344,807,122,353,325,569,620,768,4908
"06067006300",1497,1288,242,394,1279,500,1060,768,7028
"06067006400",2309,965,150,158,752,810,903,883,6930
"06067006500",995,572,879,581,1912,911,1206,626,7682
"06067006600",2025,790,427,656,1515,557,1457,637,8064
"06067006701",2054,644,637,12,4417,1130,2990,533,12417
"06067006702",991,1031,805,499,2181,1160,1066,1136,8869
"06067006800",1926,1221,422,394,2469,1545,2341,1959,12277
"06067006900",2677,392,458,300,385,206,717,357,5492
"06067007001",1228,850,93,27,1364,1170,1479,1622,7833
"06067007004",1943,804,934,411,1874,676,1621,1115,9378
"06067007007",2686,691,349,89,1181,262,2339,540,8137
"06067007010",1705,310,318,123,895,213,695,173,4432
"06067007011",1897,526,965,294,1878,482,1900,589,8531
"06067007012",1328,371,557,197,804,85,798,322,4462
"06067007013",1283,230,384,26,579,53,803,203,3561
"06067007014",3126,801,918,323,1888,227,2616,737,10636
"06067007015",1734,456,611,131,1387,152,613,137,5221
"06067007016",2598,168,420,82,2100,252,1307,147,7074
"06067007017",1462,0,187,15,867,65,479,0,3075
"06067007018",1582,90,564,0,2330,120,561,24,5271
"06067007019",216,29,74,130,181,264,178,97,1169
"06067007020",2280,133,228,19,1514,343,972,39,5528
"06067007101",141,0,8,0,0,0,0,0,149
"06067007102",3333,175,958,93,2499,486,737,120,8401
"06067007103",1457,155,233,86,2386,167,1378,86,5948
"06067007104",4006,46,715,93,2467,396,1410,117,9250
"06067007105",2561,657,772,332,2597,342,1499,188,8948
"06067007106",3689,75,359,0,3559,266,1445,252,9645
"06067007107",1439,42,654,0,1284,148,596,12,4175
"06067007202",1914,294,107,0,1812,188,760,211,5286
"06067007204",2657,365,379,118,1138,228,1029,170,6084
"06067007206",3008,191,26,45,651,77,482,61,4541
"06067007207",3188,216,43,0,589,92,500,94,4722
"06067007208",2640,493,253,123,684,151,472,92,4908
"06067007209",2338,583,79,0,457,313,444,290,4504
"06067007301",2069,908,335,226,1411,535,1204,611,7299
"06067007402",3373,1111,550,17,949,353,937,756,8046
"06067007403",2144,461,342,381,1172,196,1028,211,5935
"06067007406",4755,711,398,207,1732,341,1161,287,9592
"06067007413",2976,888,441,127,785,640,685,575,7117
"06067007414",2034,629,264,137,938,225,500,217,4944
"06067007415",1891,146,194,42,363,396,627,269,3928
"06067007416",2925,259,99,76,360,186,461,95,4461
"06067007417",1960,187,324,6,649,117,328,97,3668
"06067007421",5758,349,542,33,2030,24,1227,0,9963
"06067007422",1526,425,119,28,417,109,337,162,3123
"06067007423",1404,733,401,607,1050,985,956,1194,7330
"06067007424",1676,530,350,395,548,203,434,229,4365
"06067007426",1220,142,76,125,378,281,162,95,2479
"06067007427",3398,984,561,155,2015,216,875,25,8229
"06067007428",2166,348,324,10,518,233,377,201,4177
"06067007429",2544,993,401,133,865,381,966,606,6889
"06067007430",4119,1255,535,79,1467,464,1018,484,9421
"06067007431",1572,57,169,0,1582,78,586,35,4079
"06067007432",3857,116,637,0,594,21,581,10,5816
"06067007433",3808,807,996,4,2690,130,808,28,9271
"06067007501",3019,720,183,195,1079,549,1107,456,7308
"06067007503",2797,1027,230,441,261,211,547,161,5675
"06067007504",1226,260,119,25,84,17,176,15,1922
"06067007601",4054,628,491,59,590,200,574,322,6918
"06067007602",2918,657,160,22,668,172,363,160,5120
"06067007701",3618,990,151,227,472,356,279,323,6416
"06067007702",3248,100,105,0,555,91,161,0,4260
"06067007801",3890,959,502,11,762,181,305,239,6849
"06067007802",3490,282,334,199,416,77,372,38,5208
"06067007903",3478,344,92,154,516,51,661,134,5430
"06067007904",4252,314,8,0,376,26,392,45,5413
"06067007905",3328,125,77,54,419,82,397,83,4565
"06067007906",2828,186,13,32,342,26,281,66,3774
"06067008005",3860,271,9,0,468,14,447,14,5083
"06067008006",4809,199,135,31,664,85,377,15,6315
"06067008007",2013,548,129,0,181,230,327,244,3672
"06067008008",3583,292,25,12,461,167,468,138,5146
"06067008009",3527,383,58,0,331,111,347,77,4834
"06067008010",3638,588,47,3,327,297,203,17,5120
"06067008111",4948,592,0,0,635,121,839,284,7419
"06067008113",2709,418,29,0,453,169,595,229,4602
"06067008117",1632,83,170,13,342,0,248,0,2488
"06067008119",3862,400,0,0,707,392,565,513,6439
"06067008120",3413,275,136,16,578,97,578,88,5181
"06067008122",2915,191,68,11,432,19,622,72,4330
"06067008124",3234,484,50,0,304,41,518,29,4660
"06067008125",3492,649,0,0,718,94,708,77,5738
"06067008127",3400,1414,10,8,522,158,901,468,6881
"06067008128",1957,124,32,0,162,28,297,10,2610
"06067008129",2164,617,62,5,380,162,198,447,4035
"06067008130",2299,381,178,123,445,256,225,300,4207
"06067008131",3236,734,175,16,392,131,404,185,5273
"06067008132",2874,142,71,0,495,44,231,10,3867
"06067008133",1413,536,81,12,254,110,233,49,2688
"06067008134",3281,479,150,273,709,33,496,252,5673
"06067008135",2980,129,104,0,644,444,664,215,5180
"06067008136",1714,131,100,0,193,42,70,40,2290
"06067008137",1615,385,0,25,329,21,247,5,2627
"06067008138",2321,428,71,0,588,146,809,381,4744
"06067008139",2553,363,222,31,346,83,500,249,4347
"06067008140",1709,269,64,27,279,30,232,32,2642
"06067008141",3729,1369,199,151,1319,422,1432,361,8982
"06067008142",2487,399,155,13,327,44,375,93,3893
"06067008143",2976,350,168,17,392,153,708,163,4927
"06067008144",2239,109,30,6,204,0,392,5,2985
"06067008145",6461,305,87,0,815,0,591,0,8259
"06067008203",3809,395,133,0,373,108,359,100,5277
"06067008204",3017,242,184,8,619,40,523,50,4683
"06067008206",4515,300,37,8,376,33,317,33,5619
"06067008207",3796,322,0,12,398,83,282,44,4937
"06067008208",3215,551,87,0,414,16,350,119,4752
"06067008209",3361,104,21,38,370,14,368,14,4290
"06067008210",4547,392,33,0,337,78,313,37,5737
"06067008211",2549,63,0,0,184,0,238,9,3043
"06067008402",4522,362,11,0,438,45,670,18,6066
"06067008403",3221,483,139,64,1268,36,319,95,5625
"06067008404",2224,167,0,0,252,85,477,66,3271
"06067008501",4598,126,66,0,1402,33,738,0,6963
"06067008504",3189,121,44,1,1118,2,189,2,4666
"06067008505",1570,49,14,0,483,0,157,0,2273
"06067008506",1345,175,8,10,595,54,96,20,2303
"06067008507",2136,219,19,0,1061,6,611,67,4119
"06067008508",4633,148,296,0,2259,15,1151,4,8506
"06067008509",3033,26,39,0,1680,2,652,2,5434
"06067008510",3716,20,63,0,560,4,362,0,4725
"06067008512",2755,60,0,0,1128,34,262,0,4239
"06067008513",1898,0,91,0,1172,0,401,0,3562
"06067008600",5261,164,376,5,842,115,504,0,7267
"06067008702",2440,35,0,0,556,11,162,0,3204
"06067008703",3345,140,284,0,1478,47,311,107,5712
"06067008704",1647,193,212,5,1314,105,362,193,4031
"06067008705",2498,180,419,0,1824,68,550,49,5588
"06067008801",2207,510,393,201,1487,146,731,136,5811
"06067008905",2656,397,298,18,966,216,700,272,5523
"06067008907",2616,662,296,164,766,592,688,449,6233
"06067008908",3471,559,340,31,386,31,781,293,5892
"06067008909",1134,412,108,153,278,133,365,176,2759
"06067008910",2278,183,120,0,438,191,454,106,3770
"06067008911",782,383,113,265,504,300,377,310,3034
"06067008912",2102,286,282,0,476,83,458,46,3733
"06067008913",2862,336,139,103,527,204,353,152,4676
"06067009004",2020,306,532,60,580,145,597,93,4333
"06067009005",1571,411,463,23,699,208,344,118,3837
"06067009006",2585,536,657,73,702,256,768,61,5638
"06067009007",1161,332,420,265,595,326,596,300,3995
"06067009008",1930,673,245,34,959,389,843,424,5497
"06067009010",1809,310,442,281,1307,376,594,157,5276
"06067009011",2340,11,134,48,1794,114,542,21,5004
"06067009103",1675,181,448,57,471,214,362,84,3492
"06067009105",1371,582,141,380,266,223,276,382,3621
"06067009106",2389,264,195,130,547,343,436,312,4616
"06067009107",1992,394,164,128,269,66,342,147,3502
"06067009108",2103,99,143,140,861,86,394,84,3910
"06067009109",2613,307,577,0,1063,171,633,62,5426
"06067009110",396,178,245,298,200,125,262,118,1822
"06067009111",2717,813,277,120,1456,185,1263,838,7669
"06067009112",2336,481,424,48,393,222,679,330,4913
"06067009201",1052,352,47,36,768,231,384,154,3024
"06067009307",3279,368,144,53,1033,102,563,191,5733
"06067009308",3610,271,262,7,1793,226,1208,137,7514
"06067009309",1839,143,34,0,269,6,246,41,2578
"06067009310",4796,315,185,0,1237,127,1187,121,7968
"06067009311",2718,333,389,69,2563,505,1179,433,8189
"06067009312",2614,183,596,314,1910,679,1061,72,7429
"06067009314",2111,187,341,492,2387,290,339,126,6273
"06067009316",979,84,396,122,2447,380,533,73,5014
"06067009317",2068,378,872,211,1911,378,895,335,7048
"06067009318",955,61,235,125,1073,251,646,46,3392
"06067009319",1071,391,631,86,2716,521,926,328,6670
"06067009320",1905,437,482,76,1760,485,1488,309,6942
"06067009321",2275,158,828,51,2086,590,1134,106,7228
"06067009322",3570,411,1049,427,7694,959,2720,444,17274
"06067009323",2355,102,234,116,2128,24,1113,15,6087
"06067009324",1866,73,103,0,643,8,339,0,3032
"06067009325",775,21,0,0,68,55,77,18,1014
"06067009326",2467,68,259,23,1949,78,576,0,5420
"06067009328",2236,227,379,3,2031,45,620,88,5629
"06067009329",723,127,499,75,817,146,711,87,3185
"06067009330",1903,121,321,0,1497,149,718,29,4738
"06067009331",2530,134,1518,94,2839,259,812,94,8280
"06067009332",580,35,19,0,461,50,156,9,1310
"06067009403",1417,103,0,0,326,257,354,257,2714
"06067009404",3330,492,27,2,873,247,676,82,5729
"06067009406",1723,150,68,0,243,21,273,24,2502
"06067009407",6260,493,186,0,2033,959,2966,1270,14167
"06067009408",1139,239,34,61,241,6,448,11,2179
"06067009501",1602,344,2,1,455,263,1158,537,4362
"06067009502",4772,557,53,385,1497,171,2020,261,9716
"06067009503",1592,455,0,2,522,252,803,507,4133
"06067009504",983,590,72,0,323,131,592,276,2967
"06067009601",1329,355,1502,435,2156,908,1276,411,8372
"06067009606",1549,456,1751,755,1885,1127,1445,765,9733
"06067009608",1228,299,1027,343,3015,637,807,173,7529
"06067009609",1006,134,1051,163,1948,465,923,48,5738
"06067009610",1104,462,944,693,2393,547,1041,600,7784
"06067009611",1256,317,381,102,1223,31,737,192,4239
"06067009612",2197,91,414,57,1867,396,1076,29,6127
"06067009614",1740,695,701,300,3283,408,799,79,8005
"06067009615",3841,185,721,437,2905,455,1769,242,10555
"06067009616",3154,118,359,82,1603,279,1214,269,7078
"06067009617",2265,155,353,0,521,118,415,81,3908
"06067009618",2034,241,546,15,2027,110,799,154,5926
"06067009619",3429,243,469,121,3412,0,1706,82,9462
"06067009622",3241,50,992,49,2681,87,988,0,8088
"06067009630",3211,608,988,112,4566,367,1477,285,11614
"06067009632",1697,223,595,258,3362,576,547,188,7446
"06067009633",919,369,673,280,800,300,772,378,4491
"06067009634",1141,378,694,196,1061,371,1043,331,5215
"06067009635",2008,32,1248,56,2822,139,1193,0,7498
"06067009636",2522,160,586,446,3573,387,1360,119,9153
"06067009637",1528,44,775,58,3650,234,626,0,6915
"06067009638",1375,114,164,17,1313,98,800,72,3953
"06067009639",943,179,355,152,1650,221,620,53,4173
"06067009800",1164,197,0,0,228,5,332,110,2036
"06067009900",2388,319,0,0,1186,299,1394,352,5938
"06067988300",31,0,10,0,0,0,10,0,51
"06069000100",4272,495,6,39,411,83,1888,306,7500
"06069000200",4307,775,0,0,795,3,2060,339,8279
"06069000300",2585,469,16,0,1100,37,3292,485,7984
"06069000400",4143,639,68,23,749,346,3655,942,10565
"06069000501",3756,63,46,0,662,9,1817,9,6362
"06069000502",5018,604,113,0,591,487,4254,890,11957
"06069000600",5867,521,52,153,1355,19,3570,524,12061
"06069000701",2318,1169,14,0,448,49,2268,1089,7355
"06069000702",4119,244,107,0,643,15,2482,175,7785
"06069000801",2946,190,72,17,318,16,838,30,4427
"06069000802",1906,141,8,0,388,33,776,102,3354
"06071000103",2171,247,143,61,1819,160,1198,101,5900
"06071000104",2833,207,262,0,2769,153,1583,123,7930
"06071000105",2421,282,184,26,3452,129,1421,1,7916
"06071000107",1980,65,115,63,725,82,976,41,4047
"06071000108",2890,12,366,0,1465,135,1242,51,6161
"06071000109",5011,444,41,0,1380,94,2181,271,9422
"06071000111",1913,54,65,0,901,22,686,21,3662
"06071000113",5943,1045,203,0,3487,452,4842,1218,17190
"06071000115",3254,0,531,0,3561,143,1968,71,9528
"06071000116",5134,152,268,0,5431,136,2385,0,13506
"06071000117",3608,82,292,25,2459,240,1584,0,8290
"06071000118",1996,18,69,0,2258,130,1090,18,5579
"06071000201",1437,169,289,76,1625,453,2273,395,6717
"06071000203",1765,413,44,0,1841,348,2385,674,7470
"06071000205",2249,340,235,188,1762,369,2572,384,8099
"06071000207",2200,381,0,18,1819,482,3355,466,8721
"06071000208",1671,20,94,10,2256,179,2911,158,7299
"06071000301",1923,1027,358,112,4281,1473,4718,2066,15958
"06071000303",2306,936,243,23,3204,777,4327,1429,13245
"06071000304",2326,410,180,119,2810,79,3346,476,9746
"06071000401",3971,246,75,0,1576,171,3623,313,9975
"06071000403",2916,186,103,4,947,195,2160,195,6706
"06071000404",2873,357,201,13,1248,308,2598,427,8025
"06071000501",3402,145,168,0,2703,420,3688,453,10979
"06071000503",3000,323,72,52,1266,216,2459,341,7729
"06071000504",2748,602,328,3,940,131,1870,435,7057
"06071000603",2536,441,69,43,2010,296,2479,438,8312
"06071000604",3518,372,97,14,1415,262,3436,288,9402
"06071000605",2179,526,14,0,1233,167,3033,596,7748
"06071000606",2802,234,63,0,1012,119,2455,228,6913
"06071000804",2483,57,0,2,631,31,559,31,3794
"06071000808",2857,407,161,109,1841,407,1751,398,7931
"06071000812",2912,106,62,2,628,22,1447,40,5219
"06071000813",2395,106,319,0,606,74,680,0,4180
"06071000814",2999,110,0,0,630,9,697,30,4475
"06071000815",2302,237,207,0,860,0,831,9,4446
"06071000816",3165,140,186,0,668,23,958,1,5141
"06071000817",2182,102,175,10,617,175,733,105,4099
"06071000818",3847,244,60,32,897,253,1228,197,6758
"06071000819",3369,137,193,0,1653,92,1134,0,6578
"06071000820",2795,213,49,22,572,9,867,82,4609
"06071000821",1366,125,529,27,1096,482,684,319,4628
"06071000823",2512,633,169,72,2465,1150,2944,918,10863
"06071000824",1810,615,151,27,1816,662,1950,948,7979
"06071000825",1582,369,450,44,1153,246,1954,388,6186
"06071000826",1971,96,486,102,1551,69,1791,95,6161
"06071000901",1870,302,114,23,1090,347,1555,392,5693
"06071000903",1715,340,247,71,1606,430,2567,501,7477
"06071000904",1722,200,15,99,785,520,1665,626,5632
"06071001001",2024,554,136,131,1369,454,2390,699,7757
"06071001002",3032,797,162,7,1795,306,3905,1023,11027
"06071001101",1663,412,46,127,1244,214,2235,499,6440
"06071001103",2349,492,259,17,849,81,1271,379,5697
"06071001104",3062,292,259,46,1402,506,3114,588,9269
"06071001200",3053,660,67,0,930,182,2248,734,7874
"06071001305",2257,813,95,2,1326,475,3059,1211,9238
"06071001307",2179,379,106,0,1111,177,2637,529,7118
"06071001308",2712,555,99,2,1159,1069,3533,1460,10589
"06071001309",2459,577,298,543,592,458,2599,898,8424
"06071001310",3213,495,69,12,1364,294,3454,658,9559
"06071001311",1718,206,344,1,1308,47,1049,210,4883
"06071001312",2582,271,282,74,1276,329,2410,415,7639
"06071001400",971,236,29,10,1232,285,1642,436,4841
"06071001501",1317,581,57,2,839,1079,1936,1634,7445
"06071001503",1417,674,0,0,573,620,1764,1121,6169
"06071001504",1902,1495,433,79,1082,534,2213,1866,9604
"06071001600",1763,1431,13,0,1388,1115,2855,2450,11015
"06071001702",2749,413,172,21,1075,367,2071,717,7585
"06071001703",3468,498,92,30,1915,275,2528,648,9454
"06071001704",2166,662,354,16,2089,158,3106,356,8907
"06071001706",2420,425,230,196,2633,252,4175,657,10988
"06071001707",2908,13,341,7,2243,430,3496,429,9867
"06071001803",1408,90,131,0,896,8,1494,34,4061
"06071001804",3546,74,213,28,1566,49,3162,107,8745
"06071001806",2392,45,599,405,1686,25,2260,278,7690
"06071001808",2127,47,573,45,1598,25,2841,72,7328
"06071001809",1875,512,456,10,1958,334,2931,686,8762
"06071001810",1983,339,231,0,2145,284,3496,539,9017
"06071001812",1429,679,22,0,1039,703,2293,1304,7469
"06071001813",1962,969,309,4,1250,232,3173,1039,8938
"06071001901",3504,198,460,2,1678,32,2700,103,8677
"06071001903",2941,82,304,38,3355,300,2057,222,9299
"06071001905",3850,69,466,17,1851,118,2727,1,9099
"06071001906",4947,350,544,47,1876,143,4309,288,12504
"06071002010",5417,279,1149,17,2426,145,3154,220,12807
"06071002011",3043,122,93,0,665,31,1126,4,5084
"06071002013",3516,374,179,7,368,128,967,242,5781
"06071002014",3638,212,82,0,850,0,1613,0,6395
"06071002015",3409,491,215,0,908,136,1948,262,7369
"06071002016",3293,232,131,0,821,51,1308,201,6037
"06071002017",3971,192,109,0,1059,27,1273,133,6764
"06071002018",3260,386,308,29,1184,172,1500,232,7071
"06071002019",2711,40,482,16,1549,15,1655,15,6483
"06071002021",3148,91,462,0,1608,0,1515,17,6841
"06071002022",7174,15,895,0,4009,122,3868,15,16098
"06071002023",2878,459,781,140,778,198,1391,264,6889
"06071002025",3778,197,306,2,878,14,1793,27,6995
"06071002027",3615,544,135,42,1127,295,2167,521,8446
"06071002028",3082,87,512,33,1013,85,1660,99,6571
"06071002029",3906,146,331,18,1375,170,1668,106,7720
"06071002031",3396,0,608,0,1709,142,1656,54,7565
"06071002033",5642,72,322,43,1787,181,3283,0,11330
"06071002034",8070,477,1564,0,4486,42,5039,9,19687
"06071002035",3748,43,862,30,1620,110,1531,27,7971
"06071002036",5769,647,1377,142,2978,92,3206,332,14543
"06071002037",3396,446,1245,152,3313,31,3876,140,12599
"06071002038",2336,129,1312,0,1809,11,2159,0,7756
"06071002101",2259,215,404,47,1459,55,2631,274,7344
"06071002103",2694,270,663,11,742,85,1469,185,6119
"06071002105",2879,633,564,13,784,219,2108,377,7577
"06071002107",2739,738,398,10,934,90,1793,534,7236
"06071002109",1316,300,1078,38,1637,163,1872,267,6671
"06071002110",3376,124,358,165,2731,640,2963,397,10754
"06071002204",2828,948,301,158,1997,223,3985,1060,11500
"06071002206",3845,145,474,109,2258,66,3713,69,10679
"06071002207",785,152,276,77,468,56,652,178,2644
"06071002301",4376,300,845,55,3849,346,6585,595,16951
"06071002304",9752,403,3724,98,4668,227,7542,358,26772
"06071002305",4736,652,966,82,3267,690,5690,1105,17188
"06071002306",1326,538,710,4,1356,162,2023,617,6736
"06071002307",2669,619,227,80,1368,302,3296,880,9441
"06071002401",5025,999,82,159,2633,847,7073,1490,18308
"06071002402",3540,857,267,91,2273,841,5336,1675,14880
"06071002501",3335,641,256,34,1419,683,4207,1283,11858
"06071002502",4509,598,124,4,2995,470,5947,1048,15695
"06071002601",5654,940,781,3,2963,589,6767,1236,18933
"06071002602",3310,702,572,12,2374,383,4551,1062,12966
"06071002604",2627,798,257,39,1478,78,2974,807,9058
"06071002606",3775,586,613,75,1859,214,4914,689,12725
"06071002607",4076,129,1336,101,2139,22,5103,90,12996
"06071002703",2713,85,1041,265,1448,27,2370,51,8000
"06071002704",4667,150,1056,90,3855,344,4327,443,14932
"06071002705",2690,118,1033,53,1603,47,3486,133,9163
"06071002706",2913,286,944,67,1581,279,3209,145,9424
"06071002801",2620,930,496,107,923,561,3148,1054,9839
"06071002803",1488,626,119,30,1243,297,2337,779,6919
"06071002804",1753,1592,312,142,1048,748,2617,2287,10499
"06071002901",1760,546,48,0,1224,448,2471,955,7452
"06071002902",3833,820,426,39,1175,466,4099,927,11785
"06071003000",1280,600,279,14,863,65,1719,556,5376
"06071003101",1994,767,217,107,1158,662,2919,1361,9185
"06071003102",2968,938,21,23,806,831,3296,1585,10468
"06071003200",4007,1471,235,140,2373,234,4856,1494,14810
"06071003301",2761,834,66,34,920,667,3286,1066,9634
"06071003302",3053,933,179,76,1566,540,3760,1134,11241
"06071003401",3651,706,99,86,2002,742,4253,1376,12915
"06071003403",2258,643,154,47,1225,277,2430,713,7747
"06071003404",1633,1223,407,24,1353,319,2555,1197,8711
"06071003405",1396,709,791,215,1004,370,1976,1021,7482
"06071003503",2201,559,989,39,1362,263,2863,691,8967
"06071003505",2858,1084,332,382,1109,386,3246,1477,10874
"06071003506",1863,476,683,313,1188,422,2409,908,8262
"06071003507",2559,359,310,199,1452,61,2195,374,7509
"06071003509",2392,760,222,19,743,548,2740,1301,8725
"06071003510",993,424,737,450,658,309,1487,768,5826
"06071003603",2497,351,398,80,1281,204,3117,463,8391
"06071003605",2025,349,102,101,2102,224,2932,332,8167
"06071003606",2610,505,101,0,1458,563,3529,959,9725
"06071003607",3483,401,224,221,822,54,3664,424,9293
"06071003609",3496,587,480,94,727,49,3620,553,9606
"06071003611",1644,628,378,174,1827,273,3088,836,8848
"06071003612",1724,362,386,56,1253,232,2398,470,6881
"06071003700",1329,853,346,113,922,379,1925,1001,6868
"06071003801",2250,169,1035,47,496,47,2505,176,6725
"06071003803",2209,558,184,452,809,498,2532,958,8200
"06071003804",2298,746,1115,217,716,26,2313,718,8149
"06071003900",3772,621,229,43,666,564,3735,1104,10734
"06071004001",2261,430,121,83,1711,375,3482,522,8985
"06071004003",3301,851,314,68,1035,745,3825,1602,11741
"06071004004",3472,575,309,143,1018,283,3514,755,10069
"06071004101",2357,905,203,137,1102,753,2835,1504,9796
"06071004103",1686,962,315,97,1724,933,3225,1788,10730
"06071004104",2547,585,252,29,1463,623,3547,976,10022
"06071004201",942,833,1616,1081,1739,533,2217,1199,10160
"06071004202",1741,822,829,372,1161,444,2524,1026,8919
"06071004301",1498,930,460,538,1516,731,2807,1526,10006
"06071004302",1932,543,275,131,954,219,2419,811,7284
"06071004401",1781,999,310,88,847,187,1867,1016,7095
"06071004403",2092,325,166,148,1656,924,3033,1217,9561
"06071004404",1703,906,727,288,1652,540,2829,1234,9879
"06071004503",2363,90,333,3,585,19,1153,11,4557
"06071004504",5119,307,967,32,1589,241,3523,262,12040
"06071004505",2359,473,426,177,806,210,1422,560,6433
"06071004507",2001,810,272,378,1137,579,1951,1232,8360
"06071004509",2615,279,419,90,1215,246,2062,447,7373
"06071004510",1748,219,703,144,589,305,1585,120,5413
"06071004601",2627,531,904,234,1757,171,2222,218,8664
"06071004603",2656,589,1010,183,1010,562,2022,801,8833
"06071004604",1809,1657,216,375,1228,352,2049,1595,9281
"06071004700",1624,681,145,56,1989,1099,3347,1715,10656
"06071004800",795,539,32,58,792,1167,1514,1647,6544
"06071004900",1634,1334,37,162,2231,1581,3510,2726,13215
"06071005100",5155,1610,534,272,1104,174,3571,1061,13481
"06071005200",1631,728,239,55,858,164,1329,534,5538
"06071005300",1799,867,615,388,1812,503,2826,1233,10043
"06071005400",1654,1532,613,578,1550,905,2508,2139,11479
"06071005500",1413,2629,880,522,1402,1750,2417,3703,14716
"06071005600",1269,1495,482,240,890,2023,1913,2976,11288
"06071005701",323,642,79,57,498,661,549,964,3773
"06071005800",535,800,319,499,705,480,1124,971,5433
"06071006100",3636,905,459,326,3368,887,3888,1537,15006
"06071006201",2236,414,250,12,401,152,1439,495,5399
"06071006203",1021,914,549,384,697,695,1117,996,6373
"06071006204",897,937,385,471,922,595,1274,1225,6706
"06071006301",2051,932,150,103,1124,1018,2377,1756,9511
"06071006302",3034,1712,644,637,1907,1313,3254,2596,15097
"06071006401",874,642,59,189,600,782,1327,1158,5631
"06071006402",1222,610,172,644,1584,661,2241,1089,8223
"06071006500",1553,891,279,472,1411,1401,2198,1678,9883
"06071006601",2354,423,59,30,1049,792,2912,1148,8767
"06071006603",2328,952,340,9,1559,300,3411,1158,10057
"06071006604",1906,490,312,159,1112,84,2685,517,7265
"06071006700",2002,723,20,27,1440,272,3165,910,8559
"06071007000",2311,1510,115,38,1749,644,3473,2086,11926
"06071007104",2877,91,312,5,974,34,1422,81,5796
"06071007105",1547,328,321,95,488,132,776,273,3960
"06071007106",2789,253,218,83,874,145,1794,232,6388
"06071007107",1257,715,114,310,545,287,1108,854,5190
"06071007108",826,264,478,68,473,134,1038,278,3559
"06071007109",2723,830,814,48,1706,360,2497,875,9853
"06071007110",2755,155,123,40,1965,175,2090,43,7346
"06071007200",2270,1271,87,35,2290,1065,2274,1721,11013
"06071007302",4308,526,482,108,3725,266,1164,74,10653
"06071007303",1681,417,555,246,923,644,867,214,5547
"06071007305",1111,801,508,176,1494,147,859,563,5659
"06071007306",1811,292,607,12,2555,189,1234,100,6800
"06071007403",3850,620,945,55,1736,78,2947,426,10657
"06071007404",2825,199,432,99,799,73,1228,139,5794
"06071007407",660,509,263,316,528,802,656,1073,4807
"06071007408",899,657,519,259,954,591,1149,1081,6109
"06071007409",3135,200,619,78,1757,532,2729,604,9654
"06071007410",2017,589,845,281,1356,187,1583,622,7480
"06071007601",1790,1608,462,365,1880,1020,2790,2018,11933
"06071007603",2020,536,518,316,1102,101,1899,504,6996
"06071007604",1316,208,332,17,1709,224,1618,255,5679
"06071007800",2145,682,564,56,1084,259,1103,367,6260
"06071007901",4809,254,601,68,2652,61,2279,132,10856
"06071007903",2943,123,674,27,806,41,1086,9,5709
"06071007904",4682,230,142,67,1120,355,1923,444,8963
"06071008001",3319,944,280,318,2075,188,3169,424,10717
"06071008002",2563,797,401,149,1725,1125,3322,1522,11604
"06071008100",1714,370,124,321,726,148,649,243,4295
"06071008200",4030,353,177,64,629,129,848,137,6367
"06071008301",4984,234,108,27,906,77,1629,0,7965
"06071008302",2362,143,148,0,318,9,463,32,3475
"06071008401",5736,518,427,0,1460,178,2659,280,11258
"06071008402",4722,295,172,3,677,0,871,93,6833
"06071008403",5018,176,26,15,640,81,926,68,6950
"06071008404",1418,396,182,41,416,107,669,290,3519
"06071008500",6171,448,212,0,1342,35,896,128,9232
"06071008601",4122,536,403,78,929,129,1758,246,8201
"06071008602",2558,193,188,6,441,79,863,180,4508
"06071008703",6656,101,111,0,544,32,1242,46,8732
"06071008704",5643,818,303,14,1409,324,1824,603,10938
"06071008705",2842,535,83,19,911,185,1392,429,6396
"06071008706",9129,603,138,0,2252,319,2646,355,15442
"06071008708",3115,415,11,4,520,10,616,111,4802
"06071008709",2975,901,0,127,196,146,796,327,5468
"06071008710",2347,618,0,0,733,530,975,925,6128
"06071008800",4133,1327,33,10,763,70,1763,805,8904
"06071008901",1603,480,60,44,151,21,233,26,2618
"06071009107",4592,864,65,0,10,13,871,409,6824
"06071009108",4418,817,0,11,718,181,1137,458,7740
"06071009109",4343,360,202,0,360,165,1202,133,6765
"06071009110",7683,802,2956,600,3177,1556,6576,1758,25108
"06071009112",4331,936,678,655,1305,497,3978,1045,13425
"06071009114",5331,363,1517,602,1568,780,4607,629,15397
"06071009116",1929,1723,398,1437,616,1017,1379,1632,10131
"06071009117",2219,1858,105,522,265,382,1031,1658,8040
"06071009118",13341,1934,2262,1736,2507,1111,11056,1619,35566
"06071009119",3767,731,31,61,554,223,1574,365,7306
"06071009201",3948,149,0,0,111,46,418,75,4747
"06071009202",1872,144,30,4,255,24,653,16,2998
"06071009300",829,95,0,119,151,58,394,58,1704
"06071009400",996,1014,355,468,199,389,737,759,4917
"06071009500",3562,957,382,532,961,525,2530,714,10163
"06071009707",4430,380,239,104,532,16,1071,114,6886
"06071009708",2839,907,54,0,380,104,695,304,5283
"06071009709",4028,827,333,1,615,159,1196,199,7358
"06071009710",4096,2076,346,490,511,224,1810,1091,10644
"06071009711",7621,597,478,0,785,180,2001,354,12016
"06071009712",2859,1774,733,193,357,473,1139,1391,8919
"06071009713",4913,876,405,174,366,89,2192,454,9469
"06071009714",2009,605,175,108,354,118,542,411,4322
"06071009715",6429,518,294,290,764,9,1342,9,9655
"06071009716",3073,1778,584,404,367,345,1131,1514,9196
"06071009717",3175,531,237,0,163,27,901,200,5234
"06071009800",1977,1321,295,163,494,291,1945,905,7391
"06071009904",4843,1857,1087,1195,1576,598,4360,1760,17276
"06071009905",2597,1096,423,785,1410,1201,2134,2065,11711
"06071009906",1946,720,638,34,1268,133,1689,715,7143
"06071009908",3104,375,434,312,609,152,1790,498,7274
"06071009910",2533,312,526,211,1124,39,2438,218,7401
"06071009911",3384,297,1478,369,821,233,2338,228,9148
"06071009912",2556,986,489,574,326,148,1397,593,7069
"06071009913",2426,1457,368,225,392,309,1724,1429,8330
"06071010004",6144,766,269,117,518,0,1546,148,9508
"06071010009",2035,181,263,0,495,64,1052,143,4233
"06071010010",3183,1102,147,389,1165,360,2550,1031,9927
"06071010011",1727,1446,158,262,1174,158,1650,1301,7876
"06071010012",3390,857,140,39,309,103,1564,467,6869
"06071010013",4320,1068,524,64,1548,432,3231,1057,12244
"06071010014",2345,1484,291,51,601,323,1964,1321,8380
"06071010015",3213,1035,274,82,558,325,1904,850,8241
"06071010016",2888,1135,306,109,847,374,2133,956,8748
"06071010017",9196,1185,1055,458,1829,663,5339,1229,20954
"06071010018",3925,1642,453,126,1146,395,2243,1618,11548
"06071010019",3314,1043,104,192,856,113,2103,691,8416
"06071010020",4181,919,736,223,706,410,1853,781,9809
"06071010021",4418,1798,27,0,487,109,1757,1348,9944
"06071010022",2776,602,181,40,349,117,825,391,5281
"06071010023",4315,445,77,36,612,249,2062,341,8137
"06071010024",3439,990,54,14,547,257,1000,541,6842
"06071010025",3521,426,471,870,1110,545,2469,683,10095
"06071010026",6053,892,656,631,1194,2188,2947,1117,15678
"06071010300",2149,591,0,146,549,12,1004,238,4689
"06071010402",3323,607,320,67,1162,87,1174,504,7244
"06071010409",2087,366,164,0,331,143,377,131,3599
"06071010410",2263,360,39,0,286,13,309,111,3381
"06071010411",4764,474,328,206,526,432,642,380,7752
"06071010412",4514,1423,138,0,779,214,909,138,8115
"06071010413",4233,1057,12,34,894,361,954,463,8008
"06071010415",2863,676,358,59,970,171,495,303,5895
"06071010416",2372,850,51,0,427,0,655,0,4355
"06071010417",2124,777,0,0,326,113,539,209,4088
"06071010419",3007,780,90,0,403,301,483,315,5379
"06071010420",3249,447,115,5,556,95,652,146,5265
"06071010421",3564,458,246,437,713,561,1347,315,7641
"06071010422",1096,151,0,0,88,0,124,39,1498
"06071010423",2295,1054,0,0,246,218,213,211,4237
"06071010424",1071,391,0,0,62,31,88,64,1707
"06071010700",2299,1036,99,21,444,253,413,512,5077
"06071010802",2955,950,22,2,452,45,395,144,4965
"06071010803",1895,464,64,0,210,92,139,0,2864
"06071010804",2087,519,39,0,198,200,551,271,3865
"06071010901",3796,88,14,0,526,206,709,206,5545
"06071010902",2311,178,0,0,359,0,538,21,3407
"06071011001",1410,376,0,0,190,218,444,275,2913
"06071011002",1137,140,88,0,179,84,322,167,2117
"06071011101",3234,386,0,12,110,75,442,25,4284
"06071011102",1428,197,11,11,466,35,524,1,2673
"06071011203",1071,109,0,0,131,0,211,0,1522
"06071011204",1119,258,21,60,102,0,49,0,1609
"06071011205",971,129,7,0,276,243,527,258,2411
"06071011206",388,124,0,0,80,5,110,15,722
"06071011300",1423,38,0,0,108,0,204,0,1773
"06071011401",2438,767,0,0,571,261,716,375,5128
"06071011403",2626,504,0,0,66,8,298,70,3572
"06071011404",2688,834,0,0,312,40,685,127,4686
"06071011500",1354,123,0,0,118,0,201,1,1797
"06071011600",5216,1137,547,22,380,74,990,470,8836
"06071011700",893,364,16,30,337,46,570,286,2542
"06071011800",3637,824,456,84,1225,425,1932,797,9380
"06071011900",2445,679,51,23,503,78,675,484,4938
"06071012001",3591,511,242,122,1565,184,2285,425,8925
"06071012002",2470,632,451,242,1274,302,1534,447,7352
"06071012101",3476,396,430,180,1098,54,1689,111,7434
"06071012103",2615,641,313,0,652,49,1001,30,5301
"06071012104",3140,1458,136,63,1009,90,1405,298,7599
"06071012200",632,25,45,37,910,112,386,27,2174
"06071012300",99,1069,60,505,46,587,76,643,3085
"06071012400",1589,279,120,5,918,375,1925,599,5810
"06071012500",2045,680,30,185,1110,516,3093,1108,8767
"06071012700",2857,0,131,52,801,429,1758,415,6443
"06071025000",4468,312,993,159,1332,232,1951,122,9569
"06071025100",376,154,8,0,406,138,141,41,1264
"06071940100",1012,144,0,0,107,50,132,0,1445
"06071980100",0,0,0,0,0,0,0,0,0
"06071980200",0,0,0,0,0,0,0,0,0
"06073000100",2575,99,0,0,32,0,261,3,2970
"06073000201",1790,74,14,0,189,0,260,0,2327
"06073000202",4096,130,32,0,271,0,390,60,4979
"06073000300",3266,428,18,65,458,202,374,225,5036
"06073000400",2113,464,46,0,632,120,344,14,3733
"06073000500",1927,181,101,0,404,73,326,27,3039
"06073000600",2264,252,56,19,261,34,457,32,3375
"06073000700",2906,481,116,0,345,29,608,24,4509
"06073000800",2345,463,366,149,344,42,546,202,4457
"06073000900",2956,684,317,0,817,118,931,186,6009
"06073001000",3514,525,217,44,706,141,963,217,6327
"06073001100",2154,498,200,16,381,48,833,195,4325
"06073001200",3128,544,351,236,1086,208,1757,425,7735
"06073001300",3211,707,629,212,1573,400,1693,447,8872
"06073001400",1939,308,136,22,424,30,505,134,3498
"06073001500",2661,350,122,186,460,34,1143,207,5163
"06073001600",2119,1308,523,328,1261,354,1644,1135,8672
"06073001700",2613,650,322,50,842,142,1405,626,6650
"06073001800",2999,849,906,66,1028,109,1556,396,7909
"06073001900",2260,309,38,28,357,60,355,131,3538
"06073002001",2948,52,98,7,136,44,289,11,3585
"06073002002",1953,256,112,90,172,53,288,49,2973
"06073002100",2437,535,259,140,697,396,1098,519,6081
"06073002201",2044,462,604,122,382,636,2062,814,7126
"06073002202",1747,1291,239,14,1174,575,2013,1398,8451
"06073002301",1146,263,357,295,540,363,797,333,4094
"06073002302",1716,920,270,729,1741,900,2165,1065,9506
"06073002401",2328,922,309,202,873,144,1799,770,7347
"06073002402",2811,727,191,102,899,307,2918,738,8693
"06073002501",2435,807,545,15,1254,499,2621,823,8999
"06073002502",3010,755,432,247,1386,231,2338,562,8961
"06073002601",1952,1383,96,271,1615,644,2076,1697,9734
"06073002602",1589,823,525,78,711,320,1526,775,6347
"06073002702",2314,612,720,268,718,178,881,528,6219
"06073002703",3630,168,874,381,1489,474,1790,92,8898
"06073002705",1158,47,402,223,2241,133,1217,65,5486
"06073002707",1595,823,444,428,1563,785,2052,1272,8962
"06073002708",1321,1395,658,683,1008,992,1500,1485,9042
"06073002709",1406,730,226,149,535,402,1254,878,5580
"06073002710",1107,468,557,310,1252,179,1429,422,5724
"06073002711",1184,64,379,120,1106,212,942,6,4013
"06073002712",1679,325,953,362,1340,305,1424,337,6725
"06073002801",837,809,21,16,111,259,75,171,2299
"06073002803",2566,506,946,16,895,366,719,351,6365
"06073002804",2264,783,130,27,506,257,465,231,4663
"06073002902",3608,810,536,55,1006,191,1876,133,8215
"06073002903",2638,516,247,88,533,177,1272,386,5857
"06073002904",2149,1816,0,125,523,459,461,454,5987
"06073002905",2093,317,431,432,761,276,973,220,5503
"06073003001",665,127,1129,113,1167,660,1354,748,5963
"06073003003",2064,771,1017,12,1249,131,2078,415,7737
"06073003004",1318,490,857,87,1843,820,2603,1193,9211
"06073003101",970,242,1430,222,1080,58,1671,111,5784
"06073003103",1528,300,1905,392,2218,431,2164,612,9550
"06073003105",1117,180,514,155,2037,253,2223,293,6772
"06073003107",1647,241,967,67,2774,596,1632,701,8625
"06073003108",2427,274,133,47,748,103,1733,291,5756
"06073003109",262,20,92,172,2677,212,204,44,3683
"06073003111",1466,779,1242,203,2168,1062,2131,1614,10665
"06073003112",1101,111,455,75,1968,527,1105,538,5880
"06073003113",701,142,620,172,2994,335,652,266,5882
"06073003114",235,56,482,55,2640,64,532,0,4064
"06073003115",1091,580,614,255,3793,529,1625,765,9252
"06073003201",1936,506,625,174,1988,328,1161,405,7123
"06073003202",2435,410,103,55,1462,356,2458,494,7773
"06073003204",2152,347,105,0,826,70,1659,303,5462
"06073003207",4152,568,947,0,961,384,2850,669,10531
"06073003208",1679,701,1044,34,2752,576,2070,726,9582
"06073003209",1284,270,813,342,2378,239,1406,310,7042
"06073003211",1674,177,110,78,1043,57,1471,117,4727
"06073003212",1280,649,530,6,1333,80,1213,358,5449
"06073003213",492,208,400,0,2899,18,888,197,5102
"06073003214",2089,127,774,278,1864,23,1632,18,6805
"06073003301",766,293,796,283,583,516,1166,815,5218
"06073003303",1368,386,322,233,1262,871,2404,1137,7983
"06073003304",1705,968,342,119,652,159,1720,923,6588
"06073003305",672,835,1051,680,1689,915,1510,1644,8996
"06073003401",2616,226,1752,251,1444,135,2144,62,8630
"06073003403",2002,620,463,66,679,322,2230,905,7287
"06073003404",2219,490,419,274,906,452,2531,649,7940
"06073003501",1138,609,205,202,1192,684,2235,1264,7529
"06073003502",1194,631,419,286,1529,914,2532,1449,8954
"06073003601",767,474,98,0,697,888,1373,1345,5642
"06073003602",716,666,250,94,1160,691,1741,1266,6584
"06073003603",954,563,255,8,1516,1100,2267,1519,8182
"06073003800",35,0,0,0,50,0,0,0,85
"06073003901",920,636,163,222,1103,1615,1995,2202,8856
"06073003902",1372,445,319,27,1624,1153,2785,1541,9266
"06073004000",1887,1564,263,181,626,159,2271,1636,8587
"06073004100",3549,1435,447,108,935,163,2621,1040,10298
"06073004200",4405,534,95,25,757,212,1052,375,7455
"06073004300",2960,155,99,3,455,42,1015,40,4769
"06073004400",2685,392,192,0,592,72,1257,176,5366
"06073004501",1874,441,95,0,241,118,1148,340,4257
"06073004600",1331,370,49,44,216,34,571,213,2828
"06073004700",879,583,80,47,183,156,815,574,3317
"06073004800",1515,1048,138,214,532,280,1807,1342,6876
"06073004900",1337,919,152,168,1099,1504,2186,2384,9749
"06073005000",765,221,16,0,533,537,1265,688,4025
"06073005100",2379,2118,501,521,602,728,658,1592,9099
"06073005200",2454,1323,259,245,377,230,808,506,6202
"06073005300",2227,585,292,131,440,137,195,252,4259
"06073005400",5025,515,205,122,1420,280,1158,162,8887
"06073005500",0,0,0,0,0,0,0,0,0
"06073005600",2522,240,235,0,508,11,394,55,3965
"06073005700",778,387,39,112,218,125,200,116,1975
"06073005800",2022,364,73,13,243,85,436,136,3372
"06073005900",1950,257,65,76,197,14,423,34,3016
"06073006000",2706,275,36,0,270,64,309,71,3731
"06073006100",1677,256,58,13,289,234,287,309,3123
"06073006200",0,0,0,0,0,0,0,0,0
"06073006300",48,0,0,0,0,0,0,0,48
"06073006500",1620,389,156,88,266,132,465,177,3293
"06073006600",1138,51,286,6,484,39,764,0,2768
"06073006801",1754,246,52,76,208,19,148,22,2525
"06073006802",4268,667,44,73,539,55,1498,339,7483
"06073006900",4735,318,171,1,392,67,434,30,6148
"06073007002",2761,115,0,0,208,0,336,44,3464
"06073007100",3907,339,36,0,276,52,453,15,5078
"06073007200",3543,153,23,0,174,51,52,3,3999
"06073007301",3659,403,41,50,202,0,372,14,4741
"06073007302",1832,139,0,0,64,0,53,0,2088
"06073007400",4846,762,102,0,502,81,735,107,7135
"06073007501",3195,386,65,0,195,0,311,13,4165
"06073007502",2158,205,107,116,218,18,338,35,3195
"06073007600",3212,1116,0,0,118,117,75,25,4663
"06073007701",3320,532,0,0,154,48,189,83,4326
"06073007702",2810,317,29,41,205,75,496,99,4072
"06073007800",4269,543,57,0,517,114,1326,82,6908
"06073007903",3838,715,52,0,167,83,298,28,5181
"06073007905",1462,623,20,0,63,0,98,46,2312
"06073007907",2163,509,18,1,123,47,303,113,3277
"06073007908",2118,361,0,0,137,84,223,33,2956
"06073007910",2510,333,0,0,100,38,129,19,3129
"06073008002",2061,136,13,0,125,9,139,9,2492
"06073008003",2547,224,156,0,283,9,302,26,3547
"06073008006",3073,328,27,0,185,83,216,90,4002
"06073008101",2931,362,13,0,270,48,135,34,3793
"06073008102",2820,97,14,0,210,16,294,25,3476
"06073008200",2242,149,9,13,216,29,97,38,2793
"06073008301",2336,175,0,0,99,21,78,12,2721
"06073008303",2983,189,35,0,87,0,99,2,3395
"06073008305",1002,204,14,27,541,418,298,127,2631
"06073008306",2574,206,0,62,447,133,166,0,3588
"06073008307",2754,140,20,0,715,120,306,23,4078
"06073008310",4197,491,2,0,638,0,397,254,5979
"06073008311",2625,17,0,3,172,0,161,3,2981
"06073008312",2977,115,18,0,493,49,170,31,3853
"06073008313",1758,59,0,0,365,0,73,7,2262
"06073008324",5813,139,323,0,591,24,443,14,7347
"06073008327",4763,192,0,0,953,0,677,17,6602
"06073008328",3615,197,0,0,970,204,260,72,5318
"06073008329",3562,749,32,0,1624,243,576,130,6916
"06073008330",3208,52,76,0,2008,58,483,0,5885
"06073008331",1835,12,5,15,709,0,157,6,2739
"06073008333",7594,371,123,0,5234,359,936,86,14703
"06073008335",6402,43,104,60,4508,51,935,0,12103
"06073008336",1593,0,22,0,563,9,251,0,2438
"06073008337",2750,84,170,0,1611,75,281,32,5003
"06073008339",738,232,6,0,624,336,252,91,2279
"06073008340",4207,851,363,77,2877,1070,799,108,10352
"06073008341",2755,1054,40,0,2060,1405,522,75,7911
"06073008343",1889,512,12,32,1329,1332,346,84,5536
"06073008344",2482,413,35,0,567,151,357,12,4017
"06073008345",2521,265,68,0,560,166,537,12,4129
"06073008346",2336,100,26,0,2805,41,669,38,6015
"06073008347",2436,121,123,35,3601,252,648,224,7440
"06073008348",2075,31,39,2,2869,214,986,0,6216
"06073008349",1203,271,77,0,1913,121,378,111,4074
"06073008350",1832,94,81,15,4203,220,429,14,6888
"06073008351",1513,195,82,146,2671,84,663,160,5514
"06073008352",1018,341,236,0,2444,85,260,276,4660
"06073008353",2327,264,46,0,2241,392,630,116,6016
"06073008354",2292,52,451,0,3247,172,648,0,6862
"06073008355",1053,63,140,58,2360,220,531,4,4429
"06073008356",1557,55,81,12,2100,175,297,19,4296
"06073008357",961,58,111,68,3277,282,396,0,5153
"06073008358",2553,337,229,17,3856,506,1089,0,8587
"06073008359",1638,186,109,58,1419,247,596,207,4460
"06073008360",1971,150,875,8,2678,335,944,53,7014
"06073008361",1260,519,0,28,380,650,41,341,3219
"06073008362",2103,501,45,20,678,233,172,169,3921
"06073008363",1908,670,150,0,1310,830,388,51,5307
"06073008364",2411,502,0,90,1215,896,498,81,5693
"06073008365",1665,22,28,0,1233,60,192,0,3200
"06073008366",3186,159,251,1,2520,77,360,35,6589
"06073008501",4338,660,4,4,497,42,494,103,6142
"06073008502",4821,505,68,0,782,103,1382,208,7869
"06073008503",4843,630,37,37,774,108,726,160,7315
"06073008504",3805,482,15,32,1079,26,934,132,6505
"06073008505",3812,225,229,0,1471,228,948,75,6988
"06073008506",2809,268,57,10,1147,127,1130,129,5677
"06073008507",4456,543,429,126,1835,504,1059,102,9054
"06073008509",4325,403,359,75,1292,330,1209,32,8025
"06073008510",4270,652,278,8,1301,375,850,195,7929
"06073008511",1489,191,145,0,800,296,287,152,3360
"06073008512",3198,279,125,0,712,50,458,39,4861
"06073008513",2333,135,0,0,416,77,434,7,3402
"06073008600",3042,960,271,150,1796,519,2329,986,10053
"06073008701",1930,65,275,63,870,255,729,29,4216
"06073008702",2248,233,119,97,1433,131,1023,165,5449
"06073008800",1555,921,218,279,2681,1359,1076,1186,9275
"06073008901",2855,988,224,16,565,177,1095,634,6554
"06073008902",1554,103,82,13,259,135,146,56,2348
"06073009000",1944,495,79,106,785,232,1302,491,5434
"06073009101",3807,308,51,10,1425,54,633,0,6288
"06073009102",2137,453,48,27,613,358,720,318,4674
"06073009103",2823,283,47,0,321,1,694,27,4196
"06073009104",2377,158,9,0,321,6,175,0,3046
"06073009106",1412,116,0,0,278,74,230,53,2163
"06073009107",2353,572,89,95,626,68,624,26,4453
"06073009201",2533,120,483,178,1581,246,871,198,6210
"06073009202",3126,132,208,0,934,156,351,63,4970
"06073009301",2720,227,317,18,1378,252,1137,118,6167
"06073009304",4936,560,749,16,1356,473,896,292,9278
"06073009305",2808,529,27,0,1231,71,1068,172,5906
"06073009306",3494,176,590,47,1444,464,1146,129,7490
"06073009400",1418,23,291,0,155,95,577,95,2654
"06073009502",2576,128,213,0,1125,73,414,16,4545
"06073009504",4541,120,96,0,1463,29,366,0,6615
"06073009505",4522,369,350,0,1284,49,548,69,7191
"06073009506",2875,170,166,0,813,91,470,40,4625
"06073009507",2860,91,84,0,684,20,706,2,4447
"06073009509",2464,195,219,0,840,38,549,0,4305
"06073009510",3739,248,345,0,560,46,831,46,5815
"06073009511",2611,194,350,284,807,145,799,0,5190
"06073009602",2745,204,143,11,569,20,625,12,4329
"06073009603",2856,309,166,226,1016,136,786,46,5541
"06073009604",1956,240,109,0,767,90,611,56,3829
"06073009703",2857,180,132,0,202,0,511,0,3882
"06073009704",4378,148,328,4,877,59,1088,0,6882
"06073009705",2471,194,120,23,360,38,403,90,3699
"06073009706",5534,328,84,8,749,127,1082,19,7931
"06073009801",3330,334,67,7,915,57,647,18,5375
"06073009802",3922,624,110,9,793,79,875,293,6705
"06073009804",3987,151,72,9,429,0,705,51,5404
"06073009805",4155,99,220,0,687,106,793,26,6086
"06073009901",32,0,0,0,0,0,0,0,32
"06073009902",0,0,0,0,0,0,0,0,0
"06073010001",2035,185,32,0,1528,44,1907,141,5872
"06073010003",3338,669,272,24,1359,122,3114,707,9605
"06073010004",3145,398,69,13,780,58,3080,332,7875
"06073010005",4540,1952,111,99,955,187,5052,2069,14965
"06073010009",4068,1286,86,0,951,380,4745,1580,13096
"06073010010",3425,1258,117,9,976,189,3184,1144,10302
"06073010011",2399,248,31,174,912,182,2338,208,6492
"06073010012",2693,1509,74,0,612,21,3056,1507,9472
"06073010013",3564,1545,0,7,397,199,3896,1618,11226
"06073010014",8422,144,617,530,4710,170,7834,271,22698
"06073010015",1374,558,231,0,547,74,1562,625,4971
"06073010103",4485,836,144,58,1078,152,4375,903,12031
"06073010104",2067,183,89,0,1048,19,1680,86,5172
"06073010106",3344,1328,54,0,548,224,3414,1451,10363
"06073010107",4058,537,507,75,1292,201,4109,581,11360
"06073010109",2402,657,318,7,1015,63,2601,676,7739
"06073010110",4335,1076,117,44,1635,177,3925,1195,12504
"06073010111",1986,618,60,1,331,6,2012,586,5600
"06073010112",3316,1148,257,74,385,143,3235,1256,9814
"06073010200",4218,938,101,188,904,188,1627,691,8855
"06073010300",3005,338,0,13,1233,55,1230,221,6095
"06073010401",1443,312,100,59,267,258,1004,496,3939
"06073010402",3074,850,183,190,1324,317,2494,834,9266
"06073010501",893,160,0,0,245,62,294,153,1807
"06073010502",3282,618,210,77,1163,331,2645,726,9052
"06073010601",2457,129,0,0,193,29,884,68,3760
"06073010800",2101,125,0,0,176,162,124,173,2861
"06073010900",1842,104,8,0,71,1,92,1,2119
"06073011000",2691,123,10,0,103,8,298,13,3246
"06073011100",3501,138,12,0,301,43,313,64,4372
"06073011300",80,15,0,0,13,0,0,0,108
"06073011601",2638,1335,75,64,1261,753,3598,1993,11717
"06073011602",1417,602,174,96,570,261,1578,824,5522
"06073011700",2381,1347,220,98,2025,838,2493,1760,11162
"06073011801",1943,483,55,11,754,358,2176,638,6418
"06073011802",2820,828,369,117,1666,907,3705,1596,12008
"06073011902",2772,459,119,72,1996,204,2904,581,9107
"06073012002",769,479,141,55,2130,343,721,534,5172
"06073012003",1269,341,82,22,1273,181,1511,392,5071
"06073012101",1721,264,10,0,422,94,1626,327,4464
"06073012102",1538,838,125,2,957,279,1808,1001,6548
"06073012200",1858,585,80,51,699,248,2091,737,6349
"06073012302",806,156,45,0,370,186,739,210,2512
"06073012303",2046,381,83,39,474,80,1618,358,5079
"06073012304",2570,190,48,16,514,0,1692,150,5180
"06073012401",1231,837,103,77,943,390,1450,941,5972
"06073012402",3027,728,367,124,726,231,2407,739,8349
"06073012501",1283,1122,105,179,490,92,1166,758,5195
"06073012502",2490,1071,166,7,615,252,2696,1257,8554
"06073012600",2808,1103,105,68,601,30,2666,1098,8479
"06073012700",2422,1053,171,97,738,288,2256,1220,8245
"06073012800",2857,300,50,8,889,122,2328,364,6918
"06073012900",2429,115,0,0,454,114,1597,133,4842
"06073013000",3522,702,221,0,1223,97,3429,659,9853
"06073013102",3925,927,238,16,754,194,4005,928,10987
"06073013103",1364,601,30,13,568,73,1557,613,4819
"06073013104",3619,1161,248,85,574,166,3167,1267,10287
"06073013203",3620,2165,185,71,828,196,3883,2211,13159
"06073013204",2584,635,61,0,557,189,2748,697,7471
"06073013205",1272,338,22,39,272,37,1331,318,3629
"06073013206",4135,1325,30,24,747,498,3609,1473,11841
"06073013301",3858,471,5,0,1196,17,3381,209,9137
"06073013302",3340,359,54,0,898,106,2871,343,7971
"06073013303",3739,266,67,0,1032,98,3771,313,9286
"06073013306",2659,161,139,126,971,72,2618,154,6900
"06073013307",2366,434,209,18,793,5,2328,337,6490
"06073013308",2968,308,68,0,764,100,3105,329,7642
"06073013309",5075,319,149,15,1802,156,3752,325,11593
"06073013310",12733,1176,1430,116,10968,270,10814,1140,38647
"06073013311",6302,362,395,2,2472,82,4380,334,14329
"06073013312",1967,218,152,147,509,54,1662,199,4908
"06073013313",4174,353,641,0,4620,212,2975,355,13330
"06073013314",9559,579,1023,0,4929,0,7812,532,24434
"06073013401",3336,320,23,0,692,94,2176,220,6861
"06073013409",3550,378,109,0,1601,71,2661,296,8666
"06073013410",4154,171,303,0,2552,258,3039,234,10711
"06073013411",3300,107,79,0,1623,55,1848,46,7058
"06073013412",3405,245,62,0,1185,65,2345,187,7494
"06073013414",5065,324,97,0,1931,256,3241,158,11072
"06073013415",1298,84,0,0,251,45,753,34,2465
"06073013416",2268,182,259,2,940,0,1211,75,4937
"06073013417",1568,45,27,0,472,6,850,46,3014
"06073013418",3640,435,374,68,1434,47,3278,341,9617
"06073013419",4549,317,721,0,2899,105,3931,299,12821
"06073013420",2172,182,487,0,1085,79,1883,154,6042
"06073013421",2930,78,316,0,1691,43,2095,83,7236
"06073013503",3961,456,486,128,426,217,900,83,6657
"06073013504",2289,380,394,8,487,0,960,43,4561
"06073013505",3055,352,606,14,581,41,1031,238,5918
"06073013506",2845,277,210,13,550,121,888,134,5038
"06073013601",3710,768,424,174,433,19,1034,562,7124
"06073013604",4493,273,581,142,841,16,1169,75,7590
"06073013605",4943,266,147,13,324,26,864,2,6585
"06073013606",4202,674,369,19,1745,0,1745,132,8886
"06073013701",1865,96,57,0,163,14,242,30,2467
"06073013702",3315,470,673,301,786,187,1507,415,7654
"06073013801",3304,215,310,48,777,65,1485,172,6376
"06073013802",1435,508,374,18,413,65,980,366,4159
"06073013903",2740,217,379,20,1039,111,1831,100,6437
"06073013905",2515,95,447,193,539,32,1246,84,5151
"06073013906",2623,236,719,143,720,139,1474,173,6227
"06073013907",2312,978,387,36,631,214,2432,958,7948
"06073013908",2462,306,435,160,561,110,1962,337,6333
"06073013909",2910,625,51,3,801,55,2550,457,7452
"06073014001",2490,333,261,66,1106,680,1404,566,6906
"06073014002",2789,188,383,32,1157,139,2100,146,6934
"06073014101",2208,85,519,0,501,319,1164,305,5101
"06073014102",783,357,1110,176,1047,134,907,329,4843
"06073014200",2725,476,492,46,1869,335,2126,587,8656
"06073014300",1828,248,336,15,880,429,1632,582,5950
"06073014400",1156,293,336,196,488,842,995,731,5037
"06073014500",1765,212,599,102,804,103,740,27,4352
"06073014601",2910,425,301,14,1060,287,1208,285,6490
"06073014602",3005,196,273,0,892,319,850,148,5683
"06073014700",5735,566,295,180,1118,224,1450,416,9984
"06073014803",2737,353,66,39,862,213,796,211,5277
"06073014804",2813,214,74,163,513,57,519,13,4366
"06073014805",2875,368,128,100,730,232,784,272,5489
"06073014806",1138,207,80,432,290,121,394,121,2783
"06073014901",3085,335,334,0,560,132,719,200,5365
"06073014902",2227,172,278,0,313,88,706,97,3881
"06073015000",4284,561,437,41,946,369,1270,172,8080
"06073015100",3556,201,542,27,835,67,913,48,6189
"06073015200",3173,120,31,0,188,19,464,7,4002
"06073015301",1512,1052,112,7,561,292,889,96,4521
"06073015302",2744,340,305,16,333,78,624,52,4492
"06073015403",1944,231,75,0,198,59,236,22,2765
"06073015404",4432,1549,359,62,508,530,1027,26,8493
"06073015405",5019,219,155,0,436,13,1169,42,7053
"06073015406",2015,43,103,0,330,37,278,3,2809
"06073015501",4131,400,24,0,313,64,728,21,5681
"06073015502",1971,98,12,0,472,89,602,49,3293
"06073015601",3378,1367,45,28,880,363,1586,430,8077
"06073015602",2099,160,0,0,263,0,390,19,2931
"06073015701",2728,1668,649,48,853,132,1684,863,8625
"06073015703",3128,1958,150,77,1037,629,1690,525,9194
"06073015704",2298,872,108,17,1215,251,1533,490,6784
"06073015801",1299,1269,275,197,675,165,1014,469,5363
"06073015802",2079,854,124,58,523,549,1086,619,5892
"06073015901",928,1131,193,298,671,649,1050,1016,5936
"06073015902",2085,1382,119,220,974,258,1239,222,6499
"06073016000",1902,157,25,0,353,0,535,127,3099
"06073016100",4250,326,87,26,1413,145,589,78,6914
"06073016201",4564,400,82,0,716,0,490,185,6437
"06073016202",1859,314,276,22,418,35,723,133,3780
"06073016301",2740,1266,263,288,450,122,1388,543,7060
"06073016302",2228,1063,239,52,1003,234,1178,573,6570
"06073016401",3902,356,16,40,452,21,954,135,5876
"06073016402",4755,1305,250,63,707,281,1350,851,9562
"06073016502",3672,1385,463,69,1035,720,1780,903,10027
"06073016503",1823,374,159,42,286,51,571,296,3602
"06073016504",3515,1049,551,82,651,412,1852,725,8837
"06073016605",6109,281,43,0,768,180,1306,22,8709
"06073016606",2873,225,0,0,530,32,650,161,4471
"06073016607",5042,467,45,0,401,48,679,212,6894
"06073016608",2431,29,5,2,258,0,275,0,3000
"06073016609",3995,325,49,95,570,42,601,41,5718
"06073016610",3427,210,37,0,442,12,424,26,4578
"06073016612",4856,336,67,0,558,182,762,251,7012
"06073016613",1414,42,8,11,341,14,253,27,2110
"06073016614",2870,246,36,79,795,15,600,0,4641
"06073016615",1870,137,13,0,231,16,375,17,2659
"06073016616",2730,426,196,29,729,0,852,19,4981
"06073016617",2113,236,48,0,536,0,543,13,3489
"06073016701",6784,1265,80,0,974,53,1372,177,10705
"06073016702",5851,317,4,0,590,0,1813,129,8704
"06073016802",6672,449,14,0,509,84,640,84,8452
"06073016804",5090,1579,0,0,440,198,954,883,9144
"06073016806",2696,689,95,3,591,98,834,194,5200
"06073016807",6152,604,0,18,457,84,1130,130,8575
"06073016809",3835,281,37,15,574,61,1097,126,6026
"06073016810",2299,284,15,32,299,56,374,23,3382
"06073016811",3098,100,19,9,124,13,491,2,3856
"06073016901",5131,245,674,0,776,38,668,0,7532
"06073016902",1550,187,32,0,577,121,297,31,2795
"06073017006",2184,24,100,0,335,70,84,31,2828
"06073017009",3312,201,67,0,647,46,871,123,5267
"06073017010",2223,117,56,0,397,0,295,43,3131
"06073017014",2133,137,0,0,100,50,197,9,2626
"06073017015",5454,370,190,29,1404,176,1095,0,8718
"06073017018",1812,155,211,12,1858,228,476,9,4761
"06073017019",5120,183,42,0,881,0,385,10,6621
"06073017020",3030,164,28,0,225,0,310,0,3757
"06073017021",2484,76,41,0,213,2,150,16,2982
"06073017022",3523,244,214,0,1167,11,438,0,5597
"06073017029",6692,335,24,0,1123,0,610,93,8877
"06073017030",9867,247,416,126,7294,141,946,188,19225
"06073017031",2572,213,60,0,905,107,651,81,4589
"06073017032",6305,228,309,1,6120,54,815,21,13853
"06073017033",2617,111,62,1,1858,215,503,51,5418
"06073017034",3125,173,276,0,1045,256,502,172,5549
"06073017035",1094,557,55,153,742,96,98,127,2922
"06073017036",1982,252,111,22,1198,147,244,198,4154
"06073017037",3329,154,256,14,1360,352,355,181,6001
"06073017039",4124,68,94,12,2999,88,924,0,8309
"06073017040",3102,121,70,0,1089,286,683,218,5569
"06073017041",5127,307,12,0,1058,19,982,32,7537
"06073017042",4391,164,128,0,3390,66,453,29,8621
"06073017043",2908,90,68,0,2523,97,517,16,6219
"06073017044",3086,42,125,23,2544,131,430,0,6381
"06073017045",1796,15,25,0,951,8,184,0,2979
"06073017046",2598,129,45,0,1040,60,214,15,4101
"06073017047",3102,63,36,0,646,0,602,0,4449
"06073017048",3954,102,199,0,2223,84,1870,48,8480
"06073017049",1846,438,51,0,659,28,360,204,3586
"06073017050",2147,74,0,0,649,24,647,21,3562
"06073017051",3070,96,206,60,1241,0,264,0,4937
"06073017052",2643,210,119,0,1838,109,848,86,5853
"06073017053",2569,135,91,1,543,2,186,4,3531
"06073017054",4478,175,0,18,926,73,696,0,6366
"06073017055",3468,41,27,0,1944,0,615,0,6095
"06073017056",2461,250,288,0,1065,47,200,64,4375
"06073017104",3230,288,22,2,448,9,370,53,4422
"06073017106",3503,466,0,0,437,50,270,0,4726
"06073017107",2112,294,20,0,314,0,141,35,2916
"06073017108",4106,36,45,0,626,29,711,29,5582
"06073017109",4928,866,0,0,812,305,154,55,7120
"06073017110",7545,1571,409,51,1238,84,1168,491,12557
"06073017200",4121,52,0,0,17,17,494,0,4701
"06073017303",2543,310,13,0,121,68,329,6,3390
"06073017304",4100,324,0,0,1231,244,1594,223,7716
"06073017305",2385,111,47,0,267,0,73,0,2883
"06073017306",2365,97,26,0,271,0,96,0,2855
"06073017401",4657,611,0,0,363,42,217,0,5890
"06073017403",4449,298,0,0,401,0,574,115,5837
"06073017404",5279,508,17,39,765,85,680,344,7717
"06073017501",2609,187,0,0,174,0,343,9,3322
"06073017502",2542,328,56,0,296,73,511,146,3952
"06073017601",4272,207,0,16,697,113,563,0,5868
"06073017603",1827,223,0,7,282,10,300,15,2664
"06073017604",5093,509,0,0,958,75,1000,32,7667
"06073017701",3856,959,85,0,452,0,618,673,6643
"06073017702",2325,327,0,0,109,71,237,30,3099
"06073017801",5169,437,73,0,797,1,1250,30,7757
"06073017808",4777,512,14,0,659,41,695,0,6698
"06073017809",1527,536,1,0,166,7,266,94,2597
"06073017810",4270,343,34,3,324,16,278,133,5401
"06073017811",5409,544,88,0,1052,50,387,120,7650
"06073017813",3188,366,10,0,567,0,410,25,4566
"06073017900",4402,1185,33,0,730,105,2134,380,8969
"06073018000",2432,376,145,0,194,9,181,9,3346
"06073018100",3950,598,66,12,880,324,951,287,7068
"06073018200",4433,1334,75,147,1227,246,3031,1196,11689
"06073018300",1723,272,0,0,184,24,374,27,2604
"06073018400",1672,264,38,89,875,351,1278,272,4839
"06073018504",4927,535,350,3,1167,452,1491,148,9073
"06073018507",4481,651,415,0,3533,579,3875,881,14415
"06073018509",2424,661,206,79,1532,405,2395,793,8495
"06073018510",1579,555,149,0,611,34,1089,248,4265
"06073018511",2561,442,12,122,1169,425,1567,582,6880
"06073018512",2392,279,126,36,526,65,955,65,4444
"06073018513",5723,411,425,119,1677,69,1709,90,10223
"06073018514",4694,678,483,59,1702,237,1325,290,9468
"06073018515",3549,190,77,0,628,96,793,113,5446
"06073018516",1963,335,98,0,1302,73,1267,154,5192
"06073018517",2278,456,437,1,1453,79,1526,161,6391
"06073018518",1227,206,53,17,1293,272,1578,365,5011
"06073018519",2598,448,222,26,1872,539,2613,907,9225
"06073018601",2900,328,60,17,1417,26,1564,90,6402
"06073018603",3190,445,347,165,1508,761,3006,997,10419
"06073018608",2401,91,103,0,592,100,776,41,4104
"06073018609",2685,433,414,90,1801,92,2730,337,8582
"06073018610",3243,706,221,68,2421,873,3317,1077,11926
"06073018611",3731,639,481,18,2492,119,1732,560,9772
"06073018612",2343,194,44,65,708,57,1346,238,4995
"06073018613",1682,166,577,40,1064,98,1077,1,4705
"06073018614",3540,555,373,11,1660,293,2035,506,8973
"06073018700",13727,1871,2184,144,5621,488,5022,789,29846
"06073018801",3147,375,49,11,280,13,606,60,4541
"06073018802",7075,723,53,0,563,96,1028,8,9546
"06073018803",3158,235,155,6,810,48,641,131,5184
"06073018903",3131,975,28,0,480,114,1318,548,6594
"06073018904",3642,534,393,0,1031,398,2031,700,8729
"06073018905",4143,693,114,26,947,516,2776,831,10046
"06073018906",3753,536,118,97,1002,105,2225,366,8202
"06073019001",4471,820,44,20,987,203,952,342,7839
"06073019002",987,196,0,0,330,0,565,117,2195
"06073019101",4520,426,22,26,1746,441,1924,236,9341
"06073019103",4427,661,0,0,635,0,900,196,6819
"06073019105",5408,284,76,53,765,0,567,2,7155
"06073019106",6534,316,3,0,1988,506,2156,393,11896
"06073019107",1559,129,0,35,256,83,232,68,2362
"06073019203",1821,235,39,0,453,8,550,13,3119
"06073019205",4199,337,272,0,877,131,2809,146,8771
"06073019206",3937,675,52,29,556,99,3264,601,9213
"06073019207",6553,1014,90,49,537,52,3060,591,11946
"06073019208",2947,121,5,0,240,20,479,46,3858
"06073019301",4635,312,286,1,1570,142,1416,17,8379
"06073019302",4855,495,207,40,1380,138,1893,124,9132
"06073019303",4745,673,284,0,1580,461,2840,524,11107
"06073019403",4588,627,132,13,892,44,2878,343,9517
"06073019404",2484,673,16,0,410,83,2520,551,6737
"06073019405",2461,747,127,25,538,46,1581,541,6066
"06073019406",3299,422,154,0,954,98,1845,230,7002
"06073019501",2399,503,57,37,472,102,2497,541,6608
"06073019502",3391,1051,88,12,560,112,3249,884,9347
"06073019503",2789,979,42,0,570,120,2222,600,7322
"06073019601",4336,1054,126,32,619,65,1372,703,8307
"06073019602",3674,911,116,15,393,215,1548,553,7425
"06073019701",3255,401,386,16,810,88,1150,65,6171
"06073019702",3348,773,99,13,802,54,1294,456,6839
"06073019803",3223,280,24,0,633,72,403,34,4669
"06073019804",3720,425,0,0,344,52,454,25,5020
"06073019805",2439,457,32,207,909,171,1348,313,5876
"06073019806",9098,1142,33,80,1685,37,1424,198,13697
"06073019808",3434,341,54,0,601,14,515,0,4959
"06073019809",3416,168,11,1,490,57,377,57,4577
"06073019902",2962,342,57,10,439,37,1599,96,5542
"06073019903",2917,465,35,0,508,139,941,127,5132
"06073019904",3972,907,443,54,752,154,981,259,7522
"06073019905",2942,540,71,0,419,144,454,223,4793
"06073020013",9939,1027,443,0,1608,76,1847,330,15270
"06073020014",5255,533,55,0,1251,141,495,128,7858
"06073020015",3251,288,42,0,323,0,211,44,4159
"06073020016",7276,1102,30,134,893,29,485,20,9969
"06073020017",2289,394,174,5,406,30,1178,70,4546
"06073020018",5196,1149,164,0,1442,210,4534,1005,13700
"06073020019",5429,784,36,37,862,87,1628,488,9351
"06073020020",3745,509,118,13,1660,632,897,285,7859
"06073020021",3827,918,62,19,1479,372,3198,929,10804
"06073020022",4939,679,259,153,1841,72,2062,198,10203
"06073020023",3423,341,41,0,408,13,1434,61,5721
"06073020024",2974,359,87,36,386,26,903,49,4820
"06073020025",3531,285,147,28,775,84,1192,94,6136
"06073020026",3103,175,0,0,933,15,772,8,5006
"06073020027",10190,1572,131,2,1550,131,2047,224,15847
"06073020028",2233,932,13,0,467,77,2113,880,6715
"06073020029",3299,471,169,0,496,309,2404,318,7466
"06073020103",7482,843,129,10,2101,29,3052,20,13666
"06073020105",2261,543,37,0,550,276,590,194,4451
"06073020106",3157,241,0,77,311,39,1804,110,5739
"06073020107",3051,648,21,0,423,39,1350,385,5917
"06073020108",4301,716,58,3,537,163,3722,634,10134
"06073020109",3475,1096,17,2,724,20,2256,810,8400
"06073020202",3132,1352,211,29,887,344,3096,1547,10598
"06073020206",3509,759,36,89,538,350,2898,887,9066
"06073020207",3220,738,149,28,705,39,2480,483,7842
"06073020208",1776,374,28,0,353,89,1205,398,4223
"06073020209",2914,1112,180,44,491,8,1597,634,6980
"06073020210",3130,534,29,0,1315,136,2562,345,8051
"06073020211",4634,1158,83,0,1252,87,3796,937,11947
"06073020213",2157,1570,0,1,502,112,2114,1513,7969
"06073020214",2097,1788,94,53,550,425,2047,1512,8566
"06073020304",3857,732,22,0,1261,24,718,49,6663
"06073020305",3791,1112,182,9,979,56,1180,545,7854
"06073020306",5013,1071,414,17,1084,221,1058,283,9161
"06073020307",5738,820,70,0,946,31,1970,195,9770
"06073020308",3692,752,87,149,507,194,1492,374,7247
"06073020309",3129,446,5,0,590,69,1750,176,6165
"06073020401",2204,126,19,2,63,4,180,2,2600
"06073020403",2653,255,1,0,900,51,1336,213,5409
"06073020404",3558,350,194,7,875,442,1106,408,6940
"06073020405",2552,336,6,3,346,92,64,28,3427
"06073020500",3570,1086,0,0,261,70,2154,523,7664
"06073020601",3101,1465,64,21,618,106,2972,932,9279
"06073020602",3738,907,122,31,849,265,2181,667,8760
"06073020705",3320,615,103,0,782,0,1189,430,6439
"06073020706",5181,357,64,79,620,20,722,28,7071
"06073020707",2380,806,116,0,501,62,1070,643,5578
"06073020708",2701,325,129,0,384,23,712,14,4288
"06073020709",5799,811,267,16,1397,21,1653,492,10456
"06073020710",1486,52,21,0,123,5,303,31,2021
"06073020801",4684,305,34,0,184,62,567,80,5916
"06073020805",2844,490,198,0,368,183,1055,522,5660
"06073020806",4335,694,61,0,859,162,1686,544,8341
"06073020807",1944,145,18,0,84,17,286,54,2548
"06073020809",6489,701,0,0,914,113,2442,386,11045
"06073020810",4690,186,0,0,159,10,403,72,5520
"06073020811",4759,350,160,0,511,0,628,129,6537
"06073020902",1498,86,9,0,53,54,81,30,1811
"06073020903",1369,225,0,3,496,197,355,57,2702
"06073020904",2281,258,0,10,130,6,237,0,2922
"06073021000",2038,505,0,2,451,47,718,223,3984
"06073021100",3690,1496,149,16,771,317,1287,458,8184
"06073021202",2015,519,14,0,285,145,155,72,3205
"06073021204",4435,184,97,0,354,26,678,0,5774
"06073021205",4765,632,41,62,1073,12,1481,124,8190
"06073021206",2281,188,41,16,143,28,333,45,3075
"06073021302",3443,847,132,16,181,27,761,704,6111
"06073021303",5780,407,299,0,2222,81,2427,223,11439
"06073021304",2253,83,47,9,172,0,771,32,3367
"06073021400",4375,389,273,11,1325,97,1562,125,8157
"06073021500",5898,83,49,8,2683,92,1060,0,9873
"06073021600",1938,203,80,0,269,0,393,32,2915
"06073021800",2215,155,0,0,31,66,90,72,2629
"06073021900",860,263,40,29,498,97,1010,288,3085
"06073022000",1708,623,60,0,1480,418,1799,609,6697
"06073022100",6227,641,41,1,1506,370,1427,321,10534
"06073990100",0,0,0,0,0,0,0,0,0
"06075010100",1798,176,26,32,1401,295,254,131,4113
"06075010200",3244,172,19,0,569,24,159,50,4237
"06075010300",2445,285,0,0,1619,380,292,52,5073
"06075010400",2868,213,0,1,1825,180,433,37,5557
"06075010500",1720,45,40,0,730,57,169,35,2796
"06075010600",1114,101,44,34,1564,750,280,61,3948
"06075010700",860,73,183,0,3228,1164,107,27,5642
"06075010800",2220,128,15,0,1875,687,239,25,5189
"06075010900",3021,200,35,12,1051,252,198,0,4769
"06075011000",2465,261,66,32,2379,418,491,21,6133
"06075011100",2318,207,326,18,1960,380,730,143,6082
"06075011200",1516,126,36,0,946,308,140,0,3072
"06075011300",491,43,25,32,1850,737,29,0,3207
"06075011700",386,163,36,125,597,100,85,39,1531
"06075011800",84,91,0,3,1062,568,75,9,1892
"06075011901",1110,142,115,0,705,166,198,39,2475
"06075011902",1328,243,10,31,817,294,425,58,3206
"06075012000",1844,243,178,61,807,552,184,89,3958
"06075012100",1752,326,32,19,1001,232,381,53,3796
"06075012201",1378,493,254,106,1634,649,854,138,5506
"06075012202",751,511,284,118,648,293,98,216,2919
"06075012301",370,264,103,113,518,436,183,139,2126
"06075012302",912,202,132,108,754,268,100,13,2489
"06075012401",1537,452,172,121,1423,487,1266,316,5774
"06075012402",1016,380,141,110,851,645,143,178,3464
"06075012501",756,399,35,357,1197,501,245,136,3626
"06075012502",419,371,107,361,1433,894,226,401,4212
"06075012601",1991,96,0,0,305,0,278,0,2670
"06075012602",2760,123,0,0,340,36,93,31,3383
"06075012700",2840,285,68,0,461,28,55,28,3765
"06075012800",3590,107,16,43,849,29,379,73,5086
"06075012901",1796,42,2,1,550,0,60,8,2459
"06075012902",2475,78,34,0,630,15,263,15,3510
"06075013000",3227,343,0,0,537,36,277,0,4420
"06075013101",2535,75,95,2,897,74,165,51,3894
"06075013102",2356,160,0,0,145,63,59,29,2812
"06075013200",3512,111,80,0,619,36,167,0,4525
"06075013300",3213,261,22,28,685,84,357,11,4661
"06075013400",2843,85,71,48,323,130,326,38,3864
"06075013500",1936,133,9,41,384,66,180,13,2762
"06075015100",1225,77,12,0,703,17,157,0,2191
"06075015200",2455,320,45,70,943,45,196,38,4112
"06075015300",1315,132,95,3,411,69,247,18,2290
"06075015400",3676,149,133,55,1747,171,402,0,6333
"06075015500",1782,262,150,158,1122,378,358,62,4272
"06075015600",1272,235,52,0,1067,116,53,38,2833
"06075015700",2703,287,408,41,1522,323,276,10,5570
"06075015801",1710,125,1173,135,538,125,267,58,4131
"06075015802",1725,236,200,75,514,73,236,88,3147
"06075015900",1328,281,616,60,1382,665,407,11,4750
"06075016000",1209,102,36,10,888,202,274,9,2730
"06075016100",903,411,1012,797,1016,743,463,0,5345
"06075016200",1506,131,41,62,455,196,242,71,2704
"06075016300",2130,283,829,460,797,175,706,32,5412
"06075016400",2531,324,312,103,446,132,378,132,4358
"06075016500",3480,494,196,33,705,244,495,110,5757
"06075016600",3659,559,218,11,941,243,278,90,5999
"06075016700",3627,363,68,0,653,125,390,22,5248
"06075016801",1927,314,494,14,704,144,347,82,4026
"06075016802",1721,173,283,310,495,98,245,17,3342
"06075016900",2417,96,68,11,435,52,268,23,3370
"06075017000",2723,274,165,7,429,43,201,56,3898
"06075017101",2788,112,91,34,393,35,199,20,3672
"06075017102",2772,282,81,11,516,63,345,86,4156
"06075017601",1392,532,470,539,3134,883,183,240,7373
"06075017700",735,150,22,3,541,83,402,108,2044
"06075017801",555,101,62,80,1341,891,52,13,3095
"06075017802",1780,491,144,157,1436,160,453,174,4795
"06075017902",707,273,250,308,373,488,311,250,2960
"06075018000",1435,226,184,123,644,230,331,193,3366
"06075020100",1951,823,127,236,1676,656,1484,1005,7958
"06075020200",3277,452,179,306,1530,250,1402,48,7444
"06075020300",2142,193,46,0,568,189,374,87,3599
"06075020401",2305,54,113,14,360,0,119,0,2965
"06075020402",3026,124,73,40,855,74,384,12,4588
"06075020500",1980,156,12,0,238,83,178,47,2694
"06075020600",3430,256,41,27,673,73,482,53,5035
"06075020700",4124,368,19,35,1095,90,585,92,6408
"06075020800",3376,1058,147,44,1821,227,2596,979,10248
"06075020900",2611,637,24,0,1475,210,1980,507,7444
"06075021000",3334,142,0,0,777,318,513,54,5138
"06075021100",2901,309,56,0,553,42,506,216,4583
"06075021200",2114,143,0,1,411,61,180,23,2933
"06075021300",2058,76,0,0,330,13,184,0,2661
"06075021400",2539,108,29,0,650,33,386,21,3766
"06075021500",3684,156,123,15,963,17,837,54,5849
"06075021600",2183,226,333,46,1318,43,532,0,4681
"06075021700",2159,78,270,209,956,90,248,29,4039
"06075021800",2867,257,35,25,899,50,561,12,4706
"06075022600",1086,34,134,7,468,14,119,0,1862
"06075022702",1719,40,58,2,436,24,264,1,2544
"06075022704",2266,122,28,0,766,9,198,19,3408
"06075022801",2827,427,113,102,1179,97,1286,214,6245
"06075022802",828,386,58,4,547,149,433,330,2735
"06075022803",2787,542,92,32,1495,115,2360,505,7928
"06075022901",2248,282,110,111,1398,154,2242,256,6801
"06075022902",1447,203,88,101,550,37,941,134,3501
"06075022903",2028,229,36,33,418,265,1035,300,4344
"06075023001",709,64,919,187,2275,996,458,112,5720
"06075023003",800,66,1120,176,1513,206,525,88,4494
"06075023102",520,110,1737,875,439,269,504,206,4660
"06075023103",84,196,1323,1151,664,526,200,238,4382
"06075023200",1176,163,1344,624,841,237,1122,161,5668
"06075023300",496,28,436,17,2171,329,736,36,4249
"06075023400",676,299,448,145,1708,440,1642,633,5991
"06075025100",2169,157,152,2,774,49,659,50,4012
"06075025200",3623,314,258,9,1214,343,1305,195,7261
"06075025300",2864,165,103,14,1011,212,1137,194,5700
"06075025401",1637,360,91,165,1342,107,901,357,4960
"06075025402",1753,82,73,0,1358,88,697,12,4063
"06075025403",2273,342,98,139,2215,295,2090,255,7707
"06075025500",3557,327,68,3,4380,400,3018,190,11943
"06075025600",1498,198,84,2,3815,189,962,60,6808
"06075025701",1100,246,193,45,2735,231,397,66,5013
"06075025702",1122,117,21,80,2811,159,846,14,5170
"06075025800",305,78,75,13,1044,440,318,213,2486
"06075025900",1136,60,377,16,2312,90,828,8,4827
"06075026001",1779,221,165,11,2609,623,1814,588,7810
"06075026002",919,110,88,0,2060,195,1146,177,4695
"06075026003",1936,371,42,0,2596,83,2349,368,7745
"06075026004",1528,135,42,44,2741,253,1647,177,6567
"06075026100",1710,307,73,15,4288,354,1569,365,8681
"06075026200",1480,356,105,24,5393,282,1448,444,9532
"06075026301",1002,72,22,47,2768,370,933,28,5242
"06075026302",1555,42,153,0,3062,246,1219,83,6360
"06075026303",1144,140,97,0,3548,490,1357,193,6969
"06075026401",363,20,423,107,2569,367,570,59,4478
"06075026402",612,13,524,50,2831,144,520,30,4724
"06075026403",475,153,92,16,2362,490,613,137,4338
"06075026404",227,2,437,193,1502,76,405,10,2852
"06075030101",2506,535,58,12,1312,158,252,0,4833
"06075030102",2676,208,67,1,1287,250,250,12,4751
"06075030201",2273,153,8,0,1669,126,218,1,4448
"06075030202",2289,372,96,15,1109,220,259,16,4376
"06075030301",2808,290,50,2,2211,136,224,69,5790
"06075030302",1748,224,17,8,1859,203,165,9,4233
"06075030400",2535,171,51,0,2291,467,183,0,5698
"06075030500",1326,137,86,81,747,69,242,16,2704
"06075030600",1363,73,13,0,807,1,228,0,2485
"06075030700",4017,135,26,13,2216,277,711,174,7569
"06075030800",2996,100,47,17,2244,59,361,28,5852
"06075030900",3103,16,207,16,2854,263,446,1,6906
"06075031000",1856,81,118,6,1285,157,553,14,4070
"06075031100",3255,220,509,0,2300,149,885,22,7340
"06075031201",1300,229,636,28,4730,677,879,320,8799
"06075031202",424,48,444,14,1585,422,373,8,3318
"06075031301",872,179,531,99,2110,286,459,19,4555
"06075031302",810,619,927,142,3361,449,586,606,7500
"06075031400",2116,423,534,214,3062,503,2030,378,9260
"06075032601",1452,268,21,0,2761,236,143,13,4894
"06075032602",1259,294,17,1,2230,370,53,9,4233
"06075032700",2345,159,0,0,4178,443,226,100,7451
"06075032801",1154,148,0,0,2247,255,209,0,4013
"06075032802",795,130,15,71,2592,392,146,27,4168
"06075032901",1602,130,8,24,3209,402,539,141,6055
"06075032902",936,69,51,0,2456,259,96,6,3873
"06075033000",3120,269,49,0,4058,610,556,142,8804
"06075033100",1524,97,0,0,2756,71,229,0,4677
"06075033201",542,328,74,57,362,341,83,162,1949
"06075033203",1519,329,76,32,1299,606,305,33,4199
"06075033204",1166,323,208,127,1013,751,365,214,4167
"06075035100",2478,195,39,31,4820,334,419,25,8341
"06075035201",1929,188,2,2,2809,214,301,2,5447
"06075035202",1901,230,42,0,2128,262,363,102,5028
"06075035300",1916,178,0,84,5182,535,394,98,8387
"06075035400",2081,351,38,32,3795,328,391,157,7173
"06075040100",2358,183,41,63,1364,335,198,62,4604
"06075040200",2229,220,79,60,2777,153,329,20,5867
"06075042601",1648,289,52,1,1915,241,435,4,4585
"06075042602",1717,227,52,0,1432,28,199,0,3655
"06075042700",2702,365,125,6,2030,352,490,200,6270
"06075042800",1753,89,10,0,544,63,220,0,2679
"06075045100",2065,195,61,57,1806,584,368,170,5306
"06075045200",2851,406,29,0,2987,863,385,65,7586
"06075047600",2232,205,22,1,2966,224,146,0,5796
"06075047701",1430,84,74,0,2150,273,146,0,4157
"06075047702",1480,132,36,1,2298,166,119,13,4245
"06075047801",1419,298,47,10,2041,130,298,71,4314
"06075047802",1287,145,0,0,2233,158,300,10,4133
"06075047901",2897,285,128,10,3004,96,677,68,7165
"06075047902",1656,213,9,18,1519,230,223,33,3901
"06075060100",2372,114,29,0,388,5,160,0,3068
"06075060400",1083,196,62,62,492,101,320,83,2399
"06075060502",298,150,249,608,1276,452,620,199,3852
"06075060700",3675,349,105,145,4151,526,780,74,9805
"06075061000",920,54,650,1,2497,55,611,37,4825
"06075061100",174,78,9,9,2490,1598,174,34,4566
"06075061200",556,150,895,193,1932,224,1271,280,5501
"06075061400",3447,119,176,249,923,574,778,62,6328
"06075061500",6436,668,146,37,4030,515,1494,274,13600
"06075980200",125,12,14,0,25,0,13,0,189
"06075980300",39,0,0,0,0,0,0,0,39
"06075980401",0,0,0,0,0,0,0,0,0
"06075980501",89,13,12,106,251,191,14,27,703
"06075980600",82,0,184,22,34,35,72,0,429
"06075980900",78,30,19,23,97,0,12,18,277
"06075990100",0,0,0,0,0,0,0,0,0
"06077000100",815,857,163,509,767,430,962,751,5254
"06077000300",704,500,90,57,300,290,698,553,3192
"06077000401",1708,233,254,75,395,218,679,158,3720
"06077000402",1318,596,176,540,384,500,820,844,5178
"06077000500",812,619,12,9,688,631,1119,1124,5014
"06077000600",648,311,12,46,494,509,875,737,3632
"06077000700",638,1016,88,214,2032,1151,1750,1977,8866
"06077000801",2214,622,738,324,2206,1207,3087,1507,11905
"06077000900",2702,928,208,160,1313,500,2110,724,8645
"06077001000",3099,420,141,49,698,254,1419,303,6383
"06077001101",3025,462,249,173,1539,326,2318,369,8461
"06077001102",2252,605,87,10,1042,328,1642,505,6471
"06077001200",2428,436,35,32,463,36,734,169,4333
"06077001300",2655,1148,197,251,886,449,1635,1032,8253
"06077001400",2381,192,70,17,1372,527,1655,236,6450
"06077001500",2463,2120,163,34,2449,844,2522,1924,12519
"06077001600",1079,628,6,5,412,127,1014,426,3697
"06077001700",1743,620,45,21,904,466,1909,906,6614
"06077001800",1660,334,30,0,918,633,2090,543,6208
"06077001900",1325,1127,342,216,1342,856,2099,1815,9122
"06077002000",1140,700,493,111,1173,411,1873,954,6855
"06077002100",2483,464,390,219,846,818,3015,932,9167
"06077002201",503,558,426,219,576,270,889,745,4186
"06077002202",1562,800,392,722,1387,913,2646,1556,9978
"06077002300",800,918,98,122,1728,1376,2065,2108,9215
"06077002401",779,549,144,202,1935,778,1467,1056,6910
"06077002402",612,208,83,130,768,323,958,609,3691
"06077002503",492,156,161,174,950,628,746,282,3589
"06077002504",905,510,448,39,1942,715,1507,860,6926
"06077002701",3041,1050,82,0,2098,610,3764,1041,11686
"06077002702",2590,622,113,0,933,284,2729,660,7931
"06077002800",1851,173,903,118,2660,397,3413,427,9942
"06077003106",2471,262,34,41,648,170,659,89,4374
"06077003108",2461,488,337,204,571,312,937,153,5463
"06077003109",3120,217,354,53,878,285,958,126,5991
"06077003110",1167,263,109,556,994,405,789,480,4763
"06077003111",1425,302,544,28,1032,226,880,206,4643
"06077003112",1650,238,250,163,941,384,778,444,4848
"06077003113",1928,212,413,552,1330,755,1392,239,6821
"06077003114",5599,284,619,0,3046,150,1918,85,11701
"06077003203",2184,203,48,20,1052,0,541,31,4079
"06077003205",2341,49,233,48,1026,76,940,28,4741
"06077003208",5466,554,1064,226,4817,474,2696,170,15467
"06077003209",1606,252,235,38,860,109,696,235,4031
"06077003210",1627,122,46,123,712,126,461,57,3274
"06077003213",1914,283,425,95,1323,633,1203,337,6213
"06077003214",1817,134,174,3,1131,104,1024,77,4464
"06077003215",1757,159,304,171,1106,63,884,132,4576
"06077003216",811,204,344,291,1109,88,742,130,3719
"06077003217",999,212,284,179,881,560,953,234,4302
"06077003305",2038,150,56,128,1351,82,1398,140,5343
"06077003306",1578,395,494,103,1939,289,1735,325,6858
"06077003307",1389,1122,240,288,1293,839,828,1320,7319
"06077003308",574,139,166,69,354,138,514,118,2072
"06077003310",1333,208,466,162,1592,596,1117,294,5768
"06077003311",1448,395,149,96,609,414,949,141,4201
"06077003312",538,494,108,168,554,869,814,1074,4619
"06077003313",740,263,343,255,555,534,727,401,3818
"06077003403",843,315,168,400,2631,448,936,332,6073
"06077003404",1392,620,497,151,2802,993,1753,520,8728
"06077003405",934,430,127,257,1458,749,814,469,5238
"06077003406",643,567,190,384,1188,1057,644,725,5398
"06077003407",680,333,155,250,929,456,838,298,3939
"06077003409",710,516,421,18,2132,792,1198,869,6656
"06077003410",1383,398,588,434,2043,738,1328,700,7612
"06077003500",7550,758,1583,402,8576,1800,4726,730,26125
"06077003601",2261,494,36,27,824,32,934,263,4871
"06077003602",1760,604,0,0,527,231,728,590,4440
"06077003700",1823,537,0,9,421,273,1012,612,4687
"06077003801",3166,750,2331,215,5757,692,4324,538,17773
"06077003802",2010,115,1020,131,2688,241,2239,263,8707
"06077003803",1701,712,234,193,991,543,1469,887,6730
"06077003900",757,430,19,0,333,165,621,461,2786
"06077004001",1407,371,7,0,276,117,796,364,3338
"06077004002",4843,386,1079,136,4039,1048,2470,241,14242
"06077004102",3738,588,825,0,2375,470,1816,487,10299
"06077004104",2648,156,21,0,311,0,173,45,3354
"06077004105",3600,454,12,0,397,30,1026,216,5735
"06077004106",1087,317,15,0,276,164,281,393,2533
"06077004201",5037,394,32,0,642,57,1331,213,7706
"06077004202",1394,49,0,0,120,0,164,0,1727
"06077004203",2122,803,42,0,599,69,1121,705,5461
"06077004204",2170,355,17,0,151,74,414,153,3334
"06077004302",4124,382,0,129,740,0,1533,0,6908
"06077004303",3896,565,0,0,633,60,778,302,6234
"06077004305",4321,316,20,0,805,41,998,268,6769
"06077004307",2188,290,238,0,595,149,545,158,4163
"06077004308",1416,752,9,0,1342,381,1195,748,5843
"06077004402",3250,679,65,0,840,494,1105,674,7107
"06077004403",1374,584,0,122,1556,699,1826,762,6923
"06077004404",2094,518,0,19,427,501,1488,714,5761
"06077004501",1934,608,0,0,369,104,634,483,4132
"06077004502",1187,1194,24,0,1101,812,1509,1878,7705
"06077004600",4825,807,116,0,862,13,1727,105,8455
"06077004701",2104,446,0,0,155,52,607,289,3653
"06077004703",2412,304,6,0,551,73,938,287,4571
"06077004704",3391,262,0,0,299,417,664,510,5543
"06077004800",3597,453,0,0,992,238,1662,298,7240
"06077004901",5971,826,45,0,317,121,1070,267,8617
"06077004902",5353,289,11,0,670,362,1742,376,8803
"06077005001",4279,647,54,1,403,20,923,425,6752
"06077005003",4725,202,34,12,603,1,1120,71,6768
"06077005004",4341,450,0,38,693,90,1297,125,7034
"06077005106",3558,232,260,0,1781,223,1741,261,8056
"06077005108",2968,291,76,1,764,139,2186,346,6771
"06077005109",2401,385,11,27,356,390,1207,528,5305
"06077005110",5318,692,73,157,1235,173,2415,655,10718
"06077005113",3977,316,368,0,927,169,1893,122,7772
"06077005114",4963,331,413,0,1972,318,2234,164,10395
"06077005119",2042,207,692,213,2584,146,1648,166,7698
"06077005122",2966,392,154,31,1059,148,1509,221,6480
"06077005123",2660,212,139,66,1393,215,1802,110,6597
"06077005124",2022,183,136,0,640,127,1130,77,4315
"06077005125",1250,65,46,0,210,35,572,42,2220
"06077005126",2332,529,264,0,838,388,1427,371,6149
"06077005127",2362,114,376,59,1958,179,1980,131,7159
"06077005129",1771,349,59,15,1020,62,2030,238,5544
"06077005130",1562,344,51,9,795,77,1094,188,4120
"06077005131",2865,229,0,0,629,266,1460,264,5713
"06077005132",2140,720,24,3,192,64,1015,622,4780
"06077005133",3184,240,24,0,920,18,1864,38,6288
"06077005134",2682,364,41,81,1416,0,1258,264,6106
"06077005135",4144,192,40,3,1267,208,1155,231,7240
"06077005202",4920,201,177,66,2038,85,1829,101,9417
"06077005206",8333,560,2183,39,7252,492,3851,357,23067
"06077005207",5474,235,1232,0,7457,310,3957,347,19012
"06077005208",3305,62,222,65,1788,69,1736,14,7261
"06077005209",3123,48,444,105,2643,275,2051,297,8986
"06077005210",6862,248,886,0,3173,301,3433,419,15322
"06077005302",3793,615,9,0,1984,158,3144,673,10376
"06077005303",2570,550,36,63,881,255,1898,525,6778
"06077005305",4544,464,194,17,1032,252,3048,453,10004
"06077005307",1368,180,127,5,1458,111,1032,144,4425
"06077005308",2149,332,196,7,1558,118,1170,314,5844
"06077005403",3178,188,425,76,1601,154,1766,232,7620
"06077005405",1545,321,242,0,1309,148,1713,351,5629
"06077005406",1706,348,116,2,608,317,893,573,4563
"06077005501",1445,162,0,0,90,4,213,39,1953
"06077005502",1221,50,7,9,514,0,331,17,2149
"06079010002",2560,84,30,0,195,19,489,0,3377
"06079010016",3571,387,0,0,825,536,1228,545,7092
"06079010101",1542,60,0,0,150,0,167,4,1923
"06079010102",3821,1054,112,1,1257,400,2581,1076,10302
"06079010201",5924,282,198,0,881,58,1321,109,8773
"06079010202",3894,591,197,0,799,200,1860,498,8039
"06079010204",3859,197,115,102,828,130,1367,240,6838
"06079010205",2712,248,377,0,714,356,1055,473,5935
"06079010300",7383,734,161,59,1289,87,1732,210,11655
"06079010403",3466,192,0,0,257,25,542,90,4572
"06079010404",1632,253,1,1,244,12,493,197,2833
"06079010503",4148,634,0,0,235,0,696,220,5933
"06079010504",2078,280,0,0,99,17,245,40,2759
"06079010602",3473,260,0,0,189,43,628,79,4672
"06079010603",734,449,0,0,75,42,128,396,1824
"06079010701",3609,330,21,5,639,67,572,71,5314
"06079010703",2404,250,0,7,547,120,547,100,3975
"06079010707",4585,429,22,0,721,58,490,54,6359
"06079010901",284,956,0,45,9,283,40,197,1814
"06079010902",1157,2344,36,25,219,145,315,264,4505
"06079011001",3573,716,311,0,607,102,416,91,5816
"06079011002",1433,1141,0,0,411,308,342,216,3851
"06079011101",1797,895,32,16,374,137,258,185,3694
"06079011102",3388,1027,40,185,352,300,636,342,6270
"06079011103",1767,257,17,37,209,135,461,78,2961
"06079011200",3567,2340,19,0,164,476,217,414,7197
"06079011300",5109,1378,79,68,945,377,988,398,9342
"06079011400",0,0,0,0,0,0,0,0,0
"06079011501",1231,198,0,3,233,76,440,55,2236
"06079011503",2739,438,90,30,304,11,322,35,3969
"06079011504",546,130,0,0,7,0,47,109,839
"06079011600",3702,257,10,0,142,14,43,14,4182
"06079011701",4206,197,83,0,207,86,196,39,5014
"06079011704",2472,225,26,0,152,49,92,8,3024
"06079011800",6117,402,166,0,775,1,730,13,8204
"06079011901",2420,447,0,0,323,0,140,68,3398
"06079011902",6151,487,140,20,1103,68,1547,127,9643
"06079012000",4571,1000,236,13,1416,22,2032,399,9689
"06079012102",4539,545,0,5,715,32,1264,87,7187
"06079012200",4382,904,0,0,1487,485,3124,817,11199
"06079012302",4059,409,0,0,533,0,875,134,6010
"06079012304",8445,609,50,46,937,36,1734,38,11895
"06079012401",4973,662,42,26,842,0,2327,373,9245
"06079012402",7196,898,148,0,1349,387,2309,573,12860
"06079012502",3832,417,54,30,392,124,535,210,5594
"06079012503",3697,638,0,0,509,402,775,434,6455
"06079012505",4476,289,21,0,268,39,630,121,5844
"06079012600",6980,510,32,44,266,123,929,255,9139
"06079012702",5852,625,0,17,389,10,509,234,7636
"06079012704",7137,458,95,0,625,104,690,100,9209
"06079012800",59,16,1,0,2,39,31,50,198
"06079012900",4322,498,0,0,554,112,777,327,6590
"06079013000",1788,118,0,0,443,5,782,86,3222
"06079990000",0,0,0,0,0,0,0,0,0
"06081600100",2525,127,12,0,2181,105,1020,76,6046
"06081600200",492,33,81,122,2874,756,1220,123,5701
"06081600300",1060,19,64,0,3089,94,875,76,5277
"06081600401",1207,0,189,126,1607,142,902,14,4187
"06081600402",1050,23,97,0,3101,577,1540,315,6703
"06081600500",1521,97,159,3,5693,421,1937,337,10168
"06081600600",1222,60,23,6,3556,126,1671,102,6766
"06081600700",2034,186,167,35,4816,304,2191,142,9875
"06081600800",1771,188,221,39,3755,859,1468,153,8454
"06081600900",1726,44,0,0,1938,224,402,28,4362
"06081601000",1600,45,254,8,4852,188,997,15,7959
"06081601100",1192,91,56,4,3895,266,289,22,5815
"06081601200",1650,132,45,18,3605,385,1346,97,7278
"06081601300",2404,330,146,15,4286,890,3101,430,11602
"06081601400",893,61,202,0,4589,420,608,25,6798
"06081601501",564,39,66,0,4038,161,201,12,5081
"06081601502",862,541,100,26,3894,557,1463,369,7812
"06081601601",977,78,47,14,1479,98,1056,104,3853
"06081601603",771,9,138,0,5091,120,587,84,6800
"06081601604",867,124,126,0,1512,0,355,11,2995
"06081601605",772,84,239,0,4736,265,577,34,6707
"06081601700",1601,136,36,17,2671,73,1421,28,5983
"06081601800",2835,251,204,14,2767,35,1809,11,7926
"06081601901",2222,121,62,0,1970,4,1473,45,5897
"06081601902",1634,102,169,0,3080,419,1413,241,7058
"06081602000",3071,431,49,0,4022,314,2167,547,10601
"06081602100",1313,138,80,0,1545,185,1841,313,5415
"06081602200",3879,291,155,20,3167,490,5315,215,13532
"06081602300",1663,238,25,0,1790,108,1801,276,5901
"06081602400",3385,162,185,21,3301,282,1701,117,9154
"06081602500",1167,55,210,0,3681,74,619,18,5824
"06081602600",1260,288,121,15,6215,242,923,427,9491
"06081602700",2138,84,364,49,2824,241,936,169,6805
"06081602800",1477,63,189,0,2636,96,833,18,5312
"06081602900",2374,124,89,0,1047,108,566,145,4453
"06081603000",3095,175,81,0,771,64,708,26,4920
"06081603100",2345,74,60,0,752,41,262,41,3575
"06081603200",3127,167,46,0,517,0,621,0,4478
"06081603300",5246,242,126,0,1463,50,1240,182,8549
"06081603400",3839,116,57,0,1336,101,982,49,6480
"06081603700",2288,56,93,0,3012,206,1038,50,6743
"06081603801",1184,97,0,0,730,54,295,63,2423
"06081603802",2941,242,167,0,1504,16,1042,15,5927
"06081603900",3439,76,129,15,1704,60,1588,15,7026
"06081604000",1865,142,42,0,894,64,533,64,3604
"06081604101",3137,597,372,70,3895,135,3402,555,12163
"06081604102",1104,44,130,26,1245,174,550,0,3273
"06081604200",1812,207,29,0,1660,70,1636,206,5620
"06081604400",1711,231,19,1,2445,124,1012,85,5628
"06081604500",1862,127,69,0,1177,121,293,66,3715
"06081604600",1213,46,0,0,1111,10,238,0,2618
"06081604700",1350,27,5,0,1400,49,313,0,3144
"06081604800",2461,88,123,2,2482,183,843,12,6194
"06081604900",1377,109,14,0,1507,116,81,25,3229
"06081605000",4309,252,61,26,2848,226,317,49,8088
"06081605100",2190,0,19,0,779,21,517,0,3526
"06081605200",2634,275,36,0,910,40,283,22,4200
"06081605300",3172,260,46,6,1014,44,594,26,5162
"06081605400",3735,441,14,0,1505,332,815,590,7432
"06081605500",3410,123,6,0,1140,103,694,55,5531
"06081605600",3522,56,42,9,1802,46,223,0,5700
"06081605700",3482,61,0,0,1822,164,224,17,5770
"06081605800",1917,59,32,0,642,39,149,24,2862
"06081605900",3810,837,147,10,1145,210,1745,410,8314
"06081606000",2864,100,284,0,1663,109,1609,51,6680
"06081606100",1747,326,42,20,1559,307,1242,321,5564
"06081606200",4032,434,403,0,3532,192,5057,498,14148
"06081606300",1971,218,75,0,1483,95,1008,54,4904
"06081606400",3114,291,15,29,1301,104,512,13,5379
"06081606500",2804,61,19,0,743,1,157,0,3785
"06081606600",2250,156,26,2,1006,79,757,125,4401
"06081606700",1648,49,0,0,673,37,172,0,2579
"06081606800",2178,36,8,2,1027,93,86,15,3445
"06081606900",1455,91,0,1,626,93,76,0,2342
"06081607000",1973,62,23,0,1172,66,433,20,3749
"06081607100",1877,64,44,0,755,33,307,0,3080
"06081607200",2428,212,3,10,1374,120,846,102,5095
"06081607300",2644,30,0,5,781,5,432,0,3897
"06081607400",2605,110,72,11,1405,161,611,45,5020
"06081607500",2296,71,112,30,1274,61,700,38,4582
"06081607600",2111,84,137,19,806,126,843,27,4153
"06081607701",1901,234,46,60,1807,360,1189,195,5792
"06081607702",1286,250,31,11,1216,6,862,94,3756
"06081607800",1724,36,58,0,1166,37,577,35,3633
"06081607900",1680,37,53,32,1287,83,223,30,3425
"06081608001",1412,15,25,0,1778,188,258,22,3698
"06081608002",1657,21,29,0,1773,14,332,0,3826
"06081608004",2884,195,339,0,2798,145,370,0,6731
"06081608013",2157,34,50,0,1656,413,112,2,4424
"06081608023",1029,51,11,0,1489,31,62,0,2673
"06081608100",1755,49,97,41,1889,12,407,4,4254
"06081608200",1597,32,19,0,1901,50,177,16,3792
"06081608300",1323,99,33,13,1979,41,311,0,3799
"06081608400",2889,98,40,0,2099,27,1025,14,6192
"06081608501",3496,315,79,0,1280,107,1379,87,6743
"06081608502",1646,42,52,0,859,16,819,0,3434
"06081608600",2309,289,115,32,1539,340,802,272,5698
"06081608700",4430,142,42,0,1635,53,635,0,6937
"06081608800",4404,39,37,0,1501,17,544,1,6543
"06081608900",4132,84,209,14,1793,332,735,43,7342
"06081609000",1511,62,78,0,889,7,258,8,2813
"06081609100",972,93,9,0,762,76,504,90,2506
"06081609201",2925,53,0,33,508,5,206,13,3743
"06081609202",2519,209,55,18,778,273,357,273,4482
"06081609300",2802,54,45,0,377,16,265,0,3559
"06081609400",3086,140,10,9,320,0,266,16,3847
"06081609500",3925,8,0,0,861,0,397,0,5191
"06081609601",1840,151,85,0,636,52,171,31,2966
"06081609602",1154,23,4,0,381,17,101,0,1680
"06081609603",4000,163,21,25,927,0,404,5,5545
"06081609700",3880,93,36,3,517,6,267,0,4802
"06081609800",3743,160,9,14,642,29,695,26,5318
"06081609900",2583,61,19,0,384,4,370,11,3432
"06081610000",3707,64,67,0,842,47,1465,20,6212
"06081610100",1798,59,4,13,561,16,1266,62,3779
"06081610201",2926,1018,296,0,1317,85,3346,980,9968
"06081610202",709,129,26,13,269,61,439,104,1750
"06081610203",1560,604,67,30,787,189,1995,735,5967
"06081610302",1309,97,77,0,269,102,660,122,2636
"06081610303",4211,69,98,0,2895,67,363,30,7733
"06081610304",1945,122,28,9,1571,91,382,76,4224
"06081610400",3727,410,100,320,1291,164,3523,459,9994
"06081610500",2858,931,52,19,1167,337,3132,1124,9620
"06081610601",2728,1311,120,4,1182,711,3167,1853,11076
"06081610602",2430,367,25,0,527,63,1227,240,4879
"06081610700",4072,309,70,142,848,131,2346,151,8069
"06081610800",2794,482,44,0,979,223,2483,604,7609
"06081610900",5664,939,74,16,1408,174,3891,868,13034
"06081611000",4202,202,223,0,912,9,1670,41,7259
"06081611100",4410,92,34,0,1326,118,786,102,6868
"06081611200",2499,76,0,0,371,27,706,32,3711
"06081611300",3934,81,16,2,882,14,1136,0,6065
"06081611400",3488,119,0,0,341,13,98,24,4083
"06081611500",1984,78,0,0,548,26,111,0,2747
"06081611600",1710,60,58,17,370,23,126,0,2364
"06081611700",2938,159,986,95,1158,297,3529,301,9463
"06081611800",1467,411,1055,98,1337,99,2043,450,6960
"06081611900",4479,871,1247,254,2699,430,4269,1054,15303
"06081612000",3290,651,674,295,2024,396,4417,767,12514
"06081612100",3757,1184,573,196,1478,377,3060,1331,11956
"06081612500",3473,245,4,18,650,6,177,17,4590
"06081612600",3004,159,57,0,721,97,141,1,4180
"06081612700",1820,27,0,0,159,0,54,0,2060
"06081612800",2578,142,0,4,365,0,104,108,3301
"06081612900",3302,80,80,2,868,96,240,2,4670
"06081613000",2640,162,0,22,581,13,133,0,3551
"06081613200",5965,131,0,0,588,41,129,19,6873
"06081613300",2032,124,17,0,260,0,51,0,2484
"06081613400",2980,107,0,0,276,42,197,73,3675
"06081613501",3296,255,145,31,498,57,1529,223,6034
"06081613502",5004,311,0,0,576,18,830,69,6808
"06081613600",4992,122,0,0,706,146,820,127,6913
"06081613700",6406,455,39,19,1423,164,2383,471,11360
"06081613800",3156,409,8,0,149,100,422,379,4623
"06081613900",3953,293,128,12,1583,92,654,93,6808
"06081614000",1910,110,432,0,2959,254,648,195,6508
"06081984300",0,0,0,0,0,0,0,0,0
"06081990100",0,0,0,0,0,0,0,0,0
"06083000101",3728,447,256,37,980,152,1283,323,7206
"06083000102",3888,313,0,2,1050,67,1335,118,6773
"06083000103",2605,153,13,0,210,30,298,15,3324
"06083000200",2871,152,0,0,535,182,692,269,4701
"06083000301",1641,345,19,10,431,426,552,634,4058
"06083000302",2556,556,75,12,798,81,1146,370,5594
"06083000400",3742,260,136,0,252,54,365,41,4850
"06083000501",2800,165,52,0,190,10,273,28,3518
"06083000502",4298,412,79,19,665,99,864,0,6436
"06083000600",3700,167,34,0,619,19,822,6,5367
"06083000700",3322,384,84,0,787,419,1137,356,6489
"06083000801",1738,422,17,0,1930,539,2984,795,8425
"06083000804",3997,701,141,70,2213,439,4614,894,13069
"06083000900",1564,556,33,40,816,183,1274,290,4756
"06083001000",3656,847,194,40,753,201,2092,699,8482
"06083001101",2753,908,28,0,783,166,1863,810,7311
"06083001102",2217,693,45,0,1760,584,3071,854,9224
"06083001203",2084,231,0,0,621,81,550,48,3615
"06083001206",2789,325,0,1,1639,252,2929,358,8293
"06083001208",3090,350,95,24,343,73,534,130,4639
"06083001304",5430,268,72,50,1244,120,1485,155,8824
"06083001306",2594,102,103,9,552,0,578,0,3938
"06083001402",2922,145,38,2,116,3,46,3,3275
"06083001500",2939,300,0,6,136,0,171,0,3552
"06083001601",3616,128,0,0,1176,77,1913,74,6984
"06083001604",3758,457,0,0,651,132,1717,298,7013
"06083001704",2220,166,24,0,819,16,1850,86,5181
"06083001706",3196,165,78,6,799,78,922,34,5278
"06083001800",790,91,0,0,70,80,392,117,1540
"06083001901",5252,309,84,24,1252,416,2015,464,9816
"06083001903",4702,253,0,0,499,173,922,131,6680
"06083001905",2319,189,4,65,148,33,414,46,3218
"06083001906",5150,212,29,18,682,129,900,126,7246
"06083002005",4001,255,167,17,576,37,802,8,5863
"06083002006",1783,141,0,0,287,27,566,66,2870
"06083002007",7812,491,261,36,1717,6,3320,175,13818
"06083002008",5029,335,217,3,951,34,1922,125,8616
"06083002009",3009,265,0,0,474,15,702,39,4504
"06083002010",3851,129,94,0,567,92,855,87,5675
"06083002011",3425,267,56,16,1172,79,2482,196,7693
"06083002012",2648,334,11,0,149,1,292,12,3447
"06083002013",2289,175,0,0,192,46,276,10,2988
"06083002101",2062,495,33,12,770,393,1966,827,6558
"06083002102",1726,101,5,2,548,92,1404,123,4001
"06083002103",2035,633,54,0,794,426,1755,681,6378
"06083002205",2413,610,0,11,1575,474,2489,906,8478
"06083002206",2598,640,13,58,763,285,2347,768,7472
"06083002209",2047,329,21,18,763,205,2154,452,5989
"06083002210",2863,341,98,34,1672,666,2545,701,8920
"06083002211",3534,397,31,0,1408,47,2205,379,8001
"06083002303",3593,642,0,5,1351,330,4252,900,11073
"06083002304",3181,995,0,0,1573,681,4137,1612,12179
"06083002305",4509,1228,215,0,874,431,4783,1604,13644
"06083002306",5200,346,102,0,2051,222,4725,316,12962
"06083002402",6010,2732,66,8,2550,738,5949,3059,21112
"06083002403",2790,1757,110,34,1410,718,3941,2342,13102
"06083002404",4261,1822,19,83,1313,999,5052,2679,16228
"06083002502",4491,963,9,53,1294,455,5106,1212,13583
"06083002604",70,0,14,0,21,0,0,0,105
"06083002606",2093,120,326,14,452,275,455,262,3997
"06083002702",3144,2054,197,80,1572,620,3384,2238,13289
"06083002703",1912,649,208,0,714,403,1288,471,5645
"06083002705",1903,391,209,33,958,500,1473,635,6102
"06083002706",2420,1486,143,312,1361,677,2783,1876,11058
"06083002707",1480,369,94,5,384,28,720,312,3392
"06083002708",1866,205,0,0,262,97,761,73,3264
"06083002802",4671,387,225,0,1546,715,2104,924,10572
"06083002806",1630,124,45,14,263,0,636,87,2799
"06083002808",5292,221,181,0,822,189,1025,170,7900
"06083002809",3164,250,361,12,984,75,1133,195,6174
"06083002906",3220,198,73,0,376,14,383,31,4295
"06083002907",3084,48,0,10,762,39,784,20,4747
"06083002909",4142,253,0,0,1123,39,2039,87,7683
"06083002913",2751,127,17,0,661,24,461,10,4051
"06083002914",2205,63,0,0,637,18,442,1,3366
"06083002915",133,14,0,0,260,49,123,9,588
"06083002922",1275,333,131,6,815,142,517,71,3290
"06083002924",1241,2561,1,81,222,975,354,576,6011
"06083002926",1620,2073,40,120,596,1140,636,1027,7252
"06083002928",1139,2685,10,25,393,741,375,432,5800
"06083002930",4074,369,26,9,2498,326,2582,206,10090
"06083002932",1380,239,23,9,563,119,568,112,3013
"06083003001",3001,197,36,1,1937,195,3042,211,8620
"06083003004",3881,91,17,0,820,14,1477,13,6313
"06083003005",2931,239,119,5,1695,170,1794,81,7034
"06083003007",3166,129,0,0,328,117,320,8,4068
"06083003102",2351,79,76,0,748,116,1020,68,4458
"06083980000",8,0,0,0,0,0,0,0,8
"06083980100",0,0,0,0,0,0,0,0,0
"06083990000",0,0,0,0,0,0,0,0,0
"06085500100",2140,396,168,9,3312,878,3355,915,11173
"06085500200",2320,381,22,93,1682,377,1251,260,6386
"06085500300",1667,385,98,35,883,95,1002,136,4301
"06085500400",1484,96,39,0,500,389,592,346,3446
"06085500500",3020,369,44,0,1546,92,1058,111,6240
"06085500600",2847,218,107,29,1402,324,1503,273,6703
"06085500800",1152,135,230,18,901,153,797,101,3487
"06085500901",1108,499,177,189,1146,395,426,414,4354
"06085500902",171,215,32,76,580,478,227,229,2008
"06085501000",1612,437,53,81,1844,523,2069,597,7216
"06085501101",1307,516,92,79,1912,209,1259,476,5850
"06085501102",2295,264,113,19,1564,102,2499,221,7077
"06085501200",1473,589,152,42,1491,426,1700,751,6624
"06085501300",1823,476,125,74,627,643,689,324,4781
"06085501401",1505,366,52,6,728,611,1620,851,5739
"06085501402",1118,273,8,8,1338,201,1736,407,5089
"06085501501",1430,576,71,0,1695,599,1795,1007,7173
"06085501502",1436,527,162,31,1676,418,2223,804,7277
"06085501600",1849,950,368,417,1724,840,1666,1035,8849
"06085501700",1688,758,43,0,1816,584,2827,1168,8884
"06085501800",2058,178,12,0,2341,376,2549,417,7931
"06085501900",1875,312,742,119,2345,352,1269,521,7535
"06085502001",2785,375,108,1,1841,388,2234,489,8221
"06085502002",1399,679,49,29,2063,774,2505,1242,8740
"06085502101",2904,325,19,0,1435,152,927,154,5916
"06085502102",2935,686,315,93,2152,1022,2498,1393,11094
"06085502201",2462,453,430,21,2729,780,2143,631,9649
"06085502202",1852,137,70,0,951,116,567,136,3829
"06085502301",2593,81,112,2,265,86,430,30,3599
"06085502302",2219,158,8,0,607,137,1063,81,4273
"06085502400",5215,165,381,5,1140,158,1560,30,8654
"06085502500",4685,73,175,11,1318,41,1242,68,7613
"06085502601",2096,162,0,0,525,12,344,44,3183
"06085502603",1884,30,30,0,531,26,417,12,2930
"06085502604",2611,466,314,0,762,12,478,98,4741
"06085502701",2950,393,170,4,1000,55,744,153,5469
"06085502702",4589,526,190,39,2116,68,1078,39,8645
"06085502800",3159,142,0,0,865,41,574,0,4781
"06085502901",4197,241,0,2,1724,57,1290,160,7671
"06085502902",4887,493,58,7,1840,2,1289,119,8695
"06085502903",3741,183,257,2,701,39,724,63,5710
"06085502906",2822,226,306,0,795,159,712,49,5069
"06085502907",2748,115,71,0,826,101,701,44,4606
"06085502908",4382,510,165,0,1715,43,556,390,7761
"06085502909",3500,333,46,0,1163,303,1417,362,7124
"06085502910",2585,94,67,0,979,27,1063,27,4842
"06085503001",3249,161,25,0,676,41,392,97,4641
"06085503002",2484,152,26,0,775,24,862,23,4346
"06085503003",3894,174,47,0,1427,35,1237,11,6825
"06085503105",326,33,13,0,1186,750,292,209,2809
"06085503108",2803,801,210,68,4066,92,1922,781,10743
"06085503110",1022,530,27,29,2065,1049,1638,795,7155
"06085503111",1301,225,77,154,2732,426,1477,496,6888
"06085503112",1140,367,61,66,1763,299,1444,459,5599
"06085503113",1630,560,55,36,1610,966,2531,1519,8907
"06085503115",3307,108,99,0,2353,147,1352,17,7383
"06085503116",2103,201,388,0,2387,84,958,90,6211
"06085503117",483,144,0,0,1715,879,1323,518,5062
"06085503118",2100,52,154,16,2540,671,2796,438,8767
"06085503121",1972,361,133,190,1277,580,1957,359,6829
"06085503122",485,242,28,53,1845,262,788,46,3749
"06085503123",1312,431,215,82,1684,309,1824,313,6170
"06085503204",2457,381,168,253,3955,546,3530,497,11787
"06085503207",849,84,46,0,2724,410,732,98,4943
"06085503208",1805,368,69,2,1770,110,1968,363,6455
"06085503210",1513,97,32,17,1951,465,1561,361,5997
"06085503211",1562,361,146,7,2595,256,1418,335,6680
"06085503212",1196,143,69,0,2640,306,1324,93,5771
"06085503213",654,493,0,0,2669,194,664,437,5111
"06085503214",1665,773,74,24,3537,1723,2257,1278,11331
"06085503217",1063,330,87,0,1904,627,1522,430,5963
"06085503218",2346,511,109,0,1319,397,2950,835,8467
"06085503304",1459,637,148,55,3178,764,1902,880,9023
"06085503305",1351,369,75,0,3633,797,2047,525,8797
"06085503306",1556,71,61,4,2036,174,2090,61,6053
"06085503312",1719,49,354,0,1493,8,1351,22,4996
"06085503313",1331,15,118,0,2687,232,764,0,5147
"06085503315",2011,254,410,18,4606,740,2766,559,11364
"06085503321",406,153,0,0,3943,123,270,151,5046
"06085503322",1428,31,194,93,1904,303,1206,197,5356
"06085503323",1038,82,82,0,3184,312,1237,147,6082
"06085503324",638,37,96,0,2538,156,489,33,3987
"06085503325",1054,57,100,3,3266,194,1153,92,5919
"06085503326",1039,65,203,0,5151,330,689,219,7696
"06085503327",1469,135,158,138,2899,143,1288,263,6493
"06085503329",661,14,62,0,2406,101,436,51,3731
"06085503330",1203,3,0,3,6381,102,609,26,8327
"06085503331",1811,166,144,8,1267,105,815,10,4326
"06085503332",3841,146,10,0,1497,44,430,0,5968
"06085503333",1629,439,80,0,2208,40,686,295,5377
"06085503334",2931,43,121,0,5837,148,857,25,9962
"06085503336",725,44,6,26,2512,201,1174,86,4774
"06085503337",819,36,36,0,2638,309,784,70,4692
"06085503401",1703,237,162,0,1907,463,2820,660,7952
"06085503402",1166,625,55,30,2497,889,2347,1048,8657
"06085503504",3179,328,15,0,1922,489,4082,598,10613
"06085503506",2138,277,95,5,2831,586,3374,617,9923
"06085503507",1181,201,36,17,943,74,1668,240,4360
"06085503508",2797,322,123,6,2632,967,4062,973,11882
"06085503509",1051,190,32,0,2597,548,1779,606,6803
"06085503510",2166,325,107,148,2114,933,2765,1104,9662
"06085503511",585,169,0,0,2507,336,993,402,4992
"06085503601",1069,370,35,0,896,584,1004,605,4563
"06085503602",1923,645,159,30,1630,534,2489,767,8177
"06085503703",1261,396,220,0,1266,536,2009,714,6402
"06085503707",942,508,134,31,3080,520,1329,788,7332
"06085503708",215,254,137,17,1532,282,290,141,2868
"06085503709",860,348,30,11,2771,1682,1398,876,7976
"06085503710",609,188,22,0,1603,822,1250,753,5247
"06085503711",1847,512,140,4,1758,737,2789,1105,8892
"06085503712",1056,122,160,50,1827,463,1497,299,5474
"06085503713",1169,90,0,0,1339,650,1565,334,5147
"06085503802",3280,198,205,10,4458,281,3717,175,12324
"06085503803",1036,67,22,64,3315,195,673,48,5420
"06085503804",1669,132,155,92,2886,457,1605,247,7243
"06085503902",1789,306,178,34,2531,892,3064,782,9576
"06085503903",973,61,0,8,2179,349,1841,179,5590
"06085504001",2183,166,139,24,2781,414,3617,493,9817
"06085504002",1131,479,76,19,3799,514,2919,755,9692
"06085504101",1602,457,62,89,1802,781,2198,909,7900
"06085504102",1756,96,112,10,3426,433,3625,332,9790
"06085504201",2834,56,80,25,2143,88,1822,75,7123
"06085504202",2748,186,252,2,1425,53,1671,10,6347
"06085504307",841,189,188,17,4077,488,616,155,6571
"06085504308",1457,77,43,0,2514,335,638,43,5107
"06085504311",670,77,202,0,5746,375,396,0,7466
"06085504314",907,7,169,26,2849,603,543,39,5143
"06085504315",1441,81,345,33,4027,380,851,142,7300
"06085504316",938,40,103,0,3793,322,1053,0,6249
"06085504317",792,19,137,0,3236,120,249,103,4656
"06085504318",762,254,39,42,3573,406,1038,227,6341
"06085504319",1661,132,132,22,4919,388,1302,93,8649
"06085504320",826,0,22,0,1861,192,231,58,3190
"06085504321",1031,67,56,0,3917,480,758,182,6491
"06085504322",999,55,142,164,3644,327,388,0,5719
"06085504323",631,66,10,0,5075,403,1028,314,7527
"06085504410",1099,162,40,10,3349,289,986,141,6076
"06085504411",1556,64,20,14,3686,315,822,31,6508
"06085504412",1024,123,49,0,3362,304,713,108,5683
"06085504413",289,0,46,0,1319,97,70,0,1821
"06085504414",854,37,83,0,4466,319,417,21,6197
"06085504415",981,45,56,14,4080,112,647,37,5972
"06085504416",504,22,40,8,2816,15,530,3,3938
"06085504417",159,97,0,0,192,0,10,97,555
"06085504418",730,185,63,19,3508,644,1279,308,6736
"06085504420",875,45,89,0,3272,271,343,23,4918
"06085504421",952,136,128,0,3252,297,744,95,5604
"06085504422",887,49,201,2,2438,268,585,40,4470
"06085504423",723,19,139,0,1516,75,542,51,3065
"06085504504",919,226,41,12,5773,220,531,175,7897
"06085504505",811,91,34,0,3528,231,670,95,5460
"06085504506",1408,54,90,0,3787,295,506,61,6201
"06085504507",1104,56,190,33,4125,281,983,150,6922
"06085504601",626,28,0,4,137,22,271,22,1110
"06085504602",1053,114,0,26,449,86,966,181,2875
"06085504700",327,44,92,0,39,0,126,0,628
"06085504802",2061,165,35,0,2687,174,1157,191,6470
"06085504803",1683,195,182,0,4172,262,983,122,7599
"06085504805",3389,627,82,47,1984,14,638,43,6824
"06085504806",1173,72,25,55,1280,91,705,83,3484
"06085504901",1957,128,228,274,6731,497,555,39,10409
"06085505001",3038,70,435,18,5970,679,1587,347,12144
"06085505006",946,38,71,0,2327,47,176,0,3605
"06085505007",1368,23,166,211,1973,139,590,114,4584
"06085505008",1224,145,136,0,3409,167,366,47,5494
"06085505009",2478,225,408,22,3415,287,1944,244,9023
"06085505100",946,312,50,0,1681,294,940,306,4529
"06085505202",2780,211,192,0,2894,379,2837,333,9626
"06085505203",1491,497,124,0,1053,208,674,135,4182
"06085505301",1704,348,248,1,1867,245,733,277,5423
"06085505302",2086,72,76,1,1489,145,643,55,4567
"06085505303",2451,456,358,0,3029,199,2247,439,9179
"06085505304",1830,29,0,0,1181,42,649,2,3733
"06085505305",2899,53,1,0,2719,402,1188,134,7396
"06085505401",1746,310,110,0,3734,90,716,0,6706
"06085505402",898,100,8,16,1619,131,545,57,3374
"06085505403",2464,290,261,2,2861,74,808,183,6943
"06085505500",2212,122,97,85,1250,118,933,118,4935
"06085505600",1337,541,0,54,623,420,470,136,3581
"06085505700",3804,596,51,149,1425,182,1263,173,7643
"06085505800",2266,85,20,98,996,278,622,193,4558
"06085505900",4389,217,391,143,1981,166,1332,223,8842
"06085506000",2519,146,54,17,1324,77,822,5,4964
"06085506101",2812,113,302,70,1390,113,720,23,5543
"06085506102",2019,30,22,0,1399,229,455,0,4154
"06085506103",1832,86,29,42,2456,214,350,39,5048
"06085506202",3014,128,177,0,3594,90,605,17,7625
"06085506203",1096,249,86,0,4613,243,610,69,6966
"06085506204",2680,36,63,58,2561,290,574,28,6290
"06085506301",2620,113,220,40,2078,425,752,234,6482
"06085506302",3147,503,414,16,2134,69,1040,146,7469
"06085506304",2526,443,197,0,1978,329,1426,280,7179
"06085506305",3764,759,302,0,2798,432,3397,562,12014
"06085506401",2080,166,252,0,1821,235,1122,143,5819
"06085506402",3096,510,456,28,1646,377,1084,696,7893
"06085506501",3385,1143,303,171,2285,730,2969,1325,12311
"06085506502",3003,183,143,1,659,20,369,17,4395
"06085506503",4161,386,68,11,886,362,909,234,7017
"06085506601",2311,354,17,93,1634,197,857,336,5799
"06085506603",2665,67,24,0,1276,162,466,76,4736
"06085506604",3661,133,164,0,2788,32,817,83,7678
"06085506605",1923,113,132,0,1912,106,1209,33,5428
"06085506606",2226,152,33,0,1586,68,892,35,4992
"06085506701",2431,193,0,0,924,95,413,32,4088
"06085506702",3695,229,65,0,1945,37,1130,52,7153
"06085506703",2193,158,58,11,1178,54,373,106,4131
"06085506801",4565,129,85,0,1083,2,596,2,6462
"06085506802",3761,153,90,1,851,10,420,1,5287
"06085506803",4275,190,211,111,2202,248,914,7,8158
"06085506804",2755,65,0,0,745,30,196,0,3791
"06085506900",5902,110,24,0,1055,59,572,23,7745
"06085507001",6105,267,0,8,490,69,97,6,7042
"06085507002",2548,187,111,19,340,7,140,0,3352
"06085507100",2095,146,16,0,316,45,99,46,2763
"06085507203",2064,81,0,0,577,37,128,37,2924
"06085507205",3779,129,0,0,866,9,141,0,4924
"06085507206",2391,44,24,0,381,0,110,4,2954
"06085507301",3681,116,29,0,2923,130,478,4,7361
"06085507302",1663,58,0,0,768,9,47,31,2576
"06085507401",2429,27,0,1,3040,42,71,23,5633
"06085507402",2296,251,24,0,1375,0,137,36,4119
"06085507500",2124,98,0,0,3409,49,61,0,5741
"06085507600",2570,195,52,0,2835,185,201,40,6078
"06085507701",1270,23,0,0,2423,74,82,12,3884
"06085507702",2052,23,0,0,4662,103,114,0,6954
"06085507703",2942,160,0,0,4197,105,97,0,7501
"06085507805",2059,162,36,40,3068,190,399,97,6051
"06085507806",1133,80,13,21,3839,107,117,20,5330
"06085507807",633,43,0,0,2398,96,11,0,3181
"06085507808",1515,35,16,0,3915,189,56,0,5726
"06085507903",1217,69,49,0,3180,281,228,113,5137
"06085507904",1009,12,60,0,2430,0,47,12,3570
"06085507905",1018,151,60,0,4839,362,314,90,6834
"06085507906",986,216,0,3,3262,127,97,0,4691
"06085508001",2360,238,39,0,5297,123,695,0,8752
"06085508003",850,64,0,0,1104,260,92,57,2427
"06085508004",2004,16,0,0,4143,104,719,0,6986
"06085508101",2006,55,0,0,4608,89,448,0,7206
"06085508102",892,77,0,0,2212,60,209,4,3454
"06085508202",3055,48,167,8,4066,167,712,124,8347
"06085508203",2202,102,108,1,2476,130,299,2,5320
"06085508204",1537,205,7,0,2440,131,317,177,4814
"06085508301",2250,47,0,0,1587,48,188,7,4127
"06085508303",1416,87,0,0,882,41,28,2,2456
"06085508304",2764,210,128,80,4177,745,1162,28,9294
"06085508401",3621,152,29,72,2814,47,792,13,7540
"06085508403",1528,13,17,0,1226,13,138,2,2937
"06085508404",3080,75,19,0,2720,55,459,60,6468
"06085508503",2050,199,77,0,3675,172,439,120,6732
"06085508504",2062,797,144,22,4409,611,801,770,9616
"06085508505",2052,41,30,0,2082,108,498,14,4825
"06085508507",680,53,51,0,1780,173,177,9,2923
"06085508508",1975,197,171,0,2754,188,907,63,6255
"06085508601",1656,154,64,9,1511,146,573,250,4363
"06085508602",2591,102,136,1,1440,86,657,2,5015
"06085508703",2160,297,125,15,4639,188,1018,19,8461
"06085508704",1864,226,174,40,2484,295,739,134,5956
"06085508800",1370,711,62,17,1869,78,1067,731,5905
"06085508900",1828,300,68,0,2975,713,2143,322,8349
"06085509000",4167,512,312,0,2803,368,2946,593,11701
"06085509102",1694,86,138,0,3035,46,532,0,5531
"06085509105",3449,437,320,0,2705,321,1570,427,9229
"06085509106",2097,129,124,12,1948,83,953,97,5443
"06085509107",1804,192,32,31,2285,277,936,185,5742
"06085509108",2426,180,17,18,1593,92,1076,139,5541
"06085509109",2279,62,60,10,1762,15,244,0,4432
"06085509201",2701,106,79,0,1366,192,644,14,5102
"06085509202",2314,102,40,17,1987,82,843,55,5440
"06085509302",2288,76,68,0,586,86,614,3,3721
"06085509303",1761,288,55,0,1158,178,570,92,4102
"06085509304",1105,144,46,0,1783,32,772,0,3882
"06085509401",1450,163,44,32,1244,122,189,130,3374
"06085509403",2345,644,143,59,1249,100,1382,417,6339
"06085509404",2337,427,52,0,3133,409,1832,193,8383
"06085509500",2561,582,88,0,1886,180,1101,356,6754
"06085509600",1870,43,0,0,744,73,383,0,3113
"06085509700",1745,215,48,0,972,46,409,106,3541
"06085509801",3771,88,69,2,1644,0,880,0,6454
"06085509802",1631,163,125,0,882,20,315,124,3260
"06085509901",1479,14,3,0,392,20,26,8,1942
"06085509902",3235,230,1,5,1352,85,399,4,5311
"06085510001",3997,37,0,0,1843,23,259,4,6163
"06085510002",2367,101,0,0,1142,43,134,8,3795
"06085510100",2169,0,0,0,967,0,112,0,3248
"06085510200",3062,45,209,0,1067,40,168,0,4591
"06085510300",2989,70,0,1,1099,14,71,2,4246
"06085510400",2174,33,0,0,1064,11,246,0,3528
"06085510500",3167,122,0,2,1274,15,209,0,4789
"06085510600",3661,151,340,0,2131,117,752,158,7310
"06085510700",2493,118,156,11,2098,176,432,79,5563
"06085510801",3086,63,12,0,2123,0,271,0,5555
"06085510802",1398,39,41,1,561,0,111,0,2151
"06085510803",1264,87,26,0,1085,69,79,9,2619
"06085510900",2927,223,167,0,2041,61,575,0,5994
"06085511000",3536,251,198,5,2694,134,605,90,7513
"06085511100",3392,176,34,4,1613,227,300,2,5748
"06085511200",3730,97,105,1,941,38,267,12,5191
"06085511301",2490,332,40,0,735,10,223,57,3887
"06085511302",2621,255,45,68,787,117,219,17,4129
"06085511400",2691,125,132,0,403,22,248,39,3660
"06085511500",5016,131,192,32,1359,248,393,0,7371
"06085511608",76,4,0,0,43,5,0,0,128
"06085511609",2097,119,143,0,876,38,81,44,3398
"06085511701",2870,42,0,1,1337,61,77,1,4389
"06085511702",2154,23,6,0,692,83,49,0,3007
"06085511704",2895,201,14,0,1306,70,132,0,4618
"06085511705",642,25,0,0,265,0,41,0,973
"06085511707",1993,157,0,0,571,178,125,22,3046
"06085511800",3429,261,10,8,530,47,71,9,4365
"06085511905",1563,79,47,0,1201,76,116,42,3124
"06085511907",2272,4,0,0,1823,0,471,0,4570
"06085511909",4664,100,0,0,3861,96,509,21,9251
"06085511910",2299,137,15,0,682,0,182,10,3325
"06085511911",3296,114,195,0,1324,11,494,38,5472
"06085511912",3000,51,22,11,2425,18,185,0,5712
"06085511913",3121,96,35,0,1077,36,667,16,5048
"06085511914",3785,121,205,0,1712,31,663,42,6559
"06085511915",1425,300,46,255,1265,367,1304,309,5271
"06085511916",2836,105,58,51,1379,55,471,9,4964
"06085512001",3342,99,134,30,3278,112,1797,4,8796
"06085512005",3869,334,157,67,1963,170,1499,291,8350
"06085512017",3269,1067,167,95,3556,275,3299,923,12651
"06085512019",2013,130,95,0,2135,180,1308,119,5980
"06085512020",2690,189,229,177,3368,419,2124,489,9685
"06085512021",2781,275,89,40,2474,313,762,106,6840
"06085512022",2819,175,167,24,2280,274,2375,213,8327
"06085512023",2847,553,348,85,1748,292,2446,587,8906
"06085512024",2511,52,175,35,1716,93,1240,0,5822
"06085512025",2009,73,69,0,1071,17,813,0,4052
"06085512026",2081,105,107,34,1129,277,1263,102,5098
"06085512027",2535,396,119,25,1104,123,1126,219,5647
"06085512029",4664,113,115,0,2206,44,2258,45,9445
"06085512030",1866,72,57,0,661,201,510,78,3445
"06085512031",2981,183,87,0,942,14,881,127,5215
"06085512032",1860,216,15,0,1115,208,928,346,4688
"06085512033",3362,274,371,27,2274,26,1769,137,8240
"06085512034",1751,70,9,0,1095,27,790,0,3742
"06085512035",2333,214,80,0,1477,34,1346,169,5653
"06085512036",2285,402,233,0,1894,43,1004,177,6038
"06085512037",1640,48,30,0,1248,52,564,30,3612
"06085512038",1319,125,260,68,1078,36,777,40,3703
"06085512039",1887,53,126,16,2228,281,1327,207,6125
"06085512042",749,217,103,46,1336,122,697,218,3488
"06085512043",2268,835,640,34,2614,811,3675,1244,12121
"06085512045",3851,170,52,15,1389,10,1409,64,6960
"06085512047",3403,383,66,0,1464,204,1377,190,7087
"06085512052",2516,168,34,0,991,47,648,51,4455
"06085512053",2738,190,300,0,1457,184,1548,224,6641
"06085512100",973,193,0,0,439,36,469,194,2304
"06085512200",3540,296,43,0,815,0,1177,10,5881
"06085512305",2343,98,138,0,1148,37,695,3,4462
"06085512307",4533,298,65,0,1276,1,1406,142,7721
"06085512308",5372,109,19,187,1917,143,1987,25,9759
"06085512309",3556,39,113,0,798,495,657,478,6136
"06085512310",2026,471,109,0,1126,135,1360,505,5732
"06085512311",2001,166,101,26,539,37,712,119,3701
"06085512312",1915,16,81,0,839,23,865,19,3758
"06085512313",1943,727,74,143,911,107,1029,748,5682
"06085512314",3124,707,77,78,1971,392,2600,878,9827
"06085512401",3068,184,107,0,1140,183,1703,137,6522
"06085512402",3066,14,118,0,1738,224,1685,42,6887
"06085512503",5776,47,169,1,1263,134,2407,73,9870
"06085512505",5274,602,267,0,1131,148,3764,725,11911
"06085512506",2852,629,72,175,2176,760,3094,1198,10956
"06085512508",5439,700,14,9,1791,427,4232,998,13610
"06085512509",2231,432,32,10,1494,148,2201,522,7070
"06085512510",3783,248,50,27,1775,204,2442,321,8850
"06085512602",1604,287,0,43,869,214,1680,344,5041
"06085512603",1498,692,213,0,711,424,1656,1025,6219
"06085512604",2021,867,0,0,782,799,2409,1629,8507
"06085513000",1596,569,40,0,1232,570,327,69,4403
"06085513500",740,66,0,7,51,73,148,106,1191
"06087100100",1786,117,70,18,170,19,210,37,2427
"06087100200",4615,1011,176,192,640,296,1129,309,8368
"06087100300",2270,324,0,26,135,318,91,83,3247
"06087100400",524,185,0,17,349,103,276,73,1527
"06087100500",3964,997,77,0,504,309,430,76,6357
"06087100600",2833,436,27,0,88,144,537,99,4164
"06087100700",1075,209,40,1,319,45,271,43,2003
"06087100800",4538,1782,126,41,837,480,1331,822,9957
"06087100900",3363,342,5,0,323,107,795,1,4936
"06087101000",4171,1562,162,118,1205,1096,1622,890,10826
"06087101100",4079,702,34,0,487,179,509,150,6140
"06087101200",2212,417,36,0,195,152,159,56,3227
"06087110100",4256,631,0,2,1901,97,4042,567,11496
"06087110200",4695,967,36,0,1543,939,4714,1766,14660
"06087110300",3278,1235,0,0,1225,1361,4283,2399,13781
"06087110400",3748,1522,20,6,2253,467,4687,1927,14630
"06087110501",3661,669,0,0,1438,652,3928,1130,11478
"06087110502",4251,512,0,0,1543,398,5054,864,12622
"06087110600",5143,437,0,0,1855,708,5389,1011,14543
"06087110700",1504,281,8,0,1094,786,1828,881,6382
"06087120200",3339,495,23,0,249,76,405,106,4693
"06087120301",4664,217,0,0,332,0,242,18,5473
"06087120302",2310,280,0,0,244,26,299,69,3228
"06087120400",4131,511,0,0,297,49,360,0,5348
"06087120500",5232,205,6,0,336,0,356,1,6136
"06087120600",4024,264,0,0,314,23,341,131,5097
"06087120700",3825,168,0,0,264,0,357,0,4614
"06087120800",5173,147,35,0,346,99,702,0,6502
"06087120900",6453,286,85,3,1133,61,586,64,8671
"06087121000",2827,178,0,0,339,11,114,11,3480
"06087121100",2456,144,26,0,301,21,474,24,3446
"06087121200",4908,303,37,0,486,6,513,0,6253
"06087121300",3754,224,0,14,477,156,1315,221,6161
"06087121401",1319,390,43,2,475,41,610,142,3022
"06087121402",2628,975,0,0,651,95,784,665,5798
"06087121403",2721,401,7,60,235,31,562,141,4158
"06087121500",3624,665,75,0,391,338,501,416,6010
"06087121600",4355,558,206,0,682,172,1237,275,7485
"06087121700",4986,482,25,0,1453,39,1903,29,8917
"06087121800",3752,202,70,4,542,102,701,84,5457
"06087122001",4457,230,0,3,490,40,393,8,5621
"06087122002",2865,195,36,0,376,124,98,32,3726
"06087122003",4877,716,19,0,818,0,893,85,7408
"06087122100",2515,433,11,0,255,67,594,179,4054
"06087122201",5441,709,75,0,299,220,782,459,7985
"06087122202",2008,133,14,0,162,23,269,11,2620
"06087122203",2884,137,58,0,163,21,177,15,3455
"06087122300",2676,455,28,0,242,7,485,160,4053
"06087122400",5314,422,28,0,820,32,1566,84,8266
"06087122500",4728,477,122,0,1241,141,4484,600,11793
"06087123100",1983,242,0,0,304,45,1246,204,4024
"06087123300",1032,167,0,2,212,259,682,338,2692
"06087990100",0,0,0,0,0,0,0,0,0
"06089010100",747,333,2,5,85,76,23,35,1306
"06089010200",1487,306,25,0,60,43,50,31,2002
"06089010300",2611,542,69,32,370,128,163,160,4075
"06089010400",2209,1163,0,29,313,138,181,104,4137
"06089010500",3015,685,90,20,469,237,344,137,4997
"06089010601",2177,149,0,13,339,5,74,6,2763
"06089010602",4065,576,43,4,480,138,382,55,5743
"06089010603",1309,53,0,0,99,22,105,2,1590
"06089010702",2885,610,0,0,343,19,236,38,4131
"06089010703",2216,1138,8,0,269,53,80,59,3823
"06089010704",2682,974,27,1,251,158,253,87,4433
"06089010803",3719,454,160,23,432,264,461,78,5591
"06089010804",1901,137,0,2,145,18,52,0,2255
"06089010805",3897,592,13,74,600,38,219,52,5485
"06089010806",2340,426,0,0,61,160,103,46,3136
"06089010807",3620,275,0,0,149,140,406,26,4616
"06089010900",2328,727,20,20,658,142,232,181,4308
"06089011001",1361,144,2,1,105,19,144,7,1783
"06089011002",4298,563,53,0,586,193,427,117,6237
"06089011100",2317,225,35,5,462,30,251,0,3325
"06089011209",3029,1451,155,0,605,199,301,206,5946
"06089011300",3485,795,24,0,561,615,329,339,6148
"06089011401",3272,388,18,0,285,126,269,55,4413
"06089011402",3006,102,64,19,379,0,366,0,3936
"06089011403",2094,221,0,0,455,0,435,0,3205
"06089011500",4643,670,10,0,582,193,72,113,6283
"06089011600",2511,509,14,48,419,122,227,159,4009
"06089011701",1624,445,0,0,156,28,85,10,2348
"06089011702",1838,848,0,1,427,201,463,151,3929
"06089011703",2208,409,8,0,341,107,374,30,3477
"06089011801",2257,251,16,1,122,60,118,1,2826
"06089011802",2021,131,0,0,153,24,76,75,2480
"06089011803",1989,493,0,32,153,0,206,46,2919
"06089011900",3824,321,13,55,419,72,240,21,4965
"06089012000",2390,1010,13,25,926,242,593,127,5326
"06089012101",3433,690,0,0,195,94,200,93,4705
"06089012102",1368,437,0,0,51,73,128,27,2084
"06089012200",4244,762,23,28,362,435,577,461,6892
"06089012301",2005,707,21,0,175,48,277,417,3650
"06089012302",4401,775,0,0,278,73,345,51,5923
"06089012303",2986,472,0,0,136,12,25,119,3750
"06089012400",3278,537,14,0,258,63,199,0,4349
"06089012500",930,310,0,0,94,93,28,2,1457
"06089012601",3685,512,4,7,497,63,239,56,5063
"06089012603",2943,318,35,0,529,98,148,7,4078
"06089012604",1850,253,0,1,223,71,66,24,2488
"06089012701",3028,425,0,53,125,172,184,13,4000
"06089012702",2773,447,0,0,146,10,339,113,3828
"06091010000",2337,501,17,1,139,97,144,126,3362
"06093000100",971,278,26,10,83,50,403,226,2047
"06093000200",1407,217,0,0,189,98,451,73,2435
"06093000300",3045,645,2,0,252,73,143,164,4324
"06093000400",517,142,0,0,60,9,31,12,771
"06093000500",1057,399,6,0,354,260,99,95,2270
"06093000600",1336,234,0,0,89,36,106,15,1816
"06093000701",2649,690,2,3,279,97,108,7,3835
"06093000702",2316,886,2,57,571,289,366,82,4569
"06093000703",2016,686,103,0,349,225,228,226,3833
"06093000800",2324,478,3,0,321,121,129,38,3414
"06093000900",4714,1275,149,58,389,205,649,155,7594
"06093001000",5663,813,0,0,471,154,419,186,7706
"06093001100",1457,375,88,0,158,22,61,65,2226
"06093001200",1132,293,0,0,142,38,77,56,1738
"06095250103",1258,546,739,104,1783,253,661,282,5626
"06095250104",786,168,273,5,897,48,128,10,2315
"06095250105",841,55,1425,207,4427,133,519,34,7641
"06095250106",1209,94,511,0,2841,119,562,3,5339
"06095250200",1438,342,581,281,456,414,580,312,4404
"06095250300",1240,380,383,421,923,232,757,185,4521
"06095250400",1323,90,209,129,604,22,611,42,3030
"06095250501",1145,186,93,0,333,99,337,69,2262
"06095250502",1486,48,306,84,684,245,452,7,3312
"06095250601",2059,289,904,268,961,212,1304,78,6075
"06095250604",1310,193,336,65,1898,40,434,0,4276
"06095250605",1423,64,836,0,2009,9,187,5,4533
"06095250701",1117,492,527,233,822,152,1217,564,5124
"06095250801",1429,225,646,279,663,43,538,66,3889
"06095250900",415,103,213,348,428,271,224,174,2176
"06095251000",1228,69,441,203,353,120,425,50,2889
"06095251100",1344,993,341,44,763,128,1320,922,5855
"06095251200",1373,285,284,343,530,341,989,169,4314
"06095251300",1796,156,191,37,570,33,631,49,3463
"06095251400",2342,337,670,128,1532,355,935,327,6626
"06095251500",1531,531,590,169,753,172,1017,479,5242
"06095251600",971,391,310,278,501,215,703,305,3674
"06095251701",1066,508,334,144,897,154,423,424,3950
"06095251702",602,114,434,386,775,219,153,164,2847
"06095251802",909,341,297,192,572,349,465,278,3403
"06095251803",1468,351,335,357,2593,239,1752,299,7394
"06095251804",978,97,348,157,1915,74,698,48,4315
"06095251901",1725,369,1198,470,1004,285,1372,217,6640
"06095251902",1363,397,1176,251,2337,251,1409,350,7534
"06095251903",1261,114,1211,589,1786,146,1396,195,6698
"06095252000",3465,229,97,0,508,50,674,49,5072
"06095252102",2612,218,256,17,491,16,467,85,4162
"06095252103",1303,33,967,380,2515,329,702,169,6398
"06095252104",3263,27,489,25,1829,239,644,44,6560
"06095252105",2202,87,72,19,866,24,429,20,3719
"06095252106",2831,272,164,0,817,79,612,55,4830
"06095252107",2523,77,21,0,838,17,537,17,4030
"06095252108",2120,104,229,9,530,103,360,26,3481
"06095252201",4690,16,508,153,3002,57,1105,0,9531
"06095252202",4405,281,894,198,4154,0,1984,267,12183
"06095252305",2741,211,299,0,1417,65,658,183,5574
"06095252306",2158,211,370,53,543,83,538,0,3956
"06095252310",2287,83,235,0,665,0,220,0,3490
"06095252311",2061,38,785,90,1646,0,610,19,5249
"06095252312",1462,387,326,0,897,61,557,306,3996
"06095252313",2325,100,490,75,1607,188,950,52,5787
"06095252314",1664,83,405,22,1702,62,1000,22,4960
"06095252315",1686,103,624,27,1589,49,468,1,4547
"06095252316",1761,40,485,41,1058,231,1042,231,4889
"06095252317",2347,38,1229,0,3280,47,894,22,7857
"06095252401",1987,498,339,91,1223,152,1647,498,6435
"06095252402",1595,333,937,308,1515,612,1186,695,7181
"06095252501",934,208,215,61,663,796,683,814,4374
"06095252502",611,173,183,18,408,99,414,107,2013
"06095252604",943,407,741,185,563,254,782,209,4084
"06095252605",1813,455,510,391,1864,744,1933,691,8401
"06095252606",1184,711,808,255,1707,429,1362,505,6961
"06095252607",995,487,300,339,795,777,978,728,5399
"06095252608",1233,118,593,116,1163,589,1026,644,5482
"06095252610",1379,146,425,131,981,12,853,57,3984
"06095252611",869,92,456,86,899,393,651,329,3775
"06095252702",2066,176,919,360,2916,557,912,329,8235
"06095252703",756,64,1254,169,1594,260,821,163,5081
"06095252704",1341,137,1098,365,1908,144,1144,125,6262
"06095252705",1664,418,982,85,2244,379,825,578,7175
"06095252706",2030,31,748,14,1241,34,896,34,5028
"06095252707",1751,201,551,616,1320,294,923,313,5969
"06095252801",1786,199,119,54,612,133,275,41,3219
"06095252802",396,12,44,0,14,0,24,0,490
"06095252903",3735,94,0,0,617,0,614,0,5060
"06095252904",3108,298,330,10,1660,15,1377,11,6809
"06095252908",2140,223,90,0,987,230,554,217,4441
"06095252909",2336,167,75,16,552,31,700,43,3920
"06095252910",3953,271,353,106,1109,48,1157,38,7035
"06095252911",3854,324,126,1,501,14,336,96,5252
"06095252912",3766,62,263,0,1008,230,393,78,5800
"06095252913",3173,93,342,0,1149,8,854,23,5642
"06095252914",3313,136,594,16,1357,497,969,532,7414
"06095252915",2036,0,591,0,1423,0,632,0,4682
"06095253000",0,0,0,0,0,0,0,0,0
"06095253101",3498,469,260,0,722,97,1007,125,6178
"06095253105",3123,547,400,27,998,290,1465,275,7125
"06095253106",2106,250,274,19,517,108,630,143,4047
"06095253107",3206,234,167,40,1674,583,1387,538,7829
"06095253108",2265,243,487,62,773,249,867,97,5043
"06095253201",3718,172,185,34,581,0,881,48,5619
"06095253203",3001,332,23,11,489,127,1283,190,5456
"06095253204",3520,636,365,159,1480,363,1451,649,8623
"06095253205",1865,68,24,59,807,620,716,189,4348
"06095253206",2434,34,96,0,349,0,382,0,3295
"06095253300",1860,188,31,6,764,39,1034,163,4085
"06095253402",4977,563,44,1,959,73,2323,465,9405
"06095253403",3869,78,222,0,1038,20,2134,16,7377
"06095253404",3886,1093,173,0,1260,206,1720,730,9068
"06095253500",5672,637,524,14,1296,229,1039,102,9513
"06095980000",0,0,0,0,0,0,0,0,0
"06097150100",2281,185,0,0,160,60,394,18,3098
"06097150202",4178,338,0,0,775,89,954,59,6393
"06097150203",3860,154,0,13,312,240,655,240,5474
"06097150204",3479,253,0,0,260,13,348,0,4353
"06097150303",3880,325,0,30,259,3,437,3,4937
"06097150304",4180,423,11,0,1302,570,2105,677,9268
"06097150305",4053,237,51,0,812,1024,3226,901,10304
"06097150306",3135,194,1,0,391,551,695,582,5549
"06097150500",3315,775,35,46,565,80,190,160,5166
"06097150601",2675,370,167,3,694,79,1252,209,5449
"06097150602",3231,230,42,0,422,75,551,214,4765
"06097150603",5274,512,0,23,795,333,1615,403,8955
"06097150607",4478,40,12,0,866,40,555,51,6042
"06097150609",3141,225,8,29,849,131,888,180,5451
"06097150610",3435,43,0,0,511,154,549,140,4832
"06097150611",2490,525,202,0,662,107,604,441,5031
"06097150612",3523,105,0,0,658,13,635,0,4934
"06097150701",3227,468,52,0,716,113,840,99,5515
"06097150702",4224,101,26,0,322,0,287,12,4972
"06097150800",3802,193,23,0,519,334,655,160,5686
"06097150901",3563,939,73,0,803,184,1376,766,7704
"06097150902",2846,285,18,0,242,25,424,114,3954
"06097151000",3113,213,54,0,245,0,493,105,4223
"06097151100",4101,293,36,0,567,69,623,153,5842
"06097151201",5089,531,115,0,1155,42,1563,55,8550
"06097151203",3802,399,47,0,602,80,613,175,5718
"06097151204",2498,373,88,10,470,79,511,174,4203
"06097151301",2934,532,87,21,950,137,1422,312,6395
"06097151305",3142,661,319,14,851,225,1249,183,6644
"06097151306",2389,341,43,0,701,17,429,34,3954
"06097151307",3640,316,10,0,779,153,761,128,5787
"06097151308",3960,329,95,37,313,367,852,332,6285
"06097151309",3863,481,68,0,643,65,728,161,6009
"06097151310",2467,207,104,0,1003,196,1202,25,5204
"06097151311",3638,1329,109,22,1562,139,1018,52,7869
"06097151401",3435,707,18,241,2401,419,2888,811,10920
"06097151402",5078,1181,150,0,2414,548,3271,1216,13858
"06097151502",5410,380,122,30,864,112,681,137,7736
"06097151503",3331,46,0,0,175,14,123,4,3693
"06097151504",2705,94,58,0,325,108,495,108,3893
"06097151601",2337,136,17,0,52,19,8,8,2577
"06097151602",2955,153,0,0,79,0,35,22,3244
"06097151700",5152,310,71,36,886,67,1107,175,7804
"06097151800",4298,292,0,0,339,73,495,73,5570
"06097151900",2188,394,30,6,475,200,693,221,4207
"06097152000",1144,431,10,9,328,83,393,160,2558
"06097152100",1501,380,46,0,467,106,530,59,3089
"06097152201",2407,659,104,10,447,54,376,92,4149
"06097152202",4629,795,81,0,955,55,876,552,7943
"06097152203",2778,242,115,11,162,0,216,9,3533
"06097152300",3769,170,43,0,274,35,308,15,4614
"06097152400",7580,279,78,0,1805,62,863,0,10667
"06097152501",3209,374,51,16,474,53,441,139,4757
"06097152502",2719,291,38,7,338,184,501,229,4307
"06097152600",6536,456,130,0,739,20,814,61,8756
"06097152701",4496,187,24,0,217,277,446,107,5754
"06097152702",3450,633,16,0,745,76,961,373,6254
"06097152801",4096,261,34,11,812,283,1014,317,6828
"06097152802",3704,1002,210,315,1674,305,2722,385,10317
"06097152903",3097,602,131,8,1245,356,2520,570,8529
"06097152904",3846,310,194,0,668,269,1005,293,6585
"06097152905",3059,130,94,0,271,94,931,31,4610
"06097152906",3638,396,92,1,795,60,571,10,5563
"06097153001",4004,1179,116,31,859,240,2281,627,9337
"06097153002",3127,1150,129,71,943,232,1781,1130,8563
"06097153003",3340,637,135,29,1165,254,1693,510,7763
"06097153005",5205,167,60,16,1360,306,1990,247,9351
"06097153006",4550,661,0,14,1191,254,1451,245,8366
"06097153102",2724,589,25,9,1468,348,2597,594,8354
"06097153103",3246,768,81,0,723,257,2480,595,8150
"06097153104",1593,673,30,0,1197,681,1794,1072,7040
"06097153200",3929,1244,293,0,2283,449,2326,1230,11754
"06097153300",5537,1245,660,39,3328,462,2535,1043,14849
"06097153401",4905,533,85,0,887,52,897,0,7359
"06097153403",3300,225,63,0,317,35,377,65,4382
"06097153404",3672,280,25,0,300,85,342,12,4716
"06097153501",3561,483,7,5,433,69,285,104,4947
"06097153502",3086,181,92,0,107,83,111,45,3705
"06097153600",3689,406,0,6,757,188,623,207,5876
"06097153703",2238,512,39,0,184,75,136,25,3209
"06097153704",2265,864,21,48,120,56,182,289,3845
"06097153705",2728,385,13,0,184,118,226,110,3764
"06097153706",3380,208,11,0,486,3,371,3,4462
"06097153801",7036,363,44,0,2749,249,3279,342,14062
"06097153804",2806,35,0,0,513,26,930,26,4336
"06097153806",2779,135,0,0,551,0,620,22,4107
"06097153807",3785,113,0,0,142,0,389,27,4456
"06097153808",2529,226,12,20,1152,0,1502,59,5500
"06097153809",3239,119,9,0,966,4,1508,0,5845
"06097153901",3648,229,0,0,960,268,1249,268,6622
"06097153902",2362,494,26,0,816,203,1362,445,5708
"06097153903",2803,287,43,0,543,305,723,358,5062
"06097154000",1974,305,0,38,368,85,414,133,3317
"06097154100",2587,367,17,2,956,82,1225,163,5399
"06097154201",2111,555,9,10,1059,4,1370,91,5209
"06097154202",4983,183,0,0,958,0,1560,54,7738
"06097154302",2967,225,0,0,202,25,177,9,3605
"06097154303",1062,45,15,0,57,20,68,0,1267
"06097154304",1543,175,7,1,168,61,181,14,2150
"06097990100",0,0,0,0,0,0,0,0,0
"06099000101",4231,486,35,0,377,13,674,124,5940
"06099000102",3216,456,0,0,184,91,704,339,4990
"06099000201",5066,285,30,78,134,0,806,39,6438
"06099000202",5147,767,59,1,604,237,1586,150,8551
"06099000203",5896,1946,65,0,717,104,1721,1041,11490
"06099000301",1174,283,36,0,363,84,861,266,3067
"06099000302",1775,401,87,93,213,23,1073,316,3981
"06099000303",3769,885,98,0,851,115,2688,534,8940
"06099000304",3031,1307,14,60,553,33,2537,1043,8578
"06099000402",7797,632,57,4,1948,95,3326,290,14149
"06099000403",3541,349,41,10,214,141,631,198,5125
"06099000404",3114,563,271,0,1021,317,494,344,6124
"06099000501",5628,101,199,19,1435,35,2398,0,9815
"06099000503",2716,811,96,34,1207,188,1059,578,6689
"06099000504",5329,267,341,3,2729,188,2100,129,11086
"06099000505",2378,762,179,0,1670,343,1153,461,6946
"06099000506",2348,857,144,14,514,497,475,910,5759
"06099000510",6577,963,146,0,1066,73,4009,683,13517
"06099000601",3110,259,71,69,1200,77,1559,171,6516
"06099000602",1764,303,22,71,726,75,1058,253,4272
"06099000801",3766,1081,75,15,963,181,1286,408,7775
"06099000803",2123,818,190,19,333,404,1101,863,5851
"06099000805",3649,837,136,140,724,500,1545,770,8301
"06099000806",2535,545,139,49,739,151,952,435,5545
"06099000807",2342,413,20,9,537,157,863,192,4533
"06099000905",4106,268,0,450,860,134,1065,27,6910
"06099000906",4431,398,145,73,783,63,1346,257,7496
"06099000907",2505,103,0,41,198,18,409,17,3291
"06099000908",3282,846,343,143,391,244,1152,631,7032
"06099000909",2458,941,58,112,647,276,738,730,5960
"06099000910",3717,864,267,93,1234,202,1541,620,8538
"06099000911",3374,458,134,71,713,164,1267,136,6317
"06099000912",10648,969,596,0,4741,575,3093,911,21533
"06099001001",4008,878,114,107,314,294,851,544,7110
"06099001002",1905,496,25,35,303,104,509,157,3534
"06099001100",2563,725,52,0,483,167,700,470,5160
"06099001200",2255,568,141,6,487,277,809,267,4810
"06099001300",4142,534,84,0,411,291,700,576,6738
"06099001400",2846,1330,84,134,1380,976,1697,1119,9566
"06099001500",3896,826,163,15,876,768,2454,1148,10146
"06099001601",2109,1147,64,136,1109,716,2490,1424,9195
"06099001603",2875,1300,58,63,1039,849,2296,1645,10125
"06099001604",1440,796,67,123,898,652,1853,1152,6981
"06099001700",1016,684,117,28,457,362,1285,518,4467
"06099001800",819,457,64,54,117,60,176,187,1934
"06099001900",3306,948,146,120,765,120,1078,421,6904
"06099002002",2459,1338,51,0,447,249,1612,915,7071
"06099002004",3330,1267,311,337,882,223,2129,622,9101
"06099002005",1771,554,92,19,687,63,1254,317,4757
"06099002006",1896,258,160,8,1347,87,1119,206,5081
"06099002100",1621,1471,0,0,344,227,1386,1226,6275
"06099002200",2308,1319,59,251,875,1087,2152,1944,9995
"06099002301",2924,1846,148,147,1777,951,3616,2187,13596
"06099002302",1660,761,0,0,824,393,2120,822,6580
"06099002401",1814,635,161,0,657,149,1919,648,5983
"06099002402",2028,1023,9,0,1145,1185,2719,2062,10171
"06099002501",3433,625,141,0,1947,342,4087,771,11346
"06099002503",2068,967,37,13,239,390,1481,724,5919
"06099002504",2492,703,68,0,911,178,1993,726,7071
"06099002602",2487,1042,90,47,694,170,1552,822,6904
"06099002603",2203,127,1,10,289,144,835,138,3747
"06099002604",1788,1180,59,127,479,356,1382,799,6170
"06099002605",2555,594,0,0,466,148,1351,295,5409
"06099002701",2025,375,10,0,821,184,1241,202,4858
"06099002702",3672,1185,24,0,1816,962,3442,1920,13021
"06099002801",3726,695,0,47,826,244,1580,464,7582
"06099002802",3572,1033,0,72,1002,516,2011,778,8984
"06099002803",2015,384,76,0,401,92,634,314,3916
"06099002901",3125,873,0,0,324,40,701,535,5598
"06099002902",4933,1250,107,0,876,1,2029,923,10119
"06099003001",6143,603,0,3,3656,89,5110,481,16085
"06099003002",3764,1793,46,0,1257,769,2611,1848,12088
"06099003100",2665,1078,0,1,175,64,1034,891,5908
"06099003201",2742,1318,33,21,750,162,2384,1421,8831
"06099003202",9334,882,1755,207,3226,683,6697,1468,24252
"06099003300",3985,1354,230,11,690,35,2661,1227,10193
"06099003400",743,440,0,23,21,27,400,386,2040
"06099003500",6775,2034,51,37,1180,306,4848,1951,17182
"06099003603",2932,1030,0,0,230,262,1064,763,6281
"06099003604",6778,1244,0,68,634,175,1855,608,11362
"06099003605",5978,759,0,1,854,651,1542,143,9928
"06099003606",7433,246,178,126,3227,216,2710,208,14344
"06099003700",3033,688,99,0,601,170,1740,553,6884
"06099003802",3092,1958,11,113,370,239,2464,1674,9921
"06099003803",1338,458,0,0,543,81,1219,402,4041
"06099003804",4104,1468,52,70,492,355,2200,1408,10149
"06099003805",1905,242,3,46,297,185,843,169,3690
"06099003904",3330,393,0,0,442,183,1724,197,6269
"06099003905",3387,98,0,0,126,61,455,32,4159
"06099003906",2207,1190,30,167,567,338,958,783,6240
"06099003907",5599,238,111,224,862,75,1191,130,8430
"06099003908",1671,346,12,39,291,89,812,183,3443
"06099003909",3955,672,30,0,732,112,1098,50,6649
"06099004000",3078,305,0,0,389,49,843,151,4815
"06101050101",4109,735,135,8,1252,552,1775,643,9209
"06101050102",2797,568,38,10,551,442,1138,329,5873
"06101050201",946,1079,28,62,692,414,477,1047,4745
"06101050202",2204,990,13,18,535,208,1072,635,5675
"06101050301",1947,170,17,0,191,99,294,81,2799
"06101050302",2674,943,34,93,1357,1063,2248,1524,9936
"06101050401",2948,205,47,20,1712,198,1182,111,6423
"06101050402",2406,315,134,0,1112,25,519,98,4609
"06101050403",1972,151,111,0,1128,72,968,49,4451
"06101050501",2587,547,130,0,2408,648,614,548,7482
"06101050503",3517,169,114,0,2344,670,1342,62,8218
"06101050504",3501,98,139,0,2680,267,1190,18,7893
"06101050601",3213,610,167,9,1519,422,508,316,6764
"06101050603",3387,210,104,3,784,46,249,54,4837
"06101050604",2723,250,50,30,826,165,536,74,4654
"06101050701",1873,821,0,0,1260,311,1561,827,6653
"06101050702",3767,357,37,0,1451,285,2489,482,8868
"06101050800",2640,249,0,0,259,97,317,100,3662
"06101050900",1047,261,0,23,311,63,409,213,2327
"06101051000",1409,202,5,15,406,130,405,207,2779
"06101051100",1779,149,39,0,397,49,357,92,2862
"06103000100",3059,540,80,3,286,64,461,38,4531
"06103000200",6255,755,0,0,468,206,314,226,8224
"06103000300",3033,1168,0,0,258,406,346,545,5756
"06103000400",4677,502,0,0,420,24,351,121,6095
"06103000500",3706,944,0,0,257,46,889,411,6253
"06103000600",3174,800,3,7,658,168,975,258,6043
"06103000700",5109,2111,0,9,879,275,1446,657,10486
"06103000800",2955,439,13,0,566,75,925,159,5132
"06103000900",2348,830,0,0,384,60,551,375,4548
"06103001000",4699,922,172,0,715,20,1907,236,8671
"06103001100",5276,1285,4,87,687,525,1978,852,10694
"06105000101",2005,709,0,0,134,135,66,168,3217
"06105000102",3114,407,0,0,448,80,295,9,4353
"06105000200",1960,254,35,0,103,47,110,18,2527
"06105000300",2096,750,16,0,345,75,163,56,3501
"06105000400",500,86,0,0,63,36,21,0,706
"06107000100",3976,387,26,0,419,147,872,266,6093
"06107000201",3968,2719,17,6,2106,763,5258,3397,18234
"06107000202",1188,952,0,0,489,159,1171,997,4956
"06107000301",3939,1013,0,63,761,372,2153,1206,9507
"06107000302",1677,1304,3,0,340,289,1678,1452,6743
"06107000401",3176,1543,0,0,923,84,3692,1587,11005
"06107000402",4473,1030,22,0,1384,386,4076,1293,12664
"06107000501",2666,2011,0,5,1004,798,3442,2768,12694
"06107000502",2241,385,0,0,881,239,2768,565,7079
"06107000600",3154,2128,0,36,411,674,3250,2793,12446
"06107000701",1809,279,32,0,150,57,1408,228,3963
"06107000702",3207,1267,0,16,1116,415,3817,1495,11333
"06107000800",4252,1389,1,0,929,383,3063,1368,11385
"06107000900",4516,1486,12,167,832,57,3461,1374,11905
"06107001003",14233,1311,99,99,3375,887,7878,902,28784
"06107001004",4425,1605,61,26,1455,865,4941,1719,15097
"06107001005",1907,108,70,0,472,27,640,95,3319
"06107001006",3895,498,130,3,769,126,987,274,6682
"06107001100",2478,3112,21,221,786,455,2203,3236,12512
"06107001200",764,224,20,8,66,25,404,133,1644
"06107001301",5225,776,227,13,1016,555,3069,729,11610
"06107001302",4999,1365,116,20,867,335,2766,780,11248
"06107001400",3934,1173,56,0,649,30,2447,826,9115
"06107001501",3490,850,0,25,500,139,856,617,6477
"06107001502",3763,2040,117,46,321,163,2053,1539,10042
"06107001601",2497,1955,0,0,900,256,2880,1955,10443
"06107001602",2956,1471,4,0,616,116,2409,1435,9007
"06107001701",2916,1915,139,142,688,356,1984,1787,9927
"06107001703",5257,702,0,62,723,69,1748,402,8963
"06107001704",4514,654,295,0,767,111,2347,421,9109
"06107001800",3502,319,25,43,463,276,1257,415,6300
"06107001901",2683,224,8,0,510,98,924,183,4630
"06107001902",3068,398,0,20,728,47,1363,160,5784
"06107002002",3173,752,4,28,761,71,1391,508,6688
"06107002003",3173,1055,302,103,615,104,1213,692,7257
"06107002004",3792,882,9,0,390,169,1611,727,7580
"06107002006",3604,80,0,88,440,42,972,40,5266
"06107002007",5920,867,177,0,1295,199,2580,652,11690
"06107002008",1573,777,0,99,253,96,687,342,3827
"06107002009",3070,598,185,14,304,32,1594,461,6258
"06107002100",1695,364,0,3,282,124,960,343,3771
"06107002202",2787,1939,90,257,457,314,2195,1940,9979
"06107002203",3168,1021,61,280,445,100,2581,611,8267
"06107002204",3470,1233,157,145,874,88,3042,910,9919
"06107002302",3364,229,180,35,396,230,1283,376,6093
"06107002303",4832,487,0,22,521,132,1674,272,7940
"06107002304",1369,475,36,0,31,49,622,165,2747
"06107002400",8745,669,202,33,2362,159,5190,391,17751
"06107002500",2966,510,25,3,437,72,2002,439,6454
"06107002601",1965,946,0,18,567,408,2268,1258,7430
"06107002602",3145,1308,0,2,618,812,3099,1844,10828
"06107002700",3599,376,12,24,1231,315,961,76,6594
"06107002800",1051,2104,26,0,362,280,1213,2204,7240
"06107002901",1737,1000,238,40,401,199,1591,1008,6214
"06107002903",3589,828,67,79,680,163,2369,697,8472
"06107002904",3216,702,156,61,506,216,1975,815,7647
"06107003001",2544,782,132,0,599,126,2702,717,7602
"06107003002",2126,906,33,92,374,42,1732,884,6189
"06107003100",1984,781,95,0,315,29,1254,638,5096
"06107003200",4096,1755,0,0,366,353,3351,1907,11828
"06107003300",4407,2749,3,2,1004,396,3607,2672,14840
"06107003400",3586,2306,17,28,555,384,1892,2176,10944
"06107003501",2114,472,0,0,311,153,1015,515,4580
"06107003502",7294,1576,84,25,2196,456,5863,1606,19100
"06107003601",4578,998,20,0,1067,58,3260,462,10443
"06107003602",3900,1202,0,0,1062,640,2157,1275,10236
"06107003700",3625,930,30,0,673,555,2370,1092,9275
"06107003801",1649,1172,5,0,157,188,902,989,5062
"06107003802",2010,1425,0,95,324,393,1691,1346,7284
"06107003901",4323,1381,73,0,1063,340,3727,1390,12297
"06107003902",3428,1667,0,0,562,379,2510,1628,10174
"06107004000",12,57,0,30,2,30,2,56,189
"06107004101",4153,2477,32,44,1117,793,4465,2963,16044
"06107004102",1079,532,0,85,324,167,687,600,3474
"06107004200",2619,2643,134,116,427,469,2657,2567,11632
"06107004300",3140,2548,7,43,1164,766,3704,3139,14511
"06107004400",2781,2619,30,3,557,519,3052,2971,12532
"06107004500",3045,1603,207,0,759,650,2577,2089,10930
"06109001100",2899,272,144,3,247,24,266,42,3897
"06109001200",2306,1031,76,69,471,185,113,165,4416
"06109002100",3435,474,0,0,423,166,328,36,4862
"06109002200",6395,802,75,22,152,13,577,0,8036
"06109003100",5144,460,0,0,461,69,308,18,6460
"06109003200",4089,784,0,4,606,64,519,176,6242
"06109004100",4530,407,0,1,213,131,511,183,5976
"06109004200",2864,521,0,0,61,65,141,68,3720
"06109005100",6523,1466,0,0,542,266,520,385,9702
"06109005201",1683,112,24,0,167,0,101,14,2101
"06109985202",0,0,0,0,0,0,0,0,0
"06111000100",536,92,0,0,14,44,27,31,744
"06111000200",1435,210,0,23,906,186,2138,363,5261
"06111000302",3765,575,1,0,1799,619,3465,1148,11372
"06111000303",3472,408,0,0,1038,318,3217,693,9146
"06111000304",2639,1142,9,0,651,124,2532,1225,8322
"06111000400",3290,476,5,0,2028,384,4320,753,11256
"06111000500",982,401,0,0,684,126,1235,423,3851
"06111000600",2017,1081,11,8,2121,967,3415,1953,11573
"06111000701",3010,1166,2,0,1552,308,3780,1375,11193
"06111000702",1663,404,4,0,1343,128,2264,523,6329
"06111000800",5134,593,9,0,1712,233,3710,544,11935
"06111000901",2047,172,0,2,189,3,123,4,2540
"06111000902",1419,155,0,2,275,67,270,72,2260
"06111000903",4178,777,0,23,279,38,879,311,6485
"06111001001",2135,324,23,0,279,47,388,41,3237
"06111001002",5376,655,23,23,775,194,1426,300,8772
"06111001101",3983,364,0,0,303,82,1140,34,5906
"06111001102",3089,411,0,0,310,0,623,0,4433
"06111001201",3163,158,38,9,692,177,1316,213,5766
"06111001202",5676,254,90,19,750,184,1363,190,8526
"06111001204",1505,451,102,3,453,21,975,301,3811
"06111001206",708,37,0,0,176,11,207,22,1161
"06111001301",5323,630,63,0,2519,22,3251,345,12153
"06111001302",1094,366,21,0,336,131,543,454,2945
"06111001401",3384,308,38,3,617,48,1190,129,5717
"06111001402",4392,299,87,1,1061,71,1501,92,7504
"06111001502",5741,863,216,87,1553,170,2673,561,11864
"06111001503",2638,351,223,0,901,235,1020,332,5700
"06111001506",3855,322,65,2,869,24,1668,38,6843
"06111001507",2477,291,86,0,1385,252,1355,352,6198
"06111001601",702,48,14,7,241,0,320,23,1355
"06111001602",1847,48,0,0,331,29,372,42,2669
"06111001700",3268,107,2,0,230,0,328,0,3935
"06111001800",3684,126,93,0,413,6,595,21,4938
"06111001900",2837,195,19,9,516,113,474,72,4235
"06111002000",1950,213,61,21,170,0,260,25,2700
"06111002102",1139,223,5,0,208,8,216,29,1828
"06111002200",3483,800,25,0,1543,319,3087,709,9966
"06111002300",3300,1223,0,0,2043,416,4020,1003,12005
"06111002400",1948,436,51,17,118,111,396,113,3190
"06111002500",4029,199,0,0,387,91,370,46,5122
"06111002600",1975,411,9,0,567,62,847,168,4039
"06111002700",3286,138,72,0,252,194,589,236,4767
"06111002800",4195,722,138,51,1037,115,1419,382,8059
"06111002901",3986,200,305,0,1288,75,2514,144,8512
"06111002905",3580,317,449,23,1281,22,3041,283,8996
"06111003010",2201,135,79,0,571,145,1993,220,5344
"06111003011",3770,927,316,22,679,155,3915,1002,10786
"06111003012",375,0,0,0,29,0,367,0,771
"06111003013",3506,264,222,0,1127,4,2926,238,8287
"06111003100",9828,1023,394,12,3938,835,10029,1771,27830
"06111003201",1651,1240,1,3,669,98,2299,1313,7274
"06111003300",5312,1092,127,154,1380,11,4741,1053,13870
"06111003605",5406,819,613,38,2196,45,4095,777,13989
"06111003608",2524,328,222,0,1179,17,2647,316,7233
"06111003609",4671,307,9,0,672,164,461,164,6448
"06111003612",3372,60,80,0,350,14,324,0,4200
"06111003700",3714,822,274,9,1228,315,4568,1117,12047
"06111003801",2724,561,177,38,1002,294,3692,889,9377
"06111003802",1673,535,76,0,536,87,2108,622,5637
"06111003900",3997,1711,27,122,1185,301,4660,1883,13886
"06111004000",3618,598,46,51,1357,453,4288,893,11304
"06111004101",4910,820,69,0,1102,160,5166,731,12958
"06111004200",3133,420,80,25,1479,143,3273,488,9041
"06111004304",3957,1473,271,0,796,277,2479,1262,10515
"06111004305",1031,94,135,0,349,33,340,53,2035
"06111004400",3865,652,414,41,1656,492,2614,793,10527
"06111004503",2461,599,174,0,1304,266,3045,857,8706
"06111004504",2596,810,69,18,1901,245,3058,979,9676
"06111004505",1188,207,131,2,533,60,1062,163,3346
"06111004506",3335,2360,65,101,1206,136,3917,2331,13451
"06111004600",906,116,59,17,447,18,265,31,1859
"06111004704",870,294,0,0,343,0,987,281,2775
"06111004710",2436,636,82,0,1295,152,2682,705,7988
"06111004711",1656,172,24,7,1058,277,1313,308,4815
"06111004715",2837,535,80,14,1521,357,3396,650,9390
"06111004716",2346,713,108,0,926,262,2619,813,7787
"06111004717",2023,701,93,6,1171,86,2688,793,7561
"06111004901",4411,148,195,93,1818,157,4334,149,11305
"06111004902",2961,889,6,64,470,74,3423,963,8850
"06111005002",1759,551,0,0,226,151,1722,693,5102
"06111005003",5222,1129,0,25,859,242,5244,1328,14049
"06111005004",3279,650,9,121,1158,178,2186,749,8330
"06111005100",2250,71,48,0,542,194,1124,180,4409
"06111005202",2267,137,34,0,492,134,550,178,3792
"06111005203",4034,309,63,28,923,54,1385,53,6849
"06111005204",2860,249,0,0,368,61,407,113,4058
"06111005205",4046,473,65,0,1088,306,983,484,7445
"06111005303",6910,269,82,18,1890,33,1335,69,10606
"06111005304",3913,132,15,0,976,0,572,0,5608
"06111005305",4670,212,0,0,645,0,766,35,6328
"06111005306",4160,171,57,0,839,0,956,25,6208
"06111005401",2932,226,70,1,919,21,1105,49,5323
"06111005403",1671,207,58,0,432,47,988,96,3499
"06111005404",2971,44,128,0,318,32,1132,43,4668
"06111005502",2674,346,257,68,1985,19,2039,182,7570
"06111005503",2065,114,67,0,1208,0,956,8,4418
"06111005504",3202,149,91,37,617,213,779,261,5349
"06111005600",5862,245,305,46,2875,204,2526,289,12352
"06111005700",1040,165,91,12,331,6,331,10,1986
"06111005801",3980,135,89,0,999,42,593,11,5849
"06111005802",7083,103,182,0,2244,0,996,14,10622
"06111005901",5378,343,109,0,1089,76,614,49,7658
"06111005906",5380,378,69,13,775,72,598,81,7366
"06111005907",3035,154,37,0,469,7,171,7,3880
"06111005908",2144,39,20,0,369,11,358,0,2941
"06111005909",2701,77,7,83,315,0,372,30,3585
"06111005910",1392,92,0,0,201,23,129,9,1846
"06111005911",2905,165,54,0,722,185,592,158,4781
"06111006000",3476,480,157,13,853,105,1240,114,6438
"06111006100",4609,334,69,2,2483,936,2329,1182,11944
"06111006200",2721,41,0,0,427,0,192,0,3381
"06111006301",5201,132,0,0,846,63,668,25,6935
"06111006302",1977,109,10,0,263,30,149,14,2552
"06111006400",5650,102,0,0,1967,147,1991,147,10004
"06111006500",2235,341,0,0,774,283,1592,301,5526
"06111006600",3515,199,0,0,383,10,480,16,4603
"06111006700",2173,234,0,0,534,72,376,16,3405
"06111006800",2825,384,2,0,671,93,877,366,5218
"06111006900",2301,712,8,0,646,107,574,427,4775
"06111007000",2097,447,33,0,1284,196,1236,253,5546
"06111007100",3335,846,138,57,1143,36,1611,440,7606
"06111007201",2965,47,0,1,276,3,237,1,3530
"06111007202",3933,58,40,0,530,13,321,0,4895
"06111007300",1407,72,0,0,98,44,50,31,1702
"06111007402",5097,210,63,0,632,64,454,0,6520
"06111007403",4195,305,21,0,1102,0,270,20,5913
"06111007405",6213,270,16,0,580,61,409,35,7584
"06111007406",1969,40,0,0,308,12,41,4,2374
"06111007505",2594,125,0,0,547,0,750,0,4016
"06111007506",6246,185,54,2,853,0,1158,69,8567
"06111007507",6030,42,46,0,1129,0,454,0,7701
"06111007508",2491,139,67,0,675,8,544,26,3950
"06111007509",3051,16,190,0,1049,0,601,8,4915
"06111007510",4689,145,27,0,1415,32,389,51,6748
"06111007511",1598,133,0,0,441,9,234,9,2424
"06111007512",3885,179,24,61,734,0,1055,33,5971
"06111007513",1445,42,48,2,61,0,107,0,1705
"06111007514",4910,116,102,0,1110,244,863,244,7589
"06111007606",1252,27,49,0,157,13,395,21,1914
"06111007607",4831,52,28,15,936,0,613,0,6475
"06111007609",2312,13,0,0,406,8,650,9,3398
"06111007610",4469,170,42,0,694,0,978,0,6353
"06111007611",2313,599,15,0,913,749,2448,1248,8285
"06111007612",2990,139,7,0,1053,179,1693,192,6253
"06111007613",2940,191,71,0,544,5,571,156,4478
"06111007614",5243,257,31,0,1820,134,2014,227,9726
"06111007700",3766,159,107,0,1291,251,1761,249,7584
"06111007800",1958,636,88,9,1336,105,1241,500,5873
"06111007901",4075,166,185,0,1041,66,1982,70,7585
"06111007903",3250,110,21,0,1122,28,803,45,5379
"06111007904",4102,266,66,2,1435,48,1866,199,7984
"06111008001",2150,227,0,0,733,160,976,208,4454
"06111008002",3195,433,0,4,1039,246,1526,350,6793
"06111008004",3527,130,66,14,1204,56,1650,62,6709
"06111008005",1984,157,10,4,462,128,930,221,3896
"06111008101",2835,85,0,3,589,12,847,37,4408
"06111008201",2965,162,76,15,891,81,1154,101,5445
"06111008202",3061,323,10,7,977,258,917,155,5708
"06111008302",3686,676,58,0,1141,25,1155,197,6938
"06111008303",2844,173,76,0,852,103,760,173,4981
"06111008304",3783,233,85,0,1246,109,639,51,6146
"06111008305",2425,20,182,0,1074,59,459,0,4219
"06111008306",2423,277,100,0,1072,14,764,64,4714
"06111008401",3762,387,31,11,963,306,804,365,6629
"06111008402",4393,176,71,0,591,10,555,76,5872
"06111008500",6497,494,117,0,1487,56,1377,90,10118
"06111008600",4381,2188,183,145,1354,506,4530,2692,15979
"06111008700",3724,639,102,21,1381,258,3961,740,10826
"06111008800",3301,195,93,37,1341,0,3333,96,8396
"06111008900",2801,211,13,0,625,40,2878,212,6780
"06111009100",2081,1269,124,25,926,336,2823,1529,9113
"06111980000",0,0,0,0,0,0,0,0,0
"06111990100",0,0,0,0,0,0,0,0,0
"06113010101",3291,965,126,151,1276,1372,2160,843,10184
"06113010102",3638,1147,150,23,2101,466,2579,345,10449
"06113010201",1942,233,48,44,276,176,662,148,3529
"06113010203",1910,750,47,121,1014,940,1629,1006,7417
"06113010204",2655,639,7,74,1052,611,1144,705,6887
"06113010302",4295,224,542,147,1788,446,1130,435,9007
"06113010310",3191,412,145,16,1847,166,1207,310,7294
"06113010312",3308,162,133,7,1141,59,966,16,5792
"06113010401",2983,366,34,7,626,237,526,392,5171
"06113010402",2030,11,425,13,1163,325,537,63,4567
"06113010501",721,452,21,0,818,555,107,165,2839
"06113010505",3566,203,38,0,1151,125,603,44,5730
"06113010508",1479,353,89,45,327,115,151,9,2568
"06113010509",2043,330,44,93,644,317,554,34,4059
"06113010510",2444,488,35,15,1122,1110,290,93,5597
"06113010511",1738,293,24,7,749,412,204,70,3497
"06113010512",1498,506,5,11,1012,308,354,180,3874
"06113010513",1415,660,0,43,370,280,75,137,2980
"06113010602",2467,969,208,218,784,808,764,211,6429
"06113010605",1903,178,10,0,1255,131,240,202,3919
"06113010606",4890,601,60,140,955,641,774,451,8512
"06113010607",2708,113,29,1,1197,153,542,7,4750
"06113010608",2417,620,60,31,1076,1855,427,338,6824
"06113010701",2525,1066,27,2,693,531,332,106,5282
"06113010703",1472,554,15,34,605,1405,169,435,4689
"06113010704",1194,468,0,4,343,329,140,120,2598
"06113010800",2739,479,4,31,461,229,1738,487,6168
"06113010901",3784,592,53,8,1144,392,2911,719,9603
"06113010902",3504,367,39,273,1590,76,2710,536,9095
"06113011001",3178,959,16,0,986,203,1556,659,7557
"06113011002",2544,274,16,0,360,38,647,58,3937
"06113011101",2060,244,17,9,714,96,1485,173,4798
"06113011102",2838,647,96,6,1065,168,2582,525,7927
"06113011103",1671,197,9,56,986,263,1372,185,4739
"06113011203",2208,0,0,0,317,0,495,0,3020
"06113011204",3572,472,0,0,1010,43,1491,415,7003
"06113011205",4397,401,41,0,2813,300,4097,555,12604
"06113011206",4570,292,19,0,1792,73,2160,163,9069
"06113011300",5589,385,0,0,1976,647,3240,757,12594
"06113011400",2405,328,100,0,590,230,1138,402,5193
"06113011500",3162,352,358,0,891,175,1756,302,6996
"06115040100",2117,903,284,194,631,276,923,360,5688
"06115040200",3866,1579,290,36,870,762,865,919,9187
"06115040301",1479,838,30,109,850,410,1016,482,5214
"06115040302",921,576,0,34,680,149,569,278,3207
"06115040303",3628,333,31,33,1815,908,1368,536,8652
"06115040400",2260,1242,25,51,1020,497,1191,443,6729
"06115040500",1536,657,0,0,1175,178,1215,354,5115
"06115040600",2849,1489,70,0,2060,160,1898,219,8745
"06115040700",7689,353,340,179,2761,225,2784,250,14581
"06115040800",2684,321,0,54,766,327,603,321,5076
"06115040901",1738,496,0,7,705,199,607,32,3784
"06115040902",888,99,148,5,289,39,126,11,1605
"06115041000",5013,572,96,0,870,158,458,136,7303
"06115041100",3016,638,3,32,386,274,180,238,4767
"08001007801",1065,1049,120,352,628,864,1059,1215,6352
"08001007802",1040,1166,207,511,359,589,1133,1704,6709
"08001007900",2469,1457,473,612,1148,392,2552,1633,10736
"08001008000",3152,436,907,359,718,249,2366,429,8616
"08001008100",336,240,14,12,111,67,98,43,921
"08001008200",3096,257,530,64,726,40,1677,187,6577
"08001008308",2571,880,509,952,788,296,1662,1137,8795
"08001008309",1778,605,96,130,452,335,1238,779,5413
"08001008353",3207,245,990,27,1031,10,1879,221,7610
"08001008401",3540,275,14,0,270,11,480,12,4602
"08001008402",3925,349,178,0,320,0,212,0,4984
"08001008505",5193,642,107,0,593,190,1488,410,8623
"08001008506",3859,1143,133,46,230,64,1245,567,7287
"08001008507",5100,549,0,20,889,199,1869,386,9012
"08001008508",4246,187,180,0,426,0,1168,0,6207
"08001008523",6318,329,431,19,510,0,1070,69,8746
"08001008524",6530,163,82,0,894,0,1596,0,9265
"08001008526",5631,124,133,15,786,0,960,30,7679
"08001008529",6301,363,238,20,777,201,1144,90,9134
"08001008533",6023,456,138,46,382,82,2065,126,9318
"08001008534",3733,39,10,0,751,0,1213,12,5758
"08001008535",2812,87,55,0,193,149,1175,0,4471
"08001008536",2303,117,51,0,257,0,549,77,3354
"08001008537",4071,431,8,0,1142,0,1775,284,7711
"08001008538",4492,68,383,0,689,14,805,45,6496
"08001008539",6067,117,318,0,1808,0,2519,24,10853
"08001008540",5071,89,240,0,994,0,1508,40,7942
"08001008541",3800,130,145,0,359,0,231,0,4665
"08001008542",5502,221,237,0,909,0,1528,14,8411
"08001008543",5633,188,9,0,949,109,2281,165,9334
"08001008544",3642,17,14,0,573,0,417,8,4671
"08001008545",5541,350,106,0,856,46,1257,2,8158
"08001008546",2026,305,39,0,553,0,560,42,3525
"08001008547",3135,0,0,0,141,0,557,0,3833
"08001008548",1043,221,0,0,209,0,324,17,1814
"08001008549",3449,72,16,0,708,22,1093,0,5360
"08001008550",6013,413,78,0,1151,116,1224,109,9104
"08001008551",770,33,29,0,221,0,111,0,1164
"08001008603",1275,526,0,0,315,101,1063,484,3764
"08001008604",2542,318,31,0,836,16,1946,113,5802
"08001008605",2927,98,0,0,469,7,1063,14,4578
"08001008606",4874,483,0,2,976,370,3866,705,11276
"08001008705",2752,871,126,49,464,288,1891,836,7277
"08001008706",3010,761,0,1,703,521,2340,1004,8340
"08001008709",3424,2190,38,126,1561,934,3111,2592,13976
"08001008801",2476,1016,62,62,1077,183,2148,849,7873
"08001008802",2359,714,107,0,1059,86,2138,625,7088
"08001008901",1257,627,49,5,484,187,1078,691,4378
"08001009001",3132,354,22,160,805,208,2294,298,7273
"08001009002",6296,1630,347,0,1252,63,4485,1262,15335
"08001009101",3482,344,28,0,338,124,2041,219,6576
"08001009103",2646,274,0,0,371,99,1750,198,5338
"08001009104",3694,1121,35,0,895,9,2272,948,8974
"08001009202",3159,537,25,9,614,115,2172,562,7193
"08001009203",2370,931,19,0,465,259,1579,895,6518
"08001009204",4716,136,191,16,1543,81,2390,204,9277
"08001009206",1620,32,0,0,316,41,602,9,2620
"08001009207",2978,372,18,0,430,239,1445,431,5913
"08001009304",3532,616,102,14,760,475,1545,682,7726
"08001009306",2559,563,0,0,595,46,1472,536,5771
"08001009307",2588,600,52,0,174,66,1278,432,5190
"08001009308",2900,601,0,0,651,238,2320,550,7260
"08001009309",2451,437,3,162,594,29,1434,237,5347
"08001009310",4293,1319,27,39,422,79,2438,1194,9811
"08001009316",4213,871,19,2,954,273,2655,858,9845
"08001009318",3760,1196,245,1,535,312,2598,1101,9748
"08001009319",1422,393,32,3,205,82,1003,272,3412
"08001009320",1584,1038,18,16,277,104,717,893,4647
"08001009321",2440,400,46,5,583,245,1208,372,5299
"08001009322",2332,470,10,6,743,99,1109,192,4961
"08001009323",2475,812,120,30,408,41,789,477,5152
"08001009325",3553,291,130,0,517,33,701,0,5225
"08001009326",1926,7,67,22,375,49,151,0,2597
"08001009327",2877,506,5,29,696,488,785,715,6101
"08001009401",3393,388,58,0,1060,66,1524,157,6646
"08001009406",3851,534,43,86,312,52,927,310,6115
"08001009407",3598,1020,0,13,549,97,1703,572,7552
"08001009408",3485,18,104,23,535,0,394,0,4559
"08001009409",4432,133,35,0,480,246,249,256,5831
"08001009410",2678,260,11,0,224,37,428,38,3676
"08001009411",2472,88,41,0,198,0,525,0,3324
"08001009501",1701,647,50,10,515,196,1086,732,4937
"08001009502",3283,467,0,0,749,72,2326,433,7330
"08001009553",1914,389,0,0,548,219,1479,417,4966
"08001009603",4492,714,162,44,192,186,1669,220,7679
"08001009604",2761,966,46,1,396,236,845,758,6009
"08001009606",1350,795,9,0,171,157,726,827,4035
"08001009607",2971,298,28,13,966,227,1436,415,6354
"08001009608",2025,109,11,0,775,17,782,71,3790
"08001009751",1572,806,1,1,902,423,1468,633,5806
"08001009752",1989,166,32,0,972,55,2136,44,5394
"08001015000",1862,428,0,0,163,41,741,295,3530
"08001060000",4302,166,0,0,642,0,429,0,5539
"08001060100",4647,298,75,0,1394,0,697,96,7207
"08001060200",2711,407,6,18,768,60,676,200,4846
"08001061200",1164,0,7,0,59,0,128,0,1358
"08001988700",0,0,0,0,0,0,0,0,0
"08003960000",1032,239,0,0,291,20,210,123,1915
"08003960100",1951,438,1,0,320,38,743,283,3774
"08003960200",3998,1725,0,58,594,158,1725,805,9063
"08003960300",1853,1099,24,69,837,80,1964,876,6802
"08005004951",903,716,52,0,172,49,355,331,2578
"08005004952",1308,506,170,0,333,164,340,250,3071
"08005005551",1200,613,12,419,871,288,1263,554,5220
"08005005552",1405,333,59,0,388,198,739,291,3413
"08005005553",2617,333,116,82,314,426,612,452,4952
"08005005611",4042,360,49,0,309,127,384,101,5372
"08005005612",2782,360,8,0,416,41,268,129,4004
"08005005614",2924,143,40,12,66,0,70,14,3269
"08005005619",4248,121,0,0,105,0,496,0,4970
"08005005620",2237,257,8,7,198,0,375,31,3113
"08005005621",2922,94,0,0,148,0,162,3,3329
"08005005622",2070,157,24,0,197,0,68,0,2516
"08005005623",3320,245,1,0,345,28,163,10,4112
"08005005624",1961,75,0,0,234,0,145,0,2415
"08005005625",2548,157,11,1,100,0,260,1,3078
"08005005626",3132,142,12,0,146,31,261,0,3724
"08005005627",4027,117,8,0,260,14,69,0,4495
"08005005628",4658,212,0,0,255,211,235,158,5729
"08005005629",2157,0,14,0,60,0,0,0,2231
"08005005630",4774,240,18,44,234,0,225,0,5535
"08005005631",2771,95,10,1,210,12,393,12,3504
"08005005632",2707,43,198,0,371,0,233,0,3552
"08005005633",2789,170,30,0,213,0,209,10,3421
"08005005634",2547,131,63,0,172,0,131,0,3044
"08005005635",4552,271,59,15,99,0,46,24,5066
"08005005636",1832,10,0,0,36,5,78,0,1961
"08005005700",2701,562,38,10,150,231,528,351,4571
"08005005800",1938,112,28,0,159,0,298,6,2541
"08005005951",3153,589,87,35,445,23,238,15,4585
"08005005952",2462,270,171,11,294,31,273,56,3568
"08005006000",1886,302,7,9,154,291,184,434,3267
"08005006100",2132,336,24,10,50,62,212,45,2871
"08005006200",2326,285,0,8,280,41,258,120,3318
"08005006300",2120,118,25,0,172,0,342,46,2823
"08005006400",1865,254,0,18,254,327,388,312,3418
"08005006501",1061,400,10,16,297,71,147,31,2033
"08005006502",2527,457,0,49,208,108,405,125,3879
"08005006601",3380,807,82,31,506,139,909,459,6313
"08005006603",2869,296,0,0,144,49,335,31,3724
"08005006604",3138,461,27,0,119,83,346,104,4278
"08005006704",3802,35,120,74,343,0,104,0,4478
"08005006705",1572,60,3,0,117,0,39,0,1791
"08005006706",4610,165,0,0,385,119,270,9,5558
"08005006707",3807,371,113,95,412,75,186,17,5076
"08005006708",4068,173,86,13,334,27,293,12,5006
"08005006709",4560,186,21,0,436,13,207,38,5461
"08005006711",3495,68,19,0,417,12,106,2,4119
"08005006712",1324,19,0,0,69,0,93,0,1505
"08005006713",792,109,32,0,433,0,133,0,1499
"08005006808",4848,222,45,0,329,0,72,6,5522
"08005006815",2993,165,139,0,962,74,595,13,4941
"08005006854",1847,138,112,26,139,0,54,65,2381
"08005006855",3767,157,0,0,1225,58,168,151,5526
"08005006856",5049,263,287,96,904,60,659,91,7409
"08005006857",2077,0,0,0,102,0,44,0,2223
"08005006858",3139,416,159,0,567,11,895,39,5226
"08005007101",4356,330,29,0,199,77,235,108,5334
"08005007103",1363,152,7,0,119,6,79,27,1753
"08005007104",3080,163,743,0,1175,28,757,36,5982
"08005007105",2349,138,296,0,541,129,470,135,4058
"08005007106",3679,108,252,103,409,0,781,0,5332
"08005007107",3785,140,122,0,786,14,669,14,5530
"08005007201",1126,805,482,174,681,258,884,737,5147
"08005007202",1823,875,565,193,587,126,1487,644,6300
"08005007301",866,116,409,320,766,166,1193,143,3979
"08005007302",1935,1037,412,272,476,825,1953,1405,8315
"08005007400",2745,952,646,77,908,501,2442,1250,9521
"08005007500",1271,485,330,92,288,203,728,642,4039
"08005007600",2093,326,318,236,132,85,1116,227,4533
"08005007702",2466,465,486,229,644,75,1609,357,6331
"08005007703",1593,701,719,252,602,892,667,1018,6444
"08005007704",1623,586,1209,508,446,366,1078,862,6678
"08005015100",2146,103,22,9,103,0,186,7,2576
"08005080000",1520,327,441,370,627,45,533,322,4185
"08005080100",2122,569,860,323,405,0,1142,461,5882
"08005080200",2866,260,531,134,849,197,831,75,5743
"08005080300",3633,425,379,0,769,97,478,77,5858
"08005080400",3399,232,557,120,316,42,681,13,5360
"08005080500",1934,280,248,42,550,59,274,46,3433
"08005080600",1807,388,296,60,458,111,522,150,3792
"08005080700",2404,766,1159,118,686,179,1052,695,7059
"08005080800",1412,420,251,209,512,129,902,403,4238
"08005080900",2500,500,396,82,532,78,961,482,5531
"08005081000",2269,728,1166,240,774,559,1947,985,8668
"08005081100",1863,242,1902,625,707,275,911,269,6794
"08005081200",1879,302,811,396,757,183,829,139,5296
"08005081300",1648,46,637,112,449,176,825,61,3954
"08005081400",2793,334,268,19,626,0,652,186,4878
"08005081500",2653,183,15,0,62,21,37,21,2992
"08005081600",3515,78,219,25,555,12,494,12,4910
"08005081700",2089,181,83,31,436,6,77,155,3058
"08005081800",2324,1390,444,158,685,324,1906,1537,8768
"08005081900",2441,674,1081,461,1358,395,1884,738,9032
"08005082000",1229,568,738,281,777,94,1041,470,5198
"08005082100",3678,341,675,201,1436,514,1800,582,9227
"08005082200",3172,123,938,142,1140,168,983,199,6865
"08005082300",1732,304,520,189,483,683,523,790,5224
"08005082400",2265,351,503,160,972,234,1020,386,5891
"08005082500",1760,123,259,22,109,5,266,5,2549
"08005082600",2326,113,1126,305,1106,289,953,269,6487
"08005082700",1591,164,660,0,620,25,493,25,3578
"08005082800",2782,96,1057,49,872,99,691,91,5737
"08005082900",2691,53,797,314,484,9,892,9,5249
"08005083000",2280,171,459,0,528,36,495,25,3994
"08005083100",4285,56,813,182,1375,49,1379,49,8188
"08005083200",6033,291,915,185,1435,201,909,0,9969
"08005083300",2858,314,604,14,634,0,541,150,5115
"08005083400",4273,323,478,184,1154,21,1291,141,7865
"08005083500",2627,351,905,145,1053,449,818,158,6506
"08005083600",2045,504,440,111,367,0,203,103,3773
"08005083700",3186,190,290,40,243,111,579,28,4667
"08005083800",1529,207,458,76,166,0,451,37,2924
"08005083900",1997,335,186,28,371,0,327,9,3253
"08005084000",1991,179,50,0,329,0,490,0,3039
"08005084100",3013,110,378,72,815,19,870,9,5286
"08005084200",2799,148,290,44,549,119,721,159,4829
"08005084300",2477,260,397,34,285,31,204,169,3857
"08005084400",1366,257,155,38,867,367,265,275,3590
"08005084500",1718,110,161,83,435,109,641,83,3340
"08005084600",3650,222,584,100,762,140,715,155,6328
"08005084700",3524,211,422,162,415,95,546,165,5540
"08005084800",2676,152,230,189,562,0,281,85,4175
"08005084900",2527,34,167,0,401,0,114,0,3243
"08005085000",1105,14,16,0,454,0,193,0,1782
"08005085100",4753,224,525,0,984,207,428,0,7121
"08005085200",2452,3,37,2,405,17,91,0,3007
"08005085300",1551,59,204,26,361,10,157,0,2368
"08005085400",3446,169,341,30,703,32,505,22,5248
"08005085500",3686,211,216,0,893,76,525,0,5607
"08005085600",2639,60,85,0,608,33,485,25,3935
"08005085700",3263,103,390,16,697,115,1070,60,5714
"08005085800",1406,109,52,0,118,13,61,0,1759
"08005085900",2029,35,484,0,731,0,457,0,3736
"08005086000",5438,289,809,176,1313,117,706,238,9086
"08005086100",3316,128,543,39,753,0,727,0,5506
"08005086200",4518,250,363,99,932,13,420,0,6595
"08005086300",2488,215,86,0,808,115,915,5,4632
"08005086400",2033,27,0,0,116,0,63,0,2239
"08005086500",3860,114,71,0,740,0,424,0,5209
"08005086600",3872,169,164,0,292,0,104,0,4601
"08005086700",2966,0,91,0,628,0,135,0,3820
"08005086800",2644,757,444,822,598,145,233,177,5820
"08005086900",1277,278,709,319,380,208,147,7,3325
"08005087000",1890,598,895,313,873,114,1084,215,5982
"08005087100",1514,321,268,111,222,44,549,80,3109
"08005087200",2081,355,572,414,509,6,177,12,4126
"08005087300",4358,931,643,148,963,158,1741,492,9434
"08007940400",1065,199,0,0,190,5,274,5,1738
"08007974200",4414,315,2,1,508,30,866,85,6221
"08007974300",2562,261,22,0,261,168,539,139,3952
"08007974400",1625,154,35,0,130,28,213,27,2212
"08009964600",1463,167,0,0,25,40,159,29,1883
"08009964700",1524,314,5,0,66,30,125,15,2079
"08011966700",3096,740,2,0,206,42,917,392,5395
"08013012101",4361,338,0,0,174,43,144,0,5060
"08013012102",5547,876,14,10,300,262,528,260,7797
"08013012103",2962,293,17,60,241,106,115,89,3883
"08013012104",1904,238,0,0,165,50,156,49,2562
"08013012105",4370,482,32,0,729,12,1195,191,7011
"08013012201",2559,912,6,0,68,10,83,37,3675
"08013012202",3153,2294,6,58,506,75,404,113,6609
"08013012203",4073,1340,13,0,839,204,747,742,7958
"08013012204",1732,1388,18,13,89,42,63,62,3407
"08013012300",645,343,17,35,479,154,97,25,1795
"08013012401",2135,2764,73,0,174,144,53,275,5618
"08013012501",1844,287,30,0,147,80,80,103,2571
"08013012505",3437,511,0,0,185,30,96,11,4270
"08013012507",2623,1324,0,0,331,141,312,77,4808
"08013012508",2016,571,0,33,264,60,116,28,3088
"08013012509",2883,198,9,0,259,34,191,12,3586
"08013012510",4014,351,3,0,257,5,64,9,4703
"08013012511",2661,566,7,14,307,267,208,164,4194
"08013012603",2732,307,13,0,76,11,54,56,3249
"08013012605",639,450,21,0,303,77,115,5,1610
"08013012607",1764,2018,77,57,353,226,168,177,4840
"08013012608",1896,458,67,0,55,83,313,51,2923
"08013012701",4932,138,28,0,215,0,88,10,5411
"08013012705",3009,335,52,4,332,19,204,76,4031
"08013012707",1588,293,8,0,26,7,87,145,2154
"08013012708",4600,319,50,0,256,0,170,64,5459
"08013012709",1693,21,9,0,107,0,175,0,2005
"08013012710",3212,204,0,0,45,210,172,189,4032
"08013012800",9629,398,111,0,878,62,646,0,11724
"08013012903",1838,59,34,0,172,6,71,7,2187
"08013012904",4538,182,154,29,597,0,196,0,5696
"08013012905",2108,196,29,0,265,1,557,21,3177
"08013012907",2265,92,38,0,438,49,310,88,3280
"08013013003",4471,500,35,0,419,82,170,0,5677
"08013013004",2974,149,0,0,495,26,79,0,3723
"08013013005",2871,214,25,0,90,13,217,0,3430
"08013013006",4493,138,0,0,339,32,293,0,5295
"08013013201",1375,127,0,3,81,0,76,14,1676
"08013013202",1265,139,0,0,73,5,32,51,1565
"08013013205",4882,180,0,23,266,25,206,9,5591
"08013013207",3564,312,14,0,356,53,328,163,4790
"08013013208",4174,449,0,36,257,84,61,0,5061
"08013013210",3801,548,14,17,392,199,1444,506,6921
"08013013211",4513,658,75,0,538,294,630,593,7301
"08013013212",3517,186,0,3,925,103,511,54,5299
"08013013213",5430,816,62,0,1031,13,620,574,8546
"08013013302",4169,270,23,12,205,75,473,77,5304
"08013013305",3312,475,6,0,675,19,676,117,5280
"08013013306",3189,536,0,0,261,665,1120,613,6384
"08013013307",2276,393,32,0,346,151,506,325,4029
"08013013308",2477,293,24,0,361,181,315,289,3940
"08013013401",1715,809,0,12,423,259,810,653,4681
"08013013402",6393,511,26,0,703,16,1790,245,9684
"08013013503",2977,1142,149,15,992,421,1920,1164,8780
"08013013505",2238,1073,121,11,659,856,1235,1525,7718
"08013013506",3036,370,0,0,790,7,1053,322,5578
"08013013507",2493,176,7,45,477,39,955,143,4335
"08013013508",5769,167,154,0,761,66,595,0,7512
"08013013601",3689,233,29,0,195,16,249,58,4469
"08013013602",863,20,1,0,56,0,0,0,940
"08013013701",5818,383,49,12,334,20,173,37,6826
"08013013702",5088,475,0,3,101,94,143,0,5904
"08013060600",3975,374,13,0,1070,102,502,42,6078
"08013060700",2704,123,0,0,254,5,87,10,3183
"08013060800",3628,849,38,0,1137,340,1533,789,8314
"08013060900",3355,286,0,8,403,106,363,129,4650
"08013061300",2707,21,63,0,680,0,456,0,3927
"08013061400",3457,121,0,0,288,0,99,0,3965
"08014030000",2712,247,18,0,353,81,402,41,3854
"08014030100",1755,207,44,0,216,0,245,39,2506
"08014030200",1377,163,0,0,77,13,187,0,1817
"08014030300",2735,500,24,0,384,43,434,275,4395
"08014030400",3086,133,0,0,247,0,467,19,3952
"08014030500",4127,177,20,0,809,83,562,0,5778
"08014030600",5349,295,77,0,1065,36,1273,0,8095
"08014030700",2359,224,30,6,317,58,221,0,3215
"08014030800",4744,191,0,16,682,73,786,76,6568
"08014030900",4756,372,23,0,664,17,285,82,6199
"08014031000",4023,164,49,146,182,0,288,9,4861
"08014031100",2123,251,0,13,381,64,281,0,3113
"08014031200",2950,151,26,23,442,201,452,102,4347
"08014031300",1826,41,0,0,60,0,28,13,1968
"08014031400",2451,43,19,0,257,0,99,18,2887
"08014980100",0,0,0,0,0,0,0,0,0
"08014980200",0,0,0,0,0,0,0,0,0
"08014980300",0,0,0,0,0,0,0,0,0
"08015000100",2134,145,0,0,162,14,167,38,2660
"08015000200",3820,547,15,0,155,0,377,98,5012
"08015000300",3158,215,8,0,77,5,221,26,3710
"08015000401",3987,321,0,0,67,16,146,26,4563
"08015000402",1819,95,70,0,64,0,108,0,2156
"08017960600",1945,145,3,0,39,9,224,66,2431
"08019014700",4164,495,28,0,321,0,124,0,5132
"08019014800",1359,184,0,0,23,49,39,133,1787
"08019014900",2016,173,0,0,52,8,72,0,2321
"08021974800",2423,729,5,0,563,242,1656,845,6463
"08021974900",3250,563,0,5,336,46,1671,316,6187
"08023972600",1310,361,0,0,237,49,765,236,2958
"08023972700",963,300,0,0,239,74,987,307,2870
"08025969600",2651,1049,6,0,167,108,787,288,5056
"08027970100",3503,581,12,23,57,9,121,41,4347
"08029964600",3383,477,0,0,76,48,289,31,4304
"08029964700",3321,452,0,6,194,16,265,117,4371
"08029964800",2513,620,0,0,129,12,532,369,4175
"08029964900",4444,880,0,0,89,0,651,282,6346
"08029965000",3976,605,0,0,92,8,307,165,5153
"08029965100",2821,593,0,3,146,135,404,252,4354
"08029965200",3615,652,35,6,108,63,423,68,4970
"08031000102",2508,243,17,17,184,34,642,71,3716
"08031000201",2791,324,10,6,544,428,1930,612,6645
"08031000202",2518,605,25,35,334,346,1533,831,6227
"08031000301",3889,603,0,17,379,25,1309,264,6486
"08031000302",3335,104,85,200,285,25,603,52,4689
"08031000303",4036,600,44,0,225,0,712,212,5829
"08031000401",2424,693,112,39,460,137,986,559,5410
"08031000402",3826,771,86,36,393,72,1146,420,6750
"08031000501",1615,166,19,0,130,38,304,53,2325
"08031000502",3322,903,95,433,744,0,1144,699,7340
"08031000600",1298,571,86,0,615,56,1019,422,4067
"08031000701",2361,697,76,125,319,258,1315,661,5812
"08031000702",2399,1441,138,324,382,537,1570,1426,8217
"08031000800",150,466,19,305,64,385,134,543,2066
"08031000902",2783,875,62,0,878,420,2468,1035,8521
"08031000903",3246,1437,88,0,623,435,2964,1669,10462
"08031000904",2909,1433,16,53,387,46,2411,1263,8518
"08031000905",2057,869,60,26,443,248,1925,925,6553
"08031001000",1855,793,128,56,469,324,1523,1105,6253
"08031001101",1343,690,36,103,332,155,1093,692,4444
"08031001102",2206,349,12,189,297,18,775,167,4013
"08031001301",2428,426,1,2,1029,666,2265,1016,7833
"08031001302",2427,433,31,7,914,211,2269,554,6846
"08031001401",3059,1024,36,28,772,961,2485,1778,10143
"08031001402",2036,469,138,14,1080,399,1907,596,6639
"08031001403",1738,217,103,65,315,104,686,144,3372
"08031001500",1631,632,55,41,315,440,1356,883,5353
"08031001600",4979,1392,321,827,296,182,659,581,9237
"08031001701",3350,831,22,16,286,82,172,91,4850
"08031001702",2138,519,73,135,229,55,182,114,3445
"08031001800",2005,804,9,18,308,97,936,350,4527
"08031001901",1152,374,193,414,245,373,781,482,4014
"08031001902",113,38,0,0,16,0,67,16,250
"08031002000",1201,93,2,125,141,0,47,0,1609
"08031002100",3071,1168,11,64,586,398,906,1236,7440
"08031002300",3304,476,850,831,386,175,819,564,7405
"08031002402",850,224,305,125,139,142,80,263,2128
"08031002403",1390,459,372,342,343,88,422,135,3551
"08031002601",2083,622,100,109,149,78,191,99,3431
"08031002602",1581,334,74,32,225,80,62,141,2529
"08031002701",3017,564,15,67,630,141,811,120,5365
"08031002702",4183,632,118,30,526,74,350,11,5924
"08031002703",3914,519,25,169,259,52,330,159,5427
"08031002801",2414,246,20,0,199,0,241,42,3162
"08031002802",3547,559,16,37,129,125,388,316,5117
"08031002803",3655,320,66,0,263,29,183,64,4580
"08031002901",2178,338,82,9,104,123,145,172,3151
"08031002902",3573,141,23,1,202,0,165,16,4121
"08031003001",4636,232,21,0,360,97,195,0,5541
"08031003002",2294,288,13,11,133,2,192,61,2994
"08031003003",1497,427,0,0,45,77,93,87,2226
"08031003004",3653,877,137,10,291,279,275,46,5568
"08031003101",1027,68,156,135,75,1,230,8,1700
"08031003102",1411,630,114,417,139,32,124,298,3165
"08031003201",3899,760,99,300,275,111,297,105,5846
"08031003202",2436,405,102,18,128,5,202,27,3323
"08031003203",2853,96,53,0,232,0,156,10,3400
"08031003300",2902,173,31,0,143,49,195,9,3502
"08031003401",2125,121,10,0,41,0,77,16,2390
"08031003402",3948,219,15,0,292,8,273,83,4838
"08031003500",3006,1476,165,190,1251,799,3581,2098,12566
"08031003601",2499,1153,382,316,514,152,1969,1176,8161
"08031003602",1587,527,1065,365,820,291,1552,553,6760
"08031003603",1447,225,1186,170,192,30,405,233,3888
"08031003701",2106,233,168,0,134,23,217,142,3023
"08031003702",3314,579,207,69,328,68,261,238,5064
"08031003703",1936,179,134,81,250,25,144,42,2791
"08031003800",4501,669,12,13,264,32,190,57,5738
"08031003901",4335,115,35,0,143,0,208,22,4858
"08031003902",3460,238,3,1,344,0,81,16,4143
"08031004002",3084,160,0,0,111,0,64,6,3425
"08031004003",3618,195,464,0,184,41,413,35,4950
"08031004004",1815,35,77,0,46,0,105,0,2078
"08031004005",1676,686,69,0,340,86,150,83,3090
"08031004006",3450,504,35,23,177,227,124,26,4566
"08031004101",1078,203,893,1014,613,223,780,339,5143
"08031004102",689,333,1382,731,683,110,862,66,4856
"08031004103",3097,19,1465,332,114,102,172,102,5403
"08031004104",1782,63,1608,248,395,197,472,117,4882
"08031004106",7119,180,178,11,736,39,294,0,8557
"08031004107",2800,160,409,28,400,7,243,0,4047
"08031004201",3875,316,239,49,214,74,434,81,5282
"08031004202",2594,145,304,45,382,33,153,11,3667
"08031004301",2910,408,228,60,355,46,386,44,4437
"08031004302",1762,243,128,0,253,27,143,30,2586
"08031004303",3718,28,46,0,222,0,34,0,4048
"08031004304",4807,441,289,50,209,48,718,87,6649
"08031004306",4240,306,234,0,86,0,134,41,5041
"08031004403",1956,863,628,179,452,100,599,632,5409
"08031004404",2158,599,825,1573,794,918,986,364,8217
"08031004405",5915,635,557,389,491,140,361,393,8881
"08031004503",1972,1593,0,0,901,384,2091,1922,8863
"08031004504",1678,435,16,0,844,773,1937,1008,6691
"08031004505",2084,1129,1,2,771,476,2249,1383,8095
"08031004506",1306,839,36,221,1086,345,1777,1031,6641
"08031004601",3379,771,0,11,1459,476,2802,1070,9968
"08031004602",3678,836,13,26,2517,631,4789,1206,13696
"08031004603",3250,571,65,53,776,727,2100,1013,8555
"08031004700",3483,698,0,0,1600,169,2499,763,9212
"08031004801",2054,180,0,0,800,94,997,176,4301
"08031005001",1583,215,90,325,263,0,113,86,2675
"08031005002",3581,914,663,688,838,172,429,202,7487
"08031005102",2808,167,67,34,171,151,467,151,4016
"08031005104",1550,597,146,25,328,242,487,227,3602
"08031005200",2386,232,104,0,312,111,290,41,3476
"08031005300",825,166,68,41,183,0,129,64,1476
"08031005502",1140,105,11,51,327,69,537,116,2356
"08031005503",3483,290,8,24,538,137,1372,52,5904
"08031006701",2026,256,30,0,240,17,103,16,2688
"08031006804",1885,50,70,0,76,7,43,0,2131
"08031006809",4815,599,446,353,598,78,393,165,7447
"08031006810",3517,121,534,293,556,137,603,100,5861
"08031006811",4411,320,473,27,728,129,419,69,6576
"08031006812",2488,108,140,23,194,18,220,10,3201
"08031006813",2325,526,596,374,176,127,284,22,4430
"08031006814",2908,568,220,141,492,14,971,264,5578
"08031006901",2310,951,236,223,668,496,739,464,6087
"08031007006",1688,727,412,195,1067,208,651,511,5459
"08031007013",2337,221,509,38,126,52,319,24,3626
"08031007037",1785,585,835,421,413,197,1004,619,5859
"08031007088",2611,316,538,105,480,49,648,62,4809
"08031007089",3210,397,580,145,216,197,297,215,5257
"08031008304",1480,563,432,408,592,85,1576,634,5770
"08031008305",1687,622,664,166,496,457,1650,1062,6804
"08031008306",1317,1089,1312,490,1537,679,2475,1807,10706
"08031008312",1997,837,1312,878,1014,583,2084,1227,9932
"08031008386",1725,410,674,237,914,379,2058,764,7161
"08031008387",2363,756,1345,316,1470,106,2977,588,9921
"08031008388",3506,353,1564,133,1083,24,2925,261,9849
"08031008389",4215,110,2210,383,1681,206,2928,96,11829
"08031008390",3196,405,1798,596,2340,226,3213,528,12302
"08031008391",3660,115,1864,382,1737,0,3735,89,11582
"08031011902",5585,547,9,17,597,257,2826,567,10405
"08031011903",2158,335,0,0,153,0,927,209,3782
"08031012001",1540,164,70,16,193,44,261,70,2358
"08031012010",4129,275,23,0,426,0,843,46,5742
"08031012014",5067,498,0,0,938,0,1326,45,7874
"08031015300",2242,297,275,22,386,65,370,20,3677
"08031015400",2607,373,30,3,254,535,843,386,5031
"08031015500",2050,486,175,65,450,208,609,307,4350
"08031015600",2223,949,88,165,1900,1157,2700,1968,11150
"08031015700",3170,693,56,0,1308,377,2465,682,8751
"08031980000",407,58,392,56,92,63,106,40,1214
"08031980100",0,0,0,0,0,0,0,0,0
"08033000100",1408,236,0,0,41,17,67,10,1779
"08035013901",5776,257,30,0,257,24,179,0,6523
"08035013904",3256,268,57,0,184,83,321,71,4240
"08035013905",3571,93,106,0,97,106,92,107,4172
"08035013907",4157,306,51,38,386,30,293,23,5284
"08035013908",5924,149,0,0,173,0,181,0,6427
"08035013909",5768,181,67,0,352,0,304,110,6782
"08035013910",5650,137,27,0,187,5,286,34,6326
"08035013911",5172,341,101,0,653,37,500,37,6841
"08035014001",5846,77,0,0,471,32,1112,0,7538
"08035014005",3991,109,57,0,386,202,322,0,5067
"08035014006",4861,96,0,0,508,55,326,0,5846
"08035014007",1349,241,64,0,292,14,224,0,2184
"08035014008",5867,152,20,0,294,7,459,0,6799
"08035014009",3397,88,22,49,84,0,176,0,3816
"08035014010",5348,77,60,17,324,0,297,0,6123
"08035014011",1327,22,23,0,449,12,94,0,1927
"08035014012",6632,196,84,0,785,127,882,127,8833
"08035014013",3453,45,168,0,408,0,53,0,4127
"08035014107",3325,106,0,0,154,0,220,0,3805
"08035014108",4694,115,0,0,183,47,217,0,5256
"08035014109",2191,101,32,0,48,6,125,0,2503
"08035014110",4674,393,36,0,362,81,345,153,6044
"08035014112",3749,59,55,0,144,0,178,0,4185
"08035014113",2776,85,71,0,200,0,247,53,3432
"08035014114",3154,29,27,0,349,57,371,0,3987
"08035014115",3654,290,0,0,356,13,187,59,4559
"08035014116",3866,205,121,0,468,8,204,0,4872
"08035014122",6248,144,37,0,245,14,300,14,7002
"08035014123",2443,565,30,0,126,58,261,183,3666
"08035014124",4529,82,84,0,486,0,628,0,5809
"08035014125",2344,77,0,0,136,0,24,0,2581
"08035014126",1249,15,0,0,175,91,52,5,1587
"08035014127",5156,0,26,0,248,53,539,0,6022
"08035014128",4056,79,10,0,514,0,317,0,4976
"08035014129",3303,283,33,0,259,0,120,0,3998
"08035014130",7542,52,135,0,848,19,638,0,9234
"08035014131",3099,70,0,0,176,0,152,0,3497
"08035014132",5134,0,38,20,701,0,183,0,6076
"08035014133",6103,52,92,0,592,0,365,0,7204
"08035014134",4770,154,61,0,908,54,607,33,6587
"08035014135",2250,87,0,0,167,0,221,0,2725
"08035014136",7152,186,94,0,937,300,1065,0,9734
"08035014137",8042,82,100,0,1463,61,377,25,10150
"08035014138",3028,70,20,20,392,0,383,0,3913
"08035014139",3394,25,0,0,583,6,361,0,4369
"08035014140",5042,154,39,0,594,0,263,0,6092
"08035014202",1649,139,0,0,7,0,36,29,1860
"08035014203",5924,115,120,0,414,0,570,0,7143
"08035014204",2012,46,99,0,293,4,453,6,2913
"08035014300",672,34,0,0,16,0,81,0,803
"08035014403",4360,436,57,0,144,0,415,20,5432
"08035014404",2249,104,37,0,96,0,79,48,2613
"08035014405",7202,367,0,0,504,61,595,102,8831
"08035014406",7389,179,35,0,312,0,509,0,8424
"08035014503",4958,168,95,0,238,0,780,60,6299
"08035014504",3547,398,24,0,278,80,594,0,4921
"08035014505",3513,84,9,27,146,0,328,0,4107
"08035014506",3035,155,7,0,215,0,257,62,3731
"08035014602",2160,85,26,0,34,0,37,0,2342
"08035014603",6501,236,11,0,142,0,715,28,7633
"08035014604",3360,389,0,0,343,0,332,287,4711
"08037000100",1168,185,0,0,39,194,592,349,2527
"08037000200",5544,536,0,0,516,0,2154,360,9110
"08037000301",5092,592,0,0,501,197,2625,446,9453
"08037000302",1629,119,0,0,310,0,256,13,2327
"08037000401",4469,376,0,0,254,603,1349,868,7919
"08037000402",3034,223,20,0,317,0,664,175,4433
"08037000403",7159,399,0,19,407,0,1012,272,9268
"08037000501",692,82,0,1,111,0,220,21,1127
"08037000502",3229,372,99,0,121,0,268,212,4301
"08037000503",4744,847,0,1,476,324,1958,1105,9455
"08037000600",1025,102,0,0,149,35,337,67,1715
"08037000701",1004,11,0,0,0,0,0,0,1015
"08037000702",1142,5,59,41,15,0,0,0,1262
"08037000703",2587,402,0,0,300,0,225,20,3534
"08039961100",1528,150,13,0,82,74,26,17,1890
"08039961204",6538,106,2,0,305,0,442,2,7395
"08039961205",1452,225,0,0,29,13,27,73,1819
"08039961206",2567,94,0,28,198,142,155,0,3184
"08039961207",3798,19,13,0,5,26,249,10,4120
"08039961208",3044,493,0,0,18,5,179,55,3794
"08039961209",1954,128,0,0,104,0,76,0,2262
"08041000101",3559,782,143,57,624,220,733,105,6223
"08041000102",2740,233,12,10,362,18,305,43,3723
"08041000202",3484,698,185,22,198,185,367,247,5386
"08041000203",2853,410,8,14,269,161,268,172,4155
"08041000301",2212,289,91,0,300,246,553,315,4006
"08041000302",2011,800,121,0,316,56,424,155,3883
"08041000400",2020,190,29,68,134,52,188,105,2786
"08041000500",1516,262,0,0,86,18,88,10,1980
"08041000600",2531,596,35,0,89,0,245,145,3641
"08041000700",1950,593,36,116,381,119,382,241,3818
"08041000800",1927,233,29,0,271,140,207,128,2935
"08041000900",1837,345,0,2,190,0,131,3,2508
"08041001000",1969,116,0,0,95,8,86,45,2319
"08041001101",914,164,0,7,37,9,103,64,1298
"08041001104",2189,324,10,66,463,39,583,127,3801
"08041001301",1937,402,0,5,106,0,120,85,2655
"08041001302",3571,969,173,0,424,50,367,261,5815
"08041001400",2645,571,25,2,248,54,214,85,3844
"08041001500",1664,249,42,17,156,11,127,0,2266
"08041001600",1058,294,45,0,121,41,172,42,1773
"08041001700",1094,430,68,9,142,101,157,107,2108
"08041001800",1478,170,17,34,103,21,128,42,1993
"08041001900",2828,677,166,54,255,137,384,171,4672
"08041002000",3855,870,253,280,1111,310,922,537,8138
"08041002101",1737,413,96,102,410,92,395,167,3412
"08041002102",3222,654,405,48,687,306,1305,680,7307
"08041002200",1747,231,179,118,321,82,295,50,3023
"08041002300",603,561,89,57,96,71,110,77,1664
"08041002400",3224,737,82,213,220,320,448,558,5802
"08041002501",2893,145,28,0,146,7,138,7,3364
"08041002502",2895,349,172,7,402,0,406,19,4250
"08041002700",1606,566,163,46,446,116,620,361,3924
"08041002800",2692,349,522,161,1164,333,1526,518,7265
"08041002900",2861,1221,516,579,402,494,1370,1060,8503
"08041003000",3701,791,131,179,399,73,492,390,6156
"08041003100",3815,200,56,33,157,25,204,49,4539
"08041003303",3078,1053,271,126,664,86,769,346,6393
"08041003305",6363,131,118,97,415,15,334,0,7473
"08041003306",2728,357,52,0,112,33,21,87,3390
"08041003307",2827,257,109,305,402,0,740,7,4647
"08041003308",4085,281,443,109,1329,97,1189,67,7600
"08041003400",2870,319,23,0,145,182,128,89,3756
"08041003701",7009,179,43,0,390,1,700,0,8322
"08041003702",4140,222,112,0,501,11,273,0,5259
"08041003705",4152,131,127,0,606,159,302,147,5624
"08041003706",4094,262,0,137,228,24,313,80,5138
"08041003707",3542,258,190,34,241,45,220,76,4606
"08041003708",2372,48,20,90,199,109,240,0,3078
"08041003709",5047,145,40,44,473,124,337,0,6210
"08041003801",1147,122,21,0,177,40,54,27,1588
"08041003802",0,0,0,0,0,0,0,0,0
"08041003902",8671,340,235,9,1056,10,1361,0,11682
"08041003905",2799,179,163,0,298,0,481,31,3951
"08041003906",5535,23,209,0,251,64,290,0,6372
"08041003909",5232,801,109,44,200,50,167,52,6655
"08041004008",1108,13,123,0,63,4,357,4,1672
"08041004009",720,165,318,63,292,68,423,35,2084
"08041004100",3381,488,152,77,821,120,688,196,5923
"08041004200",2697,321,177,11,555,95,745,132,4733
"08041004300",4501,519,377,100,697,179,1507,221,8101
"08041004401",5417,1581,502,66,1148,116,1378,268,10476
"08041004402",120,128,131,0,0,0,18,0,397
"08041004403",537,8,395,0,286,0,204,0,1430
"08041004501",2107,1007,292,85,756,226,976,465,5914
"08041004502",3438,193,529,16,589,126,730,44,5665
"08041004503",8028,563,1638,37,1721,113,2277,224,14601
"08041004506",2918,516,291,15,728,88,649,99,5304
"08041004507",2074,203,369,87,482,66,564,33,3878
"08041004508",4114,623,386,227,476,70,926,40,6862
"08041004510",5006,453,779,80,1144,78,1005,58,8603
"08041004511",6236,509,343,0,850,27,801,48,8814
"08041004601",3376,293,11,0,298,28,415,89,4510
"08041004602",2652,627,21,21,291,61,108,206,3987
"08041004603",3335,408,452,0,568,124,495,202,5584
"08041004701",3482,196,144,33,419,68,365,42,4749
"08041004702",1973,74,38,0,208,10,200,10,2513
"08041004703",5000,208,319,127,541,24,479,0,6698
"08041004705",6014,79,222,0,566,0,598,0,7479
"08041004706",4096,276,174,129,454,103,614,165,6011
"08041004800",3896,575,215,41,445,140,734,271,6317
"08041004901",2518,158,103,0,774,42,1016,13,4624
"08041004902",4440,261,213,0,419,10,563,1,5907
"08041005000",3327,827,263,0,755,143,567,125,6007
"08041005104",5651,263,256,0,432,0,1110,21,7733
"08041005105",5062,293,164,189,978,0,660,14,7360
"08041005106",7747,818,330,45,854,531,862,625,11812
"08041005107",5757,219,455,0,1027,0,1377,4,8839
"08041005108",6350,351,359,0,1211,79,961,87,9398
"08041005109",5885,575,216,0,847,76,883,18,8500
"08041005110",2576,343,280,14,557,107,563,52,4492
"08041005111",4603,392,553,10,852,124,1072,30,7636
"08041005201",1339,1063,420,212,746,190,909,663,5542
"08041005202",1028,256,441,142,284,191,345,134,2821
"08041005300",2200,520,582,213,722,626,931,589,6383
"08041005400",1327,580,661,559,1693,1136,1353,1430,8739
"08041005501",3371,202,81,0,590,207,346,192,4989
"08041005502",2727,383,204,98,363,665,509,753,5702
"08041005601",3960,412,146,0,324,20,399,96,5357
"08041005602",2318,259,123,111,80,0,174,14,3079
"08041005700",4139,654,316,58,675,10,465,93,6410
"08041005800",2487,274,101,30,171,77,368,25,3533
"08041005900",4840,255,666,0,537,107,485,21,6911
"08041006000",3678,766,179,109,1059,593,1128,535,8047
"08041006100",1433,621,269,307,598,901,964,1171,6264
"08041006200",2752,807,458,183,765,479,1037,901,7382
"08041006301",3196,445,536,108,708,178,1546,314,7031
"08041006302",2663,754,389,651,515,360,1344,731,7407
"08041006400",3345,806,1021,391,1296,303,1767,621,9550
"08041006501",1706,162,550,87,396,469,807,337,4514
"08041006502",3170,665,925,0,1115,472,1362,703,8412
"08041006600",2248,171,0,0,85,33,152,40,2729
"08041006700",4939,828,30,28,125,72,172,142,6336
"08041006801",3324,396,68,0,513,0,483,0,4784
"08041006802",3274,43,184,0,257,25,251,25,4059
"08041006901",4649,166,233,81,425,12,662,0,6228
"08041006902",4379,227,95,0,632,9,367,0,5709
"08041007000",3552,79,94,9,614,18,90,0,4456
"08041007101",3932,271,262,0,607,31,578,0,5681
"08041007102",7535,401,371,0,1139,0,678,155,10279
"08041007201",5517,230,24,0,748,151,774,42,7486
"08041007202",8560,86,108,17,570,0,427,0,9768
"08041007300",8852,282,81,0,468,38,428,0,10149
"08041007400",7462,233,38,0,539,0,375,0,8647
"08041007500",7178,352,0,0,364,28,172,115,8209
"08041007601",5090,422,93,0,291,12,301,0,6209
"08041007602",2804,342,25,0,382,17,391,17,3978
"08041007700",4126,572,125,16,411,126,611,86,6073
"08041007800",3058,260,89,9,231,64,123,0,3834
"08041007900",1796,121,66,0,147,0,89,13,2232
"08041008000",2966,630,50,73,316,109,346,163,4653
"08043978100",3002,700,0,0,263,3,211,11,4190
"08043978200",2511,688,0,1,294,17,337,103,3951
"08043978300",3800,1037,22,0,205,23,207,7,5301
"08043978400",1537,316,2,1,55,5,189,108,2213
"08043978500",3793,1274,0,0,39,0,120,68,5294
"08043978600",1882,624,0,5,58,56,110,20,2755
"08043978800",1770,608,0,0,47,0,130,100,2655
"08043979000",3387,237,0,0,76,2,59,2,3763
"08043979100",2517,372,0,1,202,30,95,91,3308
"08043979200",1603,12,0,0,47,67,20,0,1749
"08043979400",1920,167,6,0,183,16,92,1,2385
"08043980100",0,0,0,0,0,0,0,0,0
"08043980200",0,0,0,0,0,0,0,0,0
"08043980300",0,0,0,0,0,0,0,0,0
"08045951600",3130,297,0,2,446,0,1036,46,4957
"08045951701",3263,509,63,133,97,185,777,634,5661
"08045951702",2548,479,0,0,122,245,529,320,4243
"08045951802",3038,226,1,0,311,1,689,187,4453
"08045951803",4572,1062,0,0,306,1,1491,749,8181
"08045951804",3192,297,42,104,574,0,874,104,5187
"08045951901",3206,420,15,0,690,31,905,209,5476
"08045951902",6062,320,9,1,405,24,1909,165,8895
"08045952001",3695,683,18,0,219,342,1235,667,6859
"08045952002",6733,470,0,0,443,0,1439,153,9238
"08045952100",5510,683,25,0,323,83,1240,297,8161
"08047013800",4523,510,13,0,305,79,309,53,5792
"08049000100",2371,319,0,0,238,125,394,62,3509
"08049000201",4527,405,76,0,164,86,237,125,5620
"08049000202",5087,651,11,0,352,16,275,8,6400
"08051963600",3154,438,0,0,53,48,33,255,3981
"08051963700",3342,1573,0,0,195,42,394,311,5857
"08051963800",4136,293,5,0,134,10,162,1,4741
"08051963900",761,123,9,0,39,18,17,0,967
"08053973100",760,39,0,0,8,2,21,0,830
"08055960600",1260,309,0,0,736,422,1227,457,4411
"08055960900",2626,484,0,0,241,50,392,72,3865
"08057955600",1214,115,0,0,19,6,149,8,1511
"08059009806",3206,136,16,2,145,28,91,2,3626
"08059009807",1387,124,7,0,22,0,193,0,1733
"08059009808",4960,207,9,0,326,14,346,29,5891
"08059009815",4549,125,0,0,241,30,378,0,5323
"08059009823",3968,175,16,0,282,0,388,20,4849
"08059009824",4240,464,0,6,481,38,772,44,6045
"08059009827",4846,176,48,0,1181,0,456,11,6718
"08059009828",4611,153,0,0,666,8,964,0,6402
"08059009829",1872,31,5,0,78,12,167,0,2165
"08059009830",1884,87,0,24,206,0,319,0,2520
"08059009831",1697,144,0,6,81,83,321,51,2383
"08059009832",2296,212,23,0,135,0,735,9,3410
"08059009833",4304,580,51,11,466,230,799,236,6677
"08059009834",3594,704,44,0,350,0,641,233,5566
"08059009835",3385,155,0,0,66,22,299,13,3940
"08059009836",3782,82,24,0,43,0,207,0,4138
"08059009837",2416,33,2,0,68,1,65,15,2600
"08059009838",3958,81,0,11,199,12,198,23,4482
"08059009839",2245,49,0,10,65,0,121,26,2516
"08059009840",3345,179,33,0,76,0,257,0,3890
"08059009841",2224,100,15,0,59,0,216,61,2675
"08059009842",2253,146,0,0,393,27,111,7,2937
"08059009843",7023,220,0,0,300,13,416,2,7974
"08059009845",3744,115,0,0,228,0,53,0,4140
"08059009846",4304,242,0,0,66,92,121,92,4917
"08059009847",2872,178,0,0,110,0,62,1,3223
"08059009848",2006,141,18,0,97,0,46,39,2347
"08059009849",4532,782,0,17,312,112,522,28,6305
"08059009850",2282,97,0,0,133,3,196,0,2711
"08059009851",3534,130,8,0,362,0,159,39,4232
"08059009852",3189,59,0,0,432,0,177,21,3878
"08059009900",2116,236,0,0,81,12,234,25,2704
"08059010000",1484,729,0,51,187,158,77,53,2739
"08059010100",3275,554,34,0,159,24,285,75,4406
"08059010205",2091,280,0,0,56,0,77,72,2576
"08059010206",3497,302,0,0,295,15,394,153,4656
"08059010208",4502,268,0,0,625,353,728,170,6646
"08059010209",4806,253,169,0,627,179,1322,178,7534
"08059010210",2695,347,0,8,243,11,329,11,3644
"08059010211",2667,368,21,0,122,17,217,54,3466
"08059010212",3392,656,29,0,299,8,446,391,5221
"08059010213",3532,509,65,52,393,83,782,303,5719
"08059010303",4612,316,132,20,261,53,479,33,5906
"08059010304",2591,40,0,0,180,17,244,0,3072
"08059010305",2715,396,98,1,218,66,455,166,4115
"08059010306",2461,86,29,0,157,2,258,11,3004
"08059010307",4099,364,0,0,291,125,782,173,5834
"08059010308",5020,309,2,0,263,49,454,96,6193
"08059010402",3866,881,52,0,349,176,850,221,6395
"08059010403",3457,1042,0,0,638,293,687,666,6783
"08059010405",1383,423,98,16,236,20,325,45,2546
"08059010406",1416,514,0,0,384,25,908,388,3635
"08059010502",4397,452,0,15,304,37,793,177,6175
"08059010503",4074,443,0,0,321,55,897,41,5831
"08059010504",2743,10,0,0,135,22,165,0,3075
"08059010603",2251,285,2,9,272,52,697,145,3713
"08059010604",1902,241,15,0,111,23,474,52,2818
"08059010701",3308,327,0,17,135,22,328,46,4183
"08059010702",3240,795,40,0,477,132,939,657,6280
"08059010801",2106,106,0,0,153,41,366,113,2885
"08059010901",3552,476,25,0,257,34,608,66,5018
"08059010902",1492,460,0,23,356,72,740,289,3432
"08059011000",3745,702,21,0,264,249,792,221,5994
"08059011100",4038,1134,69,30,680,504,1497,509,8461
"08059011202",3643,186,18,0,387,19,678,24,4955
"08059011300",2659,302,0,0,120,234,531,175,4021
"08059011401",1643,651,377,8,230,162,888,563,4522
"08059011402",2189,550,2,34,246,229,529,176,3955
"08059011550",3687,1722,43,20,552,246,1274,734,8278
"08059011601",2087,1148,78,0,233,57,681,982,5266
"08059011602",2527,1011,9,0,425,141,813,835,5761
"08059011701",4023,397,39,10,281,0,1068,167,5985
"08059011702",4282,513,34,0,392,16,720,266,6223
"08059011708",3334,257,2,70,442,69,625,79,4878
"08059011709",3155,107,51,0,182,24,575,11,4105
"08059011710",2974,249,17,0,327,13,295,0,3875
"08059011711",3339,142,21,0,250,14,533,0,4299
"08059011712",3690,225,54,0,143,7,343,0,4462
"08059011720",4186,275,0,36,463,0,288,14,5262
"08059011721",2226,199,0,0,177,17,178,34,2831
"08059011723",2347,318,0,0,397,30,256,32,3380
"08059011724",4127,87,22,0,347,0,252,0,4835
"08059011725",1382,49,31,0,140,1,88,15,1706
"08059011726",4879,366,33,0,361,0,313,0,5952
"08059011727",3275,104,7,0,118,0,380,27,3911
"08059011728",2415,20,41,0,162,0,284,1,2923
"08059011729",3055,401,14,1,217,22,659,232,4601
"08059011730",2761,290,179,0,127,77,772,95,4301
"08059011731",3231,135,0,0,325,97,619,72,4479
"08059011732",3495,657,111,0,510,84,549,64,5470
"08059011733",889,179,8,0,198,51,104,37,1466
"08059011803",4009,475,72,70,707,119,2093,306,7851
"08059011804",3172,254,19,0,471,45,1061,0,5022
"08059011805",3607,367,77,0,457,97,1188,97,5890
"08059011806",3182,601,102,165,371,34,1070,348,5873
"08059011904",1590,141,32,0,190,0,364,0,2317
"08059011951",2263,312,14,96,276,15,556,129,3661
"08059012022",5268,185,50,0,199,0,637,0,6339
"08059012023",2886,194,77,0,380,0,399,0,3936
"08059012024",4794,97,47,0,217,0,469,0,5624
"08059012026",2860,275,11,0,148,0,157,11,3462
"08059012027",2622,104,0,0,11,25,235,25,3022
"08059012030",3466,82,10,7,50,18,54,0,3687
"08059012031",3711,118,21,0,171,0,600,0,4621
"08059012032",2444,87,0,0,31,3,41,3,2609
"08059012033",2894,70,0,0,85,0,90,0,3139
"08059012034",3410,22,0,0,166,0,204,12,3814
"08059012035",5268,147,19,0,201,37,257,0,5929
"08059012036",3748,60,0,0,253,0,179,0,4240
"08059012037",2976,81,0,0,121,0,162,13,3353
"08059012038",2919,167,68,13,235,0,411,95,3908
"08059012039",4704,126,29,2,434,0,791,0,6086
"08059012041",4289,310,27,1,534,30,739,30,5960
"08059012042",3411,62,16,0,547,35,533,35,4639
"08059012043",4838,197,132,0,232,12,492,0,5903
"08059012044",3136,216,52,0,204,0,416,23,4047
"08059012045",5300,108,0,0,492,0,361,0,6261
"08059012046",1994,63,10,0,210,0,626,9,2912
"08059012047",3377,181,76,35,369,55,687,6,4786
"08059012048",2125,81,0,0,164,21,296,0,2687
"08059012049",3128,43,65,0,317,29,290,0,3872
"08059012050",3299,141,33,0,458,0,397,0,4328
"08059012051",3226,114,18,0,160,5,179,0,3702
"08059012052",4973,207,78,0,326,0,657,0,6241
"08059012053",3509,158,85,92,223,11,457,0,4535
"08059012054",3808,132,0,0,268,0,263,9,4480
"08059012055",3333,59,0,2,139,0,274,3,3810
"08059012057",5520,107,12,0,375,45,469,48,6576
"08059012058",3195,301,4,0,87,0,106,0,3693
"08059012059",2954,41,178,1,45,12,364,0,3595
"08059012060",2932,402,58,19,87,20,336,296,4150
"08059015800",2715,271,0,33,607,28,614,28,4296
"08059015900",2782,191,19,0,203,79,698,107,4079
"08059060300",3493,136,60,0,728,31,353,41,4842
"08059060400",3304,154,38,0,278,88,426,40,4328
"08059060500",3352,150,98,0,418,48,281,20,4367
"08059980000",0,0,0,0,0,0,0,0,0
"08059980400",0,0,0,0,0,0,0,0,0
"08061960100",1128,242,0,0,26,1,62,5,1464
"08063962100",4255,517,0,0,61,0,781,142,5756
"08063962200",1106,319,0,0,23,16,123,202,1789
"08063962300",947,173,1,0,4,2,37,33,1197
"08065961700",3834,252,48,0,303,231,582,265,5515
"08065961900",1277,432,20,0,678,117,1284,324,4132
"08067940300",3514,320,2,1,1563,338,1143,153,7034
"08067940400",5024,434,2,0,353,68,522,64,6467
"08067970600",7056,673,14,25,324,0,485,25,8602
"08067970701",4005,306,14,0,145,8,419,8,4905
"08067970703",4140,440,16,11,616,0,557,243,6023
"08067970704",3103,470,31,0,95,85,174,36,3994
"08067970800",4005,642,0,6,608,30,592,125,6008
"08067970900",3413,322,6,0,156,115,385,0,4397
"08067971000",2757,314,4,2,159,59,36,55,3386
"08067971100",2776,936,23,18,480,64,599,322,5218
"08069000100",1631,576,14,10,69,51,121,50,2522
"08069000201",1679,1291,10,0,25,60,27,27,3119
"08069000202",1756,589,45,0,142,80,231,128,2971
"08069000300",2339,368,7,0,55,29,98,19,2915
"08069000401",1442,434,8,6,32,61,96,54,2133
"08069000402",1703,705,20,58,154,219,86,136,3081
"08069000503",1650,1812,147,37,276,241,169,176,4508
"08069000504",1371,1053,10,53,346,88,340,63,3324
"08069000505",1255,1542,0,40,313,119,276,237,3782
"08069000506",1867,941,35,17,202,29,214,102,3407
"08069000600",460,443,16,27,124,108,75,68,1321
"08069000700",1971,532,0,3,60,71,62,53,2752
"08069000801",1218,449,0,4,106,23,135,146,2081
"08069000802",809,132,31,0,198,25,313,19,1527
"08069000901",3742,767,0,0,132,19,273,25,4958
"08069000902",2354,759,33,5,104,118,170,313,3856
"08069001003",3811,702,101,0,261,82,214,31,5202
"08069001004",2508,306,0,0,130,0,105,0,3049
"08069001007",2387,461,0,18,387,71,484,86,3894
"08069001008",1441,297,0,0,210,0,113,0,2061
"08069001009",5160,701,0,3,466,2,391,33,6756
"08069001010",2397,57,0,0,22,0,76,0,2552
"08069001104",4315,1094,25,0,300,31,727,154,6646
"08069001106",3842,641,139,0,382,52,149,190,5395
"08069001107",4021,844,12,0,297,223,684,83,6164
"08069001109",3931,527,43,0,272,61,556,16,5406
"08069001110",2822,1729,0,0,177,339,237,146,5450
"08069001111",1084,642,22,25,184,18,0,24,1999
"08069001112",3418,539,0,1,428,44,580,330,5340
"08069001113",3101,303,0,5,240,10,315,17,3991
"08069001114",2113,35,25,0,86,8,83,0,2350
"08069001301",3146,434,0,0,271,24,101,203,4179
"08069001304",1309,661,0,0,479,284,1013,828,4574
"08069001305",1502,456,0,38,146,102,362,232,2838
"08069001306",970,347,0,69,250,253,503,302,2694
"08069001307",3644,147,3,0,279,38,504,26,4641
"08069001308",4117,81,0,0,268,20,518,6,5010
"08069001601",1325,269,0,1,164,109,345,14,2227
"08069001602",3955,332,33,0,343,0,354,98,5115
"08069001603",3967,597,36,15,561,35,647,337,6195
"08069001605",2190,119,56,7,263,24,123,52,2834
"08069001606",2507,86,147,0,440,0,108,0,3288
"08069001607",3421,184,43,0,211,0,327,45,4231
"08069001608",4494,133,0,0,793,8,475,0,5903
"08069001704",6126,856,0,13,599,357,1150,438,9539
"08069001706",5800,418,36,0,431,89,609,89,7472
"08069001707",3693,886,0,0,356,186,373,119,5613
"08069001708",2969,168,0,0,284,0,405,0,3826
"08069001709",12034,532,25,0,654,2,953,0,14200
"08069001804",3133,431,0,0,200,37,323,114,4238
"08069001806",5936,563,78,0,565,0,920,23,8085
"08069001807",4528,269,21,0,343,387,364,415,6327
"08069001808",3997,115,0,0,366,15,141,0,4634
"08069001809",9664,581,149,18,899,15,888,0,12214
"08069001901",2979,543,0,0,83,82,169,71,3927
"08069001902",3774,271,0,0,219,317,277,84,4942
"08069001903",3427,152,0,0,51,50,70,23,3773
"08069002005",4169,340,20,0,401,171,837,259,6197
"08069002007",2490,477,54,0,36,104,180,144,3485
"08069002008",2803,167,0,0,284,48,287,85,3674
"08069002010",2454,51,10,0,26,0,127,0,2668
"08069002011",4878,189,0,0,79,26,328,17,5517
"08069002300",2894,194,10,0,360,40,306,27,3831
"08069002401",949,359,0,0,39,7,49,0,1403
"08069002402",2339,110,114,0,45,4,37,0,2649
"08069002501",7149,634,0,0,291,56,204,419,8753
"08069002502",6805,688,24,13,452,67,691,92,8832
"08069002503",2662,499,11,0,137,0,227,360,3896
"08069002600",5468,447,27,0,414,60,462,94,6972
"08069002700",4302,413,52,1,191,59,415,12,5445
"08069002801",2711,181,4,11,117,0,108,28,3160
"08069002802",5093,313,43,8,100,0,159,0,5716
"08069002803",78,5,0,0,0,13,0,13,109
"08071000100",2355,543,27,0,553,118,1411,238,5245
"08071000200",1680,373,20,5,293,26,898,228,3523
"08071000300",1758,321,0,9,213,10,556,137,3004
"08071000400",1272,354,0,22,181,64,663,323,2879
"08071000500",1195,245,0,0,181,253,746,315,2935
"08071000800",2081,219,0,0,187,37,555,106,3185
"08073961700",1831,288,12,0,18,0,50,0,2199
"08073961800",1467,231,0,0,16,13,69,1,1797
"08075965900",1067,55,3,0,4,0,57,23,1209
"08075966000",2112,312,7,0,7,6,90,0,2534
"08075966100",5559,1660,0,0,689,128,792,872,9700
"08075966200",2477,636,0,4,142,80,563,215,4117
"08075966300",3955,727,80,0,233,11,568,203,5777
"08075966400",1361,168,21,0,20,1,8,0,1579
"08077000200",1509,521,22,8,147,52,355,110,2724
"08077000300",1015,265,0,20,159,0,248,11,1718
"08077000400",2463,421,0,0,466,31,435,67,3883
"08077000500",892,434,0,13,11,27,82,21,1480
"08077000601",3089,630,8,55,151,257,263,161,4614
"08077000602",3458,1169,21,13,518,23,692,500,6394
"08077000700",2920,785,35,0,358,371,595,401,5465
"08077000800",6545,1288,48,5,456,61,673,50,9126
"08077000900",1660,346,50,31,85,24,314,24,2534
"08077001001",3770,362,0,0,123,0,171,150,4576
"08077001002",5019,462,0,0,773,57,594,17,6922
"08077001101",6235,962,11,42,168,218,701,331,8668
"08077001102",4167,365,38,0,144,21,415,126,5276
"08077001200",1858,152,0,0,89,17,121,23,2260
"08077001301",5916,1663,53,10,577,465,1382,598,10664
"08077001302",3629,429,0,0,451,98,695,62,5364
"08077001402",5950,323,0,0,279,0,275,0,6827
"08077001403",2928,274,30,0,62,201,117,193,3805
"08077001404",3877,302,0,0,145,0,116,0,4440
"08077001501",9579,1629,23,0,1202,0,1412,19,13864
"08077001502",6261,479,46,0,327,40,409,40,7602
"08077001600",2921,264,0,0,151,10,172,0,3518
"08077001702",3963,382,13,0,293,14,411,91,5167
"08077001703",3947,555,0,0,172,296,440,296,5706
"08077001705",3908,814,96,0,372,298,1147,304,6939
"08077001706",4228,1714,0,0,355,0,1027,1157,8481
"08077001707",5321,508,36,0,398,0,996,0,7259
"08077001800",2511,339,0,16,75,60,105,68,3174
"08077001900",4329,275,12,48,112,143,135,4,5058
"08079973600",686,41,3,3,23,5,22,0,783
"08081000300",2581,215,0,0,88,8,100,21,3013
"08081000400",3293,504,0,0,257,115,682,125,4976
"08081000500",3874,365,0,9,170,37,573,168,5196
"08081000600",1327,169,0,0,109,93,59,96,1853
"08083941100",84,18,0,0,844,359,46,26,1377
"08083969000",2601,635,0,0,54,11,75,11,3387
"08083969100",2382,284,0,0,135,100,130,58,3089
"08083969200",2405,455,0,0,71,64,158,41,3194
"08083969300",4217,477,0,2,185,220,487,264,5852
"08083969400",2541,679,0,9,607,496,616,238,5186
"08083969600",3396,831,31,0,708,191,525,176,5858
"08085966100",1737,337,0,0,100,44,98,30,2346
"08085966201",2384,292,42,0,110,0,417,0,3245
"08085966202",3141,486,46,9,205,121,989,234,5231
"08085966300",4027,891,0,7,299,480,1516,899,8119
"08085966400",4479,920,15,9,254,418,543,472,7110
"08085966501",2888,442,0,0,0,0,78,118,3526
"08085966502",3196,462,0,10,184,0,566,78,4496
"08085966503",2569,475,27,0,385,0,592,56,4104
"08085966601",3468,519,0,0,456,224,917,294,5878
"08085966602",3848,300,0,0,103,38,125,0,4414
"08087000100",2548,112,5,0,5,0,185,0,2855
"08087000200",2101,265,7,0,127,4,498,157,3159
"08087000300",1231,363,0,0,85,32,610,240,2561
"08087000400",3457,677,348,73,269,71,1248,294,6437
"08087000500",1611,262,189,32,222,169,788,239,3512
"08087000600",4568,723,0,0,452,5,2599,544,8891
"08087000700",4596,478,0,0,445,152,1697,161,7529
"08087000800",1619,163,0,7,45,91,139,97,2161
"08089968000",1123,179,0,0,29,29,164,42,1566
"08089968100",1553,1041,6,8,156,65,992,901,4722
"08089968200",1856,609,35,5,231,0,678,530,3944
"08089968300",3016,783,1,0,72,167,744,540,5323
"08089968400",629,238,0,0,63,16,179,140,1265
"08089968500",1176,201,0,0,69,0,139,81,1666
"08089968600",3091,894,0,7,494,331,1493,880,7190
"08091967600",4144,202,0,0,75,49,114,39,4623
"08093000100",5466,396,0,0,182,199,414,37,6694
"08093000200",3680,88,0,0,89,0,150,0,4007
"08093000300",2243,172,0,0,40,20,121,16,2612
"08093000400",870,344,0,0,0,16,0,0,1230
"08093000500",1938,200,0,0,49,16,18,28,2249
"08095967600",1976,708,1,20,146,44,541,527,3963
"08095967700",1294,81,0,0,47,5,10,0,1437
"08097000100",6445,913,3,0,309,21,313,353,8357
"08097000401",3932,222,41,0,142,0,90,0,4427
"08097000402",2185,365,110,0,178,5,470,167,3480
"08097000500",1919,204,6,0,137,0,134,62,2462
"08099000100",1224,74,0,0,104,4,176,36,1618
"08099000200",1236,857,9,0,284,21,741,581,3729
"08099000300",3512,1046,0,0,111,42,1221,526,6458
"08099000600",998,290,0,0,59,18,237,165,1767
"08099000700",1655,418,0,6,74,32,438,260,2883
"08101000100",1795,274,34,2,417,366,941,508,4337
"08101000200",1079,338,33,0,369,129,930,334,3212
"08101000300",1,15,0,0,0,0,0,0,16
"08101000400",1762,139,29,9,397,243,1010,305,3894
"08101000500",1633,216,56,0,321,49,516,76,2867
"08101000600",885,398,25,0,578,226,913,404,3429
"08101000800",1568,704,21,4,277,306,1339,793,5012
"08101000902",3029,755,172,14,1209,485,2058,944,8666
"08101000903",0,4,0,5,0,3,0,0,12
"08101000904",2835,869,41,19,288,149,1028,465,5694
"08101000905",1288,266,114,41,358,55,757,123,3002
"08101001000",1866,1197,7,53,779,852,1642,1407,7803
"08101001100",686,638,12,1,326,587,694,962,3906
"08101001200",874,519,20,0,221,229,758,568,3189
"08101001400",645,246,0,0,226,107,418,220,1862
"08101001500",1339,657,4,3,182,133,437,405,3160
"08101001600",1327,168,0,0,125,9,398,30,2057
"08101001700",3303,390,16,5,204,88,709,251,4966
"08101001800",1967,178,0,2,218,88,623,185,3261
"08101001900",832,149,8,2,484,44,803,85,2407
"08101002000",1552,709,33,4,561,369,1283,967,5478
"08101002100",844,267,30,34,409,211,980,398,3173
"08101002200",1207,198,0,16,222,59,780,105,2587
"08101002300",1894,606,44,48,451,319,1603,728,5693
"08101002400",1059,192,117,12,310,90,855,194,2829
"08101002500",1695,462,0,22,379,240,1007,335,4140
"08101002600",1501,729,14,66,258,722,765,1233,5288
"08101002700",3123,883,14,27,1099,227,2217,763,8353
"08101002801",3265,730,95,0,1027,158,2365,635,8275
"08101002802",3207,212,22,0,464,269,1209,353,5736
"08101002804",3056,465,8,5,106,92,115,25,3872
"08101002806",2756,189,0,0,198,9,638,9,3799
"08101002807",3422,170,43,9,845,42,2004,88,6623
"08101002808",2337,163,0,0,424,123,854,127,4028
"08101002901",1321,697,95,24,677,422,1100,661,4997
"08101002903",4022,746,372,14,692,403,1930,736,8915
"08101002906",3698,151,0,19,204,46,690,47,4855
"08101002911",2001,185,0,0,435,0,303,81,3005
"08101002912",1123,298,79,13,342,46,542,202,2645
"08101002913",3198,68,61,0,251,33,752,35,4398
"08101002914",2818,208,6,6,436,51,1173,69,4767
"08101002915",2089,303,2,8,212,20,872,56,3562
"08101002916",1918,398,31,6,354,28,445,31,3211
"08101002917",2262,177,13,0,196,0,514,0,3162
"08101002918",5380,275,269,0,329,60,814,142,7269
"08101003001",916,280,89,0,129,8,441,61,1924
"08101003004",1925,208,35,12,232,16,636,12,3076
"08101003103",1581,198,0,15,198,81,820,250,3143
"08101003104",2037,188,0,0,166,31,566,65,3053
"08101003105",2733,206,0,0,155,46,833,81,4054
"08101003106",893,64,1,0,137,7,275,8,1385
"08101003200",2653,206,0,0,226,235,496,355,4171
"08101003500",609,591,5,59,286,219,540,550,2859
"08101003600",946,368,21,36,459,282,796,405,3313
"08101980100",0,0,0,0,0,0,0,0,0
"08103951100",3293,620,0,17,155,59,399,99,4642
"08103951200",2010,278,0,0,87,0,161,19,2555
"08105976700",2982,705,15,0,1084,211,2519,544,8060
"08105976800",946,412,0,0,223,157,542,325,2605
"08105977000",3648,601,33,0,418,141,837,211,5889
"08107000100",1918,118,0,0,6,0,21,0,2063
"08107000200",1750,192,0,0,49,5,258,0,2254
"08107000300",1813,183,0,0,14,4,74,0,2088
"08107000400",2896,143,67,0,25,21,106,57,3315
"08107000500",3568,277,29,0,124,127,480,106,4711
"08107000600",3112,132,0,0,84,40,245,40,3653
"08107000700",3350,642,0,0,250,0,0,0,4242
"08107000800",1840,210,1,0,95,0,104,0,2250
"08109977600",2394,585,4,1,217,92,487,51,3831
"08109977700",1654,445,0,0,351,395,1141,795,4781
"08111972600",493,113,0,0,53,0,103,25,787
"08113968101",1792,199,11,0,12,0,103,0,2117
"08113968102",1473,166,0,0,83,17,360,86,2185
"08113968103",1842,101,0,0,49,0,45,0,2037
"08113968200",1357,284,0,0,59,26,78,0,1804
"08115968300",1799,377,7,0,91,64,265,92,2695
"08117000100",6120,590,82,0,529,89,854,67,8331
"08117000200",5818,1286,41,52,219,896,717,885,9914
"08117000300",2731,284,0,0,196,17,102,0,3330
"08117000401",3389,378,0,0,655,82,1172,3,5679
"08117000402",4185,162,20,0,140,0,163,0,4670
"08119010103",6895,191,0,0,309,0,520,0,7915
"08119010104",1563,466,0,0,65,15,22,0,2131
"08119010105",4900,379,69,0,5,18,94,16,5481
"08119010106",4216,109,107,0,314,0,298,0,5044
"08119010201",2123,329,16,0,277,21,218,36,3020
"08119010202",477,82,0,0,35,4,42,0,640
"08121924100",1786,254,0,0,15,2,54,79,2190
"08121924200",2108,312,0,4,69,26,169,61,2749
"08123000100",1229,744,57,125,94,136,583,337,3305
"08123000200",599,1052,65,122,191,184,392,434,3039
"08123000300",0,0,0,0,0,0,0,0,0
"08123000401",1965,588,0,0,202,39,221,201,3216
"08123000402",1812,556,99,108,433,116,835,441,4400
"08123000501",1483,787,0,0,600,423,1805,1080,6178
"08123000502",1374,912,0,1,936,365,1536,995,6119
"08123000600",484,271,0,0,210,21,609,276,1871
"08123000701",646,387,16,0,444,75,760,399,2727
"08123000703",2868,1939,108,16,1112,757,2608,2070,11478
"08123000704",349,52,11,0,21,0,143,52,628
"08123000705",853,288,0,0,156,142,160,300,1899
"08123000800",880,1416,44,76,290,281,431,626,4044
"08123000900",1896,486,1,0,493,84,675,181,3816
"08123001003",1675,1336,80,381,933,426,1673,984,7488
"08123001004",1698,1432,29,0,639,331,1397,1155,6681
"08123001005",5112,1156,19,21,354,21,2008,446,9137
"08123001006",3670,770,0,0,731,67,2172,514,7924
"08123001100",2994,796,208,2,800,57,1327,402,6586
"08123001201",3263,548,0,0,417,167,1229,345,5969
"08123001202",2147,253,9,33,392,108,554,143,3639
"08123001300",3833,1179,41,0,1031,339,2575,945,9943
"08123001404",2113,742,0,0,263,8,862,422,4410
"08123001405",3340,117,10,0,354,19,1472,46,5358
"08123001406",4260,392,36,60,563,0,841,0,6152
"08123001407",2098,13,0,0,66,0,63,0,2240
"08123001408",1651,55,0,0,83,46,110,46,1991
"08123001409",2248,410,15,0,314,10,312,51,3360
"08123001410",2700,178,22,0,157,0,51,0,3108
"08123001411",2306,180,0,0,105,70,329,140,3130
"08123001412",1812,88,0,0,168,52,101,67,2288
"08123001413",2507,273,0,0,82,39,1089,74,4064
"08123001414",1959,278,0,45,168,0,726,22,3198
"08123001415",3416,59,0,0,164,0,524,0,4163
"08123001416",1908,149,0,0,102,0,244,0,2403
"08123001417",1311,309,4,0,434,50,439,152,2699
"08123001500",5633,221,10,28,168,0,850,15,6925
"08123001600",3597,436,0,0,291,105,785,359,5573
"08123001700",3927,807,0,0,240,33,920,545,6472
"08123001800",3325,641,9,0,244,17,968,398,5602
"08123001902",5279,640,27,0,773,157,1961,579,9416
"08123001905",2961,770,15,0,487,59,2019,496,6807
"08123001906",1060,171,13,0,229,66,515,125,2179
"08123001907",2050,153,8,0,421,11,898,45,3586
"08123001908",1671,441,0,1,432,11,821,284,3661
"08123002004",3109,177,69,0,351,58,1219,125,5108
"08123002005",485,21,0,0,196,0,105,0,807
"08123002006",221,0,0,0,109,0,67,0,397
"08123002007",4359,309,13,0,627,5,154,28,5495
"08123002008",4166,102,23,0,586,0,283,26,5186
"08123002009",1315,47,0,0,23,0,38,0,1423
"08123002010",1466,387,0,0,323,0,464,85,2725
"08123002011",221,0,0,0,9,0,14,0,244
"08123002012",749,81,0,0,31,9,165,23,1058
"08123002013",2676,47,0,0,259,9,183,17,3191
"08123002014",1019,96,0,0,153,0,255,16,1539
"08123002015",611,19,0,0,124,0,150,0,904
"08123002016",2625,207,45,0,165,0,672,64,3778
"08123002017",746,11,0,0,89,10,256,0,1112
"08123002018",658,318,3,0,162,0,217,0,1358
"08123002019",3135,352,19,0,300,116,366,116,4404
"08123002020",4603,31,57,0,491,0,732,0,5914
"08123002021",397,3,0,0,26,0,22,0,448
"08123002101",6035,240,20,0,311,21,1841,37,8505
"08123002102",9666,410,0,0,474,104,1750,159,12563
"08123002103",6918,521,0,0,939,73,1188,223,9862
"08123002203",894,0,0,0,28,0,51,0,973
"08123002204",1808,116,0,0,85,0,115,9,2133
"08123002205",3742,250,49,0,347,20,295,104,4807
"08123002206",2927,233,0,0,296,0,307,23,3786
"08123002207",1697,198,0,0,209,0,63,0,2167
"08123002208",4129,96,24,0,141,14,413,24,4841
"08123002209",1199,15,0,0,3,0,22,0,1239
"08123002210",702,20,18,0,30,0,46,0,816
"08123002300",3705,624,4,0,316,75,731,160,5615
"08123002501",4069,649,5,4,263,61,283,160,5494
"08123002502",5296,512,0,0,152,43,1180,217,7400
"08125963100",3839,423,3,0,114,52,665,93,5189
"08125963200",4689,343,0,0,486,0,1305,41,6864
"09001010101",3670,181,0,0,117,1,145,0,4114
"09001010102",3345,162,73,11,611,5,78,15,4300
"09001010201",2764,50,158,18,264,17,85,17,3373
"09001010202",4469,56,28,0,668,23,611,0,5855
"09001010300",3487,66,0,15,396,0,298,19,4281
"09001010400",4563,131,21,0,513,60,328,8,5624
"09001010500",3466,203,112,21,1245,82,926,0,6055
"09001010600",1357,202,18,11,165,0,281,44,2078
"09001010700",3307,243,109,20,209,82,339,118,4427
"09001010800",2772,167,37,3,253,15,290,64,3601
"09001010900",3763,191,40,57,1046,11,541,0,5649
"09001011000",4629,74,84,9,428,0,336,0,5560
"09001011100",4763,89,0,0,250,0,269,0,5371
"09001011200",1758,72,0,0,108,0,75,0,2013
"09001011300",2335,221,113,50,1063,46,1384,124,5336
"09001020100",1620,385,540,742,734,64,1043,108,5236
"09001020200",3401,111,41,0,109,0,221,19,3902
"09001020300",6207,137,201,0,517,16,167,58,7303
"09001020400",3329,80,0,0,193,0,533,0,4135
"09001020500",3775,47,271,0,248,32,332,0,4705
"09001020600",3579,81,189,0,782,34,700,9,5374
"09001020700",3919,57,31,0,248,34,276,34,4599
"09001020800",2572,118,25,0,150,4,296,41,3206
"09001020900",2951,210,279,199,613,48,579,128,5007
"09001021000",2374,70,232,28,263,0,412,0,3379
"09001021100",3970,154,219,263,714,85,834,18,6257
"09001021200",3537,52,251,32,579,3,484,18,4956
"09001021300",2556,43,479,22,1005,137,1221,28,5491
"09001021400",1925,131,1892,210,2177,763,2468,750,10316
"09001021500",1105,765,1902,389,1977,726,2218,1267,10349
"09001021600",2889,176,635,502,2925,259,966,299,8651
"09001021700",2910,244,774,73,1988,631,1332,592,8544
"09001021801",2272,100,508,185,1255,230,806,211,5567
"09001021802",1978,76,1342,197,891,292,1378,129,6283
"09001021900",3573,428,672,139,752,516,1211,564,7855
"09001022000",1192,68,390,145,834,36,722,27,3414
"09001022100",2564,309,1141,140,3465,477,3952,652,12700
"09001022200",1061,304,545,100,1638,584,2064,727,7023
"09001022300",2422,176,1343,518,1332,502,1754,598,8645
"09001022400",2001,15,40,1,155,0,235,0,2447
"09001030100",3386,74,3,12,118,4,99,4,3700
"09001030200",3205,216,10,0,144,165,87,29,3856
"09001030300",3656,442,0,0,108,6,59,6,4277
"09001030400",3570,208,2,0,259,10,90,0,4139
"09001030500",4645,234,25,7,336,8,193,41,5489
"09001035100",6966,257,148,12,406,0,359,0,8148
"09001035200",3021,40,5,1,78,0,102,0,3247
"09001035300",3400,64,0,0,300,0,154,9,3927
"09001035400",4794,91,0,0,262,0,80,0,5227
"09001042500",3504,48,16,1,618,0,572,0,4759
"09001042600",3355,179,243,26,493,15,656,15,4982
"09001042700",3569,201,463,21,467,48,250,0,5019
"09001042800",3892,137,239,26,490,0,506,27,5317
"09001042900",1470,56,34,0,93,0,210,0,1863
"09001043000",2437,71,282,1,139,0,272,0,3202
"09001043100",4372,42,88,12,401,78,533,33,5559
"09001043200",1708,193,570,112,497,0,513,171,3764
"09001043300",2563,291,344,0,263,0,712,172,4345
"09001043400",2299,273,526,410,522,126,1217,227,5600
"09001043500",2251,64,199,41,182,14,464,5,3220
"09001043600",2518,54,239,0,372,52,465,58,3758
"09001043700",989,328,486,95,141,158,555,394,3146
"09001043800",5164,259,795,520,1775,84,1780,85,10462
"09001043900",4241,188,641,81,364,0,1104,120,6739
"09001044000",2808,415,882,291,577,185,1468,522,7148
"09001044100",1599,536,652,332,245,14,899,208,4485
"09001044200",2268,280,510,30,144,0,714,31,3977
"09001044300",3272,111,71,81,292,0,740,41,4608
"09001044400",1422,337,1012,356,140,267,741,510,4785
"09001044500",603,45,1087,438,381,217,807,230,3808
"09001044600",3221,90,18,13,85,0,50,16,3493
"09001045101",3923,147,11,0,298,13,70,7,4469
"09001045102",5109,310,0,13,488,12,238,23,6193
"09001045200",2175,53,11,0,127,4,67,4,2441
"09001045300",2127,86,7,6,208,5,18,0,2457
"09001045400",2677,9,49,0,276,9,61,0,3081
"09001050100",3448,48,14,0,512,0,181,9,4212
"09001050200",3524,51,26,15,439,0,144,0,4199
"09001050300",7255,368,57,1,499,0,206,15,8401
"09001050400",2025,101,0,32,225,9,116,0,2508
"09001050500",4072,176,85,7,309,20,103,32,4804
"09001050600",2933,89,16,0,174,16,79,0,3307
"09001055100",5213,48,107,15,371,39,92,6,5891
"09001055200",4200,80,8,0,171,0,206,0,4665
"09001060100",2361,15,36,0,176,0,202,0,2790
"09001060200",3753,76,9,0,353,55,139,0,4385
"09001060300",3446,79,71,0,278,0,315,71,4260
"09001060400",4230,274,20,0,183,1,139,1,4848
"09001060500",2716,46,0,0,129,0,156,0,3047
"09001060600",2044,150,0,0,99,0,10,0,2303
"09001060700",4671,199,0,0,140,0,300,0,5310
"09001060800",1915,36,0,0,68,0,144,0,2163
"09001060900",2440,32,0,0,111,0,138,0,2721
"09001061000",2829,234,54,13,539,0,155,0,3824
"09001061100",3125,80,35,25,248,12,54,37,3616
"09001061200",1643,30,7,0,400,38,192,0,2310
"09001061300",2405,195,38,0,519,38,105,19,3319
"09001061400",1670,202,191,58,464,227,237,0,3049
"09001061500",4051,283,56,0,173,60,133,90,4846
"09001061600",4716,109,0,10,238,0,59,0,5132
"09001070100",3790,95,44,0,649,216,603,207,5604
"09001070200",1124,171,1211,254,1052,261,1060,326,5459
"09001070300",136,183,291,323,139,151,292,303,1818
"09001070400",455,111,85,135,341,43,68,74,1312
"09001070500",476,223,461,410,244,327,465,428,3034
"09001070600",400,318,664,161,289,125,477,220,2654
"09001070900",452,191,582,423,341,409,684,557,3639
"09001071000",808,217,1295,290,989,467,1481,643,6190
"09001071100",1241,359,1478,349,1056,395,1588,376,6842
"09001071200",959,399,1570,736,945,630,1451,803,7493
"09001071300",590,711,971,605,560,305,632,990,5364
"09001071400",1692,366,565,248,702,240,1157,550,5520
"09001071600",424,741,205,572,217,449,439,1214,4261
"09001071900",1069,644,881,425,479,218,1003,735,5454
"09001072000",1288,397,793,341,318,94,896,317,4444
"09001072100",2688,395,1292,71,643,81,1452,23,6645
"09001072200",2196,495,728,169,265,138,1022,209,5222
"09001072300",2249,900,1160,108,1164,150,1997,654,8382
"09001072400",1025,78,957,67,597,85,1004,77,3890
"09001072500",3504,526,978,53,1018,11,909,196,7195
"09001072600",3742,889,1274,295,439,0,991,163,7793
"09001072700",1847,76,1051,0,404,24,1062,37,4501
"09001072800",1392,440,2569,559,794,91,1932,502,8279
"09001072900",1709,293,2355,389,549,2,1235,161,6693
"09001073000",831,67,658,63,175,14,655,61,2524
"09001073100",1987,457,1313,701,285,164,1496,330,6733
"09001073200",1113,226,845,37,497,44,800,110,3672
"09001073300",837,361,1636,136,220,0,707,284,4181
"09001073400",1491,243,1697,448,411,198,1407,321,6216
"09001073500",686,349,974,693,496,146,1302,520,5166
"09001073600",767,267,419,340,445,93,1148,436,3915
"09001073700",1082,487,1610,429,428,449,1204,795,6484
"09001073800",631,522,555,221,454,197,936,760,4276
"09001073900",793,352,844,319,801,161,1292,495,5057
"09001074000",390,216,541,321,300,378,690,594,3430
"09001074300",859,407,1429,637,279,144,804,601,5160
"09001074400",460,506,2168,401,489,217,1033,714,5988
"09001080100",2665,193,882,55,1085,45,1343,69,6337
"09001080200",2266,452,956,83,482,172,792,235,5438
"09001080400",1979,189,2460,562,493,48,1183,131,7045
"09001080500",2823,272,38,15,56,0,101,16,3321
"09001080600",1567,52,167,19,286,0,323,0,2414
"09001080700",1472,98,319,7,138,0,174,5,2213
"09001080800",4335,75,150,8,219,0,203,0,4990
"09001080900",3757,249,836,0,278,16,603,0,5739
"09001081000",3544,80,249,37,497,10,715,10,5142
"09001081100",4437,89,97,30,104,0,325,0,5082
"09001081200",4431,153,354,32,324,10,378,10,5692
"09001081300",3880,99,146,61,287,0,419,10,4902
"09001090100",2930,19,89,0,164,1,12,1,3216
"09001090200",7377,93,129,0,223,0,333,0,8155
"09001090300",3932,87,147,0,482,2,505,2,5157
"09001090400",4793,113,422,0,896,0,616,0,6840
"09001090500",4137,149,92,0,277,21,369,31,5076
"09001090600",2886,185,12,0,252,4,127,0,3466
"09001090700",5164,42,28,0,399,21,274,10,5938
"09001100100",5072,200,0,0,224,21,492,21,6030
"09001100200",6396,591,17,3,235,0,224,305,7771
"09001100300",6104,172,112,13,451,0,257,0,7109
"09001105100",3864,122,36,0,89,0,146,0,4257
"09001105200",3227,37,0,0,175,0,127,0,3566
"09001110100",1750,280,0,2,90,7,75,7,2211
"09001110201",3841,432,190,2,306,25,433,56,5285
"09001110202",4566,98,44,15,180,0,399,0,5302
"09001110301",4812,224,160,0,628,268,348,74,6514
"09001110302",2491,91,59,0,132,0,104,0,2877
"09001110400",4715,150,0,0,106,0,158,0,5129
"09001110500",5876,60,33,1,42,0,127,0,6139
"09001110600",7237,202,79,0,296,2,297,2,8115
"09001200100",2677,222,121,0,410,0,299,0,3729
"09001200200",4354,91,242,0,311,121,625,0,5744
"09001200301",4299,117,58,0,420,59,483,0,5436
"09001200302",4587,93,54,0,443,29,202,10,5418
"09001205100",3380,72,26,0,546,58,191,58,4331
"09001205200",6289,78,35,2,360,0,247,3,7014
"09001205300",5237,214,20,0,279,0,162,0,5912
"09001210100",2392,685,332,31,2394,184,2623,373,9014
"09001210200",1922,411,239,306,2253,818,2347,948,9244
"09001210300",3385,322,513,0,1254,292,1494,517,7777
"09001210400",4782,255,912,65,1967,1013,2008,802,11804
"09001210500",5135,605,235,1,820,234,750,218,7998
"09001210600",2837,216,348,109,2255,201,1898,296,8160
"09001210701",2107,132,82,108,1917,165,2169,74,6754
"09001210702",2117,336,180,73,1346,366,1340,332,6090
"09001210800",3872,112,144,0,581,34,297,53,5093
"09001210900",4777,138,36,0,394,26,318,26,5715
"09001211000",2903,157,378,0,684,51,482,65,4720
"09001211100",34,0,0,0,0,0,0,0,34
"09001211200",4117,467,723,0,1016,136,719,234,7412
"09001211300",3031,114,348,3,340,0,249,0,4085
"09001211400",4287,109,237,0,626,18,443,18,5738
"09001220100",4653,46,10,0,409,0,314,0,5432
"09001220200",4399,40,0,0,420,0,508,0,5367
"09001220300",3610,128,38,3,170,0,150,3,4102
"09001230100",6502,200,52,2,201,0,448,0,7405
"09001230200",1939,43,7,0,64,14,67,3,2137
"09001230300",3027,83,2,0,167,10,207,0,3496
"09001230400",5724,181,0,0,384,51,159,0,6499
"09001230501",3327,84,22,0,450,260,387,260,4790
"09001230502",3682,234,0,79,205,0,135,0,4335
"09001240100",4090,169,42,1,227,0,113,0,4642
"09001240200",4354,149,17,0,132,0,123,0,4775
"09001245100",2877,52,0,0,100,0,124,0,3153
"09001245200",3850,124,36,0,54,3,120,3,4190
"09001245300",4379,233,1,10,407,27,305,89,5451
"09001245400",3191,49,10,0,288,0,209,0,3747
"09001245500",2614,53,0,0,54,0,112,0,2833
"09001245600",5772,190,46,13,279,1,250,1,6552
"09001257100",3448,83,0,0,68,0,33,0,3632
"09001257200",1700,277,1258,183,662,31,1637,123,5871
"09001990000",0,0,0,0,0,0,0,0,0
"09003330100",2048,115,17,0,67,0,18,0,2265
"09003400100",6137,322,267,1,360,265,117,48,7517
"09003400200",5308,229,1,0,398,0,210,0,6146
"09003400300",6637,105,0,1,46,36,0,4,6829
"09003405100",2790,121,50,0,92,233,311,195,3792
"09003405200",3967,408,11,1,328,0,62,75,4852
"09003405300",5163,305,100,0,272,0,432,0,6272
"09003405401",2610,86,15,0,81,0,168,0,2960
"09003405402",2787,472,301,0,325,15,272,15,4187
"09003405500",4127,402,18,0,815,15,829,72,6278
"09003405600",6086,822,179,21,542,138,666,538,8992
"09003405700",1543,364,3,49,115,57,53,184,2368
"09003405800",6475,316,2,0,436,89,300,89,7707
"09003405900",4079,84,238,10,86,72,122,24,4715
"09003406001",2557,396,169,262,250,298,438,587,4957
"09003406002",4357,146,99,0,126,81,121,0,4930
"09003406100",1643,669,313,33,432,333,502,385,4310
"09003410101",5055,199,54,0,170,0,220,18,5716
"09003410102",3573,136,67,2,128,0,54,0,3960
"09003415300",857,357,499,174,419,505,797,767,4375
"09003415400",2848,302,730,22,1266,426,1823,335,7752
"09003415500",780,350,260,0,686,630,900,743,4349
"09003415600",2008,323,469,105,946,351,1716,390,6308
"09003415700",2203,227,183,11,434,221,718,310,4307
"09003415800",1105,329,384,172,482,40,847,109,3468
"09003415900",787,495,51,8,237,226,351,478,2633
"09003416000",2939,492,175,128,612,397,925,543,6211
"09003416100",1886,942,515,325,1223,581,2168,1328,8968
"09003416200",1024,984,142,182,448,276,814,1273,5143
"09003416300",1465,547,152,148,740,360,889,523,4824
"09003416400",2477,27,0,80,622,0,616,0,3822
"09003416500",2386,419,327,81,1134,393,1649,544,6933
"09003416600",1252,452,285,125,387,310,710,609,4130
"09003416700",3223,563,1239,39,944,341,1365,562,8276
"09003416800",1694,466,380,0,488,54,607,62,3751
"09003417100",439,247,120,85,376,201,592,252,2312
"09003417200",1030,441,146,0,246,40,473,15,2391
"09003417300",0,5,0,0,0,0,0,0,5
"09003417400",1604,260,268,13,252,32,347,79,2855
"09003417500",3331,310,274,0,486,38,624,90,5153
"09003420400",2516,105,0,0,81,2,69,2,2775
"09003420500",4594,470,212,36,98,94,463,74,6041
"09003420600",4799,302,230,1,368,62,324,62,6148
"09003420700",3404,74,46,0,96,29,160,0,3809
"09003430100",3445,416,12,0,134,0,115,0,4122
"09003430201",2735,200,34,0,283,0,137,70,3459
"09003430202",4379,30,59,0,358,0,131,0,4957
"09003430203",3958,42,85,0,206,0,90,2,4383
"09003430301",3337,133,14,0,88,16,88,16,3692
"09003430302",2393,102,11,1,22,0,42,0,2571
"09003430400",4410,170,91,63,51,33,98,2,4918
"09003430500",6381,4,82,0,140,7,231,7,6852
"09003430601",4569,473,49,0,41,0,132,81,5345
"09003430602",3453,142,0,0,153,0,117,37,3902
"09003460100",2514,157,55,18,425,8,35,0,3212
"09003460202",3632,196,73,37,373,7,128,17,4463
"09003460203",2241,173,76,0,280,164,5,0,2939
"09003460204",4385,194,239,2,1278,0,107,57,6262
"09003460301",4290,156,50,1,390,56,249,56,5248
"09003460302",3440,88,9,3,220,0,69,0,3829
"09003462101",5473,133,19,0,405,0,162,0,6192
"09003462102",3315,249,14,0,569,24,139,0,4310
"09003462201",4632,263,66,0,294,0,123,0,5378
"09003462202",2284,75,23,0,169,0,47,0,2598
"09003464101",5083,168,20,0,86,0,115,0,5472
"09003464102",4472,218,21,0,147,0,329,0,5187
"09003466101",3886,98,100,0,167,0,204,0,4455
"09003466102",4466,33,69,0,614,8,423,14,5627
"09003466201",1853,94,100,52,162,0,68,0,2329
"09003466202",4212,26,37,0,239,9,47,0,4570
"09003466300",4214,91,49,0,302,0,112,0,4768
"09003466400",2294,37,37,0,90,0,41,0,2499
"09003468101",6901,76,115,7,180,10,275,10,7574
"09003468102",3620,121,16,14,147,0,63,0,3981
"09003470100",4438,93,276,0,142,87,162,0,5198
"09003471100",441,10,2520,299,174,17,100,17,3578
"09003471200",351,0,1975,283,268,5,114,0,2996
"09003471300",1886,260,2180,68,470,81,276,12,5233
"09003471400",3456,93,1673,64,239,3,168,3,5699
"09003471500",1097,65,1786,110,226,7,69,15,3375
"09003473100",1979,224,3254,72,680,0,677,121,7007
"09003473400",1242,43,249,42,77,23,60,23,1759
"09003473501",2873,67,826,0,548,44,338,18,4714
"09003473502",2224,40,867,12,265,24,205,0,3637
"09003473601",2339,34,717,0,184,0,241,6,3521
"09003473602",1050,63,652,72,440,34,59,8,2378
"09003473700",2184,31,2556,141,356,263,444,149,6124
"09003473800",413,80,864,203,225,12,263,18,2078
"09003476100",3536,375,180,12,249,190,102,88,4732
"09003476200",2469,50,13,2,200,0,118,0,2852
"09003476300",3960,243,354,0,533,111,273,25,5499
"09003477101",3691,87,58,0,99,0,56,0,3991
"09003477102",5353,384,306,41,245,0,263,0,6592
"09003477200",2700,39,28,0,83,0,42,0,2892
"09003480300",2078,78,20,0,158,0,93,0,2427
"09003480400",3390,146,51,0,120,0,153,0,3860
"09003480500",2880,158,11,0,201,0,67,0,3317
"09003480600",3621,927,301,120,429,126,620,378,6522
"09003480700",1450,123,93,7,293,33,256,45,2300
"09003480800",3527,289,92,2,285,15,254,9,4473
"09003480900",1831,49,19,0,225,0,167,0,2291
"09003481000",3519,79,8,9,0,0,93,0,3708
"09003481100",3399,360,131,0,12,8,8,26,3944
"09003481200",3078,193,46,8,145,0,81,8,3559
"09003481300",2616,88,33,0,95,11,106,0,2949
"09003484100",3595,189,618,68,1050,43,128,28,5719
"09003484200",4614,242,250,1,347,65,162,65,5746
"09003487100",5129,702,687,1,824,0,529,20,7892
"09003487201",3613,104,295,1,463,0,321,0,4797
"09003487202",2929,3,121,0,498,63,287,0,3901
"09003487300",991,28,6,0,253,8,39,0,1325
"09003487400",1878,66,25,0,199,0,33,0,2201
"09003487500",4832,118,452,0,1183,46,290,1,6922
"09003490100",3853,292,201,0,302,54,341,125,5168
"09003490302",6098,203,152,6,2077,185,277,54,9052
"09003492100",3079,154,80,0,169,0,145,12,3639
"09003492200",3406,149,278,13,288,48,584,13,4779
"09003492300",4197,350,350,0,668,106,714,258,6643
"09003492400",2352,198,94,25,82,20,49,0,2820
"09003492500",3202,28,43,26,54,3,11,3,3370
"09003492600",6089,252,32,13,450,152,441,0,7429
"09003494100",4673,177,464,22,734,0,407,0,6477
"09003494201",3724,115,201,144,497,34,363,17,5095
"09003494202",2291,37,119,0,244,0,226,0,2917
"09003494300",3232,115,145,80,292,11,236,11,4122
"09003494400",3989,211,44,17,478,47,373,47,5206
"09003494500",3929,113,257,3,429,9,407,18,5165
"09003494600",2621,183,106,10,430,1,208,11,3570
"09003496100",1104,274,423,164,565,1,764,187,3482
"09003496200",3320,159,35,0,906,37,298,55,4810
"09003496300",2839,172,213,8,283,80,390,32,4017
"09003496400",2483,77,19,1,112,0,58,0,2750
"09003496500",2396,46,18,5,298,4,55,4,2826
"09003496600",2190,53,302,0,129,8,0,8,2690
"09003496700",2365,244,628,19,562,17,715,33,4583
"09003496800",2236,123,404,111,753,140,790,101,4658
"09003496900",4021,525,232,446,827,213,983,76,7323
"09003497000",3945,46,32,1,237,21,180,0,4462
"09003497100",3316,194,82,1,360,129,174,46,4302
"09003497200",1364,52,26,0,146,2,110,2,1702
"09003497300",3438,88,300,1,507,0,351,0,4685
"09003497400",3324,74,119,40,353,102,81,81,4174
"09003497500",3022,161,159,20,309,16,126,0,3813
"09003497600",1897,183,49,5,119,77,21,18,2369
"09003497700",3874,281,156,59,183,33,105,11,4702
"09003500100",896,788,384,224,882,855,1513,1523,7065
"09003500200",473,479,492,335,689,145,903,592,4108
"09003500300",441,366,315,228,364,369,649,573,3305
"09003500400",452,270,267,279,340,253,598,485,2944
"09003500500",229,172,177,82,377,423,210,415,2085
"09003500700",0,0,0,0,0,0,0,0,0
"09003500900",353,249,460,570,143,261,493,610,3139
"09003501200",104,149,1079,753,175,171,278,332,3041
"09003501300",2,83,597,558,146,204,159,369,2118
"09003501400",32,26,1280,1158,281,181,269,281,3508
"09003501500",42,140,1852,921,233,200,267,241,3896
"09003501700",76,32,305,243,46,211,132,247,1292
"09003501800",125,336,862,425,346,762,484,1131,4471
"09003502100",987,143,219,19,290,81,194,59,1992
"09003502300",3077,600,867,124,1184,317,2368,805,9342
"09003502400",2278,847,876,352,1232,706,2943,1321,10555
"09003502500",746,396,108,56,289,162,742,390,2889
"09003502600",1560,907,573,201,393,529,1204,1188,6555
"09003502700",682,468,317,355,377,799,820,1251,5069
"09003502800",539,644,172,144,811,650,1344,1208,5512
"09003502900",579,471,353,428,422,676,616,1081,4626
"09003503000",379,574,238,296,708,971,919,1525,5610
"09003503100",975,477,1395,790,876,534,1107,899,7053
"09003503300",395,77,1135,280,485,136,716,174,3398
"09003503500",244,130,585,565,62,168,271,270,2295
"09003503700",22,69,1574,621,98,9,0,53,2446
"09003503800",50,11,419,251,162,55,275,61,1284
"09003503900",72,0,4121,619,451,14,343,0,5620
"09003504000",33,21,2755,603,103,9,36,0,3560
"09003504100",366,317,328,218,804,87,770,443,3333
"09003504200",1530,883,1407,229,569,288,724,208,5838
"09003504300",735,406,230,80,265,432,757,740,3645
"09003504500",772,719,418,173,1208,548,1706,1143,6687
"09003504800",1402,90,521,49,1957,178,2326,178,6701
"09003504900",1229,457,559,218,938,419,1781,820,6421
"09003510100",1085,117,569,111,348,122,428,108,2888
"09003510200",828,183,576,220,460,111,382,186,2946
"09003510300",1481,214,1256,422,982,246,1519,371,6491
"09003510400",2057,348,1190,505,342,360,1579,531,6912
"09003510500",1237,90,568,24,934,169,593,216,3831
"09003510600",1386,631,1193,341,1320,203,1316,523,6913
"09003510700",3053,166,873,165,467,332,935,350,6341
"09003510800",1675,223,365,0,903,0,790,79,4035
"09003510900",2438,45,502,13,403,1,492,0,3894
"09003511000",2440,61,424,88,665,2,479,10,4169
"09003511100",2331,135,393,0,685,76,567,117,4304
"09003511200",1664,344,492,133,1030,33,728,173,4597
"09003511300",1228,88,970,249,760,78,822,78,4273
"09003511400",1348,89,627,12,325,17,364,1,2783
"09003514101",2707,87,98,0,223,169,53,169,3506
"09003514102",3201,163,616,104,2430,128,886,63,7591
"09003514200",1913,361,475,80,254,79,603,223,3988
"09003514300",3352,95,419,0,635,62,539,0,5102
"09003514400",2869,474,557,195,427,117,475,214,5328
"09003514500",3086,139,391,13,509,68,550,11,4767
"09003514600",2968,333,550,385,331,446,781,468,6262
"09003514700",2348,467,1305,94,446,32,707,33,5432
"09003514800",2004,306,699,22,221,118,529,190,4089
"09003514900",2784,65,27,0,118,3,79,3,3079
"09003515000",2609,211,142,0,105,6,293,143,3509
"09003515101",1656,189,292,37,185,0,297,120,2776
"09003515102",3085,141,457,594,1785,131,657,106,6956
"09003515200",3010,80,59,23,276,14,84,25,3571
"09003520100",5403,96,54,0,342,0,101,0,5996
"09003520201",3005,91,22,0,442,1,111,1,3673
"09003520202",3428,188,0,0,627,2,64,2,4311
"09003520301",3665,125,293,17,781,54,514,22,5471
"09003520302",2823,143,117,56,339,52,112,0,3642
"09003520400",6923,116,86,0,677,10,133,10,7955
"09003520501",3482,145,38,0,624,1,179,26,4495
"09003524100",5986,47,78,2,127,14,206,0,6460
"09003524200",4845,538,40,41,351,188,333,214,6550
"09003524300",3593,31,154,0,146,0,37,0,3961
"09003524400",164,153,1913,404,121,83,249,268,3355
"09003524501",1000,486,378,126,370,267,685,542,3854
"09003524502",930,148,861,76,64,42,78,173,2372
"09003524600",361,219,1580,683,766,253,493,361,4716
"09003524700",1138,234,637,89,801,142,1394,376,4811
"09003980000",0,0,0,0,0,0,0,0,0
"09005250100",1584,38,9,3,94,1,82,1,1812
"09005253100",2747,69,77,0,101,214,56,217,3481
"09005253200",6235,226,238,92,499,152,467,140,8049
"09005253300",1858,123,77,0,96,0,113,0,2267
"09005253400",5464,234,21,54,311,2,182,2,6270
"09005253500",5833,134,0,28,163,0,58,0,6216
"09005253600",1936,232,162,21,299,15,452,82,3199
"09005260200",2739,243,20,16,94,33,81,36,3262
"09005261100",3145,157,109,0,105,8,114,8,3646
"09005262100",2378,123,0,0,141,47,20,9,2718
"09005263200",1290,187,0,0,42,0,17,0,1536
"09005265100",1342,104,0,0,23,3,33,8,1513
"09005266100",2474,249,18,10,19,3,0,0,2773
"09005267100",3046,187,0,0,95,0,211,38,3577
"09005268100",2160,74,0,0,67,0,89,0,2390
"09005290100",3635,41,0,1,60,1,30,0,3768
"09005293100",1409,43,4,0,13,11,6,0,1486
"09005296100",2578,326,0,1,36,12,88,9,3050
"09005298300",2440,123,0,0,75,0,0,0,2638
"09005298400",2817,114,0,0,50,0,0,0,2981
"09005300100",2160,194,23,0,37,50,20,0,2484
"09005300400",2005,21,0,0,87,0,24,0,2137
"09005300500",3364,304,2,0,57,0,63,27,3817
"09005303100",2219,135,8,0,13,0,43,0,2418
"09005306100",6632,147,19,5,104,14,75,0,6996
"09005310100",3449,380,0,7,237,292,367,163,4895
"09005310200",2115,382,58,0,249,56,381,86,3327
"09005310300",1001,332,0,29,126,0,46,0,1534
"09005310400",2602,103,23,0,30,0,65,0,2823
"09005310500",1440,307,17,0,136,12,77,161,2150
"09005310601",3031,195,81,0,427,8,223,46,4011
"09005310602",4100,424,77,0,211,28,37,0,4877
"09005310700",3267,304,86,0,255,85,174,0,4171
"09005310801",1896,410,0,0,288,39,474,39,3146
"09005310803",3096,196,222,17,440,39,258,27,4295
"09005310804",2112,250,2,0,300,8,299,116,3087
"09005320100",5447,555,91,0,250,0,840,14,7197
"09005320200",4078,210,42,0,323,0,286,0,4939
"09005342100",3355,154,0,14,13,0,11,8,3555
"09005349100",4819,102,0,0,178,12,45,0,5156
"09005349200",2363,74,61,0,113,35,22,35,2703
"09005360100",4691,175,36,0,328,15,387,15,5647
"09005360200",7336,191,24,0,169,0,88,11,7819
"09005360300",3294,112,26,0,66,0,182,36,3716
"09005360400",5139,227,248,0,119,3,27,6,5769
"09005362101",3906,153,13,13,96,0,191,0,4372
"09005362102",5251,340,0,6,62,70,155,19,5903
"09005425300",3948,278,16,0,83,0,198,0,4523
"09005425400",4189,181,14,2,30,21,53,50,4540
"09005425500",2833,289,0,0,174,21,85,0,3402
"09005425600",2377,148,14,0,56,41,47,0,2683
"09007541100",1173,224,502,59,93,58,205,35,2349
"09007541200",3978,197,173,177,1150,21,855,16,6567
"09007541300",3944,345,834,353,684,42,490,41,6733
"09007541401",2785,105,169,33,271,7,87,0,3457
"09007541402",3731,550,433,13,399,52,216,52,5446
"09007541500",1132,161,144,44,137,8,75,8,1709
"09007541600",555,373,314,91,129,75,467,141,2145
"09007541700",1513,561,465,288,110,0,202,319,3458
"09007542000",3366,212,295,0,362,17,247,0,4499
"09007542100",2171,151,356,236,307,104,242,73,3640
"09007542200",1359,21,130,6,83,0,81,0,1680
"09007550100",5070,202,0,0,450,0,338,0,6060
"09007550201",3476,80,9,3,174,0,220,0,3962
"09007550202",2707,143,42,3,101,3,69,3,3071
"09007560100",5722,68,17,0,164,0,79,0,6050
"09007560200",2943,303,0,93,86,19,153,127,3724
"09007570100",3758,73,495,0,391,83,188,0,4988
"09007570200",3024,104,170,0,116,0,115,11,3540
"09007570300",4722,188,355,0,33,118,165,111,5692
"09007580100",4097,120,18,0,179,5,97,3,4519
"09007585100",7017,69,11,0,230,0,227,22,7576
"09007590100",7637,324,27,0,342,0,185,17,8532
"09007595101",3312,298,62,0,28,8,163,8,3879
"09007595102",4940,199,0,0,184,0,24,0,5347
"09007600100",3740,166,8,22,92,15,140,0,4183
"09007610100",1947,140,3,0,31,7,45,1,2174
"09007610200",3165,168,0,0,234,44,25,12,3648
"09007610300",3343,546,0,1,135,0,198,175,4398
"09007610400",3145,99,19,0,106,0,164,0,3533
"09007620100",4178,81,104,9,175,40,110,0,4697
"09007630100",6130,334,33,0,111,8,45,0,6661
"09007640100",6055,21,0,0,425,0,161,0,6662
"09007670100",4215,154,23,0,180,26,65,0,4663
"09007670200",4898,366,4,0,228,0,0,0,5496
"09007680100",6206,301,8,32,311,0,186,0,7044
"09007680200",4233,296,560,126,508,115,299,72,6209
"09007990100",0,0,0,0,0,0,0,0,0
"09009120100",4863,289,231,133,288,174,535,87,6600
"09009120200",4450,372,255,288,853,419,1598,443,8678
"09009125100",3893,211,166,0,205,0,613,0,5088
"09009125200",3570,962,337,373,421,0,646,110,6419
"09009125300",3838,384,372,618,367,46,1172,230,7027
"09009125400",1938,685,98,156,333,105,406,418,4139
"09009130101",4293,165,29,1,193,0,246,0,4927
"09009130102",2519,273,21,4,226,0,91,0,3134
"09009130200",6788,479,536,91,571,169,759,15,9408
"09009140100",1176,246,408,166,595,171,202,55,3019
"09009140200",336,175,175,240,113,260,189,399,1887
"09009140300",439,162,845,287,292,195,606,327,3153
"09009140400",874,360,578,710,732,740,955,883,5832
"09009140500",664,364,1055,603,552,618,907,1049,5812
"09009140600",552,420,992,728,727,365,958,725,5467
"09009140700",1004,612,1056,706,238,467,399,523,5005
"09009140800",923,153,1216,421,668,342,1185,339,5247
"09009140900",1046,337,2309,542,701,15,502,176,5628
"09009141000",2736,380,280,44,492,0,240,38,4210
"09009141100",1377,82,1107,80,54,6,150,29,2885
"09009141200",1154,319,2149,578,557,116,585,162,5620
"09009141300",1115,519,875,1117,358,76,354,134,4548
"09009141400",857,316,2895,832,236,306,212,440,6094
"09009141500",325,33,3310,1366,388,534,492,374,6822
"09009141600",452,339,2192,846,159,231,271,254,4744
"09009141800",1402,271,672,82,870,110,136,145,3688
"09009141900",3678,417,135,3,607,129,128,0,5097
"09009142000",2041,451,181,100,638,158,193,87,3849
"09009142100",472,347,227,274,312,47,270,344,2293
"09009142200",1330,121,40,0,110,30,47,42,1720
"09009142300",1913,759,949,274,1174,930,2475,1538,10012
"09009142400",1159,715,814,529,1335,715,2046,1371,8684
"09009142500",2500,587,1265,638,769,569,2170,1274,9772
"09009142601",1407,512,1729,749,1302,269,1019,524,7511
"09009142603",2172,306,682,274,510,127,900,163,5134
"09009142604",871,390,555,42,536,152,628,508,3682
"09009142700",2505,198,1675,424,1183,396,1684,420,8485
"09009142800",4076,188,303,0,248,45,205,79,5144
"09009150100",3642,174,0,0,125,33,128,17,4119
"09009150200",2279,192,57,13,953,0,105,135,3734
"09009150300",3558,271,92,32,153,29,122,39,4296
"09009150400",3495,181,288,149,453,0,440,0,5006
"09009150500",3237,198,208,6,216,106,221,20,4212
"09009150600",5264,339,76,0,747,109,249,109,6893
"09009150700",4078,113,1,9,202,0,92,0,4495
"09009150800",3290,154,175,0,339,0,145,0,4103
"09009150900",3397,158,0,33,300,16,146,39,4089
"09009151000",3314,156,21,0,176,10,182,0,3859
"09009151100",5915,132,34,14,538,10,265,29,6937
"09009151200",2908,88,90,5,92,53,93,12,3341
"09009154100",3200,494,2557,341,758,346,1178,531,9405
"09009154200",2511,387,2116,556,890,324,1362,205,8351
"09009154500",2621,439,670,47,308,103,659,204,5051
"09009154600",2931,308,807,74,306,38,364,159,4987
"09009154700",5969,216,98,0,158,0,181,0,6622
"09009154800",4559,167,217,2,300,2,249,17,5513
"09009154900",2595,161,167,59,229,95,572,95,3973
"09009155000",3103,273,1510,0,493,386,561,226,6552
"09009155100",2860,295,218,132,196,15,516,7,4239
"09009157100",2149,39,60,3,321,87,188,1,2848
"09009157200",3256,43,42,0,242,28,193,28,3832
"09009157300",2909,19,14,0,264,0,172,0,3378
"09009157400",3944,99,21,19,311,0,154,0,4548
"09009160100",2976,11,42,0,153,154,30,0,3366
"09009160200",4723,65,128,3,620,0,121,1,5661
"09009161100",5181,186,13,0,175,0,34,0,5589
"09009165100",2838,132,817,212,384,98,704,122,5307
"09009165200",2128,25,18,75,159,0,95,0,2500
"09009165300",1810,206,155,0,186,0,19,0,2376
"09009165400",3296,62,747,167,555,29,386,43,5285
"09009165500",1134,162,2427,541,400,6,616,69,5355
"09009165600",3592,284,790,1,674,67,1027,126,6561
"09009165700",1703,58,1582,97,561,38,336,15,4390
"09009165801",2423,485,1290,64,1738,60,473,19,6552
"09009165802",2948,39,982,13,222,50,365,50,4669
"09009165900",5931,398,639,47,351,0,270,0,7636
"09009166001",4495,948,263,71,719,69,386,12,6963
"09009166002",3877,122,128,0,131,1,0,1,4260
"09009167100",6875,225,361,0,488,0,304,17,8270
"09009167201",3684,53,180,0,211,80,179,52,4439
"09009167202",3762,334,93,1,154,8,104,100,4556
"09009167300",6509,186,23,0,590,36,159,47,7550
"09009170100",618,360,116,93,277,409,572,708,3153
"09009170200",976,415,66,223,259,249,706,482,3376
"09009170300",871,210,109,52,455,427,671,534,3329
"09009170400",1124,92,85,2,116,11,196,13,1639
"09009170500",5337,73,192,0,320,0,762,9,6693
"09009170600",1997,207,66,39,347,0,316,86,3058
"09009170700",1635,108,54,102,460,88,540,105,3092
"09009170800",3507,595,348,0,502,233,1166,694,7045
"09009170900",818,253,260,69,467,256,711,392,3226
"09009171000",604,321,84,90,520,156,637,248,2660
"09009171100",3730,487,310,76,495,22,857,136,6113
"09009171200",6661,261,673,49,591,75,815,89,9214
"09009171300",2473,377,202,45,590,68,844,359,4958
"09009171400",1088,200,139,88,392,201,766,355,3229
"09009171500",1112,517,574,97,825,182,1089,611,5007
"09009171600",3007,61,760,339,895,249,980,389,6680
"09009171700",3494,83,317,8,153,0,619,11,4685
"09009175100",2375,180,0,1,110,211,346,185,3408
"09009175200",2025,430,51,0,141,34,634,114,3429
"09009175300",3305,555,0,4,190,0,264,86,4404
"09009175400",3590,421,113,7,471,4,1093,193,5892
"09009175500",6709,161,277,0,322,47,176,0,7692
"09009175600",4374,87,60,0,481,0,418,0,5420
"09009175700",2316,87,13,0,86,0,121,6,2629
"09009175800",3399,41,45,0,362,0,195,0,4042
"09009175900",4128,123,32,21,401,51,548,17,5321
"09009176000",5883,158,35,2,176,59,148,0,6461
"09009180100",5360,744,133,0,380,10,304,159,7090
"09009180200",3722,330,333,21,468,201,555,352,5982
"09009180300",1707,420,0,2,297,90,113,68,2697
"09009180400",2148,385,148,0,237,0,369,0,3287
"09009180500",4345,101,70,0,243,0,565,0,5324
"09009180601",2663,290,50,0,66,12,134,0,3215
"09009180602",3590,155,59,5,38,69,212,69,4197
"09009184100",4689,404,40,26,116,13,283,15,5586
"09009184200",3172,208,82,2,463,125,357,0,4409
"09009184300",3456,166,0,24,346,0,88,48,4128
"09009184400",2691,145,50,0,265,0,38,0,3189
"09009184500",2053,189,12,4,75,1,40,1,2375
"09009184600",2828,99,0,0,40,0,150,0,3117
"09009184700",4600,584,35,5,829,0,398,0,6451
"09009186100",6882,172,71,0,195,0,285,0,7605
"09009186200",6551,251,29,0,147,3,68,0,7049
"09009190100",2888,200,18,5,130,1,161,31,3434
"09009190200",3189,97,0,1,105,1,90,1,3484
"09009190301",6273,196,18,0,226,0,348,0,7061
"09009190302",4916,197,32,0,343,0,205,18,5711
"09009190303",3013,107,107,19,103,0,130,0,3479
"09009194100",5191,174,0,5,132,6,37,1,5546
"09009194201",6757,248,11,2,220,6,124,5,7373
"09009194202",4905,66,54,8,234,0,53,0,5320
"09009341100",5659,189,0,0,190,0,425,0,6463
"09009343101",3319,106,9,0,404,0,0,5,3843
"09009343102",3141,53,0,25,294,12,180,12,3717
"09009343200",5573,155,58,23,893,0,544,0,7246
"09009343300",5203,198,57,1,627,23,216,74,6399
"09009343400",5966,56,17,0,444,11,200,6,6700
"09009344100",4232,121,22,46,326,45,130,19,4941
"09009344200",2260,56,28,0,358,4,31,0,2737
"09009345100",4920,672,344,178,428,98,312,175,7127
"09009345201",4932,659,109,58,325,107,309,212,6711
"09009345202",3522,96,301,0,385,0,808,0,5112
"09009345300",5079,633,2,18,643,36,495,89,6995
"09009345400",6451,489,423,39,411,33,1154,138,9138
"09009346101",6240,346,0,0,248,0,319,40,7193
"09009346102",5582,159,34,0,110,0,191,0,6076
"09009347100",4911,103,251,0,74,0,92,0,5431
"09009347200",3555,246,27,1,150,0,79,6,4064
"09009348111",2208,475,25,0,150,0,78,0,2936
"09009348122",3842,197,188,0,160,6,119,6,4518
"09009348123",5096,237,41,0,171,52,175,0,5772
"09009348124",2114,114,0,0,59,0,51,10,2348
"09009348125",3897,69,92,0,299,0,235,0,4592
"09009350100",765,824,359,318,297,547,561,831,4502
"09009350200",867,481,591,776,517,327,1157,692,5408
"09009350300",293,194,500,424,282,298,305,439,2735
"09009350400",436,388,720,272,287,293,590,515,3501
"09009350500",567,592,196,137,670,813,789,1411,5175
"09009350800",2115,912,676,370,477,582,1156,1161,7449
"09009350900",1163,43,702,208,183,18,550,75,2942
"09009351000",1612,541,828,721,396,136,844,539,5617
"09009351100",1572,597,1031,214,545,169,849,577,5554
"09009351200",934,479,752,468,659,581,799,872,5544
"09009351300",2513,537,976,10,1788,275,2128,385,8612
"09009351400",1721,589,415,88,519,432,1433,748,5945
"09009351500",3097,449,684,52,583,288,933,634,6720
"09009351601",1955,339,331,193,257,329,475,379,4258
"09009351602",5043,316,403,0,280,240,502,331,7115
"09009351700",664,492,432,411,528,436,748,568,4279
"09009351800",2444,351,585,56,195,51,315,107,4104
"09009351900",1644,129,154,24,186,51,266,44,2498
"09009352000",3392,115,738,23,484,210,604,211,5777
"09009352100",2051,414,495,81,756,91,817,397,5102
"09009352200",576,278,405,167,386,557,413,792,3574
"09009352300",1213,429,940,67,504,71,859,346,4429
"09009352400",1646,124,548,122,570,180,842,239,4271
"09009352500",1483,182,587,12,443,66,559,109,3441
"09009352600",3222,560,476,28,573,0,702,262,5823
"09009352701",2364,350,283,30,106,0,689,90,3912
"09009352702",3753,866,676,66,337,105,1007,671,7481
"09009352800",3658,445,535,118,1335,629,1737,785,9242
"09009361100",6325,98,59,0,197,6,362,13,7060
"09009361200",4542,139,142,4,340,36,554,40,5797
"09009361300",4208,191,15,3,212,0,138,13,4780
"09009361401",773,921,86,194,367,91,38,81,2551
"09009361402",93,30,0,0,12,46,0,0,181
"09009361500",2200,164,1475,656,621,32,1587,38,6773
"09009990000",0,0,0,0,0,0,0,0,0
"09011650100",2285,68,0,0,43,21,30,11,2458
"09011660101",3082,82,0,0,47,5,25,1,3242
"09011660102",4042,146,21,0,172,0,42,0,4423
"09011690300",2617,671,1098,216,1059,394,1624,544,8223
"09011690400",1003,317,260,77,300,248,932,449,3586
"09011690500",917,755,435,133,307,348,393,496,3784
"09011690700",406,197,366,19,14,133,117,125,1377
"09011690800",1270,391,610,98,755,254,683,470,4531
"09011690900",3222,258,317,0,376,209,350,209,4941
"09011693300",4196,344,0,0,518,0,209,0,5267
"09011693400",3354,266,74,0,292,27,277,4,4294
"09011693500",3252,103,9,0,203,0,93,0,3660
"09011693600",2645,109,41,17,195,0,46,0,3053
"09011693700",2720,168,49,0,473,0,343,20,3773
"09011695201",4264,301,198,58,345,54,220,93,5533
"09011695202",5176,232,36,18,701,32,321,0,6516
"09011696100",3897,233,111,327,207,0,424,0,5199
"09011696200",4099,31,237,0,613,56,368,0,5404
"09011696300",2037,60,98,0,371,150,169,124,3009
"09011696400",3055,390,791,46,792,569,691,212,6546
"09011696500",2202,379,356,27,293,25,105,31,3418
"09011696600",2739,180,77,175,745,74,175,6,4171
"09011696700",2656,954,493,221,1145,118,567,337,6491
"09011696800",1500,397,742,212,473,547,256,361,4488
"09011697000",2875,533,674,154,724,126,336,92,5514
"09011700100",3395,449,67,13,806,21,93,40,4884
"09011701100",6112,173,117,7,1263,114,646,156,8588
"09011701200",6319,246,133,0,518,45,107,12,7380
"09011702100",3797,121,54,0,438,9,203,9,4631
"09011702300",1372,202,46,13,337,0,186,60,2216
"09011702400",2688,110,204,27,520,73,147,6,3775
"09011702500",2400,649,359,115,823,341,701,384,5772
"09011702600",1135,34,0,0,45,0,24,0,1238
"09011702700",3487,371,103,77,865,19,512,89,5523
"09011702800",2586,230,268,99,714,7,498,0,4402
"09011702900",2429,85,1,0,161,10,158,0,2844
"09011703000",3063,170,65,0,119,0,137,0,3554
"09011705101",3937,203,39,0,245,64,122,82,4692
"09011705102",3377,314,185,0,403,2,142,2,4425
"09011705200",3193,120,30,12,73,9,29,0,3466
"09011705300",3198,60,0,0,220,0,211,0,3689
"09011705400",2348,63,0,0,161,0,65,0,2637
"09011707100",4605,280,117,0,266,20,74,102,5464
"09011708100",2383,52,0,0,165,8,69,0,2677
"09011709100",5893,231,40,0,280,26,110,3,6583
"09011709200",4182,645,38,1,489,83,358,263,6059
"09011710100",4117,105,0,0,95,13,8,0,4338
"09011711100",2434,242,52,0,205,14,20,0,2967
"09011712100",1795,72,0,0,65,7,23,14,1976
"09011713100",2341,97,34,15,80,42,90,0,2699
"09011714101",2790,306,28,6,99,10,150,0,3389
"09011714103",7232,80,98,0,314,0,195,0,7919
"09011714104",4773,110,50,0,24,2,82,14,5055
"09011715100",3731,82,39,0,264,29,189,0,4334
"09011716101",3540,98,20,11,364,0,163,13,4209
"09011716102",3945,98,141,10,751,35,245,0,5225
"09011870100",6748,322,36,3,182,28,245,14,7578
"09011870200",4310,389,512,26,704,1,550,17,6509
"09011870300",1393,626,475,370,556,175,861,548,5004
"09011870501",2537,105,217,0,1114,46,175,46,4240
"09011870502",1916,76,60,13,463,15,348,0,2891
"09011870701",2078,67,64,0,15,0,58,0,2282
"09011870703",1633,78,0,0,50,0,113,0,1874
"09011870704",3544,162,132,0,262,10,212,3,4325
"09011980000",0,0,0,0,0,0,0,0,0
"09011990100",0,0,0,0,0,0,0,0,0
"09013526101",4385,27,11,0,106,0,97,0,4626
"09013526102",4777,96,35,1,188,0,120,6,5223
"09013528100",2738,109,69,25,154,0,0,0,3095
"09013529100",4526,79,46,15,302,1,270,1,5240
"09013530100",1945,138,31,0,136,2,162,1,2415
"09013530200",3946,770,267,250,390,169,420,162,6374
"09013530301",3845,373,656,136,661,29,752,195,6647
"09013530302",4852,414,156,0,545,0,187,0,6154
"09013530400",2641,195,76,32,317,54,162,17,3494
"09013530500",2662,82,75,0,169,0,90,0,3078
"09013530600",2546,25,199,2,33,0,45,0,2850
"09013533101",8665,173,19,0,358,12,504,12,9743
"09013533102",5318,103,19,0,203,21,91,0,5755
"09013535100",8248,203,91,0,186,45,132,3,8908
"09013535200",6733,33,13,0,104,19,29,1,6932
"09013538100",0,0,0,0,0,0,0,0,0
"09013538201",4642,261,0,41,235,32,102,3,5316
"09013538202",3859,70,56,0,170,0,97,0,4252
"09013840100",5083,720,0,0,192,23,97,0,6115
"09013850100",4644,164,46,0,194,0,150,0,5198
"09013850200",7047,220,0,0,97,0,67,30,7461
"09013860100",4629,219,124,0,496,0,59,0,5527
"09013881100",3553,231,49,0,239,189,169,13,4443
"09013881200",43,27,0,0,11,28,0,0,109
"09013881300",2187,1441,81,26,414,152,213,26,4540
"09013881500",3936,249,31,0,845,88,301,21,5471
"09013890100",3059,646,12,0,310,85,112,99,4323
"09013890201",3656,82,0,0,25,2,137,0,3902
"09013890202",4570,321,83,0,52,0,17,8,5051
"09015800300",1929,1044,169,115,250,325,492,1112,5436
"09015800400",2858,219,189,18,620,268,1205,363,5740
"09015800500",4948,1029,117,0,557,128,1042,569,8390
"09015800600",1498,1330,135,90,752,298,1373,1144,6620
"09015800700",2042,504,160,0,488,127,761,307,4389
"09015815000",2229,79,0,27,47,4,82,2,2470
"09015820000",1633,107,12,0,42,8,60,22,1884
"09015825000",1675,34,2,0,28,0,85,0,1824
"09015830100",3883,205,46,1,104,27,327,2,4595
"09015900100",4052,370,41,0,235,0,18,6,4722
"09015900200",4237,329,0,0,91,12,98,15,4782
"09015901100",7371,203,37,2,272,31,113,0,8029
"09015902200",1491,44,4,3,93,2,36,2,1675
"09015902500",3901,120,46,0,54,0,15,20,4156
"09015903100",5733,876,67,0,351,0,240,49,7316
"09015903200",2037,154,0,7,24,3,0,0,2225
"09015904100",6636,611,49,0,63,5,140,1,7505
"09015904400",3153,479,35,28,344,9,54,5,4107
"09015904500",4568,597,28,90,262,102,120,187,5954
"09015905100",6665,713,80,0,127,104,300,246,8235
"09015906100",4851,159,0,0,109,0,0,0,5119
"09015907100",3807,465,60,0,116,166,13,0,4627
"09015907200",4494,364,157,0,181,79,332,129,5736
"09015907300",4692,380,56,0,141,23,105,0,5397
"09015908100",3078,418,42,0,170,10,35,0,3753
"10001040100",5448,392,437,0,199,84,224,41,6825
"10001040201",3567,245,1126,104,334,0,259,12,5647
"10001040202",8241,514,2868,336,1243,1,659,41,13903
"10001040203",3048,337,1682,155,127,18,115,6,5488
"10001040501",2144,246,1590,949,353,43,157,200,5682
"10001040502",1058,76,527,0,202,45,408,44,2360
"10001040700",1821,145,1642,386,400,179,170,1,4744
"10001040900",1227,232,141,59,47,61,55,0,1822
"10001041000",3486,644,1606,61,633,27,891,222,7570
"10001041100",2156,329,368,0,520,8,432,93,3906
"10001041200",1917,245,882,128,732,93,251,6,4254
"10001041300",789,140,417,830,43,15,34,52,2320
"10001041400",1011,337,820,484,398,10,460,33,3553
"10001041500",2156,31,943,590,143,64,73,1,4001
"10001041600",1677,93,126,36,274,16,66,11,2299
"10001041701",4104,255,808,228,499,0,350,0,6244
"10001041702",2666,353,1202,207,269,57,187,0,4941
"10001041801",5209,905,2127,270,711,28,352,47,9649
"10001041802",2742,696,1033,114,370,70,98,12,5135
"10001041900",4020,501,416,144,128,52,118,168,5547
"10001042000",2748,296,32,15,139,36,84,0,3350
"10001042100",3113,512,309,12,37,45,170,112,4310
"10001042201",5330,730,1648,527,736,217,329,312,9829
"10001042202",6430,672,1215,448,678,17,600,4,10064
"10001042500",1958,214,707,406,98,27,523,43,3976
"10001042800",4786,559,981,192,513,29,258,29,7347
"10001042900",3647,395,692,127,80,0,98,13,5052
"10001043000",3626,422,546,223,272,98,209,0,5396
"10001043100",1930,120,156,48,19,4,24,0,2301
"10001043202",2525,494,278,8,52,67,119,63,3606
"10001043300",1424,211,1432,214,314,106,97,76,3874
"10001043400",3092,369,611,132,260,60,251,43,4818
"10001990000",0,0,0,0,0,0,0,0,0
"10003000200",701,112,3556,749,165,28,153,34,5498
"10003000300",493,34,1854,483,284,0,227,0,3375
"10003000400",1275,182,1148,397,75,0,104,84,3265
"10003000500",373,77,2202,531,96,0,80,39,3398
"10003000601",58,90,2105,800,67,6,56,8,3190
"10003000602",187,113,1529,853,192,31,139,36,3080
"10003000900",34,0,1233,547,116,7,163,7,2107
"10003001100",2182,187,321,96,107,61,38,95,3087
"10003001200",1160,101,67,0,58,7,96,0,1489
"10003001300",3328,120,58,11,120,0,29,0,3666
"10003001400",1384,120,438,126,31,0,187,63,2349
"10003001500",1041,209,495,353,92,0,0,0,2190
"10003001600",651,92,1214,476,71,45,445,37,3031
"10003001902",330,67,873,436,142,39,27,14,1928
"10003002100",144,51,833,781,125,80,139,96,2249
"10003002200",635,309,836,721,282,159,804,373,4119
"10003002300",795,467,1669,387,287,81,1019,490,5195
"10003002400",2203,334,1281,357,202,25,561,113,5076
"10003002500",2222,99,462,163,215,163,776,185,4285
"10003002600",1135,100,1284,533,315,420,876,398,5061
"10003002700",903,73,636,373,239,23,603,53,2903
"10003002800",748,96,495,210,82,51,81,11,1774
"10003002900",28,68,1440,1651,13,44,23,57,3324
"10003003002",50,44,767,900,35,32,53,24,1905
"10003010101",1473,408,1791,249,518,37,55,86,4617
"10003010104",1911,312,791,327,295,25,187,38,3886
"10003010200",1298,61,396,26,143,0,72,0,1996
"10003010300",1801,107,669,18,117,55,180,0,2947
"10003010400",3520,122,385,81,323,8,0,4,4443
"10003010502",4368,331,673,51,187,6,65,15,5696
"10003010702",2929,221,1765,21,304,130,438,0,5808
"10003010800",3786,133,364,20,258,81,74,81,4797
"10003010900",2503,72,58,3,60,0,45,0,2741
"10003011000",2600,48,221,2,225,12,157,10,3275
"10003011100",2260,71,217,0,85,0,61,8,2702
"10003011201",1277,100,89,3,640,49,173,0,2331
"10003011202",3448,125,234,10,427,0,183,0,4427
"10003011203",3155,51,941,0,846,0,13,0,5006
"10003011204",2586,60,359,0,173,11,47,12,3248
"10003011205",1784,26,66,0,110,0,39,0,2025
"10003011206",3588,50,68,0,278,0,59,0,4043
"10003011300",1919,25,66,0,214,0,17,0,2241
"10003011400",2839,32,286,0,251,9,66,0,3483
"10003011500",2435,49,24,0,239,24,73,0,2844
"10003011600",2824,114,38,0,244,12,30,0,3262
"10003011700",3810,80,17,0,177,0,144,0,4228
"10003011800",3331,160,42,1,259,12,14,15,3834
"10003011900",2756,115,113,0,337,81,267,109,3778
"10003012000",2957,778,298,60,267,33,325,742,5460
"10003012100",1861,152,214,8,122,0,200,21,2578
"10003012200",3193,272,707,162,105,48,981,174,5642
"10003012300",1896,272,212,15,40,95,557,84,3171
"10003012400",3433,347,284,225,333,1,1070,55,5748
"10003012500",3857,924,244,422,213,47,623,462,6792
"10003012600",2226,83,84,3,0,0,37,1,2434
"10003012700",3007,489,469,81,174,38,174,259,4691
"10003012900",2408,595,1182,257,221,198,487,640,5988
"10003013000",1578,148,139,0,46,16,39,16,1982
"10003013100",1698,109,13,23,112,7,173,67,2202
"10003013200",2019,189,331,6,220,81,586,144,3576
"10003013300",1624,33,121,0,43,0,244,0,2065
"10003013400",2044,180,14,1,146,25,5,25,2440
"10003013501",5375,115,45,0,411,11,41,0,5998
"10003013503",5399,477,91,4,866,48,228,117,7230
"10003013505",2622,70,12,0,311,0,42,0,3057
"10003013506",4278,26,107,0,375,16,148,0,4950
"10003013604",3522,152,20,22,257,21,196,71,4261
"10003013607",4469,78,393,51,681,46,395,0,6113
"10003013608",1532,94,127,5,90,13,106,0,1967
"10003013610",4577,156,34,19,665,163,200,0,5814
"10003013611",4435,122,415,23,523,24,271,0,5813
"10003013612",4627,131,421,0,774,65,133,0,6151
"10003013613",4056,49,526,67,621,0,412,0,5731
"10003013614",2670,253,98,2,73,0,627,131,3854
"10003013615",2927,222,83,1,228,115,248,68,3892
"10003013700",2037,342,744,12,496,204,633,399,4867
"10003013800",3337,106,620,82,705,0,300,0,5150
"10003013901",1963,187,334,83,450,68,342,20,3447
"10003013903",3003,104,1379,0,467,0,317,0,5270
"10003013904",4102,342,1428,161,1510,21,455,11,8030
"10003014000",2703,407,1419,160,844,16,449,179,6177
"10003014100",3086,98,1005,136,418,96,629,42,5510
"10003014200",1358,105,232,11,102,21,180,24,2033
"10003014300",3438,202,296,97,289,241,108,0,4671
"10003014402",1852,741,157,0,583,65,22,229,3649
"10003014403",2639,424,389,147,490,211,216,61,4577
"10003014404",3025,99,299,0,326,52,35,0,3836
"10003014501",529,1205,11,37,70,24,22,14,1912
"10003014502",786,1862,98,208,67,97,30,140,3288
"10003014702",1610,84,162,3,98,0,191,0,2148
"10003014703",2956,292,599,178,977,8,494,0,5504
"10003014705",3376,302,1053,4,309,0,338,60,5442
"10003014706",1392,114,906,367,262,135,271,151,3598
"10003014803",2587,264,409,0,438,48,143,0,3889
"10003014805",6482,97,2348,170,1455,63,534,0,11149
"10003014807",5585,267,1555,185,910,25,349,20,8896
"10003014808",3928,353,1592,151,316,203,379,62,6984
"10003014809",5158,444,1590,98,415,75,297,58,8135
"10003014810",4777,207,1403,125,513,218,333,298,7874
"10003014903",3213,510,2656,843,561,186,1621,405,9995
"10003014904",2530,132,1331,63,658,20,186,0,4920
"10003014906",1833,58,2006,247,728,109,186,11,5178
"10003014907",1973,475,2045,180,621,26,644,9,5973
"10003014908",577,88,1391,137,304,41,160,9,2707
"10003014909",2236,221,2745,362,736,118,575,131,7124
"10003015000",2507,240,1675,469,370,0,425,11,5697
"10003015100",2389,276,472,10,118,67,313,179,3824
"10003015200",3397,768,791,212,498,214,1070,708,7658
"10003015400",35,24,2251,501,167,9,390,24,3401
"10003015502",781,113,1207,529,179,50,253,11,3123
"10003015600",602,173,1258,98,416,5,629,104,3285
"10003015802",1330,214,186,6,552,55,732,155,3230
"10003015900",1863,136,1043,21,264,53,510,0,3890
"10003016000",1068,211,1153,273,235,184,286,369,3779
"10003016100",1128,77,466,15,122,15,53,0,1876
"10003016200",1828,326,318,28,62,153,248,113,3076
"10003016301",3323,390,511,231,621,0,582,70,5728
"10003016302",2779,59,2329,170,1475,25,485,45,7367
"10003016305",2069,174,3598,440,925,22,424,26,7678
"10003016401",3475,232,1783,36,625,0,122,0,6273
"10003016404",2473,267,410,18,45,35,137,77,3462
"10003016601",8537,368,2088,310,421,16,404,43,12187
"10003016602",5538,177,1129,45,585,0,357,0,7831
"10003016604",6938,275,2754,271,1029,244,815,244,12570
"10003016608",4072,95,181,18,100,0,61,0,4527
"10003016801",4372,138,800,17,194,10,243,10,5784
"10003016804",5242,153,1132,58,121,0,176,14,6896
"10003016901",1653,143,83,2,17,0,8,0,1906
"10003016904",1124,52,27,1,0,5,0,0,1209
"10003980100",0,0,0,0,0,0,0,0,0
"10003990100",0,0,0,0,0,0,0,0,0
"10005050101",2523,302,561,36,110,13,127,14,3686
"10005050103",3622,331,532,2,316,3,480,3,5289
"10005050104",2821,424,369,212,25,189,299,123,4462
"10005050105",3514,552,1531,86,272,288,410,405,7058
"10005050200",1860,966,657,265,160,25,342,486,4761
"10005050301",4906,469,1093,255,229,362,289,367,7970
"10005050302",3305,512,388,267,351,49,267,49,5188
"10005050401",2551,384,210,267,9,39,0,25,3485
"10005050403",1597,266,544,100,374,224,319,224,3648
"10005050405",2510,383,570,17,309,0,203,0,3992
"10005050406",1539,374,902,1040,112,31,96,67,4161
"10005050407",2514,179,816,589,211,8,134,103,4554
"10005050408",2780,428,522,12,407,81,343,81,4654
"10005050501",2442,87,641,40,216,1,226,0,3653
"10005050503",2507,624,556,339,879,427,1951,721,8004
"10005050504",3314,627,447,151,292,55,783,398,6067
"10005050601",3752,291,620,95,130,83,224,14,5209
"10005050602",3950,525,672,121,277,312,95,129,6081
"10005050701",2243,458,832,161,220,93,178,156,4341
"10005050703",1504,85,209,66,151,78,96,44,2233
"10005050704",3263,193,330,0,174,31,222,22,4235
"10005050705",4265,483,0,4,411,5,177,0,5345
"10005050706",1284,184,5,0,26,0,7,26,1532
"10005050801",2241,226,266,128,222,37,202,70,3392
"10005050802",3477,183,611,11,218,38,201,21,4760
"10005050803",5212,383,397,90,329,369,505,369,7654
"10005050901",1749,120,106,48,54,0,6,0,2083
"10005050902",3491,271,61,0,124,1,11,12,3971
"10005051003",3795,250,200,211,413,30,217,117,5233
"10005051004",3249,243,115,70,477,1,148,5,4308
"10005051005",3674,415,91,1,155,23,109,0,4468
"10005051006",2216,192,29,0,100,0,60,0,2597
"10005051007",3569,532,70,39,65,86,63,0,4424
"10005051101",603,94,0,0,0,0,0,0,697
"10005051102",899,69,0,0,14,3,0,0,985
"10005051103",780,46,4,0,8,0,10,7,855
"10005051201",1218,316,0,0,19,0,63,0,1616
"10005051202",594,9,0,0,4,0,0,0,607
"10005051203",477,52,0,0,32,0,6,0,567
"10005051204",610,15,0,0,12,0,8,0,645
"10005051205",551,13,0,0,13,0,0,0,577
"10005051301",4644,547,0,10,85,0,20,210,5516
"10005051302",2537,722,84,7,66,52,158,309,3935
"10005051303",4323,148,18,1,338,0,131,0,4959
"10005051305",2203,204,57,0,17,0,0,49,2530
"10005051306",1859,125,168,0,149,0,85,16,2402
"10005051400",3057,430,324,130,380,197,997,376,5891
"10005051500",3669,386,919,21,496,261,461,302,6515
"10005051701",3462,308,179,0,93,0,187,0,4229
"10005051702",4595,438,239,0,47,174,278,174,5945
"10005051801",3487,220,190,260,287,0,52,0,4496
"10005051802",1902,443,774,312,366,126,323,50,4296
"10005051900",3195,342,366,170,219,121,47,198,4658
"10005990000",0,0,0,0,0,0,0,0,0
"11001000100",4384,168,45,18,346,38,281,0,5280
"11001000201",0,14,0,38,0,14,0,14,80
"11001000202",2833,659,45,37,244,45,162,42,4067
"11001000300",4568,632,77,0,494,138,497,0,6406
"11001000400",1206,63,61,24,104,35,175,0,1668
"11001000501",2445,190,105,8,369,130,330,0,3577
"11001000502",2518,103,80,25,286,18,296,0,3326
"11001000600",3291,382,82,66,407,16,231,184,4659
"11001000701",3728,235,121,0,831,0,215,18,5148
"11001000702",2578,149,111,54,358,36,446,15,3747
"11001000801",4484,533,325,64,459,186,309,259,6619
"11001000802",2010,221,145,0,128,149,202,13,2868
"11001000901",3293,194,120,266,323,26,379,90,4691
"11001000902",1897,52,40,3,127,15,246,0,2380
"11001001001",6129,349,46,24,977,18,477,23,8043
"11001001002",1933,726,161,52,321,104,200,45,3542
"11001001100",3449,154,263,17,307,33,234,38,4495
"11001001200",3906,228,213,13,528,97,328,41,5354
"11001001301",3064,283,253,15,399,54,164,97,4329
"11001001302",5748,538,433,22,827,128,786,94,8576
"11001001401",2617,243,103,108,268,6,217,19,3581
"11001001402",2121,38,339,100,187,115,214,10,3124
"11001001500",4644,183,806,3,355,0,219,0,6210
"11001001600",881,13,2974,128,173,12,59,0,4240
"11001001702",1107,37,1353,260,131,35,182,0,3105
"11001001803",402,4,2238,326,642,44,859,0,4515
"11001001804",1221,246,2151,716,999,148,1875,364,7720
"11001001901",476,9,2838,361,251,0,153,0,4088
"11001001902",259,51,1549,140,167,4,312,0,2482
"11001002001",548,47,957,162,828,6,657,22,3227
"11001002002",910,223,1590,360,557,33,647,265,4585
"11001002101",620,136,2844,672,1166,294,1660,390,7782
"11001002102",440,0,2428,676,1076,250,1153,239,6262
"11001002201",422,16,2464,212,477,26,502,0,4119
"11001002202",192,31,1971,643,585,173,461,204,4260
"11001002301",580,34,1543,344,331,36,308,18,3194
"11001002302",264,343,641,147,90,30,15,0,1530
"11001002400",906,76,1949,295,565,102,638,133,4664
"11001002501",711,10,887,721,114,62,305,128,2938
"11001002502",1477,244,2198,458,985,129,1657,328,7476
"11001002600",926,67,1057,29,274,42,140,32,2567
"11001002701",2990,402,622,67,272,71,670,167,5261
"11001002702",4273,143,788,63,533,47,1461,47,7355
"11001002801",1320,222,1085,474,1014,95,1149,243,5602
"11001002802",2359,189,643,500,1005,157,1928,220,7001
"11001002900",2128,227,1220,143,985,43,1504,170,6420
"11001003000",1486,164,1000,825,240,11,306,103,4135
"11001003100",1192,247,998,74,734,35,1019,233,4532
"11001003200",1396,210,2219,400,387,111,1120,208,6051
"11001003301",1104,169,1298,284,432,38,278,21,3624
"11001003302",563,65,969,315,249,41,190,41,2433
"11001003400",727,81,1194,423,225,175,309,175,3309
"11001003500",857,82,828,675,400,43,544,61,3490
"11001003600",1965,153,1396,265,509,152,661,43,5144
"11001003700",2289,156,1100,484,762,74,1296,103,6264
"11001003800",3195,159,571,201,747,121,773,121,5888
"11001003900",2956,434,601,88,580,0,605,34,5298
"11001004001",3103,56,43,0,207,18,226,34,3687
"11001004002",2070,60,237,0,263,45,185,15,2875
"11001004100",2095,122,106,5,308,45,302,46,3029
"11001004201",2859,117,308,98,346,0,222,22,3972
"11001004202",2054,152,75,14,376,31,153,1,2856
"11001004300",1827,128,673,278,375,6,364,38,3689
"11001004400",3202,365,1163,171,309,281,203,203,5897
"11001004600",858,9,1396,262,244,13,125,0,2907
"11001004701",640,39,1684,837,302,80,143,16,3741
"11001004702",912,42,562,251,172,24,71,0,2034
"11001004801",669,54,926,179,296,18,71,3,2216
"11001004802",940,29,1211,471,344,196,337,36,3564
"11001004901",979,224,645,322,181,14,179,180,2724
"11001004902",1560,137,510,51,199,174,384,119,3134
"11001005001",1295,54,377,107,200,0,115,0,2148
"11001005002",3252,403,930,144,736,102,926,280,6773
"11001005201",3936,278,405,80,1036,100,435,78,6348
"11001005301",4060,250,172,25,594,82,354,75,5612
"11001005500",4290,521,80,28,762,419,459,33,6592
"11001005600",2954,565,197,91,684,276,424,208,5399
"11001005800",1707,29,135,74,506,213,280,0,2944
"11001005900",1408,158,337,490,404,36,174,18,3025
"11001006202",0,0,0,0,0,0,0,0,0
"11001006400",83,0,932,996,116,38,11,0,2176
"11001006500",2087,97,107,63,107,0,161,13,2635
"11001006600",1637,69,44,2,110,7,62,0,1931
"11001006700",3126,115,433,38,237,30,90,0,4069
"11001006801",631,28,964,281,55,10,48,0,2017
"11001006802",1008,75,805,110,165,74,202,27,2466
"11001006804",0,0,6,103,0,0,0,0,109
"11001006900",1604,41,565,64,114,0,27,0,2415
"11001007000",1653,71,156,107,38,14,83,0,2122
"11001007100",1081,141,790,1092,166,0,183,15,3468
"11001007200",1763,191,837,219,282,0,73,27,3392
"11001007301",1810,62,491,0,253,13,342,13,2984
"11001007304",38,16,1903,1477,58,27,63,0,3582
"11001007401",5,54,1065,1386,5,0,24,79,2618
"11001007403",0,0,2094,1253,49,2,49,64,3511
"11001007404",20,3,1895,1455,37,15,0,15,3440
"11001007406",0,0,1908,1481,0,0,27,31,3447
"11001007407",28,0,2019,460,79,0,0,23,2609
"11001007408",26,0,1501,1095,18,8,18,8,2674
"11001007409",0,0,2524,1439,0,0,12,0,3975
"11001007502",20,20,2324,2292,8,12,10,0,4686
"11001007503",3,0,1479,923,11,0,0,0,2416
"11001007504",42,10,1058,1161,0,0,0,0,2271
"11001007601",39,28,3197,792,14,23,0,0,4093
"11001007603",188,94,2539,443,98,0,89,76,3527
"11001007604",136,9,2612,601,83,0,52,0,3493
"11001007605",31,13,2377,1054,136,51,12,0,3674
"11001007703",0,0,3481,1628,107,0,107,0,5323
"11001007707",51,0,3219,847,108,0,0,0,4225
"11001007708",25,0,1613,1153,0,0,0,0,2791
"11001007709",28,8,1079,397,110,0,69,0,1691
"11001007803",30,0,2199,617,47,9,40,0,2942
"11001007804",0,0,1965,933,105,19,132,0,3154
"11001007806",31,13,1581,453,29,13,5,0,2125
"11001007807",33,2,1512,664,13,0,33,0,2257
"11001007808",27,5,2734,1901,30,0,49,10,4756
"11001007809",31,13,1802,801,49,0,26,0,2722
"11001007901",392,6,2586,1106,238,0,92,39,4459
"11001007903",142,0,1078,327,64,5,6,0,1622
"11001008001",1357,21,704,271,304,5,118,0,2780
"11001008002",2060,81,1056,214,276,0,173,0,3860
"11001008100",2528,115,439,17,165,0,163,35,3462
"11001008200",2322,214,74,4,205,19,177,0,3015
"11001008301",1888,154,317,19,227,34,141,13,2793
"11001008302",1609,115,367,13,154,7,151,3,2419
"11001008402",1067,68,783,172,54,13,62,13,2232
"11001008410",480,33,722,59,80,7,116,0,1497
"11001008701",522,17,1406,311,21,25,27,0,2329
"11001008702",187,84,1320,244,192,95,196,95,2413
"11001008802",459,95,2394,1293,160,75,13,0,4489
"11001008803",34,32,404,636,179,6,150,22,1463
"11001008804",72,5,1450,870,219,56,166,19,2857
"11001008903",131,0,1837,909,86,100,74,161,3298
"11001008904",59,23,1947,855,360,0,311,10,3565
"11001009000",32,36,2423,448,28,0,29,10,3006
"11001009102",319,8,3084,1498,130,45,233,39,5356
"11001009201",302,57,621,228,102,33,48,30,1421
"11001009203",257,70,1713,272,237,60,159,105,2873
"11001009204",243,33,1346,896,229,183,435,171,3536
"11001009301",1035,36,1699,432,286,15,130,16,3649
"11001009302",161,7,751,27,146,0,9,12,1113
"11001009400",484,282,3013,315,120,69,349,107,4739
"11001009501",287,139,3218,591,313,489,462,580,6079
"11001009503",392,9,2140,596,32,14,21,68,3272
"11001009504",382,14,1620,229,284,34,288,27,2878
"11001009505",25,0,2056,287,287,42,203,56,2956
"11001009507",92,7,1359,57,31,0,141,7,1694
"11001009508",175,15,2605,214,465,156,384,156,4170
"11001009509",284,29,2639,151,190,0,390,0,3683
"11001009601",0,1,1392,1081,39,0,7,0,2520
"11001009602",0,11,1799,1271,101,0,101,11,3294
"11001009603",21,9,2117,403,163,22,128,0,2863
"11001009604",22,2,1782,216,3,0,37,8,2070
"11001009700",3,3,1818,1066,22,10,3,10,2935
"11001009801",3,2,1081,894,3,66,16,5,2070
"11001009802",0,0,660,543,0,0,0,0,1203
"11001009803",20,23,1472,1120,0,0,0,0,2635
"11001009804",10,16,1810,698,32,0,6,16,2588
"11001009807",94,4,1917,1003,11,0,24,0,3053
"11001009810",0,3,1316,656,95,9,0,9,2088
"11001009811",0,0,2600,2173,47,0,0,0,4820
"11001009901",152,0,1860,196,71,0,50,0,2329
"11001009902",8,8,2154,748,25,0,19,0,2962
"11001009903",14,22,1220,230,29,0,23,0,1538
"11001009904",22,0,1122,503,40,81,39,89,1896
"11001009905",99,2,1774,601,14,1,82,0,2573
"11001009906",1,26,975,211,0,0,3,11,1227
"11001009907",14,0,1536,1151,29,43,53,43,2869
"11001010100",1438,202,211,42,438,58,334,26,2749
"11001010200",1176,36,930,109,325,0,217,0,2793
"11001010300",323,37,1636,351,321,177,400,190,3435
"11001010400",179,40,2511,1116,30,4,0,4,3884
"11001010500",1721,27,1059,346,507,0,229,13,3902
"11001010600",2250,207,1160,466,444,124,418,117,5186
"11001010700",851,315,160,12,295,49,51,0,1733
"11001010800",605,464,97,57,90,314,100,45,1772
"11001010900",15,62,1482,2308,0,31,11,12,3921
"11001011000",1802,60,1017,75,323,0,207,46,3530
"11001011100",463,85,2929,694,207,28,337,20,4763
"12001000200",1577,3587,474,385,55,277,284,669,7308
"12001000301",1206,895,519,317,129,84,144,37,3331
"12001000302",1075,465,845,92,151,36,91,29,2784
"12001000400",1710,378,2403,780,172,82,305,187,6017
"12001000500",3069,693,742,429,122,33,285,107,5480
"12001000600",278,50,2271,1317,78,31,40,21,4086
"12001000700",949,192,3637,1226,49,86,0,21,6160
"12001000806",757,786,64,92,125,151,99,141,2215
"12001000808",1369,536,327,404,548,525,170,112,3991
"12001000809",421,158,329,38,159,40,15,18,1178
"12001000901",241,118,4,0,296,239,116,106,1120
"12001000902",4,0,29,0,79,3,0,0,115
"12001001000",3079,3107,0,32,233,157,257,395,7260
"12001001100",5032,438,74,31,344,50,407,36,6412
"12001001201",2233,73,62,26,217,182,255,0,3048
"12001001202",4798,328,793,406,538,0,650,40,7553
"12001001203",2047,542,269,316,268,132,243,176,3993
"12001001400",403,263,1158,436,54,52,60,12,2438
"12001001514",289,462,111,113,33,33,26,155,1222
"12001001515",937,1603,371,489,550,645,170,476,5241
"12001001516",515,512,338,37,224,168,109,116,2019
"12001001517",1273,1774,605,547,254,682,115,605,5855
"12001001519",500,496,266,308,217,660,108,182,2737
"12001001520",740,934,149,144,133,100,253,268,2721
"12001001521",1421,1071,658,220,377,314,314,301,4676
"12001001603",630,622,185,104,90,22,44,46,1743
"12001001604",3075,2916,340,737,311,525,466,632,9002
"12001001701",3170,715,543,851,393,151,354,60,6237
"12001001702",3697,225,301,24,398,172,107,104,5028
"12001001801",4670,824,961,273,139,35,69,146,7117
"12001001802",1531,177,340,479,224,5,117,0,2873
"12001001803",4433,217,704,719,520,27,344,68,7032
"12001001805",1174,86,124,118,55,20,66,0,1643
"12001001806",6300,986,531,352,361,143,519,171,9363
"12001001811",4543,409,369,5,1348,163,722,59,7618
"12001001813",2310,85,74,0,508,0,210,0,3187
"12001001814",2712,30,47,0,211,0,575,0,3575
"12001001902",508,825,867,910,225,10,37,61,3443
"12001001907",1728,614,295,44,91,28,29,150,2979
"12001001908",3075,360,617,85,179,38,85,15,4454
"12001002000",3043,1127,751,361,95,34,3,22,5436
"12001002101",1296,202,220,71,77,6,87,0,1959
"12001002102",627,47,135,33,4,0,34,0,880
"12001002201",3104,340,394,137,367,39,99,20,4500
"12001002202",4662,203,368,43,219,0,143,55,5693
"12001002204",8454,555,826,0,1685,69,845,19,12453
"12001002205",7748,285,315,257,705,100,911,70,10391
"12001002207",3047,104,159,0,414,0,395,0,4119
"12001002208",2355,39,37,0,129,0,238,0,2798
"12001002209",5194,580,727,123,1156,57,456,156,8449
"12001002210",2577,552,614,599,60,0,343,83,4828
"12001002217",1849,686,1374,1276,185,314,323,232,6239
"12001002218",727,220,819,442,58,40,41,59,2406
"12001002219",2599,888,798,233,359,131,339,262,5609
"12001002220",1291,133,353,139,135,12,64,23,2150
"12001110800",1454,425,78,43,47,12,100,144,2303
"12003040101",5132,693,415,0,193,121,154,0,6708
"12003040102",4913,1286,707,187,88,0,0,133,7314
"12003040201",3613,1285,748,308,30,0,63,73,6120
"12003040202",4335,316,85,56,19,0,82,0,4893
"12005000201",4095,394,0,0,96,94,173,19,4871
"12005000202",3961,653,58,0,554,47,165,47,5485
"12005000300",5590,1038,0,44,90,104,140,56,7062
"12005000400",6485,1338,14,0,327,65,24,66,8319
"12005000500",3870,248,486,0,287,88,69,21,5069
"12005000600",1103,256,6,0,34,0,49,4,1452
"12005000700",1649,211,230,42,629,41,372,26,3200
"12005000803",2875,409,442,237,323,274,155,37,4752
"12005000804",1847,409,169,0,237,0,111,0,2773
"12005000805",2887,695,393,28,532,111,140,0,4786
"12005000806",2384,190,507,27,282,221,108,25,3744
"12005000900",2831,384,685,89,228,153,231,0,4601
"12005001000",947,297,522,219,82,41,26,7,2141
"12005001100",1718,549,1165,400,462,211,88,1,4594
"12005001200",2237,288,381,218,129,87,291,60,3691
"12005001301",4211,311,345,273,182,25,258,0,5605
"12005001302",5163,542,568,118,242,102,223,24,6982
"12005001402",5045,553,960,0,348,0,153,0,7059
"12005001403",1480,345,121,120,186,40,27,0,2319
"12005001404",5259,735,262,0,452,0,256,0,6964
"12005001501",4164,192,361,12,169,58,450,14,5420
"12005001502",4408,240,461,25,231,0,251,6,5622
"12005001600",598,420,1686,741,104,25,114,101,3789
"12005001700",945,267,1178,585,252,31,264,3,3525
"12005001800",635,300,76,58,283,49,95,3,1499
"12005001900",3394,305,26,0,211,23,345,34,4338
"12005002000",1082,133,69,32,223,3,5,0,1547
"12005002200",2541,884,524,751,83,218,392,417,5810
"12005002300",3078,718,197,0,149,97,198,55,4492
"12005002400",2373,856,156,139,161,55,103,286,4129
"12005002500",2342,165,31,0,250,0,59,0,2847
"12005002601",1754,256,76,0,189,0,202,0,2477
"12005002603",1681,440,0,13,27,0,6,0,2167
"12005002604",6013,503,184,52,428,0,116,0,7296
"12005002605",1129,124,0,0,0,0,98,0,1351
"12005002606",1509,347,0,0,110,12,107,0,2085
"12005002607",1008,130,5,0,31,0,62,0,1236
"12005002608",2373,0,0,0,84,0,80,0,2537
"12005002701",2844,378,74,0,247,0,132,21,3696
"12005002702",2224,366,12,0,50,15,49,0,2716
"12005002703",2624,292,117,44,160,0,343,0,3580
"12005002704",4141,549,89,0,236,146,245,55,5461
"12005002705",1674,121,22,40,109,9,201,35,2211
"12005990000",0,0,0,0,0,0,0,0,0
"12007000100",2695,610,1273,780,351,29,10,0,5748
"12007000200",4484,1001,193,87,124,66,83,19,6057
"12007000300",6499,944,612,259,186,0,327,4,8831
"12007000400",2956,362,325,266,40,0,60,0,4009
"12009060101",2487,390,365,463,183,22,183,0,4093
"12009060102",2745,135,0,0,127,0,40,0,3047
"12009060200",4675,133,399,3,159,28,136,0,5533
"12009060300",3944,365,382,223,131,71,275,100,5491
"12009060400",2544,640,444,106,204,157,203,58,4356
"12009060500",3366,645,891,177,101,40,103,56,5379
"12009060600",2815,745,653,628,135,38,281,308,5603
"12009060700",881,253,760,626,8,278,59,172,3037
"12009061001",2678,591,716,23,424,42,339,99,4912
"12009061002",2353,414,151,0,54,119,105,44,3240
"12009061100",4463,409,470,40,173,0,368,2,5925
"12009061201",5415,281,677,0,491,46,432,0,7342
"12009061202",2875,307,115,0,496,9,298,0,4100
"12009062103",6641,584,378,15,219,41,532,101,8511
"12009062104",5747,580,401,42,137,11,520,63,7501
"12009062106",2507,520,108,8,170,206,46,263,3828
"12009062107",2209,477,47,141,33,11,102,1,3021
"12009062108",4987,416,297,16,594,17,438,9,6774
"12009062109",2315,447,217,128,48,2,25,0,3182
"12009062301",1102,236,1143,1026,214,84,165,104,4074
"12009062302",1398,744,291,437,257,246,217,217,3807
"12009062400",3886,1130,635,350,432,140,656,557,7786
"12009062500",2073,384,906,631,52,0,67,89,4202
"12009062600",279,225,1045,724,55,293,56,246,2923
"12009062800",3544,229,93,67,26,0,390,19,4368
"12009062900",2819,319,1191,385,217,0,198,0,5129
"12009063000",3021,196,385,32,346,37,422,0,4439
"12009063102",6650,309,372,199,606,0,382,114,8632
"12009063104",2554,119,538,0,161,0,124,0,3496
"12009063105",6527,248,913,76,889,110,908,28,9699
"12009063106",3202,178,341,36,494,12,178,0,4441
"12009063107",6972,308,762,0,703,74,712,81,9612
"12009064102",4483,83,229,15,274,0,519,0,5603
"12009064123",4748,522,325,0,240,16,391,214,6456
"12009064124",3036,243,143,80,217,26,66,42,3853
"12009064125",4192,514,126,38,722,88,331,215,6226
"12009064126",4077,98,186,11,197,38,62,11,4680
"12009064127",5859,396,243,5,555,7,612,11,7688
"12009064128",9721,615,604,0,814,0,1303,38,13095
"12009064201",1679,315,0,7,116,34,166,23,2340
"12009064202",1652,585,25,65,99,16,57,77,2576
"12009064301",5082,786,89,60,213,31,423,0,6684
"12009064302",3978,658,548,86,554,45,471,92,6432
"12009064400",4308,551,26,147,210,0,327,27,5596
"12009064500",3180,914,0,33,134,45,163,317,4786
"12009064601",6215,369,202,5,259,31,379,6,7466
"12009064602",1535,244,0,0,96,0,0,0,1875
"12009064700",2958,765,23,42,5,17,91,153,4054
"12009064800",1512,527,168,128,126,2,29,26,2518
"12009064901",4088,580,329,67,298,238,412,12,6024
"12009064902",1108,554,1032,367,34,212,228,28,3563
"12009065001",2253,107,56,0,91,39,293,0,2839
"12009065021",8110,822,350,0,681,18,497,48,10526
"12009065022",3780,613,76,0,314,0,405,62,5250
"12009065121",3903,1383,676,181,537,118,933,589,8320
"12009065122",3379,1163,645,558,610,97,584,321,7357
"12009065123",2593,317,296,122,97,10,162,8,3605
"12009065124",622,135,852,655,79,121,32,52,2548
"12009065125",4098,609,800,62,74,171,499,102,6415
"12009065201",3872,677,181,279,107,78,811,27,6032
"12009065202",4022,597,291,199,230,99,692,172,6302
"12009065231",4378,518,306,93,99,155,216,29,5794
"12009065234",2991,341,0,0,28,20,47,28,3455
"12009065235",4292,1014,36,0,38,33,181,9,5603
"12009065236",1284,38,23,0,219,0,43,14,1621
"12009066101",3612,260,102,0,32,20,327,118,4471
"12009066103",1831,136,0,0,10,16,14,16,2023
"12009066104",4651,436,0,0,164,59,482,1,5793
"12009066200",2063,411,0,0,154,0,88,100,2816
"12009066301",5027,762,13,29,302,74,126,49,6382
"12009066302",3452,504,0,12,289,0,231,61,4549
"12009066400",4270,476,0,0,103,191,110,35,5185
"12009066500",2671,317,44,11,211,98,110,64,3526
"12009066600",4337,193,0,0,84,0,147,0,4761
"12009066700",4001,162,156,0,112,26,107,61,4625
"12009066800",1251,57,8,11,84,0,183,14,1608
"12009066900",5171,699,59,2,328,0,374,1,6634
"12009067100",525,54,282,0,186,9,168,45,1269
"12009068101",1895,269,0,0,165,14,17,8,2368
"12009068102",2887,468,16,1,63,0,56,12,3503
"12009068200",2267,250,0,0,112,0,63,0,2692
"12009068300",2438,82,0,0,27,10,0,0,2557
"12009068400",1980,123,17,4,167,3,96,44,2434
"12009068501",2001,126,36,6,23,0,71,0,2263
"12009068502",2010,504,99,0,61,0,119,0,2793
"12009068601",1733,380,115,0,73,0,56,0,2357
"12009068602",2791,471,0,0,118,0,247,28,3655
"12009069100",4106,317,81,0,46,77,240,54,4921
"12009069200",1996,314,0,0,10,0,262,8,2590
"12009069300",2928,291,1,0,201,22,476,17,3936
"12009069400",5081,100,563,0,296,0,123,19,6182
"12009069700",1500,359,127,53,145,0,98,122,2404
"12009069801",2703,223,58,23,245,56,326,1,3635
"12009069802",2936,773,245,15,317,88,312,96,4782
"12009069901",6477,763,17,0,355,43,414,39,8108
"12009069902",2445,133,362,597,278,0,290,0,4105
"12009071100",2910,340,20,0,60,0,96,8,3434
"12009071200",11210,791,228,14,1310,44,1139,51,14787
"12009071301",3947,99,161,11,178,0,466,46,4908
"12009071322",5419,719,1201,365,971,161,1524,235,10595
"12009071332",6701,1901,1809,689,609,228,1233,618,13788
"12009071334",5747,567,846,718,608,71,895,47,9499
"12009071335",3508,189,480,59,227,0,332,30,4825
"12009071336",4191,482,401,526,473,14,563,68,6718
"12009071337",4363,1466,1159,121,260,241,719,277,8606
"12009071338",4793,986,1964,21,527,14,866,303,9474
"12009071339",5022,912,865,341,678,0,942,283,9043
"12009071340",7363,1180,1685,777,951,63,1562,96,13677
"12009071400",2084,721,154,265,80,46,56,128,3534
"12009071500",2159,197,132,54,59,28,280,0,2909
"12009071600",3280,648,166,0,107,26,115,0,4342
"12009980000",0,0,0,0,0,0,0,0,0
"12009980100",0,0,0,0,0,0,0,0,0
"12009990000",0,0,0,0,0,0,0,0,0
"12011010102",2768,243,277,84,11,0,299,40,3722
"12011010103",3003,261,0,0,12,40,101,38,3455
"12011010104",2001,104,0,0,48,0,180,9,2342
"12011010200",4388,802,331,3,325,90,874,288,7101
"12011010304",486,179,1781,904,57,0,352,131,3890
"12011010305",2124,712,777,698,95,0,702,396,5504
"12011010306",635,66,912,457,194,0,240,14,2518
"12011010307",1177,348,1520,1352,389,71,533,167,5557
"12011010308",3583,508,268,49,12,13,221,35,4689
"12011010401",3789,361,152,63,325,44,932,47,5713
"12011010402",2373,237,63,53,169,73,358,8,3334
"12011010403",4191,996,0,13,14,95,116,15,5440
"12011010405",3886,1112,1417,356,516,80,971,529,8867
"12011010406",2929,450,287,31,537,16,632,324,5206
"12011010407",4193,237,190,0,289,31,714,14,5668
"12011010502",2053,119,261,10,259,54,300,37,3093
"12011010503",9351,353,421,0,1025,518,1903,274,13845
"12011010504",4190,312,414,39,649,8,595,93,6300
"12011010601",6988,211,288,58,974,0,1747,38,10304
"12011010603",3947,262,576,34,616,36,746,44,6261
"12011010604",2831,62,726,46,131,0,514,0,4310
"12011010605",5275,87,542,0,608,67,1415,19,8013
"12011010606",4579,470,617,102,578,133,1644,461,8584
"12011010607",7536,197,1273,266,1246,44,2813,122,13497
"12011010609",2643,301,286,97,753,0,779,183,5042
"12011010610",4217,540,270,18,436,96,737,385,6699
"12011010611",3390,90,259,106,416,29,897,44,5231
"12011010612",4565,134,615,0,823,35,1220,92,7484
"12011010701",2130,554,1655,361,271,43,652,284,5950
"12011010702",2045,878,3410,1287,94,65,1216,443,9438
"12011010800",3823,891,1119,529,308,91,1894,588,9243
"12011010901",1860,251,46,0,38,59,111,59,2424
"12011010902",2420,258,18,0,69,0,146,0,2911
"12011011000",1468,58,18,10,30,0,116,14,1714
"12011020101",5250,659,817,8,1526,0,2806,404,11470
"12011020103",3053,299,1066,264,466,178,534,233,6093
"12011020104",1321,260,414,26,74,51,419,83,2648
"12011020204",3388,435,1178,250,359,144,1178,48,6980
"12011020205",3556,411,1476,138,930,0,1265,59,7835
"12011020206",2235,470,776,318,506,69,876,151,5401
"12011020207",3483,180,1378,113,219,35,1031,38,6477
"12011020209",1975,238,360,14,336,80,1270,49,4322
"12011020210",3854,552,836,479,645,78,1742,20,8206
"12011020211",1891,391,144,0,39,7,520,69,3061
"12011020212",2181,316,351,25,243,105,600,167,3988
"12011020302",4165,554,1135,741,565,41,1187,386,8774
"12011020308",2141,181,1801,801,412,161,1076,224,6797
"12011020309",3924,256,794,117,412,0,1529,63,7095
"12011020311",1804,388,560,16,128,23,206,88,3213
"12011020312",3381,285,930,65,640,54,1102,147,6604
"12011020313",3680,441,1434,367,292,206,1291,194,7905
"12011020314",3313,509,862,42,334,41,1128,295,6524
"12011020315",3301,224,717,407,359,0,741,85,5834
"12011020316",2607,267,1007,44,202,129,997,319,5572
"12011020317",2698,139,305,64,27,58,905,162,4358
"12011020318",6583,177,691,254,1171,38,1909,53,10876
"12011020319",5102,182,525,186,370,5,1539,81,7990
"12011020320",3508,420,377,339,690,54,1263,521,7172
"12011020321",1427,79,298,28,29,0,85,4,1950
"12011020322",2610,32,129,110,343,0,753,0,3977
"12011020323",2007,341,556,126,274,10,1130,156,4600
"12011020324",3698,304,1815,67,451,216,1797,171,8519
"12011020325",1670,61,687,0,578,15,904,23,3938
"12011020326",2545,457,1612,566,769,172,1447,404,7972
"12011020404",2204,265,3970,1161,935,68,1645,257,10505
"12011020405",1807,556,1614,509,510,75,1333,491,6895
"12011020406",4237,717,1408,471,731,86,2039,445,10134
"12011020407",2631,479,3327,1406,548,151,1337,497,10376
"12011020409",6061,791,934,48,697,36,1626,157,10350
"12011020411",4426,508,653,33,261,21,1279,347,7528
"12011020412",546,235,1480,870,357,20,719,245,4472
"12011020413",2255,389,2979,502,547,0,1092,332,8096
"12011020414",3023,266,116,66,119,34,851,254,4729
"12011020415",2403,153,442,183,440,0,875,75,4571
"12011020501",1708,398,1813,229,503,120,999,147,5917
"12011020502",2038,450,3169,450,531,385,1041,713,8777
"12011030100",4018,181,108,46,61,0,210,12,4636
"12011030201",2125,509,744,274,72,0,703,136,4563
"12011030202",887,57,260,493,10,98,113,0,1918
"12011030203",3738,414,299,92,226,79,1575,198,6621
"12011030301",625,436,907,425,96,17,259,374,3139
"12011030302",2111,547,2883,1559,155,0,630,148,8033
"12011030401",82,31,2182,919,24,0,15,0,3253
"12011030402",54,218,1756,1769,46,239,109,407,4598
"12011030500",1127,884,2022,801,181,29,773,729,6546
"12011030600",486,505,3203,1430,88,13,207,199,6131
"12011030702",2240,73,554,193,341,20,522,37,3980
"12011030703",3117,307,661,0,251,15,1015,25,5391
"12011030704",3595,278,291,0,564,100,619,76,5523
"12011030705",2973,455,45,30,37,21,233,29,3823
"12011030801",2632,1053,1316,768,811,207,1651,873,9311
"12011030802",5175,878,253,17,416,54,1192,227,8212
"12011030902",2759,330,284,104,118,11,314,44,3964
"12011030903",2150,765,138,337,184,44,310,460,4388
"12011030904",3970,270,45,78,150,0,493,0,5006
"12011031001",1560,180,45,177,190,0,293,0,2445
"12011031002",3396,559,98,48,127,65,611,91,4995
"12011031101",1819,220,0,177,26,0,72,42,2356
"12011031102",2893,311,105,0,48,9,339,17,3722
"12011031202",5255,485,45,37,156,27,481,58,6544
"12011031203",1012,22,6,0,41,0,20,0,1101
"12011031204",1792,512,0,4,44,0,126,51,2529
"12011031205",1469,92,0,6,48,0,113,14,1742
"12011040101",1139,165,0,0,62,0,44,0,1410
"12011040102",2695,257,48,0,16,5,310,0,3331
"12011040203",1332,183,17,0,93,0,122,15,1762
"12011040204",2384,205,52,0,98,25,393,46,3203
"12011040205",3670,229,21,97,73,23,561,25,4699
"12011040206",1864,209,20,21,125,0,451,0,2690
"12011040300",2922,425,135,19,224,33,467,156,4381
"12011040401",1896,98,15,0,35,16,121,0,2181
"12011040402",2614,160,44,12,33,9,405,19,3296
"12011040502",2760,349,25,2,75,110,131,14,3466
"12011040503",1424,160,194,1,26,0,57,8,1870
"12011040504",2881,210,23,0,104,0,168,0,3386
"12011040601",2899,681,42,0,184,21,284,0,4111
"12011040602",2735,396,0,37,151,6,287,74,3686
"12011040701",2078,333,152,0,140,45,251,102,3101
"12011040702",2244,372,315,130,157,232,296,253,3999
"12011040801",963,428,2003,1708,107,56,164,128,5557
"12011040802",1856,384,1453,537,390,258,457,236,5571
"12011040901",192,12,2695,1485,91,6,158,6,4645
"12011040902",179,49,2415,887,71,0,159,112,3872
"12011041000",50,52,1561,1347,4,48,5,35,3102
"12011041100",83,5,3097,1574,22,3,166,5,4955
"12011041200",76,20,3289,1446,35,35,149,1,5051
"12011041300",140,0,5634,818,63,0,113,0,6768
"12011041400",167,71,1482,1673,0,0,12,67,3472
"12011041500",54,30,1346,1572,60,70,19,0,3151
"12011041600",568,38,3258,1485,398,21,286,0,6054
"12011041700",491,471,1007,1787,171,45,166,238,4376
"12011041801",1154,141,0,32,81,12,179,47,1646
"12011041802",2334,250,104,41,202,0,316,37,3284
"12011041900",2744,123,36,11,95,0,421,0,3430
"12011042000",3022,382,101,0,70,37,310,24,3946
"12011042100",2195,355,26,34,84,7,353,15,3069
"12011042200",2924,229,11,0,91,0,96,10,3361
"12011042301",3300,310,62,0,32,53,315,218,4290
"12011042302",587,396,191,417,76,0,209,80,1956
"12011042400",1222,36,20,0,28,0,119,0,1425
"12011042500",3437,664,524,80,909,242,1067,278,7201
"12011042600",3251,658,279,399,131,16,400,80,5214
"12011042700",2699,717,1183,828,204,55,800,214,6700
"12011042800",1768,1138,3730,1090,277,30,1100,1033,10166
"12011042900",691,266,4909,1272,428,26,305,106,8003
"12011043001",1273,42,0,0,45,14,274,14,1662
"12011043002",4948,741,982,226,353,102,2814,511,10677
"12011043100",3595,722,326,2,311,141,882,539,6518
"12011043301",3320,288,474,1,288,2,795,12,5180
"12011043302",872,306,117,92,36,0,170,109,1702
"12011050100",3101,376,58,28,1022,416,1994,636,7631
"12011050204",3202,497,899,274,293,226,604,333,6328
"12011050205",2743,262,67,0,0,0,236,18,3326
"12011050206",1987,334,389,0,63,19,657,71,3520
"12011050207",2604,335,1064,645,354,242,731,63,6038
"12011050208",1395,439,1113,100,300,91,763,514,4715
"12011050301",559,33,6063,1143,352,153,405,55,8763
"12011050306",353,154,2784,799,102,123,145,143,4603
"12011050307",355,257,3788,1337,238,120,197,261,6553
"12011050308",38,37,1983,1094,14,16,43,16,3241
"12011050309",715,283,740,385,360,0,695,246,3424
"12011050310",1878,229,3597,383,239,40,478,78,6922
"12011050311",834,281,1467,596,137,11,234,15,3575
"12011050312",389,181,985,229,122,40,227,15,2188
"12011050401",1651,466,1527,94,227,16,533,285,4799
"12011050402",2713,467,408,41,345,35,699,118,4826
"12011050501",2276,526,394,32,47,59,891,242,4467
"12011050502",3196,210,639,269,519,38,1571,126,6568
"12011050601",2781,213,7,106,117,35,388,35,3682
"12011050602",2128,500,556,59,203,36,527,226,4235
"12011050701",1420,347,836,687,363,169,759,382,4963
"12011050702",2104,502,1624,881,984,73,1562,288,8018
"12011050800",456,53,3093,814,223,82,211,29,4961
"12011050900",3222,323,1179,357,644,14,813,59,6611
"12011051001",2766,359,58,0,42,0,473,121,3819
"12011051002",2144,215,211,16,61,0,193,9,2849
"12011060105",2710,467,1714,880,603,26,1399,187,7986
"12011060107",1348,193,808,175,399,0,839,122,3884
"12011060109",2223,138,301,62,90,6,737,29,3586
"12011060111",3465,298,1410,104,527,21,1340,33,7198
"12011060112",3499,543,781,71,155,64,1420,225,6758
"12011060113",3505,433,1701,83,538,11,1299,296,7866
"12011060114",2489,201,3521,239,556,39,759,189,7993
"12011060115",3060,301,2134,138,770,121,1732,95,8351
"12011060116",3110,278,2321,747,757,18,1190,93,8514
"12011060117",2449,553,1768,295,858,177,1894,642,8636
"12011060118",3911,168,593,15,418,5,1333,57,6500
"12011060119",3107,272,652,1,554,15,1114,185,5900
"12011060120",4506,244,1563,133,929,162,2228,179,9944
"12011060121",3825,256,526,42,634,27,836,85,6231
"12011060122",3183,204,983,0,485,88,1622,84,6649
"12011060123",1271,77,2165,178,243,28,639,28,4629
"12011060124",984,279,1981,746,239,158,444,220,5051
"12011060125",525,96,1097,234,435,17,429,81,2914
"12011060126",1052,41,3374,377,735,114,336,11,6040
"12011060127",925,152,710,787,132,0,272,80,3058
"12011060128",1975,301,2431,775,501,40,1086,174,7283
"12011060203",289,107,3354,1710,163,119,181,60,5983
"12011060206",2500,327,1010,486,294,6,1449,189,6261
"12011060207",1525,480,1131,76,270,77,831,267,4657
"12011060208",720,192,2987,898,243,39,258,145,5482
"12011060209",760,72,1549,97,156,16,391,35,3076
"12011060210",1904,189,515,214,207,18,364,48,3459
"12011060211",3033,243,532,0,192,49,652,92,4793
"12011060212",2294,60,404,167,128,0,1077,36,4166
"12011060213",2562,605,518,33,614,77,1006,337,5752
"12011060302",283,190,4049,2678,244,27,239,95,7805
"12011060303",86,0,4261,1433,124,35,85,35,6059
"12011060304",94,2,1849,1172,48,0,0,5,3170
"12011060305",326,22,1588,304,183,12,300,12,2747
"12011060306",618,219,510,115,144,16,246,45,1913
"12011060401",474,83,2431,1014,117,0,145,8,4272
"12011060402",193,14,4133,1602,113,19,286,19,6379
"12011060403",335,242,3029,1570,141,78,213,37,5645
"12011060501",2869,309,2024,68,329,68,1123,265,7055
"12011060503",3251,29,549,119,570,0,744,13,5275
"12011060504",3840,167,356,0,251,28,930,23,5595
"12011060505",2730,334,481,28,276,93,581,81,4604
"12011060603",2920,161,566,65,522,62,1498,142,5936
"12011060605",2485,310,625,109,173,0,888,129,4719
"12011060606",2726,458,1636,164,439,121,1053,148,6745
"12011060607",2337,113,119,53,96,0,167,2,2887
"12011060608",4204,1029,985,228,858,0,1615,150,9069
"12011060609",2077,320,484,0,125,74,748,180,4008
"12011060700",2107,135,571,318,140,5,262,14,3552
"12011060801",1071,153,332,49,255,132,225,9,2226
"12011060802",733,125,4109,527,552,176,1007,112,7341
"12011060900",3521,146,495,0,247,131,827,8,5375
"12011061001",5558,218,462,116,258,0,1102,35,7749
"12011061002",6667,176,442,80,802,51,1983,45,10246
"12011061100",4212,1298,486,106,1037,85,3724,1174,12122
"12011070101",3612,1596,993,454,898,364,1621,885,10423
"12011070102",1055,102,3,0,28,0,167,42,1397
"12011070204",2468,475,608,327,246,192,717,147,5180
"12011070205",4100,442,199,3,379,173,1677,65,7038
"12011070207",4855,306,34,89,317,24,1036,70,6731
"12011070208",6240,665,538,8,1148,67,1932,193,10791
"12011070209",4521,90,11,0,472,0,536,39,5669
"12011070210",2664,206,88,49,179,0,904,109,4199
"12011070211",4446,196,258,97,288,210,1123,27,6645
"12011070304",6371,196,613,55,738,24,2830,55,10882
"12011070305",5535,1106,182,0,1164,303,3655,503,12448
"12011070306",5713,81,1195,69,956,16,2105,28,10163
"12011070310",2541,204,126,0,385,10,1440,96,4802
"12011070311",4675,302,79,0,620,55,2138,263,8132
"12011070312",6289,466,59,0,440,39,2460,183,9936
"12011070313",8329,529,529,0,1429,0,4750,341,15907
"12011070314",3667,290,269,4,615,11,2128,121,7105
"12011070315",4100,62,640,0,755,152,1687,180,7576
"12011070316",4258,177,543,34,533,16,1519,38,7118
"12011070317",11605,707,599,299,1321,216,7244,591,22582
"12011070318",6511,155,212,0,59,67,2387,188,9579
"12011070319",4120,86,47,0,354,51,1787,33,6478
"12011070320",5573,247,119,0,566,63,2471,103,9142
"12011070321",2136,266,275,0,274,168,997,177,4293
"12011070322",4493,577,169,18,1195,36,4173,445,11106
"12011070401",5111,162,313,0,630,113,2193,122,8644
"12011070402",2734,90,167,10,183,0,636,15,3835
"12011070403",4273,400,281,79,804,0,1532,99,7468
"12011070404",2904,218,35,0,200,0,662,16,4035
"12011070405",3643,100,338,54,753,26,1257,56,6227
"12011070501",4899,148,192,47,562,13,1352,61,7274
"12011070502",2658,961,1432,322,1570,202,2624,822,10591
"12011070601",3022,701,270,185,302,119,1494,333,6426
"12011070602",3148,538,168,146,105,60,1199,203,5567
"12011080101",3910,322,199,42,431,14,1018,42,5978
"12011080102",2005,388,1001,705,200,143,746,67,5255
"12011080103",1177,128,40,11,11,0,388,48,1803
"12011080200",950,104,16,0,37,0,225,11,1343
"12011080402",2059,555,143,29,69,7,345,138,3345
"12011080403",3500,776,1346,56,613,163,1021,240,7715
"12011080405",1666,168,154,72,334,253,579,207,3433
"12011080406",4445,778,610,0,345,43,1342,135,7698
"12011080500",1205,231,2651,2275,228,42,621,235,7488
"12011090101",5161,463,0,0,31,0,747,46,6448
"12011090102",1262,238,16,0,69,0,128,49,1762
"12011090200",3681,261,11,0,77,15,534,52,4631
"12011090301",1311,344,167,96,75,18,173,51,2235
"12011090302",3964,997,270,393,510,53,1428,187,7802
"12011090401",2524,391,285,215,248,24,893,127,4707
"12011090403",1474,350,727,210,350,142,844,219,4316
"12011090404",2078,935,659,591,478,228,874,361,6204
"12011090502",5665,621,402,23,324,0,1188,228,8451
"12011090503",2393,146,24,0,20,0,65,0,2648
"12011090504",1867,530,338,0,420,238,640,415,4448
"12011090601",2101,335,39,29,811,22,1570,176,5083
"12011090602",4301,763,377,63,1032,243,2175,689,9643
"12011090700",4794,548,1015,341,838,212,2809,388,10945
"12011090801",2761,341,465,7,300,84,1129,392,5479
"12011090802",3099,485,313,127,238,178,1032,319,5791
"12011090900",4442,177,543,16,343,17,1309,52,6899
"12011091000",3019,247,453,102,231,0,1202,79,5333
"12011091100",2737,1053,1467,282,453,428,1901,803,9124
"12011091201",2321,399,615,188,1172,72,2148,363,7278
"12011091202",2427,615,722,102,830,298,2144,699,7837
"12011091300",2548,271,654,12,706,17,2041,213,6462
"12011091400",2154,361,1899,406,873,220,1862,436,8211
"12011091500",1838,196,2328,439,560,70,1360,159,6950
"12011091600",3701,432,840,173,591,61,1716,108,7622
"12011091701",2372,291,369,137,281,144,1172,214,4980
"12011091702",2273,399,660,374,259,77,572,125,4739
"12011091801",2018,345,2099,649,728,0,1265,284,7388
"12011091802",1310,326,1168,386,211,0,858,200,4459
"12011091901",2336,398,308,26,143,53,542,100,3906
"12011091902",2932,588,574,26,533,105,976,259,5993
"12011092000",3481,257,52,0,202,0,1017,46,5055
"12011100101",5631,625,244,18,330,53,1246,120,8267
"12011100103",3130,454,40,13,107,19,855,43,4661
"12011100104",2481,329,77,0,141,33,925,83,4069
"12011100105",1942,352,23,10,73,0,513,71,2984
"12011100201",848,245,62,90,116,7,648,103,2119
"12011100202",3551,742,182,108,215,76,962,532,6368
"12011100300",3833,638,880,879,441,24,2366,621,9682
"12011100400",704,299,2271,1595,466,82,974,328,6719
"12011100501",310,127,210,110,89,58,171,100,1175
"12011100502",1402,1122,621,135,355,35,765,703,5138
"12011100600",2619,814,1159,165,717,128,1668,528,7798
"12011100700",244,144,3456,1315,53,55,131,48,5446
"12011100801",549,328,1626,634,95,117,408,182,3939
"12011100802",2128,338,4615,457,300,63,1313,245,9459
"12011110100",4437,273,739,287,351,0,1866,110,8063
"12011110301",5173,197,605,25,654,0,3674,133,10461
"12011110302",6046,371,1770,77,448,196,3443,337,12688
"12011110303",3085,168,516,1,441,42,1549,160,5962
"12011110307",4379,75,427,0,285,4,2128,42,7340
"12011110308",4166,621,1099,143,775,101,2083,625,9613
"12011110309",4341,299,907,0,804,176,2488,208,9223
"12011110311",4553,251,1380,129,1015,147,3038,11,10524
"12011110312",5036,285,1344,83,934,49,3274,209,11214
"12011110313",2874,1079,769,77,645,228,2190,1003,8865
"12011110319",1338,156,2867,175,664,26,1178,73,6477
"12011110320",1320,79,6056,1261,545,329,1095,475,11160
"12011110321",3410,182,896,72,413,26,2738,176,7913
"12011110322",5318,636,2936,130,1066,248,5184,817,16335
"12011110323",849,132,3516,536,697,20,1091,201,7042
"12011110324",8744,227,4934,156,2550,32,8348,148,25139
"12011110325",11816,309,6971,157,3982,342,10382,207,34166
"12011110326",3082,39,769,77,614,3,2196,22,6802
"12011110327",4429,229,499,8,1000,27,3043,11,9246
"12011110328",3899,243,1008,48,570,110,2483,229,8590
"12011110330",2314,43,689,0,426,0,1759,43,5274
"12011110331",6152,204,1329,51,1732,90,4319,45,13922
"12011110332",2815,58,761,105,599,0,1596,0,5934
"12011110333",4126,22,925,0,1803,447,3569,238,11130
"12011110334",2272,117,96,38,116,18,1086,92,3835
"12011110335",5388,1137,496,73,483,150,2494,874,11095
"12011110336",2291,377,1906,282,1453,138,2105,360,8912
"12011110337",2728,184,1824,490,833,118,2362,183,8722
"12011110338",1998,152,1273,122,421,59,1512,151,5688
"12011110339",2757,263,562,0,335,24,1590,52,5583
"12011110340",2871,614,1753,198,1023,48,1534,93,8134
"12011110341",763,164,1520,275,237,0,698,58,3715
"12011110342",4471,456,4664,142,999,0,3837,343,14912
"12011110343",4052,319,2044,45,2144,37,3760,163,12564
"12011110402",468,85,3408,440,512,159,303,46,5421
"12011110403",1339,557,2207,608,680,123,1242,550,7306
"12011110404",1385,49,3115,569,615,19,1251,119,7122
"12011110501",844,111,1788,368,301,127,601,40,4180
"12011110502",973,20,2946,720,200,21,683,32,5595
"12011110600",3092,837,301,15,508,234,1376,472,6835
"12011980000",21,0,0,0,0,0,0,0,21
"12011990000",0,0,0,0,0,0,0,0,0
"12013010100",1793,491,33,2,36,24,26,23,2428
"12013010200",2929,583,0,0,18,0,148,0,3678
"12013010300",3639,1530,1004,233,181,93,9,282,6971
"12015010100",2475,183,0,1,93,79,247,21,3099
"12015010200",3681,754,19,0,187,11,168,0,4820
"12015010301",2734,211,10,0,177,0,22,0,3154
"12015010302",1663,875,473,0,47,222,19,380,3679
"12015010401",2753,104,0,0,22,0,58,0,2937
"12015010402",1974,366,28,0,5,74,0,0,2447
"12015010403",1845,67,6,15,14,26,145,0,2118
"12015010404",3833,32,14,0,71,0,31,0,3981
"12015010501",3457,427,0,1,6,12,129,74,4106
"12015010502",6007,480,30,0,207,0,302,1,7027
"12015020101",5384,1055,889,12,56,10,556,65,8027
"12015020103",3799,648,589,14,223,49,196,166,5684
"12015020104",1774,36,114,15,38,0,50,0,2027
"12015020201",5279,612,911,427,94,39,539,103,8004
"12015020202",4919,683,662,30,328,79,978,82,7761
"12015020301",4446,457,270,57,335,53,177,64,5859
"12015020302",2306,420,262,143,434,50,419,173,4207
"12015020303",3529,880,308,191,57,6,266,70,5307
"12015020400",7024,480,355,63,290,0,339,0,8551
"12015020501",3849,275,267,85,127,0,209,0,4812
"12015020502",1446,63,0,0,128,43,154,43,1877
"12015020601",1531,331,33,82,179,0,224,114,2494
"12015020602",2324,435,121,0,87,26,91,58,3142
"12015020700",2817,958,44,129,326,12,234,0,4520
"12015020800",2741,986,255,111,88,64,285,160,4690
"12015020900",4378,682,362,55,527,67,319,53,6443
"12015021001",1348,94,39,17,22,4,4,4,1532
"12015021002",2645,124,34,0,52,0,81,31,2967
"12015021003",1951,399,447,14,48,0,114,127,3100
"12015030100",4831,831,51,25,152,13,343,148,6394
"12015030200",6095,995,0,0,198,79,410,67,7844
"12015030301",2606,270,0,0,15,6,92,6,2995
"12015030302",3265,309,0,0,7,0,0,0,3581
"12015030401",1407,404,19,86,0,0,9,156,2081
"12015030402",1503,105,0,0,11,10,0,10,1639
"12015030501",3185,250,22,0,28,0,20,0,3505
"12015030502",4455,299,194,0,35,0,32,0,5015
"12015030503",5256,692,14,0,15,0,43,0,6020
"12015990000",0,0,0,0,0,0,0,0,0
"12017450101",4601,937,192,170,213,8,386,14,6521
"12017450102",2918,701,251,116,135,52,121,52,4346
"12017450201",2433,770,13,0,188,14,205,21,3644
"12017450202",2924,1136,64,21,97,0,142,136,4520
"12017450302",7142,977,282,107,263,36,566,281,9654
"12017450303",3966,1298,9,93,380,117,475,75,6413
"12017450304",8573,588,213,167,209,14,507,73,10344
"12017450400",4813,1075,0,7,139,166,75,50,6325
"12017450500",3769,435,0,133,210,1,60,66,4674
"12017450601",3338,1356,51,0,11,135,112,296,5299
"12017450602",3280,456,401,73,93,23,60,9,4395
"12017450701",5388,391,316,0,433,0,160,17,6705
"12017450702",6574,1199,151,417,299,18,399,143,9200
"12017450800",3614,912,53,0,36,41,173,0,4829
"12017450901",2553,292,0,7,11,29,36,11,2939
"12017450902",1804,434,49,105,108,0,14,0,2514
"12017451000",4416,629,18,0,225,36,222,0,5546
"12017451101",1577,80,12,0,80,0,91,0,1840
"12017451102",4449,866,42,98,186,94,86,82,5903
"12017451200",3043,636,13,67,122,0,63,49,3993
"12017451300",2594,390,75,18,38,14,259,67,3455
"12017451400",3103,555,19,0,331,14,230,99,4351
"12017451501",2345,492,61,0,0,16,64,10,2988
"12017451502",4785,1673,0,5,250,0,56,117,6886
"12017451601",4765,409,0,0,57,0,40,45,5316
"12017451602",5989,858,0,0,77,23,156,0,7103
"12017451700",3264,1060,3,2,36,0,0,0,4365
"12017990000",0,0,0,0,0,0,0,0,0
"12019030102",6490,1623,279,86,237,0,41,11,8767
"12019030103",4217,777,0,0,106,15,144,180,5439
"12019030104",2720,432,82,0,159,14,204,10,3621
"12019030201",8245,907,2147,126,751,222,822,312,13532
"12019030202",7698,383,880,0,380,0,266,0,9607
"12019030203",10461,640,2829,641,2793,100,2131,172,19767
"12019030301",4949,269,1515,69,608,25,829,66,8330
"12019030303",2007,179,456,70,264,79,581,13,3649
"12019030304",2692,266,694,79,531,0,607,108,4977
"12019030400",993,327,221,43,243,16,301,16,2160
"12019030500",1818,365,131,17,293,24,182,8,2838
"12019030600",3437,425,560,28,271,157,134,178,5190
"12019030701",6723,173,5,4,277,16,237,0,7435
"12019030702",10291,852,869,10,1152,22,1221,75,14492
"12019030703",10105,228,667,0,978,114,701,137,12930
"12019030801",4814,189,201,68,244,13,550,0,6079
"12019030802",4900,664,775,59,268,16,105,132,6919
"12019030902",6220,782,1252,272,1094,357,858,392,11227
"12019030903",3192,493,84,63,174,44,256,62,4368
"12019030904",5420,297,866,17,865,10,771,25,8271
"12019031101",2507,241,0,32,78,0,103,0,2961
"12019031104",3057,416,16,83,20,7,151,0,3750
"12019031105",1504,427,10,0,9,18,0,44,2012
"12019031106",5300,678,219,0,121,0,100,17,6435
"12019031107",304,4,0,0,11,0,0,0,319
"12019031108",1068,101,91,0,57,0,26,10,1353
"12019031200",12200,888,753,113,375,0,906,5,15240
"12019031300",4275,365,83,310,228,0,342,0,5603
"12019031400",2708,741,991,351,156,70,710,74,5801
"12019031500",2464,627,3,0,64,13,77,24,3272
"12021000101",1324,79,0,0,11,0,14,10,1438
"12021000102",1307,64,0,3,0,0,28,2,1404
"12021000200",1485,261,25,0,106,0,109,0,1986
"12021000301",2823,108,0,0,13,1,126,33,3104
"12021000302",1247,79,8,0,8,0,21,0,1363
"12021000401",2604,168,11,0,11,18,26,0,2838
"12021000402",1811,0,0,0,0,0,0,0,1811
"12021000500",1741,88,0,0,46,0,118,28,2021
"12021000600",1475,74,8,0,48,9,17,0,1631
"12021000700",170,232,418,246,0,0,26,118,1210
"12021010102",4540,306,74,19,49,40,452,87,5567
"12021010105",3843,140,21,0,86,0,441,9,4540
"12021010106",4007,193,0,19,93,0,36,0,4348
"12021010107",3754,162,0,0,263,0,290,41,4510
"12021010108",2482,161,0,0,0,0,176,0,2819
"12021010109",2068,265,0,0,221,0,330,165,3049
"12021010110",4055,707,76,5,561,44,1023,372,6843
"12021010205",2237,167,58,0,88,0,102,0,2652
"12021010208",3069,96,0,0,5,0,11,0,3181
"12021010209",1510,27,0,0,6,0,45,0,1588
"12021010210",3252,307,5,0,64,27,118,83,3856
"12021010211",1511,80,106,50,8,0,225,12,1992
"12021010212",5201,314,9,0,108,118,348,167,6265
"12021010213",4042,219,12,0,75,0,146,0,4494
"12021010215",2006,86,17,0,37,0,0,0,2146
"12021010300",2638,654,293,292,132,0,530,330,4869
"12021010401",3193,399,24,315,288,16,614,25,4874
"12021010405",9627,536,560,110,410,194,1663,157,13257
"12021010408",2221,204,15,7,239,59,366,111,3222
"12021010410",5093,2143,669,447,669,201,4400,2171,15793
"12021010411",5232,422,1274,104,167,269,3247,543,11258
"12021010412",7518,679,544,0,160,70,2361,254,11586
"12021010413",5612,891,196,1,429,125,2461,566,10281
"12021010414",6037,601,698,69,279,37,1993,205,9919
"12021010415",11959,658,45,135,1151,0,1609,152,15709
"12021010416",4759,150,25,0,161,0,432,40,5567
"12021010417",4867,334,77,0,91,0,807,88,6264
"12021010418",4824,243,189,0,80,0,719,58,6113
"12021010419",2452,479,373,360,121,200,1667,599,6251
"12021010420",3550,876,666,588,758,1121,3229,1816,12604
"12021010505",5410,451,245,132,386,9,1335,122,8090
"12021010506",4152,1494,11,0,454,116,1155,1148,8530
"12021010507",2860,547,505,204,173,0,670,483,5442
"12021010508",3202,525,257,0,240,0,747,118,5089
"12021010509",4056,737,344,38,36,24,121,431,5787
"12021010510",2724,375,18,0,54,0,35,28,3234
"12021010601",1445,850,185,52,36,56,489,287,3400
"12021010602",2302,131,434,66,126,0,569,0,3628
"12021010604",2091,366,398,82,20,0,373,163,3493
"12021010605",2367,348,477,24,59,11,321,10,3617
"12021010606",1778,55,56,0,59,0,85,5,2038
"12021010701",2998,484,345,72,418,0,947,171,5435
"12021010702",2273,373,124,185,73,0,685,91,3804
"12021010801",2974,223,146,0,6,0,128,0,3477
"12021010802",5517,1453,1464,656,797,128,3087,1224,14326
"12021010803",3083,414,380,0,65,69,565,189,4765
"12021010902",3432,234,0,0,30,73,269,100,4138
"12021010903",4675,357,0,0,15,0,220,53,5320
"12021010904",1756,201,0,0,0,0,244,159,2360
"12021010905",2358,303,16,0,5,0,208,0,2890
"12021011001",1523,29,9,4,44,0,12,0,1621
"12021011002",1816,30,45,0,39,0,73,0,2003
"12021011102",6432,993,72,52,381,12,1099,351,9392
"12021011103",1302,773,369,0,6,5,249,538,3242
"12021011105",2238,185,0,0,47,0,732,25,3227
"12021011106",2026,371,48,113,136,0,234,270,3198
"12021011201",5943,866,89,0,265,14,341,146,7664
"12021011202",14882,1643,304,286,974,136,6221,1111,25557
"12021011204",587,911,589,886,309,385,864,1358,5889
"12021011205",290,603,255,502,326,250,548,806,3580
"12021011301",4101,1430,371,320,520,38,4483,1441,12704
"12021011302",2660,1534,655,351,246,846,2537,2178,11007
"12021011400",2250,1041,95,126,201,182,2233,1169,7297
"12021990000",0,0,0,0,0,0,0,0,0
"12023110201",2892,314,390,526,147,174,389,153,4985
"12023110202",2448,268,1208,1110,86,40,38,55,5253
"12023110300",2437,571,1007,401,171,53,115,11,4766
"12023110400",1358,341,687,587,206,56,171,31,3437
"12023110500",4095,828,635,718,324,38,209,68,6915
"12023110601",6870,1379,352,248,586,105,370,15,9925
"12023110602",3107,730,228,0,74,0,273,89,4501
"12023110700",3244,483,633,121,205,88,235,23,5032
"12023110800",4830,783,172,304,186,38,0,66,6379
"12023110901",4046,718,15,4,180,0,159,1,5123
"12023110903",2750,600,120,0,166,0,297,4,3937
"12023110904",4526,793,549,98,72,70,212,39,6359
"12027010101",3555,986,0,43,92,0,490,434,5600
"12027010102",2019,872,96,144,48,25,635,339,4178
"12027010200",2403,573,519,435,419,57,975,397,5778
"12027010301",4187,2351,132,177,241,85,2394,1895,11462
"12027010302",206,287,984,935,16,11,31,277,2747
"12027010403",2341,335,12,120,38,21,74,3,2944
"12027010404",1669,832,16,10,62,6,172,405,3172
"12027010405",1255,28,0,11,23,0,0,11,1328
"12027010406",2319,1036,35,5,116,217,674,604,5006
"12029970101",2708,760,574,219,75,58,54,1,4449
"12029970102",5670,1004,0,0,163,54,94,0,6985
"12029970200",2887,520,262,0,196,26,20,13,3924
"12029990000",0,0,0,0,0,0,0,0,0
"12031000100",2078,234,1231,852,112,0,0,14,4521
"12031000200",58,125,1723,1014,19,0,0,0,2939
"12031000300",313,262,796,694,19,76,30,0,2190
"12031000600",2191,813,671,786,653,266,387,181,5948
"12031000700",3139,201,474,77,249,52,130,15,4337
"12031000800",2061,96,72,63,86,23,78,21,2500
"12031001000",294,151,394,1012,22,53,17,27,1970
"12031001100",654,147,384,213,58,30,80,0,1566
"12031001200",528,96,902,458,142,30,33,0,2189
"12031001300",176,218,1919,1326,37,0,95,58,3829
"12031001400",695,148,2654,1680,99,0,38,0,5314
"12031001500",57,22,2152,1805,65,45,0,284,4430
"12031001600",10,11,793,873,0,10,0,0,1697
"12031002101",2114,126,247,370,197,18,131,0,3203
"12031002102",2290,195,110,24,121,28,148,0,2916
"12031002200",3867,580,104,13,118,75,166,17,4940
"12031002300",1498,106,42,142,51,0,175,0,2014
"12031002400",1581,124,0,11,15,19,33,0,1783
"12031002501",1034,457,941,853,145,131,222,109,3892
"12031002502",2763,237,345,39,258,86,125,0,3853
"12031002600",192,305,1341,1152,0,18,32,24,3064
"12031002701",457,7,1477,1582,49,5,46,0,3623
"12031002702",734,130,1638,794,74,8,26,8,3412
"12031002801",29,123,2656,1259,7,0,0,247,4321
"12031002802",46,73,2455,1193,55,7,28,0,3857
"12031002901",49,16,2041,1617,29,0,42,1,3795
"12031002902",16,1,1611,1510,13,40,10,42,3243
"12031010101",4632,386,542,199,256,75,369,0,6459
"12031010102",6693,1170,1270,58,958,32,554,71,10806
"12031010103",4276,175,740,9,408,1,377,4,5990
"12031010201",5947,1158,1822,325,608,41,676,230,10807
"12031010202",2552,258,49,0,175,148,121,0,3303
"12031010301",2375,698,560,33,243,8,83,22,4022
"12031010303",1457,118,4373,669,317,174,254,174,7536
"12031010304",509,103,5069,626,270,56,285,0,6918
"12031010401",791,198,875,1048,57,0,48,85,3102
"12031010402",1547,217,1324,576,132,287,207,46,4336
"12031010500",3673,1171,8750,1084,798,113,705,0,16294
"12031010600",4284,428,815,165,13,32,258,14,6009
"12031010700",144,103,3874,1104,64,10,0,36,5335
"12031010800",101,32,4321,987,14,21,11,27,5514
"12031010900",315,51,2313,1105,70,85,16,74,4029
"12031011000",681,142,2045,802,95,143,0,0,3908
"12031011100",298,29,1746,1113,23,31,9,0,3249
"12031011200",161,12,1923,257,0,14,40,20,2427
"12031011300",21,0,1696,1197,0,15,0,0,2929
"12031011400",29,5,1893,523,71,0,70,0,2591
"12031011500",140,44,2509,1438,8,41,8,22,4210
"12031011600",0,98,2295,1414,15,0,0,0,3822
"12031011700",1239,587,770,270,71,50,23,0,3010
"12031011800",1234,249,949,762,101,176,105,47,3623
"12031011901",5613,956,933,115,358,94,353,181,8603
"12031011902",5485,1401,2555,622,1045,129,933,0,12170
"12031011903",3607,463,732,101,363,0,138,0,5404
"12031012000",3191,403,540,389,287,178,584,55,5627
"12031012100",659,318,178,99,73,82,48,60,1517
"12031012200",2385,789,2159,1796,170,301,322,195,8117
"12031012300",2261,279,376,186,256,24,166,0,3548
"12031012400",2417,198,200,8,34,0,86,0,2943
"12031012500",1892,269,321,655,271,130,213,72,3823
"12031012601",1027,152,923,635,143,82,146,0,3108
"12031012602",2070,254,1749,410,324,50,440,0,5297
"12031012702",2812,690,1016,268,155,45,282,147,5415
"12031012703",2816,405,1130,338,908,71,267,21,5956
"12031012704",1850,135,1831,770,371,114,367,86,5524
"12031012800",3259,285,1583,1915,544,154,207,112,8059
"12031012900",1532,185,512,7,242,12,51,7,2548
"12031013000",2504,140,43,0,62,0,10,0,2759
"12031013100",1683,210,312,71,28,0,27,0,2331
"12031013200",578,245,175,51,131,34,140,46,1400
"12031013300",3819,734,1662,771,699,164,471,438,8758
"12031013402",2343,1059,691,510,340,49,178,327,5497
"12031013403",1704,359,373,204,44,84,93,71,2932
"12031013404",1213,249,623,647,107,139,98,199,3275
"12031013502",1348,339,1509,186,246,0,369,202,4199
"12031013503",3381,642,2887,1024,958,330,700,208,10130
"12031013504",2257,377,2030,991,759,156,1135,283,7988
"12031013521",3609,541,4097,1636,1199,50,1345,10,12487
"12031013522",1756,273,916,578,279,47,416,132,4397
"12031013721",4066,1092,2639,214,651,79,1195,677,10613
"12031013723",3577,604,927,137,472,39,492,187,6435
"12031013726",5537,511,1890,63,1605,159,781,303,10849
"12031013727",4844,544,2376,0,1409,143,559,18,9893
"12031013800",1083,235,108,12,290,63,220,68,2079
"12031013901",2359,377,719,212,142,66,294,0,4169
"12031013902",3001,317,630,284,271,14,620,52,5189
"12031013904",2397,804,819,219,144,146,250,203,4982
"12031013905",4248,267,9,0,92,0,35,181,4832
"12031013906",3548,147,374,0,188,0,287,0,4544
"12031014001",3659,364,0,0,14,0,248,0,4285
"12031014002",2344,97,7,0,186,0,168,0,2802
"12031014101",4065,204,8,13,144,0,135,5,4574
"12031014102",2676,531,23,8,239,47,156,27,3707
"12031014202",3106,448,135,294,121,52,120,48,4324
"12031014203",3634,188,94,153,93,0,167,0,4329
"12031014204",3782,483,455,123,267,57,249,73,5489
"12031014311",2754,564,641,258,260,92,473,278,5320
"12031014312",4115,300,1407,430,474,347,587,411,8071
"12031014326",5755,517,290,133,647,66,278,57,7743
"12031014328",3616,191,934,106,1356,231,649,25,7108
"12031014329",1846,191,361,0,391,0,265,28,3082
"12031014330",3947,332,205,0,427,34,163,206,5314
"12031014331",3860,570,120,41,284,6,436,230,5547
"12031014332",5849,616,576,49,631,0,478,37,8236
"12031014333",2631,66,556,21,56,0,322,26,3678
"12031014334",2544,391,1122,179,224,21,176,48,4705
"12031014335",5601,163,1013,15,748,11,541,14,8106
"12031014336",3973,290,824,24,1361,75,787,43,7377
"12031014337",5091,478,1478,799,3023,99,1390,144,12502
"12031014338",2071,271,654,265,926,66,317,24,4594
"12031014401",7135,1458,1105,729,1418,165,1606,646,14262
"12031014404",3196,1011,572,205,660,111,207,44,6006
"12031014406",5336,359,266,77,932,0,248,85,7303
"12031014408",2883,388,350,202,265,85,214,0,4387
"12031014409",6971,308,348,0,1002,0,458,0,9087
"12031014410",6031,347,157,69,269,12,619,1,7505
"12031014411",4235,606,640,171,2669,48,394,59,8822
"12031014412",9077,527,1666,32,1329,104,1264,50,14049
"12031014413",4243,364,197,76,1050,7,1026,75,7038
"12031014500",3115,640,477,284,244,143,509,274,5686
"12031014601",5408,274,320,7,249,0,485,71,6814
"12031014603",2635,510,1281,56,702,84,305,84,5657
"12031014604",1840,300,1269,229,324,27,509,0,4498
"12031014701",2786,683,2667,619,478,22,230,91,7576
"12031014702",1508,361,600,522,209,91,181,17,3489
"12031014800",1524,137,635,491,80,64,297,51,3279
"12031014901",3698,335,1178,139,330,44,318,25,6067
"12031014902",3274,285,2199,262,742,39,606,0,7407
"12031015001",3152,258,935,123,497,83,150,51,5249
"12031015002",1951,221,941,270,83,15,116,35,3632
"12031015100",2423,247,1284,418,169,0,600,9,5150
"12031015200",1299,71,779,286,108,106,301,115,3065
"12031015300",1594,309,611,327,158,33,173,31,3236
"12031015400",1126,250,660,217,46,0,76,32,2407
"12031015501",1414,254,482,363,149,14,130,21,2827
"12031015502",1267,342,1581,1209,232,0,77,44,4752
"12031015600",2550,481,611,42,147,21,142,11,4005
"12031015700",2390,580,906,410,324,74,207,167,5058
"12031015801",4581,615,553,295,167,84,462,65,6822
"12031015802",2681,820,1307,1324,762,243,557,204,7898
"12031015922",1805,233,531,132,485,36,268,9,3499
"12031015923",5171,376,581,636,1015,13,437,124,8353
"12031015924",3339,380,410,62,127,0,506,110,4934
"12031015925",1616,701,1062,198,889,178,604,13,5261
"12031015926",2847,345,737,198,449,22,445,54,5097
"12031016000",4453,539,384,302,790,28,934,28,7458
"12031016100",3805,719,913,806,767,237,1106,536,8889
"12031016200",1022,372,257,67,227,161,118,147,2371
"12031016300",1006,107,367,224,119,318,108,19,2268
"12031016400",3980,333,163,204,23,0,139,170,5012
"12031016500",4477,108,135,1,330,471,228,0,5750
"12031016601",2435,1028,1497,657,791,174,602,359,7543
"12031016603",2666,65,132,0,55,28,109,19,3074
"12031016604",2848,230,427,172,665,153,586,101,5182
"12031016711",4081,60,57,11,112,0,151,0,4472
"12031016722",5225,603,792,176,464,220,501,133,8114
"12031016724",3054,430,775,98,278,0,323,81,5039
"12031016725",2053,217,715,209,450,92,389,67,4192
"12031016726",2409,120,120,0,521,69,344,18,3601
"12031016727",2261,345,35,0,122,46,228,174,3211
"12031016728",3352,183,404,0,385,100,266,68,4758
"12031016729",4657,440,876,92,364,55,645,55,7184
"12031016801",1938,95,2,0,108,13,151,31,2338
"12031016803",6474,103,101,0,443,16,491,0,7628
"12031016804",7131,152,319,33,501,0,330,0,8466
"12031016805",5855,0,602,64,1082,109,606,109,8427
"12031016806",9044,599,900,15,1177,0,1369,39,13143
"12031016807",2761,235,64,0,189,0,83,133,3465
"12031016808",2836,354,355,15,147,96,251,85,4139
"12031017100",3289,581,267,221,95,20,244,22,4739
"12031017200",493,119,523,627,91,4,239,34,2130
"12031017300",5268,560,778,226,399,27,444,19,7721
"12031017400",140,48,1014,1126,0,31,35,48,2442
"12031990000",0,0,0,0,0,0,0,0,0
"12033000100",695,201,291,157,109,25,67,21,1566
"12033000300",1122,266,482,138,215,0,111,0,2334
"12033000400",335,169,1294,1274,74,96,43,40,3325
"12033000500",876,226,225,159,54,9,72,8,1629
"12033000600",253,59,823,356,162,37,62,0,1752
"12033000800",2639,364,1225,326,96,48,215,19,4932
"12033000900",2009,221,129,30,134,0,103,6,2632
"12033001001",5311,275,53,183,526,162,265,27,6802
"12033001002",2123,353,264,0,165,126,64,0,3095
"12033001101",5042,130,293,45,324,44,361,78,6317
"12033001103",1995,293,239,9,138,0,89,37,2800
"12033001104",4702,589,560,21,172,103,280,5,6432
"12033001201",2444,528,714,260,443,104,345,22,4860
"12033001202",2414,182,805,300,69,43,29,89,3931
"12033001300",1168,196,1581,1112,45,38,72,0,4212
"12033001401",1063,179,59,5,24,5,7,23,1365
"12033001402",3049,316,1214,1547,387,350,466,66,7395
"12033001500",0,0,796,451,0,0,0,0,1247
"12033001600",73,0,589,241,10,61,52,0,1026
"12033001700",799,300,555,890,9,18,4,175,2750
"12033001800",464,251,828,484,33,19,49,19,2147
"12033001900",426,95,506,617,199,133,16,17,2009
"12033002000",581,179,737,701,3,203,0,25,2429
"12033002100",1624,826,796,433,199,313,62,212,4465
"12033002200",1753,436,262,524,163,66,38,85,3327
"12033002300",3416,654,247,26,103,57,68,0,4571
"12033002400",594,3,172,0,97,18,111,21,1016
"12033002500",2490,204,0,0,130,95,89,54,3062
"12033002601",2056,340,122,0,195,0,116,0,2829
"12033002602",1151,27,0,0,14,5,0,5,1202
"12033002603",5620,540,670,50,821,32,485,26,8244
"12033002604",3270,346,175,35,265,10,119,19,4239
"12033002605",3970,184,321,49,414,214,637,37,5826
"12033002701",2045,142,353,195,403,25,47,0,3210
"12033002703",986,384,616,981,94,140,89,180,3470
"12033002704",2630,587,475,280,679,176,220,135,5182
"12033002801",1335,516,481,444,152,0,90,33,3051
"12033002802",3062,735,489,637,495,51,204,311,5984
"12033002803",1088,300,458,480,270,57,86,0,2739
"12033002804",1042,191,339,57,176,0,262,0,2067
"12033002900",1912,643,628,766,405,78,31,117,4580
"12033003000",2993,484,1443,916,278,106,249,32,6501
"12033003100",1348,214,2179,877,246,241,43,3,5151
"12033003201",2071,52,1052,784,336,41,348,0,4684
"12033003203",1586,143,2017,488,153,31,46,17,4481
"12033003204",1891,37,406,0,360,0,192,30,2916
"12033003301",2876,280,280,53,190,11,114,3,3807
"12033003305",1522,165,145,23,119,22,16,41,2053
"12033003306",4047,520,1220,77,713,30,159,12,6778
"12033003307",995,240,515,38,501,331,51,74,2745
"12033003308",2382,163,742,0,316,13,123,22,3761
"12033003309",4296,736,687,178,800,151,240,206,7294
"12033003400",2654,591,773,294,252,128,183,45,4920
"12033003503",4698,608,361,67,282,231,139,37,6423
"12033003505",2482,326,210,5,109,10,165,80,3387
"12033003506",2509,207,954,268,235,0,53,15,4241
"12033003507",2609,722,1241,211,880,81,541,38,6323
"12033003508",3733,760,1233,496,124,126,34,100,6606
"12033003603",5104,625,412,0,524,37,134,0,6836
"12033003607",1066,145,69,7,87,22,4,7,1407
"12033003608",6220,1197,480,76,195,144,229,2,8543
"12033003609",2628,444,571,51,115,102,52,0,3963
"12033003610",5605,696,519,22,398,46,286,0,7572
"12033003611",3944,428,417,0,303,15,286,4,5397
"12033003612",3791,194,256,0,328,79,215,52,4915
"12033003613",3418,467,257,4,180,5,121,0,4452
"12033003614",3769,214,568,537,151,0,47,28,5314
"12033003700",2142,945,509,91,144,97,60,34,4022
"12033003800",3076,242,361,45,189,195,10,39,4157
"12033003900",3743,393,450,54,151,197,140,13,5141
"12033004000",1504,254,569,467,66,16,6,2,2884
"12033990000",0,0,0,0,0,0,0,0,0
"12035060103",1252,125,52,0,59,70,87,61,1706
"12035060104",2769,333,117,7,139,337,278,16,3996
"12035060105",3129,236,57,8,120,0,119,0,3669
"12035060106",2553,411,0,0,0,0,9,20,2993
"12035060107",2963,422,378,50,260,188,380,204,4845
"12035060204",4450,562,795,77,599,774,449,731,8437
"12035060205",4755,1276,576,419,112,13,870,107,8128
"12035060206",3473,783,148,341,148,41,82,28,5044
"12035060207",3162,658,401,441,143,91,145,8,5049
"12035060208",4512,1255,303,487,378,34,512,25,7506
"12035060209",4913,822,646,226,571,0,650,50,7878
"12035060210",2684,507,406,77,159,73,134,72,4112
"12035060211",3974,251,440,289,946,43,1036,35,7014
"12035060212",3051,614,771,338,291,24,345,34,5468
"12035060213",3282,506,831,552,829,574,551,558,7683
"12035060214",5402,912,791,301,450,27,488,17,8388
"12035060301",3537,159,350,0,263,47,247,43,4646
"12035060302",3479,140,27,0,0,0,143,0,3789
"12035060303",2014,31,68,0,20,10,37,0,2180
"12035060304",2415,23,37,0,0,0,14,0,2489
"12035990000",0,0,0,0,0,0,0,0,0
"12037970100",1926,738,78,38,61,11,34,28,2914
"12037970200",2236,535,90,2,73,0,40,23,2999
"12037970302",1344,314,300,99,52,0,11,0,2120
"12037970304",1228,151,200,84,14,0,55,10,1742
"12037990000",0,0,0,0,0,0,0,0,0
"12037990100",0,0,0,0,0,0,0,0,0
"12039020101",2734,404,777,461,85,16,18,28,4523
"12039020102",2199,360,1947,978,155,17,73,7,5736
"12039020300",1094,226,3385,1224,20,137,291,321,6698
"12039020400",1584,685,1150,870,173,76,103,70,4711
"12039020500",1859,124,2467,644,83,186,874,201,6438
"12039020600",1169,52,2370,504,46,0,57,52,4250
"12039020701",378,60,1896,1206,117,62,102,62,3883
"12039020702",465,72,2307,1830,601,375,597,316,6563
"12039020800",2511,436,814,332,309,477,770,506,6155
"12041950100",3919,1247,8,0,48,13,38,199,5472
"12041950201",1313,439,0,1,101,0,103,5,1962
"12041950202",1596,400,28,4,13,14,58,7,2120
"12041950203",2272,859,0,0,67,25,112,22,3357
"12041950204",2256,580,177,181,106,16,59,85,3460
"12043000100",1955,377,0,0,22,7,163,0,2524
"12043000200",4417,1219,403,279,98,322,1104,851,8693
"12043000300",1044,554,479,17,520,118,193,204,3129
"12043990000",0,0,0,0,0,0,0,0,0
"12045960100",4529,861,533,176,14,62,287,107,6569
"12045960200",2086,403,915,182,74,0,5,0,3665
"12045960300",2934,517,49,0,129,8,34,0,3671
"12045990000",0,0,0,0,0,0,0,0,0
"12047960100",2336,351,1171,737,49,43,62,10,4759
"12047960200",2925,643,762,185,90,216,304,371,5496
"12047960300",840,216,497,292,39,0,12,2,1898
"12049970101",2344,983,0,4,139,311,957,1004,5742
"12049970102",2780,871,2,129,65,130,740,463,5180
"12049970201",2347,1168,211,74,169,369,1401,1149,6888
"12049970202",1022,79,0,0,14,0,272,0,1387
"12049970300",4119,1488,124,6,752,674,2788,1452,11403
"12049970400",3388,804,410,339,81,135,1043,237,6437
"12051000100",4531,472,385,222,1206,276,3049,669,10810
"12051000200",3343,960,1107,1360,292,326,2009,980,10377
"12051000300",3028,1494,10,69,1113,496,2410,1721,10341
"12051000401",1880,519,0,0,592,688,1073,846,5598
"12051000402",5157,1403,436,214,751,181,3001,687,11830
"12051000600",2051,415,85,20,522,533,1517,494,5637
"12051990000",0,0,0,0,0,0,0,0,0
"12053040101",3802,365,150,0,125,0,301,0,4743
"12053040102",1646,436,0,0,19,0,12,60,2173
"12053040201",2184,423,73,0,12,0,54,8,2754
"12053040202",3791,1281,416,392,110,0,269,35,6294
"12053040301",1634,197,0,20,16,2,61,10,1940
"12053040302",3286,410,81,7,44,3,148,32,4011
"12053040303",1593,432,7,0,63,28,183,54,2360
"12053040400",2069,321,818,300,0,16,15,48,3587
"12053040501",1668,683,506,166,107,119,141,220,3610
"12053040502",1886,645,112,232,177,0,248,26,3326
"12053040601",1570,412,0,280,16,14,107,165,2564
"12053040602",1966,169,31,0,74,0,25,0,2265
"12053040701",5170,389,262,6,63,41,243,37,6211
"12053040702",4369,436,48,3,224,51,616,45,5792
"12053040801",2889,629,56,0,118,37,173,0,3902
"12053040802",4059,505,181,15,11,18,260,18,5067
"12053040901",4603,486,34,52,208,65,680,86,6214
"12053040905",5640,268,108,0,366,0,481,76,6939
"12053040906",4795,507,43,56,595,29,669,242,6936
"12053040907",1749,115,197,0,202,89,602,0,2954
"12053040908",5397,715,500,0,278,20,843,415,8168
"12053040909",3295,422,292,121,571,56,402,69,5228
"12053040910",2649,858,29,175,362,0,384,168,4625
"12053040911",2815,311,163,0,198,31,647,43,4208
"12053041003",1660,861,168,80,52,42,250,48,3161
"12053041004",5218,522,136,22,412,319,678,365,7672
"12053041005",1666,228,365,12,252,4,436,116,3079
"12053041006",4395,1061,74,0,380,106,937,162,7115
"12053041103",2872,371,0,447,132,0,251,14,4087
"12053041104",2161,160,26,2,56,0,113,2,2520
"12053041105",2846,1071,265,179,232,1,724,322,5640
"12053041106",3022,517,41,0,190,50,533,190,4543
"12053041201",3380,381,71,180,122,0,474,8,4616
"12053041203",3025,631,44,171,164,30,351,141,4557
"12053041204",2115,623,9,56,142,126,138,229,3438
"12053041302",2050,943,8,33,112,78,381,137,3742
"12053041303",2335,95,5,0,0,0,0,13,2448
"12053041304",1535,130,9,0,18,0,18,0,1710
"12053041305",1327,79,17,0,42,10,44,0,1519
"12053041401",3803,996,63,0,356,67,646,58,5989
"12053041402",4085,267,115,27,49,179,314,223,5259
"12053041501",2136,471,0,0,83,0,60,165,2915
"12053041502",2837,359,154,16,78,0,92,22,3558
"12053041600",4766,463,0,27,13,0,66,28,5363
"12053990000",0,0,0,0,0,0,0,0,0
"12055960101",2305,75,302,103,122,18,2,0,2927
"12055960102",669,71,594,275,4,0,45,0,1658
"12055960103",3135,937,389,18,290,224,379,681,6053
"12055960200",2269,465,202,317,120,297,634,478,4782
"12055960300",1603,851,1258,777,219,66,506,825,6105
"12055960400",4859,1382,437,180,548,50,949,522,8927
"12055960501",1013,123,70,0,0,13,301,0,1520
"12055960502",5235,600,324,35,705,179,914,79,8071
"12055960601",2201,316,378,23,53,0,348,157,3476
"12055960602",4336,521,0,0,177,154,342,256,5786
"12055960700",3321,398,250,144,46,55,539,163,4916
"12055960800",1537,523,184,69,36,41,497,261,3148
"12055960900",1203,284,809,248,14,144,141,280,3123
"12055961000",3420,437,26,10,83,0,546,65,4587
"12055961100",1876,1102,156,126,110,74,594,480,4518
"12055961200",3115,1127,104,249,88,13,646,492,5834
"12055961301",5509,509,293,21,238,57,583,55,7265
"12055961302",3309,524,39,127,61,0,117,0,4177
"12055961400",4822,410,35,2,110,0,233,38,5650
"12055961500",3537,562,110,0,113,17,603,141,5083
"12055961601",811,467,0,0,0,9,76,32,1395
"12055961602",650,39,0,0,18,0,104,0,811
"12055961603",3723,1793,153,157,79,32,509,965,7411
"12055961700",2858,1444,160,170,466,21,999,628,6746
"12055980000",0,0,0,0,0,0,0,0,0
"12055980100",0,0,0,0,0,0,0,0,0
"12055980200",0,0,0,0,0,0,0,0,0
"12057000101",1260,594,516,241,395,175,534,85,3800
"12057000102",2319,629,1801,736,183,216,884,778,7546
"12057000201",450,629,592,368,88,10,153,307,2597
"12057000202",1538,568,1708,866,357,165,999,565,6766
"12057000300",2083,795,1988,1562,583,172,1084,789,9056
"12057000401",1161,241,224,255,173,21,378,77,2530
"12057000402",1377,483,387,27,328,156,802,215,3775
"12057000500",3178,258,91,0,207,0,391,16,4141
"12057000601",2320,691,465,171,191,39,1477,428,5782
"12057000602",942,235,659,76,296,129,702,187,3226
"12057000700",1104,891,1214,1917,86,350,431,838,6831
"12057000800",989,410,997,409,247,20,554,107,3733
"12057000901",847,569,850,285,444,71,689,495,4250
"12057000902",688,313,2075,953,221,0,311,154,4715
"12057001001",696,343,1083,894,6,93,511,403,4029
"12057001002",521,35,2764,1524,35,8,365,35,5287
"12057001100",1646,227,533,172,53,15,419,105,3170
"12057001200",956,431,435,308,486,301,550,505,3972
"12057001300",4563,905,287,504,653,100,2537,613,10162
"12057001400",2962,1199,517,296,346,18,1665,900,7903
"12057001500",1954,193,35,389,167,19,289,116,3162
"12057001600",1489,201,236,80,64,3,169,119,2361
"12057001700",2227,345,680,700,495,71,847,130,5495
"12057001800",92,104,1667,1588,189,8,317,77,4042
"12057001900",116,19,1886,1064,0,0,250,19,3354
"12057002000",507,210,1201,783,53,77,401,73,3305
"12057002100",820,445,728,430,142,8,157,556,3286
"12057002200",1111,250,130,245,145,8,534,402,2825
"12057002300",1982,269,401,25,429,0,586,94,3786
"12057002400",2600,662,253,9,406,44,1433,396,5803
"12057002500",2586,1161,818,256,645,356,2591,1376,9789
"12057002600",857,391,61,65,158,19,872,280,2703
"12057002700",4901,1006,515,16,572,216,4049,1148,12423
"12057002800",1896,656,294,41,61,0,876,262,4086
"12057002900",1071,180,499,285,21,0,485,79,2620
"12057003000",572,410,444,891,128,88,343,363,3239
"12057003100",355,288,961,659,194,191,538,458,3644
"12057003200",536,285,651,742,246,113,633,375,3581
"12057003300",331,122,556,794,54,17,199,119,2192
"12057003400",37,28,1445,1051,36,72,11,82,2762
"12057003500",79,54,1511,898,16,0,55,21,2634
"12057003600",488,303,2250,1312,99,12,432,230,5126
"12057003700",298,420,53,233,31,45,32,184,1296
"12057003800",271,58,198,276,27,0,105,29,964
"12057003900",625,213,560,587,10,11,112,164,2282
"12057004000",0,32,15,0,0,0,0,0,47
"12057004100",343,262,272,337,0,35,127,249,1625
"12057004200",303,122,404,264,78,0,157,67,1395
"12057004300",167,325,722,2082,49,61,154,399,3959
"12057004400",261,118,838,632,247,16,424,109,2645
"12057004500",2454,743,438,150,261,142,2482,854,7524
"12057004600",1241,259,1276,321,254,30,587,139,4107
"12057004700",1798,129,252,64,393,7,710,70,3423
"12057004800",2424,503,546,0,396,0,1376,375,5620
"12057004900",2356,502,566,187,170,0,424,102,4307
"12057005000",538,399,1010,228,150,0,191,86,2602
"12057005101",791,144,17,30,72,42,128,79,1303
"12057005102",2757,263,55,0,370,0,423,0,3868
"12057005301",2131,199,52,0,197,0,368,20,2967
"12057005302",989,121,56,85,414,292,1146,405,3508
"12057005401",4338,227,58,33,194,0,484,57,5391
"12057005500",1602,303,17,12,219,58,203,75,2489
"12057005700",3101,264,274,37,188,18,756,93,4731
"12057005800",3570,98,426,0,537,23,572,16,5242
"12057005900",4981,383,15,0,459,0,599,0,6437
"12057006000",4771,95,60,3,72,61,372,18,5452
"12057006101",2585,250,24,0,142,21,41,59,3122
"12057006103",2880,154,223,15,59,0,469,29,3829
"12057006200",3310,123,92,0,256,6,507,5,4299
"12057006300",3627,100,124,3,150,9,428,16,4457
"12057006400",3535,121,166,0,134,0,559,22,4537
"12057006501",2260,175,304,0,341,264,245,231,3820
"12057006502",1443,140,107,0,104,0,211,7,2012
"12057006600",2556,388,118,0,342,198,409,346,4357
"12057006700",4385,353,17,0,463,0,513,0,5731
"12057006801",3487,161,190,190,371,24,650,0,5073
"12057006802",2740,330,79,133,148,10,408,142,3990
"12057006900",4661,270,293,95,470,63,393,44,6289
"12057007001",2362,415,82,104,455,67,643,59,4187
"12057007002",1210,323,836,1030,275,31,239,256,4200
"12057007102",1659,173,313,17,68,62,140,34,2466
"12057007103",2630,460,359,53,225,67,339,311,4444
"12057007200",2450,453,585,91,210,75,288,68,4220
"12057007300",1244,151,292,4,130,50,362,81,2314
"12057010103",3595,518,40,10,175,5,235,0,4578
"12057010105",3946,486,82,34,479,141,459,398,6025
"12057010106",4267,480,0,13,263,57,632,193,5905
"12057010107",3064,521,0,24,161,72,190,256,4288
"12057010108",1539,210,85,35,64,109,135,117,2294
"12057010203",719,434,313,183,56,19,117,103,1944
"12057010204",3510,555,1117,154,279,85,724,296,6720
"12057010205",5104,305,1451,0,1503,19,2070,47,10499
"12057010209",5572,454,1701,955,1701,287,1817,130,12617
"12057010210",2015,411,495,71,743,131,689,134,4689
"12057010211",3096,111,722,153,1025,81,848,96,6132
"12057010212",3615,176,648,70,956,50,883,12,6410
"12057010213",1400,367,237,34,88,3,179,111,2419
"12057010214",230,10,11,0,41,0,21,0,313
"12057010303",2330,959,0,20,96,79,131,146,3761
"12057010304",3183,122,280,138,187,0,497,0,4407
"12057010305",1675,812,738,366,261,2,275,125,4254
"12057010401",2621,554,1197,193,118,53,466,178,5380
"12057010402",1683,702,1593,522,377,244,486,496,6103
"12057010501",600,161,2808,599,190,270,309,325,5262
"12057010502",525,146,1025,181,239,48,250,32,2446
"12057010600",1900,342,323,75,387,51,178,42,3298
"12057010701",3989,263,306,809,421,159,807,175,6929
"12057010702",2118,295,184,9,0,69,463,134,3272
"12057010805",857,962,759,855,611,528,907,1134,6613
"12057010808",617,642,309,187,155,361,249,590,3110
"12057010809",1853,752,95,525,140,186,801,351,4703
"12057010810",1621,367,275,96,779,27,251,23,3439
"12057010811",3011,545,1603,370,834,118,691,107,7279
"12057010812",1376,1257,385,388,483,426,198,249,4762
"12057010813",974,999,1058,482,296,302,261,327,4699
"12057010814",1033,280,974,346,344,86,727,322,4112
"12057010815",280,518,462,619,111,33,218,324,2565
"12057010816",593,1377,860,1083,221,230,538,1308,6210
"12057010817",1599,514,656,364,470,116,1357,558,5634
"12057010818",532,1070,809,1210,459,453,685,1035,6253
"12057010900",0,0,0,0,0,0,0,0,0
"12057011003",2722,683,284,36,333,147,701,228,5134
"12057011005",1852,218,477,0,334,50,150,38,3119
"12057011006",4208,352,22,4,430,2,508,118,5644
"12057011007",2581,289,214,19,110,8,425,57,3703
"12057011008",4127,534,473,214,699,123,571,56,6797
"12057011010",2420,481,530,563,511,153,780,63,5501
"12057011012",4057,147,422,0,1202,162,972,58,7020
"12057011013",1872,292,346,11,478,202,425,54,3680
"12057011014",662,102,127,0,56,0,311,38,1296
"12057011015",3797,863,538,271,1115,90,969,140,7783
"12057011016",1876,92,750,64,436,9,352,0,3579
"12057011103",2934,160,336,2,103,1,274,1,3811
"12057011106",1032,122,131,10,316,38,441,68,2158
"12057011107",4986,341,435,121,1007,86,1611,119,8706
"12057011108",1180,207,8,37,28,20,284,66,1830
"12057011109",2439,110,127,0,87,0,722,31,3516
"12057011203",2472,185,161,0,280,65,712,138,4013
"12057011204",3892,609,575,287,295,156,1001,208,7023
"12057011205",2080,342,476,20,196,26,693,116,3949
"12057011206",1544,478,112,187,244,237,400,327,3529
"12057011301",2455,150,112,11,79,24,709,0,3540
"12057011303",2130,210,135,52,153,0,375,71,3126
"12057011304",4248,343,159,31,405,40,1258,126,6610
"12057011407",1828,203,131,0,156,0,200,0,2518
"12057011408",2194,523,175,29,329,13,712,259,4234
"12057011409",2474,102,110,11,45,2,573,18,3335
"12057011410",4539,178,483,0,722,1,1640,92,7655
"12057011411",1240,160,60,0,147,44,383,159,2193
"12057011412",2527,266,220,0,365,35,685,69,4167
"12057011413",4415,371,312,59,679,143,1269,84,7332
"12057011414",4039,970,694,442,404,150,2391,1123,10213
"12057011415",3603,405,398,57,1041,109,1826,368,7807
"12057011416",4243,724,942,153,864,134,2350,669,10079
"12057011417",2753,328,539,0,577,112,1372,55,5736
"12057011418",3208,102,159,13,120,18,603,54,4277
"12057011504",1634,120,40,0,61,0,148,0,2003
"12057011506",5502,830,1256,89,585,210,1307,89,9868
"12057011507",5231,303,286,104,812,100,826,223,7885
"12057011509",5938,99,101,0,167,19,552,0,6876
"12057011510",3204,70,61,31,454,0,684,13,4517
"12057011512",3574,56,12,0,316,8,758,0,4724
"12057011514",4408,773,236,0,316,139,724,317,6913
"12057011515",2959,317,303,0,275,9,669,182,4714
"12057011516",2239,110,70,0,348,0,562,0,3329
"12057011517",6770,207,306,0,1056,0,600,75,9014
"12057011518",2949,178,242,0,220,0,558,9,4156
"12057011519",2107,104,30,0,88,0,230,6,2565
"12057011520",3709,145,413,15,450,11,307,0,5050
"12057011521",2954,443,286,0,386,66,735,183,5053
"12057011522",2888,330,10,0,632,0,474,25,4359
"12057011523",1320,36,23,0,120,0,265,0,1764
"12057011524",2906,814,302,155,475,51,1035,402,6140
"12057011603",3195,157,250,107,575,0,1689,59,6032
"12057011605",4105,725,349,145,675,19,3327,507,9852
"12057011606",5134,341,818,22,661,32,1061,246,8315
"12057011607",5609,708,658,2,531,278,2288,398,10472
"12057011608",912,63,0,0,129,19,283,67,1473
"12057011610",2865,1045,231,15,405,127,1826,988,7502
"12057011611",2631,347,289,72,490,114,1724,337,6004
"12057011612",4846,653,449,58,935,0,2738,434,10113
"12057011613",3714,508,208,197,332,399,1752,743,7853
"12057011614",4422,1201,984,249,607,119,3359,1154,12095
"12057011615",2840,769,365,89,504,15,2217,548,7347
"12057011706",4930,768,841,381,495,97,2901,514,10927
"12057011708",3142,77,242,0,232,52,820,67,4632
"12057011709",532,7,8,0,106,29,97,0,779
"12057011710",4629,281,337,50,376,150,1242,26,7091
"12057011712",3573,755,169,56,377,12,955,403,6300
"12057011802",5288,1615,96,39,125,244,4145,1578,13130
"12057011803",3927,1986,539,28,562,110,2622,1350,11124
"12057011804",3502,921,161,263,931,107,3158,899,9942
"12057011901",3218,1090,777,106,398,121,1716,746,8172
"12057011902",4740,609,280,69,951,325,3977,735,11686
"12057011904",948,225,418,61,70,118,463,304,2607
"12057011905",879,361,79,0,39,9,472,340,2179
"12057011906",2727,409,466,64,471,102,1923,266,6428
"12057012001",1065,193,557,299,68,4,334,88,2608
"12057012002",1301,805,1130,373,106,87,420,179,4401
"12057012103",2584,339,1357,31,1552,248,1168,132,7411
"12057012104",3515,1470,765,408,457,670,919,1140,9344
"12057012106",3181,345,258,235,501,214,676,144,5554
"12057012107",3092,413,551,89,463,0,822,0,5430
"12057012108",2158,245,413,2,134,56,601,8,3617
"12057012206",3747,387,857,47,492,98,1361,57,7046
"12057012207",5600,282,1042,9,387,0,1049,112,8481
"12057012208",5068,116,719,0,587,56,1009,48,7603
"12057012209",3186,257,574,115,952,15,1321,24,6444
"12057012210",3449,571,332,63,157,0,590,42,5204
"12057012211",99,25,0,0,0,0,82,0,206
"12057012212",2360,866,833,207,402,64,1281,705,6718
"12057012213",3313,212,208,22,192,0,608,140,4695
"12057012301",3634,635,914,172,485,11,872,149,6872
"12057012303",2367,152,151,39,154,69,543,56,3531
"12057012304",3371,379,775,193,367,37,1558,236,6916
"12057012401",2911,1301,112,36,817,242,1371,1249,8039
"12057012402",2021,566,11,130,180,320,755,567,4550
"12057012403",4006,761,155,42,91,123,1104,607,6889
"12057012501",2707,509,135,2,343,190,894,397,5177
"12057012503",3671,460,60,0,293,224,459,396,5563
"12057012504",2982,54,133,91,169,0,365,13,3807
"12057012600",2992,364,936,620,312,97,1051,171,6543
"12057012701",3591,2348,415,73,405,159,1972,1948,10911
"12057012702",2210,411,166,10,12,10,614,314,3747
"12057012800",2717,439,207,25,367,161,1284,301,5501
"12057012900",743,215,1195,266,117,67,226,221,3050
"12057013001",2539,726,152,46,135,235,153,440,4426
"12057013002",3461,649,198,71,646,74,1142,382,6623
"12057013003",2209,513,156,41,427,104,962,447,4859
"12057013004",1812,539,794,229,174,61,679,284,4572
"12057013100",2011,484,115,58,34,34,190,363,3289
"12057013203",2014,305,407,29,277,0,372,75,3479
"12057013204",2260,485,23,76,228,159,435,312,3978
"12057013205",5769,372,663,42,406,34,1668,163,9117
"12057013206",4559,233,655,41,343,0,784,17,6632
"12057013207",2801,536,114,57,513,3,348,279,4651
"12057013208",4288,181,74,0,493,0,414,0,5450
"12057013305",3923,62,113,0,280,0,711,0,5089
"12057013307",1813,320,948,53,220,0,914,235,4503
"12057013310",2025,98,430,1,145,0,509,25,3233
"12057013311",1798,431,223,8,114,36,408,155,3173
"12057013312",2631,290,607,68,827,43,980,9,5455
"12057013313",3918,316,256,282,388,38,803,132,6133
"12057013314",2102,346,234,0,219,81,360,376,3718
"12057013315",1900,147,693,97,275,0,694,13,3819
"12057013316",986,386,563,184,182,11,533,236,3081
"12057013317",1183,88,523,75,167,103,247,22,2408
"12057013318",1719,91,688,23,580,47,614,16,3778
"12057013319",3031,294,574,0,741,90,1045,210,5985
"12057013320",2152,189,646,126,478,87,473,154,4305
"12057013321",3969,1074,1447,238,529,285,1640,995,10177
"12057013322",4915,663,1365,164,641,68,1978,237,10031
"12057013406",993,84,9,0,31,5,145,0,1267
"12057013407",4642,291,544,62,537,35,640,40,6791
"12057013409",3240,432,513,0,505,108,373,245,5416
"12057013410",3078,124,780,469,510,289,392,256,5898
"12057013411",1310,172,30,0,221,34,115,6,1888
"12057013412",2384,284,368,68,214,5,348,26,3697
"12057013413",2579,222,332,0,180,25,255,34,3627
"12057013414",5640,87,304,0,325,0,505,0,6861
"12057013415",2697,157,199,0,573,36,635,77,4374
"12057013501",1504,1025,799,284,217,65,846,598,5338
"12057013503",1593,712,507,370,59,174,908,723,5046
"12057013504",1973,729,705,84,283,34,1409,684,5901
"12057013505",1041,370,940,728,415,25,971,236,4726
"12057013602",1069,413,6,50,47,34,485,345,2449
"12057013604",639,233,0,17,43,50,50,174,1206
"12057013702",3291,553,2434,223,212,170,908,360,8151
"12057013703",2549,258,1550,335,310,177,1032,365,6576
"12057013704",4417,724,1636,504,788,45,675,344,9133
"12057013801",1301,643,172,0,194,385,725,483,3903
"12057013802",1469,625,169,7,215,19,184,284,2972
"12057013803",1193,416,0,0,32,0,286,0,1927
"12057013804",3900,741,1903,145,804,355,1614,736,10198
"12057013806",1153,243,0,0,47,4,132,0,1579
"12057013807",3964,390,923,82,328,19,1461,268,7435
"12057013903",2829,336,9,0,202,54,351,54,3835
"12057013907",1733,216,4,0,586,0,828,150,3517
"12057013908",5632,629,1464,34,818,65,1840,62,10544
"12057013912",2043,528,29,52,379,262,791,318,4402
"12057013913",2148,626,346,388,847,697,1474,1176,7702
"12057013914",2099,605,7,10,431,535,1596,913,6196
"12057013915",3765,323,1640,53,996,0,935,0,7712
"12057013916",5099,113,1407,18,882,87,1371,62,9039
"12057013917",5366,192,1583,0,1180,0,2177,113,10611
"12057013918",1485,467,22,0,34,0,65,70,2143
"12057013919",4373,321,1004,0,564,105,1048,0,7415
"12057013920",3059,607,13,70,322,26,416,231,4744
"12057013921",1724,59,155,0,38,0,185,5,2166
"12057013922",5294,167,268,0,360,0,720,0,6809
"12057013923",4200,344,371,0,246,17,303,62,5543
"12057014002",1576,525,0,0,296,139,501,365,3402
"12057014003",1351,63,0,0,31,0,35,0,1480
"12057014007",1485,214,678,37,213,8,603,158,3396
"12057014008",3142,204,9,0,0,0,0,0,3355
"12057014009",1347,69,52,0,18,0,90,0,1576
"12057014010",2223,151,0,14,0,0,19,42,2449
"12057014011",3067,178,0,0,16,0,263,0,3524
"12057014012",2396,117,60,0,0,0,67,0,2640
"12057014013",1001,383,39,0,44,0,224,258,1949
"12057014014",1946,112,19,0,0,0,14,67,2158
"12057014015",1413,35,0,48,11,0,23,13,1543
"12057014016",849,35,11,0,0,0,39,0,934
"12057014104",1304,151,13,5,108,24,151,35,1791
"12057014106",2543,454,0,1,162,44,287,253,3744
"12057014108",3353,700,172,63,569,428,1426,529,7240
"12057014109",2566,530,486,142,465,590,1471,969,7219
"12057014117",2865,104,0,0,57,0,148,0,3174
"12057014118",3052,147,134,0,214,34,141,18,3740
"12057014119",2972,321,464,222,413,18,859,92,5361
"12057014121",2517,76,700,0,282,0,184,12,3771
"12057014122",1210,148,421,45,618,305,913,346,4006
"12057980100",0,0,0,0,0,0,0,0,0
"12057980200",0,0,0,0,0,0,0,0,0
"12057980300",56,0,0,0,14,0,0,0,70
"12057980400",41,0,0,0,0,0,0,0,41
"12057980500",0,0,0,0,0,0,0,0,0
"12057980600",0,0,0,0,0,0,0,0,0
"12057980700",0,0,0,0,0,0,0,0,0
"12057990000",0,0,0,0,0,0,0,0,0
"12057990100",0,0,0,0,0,0,0,0,0
"12059960100",3177,681,146,16,117,12,29,10,4188
"12059960200",3863,1251,14,0,45,57,51,67,5348
"12059960300",2067,991,0,0,248,17,19,0,3342
"12059960400",3843,1117,57,86,154,67,41,44,5409
"12061050100",4454,1331,228,88,115,121,558,135,7030
"12061050200",2572,1029,35,121,161,56,461,467,4902
"12061050301",2659,347,179,147,81,30,160,20,3623
"12061050302",1091,707,2302,1090,79,60,217,613,6159
"12061050401",1937,1103,178,31,118,84,75,296,3822
"12061050402",1717,219,0,3,0,12,49,24,2024
"12061050501",4620,364,32,0,7,0,21,0,5044
"12061050503",4437,198,0,0,45,28,157,11,4876
"12061050504",1585,45,0,9,56,1,23,1,1720
"12061050505",3134,93,0,0,59,0,17,0,3303
"12061050601",1635,257,107,89,20,0,138,11,2257
"12061050602",4093,682,63,37,52,33,351,86,5397
"12061050603",3260,372,387,446,175,52,484,52,5228
"12061050604",1364,94,55,0,0,0,0,0,1513
"12061050605",1422,131,0,0,39,0,37,0,1629
"12061050606",6333,1004,1567,684,623,100,1222,308,11841
"12061050702",4501,369,20,39,107,70,369,96,5571
"12061050703",8126,501,234,0,310,20,752,96,10039
"12061050704",2079,347,0,5,98,11,213,11,2764
"12061050705",4148,191,169,44,37,10,190,8,4797
"12061050802",7295,433,478,90,265,21,389,9,8980
"12061050804",4225,994,510,319,462,52,376,380,7318
"12061050805",2964,314,629,421,30,0,170,25,4553
"12061050806",4111,444,344,149,123,31,164,0,5366
"12061050807",3417,505,144,0,51,0,321,56,4494
"12061050808",3144,520,33,0,152,78,122,16,4065
"12061050902",3922,343,270,0,1,41,337,38,4952
"12061050903",5621,969,119,27,241,66,512,223,7778
"12061050904",4232,1697,122,216,1110,204,3263,1452,12296
"12061980000",0,0,0,0,0,0,0,0,0
"12061990000",0,0,0,0,0,0,0,0,0
"12063210100",1447,311,771,51,16,49,13,112,2770
"12063210200",406,111,648,178,12,0,8,0,1363
"12063210300",2488,801,533,187,39,69,73,158,4348
"12063210400",1676,590,530,374,39,59,35,67,3370
"12063210500",2771,146,458,347,220,0,68,0,4010
"12063210600",1773,1221,1395,903,169,103,37,7,5608
"12063210700",2524,102,553,232,55,48,21,0,3535
"12063210800",1907,328,1096,201,49,8,25,0,3614
"12063210900",3259,700,311,168,20,40,134,294,4926
"12063211000",4352,308,397,74,201,31,51,21,5435
"12063211100",2986,496,103,17,52,27,26,38,3745
"12065250101",2444,246,1110,608,30,87,118,15,4658
"12065250102",2395,144,994,265,212,0,75,21,4106
"12065250200",2227,306,987,508,22,0,66,10,4126
"12065990000",0,0,0,0,0,0,0,0,0
"12067960100",1091,280,0,0,6,0,117,65,1559
"12067960200",4310,715,289,361,283,154,437,223,6772
"12069030102",2406,785,0,25,29,57,275,21,3598
"12069030104",1443,222,0,3,10,42,13,69,1802
"12069030105",6827,930,338,28,169,8,527,68,8895
"12069030106",1165,424,0,0,32,16,184,21,1842
"12069030107",4030,1421,58,0,118,33,120,296,6076
"12069030108",3494,678,101,26,136,0,582,157,5174
"12069030203",7053,668,445,59,357,20,733,18,9353
"12069030204",2141,1035,99,0,177,56,147,347,4002
"12069030206",1346,541,1121,952,89,71,207,171,4498
"12069030207",4093,539,203,0,102,31,48,104,5120
"12069030208",2979,432,87,10,424,187,107,12,4238
"12069030209",1691,335,63,13,101,0,149,12,2364
"12069030302",2803,494,325,37,105,31,172,0,3967
"12069030305",2342,159,31,0,32,16,34,15,2629
"12069030306",3237,293,0,0,43,0,140,23,3736
"12069030307",3300,951,398,0,170,20,147,396,5382
"12069030308",3434,429,198,9,23,0,237,17,4347
"12069030405",3413,255,119,399,100,112,39,1,4438
"12069030406",3259,639,67,16,30,0,32,21,4064
"12069030407",1989,523,482,9,109,19,224,22,3377
"12069030408",3430,359,0,0,30,0,161,103,4083
"12069030409",3959,233,0,0,0,0,0,0,4192
"12069030410",2485,82,208,0,252,73,147,0,3247
"12069030411",3821,1342,365,86,32,0,309,600,6555
"12069030502",3352,610,762,446,226,291,64,164,5915
"12069030503",495,122,378,161,85,0,195,30,1466
"12069030504",3397,607,949,877,892,122,588,364,7796
"12069030601",2977,368,689,27,179,24,189,67,4520
"12069030602",906,239,454,372,18,45,82,45,2161
"12069030701",1892,141,63,3,7,0,131,15,2252
"12069030702",3298,362,549,0,405,9,402,32,5057
"12069030803",2431,484,449,71,122,0,74,0,3631
"12069030804",814,237,6,60,34,0,127,8,1286
"12069030805",1884,489,51,483,216,9,168,235,3535
"12069030806",2725,262,215,81,60,0,46,0,3389
"12069030807",2138,249,377,388,243,0,192,0,3587
"12069030902",10365,521,438,39,315,0,1515,29,13222
"12069030912",3978,759,225,76,323,153,767,112,6393
"12069030913",1201,58,0,0,0,0,6,5,1270
"12069030914",2103,510,1359,428,264,0,355,115,5134
"12069031000",6385,838,521,51,331,77,905,306,9414
"12069031101",6963,502,70,0,107,0,103,0,7745
"12069031102",6457,181,141,64,138,14,80,5,7080
"12069031103",1567,86,13,0,21,36,325,36,2084
"12069031202",5097,955,162,148,527,66,1246,75,8276
"12069031203",4471,426,218,88,217,13,1304,75,6812
"12069031204",7654,820,1262,114,721,70,1537,218,12396
"12069031205",1072,836,38,33,789,133,1090,395,4386
"12069031301",4969,281,191,0,392,37,636,69,6575
"12069031305",4046,526,568,360,861,425,623,340,7749
"12069031306",4066,299,339,5,750,97,559,36,6151
"12069031307",12813,1704,2308,242,1932,145,2817,789,22750
"12069031308",4757,96,774,20,770,0,1059,47,7523
"12069031309",6636,546,567,384,1397,0,1783,102,11415
"12069031310",10952,847,1205,114,1537,95,2467,89,17306
"12069031311",9256,2362,1168,0,1246,318,3279,1850,19479
"12071000301",1793,884,458,308,289,775,1084,1368,6959
"12071000302",1639,1107,846,500,857,321,1769,1206,8245
"12071000401",1312,570,129,22,241,513,669,784,4240
"12071000402",1733,538,43,0,11,26,443,133,2927
"12071000502",62,208,1932,996,11,42,19,189,3459
"12071000503",443,466,1431,660,436,261,682,729,5108
"12071000504",1021,360,191,250,405,25,842,249,3343
"12071000600",88,236,2334,1779,69,25,23,171,4725
"12071000700",629,371,398,600,109,146,102,187,2542
"12071000800",1137,137,19,3,28,0,15,30,1369
"12071000900",2640,93,0,0,165,0,126,12,3036
"12071001000",4698,810,45,0,156,80,747,548,7084
"12071001101",780,609,622,454,29,272,232,298,3296
"12071001102",1161,349,883,424,268,0,333,132,3550
"12071001201",2275,522,1262,1277,891,479,1099,585,8390
"12071001202",7121,619,365,97,831,46,802,249,10130
"12071001300",1595,655,117,180,148,12,356,458,3521
"12071001401",2563,958,261,284,125,387,499,1114,6191
"12071001402",2390,112,0,21,177,0,110,16,2826
"12071001501",2348,89,0,0,146,0,138,6,2727
"12071001502",2723,1154,226,286,499,387,1260,1068,7603
"12071001601",3319,338,135,153,265,97,420,244,4971
"12071001602",2657,245,0,0,96,0,28,0,3026
"12071001701",2462,263,7,0,111,0,136,14,2993
"12071001703",3747,328,37,0,151,34,148,41,4486
"12071001705",2679,226,14,0,15,0,59,0,2993
"12071001706",2901,239,55,0,148,0,244,60,3647
"12071001707",3806,680,57,34,32,0,68,174,4851
"12071001801",4087,326,114,0,67,0,186,87,4867
"12071001802",1927,104,31,0,34,86,50,0,2232
"12071001903",2723,79,0,0,0,0,83,0,2885
"12071001906",5042,635,382,4,306,208,902,408,7887
"12071001907",4525,278,200,19,142,12,236,12,5424
"12071001908",775,27,0,0,0,0,0,0,802
"12071001910",2136,197,0,0,16,0,0,0,2349
"12071001911",775,21,0,0,21,0,0,0,817
"12071001912",1650,102,0,0,57,0,29,0,1838
"12071001913",1248,86,0,0,93,15,93,15,1550
"12071001914",4172,426,0,0,0,28,352,0,4978
"12071001915",2453,37,0,0,19,0,0,0,2509
"12071010102",6156,1114,208,0,225,30,1354,543,9630
"12071010103",6693,1302,54,41,153,189,1088,652,10172
"12071010104",1818,60,0,0,0,0,0,0,1878
"12071010105",4169,479,55,0,196,19,536,0,5454
"12071010201",6669,1354,557,621,313,470,1797,1030,12811
"12071010203",4987,1480,171,57,174,23,1597,892,9381
"12071010204",6575,1275,620,0,242,129,732,514,10087
"12071010302",3955,996,398,144,132,50,1044,312,7031
"12071010303",5300,235,193,33,224,255,823,142,7205
"12071010304",8166,661,168,81,381,166,1949,262,11834
"12071010305",3088,260,8,10,45,19,167,47,3644
"12071010306",4079,631,85,80,355,10,1140,353,6733
"12071010307",4194,923,73,0,232,125,781,490,6818
"12071010404",5375,793,169,101,294,70,1687,166,8655
"12071010405",6587,456,691,0,295,41,1202,207,9479
"12071010406",4897,423,8,4,202,0,930,48,6512
"12071010407",5916,286,52,0,483,11,771,24,7543
"12071010409",6237,1036,221,17,539,110,1100,252,9512
"12071010410",10928,1242,133,0,385,130,1595,208,14621
"12071010411",3887,528,44,24,363,79,371,298,5594
"12071010412",3719,935,185,0,128,0,606,300,5873
"12071010501",2564,230,76,8,154,0,531,46,3609
"12071010502",2848,481,163,19,362,90,594,87,4644
"12071010601",3393,675,10,2,230,0,441,64,4815
"12071010602",1858,449,91,10,178,0,230,163,2979
"12071010701",3779,326,14,0,94,0,293,211,4717
"12071010702",2131,98,0,0,74,0,207,12,2522
"12071010801",2064,258,0,0,19,43,106,65,2555
"12071010802",2560,474,63,43,76,22,328,99,3665
"12071010803",1733,185,0,0,54,5,196,0,2173
"12071020101",4208,162,0,0,96,0,185,0,4651
"12071020102",3461,833,56,0,55,25,443,128,5001
"12071020201",1081,93,0,63,0,0,86,12,1335
"12071020202",2605,172,0,5,89,0,257,0,3128
"12071020300",3108,2261,0,0,18,0,194,0,5581
"12071020400",2709,106,0,0,36,0,47,26,2924
"12071020501",1991,259,13,0,123,0,67,0,2453
"12071020502",3371,489,27,0,12,7,75,22,4003
"12071020600",1908,486,41,27,38,51,68,91,2710
"12071020700",2405,356,0,98,11,0,58,11,2939
"12071020800",2649,517,19,0,22,0,41,14,3262
"12071030100",2055,324,0,26,206,0,72,37,2720
"12071030201",727,24,25,0,9,0,0,0,785
"12071030202",3322,564,36,36,625,171,1251,250,6255
"12071030203",1220,138,170,0,20,0,53,49,1650
"12071030204",361,68,0,0,9,0,0,0,438
"12071030300",2203,74,139,72,24,54,101,21,2688
"12071040108",2807,240,127,0,277,11,131,17,3610
"12071040109",2046,528,737,183,701,224,1436,529,6384
"12071040110",977,110,66,0,365,40,176,18,1752
"12071040111",2180,165,158,0,14,0,40,0,2557
"12071040112",1961,101,79,10,382,12,374,0,2919
"12071040113",1736,23,0,0,35,0,35,0,1829
"12071040114",3420,143,39,23,248,23,179,33,4108
"12071040115",1814,257,6,5,11,0,717,27,2837
"12071040116",5554,174,175,64,393,0,879,0,7239
"12071040117",3431,22,109,0,196,58,60,58,3934
"12071040118",867,117,0,0,37,0,10,0,1031
"12071040119",576,94,0,0,94,0,6,0,770
"12071040120",956,29,163,0,73,0,125,29,1375
"12071040121",1243,304,663,421,393,64,757,148,3993
"12071040122",2101,1047,1321,1336,1222,109,2017,1032,10185
"12071040123",3138,758,135,88,318,28,430,454,5349
"12071040124",2931,489,966,277,647,586,1158,845,7899
"12071040125",1223,386,185,21,164,180,644,498,3301
"12071040126",1133,215,850,220,229,67,655,234,3603
"12071040127",1524,737,636,187,747,287,1032,726,5876
"12071040203",6697,746,1697,146,881,373,3141,378,14059
"12071040205",2663,256,876,192,841,62,1177,96,6163
"12071040206",1092,49,10,0,39,0,43,2,1235
"12071040207",3583,160,458,169,218,81,642,38,5349
"12071040208",1146,386,109,17,172,61,182,101,2174
"12071040209",1927,430,625,0,205,98,443,293,4021
"12071040210",1185,239,121,108,142,0,289,102,2186
"12071040301",3059,956,1489,343,859,207,1886,769,9568
"12071040302",1973,421,739,124,301,92,1071,218,4939
"12071040303",3135,1089,711,368,369,156,1477,828,8133
"12071040304",2474,468,197,18,596,130,1317,335,5535
"12071040305",2214,516,227,68,492,28,1129,120,4794
"12071040308",2018,780,561,206,299,80,1040,580,5564
"12071040309",3853,483,794,51,696,51,1660,118,7706
"12071040310",1546,230,465,4,129,20,497,164,3055
"12071040311",2102,304,996,13,414,241,756,350,5176
"12071040312",964,89,267,58,21,53,167,93,1712
"12071040313",756,408,124,1,133,54,358,385,2219
"12071040314",1263,284,241,53,147,41,512,80,2621
"12071050103",700,149,0,0,38,0,100,55,1042
"12071050104",1994,155,0,0,73,0,54,0,2276
"12071050105",2368,11,33,0,21,0,74,0,2507
"12071050106",3378,155,0,0,31,13,161,0,3738
"12071050203",3586,120,213,0,119,41,131,0,4210
"12071050204",2240,164,18,0,74,0,157,10,2663
"12071050205",900,306,8,0,372,83,284,74,2027
"12071050206",2446,141,30,0,318,33,266,86,3320
"12071050207",1644,157,49,37,38,0,77,0,2002
"12071050208",4573,696,0,3,116,17,989,183,6577
"12071050209",6726,990,86,0,1534,194,1812,394,11736
"12071050305",3038,140,0,0,0,0,48,0,3226
"12071050306",1723,109,20,0,97,0,72,7,2028
"12071050307",4254,152,0,0,29,0,147,0,4582
"12071050308",5176,1151,273,74,176,120,436,946,8352
"12071050310",4206,151,0,0,234,147,94,0,4832
"12071050311",4021,173,95,0,127,0,167,24,4607
"12071050312",1960,691,0,0,79,14,127,105,2976
"12071050313",4729,781,145,10,288,0,334,549,6836
"12071050314",3634,150,17,0,120,0,54,0,3975
"12071050400",5912,2293,137,0,423,990,2196,2839,14790
"12071050500",4387,967,9,17,571,183,2461,877,9472
"12071050601",2628,195,8,0,46,0,37,0,2914
"12071050602",4184,358,0,1,245,185,853,259,6085
"12071060101",698,77,0,0,98,4,0,0,877
"12071060102",2340,252,0,0,0,12,47,0,2651
"12071060201",882,37,0,0,8,0,18,0,945
"12071060202",1219,101,0,0,16,0,8,20,1364
"12071060203",1323,169,20,23,27,28,33,5,1628
"12071060300",947,45,0,0,28,13,21,0,1054
"12071070101",1714,70,0,0,14,0,0,0,1798
"12071070102",2824,477,8,0,40,0,157,0,3506
"12071070200",3122,289,0,0,0,0,128,0,3539
"12071080100",122,55,26,13,0,0,0,0,216
"12071080202",2389,133,0,0,13,0,20,0,2555
"12071080203",1417,109,0,0,31,5,24,0,1586
"12071080204",2322,176,15,0,15,0,7,0,2535
"12071080300",1043,174,339,221,35,205,73,3,2093
"12071090100",771,65,0,52,0,4,0,8,900
"12071980000",0,0,0,0,0,0,0,0,0
"12071990000",0,0,0,0,0,0,0,0,0
"12073000200",2926,706,99,182,37,20,66,114,4150
"12073000301",831,51,388,245,54,0,34,0,1603
"12073000302",1620,166,367,250,52,59,26,56,2596
"12073000303",1065,270,1437,649,201,22,12,7,3663
"12073000400",192,29,473,498,0,18,16,18,1244
"12073000500",234,891,161,132,28,35,26,133,1640
"12073000600",374,837,819,1334,79,159,130,75,3807
"12073000700",1029,309,161,384,21,7,31,41,1983
"12073000800",2082,141,439,98,143,0,174,0,3077
"12073000901",4932,660,1413,123,796,449,581,26,8980
"12073000903",957,210,648,233,53,23,69,0,2193
"12073000904",1905,192,776,53,135,0,157,72,3290
"12073000905",1409,210,941,215,242,51,80,35,3183
"12073001001",336,90,445,1784,144,133,66,30,3028
"12073001002",176,20,844,962,0,0,4,0,2006
"12073001101",35,18,700,1091,9,71,0,28,1952
"12073001102",0,0,1960,722,24,0,0,0,2706
"12073001200",34,71,568,707,0,0,0,0,1380
"12073001300",0,2,0,3,0,0,0,0,5
"12073001401",207,176,1165,545,0,0,0,48,2141
"12073001402",567,1379,634,2035,146,332,89,342,5524
"12073001500",2267,663,834,762,51,84,126,92,4879
"12073001601",1832,345,1190,392,209,122,118,39,4247
"12073001602",2884,42,247,54,108,0,120,1,3456
"12073001700",5451,305,451,222,263,13,253,0,6958
"12073001801",799,67,2230,1132,164,140,176,24,4732
"12073001802",1426,310,2663,415,179,52,188,69,5302
"12073001901",342,104,1127,563,572,264,141,12,3125
"12073001902",710,386,1225,790,122,23,53,5,3314
"12073002003",195,246,402,451,37,31,35,31,1428
"12073002004",1012,3501,1388,1892,119,308,380,589,9189
"12073002005",509,1801,204,262,29,74,88,326,3293
"12073002006",1210,1988,370,366,87,181,176,202,4580
"12073002101",1682,928,1048,533,300,7,81,50,4629
"12073002103",954,1457,849,370,51,83,40,184,3988
"12073002104",1274,2674,1210,1385,167,410,154,641,7915
"12073002201",2033,708,1064,1170,121,11,352,105,5564
"12073002205",2219,417,1458,880,251,30,339,53,5647
"12073002206",1980,39,933,100,194,0,233,0,3479
"12073002207",1134,424,427,488,31,0,0,0,2504
"12073002208",3174,359,1326,61,107,80,185,14,5306
"12073002302",2226,335,550,58,35,0,33,0,3237
"12073002303",2127,66,1014,403,65,59,104,42,3880
"12073002304",1322,619,691,265,243,57,188,60,3445
"12073002403",1404,106,781,160,223,51,93,20,2838
"12073002408",7187,588,543,0,144,0,223,435,9120
"12073002410",3701,472,1284,60,325,25,186,170,6223
"12073002411",1410,110,177,0,114,0,2,0,1813
"12073002412",7607,216,481,0,828,36,423,0,9591
"12073002413",2533,56,66,0,95,0,72,0,2822
"12073002414",4029,52,211,1,87,0,283,0,4663
"12073002415",3407,86,236,52,391,0,324,0,4496
"12073002416",2432,94,395,0,67,0,80,0,3068
"12073002417",5691,138,721,37,676,0,373,0,7636
"12073002505",2981,303,1172,410,727,0,272,24,5889
"12073002507",1845,39,656,54,52,55,84,66,2851
"12073002508",5984,458,2104,150,287,77,584,33,9677
"12073002509",1275,200,689,203,311,160,274,65,3177
"12073002510",3733,92,1749,242,569,0,261,11,6657
"12073002511",850,13,202,27,182,0,4,0,1278
"12073002512",2384,50,382,0,238,0,199,0,3253
"12073002513",3261,54,238,51,640,0,76,0,4320
"12073002603",1988,533,1220,941,171,31,32,0,4916
"12073002604",2101,159,172,108,88,13,121,0,2762
"12073002605",3442,151,450,42,606,0,300,0,4991
"12073002606",2482,93,453,0,120,0,96,13,3257
"12073002701",2811,602,1037,375,66,0,179,9,5079
"12073002702",3746,618,46,0,53,30,221,188,4902
"12075970101",1541,265,71,89,67,23,156,104,2316
"12075970102",4602,1955,641,121,164,186,342,512,8523
"12075970200",2148,804,317,541,88,122,118,97,4235
"12075970301",1256,170,0,0,0,0,0,0,1426
"12075970302",5444,1015,15,0,103,87,335,26,7025
"12075970400",1907,703,11,24,35,9,176,170,3035
"12075970500",5783,1431,232,92,97,49,515,0,8199
"12075970600",2200,259,1096,374,41,118,267,16,4371
"12075970700",2260,847,4,26,38,38,46,10,3269
"12075990000",0,0,0,0,0,0,0,0,0
"12077950100",1551,294,0,0,11,0,0,3,1859
"12077950200",2797,808,458,292,278,227,249,207,5316
"12079110100",2631,539,352,75,141,0,162,0,3900
"12079110200",1808,162,1189,376,18,23,61,25,3662
"12079110301",1039,127,561,220,239,0,221,0,2407
"12079110302",785,194,1739,1258,41,31,23,0,4071
"12079110400",2086,691,397,104,104,16,158,29,3585
"12081000101",1021,327,56,8,44,10,37,163,1666
"12081000103",2056,817,1043,553,301,203,1526,697,7196
"12081000105",1928,680,302,193,307,365,950,645,5370
"12081000106",1059,621,700,298,466,621,940,1131,5836
"12081000201",2583,359,53,19,268,0,162,0,3444
"12081000202",2492,421,187,50,44,32,134,152,3512
"12081000304",1358,379,255,153,49,0,320,199,2713
"12081000305",1765,1425,445,505,630,1065,1521,2190,9546
"12081000306",2738,1781,344,505,424,484,1289,1543,9108
"12081000307",1249,593,119,20,419,0,413,158,2971
"12081000308",2593,491,30,151,84,86,0,153,3588
"12081000309",1961,490,680,195,246,201,558,259,4590
"12081000310",2619,683,300,74,196,271,683,561,5387
"12081000403",1527,62,36,0,55,0,33,0,1713
"12081000405",2669,62,0,0,86,0,238,0,3055
"12081000406",3035,497,98,0,334,33,116,2,4115
"12081000407",3358,326,0,0,17,0,100,0,3801
"12081000408",4178,722,80,29,530,26,440,240,6245
"12081000501",2993,180,198,0,75,10,90,17,3563
"12081000503",3273,160,120,2,87,0,127,3,3772
"12081000504",2623,476,34,9,76,4,139,100,3461
"12081000601",1490,600,165,209,192,27,312,82,3077
"12081000603",2703,294,0,0,318,80,813,180,4388
"12081000604",1814,636,118,328,16,83,367,111,3473
"12081000703",760,110,1018,534,35,231,359,423,3470
"12081000704",1823,538,1143,621,159,275,1007,561,6127
"12081000705",1218,637,1011,1004,557,94,712,369,5602
"12081000803",6250,566,1381,386,922,0,1946,259,11710
"12081000804",3206,284,31,0,311,0,97,0,3929
"12081000805",3772,634,563,205,441,16,222,404,6257
"12081000807",5003,223,301,0,749,0,1060,0,7336
"12081000808",4868,615,21,26,120,0,148,7,5805
"12081000809",4489,191,167,0,159,0,549,22,5577
"12081000810",5031,201,253,40,232,0,195,0,5952
"12081000901",3091,625,457,287,104,132,556,266,5518
"12081000902",3097,505,277,26,390,94,374,78,4841
"12081001000",3675,555,1,0,518,20,793,96,5658
"12081001104",2968,174,58,0,284,0,134,0,3618
"12081001105",2471,230,224,334,176,28,217,5,3685
"12081001106",2362,139,307,26,178,42,364,73,3491
"12081001107",2648,406,108,0,40,11,97,11,3321
"12081001108",2197,282,0,2,44,2,153,159,2839
"12081001202",3960,557,23,0,100,9,306,0,4955
"12081001203",3223,391,76,0,422,39,491,0,4642
"12081001204",5131,256,152,0,272,0,250,0,6061
"12081001300",2876,430,34,0,2,0,147,172,3661
"12081001402",1401,47,4,0,0,0,106,0,1558
"12081001403",4093,648,40,0,218,45,782,422,6248
"12081001404",2851,371,233,14,59,205,442,205,4380
"12081001501",1213,481,1151,575,286,50,853,478,5087
"12081001502",2199,1038,1572,364,320,455,1022,1240,8210
"12081001601",4198,656,542,10,104,0,961,163,6634
"12081001602",2289,451,40,89,3,0,101,0,2973
"12081001701",1229,245,0,3,11,26,84,12,1610
"12081001703",1260,113,0,0,63,102,29,0,1567
"12081001704",535,48,0,0,0,0,0,0,583
"12081001800",4439,520,101,1,34,18,68,11,5192
"12081001904",3193,1144,149,95,0,86,303,552,5522
"12081001907",3528,618,362,152,148,76,283,116,5283
"12081001908",5115,671,71,50,106,0,207,77,6297
"12081001909",3132,119,83,0,75,0,77,0,3486
"12081001910",3606,204,35,26,186,15,271,0,4343
"12081001911",4491,168,213,0,270,30,547,0,5719
"12081001912",3847,197,336,33,175,0,379,17,4984
"12081001913",2358,96,112,1,160,13,108,31,2879
"12081001914",1910,507,94,24,244,12,312,302,3405
"12081002003",3898,362,363,11,196,0,321,6,5157
"12081002005",4604,327,217,0,190,0,522,38,5898
"12081002007",3773,231,237,0,178,0,137,0,4556
"12081002008",5213,227,30,12,125,0,294,0,5901
"12081002010",2959,373,0,73,246,141,310,182,4284
"12081002011",2908,558,252,11,298,152,643,367,5189
"12081002012",4130,349,59,0,137,12,79,0,4766
"12081002013",9071,556,584,54,835,72,669,42,11883
"12081002014",3743,186,10,29,20,0,104,83,4175
"12081002015",5104,434,36,0,114,7,458,8,6161
"12081002016",4522,689,181,25,180,180,207,455,6439
"12081002017",3305,167,38,0,177,10,419,0,4116
"12081990000",0,0,0,0,0,0,0,0,0
"12083000100",3178,713,504,208,83,0,306,60,5052
"12083000200",3443,837,1456,737,211,50,216,289,7239
"12083000301",3066,523,207,14,127,20,130,27,4114
"12083000302",1687,652,621,655,65,62,254,259,4255
"12083000401",1854,220,0,22,218,10,128,0,2452
"12083000402",4093,1263,0,7,238,0,311,61,5973
"12083000501",1317,225,0,0,14,0,35,0,1591
"12083000502",902,317,0,0,0,18,16,32,1285
"12083000601",2854,904,0,0,54,93,85,124,4114
"12083000602",4305,933,0,0,49,81,148,30,5546
"12083000604",2147,1244,0,8,56,162,108,362,4087
"12083000605",1754,651,175,1,20,0,0,0,2601
"12083000701",2873,1158,326,29,123,45,162,67,4783
"12083000702",6484,485,82,6,119,17,294,68,7555
"12083000801",14363,879,590,6,290,19,162,22,16331
"12083000802",9005,807,113,145,135,92,436,122,10855
"12083000901",4326,1151,299,0,140,56,735,71,6778
"12083000902",7264,1400,95,243,179,105,1037,705,11028
"12083001003",702,575,26,6,88,0,81,240,1718
"12083001004",7206,1761,2417,320,1262,459,3530,1123,18078
"12083001005",3188,533,2024,69,325,63,385,416,7003
"12083001006",7176,357,473,40,966,32,1450,40,10534
"12083001007",5104,487,115,40,380,0,736,0,6862
"12083001008",4107,241,144,0,29,68,188,86,4863
"12083001102",1916,615,114,135,101,6,230,162,3279
"12083001103",3952,436,720,168,392,49,493,72,6282
"12083001104",4404,974,170,22,176,70,319,368,6503
"12083001204",2315,1396,1836,658,461,9,653,567,7895
"12083001205",2699,379,216,159,165,0,161,93,3872
"12083001206",1026,114,415,19,161,42,63,33,1873
"12083001207",6061,1487,1533,310,799,277,1573,253,12293
"12083001208",2883,547,185,233,39,0,229,56,4172
"12083001301",4574,643,871,19,204,0,548,198,7057
"12083001302",5004,338,204,65,15,104,339,27,6096
"12083001401",2463,848,1097,581,152,193,220,232,5786
"12083001402",3735,758,549,158,223,60,76,72,5631
"12083001500",712,392,2013,892,65,5,151,14,4244
"12083001600",912,455,146,47,180,101,235,281,2357
"12083001700",676,806,1764,1290,266,589,489,1076,6956
"12083001800",53,11,729,891,26,6,0,6,1722
"12083001900",1519,337,189,251,57,14,114,264,2745
"12083002001",1606,553,165,74,170,30,272,121,2991
"12083002002",1974,925,204,715,95,89,147,88,4237
"12083002100",4050,249,55,9,116,0,328,98,4905
"12083002201",2325,526,44,0,42,18,205,67,3227
"12083002202",3154,186,27,0,0,0,89,16,3472
"12083002203",4889,457,420,290,192,16,330,55,6649
"12083002301",4418,594,308,44,317,47,188,121,6037
"12083002302",5190,336,430,78,113,80,449,41,6717
"12083002401",3237,276,349,301,353,11,420,70,5017
"12083002402",4123,437,95,183,283,0,224,1,5346
"12083002502",7460,1467,722,0,1214,50,1335,455,12703
"12083002503",3961,544,607,323,616,662,722,645,8080
"12083002504",2880,376,683,923,568,10,439,84,5963
"12083002601",4611,1266,161,207,309,271,561,319,7705
"12083002602",4150,1245,354,161,127,563,807,1375,8782
"12083002604",2874,447,90,0,77,18,421,137,4064
"12083002605",1891,342,102,18,211,0,188,0,2752
"12083002606",5512,475,60,0,212,0,33,35,6327
"12083002701",4124,1339,87,11,197,0,556,45,6359
"12083002702",4884,764,229,658,242,10,78,31,6896
"12083980000",0,0,0,0,0,0,0,0,0
"12083980100",0,0,0,0,0,0,0,0,0
"12085000100",2111,39,13,0,82,0,28,0,2273
"12085000200",2598,305,54,8,42,0,54,9,3070
"12085000300",4371,638,214,302,36,6,35,16,5618
"12085000400",6934,533,58,1,125,0,251,0,7902
"12085000501",3212,768,83,38,63,36,146,23,4369
"12085000502",1768,59,14,0,23,0,97,0,1961
"12085000603",4689,473,41,25,391,0,336,0,5955
"12085000604",5183,223,51,0,300,40,264,0,6061
"12085000606",4619,294,42,0,106,0,433,0,5494
"12085000607",2695,112,28,0,66,0,114,54,3069
"12085000610",3725,24,12,0,224,0,316,0,4301
"12085000700",2841,476,65,7,71,290,69,332,4151
"12085000800",727,88,441,606,97,9,138,0,2106
"12085000901",1791,74,0,1,13,0,23,14,1916
"12085000902",3461,622,91,80,173,56,270,149,4902
"12085001000",2343,848,560,189,327,757,461,997,6482
"12085001102",6261,449,0,0,345,0,213,0,7268
"12085001103",1799,174,38,0,114,28,140,48,2341
"12085001104",7153,475,302,0,284,191,563,352,9320
"12085001200",1170,702,74,66,200,30,466,344,3052
"12085001301",3636,926,365,192,1023,445,1448,988,9023
"12085001302",3572,192,36,22,75,0,53,0,3950
"12085001404",4801,271,182,42,23,207,517,202,6245
"12085001406",3122,245,58,21,62,0,95,0,3603
"12085001407",1798,159,0,0,0,0,77,0,2034
"12085001408",1728,454,267,198,51,75,270,118,3161
"12085001409",2477,207,26,0,14,0,44,0,2768
"12085001410",3772,301,449,205,481,62,209,236,5715
"12085001500",2825,88,107,0,113,0,174,1,3308
"12085001601",3825,173,0,34,137,18,128,30,4345
"12085001602",863,25,0,0,13,8,30,0,939
"12085001700",7790,941,378,46,482,60,459,48,10204
"12085001801",2721,880,489,656,2211,444,3344,1367,12112
"12085001802",965,679,14,4,331,344,537,924,3798
"12085990000",0,0,0,0,0,0,0,0,0
"12085990100",0,0,0,0,0,0,0,0,0
"12086000107",1868,328,85,0,11,19,818,290,3419
"12086000109",1669,532,553,131,148,117,1123,578,4851
"12086000113",6201,922,123,24,213,25,2562,355,10425
"12086000115",2009,405,115,8,101,18,764,292,3712
"12086000118",726,173,0,0,17,32,200,101,1249
"12086000119",3589,453,188,142,24,0,1480,160,6036
"12086000120",3567,409,200,0,512,0,1723,192,6603
"12086000121",1527,155,39,7,66,0,393,0,2187
"12086000122",2951,439,146,21,380,26,1062,100,5125
"12086000123",2776,530,180,1,73,84,1075,165,4884
"12086000124",556,365,980,337,174,44,668,158,3282
"12086000125",2451,356,392,123,160,126,1114,82,4804
"12086000126",2085,353,0,0,42,0,1358,107,3945
"12086000127",3129,138,24,32,237,13,1476,80,5129
"12086000128",1392,100,244,0,24,37,735,59,2591
"12086000129",2034,77,0,0,19,0,553,0,2683
"12086000130",2385,175,24,36,36,0,741,75,3472
"12086000131",1563,71,0,0,64,0,838,0,2536
"12086000132",3361,852,22,0,131,57,1200,507,6130
"12086000133",6294,378,134,0,196,0,2254,85,9341
"12086000134",1785,438,234,376,340,29,959,334,4495
"12086000140",2574,325,388,55,88,171,1899,261,5761
"12086000202",4019,1265,1074,630,563,136,3180,1081,11948
"12086000204",1316,171,2835,465,96,10,1211,135,6239
"12086000206",1175,119,2567,1038,124,61,1049,126,6259
"12086000209",571,424,3247,1754,205,60,495,643,7399
"12086000211",1743,219,422,178,386,55,1084,79,4166
"12086000212",863,336,2163,987,81,37,826,337,5630
"12086000213",2734,415,1616,798,178,10,964,213,6928
"12086000214",2684,798,1305,556,191,94,1109,441,7178
"12086000215",504,137,2132,1024,280,0,605,64,4746
"12086000216",992,170,2529,784,143,0,771,65,5454
"12086000217",565,174,3248,1497,509,200,1053,364,7610
"12086000218",379,82,1889,1079,20,60,295,60,3864
"12086000219",1178,228,1309,1201,189,119,843,201,5268
"12086000220",754,470,2419,881,561,34,1010,465,6594
"12086000301",981,261,3434,1493,562,26,933,311,8001
"12086000302",772,54,1543,64,300,0,636,17,3386
"12086000305",1014,610,3098,1569,586,25,942,661,8505
"12086000306",770,319,2601,1309,356,63,886,298,6602
"12086000307",1502,59,1834,636,210,23,1329,82,5675
"12086000308",1276,123,2601,727,393,25,1214,120,6479
"12086000402",183,124,2267,1217,0,0,167,69,4027
"12086000403",316,523,3135,983,181,41,489,545,6213
"12086000404",691,134,3920,526,566,207,1256,341,7641
"12086000405",726,145,2391,1002,280,0,716,159,5419
"12086000408",717,595,2382,1272,54,76,746,564,6406
"12086000409",330,239,2629,911,284,182,530,312,5417
"12086000410",1118,308,2822,509,155,177,1206,499,6794
"12086000411",360,73,3219,2069,231,30,620,151,6753
"12086000412",1724,342,2977,1062,238,288,1877,529,9037
"12086000413",739,340,2388,1173,100,38,527,402,5707
"12086000414",951,101,2547,947,231,34,455,100,5366
"12086000501",1653,837,2873,1183,51,99,2001,926,9623
"12086000503",1430,763,2053,3073,327,52,1630,991,10319
"12086000504",1368,544,2312,435,167,73,1672,605,7176
"12086000505",4241,1180,112,12,11,32,4162,1224,10974
"12086000601",3616,1447,33,0,6,14,3504,1404,10024
"12086000602",3713,749,9,15,158,151,3436,906,9137
"12086000603",4080,987,0,84,64,0,3829,1020,10064
"12086000604",4486,1440,14,6,267,7,4611,1383,12214
"12086000605",3704,650,7,18,67,6,3652,673,8777
"12086000607",3305,1286,0,0,209,0,3382,1268,9450
"12086000608",4098,2192,104,106,142,80,4104,2251,13077
"12086000705",3147,1121,27,8,243,61,3301,1171,9079
"12086000706",5731,1948,0,125,218,42,5803,2115,15982
"12086000707",5811,908,152,166,255,433,5704,1504,14933
"12086000708",4376,919,48,27,846,109,4973,839,12137
"12086000709",4969,1101,54,168,291,37,5293,1306,13219
"12086000710",3429,1593,32,3,42,23,3307,1602,10031
"12086000711",3559,1496,186,6,48,12,3642,1503,10452
"12086000712",1704,795,0,21,101,0,1795,633,5049
"12086000804",3264,1253,110,147,19,53,3245,1404,9495
"12086000805",5087,822,44,26,249,6,5168,842,12244
"12086000806",2402,1872,95,114,39,0,2470,1958,8950
"12086000807",1847,1608,28,158,202,111,2057,1689,7700
"12086000808",2665,1392,34,27,97,44,2719,1366,8344
"12086000901",4723,1278,863,80,381,95,5170,1353,13943
"12086000902",2728,1187,1775,395,198,29,3141,1285,10738
"12086000903",751,606,891,283,83,49,752,678,4093
"12086001002",262,754,3467,1424,0,0,297,891,7095
"12086001003",1001,179,2699,655,60,73,1111,188,5966
"12086001004",357,580,2555,1600,107,47,441,652,6339
"12086001005",134,56,1221,299,11,130,88,195,2134
"12086001006",604,416,2202,1339,263,58,557,507,5946
"12086001101",1193,235,3097,505,528,126,1020,306,7010
"12086001102",1293,308,2277,279,76,0,998,270,5501
"12086001103",1209,147,1725,567,32,91,980,108,4859
"12086001104",3258,231,687,70,245,15,1121,102,5729
"12086001203",1881,651,3115,1647,96,88,1136,458,9072
"12086001204",2963,1119,890,66,308,124,1677,998,8145
"12086001205",2611,158,443,93,246,12,1142,109,4814
"12086001206",2969,486,469,125,74,0,1120,236,5479
"12086001301",1810,592,1142,416,310,41,954,463,5728
"12086001302",3439,290,687,1377,293,148,1853,413,8500
"12086001401",346,411,2333,1969,11,43,275,364,5752
"12086001402",512,194,1542,3365,220,15,351,129,6328
"12086001501",126,92,956,2472,0,33,114,79,3872
"12086001502",95,106,1443,1818,62,61,150,129,3864
"12086001602",4553,1668,31,0,115,128,4537,1693,12725
"12086001603",1816,650,0,2,46,71,1832,721,5138
"12086001605",2031,1739,44,213,36,0,2088,1838,7989
"12086001606",3110,1271,86,12,72,85,3161,1321,9118
"12086001701",843,525,1630,775,99,193,911,647,5623
"12086001702",404,112,1207,351,8,0,378,137,2597
"12086001703",3283,1138,277,34,131,208,3520,1368,9959
"12086001801",215,273,1966,1628,0,0,206,384,4672
"12086001802",641,265,1553,1137,23,30,647,275,4571
"12086001803",187,228,1063,1228,0,215,230,482,3633
"12086001901",2,445,2234,927,0,24,2,445,4079
"12086001903",386,168,1553,1068,8,0,364,143,3690
"12086001904",205,26,2219,1758,0,90,205,116,4619
"12086002001",78,82,2069,1731,83,0,122,116,4281
"12086002003",357,515,1344,965,72,83,306,583,4225
"12086002004",414,382,1034,1011,62,13,428,365,3709
"12086002100",1418,426,405,10,305,38,667,217,3486
"12086002201",921,308,1241,267,220,143,708,393,4201
"12086002202",831,547,1876,1863,307,181,1223,665,7493
"12086002300",491,317,2569,1577,179,42,621,308,6104
"12086002402",2623,1419,309,293,168,242,2957,1652,9663
"12086002403",1945,727,325,485,605,446,2582,1490,8605
"12086002404",1966,1799,678,433,222,71,2370,1997,9536
"12086002501",1689,1267,747,632,512,77,2431,1521,8876
"12086002502",1098,690,630,678,332,84,1524,723,5759
"12086002600",2648,1423,358,1208,187,290,2148,1569,9831
"12086002702",1447,584,446,203,148,9,1497,439,4773
"12086002703",4855,418,159,53,219,16,2413,402,8535
"12086002705",1805,344,239,149,193,0,1178,217,4125
"12086002706",2065,161,338,46,280,130,1868,187,5075
"12086002800",277,433,209,411,8,38,298,358,2032
"12086002900",2870,1561,723,577,376,244,3466,1836,11653
"12086003001",780,427,565,160,168,83,573,473,3229
"12086003003",4079,1863,265,497,170,14,4317,1855,13060
"12086003004",1718,1066,246,88,161,22,1859,1121,6281
"12086003100",269,139,1616,1754,69,30,418,193,4488
"12086003400",97,69,792,701,0,44,61,115,1879
"12086003601",587,891,489,1247,141,74,676,915,5020
"12086003602",3971,2469,307,465,44,79,3927,2650,13912
"12086003702",2074,595,287,131,379,65,1353,298,5182
"12086003703",886,129,227,0,106,0,546,26,1920
"12086003704",1319,99,79,35,29,14,968,41,2584
"12086003705",846,129,29,0,70,0,685,87,1846
"12086003706",0,0,0,0,0,0,0,0,0
"12086003707",487,195,59,79,59,33,176,155,1243
"12086003801",4328,395,116,167,507,288,2011,372,8184
"12086003803",2114,363,20,0,72,0,799,239,3607
"12086003804",4548,241,16,1,974,59,1763,181,7783
"12086003906",3002,166,28,0,41,6,590,98,3931
"12086003909",746,548,46,27,34,51,424,327,2203
"12086003911",2057,959,158,189,1319,145,2531,931,8289
"12086003912",2519,429,130,35,1246,296,2590,636,7881
"12086003913",2309,745,15,0,1618,231,3117,850,8885
"12086003914",2111,728,163,71,468,154,1238,819,5752
"12086003915",2803,727,30,52,1065,35,2741,639,8092
"12086003916",1670,343,319,46,987,141,1681,405,5592
"12086003917",3261,131,84,25,1339,232,3107,196,8375
"12086003918",1082,197,163,0,560,39,862,65,2968
"12086003919",1615,142,17,0,59,0,646,110,2589
"12086003921",2323,440,30,4,247,0,1707,359,5110
"12086003922",2266,270,0,0,244,3,1017,239,4039
"12086004000",3826,393,53,52,659,169,1326,263,6741
"12086004102",2251,138,7,7,188,22,749,62,3424
"12086004103",1761,270,551,70,516,72,1502,260,5002
"12086004105",1588,126,21,14,679,23,906,21,3378
"12086004106",2905,200,114,19,236,9,1165,94,4742
"12086004203",3189,402,100,0,720,62,1426,116,6015
"12086004204",1548,236,1,2,262,22,952,119,3142
"12086004205",1201,802,0,0,512,64,876,296,3751
"12086004206",1090,173,51,50,390,34,895,167,2850
"12086004301",1392,89,148,0,188,7,737,89,2650
"12086004303",1463,503,276,34,167,97,801,367,3708
"12086004304",1951,287,64,63,533,30,1150,322,4400
"12086004403",1529,462,127,85,242,65,1003,455,3968
"12086004404",994,598,21,49,110,34,661,512,2979
"12086004405",1746,793,26,147,921,368,2021,1074,7096
"12086004406",1720,301,134,0,363,131,873,302,3824
"12086004500",3000,388,69,0,403,42,1195,298,5395
"12086004602",3932,154,0,40,155,98,2214,55,6648
"12086004605",3076,202,0,0,5,0,2003,179,5465
"12086004607",3038,67,0,0,197,0,1696,37,5035
"12086004608",1325,101,0,0,153,17,838,79,2513
"12086004701",4964,317,32,0,406,15,3164,222,9120
"12086004702",5074,674,246,1,147,1,3908,664,10715
"12086004703",3590,630,17,111,170,9,2941,657,8125
"12086004901",1748,1109,105,1,305,32,2036,1141,6477
"12086004902",5059,1403,37,1,114,25,5083,1271,12993
"12086005001",5215,1675,20,62,233,0,5273,1685,14163
"12086005002",3864,1303,129,6,206,18,4055,1312,10893
"12086005102",2426,1264,51,110,71,32,2245,1304,7503
"12086005103",1441,1011,4,1,18,0,1445,1007,4927
"12086005104",1776,1276,272,201,44,0,2083,1276,6928
"12086005201",3459,1656,247,127,145,50,3650,1735,11069
"12086005202",3255,1576,23,60,621,319,3861,1909,11624
"12086005302",2719,3476,126,412,139,53,2866,3900,13691
"12086005303",2264,937,32,103,45,44,2322,976,6723
"12086005304",2028,1799,194,114,113,69,2288,1854,8459
"12086005403",845,228,136,54,0,0,954,282,2499
"12086005405",2096,1043,228,129,102,0,2336,1171,7105
"12086005406",2335,994,371,337,32,99,2738,1428,8334
"12086005407",1117,741,51,5,82,0,1171,707,3874
"12086005409",1977,1353,54,90,171,33,2137,1413,7228
"12086005410",2086,969,126,11,34,0,2172,980,6378
"12086005501",4570,1062,92,32,131,0,4593,1061,11541
"12086005502",4090,2706,0,0,242,0,4103,2702,13843
"12086005600",4253,879,262,5,44,30,4279,790,10542
"12086005701",4652,1088,8,14,106,108,4653,1196,11825
"12086005703",5122,1005,64,64,215,27,5026,1063,12586
"12086005704",5984,2084,60,6,104,0,6045,2069,16352
"12086005801",5906,927,46,13,364,88,5956,870,14170
"12086005802",7217,2110,19,25,177,0,7116,2087,18751
"12086005901",3336,874,0,0,147,0,3141,803,8301
"12086005902",2712,924,33,16,0,0,2551,925,7161
"12086005903",4647,1138,0,0,45,0,4386,1078,11294
"12086005904",3623,432,20,0,188,23,3456,455,8197
"12086006001",5443,736,0,6,330,0,4988,693,12196
"12086006002",5176,398,46,28,73,17,4396,238,10372
"12086006101",5143,279,0,0,252,0,3587,180,9441
"12086006102",5441,438,0,0,233,3,3072,116,9303
"12086006201",2084,521,143,1,108,12,1939,532,5340
"12086006203",1215,241,0,1,222,1,771,179,2630
"12086006205",2746,443,161,67,127,49,2327,507,6427
"12086006206",2335,349,9,0,21,14,1627,236,4591
"12086006301",4570,1765,116,146,335,2,4511,1876,13321
"12086006302",3744,584,20,14,139,396,3463,938,9298
"12086006401",2442,874,37,41,131,38,2416,926,6905
"12086006402",3010,499,42,0,178,25,2980,524,7258
"12086006403",2471,815,170,1,177,9,2323,803,6769
"12086006501",2240,731,0,23,109,23,2144,690,5960
"12086006503",1858,504,11,2,290,6,1827,508,5006
"12086006504",1770,286,93,0,314,0,1733,269,4465
"12086006601",5948,1245,452,60,161,200,5713,1419,15198
"12086006602",3032,1553,83,31,246,14,2656,1578,9193
"12086006702",6871,1128,342,71,404,121,4180,712,13829
"12086006705",2457,419,37,2,76,30,1511,294,4826
"12086006706",1522,418,92,0,70,0,836,349,3287
"12086006707",3901,142,150,0,135,0,2257,85,6670
"12086006709",464,90,34,0,170,0,326,16,1100
"12086006711",1423,312,164,0,162,0,910,205,3176
"12086006713",1151,523,0,0,12,35,838,545,3104
"12086006714",1018,99,18,22,326,0,946,109,2538
"12086006801",2432,337,0,2,124,33,922,238,4088
"12086006802",3770,219,15,11,141,0,1649,158,5963
"12086006900",4691,1081,32,67,225,112,3956,1139,11303
"12086007001",6038,1728,234,34,576,230,5981,1790,16611
"12086007002",4994,1861,197,53,34,23,4806,1615,13583
"12086007101",1277,148,419,365,113,0,619,161,3102
"12086007103",1209,166,119,13,106,0,512,34,2159
"12086007104",2137,449,155,21,172,20,519,308,3781
"12086007200",422,78,1338,722,8,0,208,100,2876
"12086007300",3778,246,74,0,164,18,1382,82,5744
"12086007400",6230,232,29,0,410,30,4045,107,11083
"12086007501",2553,180,0,0,48,28,1664,120,4593
"12086007503",852,14,0,0,5,0,472,8,1351
"12086007601",2273,318,3,2,58,0,1478,142,4274
"12086007603",1244,665,1218,398,65,43,975,192,4800
"12086007604",4877,389,99,0,254,19,2754,94,8486
"12086007605",3294,578,0,27,267,155,2084,346,6751
"12086007606",4402,687,578,10,462,71,2701,425,9336
"12086007701",6041,542,125,0,174,96,5520,580,13078
"12086007702",5418,235,101,15,304,12,4193,216,10494
"12086007704",2964,321,106,54,270,91,2157,244,6207
"12086007705",3807,307,169,0,174,0,3040,186,7683
"12086007801",1180,9,0,2,4,0,570,6,1771
"12086007804",4797,426,241,43,616,179,3474,270,10046
"12086007805",3846,263,34,92,327,34,2581,279,7456
"12086007806",3986,108,116,15,169,53,1699,99,6245
"12086007807",3371,294,12,0,460,113,1810,227,6287
"12086007901",3014,284,52,8,21,18,1709,236,5342
"12086007902",3090,99,0,2,174,63,1463,67,4958
"12086008000",5250,260,312,0,125,0,2939,147,9033
"12086008101",3023,238,37,2,149,0,782,23,4254
"12086008102",3859,88,56,3,816,32,1831,21,6706
"12086008202",3105,337,187,0,251,28,1413,214,5535
"12086008205",3567,101,21,0,133,0,1799,19,5640
"12086008206",3584,196,177,11,350,21,1543,145,6027
"12086008207",3916,54,44,21,93,1,1454,14,5597
"12086008208",2732,575,291,437,131,9,1654,351,6180
"12086008209",3805,135,341,0,557,0,1447,63,6348
"12086008304",1127,494,4372,1128,152,99,1184,627,9183
"12086008305",4145,505,271,21,375,16,2228,448,8009
"12086008306",5043,638,1652,495,231,16,3852,643,12570
"12086008307",2757,398,2809,402,352,58,2457,395,9628
"12086008308",2702,472,1966,235,406,76,2509,462,8828
"12086008309",417,156,2625,1794,111,108,448,86,5745
"12086008405",5864,281,99,226,207,0,3523,140,10340
"12086008407",6565,364,10,2,543,12,5230,328,13054
"12086008409",4495,262,227,116,257,29,2767,147,8300
"12086008410",5344,217,66,68,428,0,3467,148,9738
"12086008412",3974,1225,256,44,381,38,3605,1116,10639
"12086008414",5401,761,567,4,722,0,3428,733,11616
"12086008415",4420,9,102,0,453,70,2176,9,7239
"12086008416",2817,279,1,0,296,0,2158,260,5811
"12086008417",3964,809,359,16,322,57,3337,716,9580
"12086008418",2464,249,148,72,85,0,2364,146,5528
"12086008419",4488,440,134,0,223,57,3956,351,9649
"12086008501",5499,1254,228,56,198,14,5338,1223,13810
"12086008502",4125,456,37,0,186,7,3553,316,8680
"12086008601",3951,935,0,10,148,18,3523,907,9492
"12086008602",6429,795,0,0,284,0,5602,761,13871
"12086008701",5292,893,0,11,25,42,4778,920,11961
"12086008702",4586,756,295,26,167,52,4229,710,10821
"12086008803",4959,909,197,41,29,53,4759,905,11852
"12086008804",6156,1340,259,0,173,25,6149,1348,15450
"12086008805",3331,1277,15,0,52,7,3262,1253,9197
"12086008806",3906,154,0,4,5,14,3455,151,7689
"12086008901",6623,573,82,0,24,0,6523,447,14272
"12086008902",5357,1241,100,70,130,0,5076,1256,13230
"12086008904",0,20,0,0,0,0,0,8,28
"12086008906",3678,1049,0,198,83,27,3511,1244,9790
"12086008907",3520,556,70,0,140,15,3414,447,8162
"12086009006",7912,1177,160,3,125,127,7745,1034,18283
"12086009010",4562,260,108,0,231,0,3672,258,9091
"12086009014",3375,394,50,0,227,15,3415,359,7835
"12086009015",3665,1128,0,0,83,169,3559,1104,9708
"12086009017",4421,1578,16,43,33,20,4351,1554,12016
"12086009019",3545,281,33,0,139,10,3585,288,7881
"12086009020",1545,735,0,32,122,17,1580,784,4815
"12086009021",2866,1311,15,10,210,19,3001,1261,8693
"12086009022",1515,293,9,38,0,16,1489,338,3698
"12086009023",5438,931,135,18,144,107,5428,931,13132
"12086009024",3343,536,164,0,249,276,3095,812,8475
"12086009026",1722,571,0,0,13,51,1622,489,4468
"12086009027",2916,984,0,0,200,35,2791,906,7832
"12086009028",3813,214,7,0,110,0,3704,214,8062
"12086009029",2765,608,16,11,210,0,2806,610,7026
"12086009030",3410,714,103,0,128,0,3356,714,8425
"12086009031",3033,542,25,18,314,0,3076,488,7496
"12086009034",6265,295,143,0,747,22,4912,306,12690
"12086009035",3449,602,149,25,285,54,2933,602,8099
"12086009036",6636,595,91,32,500,56,5878,517,14305
"12086009038",6110,767,0,0,566,103,5206,730,13482
"12086009039",3400,308,245,0,637,58,3061,230,7939
"12086009040",35,36,0,2,0,0,30,38,141
"12086009043",3630,513,121,0,97,0,3169,462,7992
"12086009044",1353,131,0,0,141,28,1165,143,2961
"12086009046",562,98,34,78,57,0,475,123,1427
"12086009047",2537,467,47,0,94,13,2290,467,5915
"12086009100",4114,1014,62,2,234,3,4254,990,10673
"12086009200",2737,523,0,3,347,0,2902,500,7012
"12086009305",4260,440,61,0,201,52,3293,334,8641
"12086009306",4978,1570,103,107,348,50,5031,1682,13869
"12086009307",4162,1611,309,156,391,9,4432,1546,12616
"12086009308",4700,2303,209,239,79,62,4633,2591,14816
"12086009309",5784,1058,27,22,299,104,6026,1171,14491
"12086009311",5065,922,60,40,380,0,5324,891,12682
"12086009312",4673,712,171,0,132,47,3978,654,10367
"12086009313",4478,341,229,37,128,0,3964,341,9518
"12086009314",3155,1089,40,0,186,71,3230,1111,8882
"12086009315",1814,637,56,0,226,6,1904,597,5240
"12086009400",1310,319,3624,1347,195,72,1466,431,8764
"12086009501",535,29,3616,890,29,61,571,108,5839
"12086009503",403,23,2873,1200,20,106,448,77,5150
"12086009504",300,44,3834,646,28,6,314,29,5201
"12086009600",1112,220,4253,787,39,54,995,209,7669
"12086009703",3358,148,7,0,259,95,1128,115,5110
"12086009704",5067,348,326,72,158,54,2113,239,8377
"12086009705",2489,1323,402,214,443,85,1849,833,7638
"12086009706",2364,306,141,50,93,0,1229,248,4431
"12086009803",2011,106,2225,101,296,9,1376,112,6236
"12086009804",1260,80,1562,219,208,0,734,31,4094
"12086009806",1176,546,568,54,293,38,744,365,3784
"12086009807",1376,641,3927,866,285,0,852,350,8297
"12086009808",2107,473,1963,432,179,61,1548,261,7024
"12086009901",1416,225,5672,766,202,30,1310,251,9872
"12086009903",29,17,4440,550,17,0,164,0,5217
"12086009904",34,17,1999,714,209,19,189,39,3220
"12086009905",289,11,4639,981,15,0,693,0,6628
"12086009906",644,54,3761,343,133,7,419,51,5412
"12086010001",801,468,4209,1810,296,0,1146,441,9171
"12086010005",4458,447,1231,594,928,212,5054,847,13771
"12086010006",2581,908,3350,622,289,13,2886,1156,11805
"12086010009",3837,944,2530,661,607,12,4396,930,13917
"12086010010",1680,243,1659,680,164,180,1858,425,6889
"12086010011",449,313,3336,1186,208,254,815,818,7379
"12086010012",64,0,4090,605,321,0,628,0,5708
"12086010013",2352,839,1204,49,266,43,2416,851,8020
"12086010015",2073,785,0,24,557,683,2329,1193,7644
"12086010016",3138,748,552,39,259,3,3311,744,8794
"12086010193",2042,70,82,0,153,65,1911,97,4420
"12086010198",2801,150,378,19,293,0,2157,140,5938
"12086010201",2796,274,375,8,614,0,2628,274,6969
"12086010204",5621,560,1080,0,206,84,4785,420,12756
"12086010205",2328,1215,939,229,233,0,2313,1180,8437
"12086010207",1021,719,1239,306,161,0,900,773,5119
"12086010208",1946,675,1141,837,64,80,1944,642,7329
"12086010209",3779,653,622,379,176,116,3480,804,10009
"12086010210",3704,514,903,1028,661,126,3674,525,11135
"12086010300",5384,1995,206,31,556,2,2868,1210,12252
"12086010400",1761,384,451,367,81,310,1486,534,5374
"12086010500",4062,1209,3005,878,72,119,3399,1348,14092
"12086010604",4218,417,266,110,228,0,1627,247,7113
"12086010606",5293,656,874,50,413,0,3187,614,11087
"12086010608",3635,749,1067,27,343,23,2361,614,8819
"12086010609",2087,765,1555,286,102,28,1951,503,7277
"12086010610",2899,455,464,4,259,40,1465,452,6038
"12086010612",6516,278,1458,389,703,0,4521,171,14036
"12086010613",3131,461,262,245,672,211,2480,422,7884
"12086010614",2992,959,1759,1499,481,38,2538,981,11247
"12086010617",3367,341,914,126,438,89,3187,384,8846
"12086010703",6186,2025,2238,848,766,229,5782,1807,19881
"12086010704",4548,1687,2075,713,428,52,4023,1554,15080
"12086010801",2653,776,755,1159,550,192,2637,863,9585
"12086010802",2433,724,884,2219,140,113,2299,715,9527
"12086010900",2735,1601,631,308,405,113,2766,1482,10041
"12086011001",4015,2906,1759,652,420,61,3822,2790,16425
"12086011003",1822,1285,269,787,189,65,1657,1101,7175
"12086011005",3027,1430,1110,190,519,0,2923,1334,10533
"12086011007",3750,629,598,221,552,134,2822,626,9332
"12086011008",2469,306,806,11,302,17,1946,334,6191
"12086011009",3862,159,730,200,427,39,3278,139,8834
"12086011101",4472,2984,643,351,477,362,3878,3201,16368
"12086011102",5118,583,495,102,162,0,2606,431,9497
"12086011201",4219,1136,526,775,181,101,2964,984,10886
"12086011202",4417,2221,312,53,211,0,3336,1904,12454
"12086011300",1913,1574,1778,2550,162,325,1793,1525,11620
"12086011401",8165,1674,2906,1299,1758,94,5773,1224,22893
"12086011403",2734,1435,615,1284,131,198,1960,1201,9558
"12086011404",1861,2045,527,426,59,150,1450,1824,8342
"12086011500",4361,300,56,33,151,98,2914,164,8077
"12086011600",3460,458,827,214,155,0,3004,354,8472
"12086011700",4917,681,614,383,478,225,5006,1090,13394
"12086011800",2481,253,769,2,299,24,2136,212,6176
"12086011900",3183,781,548,21,144,161,2686,887,8411
"12086012000",5317,1837,1087,120,300,63,5409,1879,16012
"12086012100",10071,2419,412,677,708,288,10240,2099,26914
"12086012200",5328,194,31,4,117,25,4577,194,10470
"12086012300",5888,503,441,399,357,23,5990,797,14398
"12086012400",7723,701,566,89,326,0,7187,653,17245
"12086012500",4770,961,64,10,340,18,5024,954,12141
"12086012600",5344,1445,0,0,101,0,5244,1421,13555
"12086012700",5866,974,470,5,197,0,5130,961,13603
"12086012800",7032,735,213,6,374,0,6701,716,15777
"12086012900",4023,426,83,0,48,0,3936,426,8942
"12086013000",4191,455,6,0,699,0,4108,353,9812
"12086013100",4724,971,0,74,0,50,4587,1072,11478
"12086013200",4836,921,49,15,233,41,4867,879,11841
"12086013300",4349,851,121,14,11,0,4338,782,10466
"12086013400",4256,920,114,0,193,16,4251,936,10686
"12086013500",4003,1298,28,8,0,99,3722,1324,10482
"12086013600",4580,1275,91,110,75,18,4629,1403,12181
"12086013700",3179,1676,178,0,86,15,3308,1676,10118
"12086013800",4575,2001,162,47,37,78,4656,1875,13431
"12086013900",4494,606,101,7,85,0,4573,608,10474
"12086014000",71,0,0,0,9,9,80,9,178
"12086014100",0,0,0,0,0,0,0,0,0
"12086014200",4268,687,214,9,16,30,4178,687,10089
"12086014300",3570,214,5,7,117,0,3457,206,7576
"12086014400",3615,612,40,5,91,127,3663,519,8672
"12086014500",3839,671,0,7,27,0,3623,669,8836
"12086014600",5827,1390,11,0,104,32,5731,1353,14448
"12086014700",5603,1377,134,1,21,34,5620,1172,13962
"12086014800",4820,715,120,0,143,9,4830,677,11314
"12086014900",4665,460,35,0,76,9,4588,453,10286
"12086015000",6708,764,0,27,349,39,6794,795,15476
"12086015100",8271,974,38,26,564,75,7903,817,18668
"12086015200",6114,387,19,53,384,84,6286,362,13689
"12086015300",4800,654,0,15,170,0,4706,654,10999
"12086015400",4859,365,31,0,218,38,4843,381,10735
"12086015500",5621,696,36,28,49,0,5041,686,12157
"12086015600",3473,820,104,0,81,10,2828,776,8092
"12086015700",2267,294,17,7,37,89,2141,276,5128
"12086015800",4010,859,90,4,99,0,3706,838,9606
"12086015900",3081,728,0,4,148,0,2847,712,7520
"12086016000",4193,717,7,1,162,0,3786,713,9579
"12086016100",4271,654,23,0,203,9,4092,620,9872
"12086016200",2782,418,0,0,8,14,2487,422,6131
"12086016300",4364,324,191,0,334,0,3998,272,9483
"12086016400",6268,480,0,1,64,0,5933,445,13191
"12086016500",6208,444,422,46,845,30,6517,234,14746
"12086016600",3885,137,86,3,217,17,3305,135,7785
"12086016700",4420,726,42,14,191,52,4284,697,10426
"12086016800",3844,191,281,3,92,63,3690,252,8416
"12086016900",3767,677,0,0,225,59,3745,736,9209
"12086017000",4033,801,6,52,255,36,4031,800,10014
"12086017100",4766,800,569,145,284,110,5106,859,12639
"12086017200",3914,363,46,24,317,0,3242,376,8282
"12086017300",3325,652,200,0,308,70,3081,646,8282
"12086017400",5068,895,0,15,161,13,4215,784,11151
"12086017500",2698,507,35,17,289,66,2698,542,6852
"12086017600",5187,637,43,0,271,36,4983,627,11784
"12086017700",2647,952,155,12,161,73,2464,960,7424
"12086017800",3625,1577,141,94,218,7,3747,1566,10975
"12086017900",6705,407,394,6,444,48,5500,447,13951
"12086018000",5687,638,705,58,505,91,5069,519,13272
"12086018100",4022,206,143,10,452,26,3517,205,8581
"12086018200",1902,391,82,0,208,32,1800,367,4782
"12086018300",4143,808,247,8,238,190,3461,729,9824
"12086018400",2317,648,245,0,131,50,1945,694,6030
"12086018500",3130,733,240,102,419,2,2819,733,8178
"12086018600",7220,630,336,44,133,123,5973,551,15010
"12086018700",4476,713,92,16,138,0,3852,713,10000
"12086018800",5930,962,454,49,709,8,4546,819,13477
"12086018900",5280,767,187,31,792,46,3479,695,11277
"12086019000",4887,789,247,33,274,0,3532,632,10394
"12086019100",3990,270,309,2,231,280,2968,325,8375
"12086019200",3501,570,708,14,524,18,2657,524,8516
"12086019300",5565,831,792,180,617,0,3739,596,12320
"12086019400",7286,155,198,157,603,58,5447,155,14059
"12086019500",5352,672,592,33,150,121,3894,711,11525
"12086019600",3884,329,1074,1,623,0,3069,329,9309
"12086019700",2934,107,693,8,292,0,2676,115,6825
"12086019800",6899,433,839,3,361,0,5899,321,14755
"12086019900",7119,827,997,0,1253,49,7300,701,18246
"12086020000",6011,425,183,26,253,39,5189,427,12553
"12086020100",3855,273,282,7,294,10,3738,285,8744
"12086020200",2693,298,243,1,281,0,2579,207,6302
"12086020300",3197,218,331,3,166,11,3039,210,7175
"12086490100",1320,453,70,16,18,14,1352,483,3726
"12086980100",0,0,0,0,0,0,0,0,0
"12086980200",0,0,0,0,0,0,0,0,0
"12086980300",4,20,0,0,8,0,8,0,40
"12086980400",0,0,0,0,0,0,0,0,0
"12086980500",0,0,0,0,0,0,0,0,0
"12086980600",0,0,0,0,0,0,0,0,0
"12086980700",42,360,16,560,11,39,11,273,1312
"12086980800",0,0,0,0,0,0,0,0,0
"12086980900",0,0,0,0,0,0,0,0,0
"12086981000",0,0,0,0,0,0,0,0,0
"12086990000",0,0,0,0,0,0,0,0,0
"12087970200",1086,193,0,50,6,0,56,25,1416
"12087970300",1910,360,35,1,24,25,394,116,2865
"12087970400",2803,791,355,13,112,0,1283,435,5792
"12087970500",2370,216,0,0,151,0,532,108,3377
"12087970600",1522,185,28,8,32,0,207,57,2039
"12087970700",2308,151,22,1,35,0,432,9,2958
"12087970800",3482,442,2,1,47,0,255,52,4281
"12087970900",1503,214,7,19,40,5,191,5,1984
"12087971001",917,109,23,3,2,0,84,7,1145
"12087971002",1067,266,0,22,4,17,292,98,1766
"12087971100",2255,277,153,145,143,110,528,163,3774
"12087971200",1509,425,76,2,56,0,261,148,2477
"12087971300",1333,575,54,150,0,0,611,408,3131
"12087971401",2160,307,32,2,69,2,341,93,3006
"12087971402",1299,86,0,0,14,0,93,39,1531
"12087971501",1598,110,7,0,0,0,95,0,1810
"12087971502",2911,184,0,0,116,0,612,0,3823
"12087971600",1550,49,62,0,113,0,97,0,1871
"12087971700",2155,481,130,147,87,0,373,307,3680
"12087971800",3377,607,572,0,202,244,1804,543,7349
"12087971900",4012,377,619,35,345,54,1387,172,7001
"12087972000",2870,430,100,39,93,0,518,61,4111
"12087972100",3068,425,853,13,240,29,604,115,5347
"12087972200",2283,230,124,23,48,0,290,70,3068
"12087972300",2271,207,21,2,107,72,435,24,3139
"12087972400",1623,381,714,92,19,0,388,51,3268
"12087972500",1072,329,6,10,17,46,49,0,1529
"12087972600",588,47,0,1,29,0,89,8,762
"12087980000",4,0,0,0,4,0,0,0,8
"12087980100",0,3,0,4,0,0,0,2,9
"12087990000",0,0,0,0,0,0,0,0,0
"12089050101",4317,506,844,216,135,49,483,24,6574
"12089050102",2038,389,316,82,118,0,198,75,3216
"12089050201",1526,102,44,0,0,0,0,0,1672
"12089050202",5255,638,127,99,234,82,71,68,6574
"12089050203",2838,143,184,0,155,0,175,42,3537
"12089050301",5942,127,656,64,479,12,584,1,7865
"12089050302",5427,955,290,4,184,0,165,3,7028
"12089050303",9216,2352,474,24,109,20,271,0,12466
"12089050400",6638,1066,166,269,173,79,103,0,8494
"12089050502",6370,455,108,0,176,0,130,0,7239
"12089050503",5081,1052,646,98,50,7,140,0,7074
"12089050504",3400,317,89,0,138,0,25,0,3969
"12089990000",0,0,0,0,0,0,0,0,0
"12091020100",5855,1434,166,15,232,65,62,62,7891
"12091020200",1326,261,107,63,103,32,56,6,1954
"12091020301",4668,442,147,54,679,134,215,0,6339
"12091020302",3543,425,186,23,74,10,38,0,4299
"12091020400",4020,1139,520,158,285,37,200,76,6435
"12091020500",4808,1196,552,296,329,328,154,320,7983
"12091020600",6051,656,1289,587,1031,0,1001,14,10629
"12091020700",6533,1079,963,101,681,337,315,37,10046
"12091020800",3572,346,196,0,271,10,333,18,4746
"12091020900",4405,279,235,30,517,0,223,8,5697
"12091021001",4914,383,111,0,522,17,538,0,6485
"12091021002",4433,232,141,0,107,0,287,36,5236
"12091021101",2262,256,63,0,299,35,6,9,2930
"12091021102",6107,559,244,178,627,31,317,15,8078
"12091021200",3784,536,236,0,604,0,189,0,5349
"12091021400",1214,113,190,12,233,0,152,17,1931
"12091021501",2821,301,214,55,352,69,254,69,4135
"12091021502",3022,290,147,193,224,38,200,12,4126
"12091021600",1730,57,45,0,171,0,53,0,2056
"12091021700",2085,409,16,2,187,81,173,0,2953
"12091021801",2917,311,509,275,767,135,215,137,5266
"12091021802",2949,246,400,91,422,374,546,323,5351
"12091021900",4738,842,1458,866,1026,853,327,326,10436
"12091022001",1820,948,459,220,569,72,401,520,5009
"12091022002",2633,460,194,70,230,47,259,67,3960
"12091022100",1873,303,123,28,667,10,559,38,3601
"12091022300",1889,219,32,45,235,42,104,9,2575
"12091022400",2753,390,51,35,179,46,249,52,3755
"12091022500",2854,236,240,55,427,66,264,65,4207
"12091022600",1634,379,489,222,232,65,123,61,3205
"12091022700",2298,215,180,15,285,146,290,147,3576
"12091022800",1153,92,440,165,261,10,244,7,2372
"12091022900",3464,87,199,59,204,129,184,25,4351
"12091023100",4766,599,510,17,1003,0,593,214,7702
"12091023200",1475,88,16,14,31,72,194,72,1962
"12091023303",1218,230,5,0,7,0,33,10,1503
"12091023304",3074,91,0,0,210,0,291,32,3698
"12091023305",2891,212,8,0,350,27,229,22,3739
"12091023306",2059,78,95,101,312,0,99,101,2845
"12091023307",1373,252,43,9,305,0,408,0,2390
"12091023308",2581,140,0,0,402,0,126,0,3249
"12091990100",0,0,0,0,0,0,0,0,0
"12091990200",0,0,0,0,0,0,0,0,0
"12093910101",3383,808,190,29,0,21,675,144,5250
"12093910102",1861,320,0,362,149,31,477,39,3239
"12093910201",2683,976,29,511,67,98,1147,448,5959
"12093910202",2068,1126,204,98,88,502,943,1130,6159
"12093910300",729,274,735,326,0,19,146,139,2368
"12093910401",2145,414,0,1,174,1,238,2,2975
"12093910402",1843,587,0,4,84,418,303,767,4006
"12093910403",2293,832,0,1,66,17,175,377,3761
"12093910500",2654,1208,75,0,216,88,391,641,5273
"12093910601",3850,585,16,13,22,34,238,292,5050
"12093910602",1325,242,0,0,109,9,67,0,1752
"12093990000",0,0,0,0,0,0,0,0,0
"12095010200",3610,466,152,35,299,29,356,51,4998
"12095010300",1972,332,193,5,172,24,259,40,2997
"12095010400",24,4,742,584,29,87,85,103,1658
"12095010500",70,76,469,552,20,56,76,39,1358
"12095010802",2417,356,9,9,136,18,231,37,3213
"12095011000",2272,509,129,22,134,117,318,346,3847
"12095011100",1903,215,11,245,196,209,266,284,3329
"12095011200",2777,140,35,120,158,76,372,7,3685
"12095011300",3508,489,120,287,0,98,266,57,4825
"12095011600",1134,162,1449,1001,141,113,394,165,4559
"12095011701",17,130,2485,1350,42,156,30,187,4397
"12095011702",27,0,2471,1384,9,0,11,32,3934
"12095012000",657,140,3011,1785,857,152,519,41,7162
"12095012100",590,118,2852,1206,588,125,889,108,6476
"12095012201",724,116,2473,858,144,43,388,131,4877
"12095012202",587,61,2343,1064,703,156,483,151,5548
"12095012303",1008,85,4656,297,740,203,584,0,7573
"12095012304",601,119,3631,1433,445,76,523,0,6828
"12095012305",829,107,4241,1470,703,205,867,150,8572
"12095012306",724,95,1533,412,355,66,385,80,3650
"12095012307",1257,197,3170,2201,494,109,781,14,8223
"12095012401",1187,88,4549,1498,445,353,661,175,8956
"12095012402",547,245,2613,323,1036,152,948,160,6024
"12095012403",1268,294,2644,673,251,0,472,44,5646
"12095012500",1732,315,58,23,47,30,247,86,2538
"12095012600",4144,410,183,21,65,46,379,57,5305
"12095012701",3972,322,117,44,202,0,135,0,4792
"12095012800",3281,174,2,1,273,40,110,15,3896
"12095012900",2497,120,12,0,181,39,189,0,3038
"12095013201",2653,430,91,212,222,163,1586,480,5837
"12095013202",2851,942,649,166,710,122,2450,815,8705
"12095013300",4518,650,194,19,610,312,2272,745,9320
"12095013402",2572,440,82,0,489,256,1779,463,6081
"12095013403",2416,566,89,274,36,97,1596,382,5456
"12095013405",1003,417,305,37,219,68,741,329,3119
"12095013406",1974,667,484,46,483,151,1537,689,6031
"12095013503",1176,498,358,37,78,133,1121,543,3944
"12095013505",2709,1048,202,57,251,131,2137,967,7502
"12095013507",3430,990,541,279,712,307,2864,905,10028
"12095013508",1397,657,186,84,175,38,1212,624,4373
"12095013509",800,123,80,0,84,5,377,54,1523
"12095013510",992,234,373,82,59,181,728,436,3085
"12095013511",3065,1460,137,173,180,118,1927,1218,8278
"12095013512",2405,807,474,196,658,428,2269,1213,8450
"12095013603",2986,1050,181,11,424,49,1394,795,6890
"12095013604",3628,466,719,198,880,40,1647,381,7959
"12095013605",2567,469,171,0,371,60,924,260,4822
"12095013606",1707,885,266,226,454,210,1225,873,5846
"12095013607",4770,489,271,7,533,27,2016,384,8497
"12095013701",3013,1070,255,7,235,26,1151,743,6500
"12095013702",2976,742,440,149,581,56,1299,449,6692
"12095013801",1852,359,71,19,17,3,151,42,2514
"12095013802",2379,388,20,1,50,1,318,147,3304
"12095013803",2304,107,128,0,67,18,400,38,3062
"12095013900",3123,551,35,29,131,98,450,224,4641
"12095014000",5837,299,0,7,162,19,416,15,6755
"12095014100",4487,254,104,93,565,424,433,344,6704
"12095014200",4547,1677,933,903,1301,543,2952,2287,15143
"12095014301",2904,328,369,436,463,66,974,176,5716
"12095014302",1910,953,380,122,973,152,1758,793,7041
"12095014400",2141,178,309,160,342,47,578,59,3814
"12095014502",810,471,2014,1008,170,15,769,353,5610
"12095014503",1242,180,971,554,121,8,608,131,3815
"12095014504",2110,147,433,88,532,15,740,90,4155
"12095014601",419,131,3894,1876,472,363,634,459,8248
"12095014605",0,42,3376,922,85,207,116,225,4973
"12095014606",2580,366,1730,433,1375,379,1647,354,8864
"12095014607",2246,357,1165,162,697,264,1012,308,6211
"12095014608",555,186,2221,1097,147,0,151,0,4357
"12095014609",1552,257,2639,598,460,172,835,289,6802
"12095014701",1408,467,1688,605,1360,711,666,744,7649
"12095014702",2214,276,1311,171,831,309,1013,212,6337
"12095014703",1042,72,461,71,389,56,670,43,2804
"12095014704",5619,969,1705,586,2057,488,2038,242,13704
"12095014804",2603,502,1119,260,886,139,496,311,6316
"12095014805",1875,219,1700,195,1455,145,1016,171,6776
"12095014806",3452,112,330,1,1077,80,604,29,5685
"12095014807",3239,420,1528,269,1427,110,895,191,8079
"12095014808",8469,231,859,0,1223,155,772,232,11941
"12095014809",2090,70,164,0,213,61,99,0,2697
"12095014810",4827,287,267,29,659,91,576,13,6749
"12095014811",4270,209,526,127,453,91,458,139,6273
"12095014812",3613,254,707,56,664,57,929,60,6340
"12095014813",2102,378,64,0,474,380,390,478,4266
"12095014904",661,155,2903,618,401,199,351,202,5490
"12095014906",3297,357,1525,241,562,35,701,43,6761
"12095014908",769,67,3481,579,524,229,436,156,6241
"12095014909",917,45,1497,317,398,53,292,0,3519
"12095015001",978,138,129,21,99,218,416,293,2292
"12095015002",3504,672,123,81,983,379,1783,733,8258
"12095015003",3923,232,515,0,705,313,927,380,6995
"12095015004",4474,102,1964,326,1557,39,1333,0,9795
"12095015103",4524,325,518,442,606,27,1302,74,7818
"12095015104",2511,379,889,559,574,128,1101,321,6462
"12095015105",1538,680,836,61,287,21,489,19,3931
"12095015106",2317,262,2437,1222,1012,229,921,246,8646
"12095015201",3512,642,1105,425,1404,83,1438,244,8853
"12095015202",2292,1120,1216,862,404,126,565,598,7183
"12095015300",2388,431,104,24,112,50,151,0,3260
"12095015402",1537,206,0,0,50,52,171,38,2054
"12095015501",3838,306,524,159,220,51,318,88,5504
"12095015601",1943,5,0,0,88,0,51,0,2087
"12095015602",2303,93,0,0,95,0,184,0,2675
"12095015701",1765,121,18,14,148,30,85,64,2245
"12095015702",1673,34,70,0,65,0,73,8,1923
"12095015801",1252,125,20,0,116,141,176,155,1985
"12095015802",2426,68,2,4,129,0,267,8,2904
"12095015901",908,239,457,339,11,9,153,32,2148
"12095015902",1262,90,8,16,88,64,197,18,1743
"12095016001",818,112,0,5,11,21,14,29,1010
"12095016002",2068,60,0,0,126,11,169,11,2445
"12095016100",3481,330,0,0,554,9,204,113,4691
"12095016200",4765,585,296,224,251,17,394,84,6616
"12095016301",4123,587,335,96,452,87,801,107,6588
"12095016302",1790,897,262,270,331,136,837,450,4973
"12095016402",1645,389,284,140,260,148,972,453,4291
"12095016406",1055,406,49,16,281,44,428,172,2451
"12095016407",1999,1223,483,561,363,175,689,357,5850
"12095016408",1658,196,126,63,289,46,580,57,3015
"12095016409",2977,123,23,110,224,7,440,7,3911
"12095016410",4591,1106,684,263,930,49,2709,419,10751
"12095016411",2039,602,289,47,58,30,696,277,4038
"12095016412",3464,710,423,4,340,25,1093,277,6336
"12095016503",2739,591,293,155,357,212,1106,83,5536
"12095016504",2678,1008,66,129,536,142,903,604,6066
"12095016505",1538,802,186,29,221,52,492,366,3686
"12095016507",4796,739,594,32,603,242,1453,173,8632
"12095016508",3210,1874,811,52,410,598,1671,1358,9984
"12095016509",3065,505,88,0,549,0,719,49,4975
"12095016510",866,836,35,232,315,180,400,119,2983
"12095016511",1712,776,147,73,189,34,914,400,4245
"12095016601",7408,1309,712,0,1517,92,2249,365,13652
"12095016602",5714,1134,741,169,1034,153,1586,309,10840
"12095016704",12408,562,1133,63,2276,99,5064,393,21998
"12095016709",4809,1008,581,284,312,322,3705,998,12019
"12095016710",2571,584,368,114,823,138,1790,416,6804
"12095016712",4322,2202,729,371,864,716,2816,2056,14076
"12095016713",4977,1172,536,144,643,265,3185,1290,12212
"12095016714",2583,437,142,56,232,107,1441,412,5410
"12095016715",3587,669,414,204,597,19,2270,495,8255
"12095016716",5074,213,197,24,252,37,1825,103,7725
"12095016717",1636,200,255,0,782,82,988,156,4099
"12095016723",3807,473,484,7,506,103,2151,478,8009
"12095016724",3451,1330,347,18,643,106,2208,999,9102
"12095016727",6708,1974,454,132,1679,328,3597,1205,16077
"12095016728",4061,401,290,19,460,27,753,67,6078
"12095016729",9624,1726,1516,125,1557,1297,4509,1629,21983
"12095016730",22093,877,1449,991,3374,293,9274,808,39159
"12095016731",1942,187,487,9,527,0,841,24,4017
"12095016732",9950,689,1370,193,2905,420,5478,745,21750
"12095016733",4033,976,586,0,1235,62,2664,916,10472
"12095016734",7399,1444,1128,0,3388,160,4981,1355,19855
"12095016802",4554,230,376,24,1131,38,2125,111,8589
"12095016803",1319,232,508,59,300,126,807,270,3621
"12095016804",2711,498,424,108,789,98,2018,127,6773
"12095016806",6687,814,1086,119,2195,315,6104,869,18189
"12095016807",10381,1869,1767,178,3062,630,9977,1527,29391
"12095016902",1867,890,983,510,738,62,1899,780,7729
"12095016903",5860,807,2927,1900,1208,852,4021,1117,18692
"12095016904",1126,153,1530,304,929,135,1113,192,5482
"12095016906",806,381,1087,482,278,441,867,661,5003
"12095016907",1228,1078,1551,816,270,253,757,1148,7101
"12095017001",448,118,1594,463,93,0,219,45,2980
"12095017004",3232,564,194,20,570,94,466,146,5286
"12095017006",2446,125,168,263,1069,13,1373,233,5690
"12095017008",4455,1002,626,13,2270,111,3208,741,12426
"12095017011",3178,498,898,15,1326,40,2398,384,8737
"12095017012",1738,7,366,78,762,296,744,0,3991
"12095017013",5579,885,1060,60,680,126,3261,424,12075
"12095017014",6831,1056,787,77,2005,406,2801,962,14925
"12095017015",4969,334,503,41,933,125,1934,192,9031
"12095017016",7018,1012,236,0,1805,231,2765,614,13681
"12095017017",3732,811,98,326,628,234,1150,350,7329
"12095017103",8530,743,871,105,1588,978,2185,510,15510
"12095017104",16486,867,3630,49,3214,315,3061,109,27731
"12095017105",9746,436,557,0,2024,44,1619,175,14601
"12095017107",5168,59,262,43,1819,0,995,0,8346
"12095017108",5514,282,341,148,1217,178,752,29,8461
"12095017109",4386,588,416,0,842,0,351,0,6583
"12095017200",2150,231,310,188,202,50,240,63,3434
"12095017300",5170,636,1241,335,1209,1155,2197,1824,13767
"12095017400",5363,368,2539,350,1718,305,2320,382,13345
"12095017501",4277,843,1950,880,1480,39,1731,208,11408
"12095017503",2758,1057,328,368,712,460,943,1032,7658
"12095017504",4907,585,1613,213,1158,247,2248,364,11335
"12095017600",970,246,1831,764,316,233,507,396,5263
"12095017701",2735,666,862,180,610,332,1346,811,7542
"12095017702",1939,48,85,0,106,0,223,0,2401
"12095017703",2196,598,386,228,447,200,1070,321,5446
"12095017802",9159,554,2304,462,1620,266,2085,301,16751
"12095017804",6314,582,863,0,670,729,601,900,10659
"12095017805",2094,350,202,201,263,178,453,364,4105
"12095017806",3822,223,300,0,313,210,296,320,5484
"12095017807",2418,305,414,38,546,367,1342,474,5904
"12095017808",3135,247,197,2,305,0,599,0,4485
"12095017901",1666,197,222,74,260,62,508,122,3111
"12095017902",3894,906,454,0,410,149,749,654,7216
"12095018000",838,222,1017,386,152,107,165,146,3033
"12095018100",1826,201,443,142,356,215,353,43,3579
"12095018200",6761,1043,595,766,730,63,1425,361,11744
"12095018300",336,410,1465,511,169,9,160,61,3121
"12095018400",1626,240,22,2,157,94,510,57,2708
"12095018500",852,178,996,975,277,30,297,21,3626
"12095018700",945,122,2161,2070,299,18,374,38,6027
"12095018800",2173,246,147,134,138,40,271,23,3172
"12095018900",3293,526,1329,1441,359,85,577,183,7793
"12095990000",0,0,0,0,0,0,0,0,0
"12097040801",515,70,21,0,118,7,15,42,788
"12097040802",3530,437,228,112,637,107,1296,175,6522
"12097040803",6842,553,149,0,391,58,429,294,8716
"12097040804",4034,862,66,140,210,42,1572,437,7363
"12097040901",1992,356,130,0,501,73,1035,157,4244
"12097040902",3542,1012,384,15,772,305,2574,631,9235
"12097041001",6090,897,838,10,1339,69,4261,424,13928
"12097041002",5613,1100,748,134,990,90,3983,847,13505
"12097041100",8365,1940,4556,913,2254,502,7019,1889,27438
"12097041300",6160,2336,2851,1647,1085,530,5332,2738,22679
"12097041500",7384,754,1768,81,1814,199,4968,442,17410
"12097041600",1568,870,322,304,201,113,915,634,4927
"12097041700",3071,1028,473,74,889,202,2416,952,9105
"12097041800",1434,907,68,187,395,220,795,776,4782
"12097041900",4002,820,415,235,842,243,3704,954,11215
"12097042000",3672,1411,608,9,842,556,3371,1716,12185
"12097042100",5479,974,892,267,1425,217,4658,1272,15184
"12097042200",5344,1620,518,212,467,791,3316,1753,14021
"12097042300",3208,869,999,246,517,126,2233,646,8844
"12097042400",5464,800,811,203,576,263,3058,1051,12226
"12097042500",5089,421,694,238,1129,51,4512,497,12631
"12097042601",2268,274,166,185,316,107,2170,376,5862
"12097042602",6427,1413,1386,164,1542,377,5884,1576,18769
"12097042701",3716,1342,775,285,1099,776,4446,2092,14531
"12097042702",3829,965,826,167,1040,389,4091,1254,12561
"12097042800",6494,1740,371,203,1084,19,3969,1390,15270
"12097042900",9268,2027,890,251,1508,314,6677,1953,22888
"12097043100",3181,142,224,0,156,23,448,23,4197
"12097043201",98,0,0,0,0,21,0,21,140
"12097043202",417,0,0,0,14,0,18,0,449
"12097043203",2932,422,213,126,368,287,1087,232,5667
"12097043204",10335,1386,462,42,727,394,4330,835,18511
"12097043205",1404,79,0,0,80,8,220,0,1791
"12097043206",262,10,0,0,0,0,5,6,283
"12097043301",933,122,0,0,19,0,59,13,1146
"12097043302",9848,633,740,210,752,109,2940,163,15395
"12097043400",4015,793,32,31,86,387,566,475,6385
"12097043500",3145,913,161,11,108,34,472,95,4939
"12097043600",5167,1010,38,17,255,36,751,253,7527
"12097043700",4536,427,72,0,468,67,675,27,6272
"12097043800",5411,913,48,3,301,0,618,41,7335
"12099000101",6274,211,0,0,393,0,439,12,7329
"12099000102",2188,198,75,0,54,0,107,30,2652
"12099000202",4991,1196,0,0,264,0,819,952,8222
"12099000204",3315,448,70,0,231,220,465,309,5058
"12099000205",4850,413,58,0,144,0,1311,205,6981
"12099000206",5709,506,139,0,454,59,840,120,7827
"12099000208",4185,113,29,0,91,9,804,0,5231
"12099000209",5191,426,178,0,763,0,1170,0,7728
"12099000210",3175,438,573,12,142,66,410,202,5018
"12099000211",3923,158,0,0,0,0,466,0,4547
"12099000213",2105,142,417,22,132,68,163,90,3139
"12099000214",6250,151,42,0,381,182,573,0,7579
"12099000215",6834,318,19,0,588,10,614,16,8399
"12099000301",3181,325,31,0,290,0,80,49,3956
"12099000303",4450,69,17,0,264,0,83,0,4883
"12099000304",4255,435,231,0,261,201,543,118,6044
"12099000405",2654,148,0,0,38,0,103,0,2943
"12099000406",2361,194,0,26,45,47,60,0,2733
"12099000407",1457,93,0,0,0,0,31,0,1581
"12099000408",2989,200,0,33,28,0,59,11,3320
"12099000410",3322,104,25,5,33,0,131,0,3620
"12099000505",2429,89,0,0,60,2,80,2,2662
"12099000507",716,15,0,0,0,0,0,0,731
"12099000509",1376,87,0,0,58,0,32,12,1565
"12099000511",2282,58,8,9,40,11,41,0,2449
"12099000600",1172,181,26,11,16,0,48,0,1454
"12099000702",2807,142,0,46,23,27,137,27,3209
"12099000703",2828,309,21,0,67,13,104,153,3495
"12099000802",1888,479,42,18,211,0,231,53,2922
"12099000803",2518,246,13,0,38,35,271,14,3135
"12099000804",2262,71,188,25,204,20,229,0,2999
"12099000902",1707,103,248,69,357,41,306,0,2831
"12099000903",3534,508,783,1,131,12,537,8,5514
"12099000904",2883,162,442,4,192,46,371,86,4186
"12099000905",3660,241,95,0,423,14,465,4,4902
"12099001002",1058,291,3910,1537,104,0,479,105,7484
"12099001003",3947,105,95,76,491,0,854,6,5574
"12099001004",2800,642,502,605,172,210,573,429,5933
"12099001101",1876,402,1934,1058,472,14,355,260,6371
"12099001102",2110,176,73,37,71,0,125,36,2628
"12099001200",887,220,2003,1070,163,54,304,93,4794
"12099001301",839,211,3158,1187,244,148,336,234,6357
"12099001302",82,2,2784,1407,187,8,0,0,4470
"12099001402",333,141,1186,562,16,25,40,125,2428
"12099001403",0,0,1604,1785,0,6,0,0,3395
"12099001404",50,14,1976,1063,108,23,20,16,3270
"12099001500",203,41,1550,580,10,3,47,17,2451
"12099001600",1249,515,845,488,57,25,341,350,3870
"12099001700",2004,790,783,486,209,141,673,691,5777
"12099001801",278,240,3005,992,127,306,156,482,5586
"12099001802",2411,58,1014,129,284,43,746,16,4701
"12099001904",1077,235,1441,120,168,20,255,9,3325
"12099001907",1724,157,331,10,63,0,128,43,2456
"12099001908",3234,243,2465,622,145,37,1434,155,8335
"12099001909",1139,479,147,311,125,59,593,365,3218
"12099001910",1368,160,103,55,34,7,228,64,2019
"12099001911",495,246,0,0,55,0,37,7,840
"12099001912",1332,242,147,14,222,0,269,69,2295
"12099001913",1398,218,47,26,13,0,54,0,1756
"12099001914",1719,208,384,11,80,29,325,37,2793
"12099001915",3982,336,2022,118,502,36,2167,182,9345
"12099001916",1551,224,715,91,307,13,475,62,3438
"12099001917",1355,154,1507,428,516,72,792,110,4934
"12099002005",922,222,2159,324,48,184,289,137,4285
"12099002006",1284,406,1300,574,263,63,456,177,4523
"12099002100",90,52,2142,678,102,36,54,47,3201
"12099002200",26,36,643,718,32,33,58,42,1588
"12099002300",840,317,471,309,112,0,292,71,2412
"12099002400",111,99,760,441,23,0,25,3,1462
"12099002600",914,176,18,29,34,6,170,72,1419
"12099002700",3064,586,467,81,288,5,124,108,4723
"12099002800",2330,752,473,0,92,35,473,562,4717
"12099002900",1160,949,992,851,586,269,1385,1047,7239
"12099003000",2682,761,989,617,497,342,1693,1001,8582
"12099003101",3086,922,955,492,341,309,1522,785,8412
"12099003102",2060,830,2082,1491,316,114,1018,595,8506
"12099003201",2465,602,874,59,90,122,1256,547,6015
"12099003202",2470,495,1195,315,339,72,1338,428,6652
"12099003300",2943,1045,262,184,141,18,2062,961,7616
"12099003400",3101,742,114,1,140,0,1289,310,5697
"12099003504",834,20,0,0,0,0,7,0,861
"12099003507",1840,81,0,0,17,0,99,0,2037
"12099003509",2506,78,1,0,0,0,84,0,2669
"12099003511",1434,94,22,0,23,0,25,0,1598
"12099003600",4870,890,42,195,144,194,1557,937,8829
"12099003700",4061,1328,0,34,353,234,2946,1412,10368
"12099003800",4352,1241,444,170,525,15,2821,852,10420
"12099003901",2414,741,626,545,186,107,628,373,5620
"12099003902",2923,1206,1010,536,278,21,1766,770,8510
"12099004005",1835,274,539,36,219,0,908,203,4014
"12099004007",3090,1032,194,0,214,63,2272,834,7699
"12099004008",2692,546,1144,722,629,45,2107,240,8125
"12099004009",2105,826,211,220,399,244,1909,524,6438
"12099004010",1814,546,136,26,141,15,731,363,3772
"12099004011",3675,802,586,60,458,36,2515,722,8854
"12099004012",2823,387,187,17,117,26,777,221,4555
"12099004013",1921,791,53,0,25,0,835,334,3959
"12099004101",2974,947,506,83,109,17,1895,803,7334
"12099004102",2469,500,330,0,167,60,1986,418,5930
"12099004201",5392,1156,567,329,488,164,3925,825,12846
"12099004202",2868,879,595,5,155,51,1528,578,6659
"12099004203",2307,407,111,60,55,0,677,270,3887
"12099004300",5195,613,115,49,196,100,1865,250,8383
"12099004401",2357,514,366,121,104,0,1215,226,4903
"12099004402",2252,1542,372,321,151,0,1563,1233,7434
"12099004500",2429,1256,673,569,220,130,1575,1079,7931
"12099004601",2226,580,208,47,363,246,1316,519,5505
"12099004602",2011,1725,501,124,173,98,1166,1560,7358
"12099004702",3427,855,422,176,487,190,1907,829,8293
"12099004704",4071,1390,334,386,416,148,2819,1174,10738
"12099004705",2739,1119,589,264,521,200,2117,1070,8619
"12099004706",1464,96,349,18,197,42,360,71,2597
"12099004809",1124,120,72,0,11,0,110,36,1473
"12099004810",3841,335,18,0,408,10,639,141,5392
"12099004811",3051,67,49,125,222,0,528,4,4046
"12099004812",2862,283,3685,538,402,229,1882,416,10297
"12099004813",2731,395,1816,330,724,6,1501,243,7746
"12099004815",4423,455,489,512,743,380,1969,458,9429
"12099004816",2857,393,123,7,0,15,518,103,4016
"12099004817",3281,672,40,42,169,30,861,481,5576
"12099004818",1367,265,380,6,251,0,364,44,2677
"12099004819",2260,456,534,304,351,191,1698,512,6306
"12099004902",1803,63,64,0,30,0,150,6,2116
"12099004903",1092,868,1351,481,283,118,1077,871,6141
"12099004904",3113,1602,687,465,298,92,2309,1408,9974
"12099005000",3522,882,129,40,452,45,1941,467,7478
"12099005101",1700,1121,118,115,126,111,1677,1083,6051
"12099005102",1414,841,1484,1536,391,106,1411,794,7977
"12099005202",1481,841,445,259,598,120,1100,534,5378
"12099005203",1021,522,16,94,64,17,251,404,2389
"12099005204",2100,535,192,743,152,31,573,445,4771
"12099005300",3310,443,342,38,200,11,398,34,4776
"12099005405",1149,101,17,0,0,9,15,23,1314
"12099005407",1491,77,9,0,44,2,18,3,1644
"12099005409",723,0,0,0,44,0,39,0,806
"12099005411",3358,208,72,19,18,11,132,4,3822
"12099005501",1681,594,612,153,221,79,491,231,4062
"12099005502",3286,547,1244,651,489,116,778,262,7373
"12099005601",1528,144,1958,297,143,34,837,25,4966
"12099005602",2126,245,64,27,27,0,704,0,3193
"12099005701",1219,279,1905,1760,197,26,289,180,5855
"12099005702",1212,470,2049,1574,580,61,371,61,6378
"12099005807",2876,490,220,209,357,45,800,107,5104
"12099005808",3225,391,790,75,407,126,429,16,5459
"12099005810",1784,251,0,0,0,0,54,73,2162
"12099005811",2433,174,583,15,325,0,260,10,3800
"12099005812",2758,276,342,72,200,192,513,129,4482
"12099005813",3593,377,544,60,248,0,744,67,5633
"12099005814",2577,1153,652,156,324,211,1935,1026,8034
"12099005815",2559,199,1088,405,559,20,1045,0,5875
"12099005816",3801,269,901,44,681,25,1280,102,7103
"12099005817",2775,93,1872,440,990,101,883,77,7231
"12099005903",6665,195,383,0,673,50,1303,38,9307
"12099005915",3757,500,447,12,429,0,770,228,6143
"12099005916",4472,321,1260,281,1094,0,1658,130,9216
"12099005917",3624,95,616,0,292,0,1084,57,5768
"12099005918",1976,273,261,217,193,125,710,85,3840
"12099005921",7177,285,289,0,565,5,459,0,8780
"12099005922",4775,309,500,0,192,0,278,21,6075
"12099005923",3315,98,192,32,70,0,183,15,3905
"12099005926",3424,221,295,227,24,180,85,0,4456
"12099005930",2719,212,462,24,151,67,296,0,3931
"12099005931",2448,180,117,17,37,0,38,32,2869
"12099005933",2851,151,0,0,12,0,97,11,3122
"12099005934",1998,104,57,34,22,0,44,0,2259
"12099005935",1663,229,8,0,40,0,29,80,2049
"12099005936",2483,154,166,222,68,67,214,70,3444
"12099005937",1570,84,0,0,57,0,0,5,1716
"12099005938",3754,201,54,0,303,0,450,0,4762
"12099005939",980,201,14,0,6,12,123,0,1336
"12099005940",981,357,67,9,11,8,90,87,1610
"12099005942",2207,25,0,0,123,0,99,0,2454
"12099005943",1534,211,86,22,22,12,83,0,1970
"12099005944",1890,258,11,0,0,0,112,0,2271
"12099005945",4200,193,241,22,0,0,53,0,4709
"12099005946",6793,372,890,61,714,125,903,30,9888
"12099005947",4031,184,0,0,12,0,43,0,4270
"12099005949",3080,60,190,49,11,0,147,67,3604
"12099005950",2353,152,553,40,597,140,545,142,4522
"12099005951",2518,512,951,583,229,142,797,203,5935
"12099005952",1409,22,6,0,0,0,0,0,1437
"12099005953",3546,442,176,210,13,0,156,225,4768
"12099005954",3165,290,102,0,22,0,68,0,3647
"12099005955",4090,123,11,0,55,0,253,44,4576
"12099005956",634,81,31,0,5,0,5,0,756
"12099006005",3139,146,51,164,179,20,621,23,4343
"12099006006",2263,271,54,0,0,0,152,0,2740
"12099006007",1564,237,1325,428,80,38,108,182,3962
"12099006008",2156,80,119,48,7,0,133,7,2550
"12099006009",1722,102,0,0,6,0,134,8,1972
"12099006010",2100,133,755,30,285,24,797,7,4131
"12099006011",2184,198,460,76,131,25,275,11,3360
"12099006012",3165,188,478,39,139,0,940,33,4982
"12099006100",1022,281,1718,959,45,135,226,304,4690
"12099006201",1740,280,1289,1159,263,16,496,21,5264
"12099006202",1465,268,132,154,145,29,360,45,2598
"12099006203",1368,167,434,129,112,0,32,0,2242
"12099006300",3829,404,477,451,220,0,450,72,5903
"12099006401",1706,82,31,0,118,0,104,0,2041
"12099006402",3213,307,43,0,79,12,101,106,3861
"12099006501",905,158,500,107,81,60,152,81,2044
"12099006502",1361,347,1052,511,100,67,121,79,3638
"12099006602",3260,129,36,0,173,0,194,0,3792
"12099006603",4240,234,82,0,223,0,191,0,4970
"12099006604",2540,146,1766,254,308,39,392,15,5460
"12099006605",2876,116,944,273,184,14,246,9,4662
"12099006700",187,48,1247,640,59,0,10,22,2213
"12099006801",952,156,2102,1260,489,303,854,393,6509
"12099006802",294,132,1464,1142,17,68,209,92,3418
"12099006906",3885,373,214,65,116,75,532,52,5312
"12099006907",2258,212,370,59,91,10,162,0,3162
"12099006908",2952,340,668,154,423,404,876,424,6241
"12099006909",2308,249,102,48,181,0,276,0,3164
"12099006910",1444,125,149,15,69,0,240,7,2049
"12099006911",1638,248,63,30,1052,0,920,47,3998
"12099006912",3019,339,137,30,141,58,138,0,3862
"12099007002",3225,271,40,15,175,0,187,29,3942
"12099007005",3273,207,23,48,117,0,227,45,3940
"12099007006",3364,118,74,0,351,198,265,218,4588
"12099007007",3201,193,0,0,262,23,256,10,3945
"12099007008",3904,59,18,15,123,0,344,0,4463
"12099007009",3053,110,120,2,219,2,362,14,3882
"12099007010",1508,139,0,0,16,0,32,0,1695
"12099007011",2585,246,0,0,170,0,122,0,3123
"12099007100",10,110,0,61,0,20,0,41,242
"12099007201",4999,573,123,58,233,38,602,362,6988
"12099007202",2775,374,108,0,297,72,355,49,4030
"12099007203",2901,1676,601,209,150,172,521,599,6829
"12099007301",3054,235,222,91,275,29,540,48,4494
"12099007302",4073,405,233,15,343,74,507,92,5742
"12099007407",1434,41,22,0,9,0,0,0,1506
"12099007410",1445,76,0,7,31,0,99,0,1658
"12099007412",1142,87,0,0,32,0,69,4,1334
"12099007414",1821,233,17,0,5,0,49,0,2125
"12099007416",2515,203,100,0,74,0,160,9,3061
"12099007418",870,33,0,0,19,0,48,0,970
"12099007420",2371,275,0,0,161,12,52,0,2871
"12099007501",2262,307,438,118,139,12,405,101,3782
"12099007504",2626,176,65,45,43,0,120,15,3090
"12099007505",1840,180,168,54,21,0,172,36,2471
"12099007602",2375,574,383,237,697,41,950,106,5363
"12099007603",2109,28,0,11,160,0,253,0,2561
"12099007604",6263,366,0,1,10,70,650,97,7457
"12099007605",3337,317,36,67,130,65,292,23,4267
"12099007607",3944,645,392,0,242,79,595,72,5969
"12099007610",4034,146,112,119,91,17,634,44,5197
"12099007612",3958,540,296,0,291,46,1087,184,6402
"12099007613",2916,621,83,76,257,4,569,378,4904
"12099007614",3314,280,0,2,282,1,324,90,4293
"12099007615",2618,544,254,95,552,0,572,246,4881
"12099007616",2731,162,0,8,17,51,211,28,3208
"12099007617",1249,194,0,0,74,0,23,0,1540
"12099007618",4378,211,205,0,81,0,610,0,5485
"12099007705",3563,199,229,20,106,99,456,44,4716
"12099007710",3643,408,563,0,297,59,494,139,5603
"12099007713",9444,354,1008,13,770,6,1543,18,13156
"12099007716",3662,515,194,53,376,0,600,89,5489
"12099007721",4102,143,242,0,205,41,892,0,5625
"12099007723",1987,182,146,6,118,6,328,25,2798
"12099007724",4107,282,868,36,581,55,924,103,6956
"12099007725",4290,414,320,7,537,30,854,147,6599
"12099007730",5256,365,111,0,601,17,1022,0,7372
"12099007731",3692,245,373,0,556,10,598,10,5484
"12099007732",3667,911,503,23,281,173,1105,223,6886
"12099007733",2082,77,413,0,197,0,520,40,3329
"12099007734",1958,8,113,0,98,0,378,0,2555
"12099007735",5382,148,114,0,310,4,740,10,6708
"12099007736",3079,141,538,0,43,30,707,29,4567
"12099007738",3126,278,227,14,493,57,784,174,5153
"12099007739",2106,451,206,44,121,19,363,66,3376
"12099007740",3674,458,280,3,327,20,758,51,5571
"12099007741",3771,538,48,0,42,35,377,97,4908
"12099007742",4049,256,9,0,647,261,501,32,5755
"12099007743",4366,404,150,0,662,66,817,83,6548
"12099007744",2452,298,0,0,160,10,322,26,3268
"12099007746",763,87,26,0,0,26,15,36,953
"12099007747",2418,273,0,0,0,0,69,15,2775
"12099007748",3934,552,0,0,354,0,507,18,5365
"12099007749",4416,272,344,15,405,38,733,38,6261
"12099007750",2612,164,1165,0,147,0,1459,63,5610
"12099007751",3375,176,0,28,152,0,714,0,4445
"12099007752",4493,134,784,201,116,130,525,10,6393
"12099007753",6129,337,1009,0,340,2,1665,2,9484
"12099007754",3886,229,404,0,186,98,262,0,5065
"12099007756",3974,250,35,0,114,0,233,18,4624
"12099007757",3218,265,292,0,215,0,308,10,4308
"12099007758",3503,517,710,366,376,162,723,254,6611
"12099007759",1257,58,48,0,100,0,237,0,1700
"12099007760",2005,114,687,67,487,0,499,0,3859
"12099007762",1647,0,43,0,144,0,268,0,2102
"12099007763",3976,321,1696,604,465,113,1322,143,8640
"12099007764",1734,6,49,0,42,0,318,0,2149
"12099007765",5726,135,900,147,845,201,1454,30,9438
"12099007766",2491,576,180,136,297,6,311,235,4232
"12099007767",2543,161,394,168,415,16,799,19,4515
"12099007805",4433,355,288,0,141,0,722,0,5939
"12099007808",3888,461,577,56,302,0,796,49,6129
"12099007809",2583,277,155,0,297,6,245,113,3676
"12099007812",3633,650,876,161,422,20,1293,30,7085
"12099007813",3614,617,1329,231,969,18,1440,477,8695
"12099007814",2029,83,0,0,25,0,61,14,2212
"12099007817",5281,216,1683,63,327,131,1139,47,8887
"12099007818",882,117,26,23,65,0,41,6,1160
"12099007820",2084,259,186,25,34,0,373,22,2983
"12099007821",2300,97,206,7,61,14,228,41,2954
"12099007822",5391,485,227,0,112,0,137,324,6676
"12099007823",3583,169,123,0,118,63,350,13,4419
"12099007828",1264,79,126,0,41,0,230,5,1745
"12099007830",2997,39,262,0,120,0,198,18,3634
"12099007831",2572,271,128,0,552,13,412,20,3968
"12099007832",1586,196,241,181,47,7,400,102,2760
"12099007833",1080,318,1207,997,103,119,412,260,4496
"12099007834",1345,164,0,20,0,0,8,0,1537
"12099007835",3148,167,231,0,278,0,317,0,4141
"12099007836",4257,435,1073,0,598,23,1029,42,7457
"12099007837",4183,193,1040,0,330,0,606,97,6449
"12099007838",4738,326,1641,156,842,22,1167,0,8892
"12099007839",5109,166,425,226,489,7,844,46,7312
"12099007908",5851,591,1672,0,313,11,935,384,9757
"12099007909",3516,513,87,0,227,15,123,17,4498
"12099007910",4779,249,1109,132,713,0,1266,1,8249
"12099007912",6074,538,1146,247,279,0,986,83,9353
"12099008001",876,277,782,871,220,69,788,277,4160
"12099008002",1264,170,1551,1741,91,51,851,161,5880
"12099008101",3133,1005,1166,663,334,127,2474,1151,10053
"12099008102",41,27,0,27,0,0,0,13,108
"12099008201",271,59,1536,1731,9,8,221,40,3875
"12099008202",0,4,1229,1500,0,0,0,4,2737
"12099008203",1819,585,1787,880,170,41,1210,761,7253
"12099008301",240,73,632,444,93,0,333,88,1903
"12099008302",483,389,1244,575,109,24,445,426,3695
"12099980000",0,0,0,0,0,0,0,0,0
"12099980100",0,0,0,0,0,0,0,0,0
"12099980200",0,0,0,0,0,0,0,0,0
"12099980400",0,0,0,0,0,0,0,0,0
"12099980500",0,0,0,0,0,0,0,0,0
"12099990000",0,0,0,0,0,0,0,0,0
"12099990100",0,0,0,0,0,0,0,0,0
"12101030101",1693,343,9,0,26,34,141,130,2376
"12101030102",1913,675,45,43,64,39,176,159,3114
"12101030202",2198,674,36,30,64,53,155,119,3329
"12101030203",1350,419,48,0,0,59,94,18,1988
"12101030204",716,308,0,0,31,29,16,115,1215
"12101030205",1838,265,0,0,89,43,81,22,2338
"12101030301",1260,475,30,0,118,0,159,175,2217
"12101030302",1697,421,38,0,81,0,145,60,2442
"12101030303",2350,163,29,0,374,0,41,0,2957
"12101030404",2223,350,20,0,67,0,132,0,2792
"12101030405",1523,243,24,84,103,69,171,18,2235
"12101030406",1455,335,0,0,16,0,103,12,1921
"12101030407",1984,458,0,66,25,45,231,0,2809
"12101030408",1708,353,0,0,168,0,176,71,2476
"12101030409",2225,166,33,0,74,25,375,9,2907
"12101030410",1322,553,19,0,114,10,31,93,2142
"12101030411",2190,294,165,0,281,22,151,21,3124
"12101030412",1550,396,184,182,15,151,577,325,3380
"12101030501",1160,542,0,1,33,32,36,49,1853
"12101030502",3133,677,83,117,125,10,314,4,4463
"12101030601",1472,299,41,0,287,0,32,0,2131
"12101030602",1471,392,261,34,293,47,273,0,2771
"12101030700",2572,956,129,9,134,195,352,253,4600
"12101030800",2261,561,114,0,93,25,324,60,3438
"12101030901",2743,593,54,26,159,14,95,115,3799
"12101030903",1430,584,26,0,281,0,241,147,2709
"12101030904",1540,334,22,10,224,2,227,40,2399
"12101030905",2267,382,60,0,40,0,157,11,2917
"12101031003",3935,891,210,14,93,82,451,198,5874
"12101031005",2649,733,53,73,159,11,561,25,4264
"12101031006",1071,618,28,97,79,13,141,67,2114
"12101031007",2963,977,38,14,168,106,218,56,4540
"12101031008",1862,587,0,0,77,0,73,38,2637
"12101031009",2119,637,288,2,83,87,308,25,3549
"12101031010",3260,533,18,0,223,28,582,25,4669
"12101031011",2271,249,0,0,11,46,139,61,2777
"12101031012",3188,477,399,0,249,148,190,87,4738
"12101031013",2411,533,146,138,25,31,312,31,3627
"12101031014",2341,386,212,26,20,254,252,326,3817
"12101031101",3039,634,0,0,68,143,237,143,4264
"12101031102",5164,615,82,0,89,0,593,54,6597
"12101031203",2003,157,28,0,0,0,25,9,2222
"12101031204",2015,254,76,0,92,0,15,0,2452
"12101031205",3441,549,24,0,72,34,189,16,4325
"12101031206",2182,1072,0,0,120,15,297,66,3752
"12101031207",1970,404,0,0,0,0,30,22,2426
"12101031208",2382,382,83,7,126,7,310,0,3297
"12101031301",2856,133,27,5,148,0,86,27,3282
"12101031302",4626,304,13,0,236,8,425,54,5666
"12101031401",2436,1039,56,97,91,41,191,607,4558
"12101031404",2816,1024,62,75,149,81,405,62,4674
"12101031405",1448,629,26,51,96,20,200,64,2534
"12101031406",2124,444,0,3,55,234,322,132,3314
"12101031407",1932,308,0,1,71,42,108,53,2515
"12101031408",1573,289,9,49,34,0,15,20,1989
"12101031409",3651,521,270,39,366,135,237,58,5277
"12101031503",2341,340,22,21,312,0,114,0,3150
"12101031504",1678,65,21,0,65,0,5,0,1834
"12101031505",5078,585,30,3,138,18,438,36,6326
"12101031506",3333,600,88,0,259,0,264,0,4544
"12101031507",5339,290,124,0,199,0,339,25,6316
"12101031508",3565,205,130,141,269,22,188,51,4571
"12101031601",3473,73,39,0,53,15,191,0,3844
"12101031602",4920,494,227,9,357,0,637,0,6644
"12101031603",5316,159,656,0,964,14,2451,28,9588
"12101031604",4308,215,430,42,643,51,671,59,6419
"12101031605",2799,284,0,0,117,0,286,0,3486
"12101031701",1956,181,37,8,334,39,125,18,2698
"12101031703",3323,1341,42,32,115,57,66,26,5002
"12101031704",4647,296,42,0,120,0,363,0,5468
"12101031705",3431,375,79,0,326,0,228,10,4449
"12101031706",3200,66,48,8,21,0,146,8,3497
"12101031707",2968,255,27,0,127,0,352,0,3729
"12101031708",5081,232,140,32,61,17,545,0,6108
"12101031804",3269,569,0,1,52,0,57,80,4028
"12101031805",3044,812,6,0,9,0,127,141,4139
"12101031806",3606,664,0,0,41,0,196,0,4507
"12101031807",2347,862,13,13,19,0,14,12,3280
"12101031808",1689,622,0,0,41,7,120,73,2552
"12101031809",1847,513,21,21,36,49,96,9,2592
"12101031901",2428,152,0,0,78,0,149,3,2810
"12101031902",4973,247,54,0,219,22,464,0,5979
"12101031903",4141,343,470,13,497,0,1414,127,7005
"12101032001",4070,170,446,0,199,34,481,71,5471
"12101032005",3041,239,28,0,136,44,252,31,3771
"12101032006",5798,859,534,42,570,69,1511,134,9517
"12101032007",2640,199,37,0,101,0,520,26,3523
"12101032008",4322,135,113,37,269,18,864,21,5779
"12101032009",5961,284,404,0,496,51,1294,11,8501
"12101032010",2525,52,176,23,223,73,706,30,3808
"12101032011",4087,94,570,26,463,36,693,68,6037
"12101032012",2572,301,44,0,296,190,1211,36,4650
"12101032013",4099,425,173,0,265,0,1201,25,6188
"12101032014",5145,392,440,28,452,14,1170,211,7852
"12101032103",3097,513,850,33,576,55,967,114,6205
"12101032104",3185,209,319,56,572,8,944,105,5398
"12101032105",2474,74,703,202,521,153,692,47,4866
"12101032106",4924,152,851,48,599,35,988,96,7693
"12101032107",3073,45,544,17,715,20,1055,0,5469
"12101032108",3232,374,84,0,319,8,389,15,4421
"12101032109",1875,118,375,0,505,110,596,68,3647
"12101032110",2490,178,113,0,242,0,350,0,3373
"12101032111",2221,225,307,0,184,0,594,0,3531
"12101032112",2945,119,433,112,371,74,708,0,4762
"12101032113",2572,96,514,0,707,0,732,5,4626
"12101032200",3087,301,98,18,166,10,337,16,4033
"12101032300",2037,167,85,16,30,66,191,81,2673
"12101032401",1962,578,26,17,58,0,219,145,3005
"12101032402",1354,1072,174,111,235,73,444,734,4197
"12101032500",3851,540,203,289,286,309,1671,535,7684
"12101032601",1401,683,409,519,21,51,530,355,3969
"12101032602",1830,504,277,310,188,247,376,187,3919
"12101032700",1909,456,359,55,35,7,389,162,3372
"12101032801",1806,56,24,0,172,0,114,0,2172
"12101032802",2661,318,30,75,32,104,96,13,3329
"12101032803",1858,369,49,0,34,0,20,282,2612
"12101032804",1983,191,0,22,18,0,29,0,2243
"12101032901",3948,267,10,2,479,6,928,73,5713
"12101032902",1811,173,5,0,28,14,24,0,2055
"12101032903",3538,425,0,0,48,0,546,0,4557
"12101032904",1539,129,0,0,11,0,10,0,1689
"12101033005",4011,423,87,48,119,32,126,53,4899
"12101033006",1433,258,54,0,26,0,43,0,1814
"12101033007",1510,80,0,0,0,0,0,0,1590
"12101033008",1708,496,0,124,86,0,72,0,2486
"12101033009",2262,750,168,6,102,95,119,278,3780
"12101033010",3002,710,9,150,221,20,149,0,4261
"12101033011",1275,425,0,0,4,19,18,95,1836
"12101033012",1884,445,9,0,35,9,27,0,2409
"12101033013",2367,477,19,9,82,6,298,70,3328
"12101033014",3178,334,19,1,0,0,230,19,3781
"12101033101",1888,286,122,80,61,35,51,78,2601
"12101033102",826,417,41,0,15,0,142,32,1473
"12101990000",0,0,0,0,0,0,0,0,0
"12103020101",789,204,2608,1031,56,54,105,66,4913
"12103020105",2653,224,437,10,35,33,146,0,3538
"12103020106",2971,188,13,0,33,14,110,0,3329
"12103020107",1369,53,9,0,10,0,97,0,1538
"12103020108",1429,351,42,0,79,0,80,0,1981
"12103020201",1317,117,2886,261,129,86,248,39,5083
"12103020202",1453,160,1223,84,96,11,101,105,3233
"12103020206",574,277,2468,275,247,30,50,61,3982
"12103020207",1295,174,1015,65,24,0,122,25,2720
"12103020208",433,84,1268,462,12,0,74,11,2344
"12103020209",1134,74,1916,777,73,50,19,50,4093
"12103020301",848,103,1593,395,188,357,107,73,3664
"12103020302",1715,335,1226,319,158,35,297,31,4116
"12103020400",1185,256,488,443,113,4,113,13,2615
"12103020500",241,171,1869,965,108,50,50,51,3505
"12103020600",95,107,2398,1506,133,130,31,58,4458
"12103020700",32,55,2808,810,14,30,14,7,3770
"12103020800",278,123,2032,1859,46,87,35,65,4525
"12103021200",67,65,1976,1178,104,235,52,4,3681
"12103021500",1967,561,238,166,61,63,61,90,3207
"12103021600",655,389,169,481,4,28,99,173,1998
"12103021800",1379,235,446,558,61,0,27,4,2710
"12103021900",1261,201,1299,184,196,39,142,57,3379
"12103022000",365,98,1901,689,19,236,15,247,3570
"12103022100",2157,729,1300,353,348,20,343,37,5287
"12103022200",2061,460,850,320,265,8,170,202,4336
"12103022301",2300,106,60,95,90,3,366,4,3024
"12103022302",2740,356,109,7,20,61,202,49,3544
"12103022401",3156,243,19,2,147,13,149,11,3740
"12103022402",4408,459,120,0,120,0,355,0,5462
"12103022501",3762,970,283,244,203,0,617,49,6128
"12103022502",3057,186,97,2,274,34,522,36,4208
"12103022503",4396,316,19,261,653,0,168,0,5813
"12103022601",2530,177,71,18,155,0,126,41,3118
"12103022602",3563,241,53,52,388,46,261,66,4670
"12103022700",3118,375,103,0,253,100,316,9,4274
"12103022801",3255,581,212,70,282,198,897,144,5639
"12103022802",2296,86,136,0,797,38,251,0,3604
"12103022901",1541,308,461,71,204,165,161,0,2911
"12103022902",1482,180,218,28,469,118,428,0,2923
"12103023000",1603,292,0,64,496,45,81,0,2581
"12103023100",1697,348,63,36,157,160,74,11,2546
"12103023200",2386,418,129,24,47,0,183,30,3217
"12103023300",1427,356,146,144,129,82,111,138,2533
"12103023400",1062,420,44,65,174,30,157,41,1993
"12103023500",1900,588,178,207,146,27,245,99,3390
"12103023600",2388,549,13,66,50,0,26,0,3092
"12103023700",2254,262,48,0,221,0,130,0,2915
"12103023800",2259,215,69,9,81,17,123,25,2798
"12103023900",1393,150,9,0,61,44,110,13,1780
"12103024001",3252,86,70,0,40,0,79,0,3527
"12103024002",4694,276,127,0,439,29,417,0,5982
"12103024004",4856,149,12,0,247,0,204,0,5468
"12103024005",2610,114,11,0,124,10,278,0,3147
"12103024100",3317,538,82,342,15,0,224,43,4561
"12103024200",3770,671,126,74,250,112,232,45,5280
"12103024301",3172,186,66,19,307,199,92,21,4062
"12103024302",3843,359,332,56,448,35,275,31,5379
"12103024403",3152,339,23,216,299,44,177,16,4266
"12103024406",2929,454,656,234,177,252,176,51,4929
"12103024408",2916,366,256,406,308,52,656,158,5118
"12103024409",2999,75,0,0,75,0,237,0,3386
"12103024410",2573,565,232,56,166,12,756,0,4360
"12103024411",3186,260,60,0,150,81,320,0,4057
"12103024412",2339,176,244,21,271,17,290,86,3444
"12103024413",3468,724,107,0,388,0,185,46,4918
"12103024505",5354,871,156,16,676,194,465,370,8102
"12103024507",2519,409,0,60,279,86,109,0,3462
"12103024508",3305,926,683,101,406,63,681,657,6822
"12103024509",2621,164,9,0,370,0,169,62,3395
"12103024510",1198,763,250,45,214,157,631,526,3784
"12103024511",4894,413,1100,116,841,55,353,0,7772
"12103024512",2080,379,7,22,446,0,377,18,3329
"12103024513",3152,208,109,46,30,0,192,68,3805
"12103024514",2701,789,282,122,291,68,466,276,4995
"12103024601",2531,485,64,152,419,64,172,41,3928
"12103024602",2831,1089,348,656,162,7,336,202,5631
"12103024701",2046,784,96,18,160,124,187,55,3470
"12103024702",1319,501,37,51,122,141,271,115,2557
"12103024703",1496,575,459,42,384,56,121,36,3169
"12103024801",3439,592,7,9,405,130,233,30,4845
"12103024803",1872,333,36,46,208,12,247,146,2900
"12103024804",1115,265,57,14,344,91,177,90,2153
"12103024805",1801,284,265,0,230,150,193,154,3077
"12103024901",3924,425,191,4,640,0,515,23,5722
"12103024902",3522,1188,232,41,832,72,556,395,6838
"12103024904",2962,287,205,72,386,53,425,138,4528
"12103024905",4650,729,160,0,1081,239,380,600,7839
"12103024906",2691,413,158,49,149,76,404,11,3951
"12103025004",4293,713,98,27,570,60,642,11,6414
"12103025007",3326,490,32,3,259,78,206,29,4423
"12103025009",2982,361,141,79,390,31,356,55,4395
"12103025010",3650,739,61,128,356,0,141,410,5485
"12103025011",4392,296,58,1,353,54,249,127,5530
"12103025012",4198,754,17,195,227,0,118,32,5541
"12103025013",3288,355,0,300,185,37,221,0,4386
"12103025014",3645,288,9,0,578,40,310,74,4944
"12103025015",2223,162,0,3,90,33,69,8,2588
"12103025016",1335,105,18,49,167,29,93,0,1796
"12103025017",2005,390,51,29,97,0,277,0,2849
"12103025018",1323,454,117,118,520,63,226,254,3075
"12103025019",1369,457,0,42,95,5,0,0,1968
"12103025106",2034,208,0,10,139,0,154,0,2545
"12103025107",3085,363,16,1,163,0,55,0,3683
"12103025108",1684,246,12,0,50,0,39,0,2031
"12103025109",3038,447,37,2,78,10,148,10,3770
"12103025110",5295,562,70,0,248,53,509,36,6773
"12103025111",2246,81,25,15,61,0,25,0,2453
"12103025112",2835,358,140,53,121,0,108,29,3644
"12103025113",2540,218,4,2,49,0,279,4,3096
"12103025114",2642,182,0,0,129,4,60,38,3055
"12103025115",2561,461,14,146,218,41,252,24,3717
"12103025116",1601,204,50,23,16,0,198,74,2166
"12103025119",4776,655,218,0,137,52,185,17,6040
"12103025120",3326,102,63,3,120,0,79,2,3695
"12103025121",3996,182,33,12,336,6,205,0,4770
"12103025122",4428,146,38,0,415,0,298,0,5325
"12103025123",1729,244,32,0,24,0,28,0,2057
"12103025203",4912,492,71,16,48,0,110,21,5670
"12103025204",2555,394,20,11,77,33,151,5,3246
"12103025205",3255,371,33,0,235,10,50,0,3954
"12103025207",4297,617,971,233,567,35,325,221,7266
"12103025208",1172,172,0,83,28,6,38,0,1499
"12103025209",3929,305,178,79,54,8,580,5,5138
"12103025303",3060,582,417,0,264,52,300,59,4734
"12103025304",2821,257,70,7,120,0,161,71,3507
"12103025305",1925,431,125,34,105,31,197,60,2908
"12103025306",1060,146,125,0,82,0,155,0,1568
"12103025307",2337,169,1167,405,163,109,217,3,4570
"12103025308",2000,145,136,0,80,0,92,22,2475
"12103025401",3779,295,66,2,122,47,270,59,4640
"12103025405",3307,411,144,0,104,165,189,108,4428
"12103025407",3978,328,142,19,284,0,430,0,5181
"12103025408",4255,1577,115,211,278,22,488,303,7249
"12103025411",1092,274,172,96,126,109,245,90,2204
"12103025412",3751,212,0,5,282,30,243,73,4596
"12103025413",2638,580,37,0,194,0,195,144,3788
"12103025414",1824,336,226,114,303,0,68,106,2977
"12103025415",2544,395,104,49,318,15,439,118,3982
"12103025416",2433,622,9,23,190,113,422,55,3867
"12103025417",1907,477,0,96,97,0,63,0,2640
"12103025501",3822,297,21,0,92,17,402,48,4699
"12103025503",3380,252,161,26,241,27,268,0,4355
"12103025505",1034,562,132,165,11,45,486,318,2753
"12103025506",3705,759,341,2,745,141,358,150,6201
"12103025602",2118,749,101,0,236,0,355,75,3634
"12103025603",1936,316,61,44,78,26,134,80,2675
"12103025604",899,203,165,0,147,15,83,15,1527
"12103025700",3507,137,28,0,107,0,173,0,3952
"12103025800",1889,472,601,647,95,71,224,124,4123
"12103025900",2426,640,372,631,66,281,327,29,4772
"12103026001",2785,287,22,0,22,0,72,0,3188
"12103026002",2218,279,0,0,352,0,102,31,2982
"12103026101",918,400,699,110,115,120,170,87,2619
"12103026102",969,195,2,54,30,11,10,10,1281
"12103026200",108,197,843,653,32,40,57,70,2000
"12103026300",3001,959,971,1258,133,160,348,414,7244
"12103026400",4174,1126,463,251,392,145,1743,735,9029
"12103026500",4537,840,266,509,379,223,449,215,7418
"12103026601",2876,109,54,2,74,0,346,15,3476
"12103026602",2392,565,282,212,107,8,451,281,4298
"12103026701",3353,622,245,286,73,0,391,86,5056
"12103026702",5756,298,216,44,400,70,577,18,7379
"12103026703",4146,623,503,93,626,163,906,163,7223
"12103026804",4186,486,191,46,239,89,816,216,6269
"12103026809",2496,80,73,0,55,28,261,0,2993
"12103026811",5909,204,0,0,266,0,119,1,6499
"12103026812",4276,136,0,0,193,0,192,0,4797
"12103026813",3160,283,31,3,75,199,682,373,4806
"12103026814",2060,123,0,109,35,0,122,2,2451
"12103026815",4189,320,35,0,390,0,156,2,5092
"12103026816",3915,611,219,66,386,47,245,109,5598
"12103026817",3953,313,129,41,319,25,130,51,4961
"12103026818",1842,413,311,354,440,260,533,136,4289
"12103026819",1356,79,139,5,89,15,293,0,1976
"12103026820",3516,326,158,0,88,84,482,0,4654
"12103026821",2540,237,158,2,51,1,349,44,3382
"12103026904",4924,441,38,11,93,12,656,0,6175
"12103026907",5448,348,71,0,76,41,491,21,6496
"12103026908",3711,182,45,9,154,0,107,0,4208
"12103026909",4736,219,48,1,38,0,201,22,5265
"12103026910",4008,205,267,2,349,82,474,102,5489
"12103026911",3299,210,0,4,176,0,528,0,4217
"12103026912",2377,726,206,33,290,91,189,382,4294
"12103026913",2561,366,204,0,30,18,190,26,3395
"12103027000",3499,478,23,92,180,157,363,227,5019
"12103027101",2161,743,118,80,142,117,64,16,3441
"12103027105",3250,81,66,9,49,0,74,0,3529
"12103027106",3608,234,11,0,78,0,46,1,3978
"12103027202",5515,286,0,2,244,0,285,2,6334
"12103027204",3537,395,10,2,24,10,130,12,4120
"12103027205",5631,651,136,0,355,0,695,103,7571
"12103027206",6221,256,14,0,302,0,440,29,7262
"12103027207",4003,534,36,0,185,19,222,78,5077
"12103027208",5680,492,0,0,373,18,400,173,7136
"12103027209",934,65,0,0,5,11,35,0,1050
"12103027210",3901,372,0,0,114,0,328,0,4715
"12103027308",2955,465,114,0,135,23,251,29,3972
"12103027309",1610,159,7,17,89,0,49,7,1938
"12103027310",8132,268,22,43,529,12,640,2,9648
"12103027314",2580,515,189,75,127,10,77,10,3583
"12103027315",4161,525,54,0,56,36,52,0,4884
"12103027316",3775,169,0,0,70,0,137,0,4151
"12103027317",4438,213,56,68,60,4,410,0,5249
"12103027318",3564,303,42,0,193,75,317,31,4525
"12103027319",3852,325,129,0,648,0,441,37,5432
"12103027320",3392,379,154,88,232,35,683,107,5070
"12103027321",1398,135,0,9,37,0,150,0,1729
"12103027322",5529,523,104,0,368,0,335,0,6859
"12103027323",2193,140,0,0,204,38,385,119,3079
"12103027324",3651,245,29,43,176,43,135,0,4322
"12103027325",3328,152,0,0,281,25,136,0,3922
"12103027326",2587,367,0,0,225,0,207,76,3462
"12103027327",2903,436,205,328,651,104,170,198,4995
"12103027401",1970,330,130,237,12,57,84,17,2837
"12103027402",3784,672,319,490,264,151,391,223,6294
"12103027403",1319,314,29,3,75,4,69,31,1844
"12103027501",5358,318,19,19,43,0,236,0,5993
"12103027502",4885,733,0,3,340,16,147,16,6140
"12103027603",2274,60,0,0,111,61,102,36,2644
"12103027604",2465,177,0,0,69,13,128,13,2865
"12103027605",1421,90,0,0,27,0,50,0,1588
"12103027606",1452,130,16,0,43,0,23,0,1664
"12103027701",2430,195,11,0,59,31,97,31,2854
"12103027703",964,119,0,0,22,0,54,0,1159
"12103027704",1935,249,6,0,72,0,113,19,2394
"12103027801",1102,296,17,0,10,0,78,23,1526
"12103027802",2496,270,0,0,0,0,152,0,2918
"12103027901",1699,283,0,0,217,12,109,12,2332
"12103027903",1234,103,0,0,5,0,62,0,1404
"12103027904",2807,372,0,0,9,0,44,21,3253
"12103028002",3919,143,0,0,104,15,65,12,4258
"12103028003",2677,418,46,0,31,9,66,0,3247
"12103028004",1600,261,0,24,8,21,48,24,1986
"12103028102",2538,368,46,0,422,16,124,27,3541
"12103028103",1491,142,0,0,20,0,95,0,1748
"12103028104",2633,213,0,0,142,0,74,14,3076
"12103028200",1838,301,35,45,40,43,209,24,2535
"12103028300",2241,407,270,289,96,35,103,109,3550
"12103028401",1229,161,13,0,8,0,22,24,1457
"12103028402",1037,118,17,6,0,0,16,0,1194
"12103028500",1217,367,256,63,61,31,72,47,2114
"12103028600",1857,536,274,151,203,12,392,50,3475
"12103028700",99,25,1390,865,40,0,31,0,2450
"12103990000",0,0,0,0,0,0,0,0,0
"12103990100",0,0,0,0,0,0,0,0,0
"12105010300",2201,657,575,316,272,253,617,451,5342
"12105010401",1210,236,60,40,16,0,75,0,1637
"12105010402",2195,571,246,189,152,0,166,0,3519
"12105010501",1341,232,49,0,34,0,213,0,1869
"12105010502",3588,323,5,34,12,64,236,241,4503
"12105010601",3087,338,131,25,69,103,499,90,4342
"12105010603",2795,189,11,0,317,0,226,2,3540
"12105010604",2561,270,298,0,75,15,187,0,3406
"12105010701",2928,526,316,97,113,0,207,64,4251
"12105010702",2690,105,171,8,37,14,259,21,3305
"12105010800",1907,818,414,349,99,217,731,470,5005
"12105010900",2402,714,588,412,135,247,792,314,5604
"12105011000",1006,496,1048,250,35,8,167,193,3203
"12105011100",556,801,1134,511,41,4,279,265,3591
"12105011202",0,145,1342,583,34,25,51,69,2249
"12105011203",249,449,1821,1050,332,72,167,408,4548
"12105011204",86,6,633,403,222,4,25,4,1383
"12105011300",849,101,170,262,380,164,373,158,2457
"12105011400",2140,648,527,281,341,72,682,109,4800
"12105011501",3694,1142,242,337,449,57,250,52,6223
"12105011502",3678,566,554,62,157,25,928,269,6239
"12105011603",1832,224,51,43,81,0,99,0,2330
"12105011604",3586,390,62,274,326,44,395,56,5133
"12105011605",2545,260,181,261,38,0,44,25,3354
"12105011606",1616,105,170,6,43,8,188,8,2144
"12105011704",2012,1284,428,391,280,217,566,873,6051
"12105011721",2243,1051,24,8,117,0,477,12,3932
"12105011722",2382,527,0,7,59,12,205,103,3295
"12105011731",2149,498,699,162,110,71,511,298,4498
"12105011732",1558,393,474,333,439,128,442,263,4030
"12105011821",2817,36,111,0,125,37,280,2,3408
"12105011822",3173,183,108,0,332,101,222,155,4274
"12105011832",3045,537,518,74,99,0,649,130,5052
"12105011833",6076,476,273,3,852,70,1258,302,9310
"12105011834",4858,440,409,23,432,0,524,0,6686
"12105011835",4021,237,76,0,81,0,676,46,5137
"12105011836",2896,74,63,0,173,23,341,8,3578
"12105011901",3063,534,170,180,222,0,658,126,4953
"12105011902",2010,372,165,34,135,2,437,2,3157
"12105011908",2700,112,283,0,191,63,393,0,3742
"12105011909",2729,88,38,0,33,0,174,0,3062
"12105011910",1495,252,37,6,6,5,418,62,2281
"12105011911",2492,15,78,46,122,22,574,22,3371
"12105011912",1407,62,183,11,94,0,120,0,1877
"12105011913",1699,260,345,62,40,0,592,137,3135
"12105012001",2972,1292,1273,344,157,75,386,580,7079
"12105012002",1537,372,421,201,173,0,214,0,2918
"12105012003",4589,831,62,86,126,0,658,125,6477
"12105012004",1728,123,167,9,23,164,120,178,2512
"12105012111",5622,293,33,0,312,0,123,10,6393
"12105012113",5200,410,386,0,51,45,494,36,6622
"12105012124",3584,658,653,119,265,169,438,288,6174
"12105012125",1993,801,12,0,14,175,188,10,3193
"12105012126",2074,68,514,0,446,24,981,0,4107
"12105012127",4662,588,562,37,377,13,646,286,7171
"12105012128",3053,160,960,30,678,125,935,0,5941
"12105012129",5055,703,1353,0,209,15,904,197,8436
"12105012203",1949,195,125,13,71,38,165,128,2684
"12105012204",4307,768,708,16,240,60,506,88,6693
"12105012205",682,209,65,57,177,55,86,7,1338
"12105012206",3633,613,573,94,29,0,529,0,5471
"12105012303",2482,503,214,0,263,0,56,0,3518
"12105012304",4632,167,307,0,239,0,286,0,5631
"12105012305",1118,520,0,0,97,17,66,99,1917
"12105012306",2184,279,0,88,50,0,179,140,2920
"12105012307",2321,334,28,0,201,141,81,41,3147
"12105012309",1132,285,0,0,57,34,14,34,1556
"12105012403",6140,851,677,250,1808,175,2724,367,12992
"12105012404",532,34,273,0,137,7,26,0,1009
"12105012405",4200,632,194,0,661,39,1216,334,7276
"12105012406",3787,237,149,0,94,88,641,0,4996
"12105012407",951,149,121,16,7,7,64,0,1315
"12105012408",1937,850,219,0,75,0,117,237,3435
"12105012409",973,248,386,11,27,0,40,0,1685
"12105012410",1597,132,580,294,155,0,824,77,3659
"12105012411",3481,705,600,74,127,123,1372,323,6805
"12105012502",3862,994,447,84,464,422,1444,750,8467
"12105012503",9628,849,1182,1187,1858,258,6423,909,22294
"12105012504",3134,876,365,427,68,12,503,733,6118
"12105012506",3923,407,404,53,415,226,1082,227,6737
"12105012507",3856,296,79,13,583,143,1065,28,6063
"12105012601",1398,100,1259,473,128,127,580,0,4065
"12105012602",2394,2447,623,255,619,108,2522,1844,10812
"12105012700",4321,1000,635,259,480,349,2518,1130,10692
"12105012802",1728,381,482,274,94,64,289,97,3409
"12105012803",3323,215,0,0,36,0,112,0,3686
"12105012804",2945,377,425,44,403,15,505,76,4790
"12105012900",2648,1272,515,430,66,163,148,825,6067
"12105013001",2145,203,375,60,12,0,318,57,3170
"12105013002",3052,1018,142,242,60,0,603,197,5314
"12105013101",3630,125,128,0,140,18,162,0,4203
"12105013102",2182,674,65,157,145,0,230,336,3789
"12105013103",673,275,0,0,15,11,174,156,1304
"12105013200",770,349,389,188,62,0,133,175,2066
"12105013300",843,632,385,428,34,81,91,79,2573
"12105013400",2754,828,590,397,192,84,341,106,5292
"12105013500",2432,543,238,31,129,52,361,58,3844
"12105013600",1556,373,1786,1957,80,52,654,39,6497
"12105013701",801,247,116,274,27,39,108,32,1644
"12105013702",2769,142,1812,470,128,11,624,0,5956
"12105013801",1795,725,547,68,112,6,31,442,3726
"12105013802",3705,555,1139,862,463,0,762,246,7732
"12105013901",1149,329,833,216,16,54,120,105,2822
"12105013902",3619,328,65,1,102,247,319,135,4816
"12105014001",4057,877,402,14,70,0,357,490,6267
"12105014003",2026,258,417,380,38,17,17,75,3228
"12105014005",2943,302,49,26,226,26,172,34,3778
"12105014006",2012,301,255,0,176,0,63,216,3023
"12105014103",4184,1672,2434,1511,445,78,3425,1223,14972
"12105014104",276,40,0,0,10,53,5,5,389
"12105014105",5135,1090,332,0,276,41,1901,444,9219
"12105014121",1097,475,107,8,178,57,335,223,2480
"12105014123",4763,391,152,91,166,0,774,54,6391
"12105014124",1370,147,273,255,19,0,59,58,2181
"12105014125",2894,757,1288,249,346,172,575,145,6426
"12105014201",4370,483,578,265,143,112,573,73,6597
"12105014202",2074,115,122,0,196,0,359,11,2877
"12105014203",2335,262,0,19,31,19,91,0,2757
"12105014301",104,115,647,571,17,8,50,106,1618
"12105014302",3692,264,812,388,210,160,928,137,6591
"12105014400",5364,565,818,252,327,83,865,166,8440
"12105014501",4990,1407,208,107,568,0,1623,842,9745
"12105014502",1940,1489,0,0,27,20,1013,881,5370
"12105014600",2588,1254,281,28,240,12,926,841,6170
"12105014701",2997,604,89,96,174,0,219,139,4318
"12105014702",5799,162,1204,73,275,0,322,0,7835
"12105014802",1359,224,455,196,181,323,435,169,3342
"12105014803",1853,0,53,4,47,0,115,0,2072
"12105014804",5366,717,447,29,495,0,601,2,7657
"12105014901",7642,698,524,0,398,0,1980,202,11444
"12105014902",4823,1219,123,0,379,210,1903,849,9506
"12105015000",2484,720,1075,247,280,90,393,139,5428
"12105015101",2331,563,170,0,15,0,237,67,3383
"12105015102",2011,386,0,0,0,0,114,2,2513
"12105015200",1311,544,1331,1083,304,3,412,7,4995
"12105015301",2330,618,823,215,217,30,633,236,5102
"12105015302",1443,809,0,0,5,0,15,351,2623
"12105015401",1601,234,419,231,45,36,347,0,2913
"12105015402",2032,346,169,8,69,155,90,98,2967
"12105015404",874,85,0,10,0,0,2,10,981
"12105015405",1708,244,101,30,122,31,303,40,2579
"12105015500",1947,1339,182,563,56,69,556,744,5456
"12105015600",2276,303,41,0,6,8,113,96,2843
"12105015701",1446,330,448,142,153,0,136,0,2655
"12105015702",1979,471,144,30,181,11,189,7,3012
"12105015801",1846,181,0,10,26,0,85,50,2198
"12105015802",1306,1186,31,6,43,119,457,960,4108
"12105015900",1596,444,92,46,34,0,500,122,2834
"12105016001",1715,160,68,71,135,7,405,26,2587
"12105016002",814,294,600,61,77,24,448,114,2432
"12105016003",2207,502,58,16,207,21,613,247,3871
"12105016100",556,43,209,94,79,0,58,11,1050
"12105016400",325,567,436,452,85,32,73,103,2073
"12105980000",0,33,0,0,0,0,0,24,57
"12107950100",3140,872,90,0,33,69,50,0,4254
"12107950201",3517,1157,197,85,122,30,153,26,5287
"12107950202",2053,472,0,0,316,0,59,0,2900
"12107950300",4631,952,369,88,46,79,275,126,6566
"12107950400",2627,425,213,66,32,14,82,0,3459
"12107950500",4799,1402,333,74,56,25,374,270,7333
"12107950600",3336,1528,660,249,26,143,35,271,6248
"12107950700",1062,302,1189,1638,82,0,132,123,4528
"12107950800",700,249,866,742,30,46,85,0,2718
"12107950900",2705,631,1241,914,93,17,194,25,5820
"12107951000",2708,483,310,32,40,0,133,14,3720
"12107951100",3312,788,209,5,268,93,126,203,5004
"12107951200",3724,1210,31,130,194,30,300,215,5834
"12107951300",2459,506,354,234,497,225,543,237,5055
"12107951401",1231,560,532,346,520,302,637,486,4614
"12107951402",1701,974,19,351,390,517,399,1141,5492
"12107980000",0,0,0,0,0,0,0,0,0
"12109020200",1740,498,0,3,40,35,76,0,2392
"12109020300",2441,477,520,640,188,52,274,99,4691
"12109020400",1044,674,444,19,35,7,56,73,2352
"12109020500",2956,510,0,16,94,0,12,8,3596
"12109020601",4721,508,0,4,32,0,108,0,5373
"12109020602",8388,758,238,0,594,57,316,0,10351
"12109020704",3322,53,0,0,134,0,52,0,3561
"12109020705",5454,316,206,45,93,0,248,27,6389
"12109020706",2594,41,0,0,338,0,21,0,2994
"12109020707",4029,381,69,57,334,53,521,40,5484
"12109020708",2250,296,62,0,50,0,107,0,2765
"12109020710",2411,41,0,0,53,0,101,0,2606
"12109020711",4485,266,36,0,208,0,49,0,5044
"12109020801",6434,146,488,0,498,271,599,34,8470
"12109020802",3830,41,16,0,167,0,472,0,4526
"12109020803",3947,132,0,22,62,33,30,15,4241
"12109020804",2242,412,154,27,167,0,157,8,3167
"12109020805",10821,199,471,0,998,0,565,0,13054
"12109020806",4548,257,98,8,627,0,225,1,5764
"12109020807",1505,15,0,0,102,0,0,0,1622
"12109020901",5376,970,247,0,486,35,451,38,7603
"12109020902",22172,1051,1101,134,2261,60,2435,20,29234
"12109021002",2358,388,998,532,82,64,332,61,4815
"12109021003",2420,591,994,141,136,45,194,0,4521
"12109021004",2444,95,112,0,46,0,3,0,2700
"12109021101",3483,454,333,364,116,14,232,102,5098
"12109021102",3966,618,95,323,161,14,118,40,5335
"12109021103",1123,358,0,0,0,21,82,21,1605
"12109021203",5350,1033,222,1,247,1,312,111,7277
"12109021204",757,85,3,4,112,0,155,19,1135
"12109021205",959,154,0,0,89,0,84,0,1286
"12109021206",5239,612,92,10,101,0,115,38,6207
"12109021301",4652,1013,158,108,208,9,233,68,6449
"12109021302",4742,461,119,11,112,53,479,42,6019
"12109021403",2068,252,0,0,14,0,15,0,2349
"12109021404",3284,42,0,0,19,0,188,0,3533
"12109021405",4424,543,26,0,109,0,149,0,5251
"12109021406",4129,554,13,0,183,19,268,0,5166
"12109021407",1202,99,0,26,3,16,0,0,1346
"12109990100",0,0,0,0,0,0,0,0,0
"12109990200",0,0,0,0,0,0,0,0,0
"12111380100",252,209,69,182,14,6,19,33,784
"12111380200",164,226,1061,1495,7,27,150,68,3198
"12111380300",175,192,2152,3268,0,0,21,66,5874
"12111380400",1859,1309,953,1196,428,129,1152,844,7870
"12111380500",2547,870,1071,1157,109,86,1064,719,7623
"12111380600",2281,369,347,661,648,14,1237,14,5571
"12111380700",4672,597,1373,826,169,259,1327,453,9676
"12111380800",1402,434,262,18,112,9,103,17,2357
"12111380901",432,679,947,219,8,0,0,331,2616
"12111380902",759,320,2923,1257,168,89,418,165,6099
"12111381000",678,121,278,84,10,3,33,5,1212
"12111381101",5619,646,628,96,126,41,448,1,7605
"12111381102",2991,436,271,5,335,0,261,2,4301
"12111381204",2558,219,0,0,28,8,51,42,2906
"12111381300",3025,323,104,17,144,0,240,133,3986
"12111381401",4093,465,430,209,53,25,823,97,6195
"12111381402",3600,1082,838,307,38,147,757,586,7355
"12111381502",7588,1027,1465,374,907,86,1181,495,13123
"12111381503",6167,1199,1169,542,985,22,1392,317,11793
"12111381601",4926,415,1,0,209,87,142,80,5860
"12111381602",2490,270,110,43,303,8,351,59,3634
"12111381603",4906,269,339,66,122,263,364,255,6584
"12111381701",2965,150,0,0,0,0,92,11,3218
"12111381702",1868,160,0,0,6,0,26,0,2060
"12111381802",1889,724,385,462,468,23,591,250,4792
"12111381803",4125,434,685,0,219,0,592,136,6191
"12111381804",3687,495,575,9,207,64,478,92,5607
"12111381900",5410,545,23,0,835,41,805,33,7692
"12111382002",4348,1644,965,159,594,933,1262,814,10719
"12111382003",6744,981,1215,258,436,125,1445,431,11635
"12111382006",5210,986,926,87,404,35,641,440,8729
"12111382007",2899,260,360,394,465,467,800,103,5748
"12111382008",4143,563,1121,41,746,50,1536,236,8436
"12111382009",2689,371,554,339,217,64,599,132,4965
"12111382010",1825,220,137,16,36,0,124,27,2385
"12111382106",13976,1642,2739,260,1766,659,4094,1077,26213
"12111382108",14351,1490,2165,981,1207,601,2385,620,23800
"12111382109",7329,876,898,135,577,0,851,247,10913
"12111382110",3980,309,1145,54,577,237,769,338,7409
"12111382111",9025,1423,1685,495,1042,288,1960,1000,16918
"12111382112",3744,1612,1235,1,556,31,590,1009,8778
"12111382113",6511,1697,2018,522,915,1112,1034,2040,15849
"12111382200",4525,557,88,45,428,33,718,201,6595
"12111980000",0,0,0,0,0,0,0,0,0
"12111990000",0,0,0,0,0,0,0,0,0
"12113010100",2805,306,0,9,116,13,5,2,3256
"12113010200",3242,529,0,12,79,10,32,0,3904
"12113010300",9252,288,27,9,581,8,446,21,10632
"12113010400",1910,314,12,31,164,0,68,10,2509
"12113010502",5447,1029,298,339,273,38,194,24,7642
"12113010503",4511,326,145,113,615,34,152,36,5932
"12113010504",3629,398,112,56,139,20,110,0,4464
"12113010600",3144,841,848,238,628,63,208,66,6036
"12113010702",5311,612,256,156,656,78,231,5,7305
"12113010704",4583,516,363,0,343,58,111,70,6044
"12113010705",1821,340,16,0,444,343,74,168,3206
"12113010706",5723,1234,299,58,531,52,191,0,8088
"12113010707",4059,509,0,0,177,9,50,0,4804
"12113010708",4273,304,135,0,547,15,491,0,5765
"12113010802",3776,395,200,0,194,26,128,109,4828
"12113010808",3075,719,0,6,332,261,228,115,4736
"12113010809",2965,1349,274,61,79,286,50,111,5175
"12113010811",9864,973,853,0,1534,126,613,120,14083
"12113010812",3882,303,0,0,177,0,79,0,4441
"12113010813",4278,422,25,0,218,270,77,251,5541
"12113010814",5309,317,50,0,375,9,209,0,6269
"12113010815",6353,957,145,8,265,62,252,9,8051
"12113010817",4551,394,121,0,176,35,602,0,5879
"12113010819",8442,1487,1177,159,758,300,846,278,13447
"12113010900",5399,306,49,7,163,0,113,0,6037
"12113990000",0,0,0,0,0,0,0,0,0
"12115000101",2890,369,13,165,85,0,55,23,3600
"12115000102",2097,752,130,62,11,0,519,356,3927
"12115000200",1807,655,472,702,175,250,403,579,5043
"12115000300",45,260,1721,1422,18,339,36,100,3941
"12115000401",3215,391,302,94,105,0,913,136,5156
"12115000404",1117,140,35,2,105,0,61,11,1471
"12115000405",2564,883,80,30,61,0,480,444,4542
"12115000406",2211,771,184,27,0,25,366,590,4174
"12115000407",2684,602,208,62,314,81,1101,454,5506
"12115000501",1300,209,0,0,88,9,166,0,1772
"12115000502",2342,864,120,31,200,279,375,671,4882
"12115000503",2767,526,16,62,106,22,243,44,3786
"12115000601",1579,440,0,0,80,10,33,0,2142
"12115000602",3262,381,11,0,161,36,41,64,3956
"12115000700",2565,153,32,0,43,0,58,0,2851
"12115000801",1726,82,0,0,89,0,54,0,1951
"12115000802",2436,191,0,0,13,0,42,0,2682
"12115000900",1845,274,143,99,76,52,114,50,2653
"12115001000",2131,193,212,170,179,0,346,7,3238
"12115001101",2369,547,280,461,136,12,328,271,4404
"12115001102",2964,626,599,376,141,182,1309,64,6261
"12115001201",6029,747,192,0,316,165,716,423,8588
"12115001202",2533,706,280,63,286,114,983,588,5553
"12115001203",3479,140,129,0,0,0,113,0,3861
"12115001204",3346,445,71,20,37,19,168,121,4227
"12115001301",2347,84,37,10,130,6,281,6,2901
"12115001302",3437,631,15,0,98,0,342,111,4634
"12115001303",2791,84,0,0,187,52,71,0,3185
"12115001304",1555,189,13,9,22,0,124,0,1912
"12115001401",7221,286,15,32,284,25,174,0,8037
"12115001402",4368,247,190,22,37,0,480,50,5394
"12115001403",5296,532,31,0,69,0,269,114,6311
"12115001503",2957,465,168,0,54,0,346,0,3990
"12115001504",2706,108,25,0,139,128,736,29,3871
"12115001505",3648,398,65,11,202,79,338,213,4954
"12115001506",4877,394,34,0,104,20,372,30,5831
"12115001507",5180,695,268,0,360,121,536,209,7369
"12115001601",3052,418,0,0,97,9,168,3,3747
"12115001602",3019,299,0,2,106,7,376,0,3809
"12115001702",5206,367,17,27,96,23,317,0,6053
"12115001703",2869,500,33,0,4,0,392,142,3940
"12115001704",2191,306,265,11,15,105,162,0,3055
"12115001801",3037,417,0,34,91,6,50,24,3659
"12115001803",1979,424,72,43,63,41,295,60,2977
"12115001804",1864,165,33,23,139,0,253,10,2487
"12115001805",1294,201,22,0,56,0,88,8,1669
"12115001903",1766,180,0,0,20,0,77,0,2043
"12115001904",2991,238,14,0,121,0,113,0,3477
"12115001905",1085,75,7,0,18,0,16,0,1201
"12115001907",986,22,0,0,68,0,0,0,1076
"12115001908",840,52,0,0,51,0,19,0,962
"12115002003",3197,595,77,76,235,49,230,58,4517
"12115002004",3164,418,0,0,75,11,177,9,3854
"12115002005",3464,451,0,0,93,0,213,0,4221
"12115002007",1984,165,27,0,74,0,45,0,2295
"12115002008",2514,145,0,0,17,0,64,0,2740
"12115002009",5348,525,215,0,541,0,305,21,6955
"12115002010",4942,341,0,26,34,0,137,0,5480
"12115002100",5483,427,0,0,242,29,188,0,6369
"12115002201",2721,199,0,0,181,5,76,0,3182
"12115002202",4001,223,0,0,29,0,0,17,4270
"12115002203",2992,578,58,3,244,38,14,0,3927
"12115002302",3436,268,12,0,70,0,28,0,3814
"12115002303",4186,286,15,0,19,58,14,76,4654
"12115002304",2354,236,10,16,26,0,110,31,2783
"12115002305",1375,151,0,0,15,0,82,0,1623
"12115002401",2561,151,1,0,10,11,16,0,2750
"12115002402",2749,350,0,0,187,50,172,14,3522
"12115002504",2132,268,7,1,123,2,135,2,2670
"12115002505",2022,113,0,2,190,148,244,129,2848
"12115002507",4593,384,0,0,163,69,201,85,5495
"12115002508",2853,136,31,4,151,0,17,4,3196
"12115002509",4028,630,0,0,11,0,245,183,5097
"12115002510",2763,499,0,0,62,0,8,20,3352
"12115002511",2548,100,0,0,98,0,19,0,2765
"12115002601",2093,207,0,0,277,33,36,10,2656
"12115002602",2317,180,22,0,102,14,0,13,2648
"12115002603",1283,185,18,0,41,0,0,0,1527
"12115002604",2290,323,22,0,50,74,32,137,2928
"12115002605",1781,326,9,0,3,0,30,0,2149
"12115002710",2187,277,28,84,41,16,189,39,2861
"12115002711",7888,729,89,129,559,76,637,120,10227
"12115002712",24336,3034,2667,1563,1712,116,2558,307,36293
"12115002713",7341,551,5,0,136,25,123,0,8181
"12115002714",4172,307,0,0,59,38,92,0,4668
"12115002715",6005,250,0,0,206,47,13,0,6521
"12115002716",5819,533,0,29,74,71,51,0,6577
"12115002718",4713,356,38,15,83,0,147,28,5380
"12115002719",3201,99,0,0,61,0,127,0,3488
"12115002720",2905,120,19,0,48,97,49,0,3238
"12115002721",2908,823,132,31,225,46,209,0,4374
"12115002722",5586,764,349,421,713,52,519,291,8695
"12115002723",1958,212,17,0,53,4,201,44,2489
"12115002724",2182,171,0,0,65,0,43,0,2461
"12115990000",0,0,0,0,0,0,0,0,0
"12117020101",443,187,206,243,22,29,29,5,1164
"12117020102",589,109,304,162,7,7,125,20,1323
"12117020201",797,252,718,112,159,21,182,79,2320
"12117020202",1948,221,1991,235,66,60,224,83,4828
"12117020301",1432,372,215,135,133,0,246,26,2559
"12117020302",869,208,272,106,370,16,208,71,2120
"12117020401",428,94,1332,262,0,10,0,13,2139
"12117020402",1259,9,1383,446,360,22,82,0,3561
"12117020500",704,262,809,1221,42,27,102,87,3254
"12117020600",7665,845,711,801,1161,121,2207,184,13695
"12117020701",9093,470,1074,452,905,0,976,132,13102
"12117020703",5332,217,280,0,933,0,505,37,7304
"12117020704",4628,275,348,0,665,0,254,0,6170
"12117020705",1532,67,294,25,366,27,136,24,2471
"12117020803",4919,374,292,53,395,24,739,148,6944
"12117020805",5356,277,207,0,930,0,603,43,7416
"12117020806",3975,317,1590,483,109,62,837,203,7576
"12117020807",4657,649,654,318,559,210,1922,196,9165
"12117020808",2785,212,288,45,502,18,432,18,4300
"12117020810",3799,381,61,4,662,2,472,4,5385
"12117020811",4278,153,591,12,49,91,1092,134,6400
"12117020812",2089,85,404,36,209,65,736,84,3708
"12117020901",2065,787,216,375,25,13,662,648,4791
"12117020902",1337,241,353,230,234,65,576,191,3227
"12117020903",5919,1058,1125,980,1023,144,2459,519,13227
"12117021000",2988,409,301,41,418,303,645,11,5116
"12117021100",1179,33,1195,633,206,43,371,41,3701
"12117021201",3946,398,71,26,174,0,379,17,5011
"12117021203",5167,38,342,0,727,5,1181,10,7470
"12117021204",7535,527,277,2,447,0,521,70,9379
"12117021306",6044,464,188,0,147,0,479,0,7322
"12117021307",6282,597,341,64,1117,100,1264,2,9767
"12117021311",2914,229,414,295,163,0,668,37,4720
"12117021312",2825,268,85,563,243,55,573,144,4756
"12117021313",4961,418,122,15,515,0,586,275,6892
"12117021314",3093,250,126,0,413,0,533,48,4463
"12117021315",6145,804,175,330,246,126,1280,201,9307
"12117021316",2803,620,148,61,706,115,374,22,4849
"12117021317",6041,767,204,137,1242,370,1713,104,10578
"12117021318",6141,451,812,18,497,93,1309,279,9600
"12117021319",1462,46,72,24,41,64,105,0,1814
"12117021320",5037,645,629,0,517,103,1019,384,8334
"12117021321",1797,214,94,0,225,10,219,34,2593
"12117021401",5239,817,602,32,476,167,1573,443,9349
"12117021403",6909,235,327,7,322,0,1109,0,8909
"12117021404",5393,827,400,165,654,89,617,506,8651
"12117021502",3675,383,155,313,451,55,774,183,5989
"12117021503",1028,161,131,4,141,26,112,53,1656
"12117021504",2423,324,8,0,193,0,353,7,3308
"12117021505",3572,194,195,30,231,0,374,67,4663
"12117021506",2713,164,246,0,172,0,381,0,3676
"12117021604",3938,260,60,0,177,0,660,27,5122
"12117021606",4293,489,521,72,828,21,1664,170,8058
"12117021608",3982,893,549,45,400,0,1056,518,7443
"12117021609",2962,30,0,0,107,28,264,11,3402
"12117021611",4822,226,67,0,329,0,707,54,6205
"12117021612",3612,294,281,0,209,0,391,0,4787
"12117021613",2064,227,365,68,109,22,738,102,3695
"12117021614",4403,241,720,107,209,5,1201,97,6983
"12117021615",2034,29,54,0,107,35,157,24,2440
"12117021616",2820,117,0,0,399,0,324,0,3660
"12117021704",4306,383,213,48,330,15,1408,63,6766
"12117021705",2823,714,601,255,167,122,1311,551,6544
"12117021706",2483,335,407,22,166,10,924,176,4523
"12117021707",4407,499,489,75,436,0,1292,67,7265
"12117021708",5660,372,416,276,474,253,1734,211,9396
"12117021802",3549,502,506,93,384,0,559,260,5853
"12117021803",1755,274,560,8,207,53,431,164,3452
"12117021805",1517,22,91,0,35,0,39,0,1704
"12117021806",4117,162,225,0,300,15,1045,0,5864
"12117021901",3127,460,191,19,791,17,689,73,5367
"12117021902",2621,312,848,231,152,0,595,59,4818
"12117022001",938,263,304,354,112,30,302,61,2364
"12117022002",2974,515,120,70,231,31,711,93,4745
"12117022004",1877,220,77,19,119,11,311,124,2758
"12117022005",6107,630,415,41,246,13,859,246,8557
"12117022101",4730,812,706,144,319,41,1224,134,8110
"12117022104",5684,601,93,46,336,0,1333,475,8568
"12117022105",3217,227,83,13,170,0,512,96,4318
"12117022106",6694,222,525,190,794,65,1750,47,10287
"12117022201",3943,519,442,0,353,96,806,194,6353
"12117022205",2414,111,127,26,183,0,429,0,3290
"12117022206",4640,356,798,59,697,115,1393,206,8264
"12117022207",4139,564,32,64,558,40,1039,308,6744
"12117022208",2446,995,231,274,112,112,954,33,5157
"12117022209",3471,336,53,2,469,26,1320,246,5923
"12119910100",1588,402,261,86,28,41,117,41,2564
"12119910300",1215,274,0,12,44,2,77,11,1635
"12119910401",2331,548,0,0,79,0,30,29,3017
"12119910402",1939,481,117,13,35,47,147,0,2779
"12119910500",3334,757,352,31,232,31,508,104,5349
"12119910601",3179,692,27,3,204,46,196,87,4434
"12119910602",1755,717,88,138,21,0,94,107,2920
"12119910700",3522,1285,277,127,62,25,234,476,6008
"12119910800",4148,208,0,0,0,0,19,23,4398
"12119910900",0,0,0,0,0,0,0,0,0
"12119911000",154,233,67,193,28,81,28,124,908
"12119911200",30106,1566,245,168,372,0,428,12,32897
"12119911301",2585,263,12,0,29,19,26,50,2984
"12119911302",39,1,513,638,0,0,0,1,1192
"12119911400",2074,327,314,90,97,0,50,32,2984
"12119911500",1011,175,796,92,12,0,25,0,2111
"12119911701",10189,484,76,0,180,64,211,46,11250
"12119911702",4501,371,44,0,82,0,157,0,5155
"12119980000",26,0,0,0,0,0,0,0,26
"12121970100",3387,1130,1018,778,81,15,323,283,7015
"12121970200",2661,700,539,213,396,187,511,463,5670
"12121970301",1325,295,0,42,38,0,169,32,1901
"12121970302",4498,781,1,31,399,0,50,60,5820
"12121970400",3816,1222,1138,482,65,24,490,547,7784
"12121970500",6914,1544,181,226,184,166,122,235,9572
"12121970600",4813,1561,105,183,132,192,134,242,7362
"12123950100",2600,462,290,366,8,13,27,68,3834
"12123950200",4332,486,109,43,118,102,120,0,5310
"12123950300",2259,526,1865,664,121,26,0,0,5461
"12123950400",4352,544,0,0,119,0,124,0,5139
"12123990000",0,0,0,0,0,0,0,0,0
"12125960100",1407,166,106,155,22,1,40,0,1897
"12125960200",2830,619,500,217,128,98,176,8,4576
"12125960300",3342,622,57,201,143,0,48,114,4527
"12127080100",6878,399,63,0,216,47,85,0,7688
"12127080201",2328,151,0,1,79,0,173,1,2733
"12127080202",2337,448,0,0,96,0,25,11,2917
"12127080300",2582,569,74,17,15,0,130,17,3404
"12127080400",2605,305,0,4,130,0,66,0,3110
"12127080500",1754,213,75,0,138,79,26,11,2296
"12127080600",2077,531,198,187,128,147,128,138,3534
"12127080700",3989,337,95,0,29,0,100,18,4568
"12127080803",4596,573,72,284,165,425,157,2,6274
"12127080804",4401,935,98,18,488,35,188,44,6207
"12127080805",4882,502,157,137,712,47,478,2,6917
"12127080806",2045,511,151,0,50,0,0,0,2757
"12127080807",3255,463,218,0,635,0,408,13,4992
"12127080901",2277,564,420,587,243,235,127,147,4600
"12127080902",2261,562,542,90,70,11,86,52,3674
"12127081000",2337,842,153,236,18,14,75,32,3707
"12127081101",1720,172,60,0,12,45,124,31,2164
"12127081102",1786,167,45,0,16,21,45,4,2084
"12127081200",2149,861,32,88,76,27,179,57,3469
"12127081300",1615,245,46,0,113,57,129,0,2205
"12127081500",797,708,75,218,33,142,56,162,2191
"12127081600",813,493,649,253,44,53,100,271,2676
"12127081700",1192,905,2264,2053,219,50,117,106,6906
"12127081800",535,219,1277,1124,67,57,18,17,3314
"12127081900",109,0,1031,1234,12,0,61,0,2447
"12127082000",357,210,354,181,20,20,30,10,1182
"12127082100",178,68,1987,1878,147,72,97,37,4464
"12127082201",1474,658,100,900,62,109,55,207,3565
"12127082202",1097,158,431,14,84,2,78,24,1888
"12127082301",2253,1038,1608,737,306,189,351,444,6926
"12127082401",1576,718,397,533,243,37,231,79,3814
"12127082404",1826,378,66,70,128,64,26,12,2570
"12127082405",2752,504,91,293,71,0,266,19,3996
"12127082406",2339,37,255,0,72,0,205,0,2908
"12127082410",4487,399,256,17,144,14,292,46,5655
"12127082411",2743,429,117,15,211,70,231,47,3863
"12127082412",1540,158,362,96,69,0,66,8,2299
"12127082413",2550,280,425,0,237,29,222,20,3763
"12127082414",2692,547,125,0,141,35,43,10,3593
"12127082415",1415,440,257,60,138,228,23,263,2824
"12127082503",4530,763,0,165,226,84,62,61,5891
"12127082506",3871,429,0,0,161,16,316,0,4793
"12127082507",5566,1391,0,40,304,22,168,42,7533
"12127082508",4104,394,170,0,326,0,231,1,5226
"12127082509",3367,157,216,0,0,0,78,0,3818
"12127082510",3116,409,8,6,190,68,74,0,3871
"12127082511",1935,518,0,2,87,0,84,0,2626
"12127082604",1944,440,0,0,220,49,40,0,2693
"12127082605",2928,297,0,0,54,0,174,30,3483
"12127082606",2868,113,0,0,35,29,139,0,3184
"12127082607",1794,292,0,23,68,20,51,0,2248
"12127082701",1602,82,0,0,20,0,27,0,1731
"12127082703",2353,306,0,0,64,0,59,0,2782
"12127082704",2010,228,33,0,37,0,36,0,2344
"12127082705",1905,403,15,0,42,0,93,0,2458
"12127082801",2302,260,0,0,145,0,153,0,2860
"12127082802",3021,542,0,119,0,2,19,84,3787
"12127082902",3978,915,118,0,162,18,174,69,5434
"12127082903",2343,704,861,242,51,0,52,27,4280
"12127082904",4124,452,39,0,18,0,39,0,4672
"12127083003",4449,877,264,43,213,0,42,25,5913
"12127083005",3176,284,119,0,71,28,162,29,3869
"12127083006",5819,510,99,176,64,324,271,101,7364
"12127083007",3587,440,182,59,0,0,0,34,4302
"12127083008",2497,260,0,123,46,9,63,24,3022
"12127083009",3068,262,48,3,79,0,18,0,3478
"12127083203",5904,300,113,214,461,42,220,9,7263
"12127083205",1504,338,100,0,183,27,63,27,2242
"12127083206",702,161,0,37,96,0,34,0,1030
"12127083207",5704,403,187,0,122,0,142,85,6643
"12127083208",9720,773,381,2,593,64,643,0,12176
"12127083209",4725,235,187,156,62,155,0,0,5520
"12127090101",2692,600,56,0,243,81,302,164,4138
"12127090102",1527,428,79,49,651,499,688,685,4606
"12127090202",4335,891,592,19,103,53,564,179,6736
"12127090203",3066,685,159,162,1069,322,688,621,6772
"12127090204",5405,1000,377,61,278,338,565,234,8258
"12127090303",1998,691,0,109,38,34,408,272,3550
"12127090304",3287,497,53,75,185,299,428,264,5088
"12127090305",2695,360,0,0,12,0,120,27,3214
"12127090306",3234,178,138,0,187,159,86,134,4116
"12127090307",4488,706,221,167,423,272,809,404,7490
"12127090400",3203,566,9,0,91,0,160,0,4029
"12127090500",992,422,84,144,44,43,86,60,1875
"12127090600",1897,507,1362,1119,559,211,520,435,6610
"12127090701",3678,988,93,5,130,69,99,81,5143
"12127090702",2478,629,1115,395,432,59,648,32,5788
"12127090803",3967,687,60,109,386,0,507,158,5874
"12127090804",5051,1050,227,0,523,12,821,253,7937
"12127090805",4429,1006,6,0,66,14,381,75,5977
"12127090806",2233,1087,347,176,403,101,991,539,5877
"12127090902",7338,628,566,112,829,51,1114,100,10738
"12127090903",3655,186,60,0,137,0,294,0,4332
"12127090904",4485,296,201,0,210,0,259,60,5511
"12127091001",3727,533,324,18,390,13,753,28,5786
"12127091005",1962,197,83,57,37,0,166,32,2534
"12127091013",6031,788,266,335,680,10,2495,111,10716
"12127091015",3514,483,408,242,167,46,1541,142,6543
"12127091016",3207,735,386,16,911,673,1402,975,8305
"12127091017",2372,489,82,98,460,25,1190,278,4994
"12127091018",3783,969,531,45,874,285,1331,658,8476
"12127091019",2939,430,706,40,701,0,1198,297,6311
"12127091020",4337,413,971,146,510,27,1287,254,7945
"12127091021",1635,107,101,18,188,8,320,54,2431
"12127091022",5465,746,727,12,811,182,2224,620,10787
"12127091023",2136,445,75,60,666,0,1157,21,4560
"12127091024",4937,215,417,334,835,193,1772,217,8920
"12127091025",2806,535,522,113,627,128,961,280,5972
"12127091026",4044,1227,721,170,316,90,1095,722,8385
"12127091027",4768,493,230,4,1398,150,2216,224,9483
"12127091028",2864,313,409,33,486,161,1437,167,5870
"12127091029",4038,344,267,0,272,24,614,23,5582
"12127092500",2274,688,715,285,229,198,682,57,5128
"12127990000",0,0,0,0,0,0,0,0,0
"12129010100",3766,630,75,41,74,51,33,0,4670
"12129010201",5793,818,1352,254,431,0,123,28,8799
"12129010202",3882,747,461,140,54,0,116,0,5400
"12129010203",6934,1183,463,0,72,53,321,53,9079
"12129990000",0,0,0,0,0,0,0,0,0
"12131950101",3682,1870,89,38,186,292,39,163,6359
"12131950102",2132,500,0,0,0,0,71,73,2776
"12131950200",2533,537,447,475,255,280,267,221,5015
"12131950301",3958,1071,170,5,544,74,576,106,6504
"12131950302",3609,547,303,162,233,299,239,156,5548
"12131950400",1594,780,174,103,427,23,67,7,3175
"12131950501",2848,843,97,31,261,30,123,13,4246
"12131950502",2909,390,25,7,157,46,155,17,3706
"12131950601",8522,575,65,1,524,0,426,27,10140
"12131950602",2225,135,0,0,47,0,0,0,2407
"12131950603",6009,602,0,0,677,0,265,0,7553
"12131990000",0,0,0,0,0,0,0,0,0
"12133970102",1338,354,32,0,45,0,0,0,1769
"12133970103",2640,398,198,60,41,27,2,9,3375
"12133970104",1407,469,569,419,72,26,43,0,3005
"12133970200",2549,465,88,104,185,26,193,28,3638
"12133970301",1898,405,36,2,27,2,119,6,2495
"12133970302",2909,461,532,358,118,149,119,4,4650
"12133970303",2653,661,362,44,190,70,2,50,4032
"13001950100",2666,260,33,15,29,130,0,130,3263
"13001950200",1461,861,1565,477,95,102,0,370,4931
"13001950300",2789,792,437,157,190,163,336,163,5027
"13001950400",1034,184,277,91,0,0,0,0,1586
"13001950500",3026,683,168,158,53,28,626,33,4775
"13003960100",963,391,343,189,155,206,212,174,2633
"13003960200",2252,643,532,307,508,591,656,685,6174
"13003960300",816,344,42,0,8,0,97,199,1506
"13005970100",2403,494,80,0,276,24,392,0,3669
"13005970201",2325,272,580,383,216,35,207,35,4053
"13005970202",2442,556,349,267,0,0,53,103,3770
"13007960100",531,221,950,667,5,0,0,3,2377
"13007960200",566,19,252,166,0,0,0,0,1003
"13009970100",2471,422,1749,466,45,0,40,0,5193
"13009970200",3576,516,1024,1436,260,255,68,273,7408
"13009970300",3027,483,1461,579,242,95,88,95,6070
"13009970400",2138,1027,1220,209,58,125,113,23,4913
"13009970500",1220,1470,875,871,182,31,0,108,4757
"13009970600",632,516,1604,980,40,101,0,0,3873
"13009970701",262,217,820,977,16,5,0,0,2297
"13009970702",477,262,639,528,3,12,4,5,1930
"13009970800",4059,467,1038,464,30,0,0,0,6058
"13011970100",4191,851,0,0,140,11,130,318,5641
"13011970200",3967,794,219,151,199,24,16,29,5399
"13011970300",3156,602,37,0,240,12,364,2,4413
"13011970400",2889,602,109,0,88,0,207,24,3919
"13013180103",3343,271,72,0,382,0,244,0,4312
"13013180104",1409,237,219,0,183,0,110,13,2171
"13013180105",1814,260,109,0,207,90,112,52,2644
"13013180106",1905,278,169,51,75,53,178,60,2769
"13013180107",2108,641,164,193,661,0,377,115,4259
"13013180108",2505,421,133,24,364,94,141,73,3755
"13013180203",1454,428,460,224,582,19,465,19,3651
"13013180204",1333,178,514,189,98,101,310,76,2799
"13013180205",2280,1096,520,346,176,110,218,20,4766
"13013180206",2055,267,125,20,503,80,286,80,3416
"13013180301",2032,98,114,0,46,0,273,0,2563
"13013180302",4576,266,322,0,384,37,314,54,5953
"13013180303",3104,166,246,33,180,0,11,44,3784
"13013180401",4328,224,465,100,73,0,20,0,5210
"13013180402",4087,504,1328,88,238,0,811,81,7137
"13013180501",4052,127,472,323,236,91,756,97,6154
"13013180502",3229,941,39,94,232,44,92,166,4837
"13013180503",3243,684,704,27,321,0,98,487,5564
"13015960101",1508,137,0,0,12,0,0,26,1683
"13015960102",8580,397,87,413,48,4,198,0,9727
"13015960200",8434,1746,833,310,667,42,465,165,12662
"13015960300",5506,948,193,274,72,300,209,298,7800
"13015960401",5740,838,820,493,486,412,319,620,9728
"13015960402",5063,1519,662,195,578,204,600,0,8821
"13015960500",5223,888,616,621,253,339,448,601,8989
"13015960600",5206,1307,1050,560,439,95,456,816,9929
"13015960700",3554,692,813,56,514,278,573,353,6833
"13015960801",2548,509,253,117,60,0,68,0,3555
"13015960802",1802,704,44,1,123,44,136,271,3125
"13015960803",4080,834,111,138,453,54,272,35,5977
"13015960901",2135,644,95,12,30,23,30,156,3125
"13015960902",4726,503,686,49,457,0,332,2,6755
"13015961000",6882,181,490,51,260,64,123,0,8051
"13017960100",1307,771,207,160,18,0,0,0,2463
"13017960200",900,284,389,28,52,14,52,17,1736
"13017960300",1544,1143,544,637,20,0,61,346,4295
"13017960400",1305,309,694,661,156,234,180,246,3785
"13017960500",2272,605,972,1656,266,54,128,26,5979
"13019970100",986,122,232,108,48,0,42,0,1538
"13019970200",2159,972,396,48,56,139,141,125,4036
"13019970300",2358,575,41,46,212,7,201,7,3447
"13019970400",1912,324,280,252,7,0,0,0,2775
"13019970500",2510,454,161,214,57,182,142,122,3842
"13019970600",2885,611,164,94,121,98,76,64,4113
"13021010100",159,27,692,758,4,26,87,0,1753
"13021010200",1368,262,338,233,23,0,100,0,2324
"13021010300",84,18,314,219,0,0,0,0,635
"13021010400",14,22,763,1111,98,0,14,16,2038
"13021010500",0,62,597,963,0,46,0,0,1668
"13021010800",716,416,257,5,31,6,94,63,1588
"13021011000",1339,223,1148,1073,174,47,210,47,4261
"13021011100",64,38,846,997,0,0,23,0,1968
"13021011500",63,18,693,698,7,10,18,10,1517
"13021011701",177,53,1828,412,19,0,40,6,2535
"13021011702",244,44,2850,1320,32,13,0,0,4503
"13021011800",2243,160,561,430,254,18,136,0,3802
"13021011900",879,107,690,181,0,0,12,0,1869
"13021012000",3703,113,710,87,93,8,77,0,4791
"13021012101",1256,0,389,27,14,136,0,0,1822
"13021012102",2774,414,1001,54,385,9,0,121,4758
"13021012200",600,122,719,632,81,0,50,0,2204
"13021012300",228,202,1263,1138,17,6,0,114,2968
"13021012400",307,16,2022,1316,0,15,0,1,3677
"13021012500",183,57,1432,1604,34,61,0,0,3371
"13021012600",529,149,2399,1836,0,21,180,0,5114
"13021012700",96,46,640,987,0,73,0,99,1941
"13021012800",420,145,1005,2256,42,16,0,0,3884
"13021012900",304,120,431,1067,164,42,65,40,2233
"13021013101",712,261,2907,2103,56,185,19,142,6385
"13021013102",451,45,2349,791,0,92,0,0,3728
"13021013201",540,156,3736,831,543,0,120,0,5926
"13021013202",371,151,1447,694,19,76,37,171,2966
"13021013302",693,312,2152,608,109,9,52,0,3935
"13021013407",2364,305,760,135,113,198,399,0,4274
"13021013408",3442,75,708,0,360,0,124,0,4709
"13021013409",2202,257,924,113,261,150,108,0,4015
"13021013410",4291,90,707,15,245,0,31,0,5379
"13021013411",2386,295,643,331,379,0,147,38,4219
"13021013502",1436,160,143,111,35,0,0,16,1901
"13021013503",1218,425,863,106,351,0,731,295,3989
"13021013504",6463,288,1476,67,216,0,174,0,8684
"13021013603",2066,278,185,591,0,46,0,63,3229
"13021013604",2916,257,1553,127,160,0,78,0,5091
"13021013605",2306,198,2526,313,96,0,57,0,5496
"13021013606",3862,274,1173,0,399,0,22,0,5730
"13021013700",748,238,686,715,14,20,14,12,2447
"13021013800",15,0,905,982,48,109,33,12,2104
"13021013900",687,275,454,386,53,4,10,45,1914
"13023790100",3884,687,94,54,43,19,22,19,4822
"13023790200",856,195,1002,747,175,16,216,16,3223
"13023790300",2541,323,187,493,0,131,28,0,3703
"13025960100",5363,1296,385,0,193,0,164,0,7401
"13025960200",4193,1395,134,49,43,0,0,5,5819
"13025960300",3929,1222,21,17,0,31,188,10,5418
"13027960200",820,76,245,93,119,116,101,103,1673
"13027960300",3491,421,556,576,95,336,97,347,5919
"13027960400",1446,259,1053,833,78,0,46,32,3747
"13027960500",735,107,1049,548,58,0,96,14,2607
"13027960600",1671,228,465,163,0,0,0,0,2527
"13029920101",3259,835,287,105,156,2,89,0,4733
"13029920102",3157,351,962,689,66,75,194,52,5546
"13029920301",1799,108,118,32,36,27,139,22,2281
"13029920303",3035,767,872,219,506,28,52,0,5479
"13029920305",3253,156,261,0,354,0,403,0,4427
"13029920306",8038,218,742,29,665,0,710,0,10402
"13029980000",0,0,0,0,0,0,0,0,0
"13031110100",1860,633,560,263,56,118,8,189,3687
"13031110200",3323,494,1446,903,383,23,97,51,6720
"13031110300",5063,925,1011,282,345,163,166,272,8227
"13031110401",716,543,1431,619,168,34,64,0,3575
"13031110403",1199,2690,872,1380,62,312,180,98,6793
"13031110404",119,1435,156,949,26,220,26,113,3044
"13031110500",2081,1002,585,599,131,279,97,162,4936
"13031110601",3274,588,1551,725,364,15,103,42,6662
"13031110602",1689,513,783,654,154,152,73,0,4018
"13031110700",5872,1663,1338,727,723,55,491,9,10878
"13031110800",1721,314,482,145,30,5,0,0,2697
"13031110900",5425,879,328,407,77,0,114,0,7230
"13033950100",2526,702,1119,1212,168,0,333,98,6158
"13033950200",1369,693,481,203,40,15,65,15,2881
"13033950400",957,157,1890,1756,3,97,0,0,4860
"13033950500",1982,245,953,1594,61,0,54,0,4889
"13033950700",1394,230,818,521,30,10,11,0,3014
"13033950900",691,115,745,126,26,4,31,0,1738
"13035150100",5897,746,920,346,34,6,63,0,8012
"13035150200",3964,399,1769,875,151,100,329,0,7587
"13035150300",4128,279,1042,249,76,51,156,0,5981
"13037950100",752,171,815,649,99,70,99,70,2725
"13037950200",733,158,677,891,54,33,54,0,2600
"13039010100",1826,237,231,97,80,0,44,8,2523
"13039010200",2969,437,960,307,199,44,78,50,5044
"13039010301",5634,1022,446,745,355,122,118,90,8532
"13039010302",2606,265,999,250,309,24,127,41,4621
"13039010401",6825,649,2085,707,449,60,587,35,11397
"13039010402",4216,226,252,45,270,6,630,39,5684
"13039010403",3102,306,201,157,112,14,80,0,3972
"13039010500",1084,222,102,21,217,14,203,62,1925
"13039010601",3882,687,1117,819,302,70,251,187,7315
"13039010602",640,64,34,24,57,10,28,0,857
"13039990000",0,0,0,0,0,0,0,0,0
"13043950100",2337,876,1082,673,331,38,271,235,5843
"13043950200",2263,293,339,142,101,0,86,0,3224
"13043950300",1025,422,215,80,223,238,379,248,2830
"13045910101",3376,261,1075,655,590,209,55,92,6313
"13045910103",3843,402,783,12,116,0,500,0,5656
"13045910104",6034,713,1362,331,335,157,212,157,9301
"13045910200",8441,1569,1222,149,77,0,121,0,11579
"13045910300",4676,863,869,29,71,28,335,0,6871
"13045910400",2468,554,173,78,24,7,6,11,3321
"13045910501",2462,1565,807,862,397,69,844,205,7211
"13045910502",411,479,751,385,140,244,344,450,3204
"13045910600",3273,531,784,899,250,366,246,565,6914
"13045910701",5258,1242,770,529,443,152,368,111,8873
"13045910702",5389,551,728,166,355,13,272,41,7515
"13045910703",4633,1093,1842,260,145,0,0,351,8324
"13045910800",3483,383,125,36,48,36,97,21,4229
"13045910900",3156,360,214,65,17,12,5,45,3874
"13045911000",3810,626,891,263,514,74,518,328,7024
"13045911100",5299,1367,529,245,20,105,81,397,8043
"13045911200",3987,857,394,347,232,75,47,0,5939
"13047030100",5373,1067,81,3,53,99,126,117,6919
"13047030201",3522,441,103,58,124,31,79,31,4389
"13047030202",5149,578,90,12,337,28,0,6,6200
"13047030301",6229,795,0,0,250,0,201,79,7554
"13047030303",3187,409,26,0,72,0,36,0,3730
"13047030304",3411,128,44,0,115,0,110,0,3808
"13047030401",6059,668,52,0,321,138,248,47,7533
"13047030402",4372,929,173,54,160,47,135,10,5880
"13047030500",4464,986,284,0,32,32,15,17,5830
"13047030600",4061,888,264,0,144,34,227,0,5618
"13047030700",6044,1240,92,245,448,16,85,1,8171
"13049010100",4705,650,1996,1200,64,0,445,0,9060
"13049010200",2502,435,36,0,29,0,49,0,3051
"13051000100",2,2,57,880,19,0,5,1,966
"13051000300",935,191,27,10,0,31,56,36,1286
"13051000601",0,15,1785,936,58,6,0,2,2802
"13051000900",798,163,65,75,20,32,65,37,1255
"13051001100",579,254,668,550,23,27,9,0,2110
"13051001200",23,49,683,1056,0,0,0,49,1860
"13051001500",345,358,100,291,23,50,26,197,1390
"13051002000",310,441,347,506,0,12,122,12,1750
"13051002100",161,111,1408,755,19,0,0,0,2454
"13051002200",698,214,2549,763,43,114,8,46,4435
"13051002300",36,9,1073,1034,5,0,0,0,2157
"13051002600",197,159,773,141,32,0,39,6,1347
"13051002700",382,42,2037,660,8,0,31,11,3171
"13051002800",186,53,1733,555,73,26,0,0,2626
"13051002900",2588,140,68,41,140,49,89,0,3115
"13051003000",1619,230,53,25,125,16,55,20,2143
"13051003301",0,20,1301,677,55,19,0,5,2077
"13051003302",141,0,1417,289,7,0,0,0,1854
"13051003400",2163,128,1235,623,107,12,203,8,4479
"13051003501",705,121,1030,783,15,24,16,5,2699
"13051003502",1087,291,1710,625,138,0,17,20,3888
"13051003601",484,198,1550,471,0,0,217,112,3032
"13051003602",941,377,2506,820,186,10,52,7,4899
"13051003700",476,58,728,297,22,6,49,0,1636
"13051003800",344,108,1314,619,124,0,20,0,2529
"13051003900",1347,45,1627,594,71,0,0,0,3684
"13051004001",2984,235,811,200,21,0,68,0,4319
"13051004002",1941,308,772,338,126,239,162,170,4056
"13051004100",1117,274,154,196,57,0,23,0,1821
"13051004207",772,177,1869,652,350,106,41,29,3996
"13051004208",1983,192,1606,419,663,120,673,88,5744
"13051004209",1313,228,1311,323,110,289,111,244,3929
"13051004210",1628,211,1316,1113,396,66,548,0,5278
"13051004211",2815,588,1121,360,56,79,147,195,5361
"13051004212",2925,276,1241,216,292,31,199,28,5208
"13051004300",899,296,618,0,89,72,270,157,2401
"13051004400",32,8,1529,919,0,0,0,0,2488
"13051004500",286,3,3095,946,0,0,57,28,4415
"13051010101",287,17,83,447,17,0,4,0,855
"13051010102",1686,186,793,297,152,21,253,64,3452
"13051010200",1409,189,1978,368,463,0,56,0,4463
"13051010501",2171,1290,854,73,210,32,627,580,5837
"13051010502",719,166,1934,797,112,21,94,0,3843
"13051010601",1397,397,1664,943,27,166,144,426,5164
"13051010603",602,89,745,153,44,16,18,8,1675
"13051010605",10,0,0,0,0,0,0,0,10
"13051010700",8016,1326,5296,443,1224,242,730,15,17292
"13051010801",2092,302,250,4,43,13,18,73,2795
"13051010802",4644,424,2550,240,597,23,545,98,9121
"13051010803",5810,685,2350,674,511,25,267,0,10322
"13051010806",3247,665,1497,180,456,114,175,86,6420
"13051010807",2590,293,1068,1,490,0,180,0,4622
"13051010808",3826,1015,3579,78,534,814,676,1031,11553
"13051010809",6176,685,2774,399,521,90,721,185,11551
"13051010901",1615,614,1519,391,118,92,329,348,5026
"13051011003",4368,813,578,48,109,13,253,83,6265
"13051011004",3076,86,58,24,106,0,42,0,3392
"13051011005",4056,81,51,0,188,0,56,0,4432
"13051011006",3451,88,0,0,77,0,138,0,3754
"13051011103",2790,393,2,0,27,0,116,40,3368
"13051011104",4145,188,257,1,309,0,99,0,4999
"13051011106",4441,290,379,19,384,238,252,0,6003
"13051011107",2688,32,78,0,206,48,48,0,3100
"13051011108",2810,46,130,0,104,20,34,0,3144
"13051011109",5682,311,212,0,432,147,236,22,7042
"13051011200",909,553,20,85,20,105,18,13,1723
"13051011300",502,809,481,360,24,72,31,13,2292
"13051011400",614,388,520,414,59,4,17,2,2018
"13051011500",2051,153,442,68,54,0,58,0,2826
"13051011600",253,138,1292,636,84,21,146,93,2663
"13051980000",0,0,0,0,0,0,0,0,0
"13051990000",0,0,0,0,0,0,0,0,0
"13053020100",1394,406,767,135,252,71,16,13,3054
"13053020201",1027,41,35,0,181,0,313,4,1601
"13053020203",1113,80,112,20,185,8,293,26,1837
"13053020205",2026,150,530,70,392,120,640,17,3945
"13053020206",0,0,102,0,0,0,0,0,102
"13055010100",1614,316,79,34,29,5,11,5,2093
"13055010200",4688,1435,144,36,271,103,348,509,7534
"13055010300",2086,563,3,22,65,31,0,25,2795
"13055010400",3115,1513,270,112,41,68,0,0,5119
"13055010500",3016,686,715,233,65,0,44,18,4777
"13055010600",1748,515,131,14,24,20,66,8,2526
"13057090100",7281,545,20,5,226,23,371,4,8475
"13057090200",6402,467,0,0,101,23,95,66,7154
"13057090300",10121,917,226,37,381,12,375,46,12115
"13057090400",6056,863,849,177,511,776,1806,959,11997
"13057090501",4997,555,95,0,221,43,222,90,6223
"13057090502",11048,1499,174,19,703,139,955,652,15189
"13057090601",4857,506,62,17,218,727,711,990,8088
"13057090602",6003,733,82,510,909,47,1009,180,9473
"13057090701",14979,1253,1378,233,1160,131,1295,98,20527
"13057090702",5703,629,470,450,365,147,504,125,8393
"13057090802",5933,252,289,226,218,70,367,70,7425
"13057090803",8310,651,381,0,677,50,430,69,10568
"13057090804",7560,203,374,1,537,265,250,338,9528
"13057090901",6023,610,505,150,278,2,568,13,8149
"13057090902",11379,527,1040,40,1484,16,1200,120,15806
"13057090904",5782,1040,244,37,731,355,831,441,9461
"13057090905",2473,220,323,0,205,34,206,0,3461
"13057091001",2874,330,619,117,303,7,535,0,4785
"13057091003",4810,803,697,59,457,154,1230,249,8459
"13057091005",6271,827,468,0,269,17,738,439,9029
"13057091006",4271,171,170,82,155,0,223,0,5072
"13057091007",5783,233,103,0,130,0,194,53,6496
"13057091008",6767,136,671,0,788,0,416,0,8778
"13057091101",4204,274,255,84,352,62,207,36,5474
"13057091102",5973,1193,852,44,474,7,646,399,9588
"13057091103",6454,444,487,0,347,16,363,91,8202
"13059000100",211,1379,30,69,11,86,21,38,1845
"13059000401",217,200,49,29,352,252,23,1,1123
"13059000402",129,606,6,14,8,60,13,7,843
"13059000600",752,784,126,388,22,28,79,91,2270
"13059000900",203,320,1035,1516,164,167,66,242,3713
"13059001200",1849,299,193,142,65,16,61,31,2656
"13059001700",1207,132,418,60,53,0,38,5,1913
"13059001800",1861,221,56,32,134,0,311,0,2615
"13059001900",1536,1266,353,517,16,31,142,35,3896
"13059002000",1369,457,61,68,95,7,8,19,2084
"13059002100",1172,1591,72,29,11,105,0,0,2980
"13059002200",1187,1090,22,43,67,78,64,91,2642
"13059030100",742,1460,1231,934,284,54,99,325,5129
"13059030200",388,470,1709,1275,98,140,16,0,4096
"13059130300",2243,1059,1286,978,389,75,1273,983,8286
"13059130400",2605,745,1843,314,29,140,380,347,6403
"13059130500",1415,71,583,417,244,0,198,0,2928
"13059130600",3003,1194,630,750,219,433,533,656,7418
"13059130700",2993,519,710,46,374,98,162,0,4902
"13059140300",1386,729,1952,553,9,180,242,520,5571
"13059140400",1053,1377,710,95,165,272,486,1329,5487
"13059140500",397,296,705,365,22,16,284,160,2245
"13059140600",2593,424,1015,567,341,27,231,170,5368
"13059150300",1695,539,506,246,197,63,225,39,3510
"13059150400",656,3379,156,334,142,529,66,106,5368
"13059150500",1866,1496,389,173,120,198,202,26,4470
"13059150600",1004,769,262,366,479,61,339,192,3472
"13059150700",3454,792,556,618,373,73,265,48,6179
"13059150800",3483,712,1044,246,390,182,122,259,6438
"13059150900",2425,547,557,211,187,3,249,0,4179
"13061960300",848,215,639,1153,220,0,161,0,3236
"13063040202",56,9,1191,741,414,184,153,142,2890
"13063040203",100,0,2408,981,124,26,129,67,3835
"13063040204",31,83,2598,798,121,0,256,0,3887
"13063040302",1118,317,1581,989,514,190,578,324,5611
"13063040303",1360,1018,2278,1737,586,292,638,879,8788
"13063040306",667,1080,842,582,389,292,661,1205,5718
"13063040307",1302,403,1022,284,1416,201,740,298,5666
"13063040308",1237,639,1044,512,473,798,936,1093,6732
"13063040407",643,130,1486,373,990,101,702,123,4548
"13063040408",1273,278,2973,868,1125,533,234,21,7305
"13063040409",878,364,2459,255,1285,192,559,175,6167
"13063040410",1247,859,3483,542,132,437,200,939,7839
"13063040411",1846,87,8141,1124,503,468,150,382,12701
"13063040412",2123,127,3794,934,1436,108,806,23,9351
"13063040413",1451,623,3061,1746,649,107,675,475,8787
"13063040414",693,35,529,178,254,8,267,43,2007
"13063040415",503,424,2560,809,304,503,429,879,6411
"13063040416",863,429,1757,288,847,0,577,241,5002
"13063040417",261,157,1904,1457,148,358,104,341,4730
"13063040509",354,1,3506,453,110,15,119,10,4568
"13063040510",295,157,2321,205,325,135,152,34,3624
"13063040512",434,46,3003,1005,229,195,18,0,4930
"13063040513",509,8,3246,545,799,51,30,0,5188
"13063040514",932,424,4592,777,153,737,844,1046,9505
"13063040515",1221,171,4195,1201,571,159,840,125,8483
"13063040516",544,543,2549,1770,578,73,273,569,6899
"13063040518",546,261,2450,1238,214,499,60,622,5890
"13063040519",85,39,2320,1221,76,99,41,132,4013
"13063040520",76,84,1983,851,46,0,76,84,3200
"13063040521",677,49,1631,725,188,90,130,79,3569
"13063040522",695,113,1917,878,683,128,276,56,4746
"13063040523",196,84,1768,543,904,0,582,80,4157
"13063040524",1091,235,4127,1116,704,45,893,326,8537
"13063040525",339,2,2201,506,120,9,134,0,3311
"13063040526",310,167,2917,1391,435,115,153,90,5578
"13063040606",1240,141,1079,250,70,237,451,221,3689
"13063040608",1912,85,7154,860,205,126,405,19,10766
"13063040609",1681,79,3508,159,370,84,402,25,6308
"13063040611",1382,626,2328,1149,497,552,1091,1041,8666
"13063040612",1130,255,1870,904,472,654,260,404,5949
"13063040613",1988,269,3716,1232,292,13,178,108,7796
"13063040614",2241,102,1168,243,762,173,205,41,4935
"13063040615",271,24,1537,18,138,0,83,0,2071
"13063040616",652,413,4394,1339,406,95,476,456,8231
"13063040617",823,170,20,0,381,199,864,262,2719
"13063040619",358,0,1828,828,209,118,19,88,3448
"13063040620",662,74,1691,715,68,0,158,237,3605
"13063040621",1421,359,5499,951,185,26,416,288,9145
"13063040622",1376,366,4243,767,565,841,753,1041,9952
"13063980000",0,0,0,0,0,0,0,0,0
"13065970100",3017,678,597,646,22,46,59,0,5065
"13065970200",818,135,172,431,85,0,188,0,1829
"13067030101",5944,252,424,295,525,142,708,133,8423
"13067030103",5637,282,1791,153,747,27,454,0,9091
"13067030104",2280,182,554,104,454,23,532,0,4129
"13067030106",3164,602,2094,175,478,254,541,307,7615
"13067030107",2455,53,1669,132,284,92,274,0,4959
"13067030209",5096,56,1268,35,200,0,208,0,6863
"13067030214",6360,329,993,2,719,14,633,81,9131
"13067030215",5907,685,823,63,1042,374,538,742,10174
"13067030218",4040,76,708,0,479,0,462,24,5789
"13067030219",7899,338,630,0,526,0,432,0,9825
"13067030220",1073,50,425,120,44,0,80,0,1792
"13067030222",4497,399,600,240,127,63,175,22,6123
"13067030223",3508,147,1363,129,380,29,319,12,5887
"13067030224",3955,136,1539,84,935,104,456,15,7224
"13067030226",5962,195,1332,95,543,349,714,0,9190
"13067030227",3852,381,1805,87,1146,338,850,368,8827
"13067030228",4073,1159,1074,409,206,83,757,182,7943
"13067030229",1831,430,178,11,333,0,68,0,2851
"13067030230",8263,252,2226,1151,1068,69,1699,107,14835
"13067030231",6279,170,353,40,464,0,197,0,7503
"13067030232",3280,63,1691,330,222,0,443,47,6076
"13067030233",2602,18,1112,140,217,0,231,0,4320
"13067030234",4127,142,835,22,296,0,144,0,5566
"13067030235",3536,333,691,0,197,0,206,0,4963
"13067030236",3858,68,260,0,127,0,99,0,4412
"13067030238",5142,472,381,132,517,60,14,25,6743
"13067030239",6851,199,782,0,287,140,312,140,8711
"13067030310",5609,766,1253,29,570,0,327,268,8822
"13067030311",5029,46,626,185,271,10,367,0,6534
"13067030312",4289,563,386,20,772,0,354,165,6549
"13067030313",5181,469,1225,10,778,0,101,0,7764
"13067030314",5912,361,611,82,989,15,916,95,8981
"13067030318",6584,152,331,0,700,43,90,17,7917
"13067030319",3665,119,39,0,267,117,113,0,4320
"13067030320",4913,419,747,269,860,82,210,83,7583
"13067030322",2543,148,210,0,408,0,230,13,3552
"13067030324",2991,158,82,2,231,76,179,0,3719
"13067030326",3606,61,185,23,795,32,372,64,5138
"13067030327",3070,126,366,18,380,100,100,19,4179
"13067030328",6094,26,381,2,140,49,307,0,6999
"13067030329",3453,229,441,22,438,60,98,20,4761
"13067030330",3980,97,386,56,735,52,106,0,5412
"13067030331",4670,109,364,1,472,11,204,11,5842
"13067030332",2650,74,61,14,530,39,112,0,3480
"13067030333",5022,277,264,10,721,54,184,0,6532
"13067030334",2673,46,59,124,281,7,26,0,3216
"13067030335",4030,77,107,30,215,52,180,0,4691
"13067030336",6636,318,281,0,803,0,432,0,8470
"13067030337",3905,176,181,0,398,0,307,0,4967
"13067030339",2796,322,1209,92,853,24,340,32,5668
"13067030340",3534,0,171,0,195,0,414,0,4314
"13067030341",3552,148,558,14,312,83,228,0,4895
"13067030342",4092,138,396,1,281,0,214,17,5139
"13067030343",4026,70,151,0,442,63,244,0,4996
"13067030344",684,194,1673,313,240,311,120,94,3629
"13067030345",1086,483,921,291,1904,450,986,697,6818
"13067030405",2646,343,1845,208,492,606,291,501,6932
"13067030407",3320,250,320,18,505,14,508,0,4935
"13067030408",1603,202,359,110,610,153,182,102,3321
"13067030409",2738,105,158,0,367,165,123,0,3656
"13067030410",2928,307,1041,277,510,106,932,0,6101
"13067030411",389,191,1483,995,220,418,354,451,4501
"13067030412",405,256,1812,454,417,499,383,443,4669
"13067030413",1216,442,1449,649,820,899,521,512,6508
"13067030414",348,337,1111,570,359,18,436,165,3344
"13067030502",4418,272,890,20,795,0,546,17,6958
"13067030504",4086,250,831,266,964,138,1149,52,7736
"13067030505",2655,536,1768,402,1019,249,1099,218,7946
"13067030506",2657,188,758,41,403,0,433,7,4487
"13067030507",3586,205,489,0,354,0,381,0,5015
"13067030601",4240,697,1443,450,1030,720,648,145,9373
"13067030602",5503,368,198,82,227,0,180,0,6558
"13067030700",1200,507,1084,207,410,70,688,136,4302
"13067030800",2020,830,469,104,133,241,1036,683,5516
"13067030901",4720,380,819,1009,393,114,252,112,7799
"13067030902",2748,764,757,171,688,360,1385,790,7663
"13067030904",2073,1013,1853,496,726,502,1424,1466,9553
"13067030905",2092,368,1602,408,647,566,930,786,7399
"13067031001",1744,1437,738,265,921,527,1429,1807,8868
"13067031002",2256,1021,2180,1345,1200,520,2278,930,11730
"13067031004",2460,1306,2022,834,1200,141,1927,887,10777
"13067031005",2170,636,1437,197,822,386,1267,611,7526
"13067031101",1533,607,783,444,885,167,1209,569,6197
"13067031106",3295,283,2399,784,646,60,758,168,8393
"13067031108",2181,269,1659,547,339,112,312,140,5559
"13067031110",2423,305,600,548,174,0,588,229,4867
"13067031111",1814,24,849,60,395,116,255,44,3557
"13067031112",3129,23,1187,97,348,0,242,0,5026
"13067031113",242,109,337,158,13,72,118,99,1148
"13067031114",2377,800,2432,543,1067,347,1291,858,9715
"13067031115",1573,262,910,764,560,199,267,371,4906
"13067031116",1409,73,1135,895,525,560,911,614,6122
"13067031117",3389,150,404,229,286,132,138,107,4835
"13067031118",2897,100,1229,232,856,41,170,21,5546
"13067031205",3947,110,1249,191,218,32,530,32,6309
"13067031206",4019,414,3019,98,1074,138,312,142,9216
"13067031207",1782,216,655,8,397,0,100,0,3158
"13067031208",2692,478,1172,174,1614,0,251,115,6496
"13067031209",2997,185,366,0,386,0,99,39,4072
"13067031211",1333,188,1575,58,420,0,379,0,3953
"13067031212",2207,11,15,0,53,0,40,0,2326
"13067031306",2066,319,1296,396,94,10,502,0,4683
"13067031307",3530,262,1210,324,369,14,414,13,6136
"13067031308",1641,364,1707,782,310,221,697,517,6239
"13067031309",2869,435,3577,604,275,32,1492,201,9485
"13067031310",753,614,3008,1666,758,556,1316,1183,9854
"13067031311",1197,872,4683,1734,866,254,1260,706,11572
"13067031312",3491,565,3408,818,641,644,1586,1013,12166
"13067031313",5517,110,3321,222,1075,0,947,0,11192
"13067031404",2911,414,1643,122,189,0,398,87,5764
"13067031405",2962,890,3457,713,659,0,1059,749,10489
"13067031406",2047,366,2870,910,126,13,518,70,6920
"13067031408",1930,426,3006,699,211,11,239,34,6556
"13067031409",1591,532,2037,714,239,9,419,224,5765
"13067031503",2830,585,3971,498,491,43,460,481,9359
"13067031505",2679,328,1950,482,222,0,217,12,5890
"13067031506",2014,366,1639,198,623,85,803,284,6012
"13067031507",648,293,1490,610,93,39,206,286,3665
"13067031508",2414,216,2020,63,314,89,242,22,5380
"13067031509",3582,641,4024,532,482,0,257,200,9718
"13069010100",2565,333,258,183,24,16,123,70,3572
"13069010200",2107,622,102,0,35,102,109,330,3407
"13069010300",1889,597,216,273,235,14,235,33,3492
"13069010400",2736,470,322,821,429,54,259,46,5137
"13069010500",1961,459,270,215,257,515,142,685,4504
"13069010600",4097,412,810,25,77,26,101,82,5630
"13069010700",2741,854,837,403,155,872,349,1092,7303
"13069010801",2263,485,2005,293,127,363,232,320,6088
"13069010802",1086,591,2229,560,51,14,42,14,4587
"13071970100",3192,1021,437,69,206,51,482,276,5734
"13071970200",2097,128,169,145,158,82,54,82,2915
"13071970300",1427,293,1231,1894,9,0,0,0,4854
"13071970400",1736,584,390,361,13,43,285,150,3562
"13071970500",2296,322,180,92,510,103,516,237,4256
"13071970600",4884,700,283,87,521,29,1044,418,7966
"13071970701",3681,941,852,769,85,256,603,563,7750
"13071970702",344,654,767,216,280,37,356,358,3012
"13071970800",1117,496,1113,413,0,15,179,288,3621
"13071970900",3806,940,570,272,539,952,696,1246,9021
"13073030102",7605,152,348,0,1673,14,222,0,10014
"13073030103",2434,74,206,0,424,0,87,0,3225
"13073030105",4113,229,1020,0,488,53,195,0,6098
"13073030106",2948,238,277,123,183,48,105,26,3948
"13073030201",4287,149,1224,45,438,0,27,65,6235
"13073030202",2234,306,300,32,186,104,208,10,3380
"13073030203",4512,447,488,40,389,52,0,52,5980
"13073030302",7632,166,1380,225,724,107,475,123,10832
"13073030304",5038,106,960,82,304,108,312,13,6923
"13073030306",3454,145,821,120,212,138,241,0,5131
"13073030307",5616,139,570,66,248,0,170,0,6809
"13073030308",6506,182,1343,127,891,0,427,0,9476
"13073030309",7347,314,1440,2,555,77,280,13,10028
"13073030401",1419,147,448,178,28,0,34,0,2254
"13073030402",5625,824,1177,0,426,85,745,144,9026
"13073030503",4444,1037,858,431,80,81,198,27,7156
"13073030504",2867,322,322,82,29,11,57,152,3842
"13073030505",3968,616,1516,63,403,108,856,163,7693
"13073030506",5515,787,2514,636,733,350,771,614,11920
"13073030603",2864,429,569,155,188,19,43,8,4275
"13075960100",1244,470,182,49,36,15,34,41,2071
"13075960200",1714,477,693,688,9,9,161,51,3802
"13075960300",3675,582,1001,567,334,68,294,0,6521
"13075960400",2975,395,1067,392,0,177,235,190,5431
"13077170100",4943,1254,532,57,301,120,219,0,7426
"13077170200",4554,822,734,248,250,0,79,105,6792
"13077170303",4316,122,127,236,217,0,85,0,5103
"13077170304",5228,83,814,88,168,66,249,101,6797
"13077170305",4514,1884,1577,436,456,7,1090,922,10886
"13077170306",4391,289,1391,690,568,506,368,383,8586
"13077170402",7464,478,1304,0,162,39,775,136,10358
"13077170403",3184,94,430,99,174,0,306,0,4287
"13077170404",5244,146,435,0,356,0,211,0,6392
"13077170405",5684,537,641,58,214,32,752,73,7991
"13077170406",3057,79,194,0,206,0,53,0,3589
"13077170501",5198,361,411,100,205,60,475,66,6876
"13077170502",4695,492,348,129,176,0,110,0,5950
"13077170503",4436,458,704,115,253,0,231,6,6203
"13077170601",2803,212,2030,1750,41,0,686,0,7522
"13077170602",6498,161,1050,0,683,12,137,12,8553
"13077170603",4027,373,638,104,109,0,332,40,5623
"13077170700",2656,213,2655,1458,215,166,165,35,7563
"13077170801",3804,722,723,307,133,18,60,191,5958
"13077170802",3609,548,159,29,227,47,135,88,4842
"13079070100",1354,375,928,670,7,32,0,2,3368
"13079070201",4248,492,271,88,60,23,75,0,5257
"13079070202",2515,249,333,564,166,75,0,23,3925
"13081010100",2050,264,1034,1192,134,52,108,34,4868
"13081010201",2683,303,648,1772,7,0,76,0,5489
"13081010202",845,124,809,752,51,125,33,125,2864
"13081010300",2102,842,812,401,0,21,14,219,4411
"13081010400",1814,51,1351,986,108,112,134,0,4556
"13081010500",1243,118,127,46,0,7,0,0,1541
"13083040101",3510,1090,82,3,175,68,56,12,4996
"13083040102",2963,502,0,0,73,40,73,37,3688
"13083040200",3553,496,9,0,54,5,49,0,4166
"13083040300",2469,241,0,3,55,0,40,0,2808
"13085970100",5828,1143,4,10,245,67,137,26,7460
"13085970201",5653,1164,0,0,338,0,427,0,7582
"13085970202",6157,1001,0,0,343,45,238,45,7829
"13087970100",2459,393,391,111,150,142,45,155,3846
"13087970200",1870,357,499,185,19,95,19,183,3227
"13087970300",2207,465,2208,830,205,0,300,0,6215
"13087970400",1154,368,1271,1771,93,36,93,0,4786
"13087970600",2873,428,997,728,127,128,108,0,5389
"13087970700",997,113,181,159,109,0,256,0,1815
"13087970800",490,194,863,524,102,140,128,156,2597
"13089020100",1662,29,11,0,136,0,50,14,1902
"13089020200",1764,101,69,36,82,22,71,20,2165
"13089020300",2885,133,281,114,420,0,210,0,4043
"13089020400",2005,191,75,0,157,0,89,14,2531
"13089020500",754,217,1301,322,228,12,218,68,3120
"13089020600",559,54,532,381,76,0,29,6,1637
"13089020700",964,106,594,234,98,14,10,11,2031
"13089020801",1201,50,827,307,48,0,67,0,2500
"13089020802",1298,136,1907,613,112,42,135,96,4339
"13089020900",2111,137,2590,649,136,83,190,63,5959
"13089021101",2889,1,381,100,278,23,147,0,3819
"13089021102",3479,371,248,22,242,15,95,0,4472
"13089021202",5424,366,520,21,527,0,314,48,7220
"13089021204",1623,1113,0,47,975,553,2433,1311,8055
"13089021208",1935,147,295,18,460,450,171,281,3757
"13089021209",3208,268,431,78,802,108,129,0,5024
"13089021210",4729,139,66,1,340,0,38,0,5313
"13089021211",3945,50,67,0,548,13,229,0,4852
"13089021213",3229,117,0,0,92,0,63,13,3514
"13089021214",5624,316,122,0,74,88,193,88,6505
"13089021215",2218,134,488,116,2398,32,468,14,5868
"13089021216",4732,365,991,470,1499,222,315,361,8955
"13089021217",1652,143,259,67,370,12,106,41,2650
"13089021218",2395,425,1220,110,845,0,219,0,5214
"13089021301",984,323,964,181,515,208,615,172,3962
"13089021303",2273,1068,477,139,1631,548,2443,1115,9694
"13089021305",1548,814,866,45,1149,909,1137,1409,7877
"13089021306",2413,607,672,54,547,359,1729,610,6991
"13089021307",1855,617,506,54,844,701,1303,881,6761
"13089021308",1623,597,468,24,508,327,1158,739,5444
"13089021405",2882,215,160,4,299,186,241,40,4027
"13089021409",1460,980,356,335,207,376,892,1241,5847
"13089021410",2551,761,296,69,151,1008,1160,1754,7750
"13089021411",2737,71,48,150,249,25,230,0,3510
"13089021412",2991,75,81,61,123,0,417,0,3748
"13089021413",1613,673,381,117,567,847,1508,1457,7163
"13089021414",1540,217,699,118,366,298,1008,409,4655
"13089021415",2389,410,377,88,498,172,475,395,4804
"13089021416",1574,555,101,46,337,281,965,824,4683
"13089021417",2561,649,425,90,394,1147,1774,1327,8367
"13089021502",2510,645,817,77,331,309,335,68,5092
"13089021503",2121,224,451,9,776,116,926,109,4732
"13089021504",2735,947,239,173,347,191,164,97,4893
"13089021602",3031,215,113,28,474,118,233,10,4222
"13089021603",3104,139,611,51,655,107,449,29,5145
"13089021604",2551,51,119,14,211,0,162,0,3108
"13089021605",3031,298,776,331,472,489,499,404,6300
"13089021703",3994,228,34,0,463,114,265,0,5098
"13089021704",3632,183,480,42,568,225,76,0,5206
"13089021705",2246,485,1099,229,592,372,311,460,5794
"13089021706",3842,256,816,48,839,302,369,270,6742
"13089021805",3284,186,1065,341,545,224,720,0,6365
"13089021806",2584,168,1091,1077,795,554,1112,64,7445
"13089021808",2839,474,753,9,879,26,380,217,5577
"13089021809",5185,172,509,19,238,193,106,9,6431
"13089021810",3390,101,798,422,638,84,180,0,5613
"13089021812",1436,285,378,6,315,15,480,205,3120
"13089021813",584,334,832,344,192,187,798,521,3792
"13089021814",2317,1058,1231,589,952,234,1918,1052,9351
"13089021906",545,139,3980,571,399,42,148,87,5911
"13089021907",1658,75,5066,1134,329,75,318,0,8655
"13089021908",372,158,2758,1754,187,27,152,61,5469
"13089021909",757,130,2722,1619,283,9,159,56,5735
"13089021910",780,76,3083,548,394,45,183,48,5157
"13089021911",12,0,1320,689,11,0,11,6,2049
"13089021912",1782,116,1173,1,326,0,53,0,3451
"13089021913",301,442,2757,616,81,32,216,400,4845
"13089022001",2701,447,570,283,185,377,402,0,4965
"13089022004",777,226,2992,1149,801,127,124,0,6196
"13089022005",385,55,2155,578,315,467,78,6,4039
"13089022007",306,141,1915,508,291,916,167,0,4244
"13089022008",985,228,2176,1297,1559,2091,70,196,8602
"13089022009",278,288,3340,1584,64,354,0,0,5908
"13089022010",356,56,406,352,575,783,4,0,2532
"13089022100",547,55,1498,1628,457,9,198,61,4453
"13089022203",734,272,143,57,262,155,67,99,1789
"13089022204",1693,601,804,428,1409,662,702,0,6299
"13089022301",4056,437,305,112,505,306,162,154,6037
"13089022302",2999,322,288,136,657,118,715,82,5317
"13089022401",3312,208,19,1,169,165,77,20,3971
"13089022402",649,191,88,18,187,177,0,7,1317
"13089022403",3454,229,34,1,202,11,84,19,4034
"13089022500",3488,226,296,814,278,59,227,1,5389
"13089022600",4500,344,497,83,339,261,241,87,6352
"13089022700",2674,133,652,326,161,26,87,0,4059
"13089022800",2546,186,489,233,158,0,87,13,3712
"13089022900",1783,195,735,192,316,9,103,0,3333
"13089023000",1564,163,134,74,122,0,122,14,2193
"13089023101",759,75,2600,549,105,96,40,96,4320
"13089023102",1000,112,1339,621,233,0,240,43,3588
"13089023107",630,338,2545,724,59,79,30,221,4626
"13089023108",79,265,2600,1704,95,36,68,189,5036
"13089023111",236,46,1062,278,34,0,20,18,1694
"13089023112",93,204,1971,1829,247,52,136,213,4745
"13089023113",576,170,1378,1054,191,2,81,64,3516
"13089023114",496,35,1631,286,80,42,25,0,2595
"13089023115",0,2,0,0,0,0,0,1,3
"13089023204",852,177,5132,846,155,386,284,9,7841
"13089023206",761,60,4913,1165,262,59,157,0,7377
"13089023208",467,30,4373,999,102,81,15,34,6101
"13089023209",550,12,4053,342,229,2,411,9,5608
"13089023210",237,43,5154,1181,336,2,106,14,7073
"13089023211",31,1,2883,186,143,50,16,79,3389
"13089023212",133,64,2950,485,79,9,10,0,3730
"13089023213",229,38,4156,797,143,254,82,0,5699
"13089023214",153,16,4035,788,142,0,98,23,5255
"13089023303",456,172,3348,1475,857,71,566,98,7043
"13089023306",243,0,5796,853,340,67,305,0,7604
"13089023309",214,25,6815,2151,600,0,254,28,10087
"13089023310",282,51,5824,2848,82,93,69,114,9363
"13089023311",138,74,3361,866,63,49,163,0,4714
"13089023312",458,216,7213,1477,194,18,189,216,9981
"13089023313",42,122,3252,1051,164,31,8,0,4670
"13089023314",241,1,4439,361,126,0,35,0,5203
"13089023315",209,7,4642,218,34,2,23,0,5135
"13089023316",177,4,7068,277,577,0,333,0,8436
"13089023410",35,0,2259,1065,0,0,3,10,3372
"13089023411",143,53,2836,825,61,0,40,53,4011
"13089023412",60,292,4781,859,261,11,53,0,6317
"13089023413",220,5,3112,170,44,18,58,18,3645
"13089023414",24,54,5111,1408,214,332,0,0,7143
"13089023416",305,5,6091,752,202,153,219,28,7755
"13089023418",574,15,14503,1534,338,0,387,0,17351
"13089023419",135,3,7989,1045,217,1,55,0,9445
"13089023421",734,1,5468,2014,332,75,14,0,8638
"13089023422",64,2,3900,771,79,0,42,0,4858
"13089023423",340,24,6678,873,210,1,155,98,8379
"13089023424",110,35,4752,693,81,0,141,0,5812
"13089023425",50,0,4721,641,58,0,33,25,5528
"13089023426",11,2,4170,451,55,0,16,0,4705
"13089023427",0,1,2298,433,140,0,0,0,2872
"13089023428",126,43,6708,1900,195,62,4,0,9038
"13089023501",271,0,2139,1385,4,0,10,0,3809
"13089023504",59,27,1840,1693,0,162,8,183,3972
"13089023505",123,17,1780,420,101,7,0,0,2448
"13089023506",257,4,4266,1098,184,0,16,15,5840
"13089023507",121,180,3386,594,115,0,49,95,4540
"13089023601",544,13,1618,457,55,0,68,0,2755
"13089023602",95,68,1679,292,44,30,11,13,2232
"13089023603",209,34,2191,637,34,41,14,0,3160
"13089023700",673,110,2561,1496,64,38,95,193,5230
"13089023801",849,126,1683,591,56,137,34,0,3476
"13089023802",488,80,1568,928,74,1,71,0,3210
"13089023803",651,96,3659,1032,70,43,268,109,5928
"13089980000",0,0,0,0,0,0,0,0,0
"13091960100",1952,136,196,66,6,5,242,0,2603
"13091960200",1986,592,389,320,89,13,80,69,3538
"13091960300",3356,311,1739,543,281,152,0,116,6498
"13091960400",1788,633,634,417,39,0,120,0,3631
"13091960500",1270,189,263,136,7,36,12,0,1913
"13091960600",1327,193,186,87,38,0,13,16,1860
"13093970100",1581,368,1177,560,3,0,33,61,3783
"13093970200",531,222,847,301,99,231,110,298,2639
"13093970300",2364,818,2004,1023,15,2,34,276,6536
"13095000100",444,297,2108,2201,171,16,125,86,5448
"13095000200",0,36,1344,1815,39,178,0,210,3622
"13095000400",2269,317,2353,723,296,0,199,13,6170
"13095000501",1776,314,1766,451,160,183,87,0,4737
"13095000502",3051,147,1009,114,311,0,89,0,4721
"13095000600",1616,239,544,168,9,11,0,10,2597
"13095000700",743,234,546,219,9,11,15,38,1815
"13095000800",78,72,450,1057,12,19,12,6,1706
"13095000900",557,80,866,477,31,13,15,0,2039
"13095001000",294,141,741,742,57,12,21,0,2008
"13095001100",284,110,3643,2018,20,23,29,0,6127
"13095001403",0,0,1552,1374,0,0,0,0,2926
"13095001500",17,4,1027,1906,0,73,0,105,3132
"13095010302",201,100,2674,1783,127,41,18,14,4958
"13095010401",4084,88,2159,115,227,118,66,87,6944
"13095010402",720,89,1789,494,58,0,47,0,3197
"13095010403",951,59,426,99,29,0,10,0,1574
"13095010500",487,132,1320,329,14,3,0,0,2285
"13095010601",105,30,1424,1165,31,0,0,0,2755
"13095010602",521,123,2172,1389,20,1,0,0,4226
"13095010700",680,310,1700,2206,76,19,122,215,5328
"13095010900",491,85,908,249,47,23,0,0,1803
"13095011000",1218,289,1065,77,49,39,36,0,2773
"13095011200",924,370,1785,1102,56,115,10,194,4556
"13095011300",894,45,428,620,50,45,46,0,2128
"13095011400",11,154,787,424,0,0,8,102,1486
"13095011600",914,66,660,83,3,39,119,45,1929
"13097080102",1595,757,4163,391,400,317,342,709,8674
"13097080103",2105,780,2690,752,219,128,712,543,7929
"13097080201",3590,347,1468,508,260,179,964,179,7495
"13097080202",4125,634,3942,1144,275,254,1147,325,11846
"13097080301",2161,592,6002,2548,309,261,543,159,12575
"13097080303",1320,218,962,444,164,0,351,41,3500
"13097080304",2261,192,1478,375,0,113,92,52,4563
"13097080402",6950,398,673,67,51,32,366,12,8549
"13097080403",3192,304,901,241,401,47,63,60,5209
"13097080404",4303,653,2217,241,314,27,665,74,8494
"13097080505",2483,981,928,190,248,29,150,232,5241
"13097080506",3403,558,959,150,265,23,388,304,6050
"13097080507",2277,240,629,250,251,15,231,0,3893
"13097080508",3263,284,1377,309,335,195,633,0,6396
"13097080509",3597,15,793,323,104,16,191,15,5054
"13097080510",3565,1126,2126,357,411,56,237,292,8170
"13097080511",3953,341,3630,107,657,32,385,175,9280
"13097080602",2555,217,2012,367,281,35,82,0,5549
"13097080603",2711,296,2020,167,207,6,81,183,5671
"13097080604",3123,179,3676,955,239,464,270,0,8906
"13099090100",338,78,631,233,0,0,6,0,1286
"13099090200",932,103,763,553,0,3,0,0,2354
"13099090300",829,44,197,416,26,7,0,0,1519
"13099090400",1417,109,745,1326,45,0,49,4,3695
"13099090500",944,243,306,195,9,14,0,11,1722
"13101880100",906,654,37,36,222,7,211,155,2228
"13101880200",1390,230,0,6,228,337,301,346,2838
"13103030100",2256,250,349,17,74,0,16,0,2962
"13103030202",4156,315,1044,264,38,158,16,37,6028
"13103030203",5882,759,1149,0,88,15,178,0,8071
"13103030204",1746,235,529,845,10,11,13,34,3423
"13103030301",4157,223,104,15,95,11,8,11,4624
"13103030303",1813,211,51,10,46,0,48,15,2194
"13103030304",5818,714,657,44,208,29,585,32,8087
"13103030305",5202,311,1100,467,899,42,227,0,8248
"13103030401",3604,287,294,0,59,12,151,12,4419
"13103030402",4875,632,181,0,123,0,224,0,6035
"13105000100",2755,328,283,218,28,8,60,0,3680
"13105000200",1667,622,95,16,78,4,90,56,2628
"13105000300",2001,233,1076,610,0,123,297,123,4463
"13105000400",1664,427,733,780,250,9,273,39,4175
"13105000500",3182,242,1745,390,49,0,19,0,5627
"13107970100",2904,578,719,709,115,153,79,113,5370
"13107970200",1173,152,297,146,0,0,0,0,1768
"13107970300",1404,571,854,747,42,41,79,186,3924
"13107970400",1937,327,1188,1107,141,60,0,23,4783
"13107970500",905,188,138,28,21,0,0,0,1280
"13107970600",2548,872,778,389,183,328,166,328,5592
"13109970100",1584,303,331,80,144,362,149,457,3410
"13109970200",2182,479,842,340,109,21,100,141,4214
"13109970300",1433,314,667,656,113,306,200,234,3923
"13111050100",2813,570,0,0,16,16,130,48,3593
"13111050200",5245,915,0,0,50,32,19,3,6264
"13111050300",1870,397,0,0,0,128,0,0,2395
"13111050400",4577,1873,0,1,301,17,222,12,7003
"13111050500",3035,1414,0,7,53,6,12,0,4527
"13113140101",1885,428,3850,282,319,119,23,284,7190
"13113140102",3443,2,1379,179,404,202,336,0,5945
"13113140203",3620,303,1158,74,397,0,592,33,6177
"13113140204",2784,885,1662,16,99,31,494,529,6500
"13113140206",3393,108,336,0,303,0,154,0,4294
"13113140207",4845,87,299,0,364,0,201,0,5796
"13113140208",5013,674,767,266,755,24,824,154,8477
"13113140303",3730,301,128,0,331,15,214,15,4734
"13113140304",4904,288,309,22,451,0,602,0,6576
"13113140305",3230,380,480,91,424,114,369,154,5242
"13113140306",5851,290,351,255,593,79,298,131,7848
"13113140307",4356,61,410,0,133,0,234,0,5194
"13113140403",2472,180,2540,104,294,0,202,18,5810
"13113140404",2993,364,1319,87,693,0,148,0,5604
"13113140405",2571,185,471,181,149,23,41,0,3621
"13113140406",1963,171,922,142,421,81,293,0,3993
"13113140407",4207,140,2109,223,700,148,229,121,7877
"13113140408",2349,31,549,2,366,0,25,0,3322
"13113140501",4610,180,207,0,260,33,140,15,5445
"13113140502",3089,263,119,3,18,21,35,61,3609
"13115000100",3081,721,336,0,209,21,155,0,4523
"13115000201",4546,616,231,97,424,123,556,18,6611
"13115000202",3602,238,64,39,234,30,0,8,4215
"13115000300",1016,36,92,12,40,4,28,1,1229
"13115000400",3732,1482,593,371,287,369,476,614,7924
"13115000500",1248,691,399,209,319,478,530,721,4595
"13115000600",1493,631,976,704,91,159,241,193,4488
"13115000700",4102,696,266,52,37,0,24,316,5493
"13115000800",3496,231,720,152,92,0,77,0,4768
"13115000900",1715,259,29,257,50,26,0,9,2345
"13115001100",920,435,301,464,261,301,339,407,3428
"13115001200",1554,874,751,200,609,398,621,787,5794
"13115001300",3722,754,554,129,396,132,474,412,6573
"13115001400",5759,264,29,0,219,6,233,0,6510
"13115001600",985,593,1238,729,343,39,261,183,4371
"13115001701",5378,1226,99,2,125,14,185,23,7052
"13115001702",4541,499,981,79,260,30,45,0,6435
"13115001800",3509,896,19,72,129,102,245,66,5038
"13115002000",3778,913,26,69,69,16,111,18,5000
"13115002100",1199,691,1273,448,164,264,245,330,4614
"13117130101",3149,309,0,0,428,0,564,34,4484
"13117130102",2382,568,37,0,52,0,52,0,3091
"13117130103",3019,316,0,0,54,0,168,0,3557
"13117130104",3533,52,0,0,124,0,0,0,3709
"13117130105",1594,589,0,0,101,0,270,26,2580
"13117130201",3909,322,0,0,81,0,240,0,4552
"13117130202",3717,18,58,0,158,0,112,0,4063
"13117130203",4903,192,0,0,333,85,504,74,6091
"13117130204",3130,315,8,0,200,372,395,425,4845
"13117130205",1374,61,203,0,119,153,98,142,2150
"13117130301",3960,772,39,35,176,163,136,444,5725
"13117130302",4694,231,0,0,152,14,117,9,5217
"13117130303",3470,79,0,0,65,0,428,0,4042
"13117130304",4039,144,49,0,173,0,688,70,5163
"13117130305",3788,150,103,27,424,0,158,21,4671
"13117130306",3044,389,171,0,606,0,123,0,4333
"13117130307",2906,346,76,24,339,38,370,130,4229
"13117130403",5479,530,153,1,548,0,1348,0,8059
"13117130404",3056,56,197,68,1029,0,255,0,4661
"13117130405",3366,77,18,0,29,41,415,29,3975
"13117130406",3732,325,233,224,513,429,326,469,6251
"13117130408",2664,827,36,0,137,50,374,557,4645
"13117130409",1577,187,0,0,145,273,157,359,2698
"13117130410",2352,330,118,27,435,380,406,358,4406
"13117130503",2123,319,21,0,55,0,0,0,2518
"13117130504",2941,223,0,0,252,0,389,0,3805
"13117130505",2367,381,0,0,33,0,14,0,2795
"13117130506",3006,67,16,0,85,103,142,0,3419
"13117130507",2102,173,105,0,42,0,37,5,2464
"13117130508",4468,57,113,0,227,0,328,0,5193
"13117130509",2865,221,33,1,136,0,593,60,3909
"13117130510",4712,339,103,166,1034,57,534,172,7117
"13117130601",2696,191,216,0,253,42,323,0,3721
"13117130602",2689,231,521,1,762,165,988,202,5559
"13117130603",3029,35,124,15,813,76,247,0,4339
"13117130604",3911,134,177,0,1098,27,409,0,5756
"13117130605",3111,98,177,0,409,0,125,25,3945
"13117130606",3951,109,99,0,294,72,182,47,4754
"13117130607",3342,26,118,0,1340,26,318,52,5222
"13117130608",2377,12,395,0,1722,288,269,0,5063
"13117130609",3233,122,172,0,985,31,135,47,4725
"13117130610",3239,86,100,0,667,84,113,0,4289
"13117130611",3238,62,6,0,336,12,129,12,3795
"13117130612",5452,63,341,1,525,1,268,1,6652
"13117130613",2417,85,0,1,320,44,175,14,3056
"13119890101",2318,255,315,310,259,270,211,235,4173
"13119890102",3412,458,106,5,45,0,31,0,4057
"13119890200",3710,860,491,100,120,43,128,0,5452
"13119890300",2440,583,0,0,37,0,21,0,3081
"13119890400",3644,913,269,177,99,50,140,110,5402
"13121000100",3772,212,12,77,244,1,135,65,4518
"13121000200",5018,388,284,37,230,22,126,17,6122
"13121000400",1347,79,100,3,21,10,30,0,1590
"13121000500",2717,418,677,37,406,140,108,35,4538
"13121000600",1464,927,960,448,501,788,344,112,5544
"13121000700",402,108,107,134,52,42,0,14,859
"13121001001",692,233,51,15,144,36,71,38,1280
"13121001002",198,154,120,107,87,210,14,30,920
"13121001100",2384,214,419,101,356,13,123,12,3622
"13121001201",2364,350,366,120,375,47,160,15,3797
"13121001202",1954,55,417,19,876,180,169,0,3670
"13121001300",2426,300,547,299,400,36,299,14,4321
"13121001400",1589,155,104,45,187,0,76,0,2156
"13121001500",3162,234,198,203,86,84,246,30,4243
"13121001600",1629,156,372,22,59,0,124,13,2375
"13121001700",1026,115,948,1003,230,36,30,104,3492
"13121001800",1195,176,1002,1264,402,92,61,99,4291
"13121001900",690,141,470,392,171,43,131,0,2038
"13121002100",635,126,686,867,34,75,21,0,2444
"13121002300",0,5,616,515,11,25,0,0,1172
"13121002400",105,0,1312,269,9,22,76,0,1793
"13121002500",26,21,956,789,0,38,18,50,1898
"13121002600",109,32,479,171,0,78,0,78,947
"13121002800",428,143,371,643,50,21,99,3,1758
"13121002900",1067,131,524,106,162,63,79,0,2132
"13121003000",1968,155,243,0,259,0,142,0,2767
"13121003100",658,95,811,204,43,8,17,0,1836
"13121003200",1202,138,452,86,152,0,56,0,2086
"13121003500",491,65,371,567,80,61,16,40,1691
"13121003600",111,7,637,130,68,0,32,0,985
"13121003700",0,0,0,0,0,0,0,0,0
"13121003800",0,0,230,75,2,0,0,0,307
"13121003900",73,10,627,677,0,0,0,0,1387
"13121004000",24,0,1514,922,23,0,0,0,2483
"13121004100",52,0,1272,600,43,34,9,0,2010
"13121004200",119,85,1629,645,19,35,6,29,2567
"13121004300",54,17,516,300,18,0,0,9,914
"13121004400",0,37,1152,613,27,0,0,9,1838
"13121004800",15,40,251,445,5,66,1,58,881
"13121004900",1070,190,871,497,121,0,149,4,2902
"13121005000",1145,326,362,33,197,54,186,83,2386
"13121005200",2792,262,598,377,114,59,45,59,4306
"13121005300",1800,164,1322,357,164,22,192,0,4021
"13121005501",187,127,1050,943,244,37,45,21,2654
"13121005502",99,31,1149,1058,7,6,0,21,2371
"13121005700",48,8,613,793,0,0,14,6,1482
"13121005800",75,10,763,667,26,13,0,0,1554
"13121006000",93,68,1725,1338,30,32,23,136,3445
"13121006100",19,63,2078,1305,119,0,54,0,3638
"13121006200",117,0,700,601,21,82,33,0,1554
"13121006300",7,0,985,891,0,0,0,0,1883
"13121006400",144,36,223,437,120,7,174,0,1141
"13121006500",464,65,2382,881,127,0,109,0,4028
"13121006601",316,56,824,694,40,5,29,7,1971
"13121006602",0,0,350,581,17,28,0,0,976
"13121006700",251,62,1515,1521,66,9,19,11,3454
"13121006801",0,0,0,0,0,0,0,0,0
"13121006802",0,0,278,1721,0,0,0,0,1999
"13121006900",1252,351,1061,619,363,104,597,224,4571
"13121007001",83,31,2374,1578,7,117,9,58,4257
"13121007002",53,194,1246,627,0,22,10,24,2176
"13121007100",0,23,1160,1028,0,1,0,1,2213
"13121007200",5,2,1139,596,9,91,0,0,1842
"13121007300",140,23,4204,3087,76,25,56,0,7611
"13121007400",246,293,897,838,178,6,202,97,2757
"13121007500",206,63,1686,1362,207,56,172,51,3803
"13121007602",1,2,1792,815,73,96,109,0,2888
"13121007603",87,32,2065,2287,92,31,11,40,4645
"13121007604",0,0,932,1307,12,8,0,0,2259
"13121007703",0,0,3075,809,0,0,0,0,3884
"13121007704",116,145,3297,1244,241,0,359,145,5547
"13121007705",18,39,2680,1591,52,87,45,11,4523
"13121007706",219,0,7180,1254,136,9,41,165,9004
"13121007802",24,0,7618,1828,63,91,22,81,9727
"13121007805",27,202,2292,609,6,19,4,202,3361
"13121007806",15,138,4441,1426,0,0,44,138,6202
"13121007807",0,73,1481,960,29,342,29,398,3312
"13121007808",0,47,1495,2527,27,228,70,266,4660
"13121007900",59,34,4522,661,196,0,1,0,5473
"13121008000",126,35,3422,1302,87,0,49,0,5021
"13121008101",5,0,844,386,0,0,0,0,1235
"13121008102",137,252,3930,2443,185,109,349,361,7766
"13121008201",37,53,4947,2062,74,0,153,271,7597
"13121008202",6,0,1542,566,6,0,6,0,2126
"13121008301",69,41,1521,848,26,18,0,0,2523
"13121008302",9,0,1316,555,0,4,0,0,1884
"13121008400",10,141,1691,1331,7,0,10,0,3190
"13121008500",71,0,2395,1790,57,0,0,0,4313
"13121008601",0,0,2692,2097,38,1,0,1,4829
"13121008602",35,1,808,459,14,10,0,0,1327
"13121008700",205,0,2352,1763,20,0,34,0,4374
"13121008800",3096,220,1045,455,289,300,500,300,6205
"13121008902",3265,608,974,381,762,239,311,133,6673
"13121008903",1170,111,133,125,251,212,612,264,2878
"13121008904",3308,355,517,88,344,59,118,132,4921
"13121009000",3751,58,101,72,296,68,179,6,4531
"13121009101",3043,250,696,115,292,34,83,0,4513
"13121009102",1786,256,636,150,295,80,101,35,3339
"13121009200",3277,819,1059,113,450,93,573,441,6825
"13121009300",3834,163,193,14,16,21,311,0,4552
"13121009402",2548,427,861,120,972,34,1512,199,6673
"13121009403",2798,302,827,345,784,478,1512,0,7046
"13121009404",3334,156,641,0,367,32,466,0,4996
"13121009501",3704,79,83,0,41,20,24,0,3951
"13121009502",2080,267,411,94,128,0,82,10,3072
"13121009601",1837,217,53,11,108,261,0,345,2832
"13121009602",3546,227,340,0,536,0,204,0,4853
"13121009603",2593,228,291,116,280,108,353,0,3969
"13121009700",3839,117,75,0,104,0,183,0,4318
"13121009801",4008,142,115,9,155,0,29,0,4458
"13121009802",3314,117,220,54,349,51,107,0,4212
"13121009900",4298,100,15,47,329,0,37,0,4826
"13121010001",3666,94,182,16,248,51,54,0,4311
"13121010002",5762,79,649,0,352,27,183,0,7052
"13121010106",2562,146,372,167,385,48,317,0,3997
"13121010107",1782,59,5,15,77,0,41,5,1984
"13121010108",3136,79,201,0,296,20,90,22,3844
"13121010110",3164,232,723,75,639,16,348,0,5197
"13121010113",4257,1034,927,110,294,556,2030,1012,10220
"13121010114",5160,968,323,126,224,67,1410,649,8927
"13121010115",1868,25,218,13,209,0,129,0,2462
"13121010117",1381,287,751,50,485,0,291,172,3417
"13121010118",1344,400,1644,1092,446,131,585,186,5828
"13121010119",1099,246,1847,1039,602,214,395,194,5636
"13121010120",982,124,754,107,56,0,92,0,2115
"13121010121",1539,67,150,11,214,9,41,0,2031
"13121010122",2688,130,685,95,2012,93,626,84,6413
"13121010123",2714,358,1101,549,87,0,617,222,5648
"13121010204",4571,264,204,0,126,15,150,0,5330
"13121010205",4042,180,221,29,159,56,10,43,4740
"13121010206",4235,352,158,0,229,0,110,28,5112
"13121010208",2023,343,1034,105,237,126,131,0,3999
"13121010209",2227,113,2371,97,497,10,596,10,5921
"13121010210",3558,277,1171,142,254,0,206,196,5804
"13121010211",3162,198,248,48,175,0,614,119,4564
"13121010212",3086,542,780,55,442,309,1468,418,7100
"13121010301",818,116,12616,1766,389,103,193,9,16010
"13121010303",74,36,8624,959,53,0,84,36,9866
"13121010304",651,53,11759,258,264,135,385,82,13587
"13121010400",4441,246,2682,588,260,91,854,68,9230
"13121010507",27,0,5418,1918,103,210,42,0,7718
"13121010508",61,43,2788,826,181,58,181,78,4216
"13121010510",1162,1011,10802,2705,487,36,412,692,17307
"13121010511",406,39,6788,683,144,0,79,0,8139
"13121010512",261,90,3911,2058,64,172,68,0,6624
"13121010513",1506,424,7982,2205,674,198,1178,268,14435
"13121010514",1233,154,8159,818,986,93,550,93,12086
"13121010515",451,92,3385,695,51,0,68,86,4828
"13121010516",132,0,6578,1139,165,0,202,0,8216
"13121010601",901,180,796,1221,93,26,239,113,3569
"13121010603",0,37,2014,1326,48,31,33,24,3513
"13121010604",26,5,1675,640,412,183,369,187,3497
"13121010800",2483,442,1230,606,536,1222,853,1389,8761
"13121011000",231,366,941,1151,238,175,369,464,3935
"13121011100",799,153,939,86,167,0,92,13,2249
"13121011201",620,132,1742,644,271,76,331,189,4005
"13121011202",933,464,2454,943,251,368,335,781,6529
"13121011301",448,94,3120,637,80,81,400,99,4959
"13121011303",682,148,5909,991,474,748,754,871,10577
"13121011305",162,0,2599,1578,26,0,38,22,4425
"13121011306",53,0,1652,852,70,0,5,0,2632
"13121011405",4417,1006,1303,332,432,309,1389,554,9742
"13121011410",4982,286,712,23,1284,65,496,17,7865
"13121011411",5145,330,604,47,453,23,355,0,6957
"13121011412",7129,183,816,56,803,71,959,71,10088
"13121011414",4799,168,1599,45,704,42,649,42,8048
"13121011416",4538,103,80,5,600,0,205,17,5548
"13121011417",3928,219,126,1,213,0,191,20,4698
"13121011418",5914,248,90,0,190,15,0,0,6457
"13121011419",4217,492,381,30,292,0,108,0,5520
"13121011420",3241,1485,1212,375,1351,318,3708,1528,13218
"13121011421",2057,147,1068,175,388,220,927,322,5304
"13121011422",3183,89,679,133,113,5,211,43,4456
"13121011423",3900,142,159,83,498,19,39,19,4859
"13121011424",3803,36,905,17,682,144,272,0,5859
"13121011425",5436,83,358,0,1413,0,176,0,7466
"13121011426",2280,28,116,0,160,3,440,0,3027
"13121011427",5489,160,379,0,894,57,467,0,7446
"13121011503",7827,211,117,164,551,31,347,0,9248
"13121011504",10162,134,1597,0,729,26,506,0,13154
"13121011505",3829,144,365,50,315,0,105,0,4808
"13121011506",5331,105,473,0,345,24,93,24,6395
"13121011610",3346,305,526,18,843,60,80,0,5178
"13121011611",3880,621,623,231,1275,293,1223,591,8737
"13121011612",2577,24,162,22,354,20,23,0,3182
"13121011613",3696,788,848,0,1055,93,334,642,7456
"13121011614",7439,241,2208,519,3212,186,784,45,14634
"13121011615",7718,314,716,3,824,0,627,0,10202
"13121011616",2912,33,964,107,973,39,838,22,5888
"13121011617",5918,264,281,15,574,15,120,0,7187
"13121011618",2786,211,133,13,982,0,208,0,4333
"13121011619",3815,66,459,69,2881,120,831,0,8241
"13121011620",6599,242,470,2,2244,96,647,74,10374
"13121011621",4343,92,583,0,1504,32,394,0,6948
"13121011622",4314,28,476,0,4470,464,438,0,10190
"13121011623",6132,182,1287,58,4067,625,293,0,12644
"13121011624",3187,32,387,11,755,0,59,0,4431
"13121011625",4298,36,920,170,2068,184,521,0,8197
"13121011626",3387,414,2076,14,2652,78,902,0,9523
"13121011800",178,272,757,1450,28,206,35,113,3039
"13121011900",554,217,814,377,6,121,39,7,2135
"13121012000",43,20,961,1109,218,82,119,35,2587
"13121012300",752,81,820,497,201,0,74,244,2669
"13121980000",0,0,0,0,0,0,0,0,0
"13123080100",3219,769,0,0,22,0,10,100,4120
"13123080200",4440,649,0,8,339,7,284,7,5734
"13123080300",3936,1429,13,75,207,577,305,817,7359
"13123080400",6475,1194,6,16,368,456,557,658,9730
"13123080500",2821,857,0,0,15,9,62,0,3764
"13125010100",2160,526,163,41,26,74,44,10,3044
"13127000101",947,106,42,0,14,0,0,0,1109
"13127000102",2695,181,57,76,156,24,28,0,3217
"13127000200",4439,69,0,22,81,35,42,0,4688
"13127000300",5106,413,131,105,294,209,184,224,6666
"13127000401",5199,382,1049,325,278,251,252,327,8063
"13127000403",2561,60,441,8,197,0,96,0,3363
"13127000404",8281,578,1343,375,441,353,416,213,12000
"13127000501",1227,273,1380,558,84,0,10,0,3532
"13127000503",1907,310,951,553,495,31,254,81,4582
"13127000504",986,123,1362,1044,350,0,311,0,4176
"13127000600",4121,514,175,549,73,61,278,61,5832
"13127000700",1937,711,2138,1803,68,143,31,0,6831
"13127000800",127,244,1307,1569,375,43,304,101,4070
"13127000900",1360,385,921,785,485,474,770,634,5814
"13127001000",7127,929,385,368,664,106,404,37,10020
"13127990000",0,0,0,0,0,0,0,0,0
"13129970100",4320,1488,0,1,34,239,194,239,6515
"13129970200",6316,846,384,37,111,0,188,0,7882
"13129970300",5392,1528,355,76,404,390,1023,894,10062
"13129970400",3462,677,146,69,474,9,671,125,5633
"13129970500",2609,615,130,204,321,550,640,689,5758
"13129970600",3491,733,394,242,527,721,1374,836,8318
"13129970700",3451,577,6,0,68,0,110,0,4212
"13129970800",4690,547,98,18,233,155,357,165,6263
"13129970900",5451,1587,78,36,72,70,196,70,7560
"13131950100",1480,454,13,119,18,126,4,190,2404
"13131950200",1805,269,78,369,42,52,2,0,2617
"13131950300",1268,306,907,1714,9,218,0,205,4627
"13131950400",4144,681,508,446,125,649,601,741,7895
"13131950500",3326,460,1922,719,97,305,317,271,7417
"13131950600",1323,252,222,150,26,154,30,157,2314
"13133950100",1264,134,543,248,0,6,0,0,2195
"13133950200",897,232,572,459,45,58,42,39,2344
"13133950301",1741,58,0,0,4,5,66,0,1874
"13133950302",1825,21,246,224,9,63,0,4,2392
"13133950303",1102,292,1621,938,288,186,489,283,5199
"13133950400",417,146,638,211,0,0,0,0,1412
"13133950500",897,163,230,103,24,0,24,0,1441
"13135050103",6828,792,629,170,802,642,1834,834,12531
"13135050105",2251,622,507,183,227,297,886,620,5593
"13135050106",6064,1855,830,56,1079,28,1712,1464,13088
"13135050107",4758,203,922,176,681,104,510,0,7354
"13135050108",6549,216,851,51,1468,727,441,652,10955
"13135050109",4087,420,1151,227,625,98,696,268,7572
"13135050205",2036,248,684,171,944,89,515,110,4797
"13135050208",3514,182,1519,128,1223,200,970,231,7967
"13135050209",3230,494,1461,136,3203,867,846,324,10561
"13135050210",3342,371,624,0,1560,391,642,455,7385
"13135050211",762,451,949,406,1595,924,1022,1135,7244
"13135050212",9402,11,1177,0,1895,248,502,0,13235
"13135050213",6680,536,1537,175,3446,537,1123,90,14124
"13135050214",4437,209,808,52,2419,223,437,54,8639
"13135050215",613,33,1021,48,1221,363,158,107,3564
"13135050216",3314,152,412,58,3939,544,168,20,8607
"13135050217",4762,87,1055,87,2962,270,689,161,10073
"13135050218",1685,103,772,76,2047,0,1619,0,6302
"13135050219",1523,87,718,179,940,135,246,29,3857
"13135050220",2197,248,1227,609,1603,457,953,201,7495
"13135050304",1578,532,1049,323,1037,905,1249,1026,7699
"13135050306",1346,584,267,158,1310,1103,1906,1414,8088
"13135050308",2934,17,0,0,791,38,62,38,3880
"13135050309",4334,196,1652,158,1580,175,349,4,8448
"13135050310",3138,73,790,368,716,27,293,52,5457
"13135050311",1544,90,346,91,519,30,101,0,2721
"13135050313",3130,255,845,374,1510,736,1474,725,9049
"13135050314",3399,423,1720,396,3361,831,2828,792,13750
"13135050315",2057,173,1549,654,330,614,557,638,6572
"13135050317",591,113,1330,184,1080,263,1099,301,4961
"13135050318",556,384,1108,194,232,34,261,342,3111
"13135050319",1142,588,1189,136,1342,923,2051,1292,8663
"13135050320",1375,515,489,249,951,1725,1349,1889,8542
"13135050321",3828,102,44,0,489,14,232,0,4709
"13135050322",3980,40,81,0,241,35,93,15,4485
"13135050410",1807,401,615,206,1340,737,1125,896,7127
"13135050415",1481,60,1448,91,461,19,134,39,3733
"13135050416",1175,287,1713,202,104,0,200,210,3891
"13135050417",984,562,732,420,1815,1387,2099,1802,9801
"13135050418",1258,685,1295,290,1886,1280,2129,1749,10572
"13135050419",2426,420,1027,239,2566,1587,2674,1826,12765
"13135050421",1249,519,1868,260,2436,1253,2094,1503,11182
"13135050422",1661,851,823,536,2814,1719,2761,2277,13442
"13135050423",1423,348,819,933,2082,1231,1743,1008,9587
"13135050424",2470,690,1297,311,2068,1101,2682,1639,12258
"13135050425",3600,72,585,81,908,232,274,66,5818
"13135050426",4278,201,901,52,789,211,481,0,6913
"13135050427",4003,304,462,82,747,402,620,507,7127
"13135050428",3744,284,887,0,1721,59,571,44,7310
"13135050429",4779,245,936,1,1023,55,631,0,7670
"13135050430",2589,338,1041,106,828,79,493,19,5493
"13135050431",1656,296,2327,316,2123,861,1241,783,9603
"13135050432",1597,248,1354,100,2719,227,1579,140,7964
"13135050433",1030,81,349,80,530,266,792,230,3358
"13135050434",2001,409,829,530,2033,2010,2374,2414,12600
"13135050435",1419,251,834,98,1129,263,1450,371,5815
"13135050436",1326,744,2100,297,2353,678,1565,1103,10166
"13135050511",3386,685,2209,389,2902,767,1759,929,13026
"13135050520",1890,435,900,464,782,163,947,290,5871
"13135050521",1963,347,730,111,538,443,417,486,5035
"13135050522",2347,305,893,397,800,419,652,389,6202
"13135050523",3183,99,2491,340,937,18,860,0,7928
"13135050524",1460,423,1192,162,1554,200,1658,293,6942
"13135050525",5021,404,698,87,1613,176,1075,109,9183
"13135050526",1278,66,1424,133,1156,263,1206,69,5595
"13135050527",4121,219,900,416,916,0,1300,0,7872
"13135050528",2829,69,965,32,1131,50,549,0,5625
"13135050529",1661,91,493,147,958,521,202,369,4442
"13135050530",3020,180,1114,73,1644,69,390,9,6499
"13135050531",2609,560,1838,172,1667,923,1418,1041,10228
"13135050532",3108,370,2510,471,1121,205,1364,318,9467
"13135050533",1518,172,1981,0,3217,930,1799,782,10399
"13135050534",2092,460,1787,125,2732,20,2228,233,9677
"13135050535",1970,370,1664,306,1296,716,1172,717,8211
"13135050536",1735,255,1465,328,1251,52,1134,214,6434
"13135050537",1010,264,1380,586,918,132,1021,329,5640
"13135050538",5091,316,958,26,1957,0,1032,268,9648
"13135050539",932,249,1142,589,1105,819,1076,867,6779
"13135050540",3431,50,2529,73,669,295,1305,30,8382
"13135050541",1467,373,2019,534,1061,695,1948,792,8889
"13135050542",1045,751,1336,524,1021,346,1134,760,6917
"13135050543",2306,86,2191,112,1564,298,690,222,7469
"13135050544",4181,666,3539,452,2703,257,866,617,13281
"13135050545",5346,186,4107,687,1603,21,3201,36,15187
"13135050546",5535,977,5663,626,1591,989,1247,1727,18355
"13135050547",4634,602,890,391,870,472,278,411,8548
"13135050548",5941,387,1385,366,835,72,685,0,9671
"13135050549",3104,3,574,45,1277,0,665,0,5668
"13135050605",8820,1470,1226,137,1405,169,1906,947,16080
"13135050606",14195,929,3184,153,2351,128,2240,24,23204
"13135050607",10084,289,2874,241,772,651,1816,221,16948
"13135050608",10776,448,2990,422,566,554,1667,554,17977
"13135050609",8522,473,958,10,853,280,1049,0,12145
"13135050610",12311,478,2017,318,1656,47,1720,0,18547
"13135050709",3578,612,5765,1036,503,279,504,645,12922
"13135050712",4419,492,811,0,909,45,569,90,7335
"13135050713",4754,487,1061,19,1369,86,0,323,8099
"13135050714",3004,79,904,200,806,19,417,0,5429
"13135050715",3375,266,512,117,931,0,651,190,6042
"13135050718",5481,290,1086,103,809,66,624,0,8459
"13135050719",2079,191,2177,439,243,0,394,59,5582
"13135050720",4720,616,1917,63,245,0,145,0,7706
"13135050721",5011,311,2500,838,651,78,1116,138,10643
"13135050722",786,263,1566,231,309,421,262,445,4283
"13135050723",1923,2,3763,263,692,88,478,0,7209
"13135050724",8260,581,4174,523,1058,359,749,56,15760
"13135050725",1884,46,2422,390,435,17,172,10,5376
"13135050726",5556,477,1439,217,1001,169,488,207,9554
"13135050727",5694,677,2207,19,782,398,463,368,10608
"13135050728",4597,805,7318,1058,385,78,344,263,14848
"13135050729",1193,110,1357,263,418,14,359,0,3714
"13135050730",3353,183,3116,225,312,0,569,47,7805
"13135050731",4788,279,3148,507,362,20,650,169,9923
"13137000100",2963,333,26,0,117,93,20,0,3552
"13137000201",2841,610,20,0,69,0,0,0,3540
"13137000202",4924,523,18,0,49,0,288,0,5802
"13137000300",2797,565,69,26,107,80,235,142,4021
"13137000400",3644,1026,28,4,488,182,630,94,6096
"13137000500",3831,1327,274,184,628,69,437,4,6754
"13137000601",2939,689,32,23,281,87,517,242,4810
"13137000602",5447,1704,134,108,224,782,1149,1763,11311
"13139000101",3070,735,228,0,306,0,414,56,4809
"13139000102",2664,616,190,0,46,20,430,47,4013
"13139000201",4539,991,0,0,396,58,512,400,6896
"13139000203",4028,158,0,0,79,0,0,0,4265
"13139000204",3830,602,0,16,76,0,184,78,4786
"13139000302",5430,197,74,0,442,36,833,0,7012
"13139000303",2398,380,0,0,14,0,11,31,2834
"13139000304",2551,468,1,2,9,163,206,308,3708
"13139000305",3518,314,167,151,156,90,192,1,4589
"13139000400",4266,823,188,245,54,88,231,406,6301
"13139000500",5355,883,43,160,446,320,589,794,8590
"13139000600",3674,1281,156,238,220,264,482,808,7123
"13139000701",1838,1212,1500,263,834,100,1745,910,8402
"13139000702",2806,621,333,93,1162,99,2145,596,7855
"13139000800",675,392,721,436,343,212,728,497,4004
"13139000900",2963,1175,607,69,17,670,204,1524,7229
"13139001002",4528,1072,281,29,614,6,2096,868,9494
"13139001003",2850,1335,353,505,777,375,3097,1114,10406
"13139001004",1873,131,365,381,430,112,503,62,3857
"13139001101",1109,1539,74,117,1278,543,2265,2021,8946
"13139001102",1570,1132,131,43,966,459,1573,1326,7200
"13139001201",3992,1917,293,376,169,162,1783,1468,10160
"13139001202",3654,1095,342,196,1175,65,2869,919,10315
"13139001301",3672,809,182,0,921,70,1315,530,7499
"13139001302",4546,459,49,14,46,0,158,25,5297
"13139001402",4042,824,216,35,332,33,579,502,6563
"13139001403",2193,383,172,30,873,127,1020,197,4995
"13139001404",3760,325,601,1,456,18,1487,225,6873
"13139001501",3289,122,117,17,278,18,355,0,4196
"13139001502",4170,692,240,0,97,0,933,0,6132
"13139001603",3455,436,57,12,457,431,146,359,5353
"13139001604",5227,383,294,82,73,0,527,0,6586
"13139001605",4209,279,321,63,173,152,211,136,5544
"13139001606",2256,521,400,0,87,60,499,123,3946
"13139001607",3990,462,132,21,213,21,517,18,5374
"13139001608",4496,380,176,27,100,0,446,0,5625
"13141480300",878,65,1094,179,10,0,0,0,2226
"13141480400",549,335,2704,1744,33,0,0,0,5365
"13143010100",2913,658,47,3,65,22,0,0,3708
"13143010200",4695,840,84,109,174,51,46,15,6014
"13143010301",2172,811,251,29,31,9,0,0,3303
"13143010302",5441,1488,140,189,139,60,18,57,7532
"13143010400",5000,1963,240,91,310,80,158,24,7866
"13145120198",2952,155,1402,296,108,44,105,15,5077
"13145120200",2361,260,650,171,17,0,43,0,3502
"13145120300",6961,727,1023,123,379,46,185,0,9444
"13145120401",5834,74,92,12,231,3,199,0,6445
"13145120402",5626,492,1442,103,272,36,372,0,8343
"13147960100",4452,1059,164,71,73,126,109,128,6182
"13147960200",2775,252,85,70,10,25,0,23,3240
"13147960300",1582,885,363,325,20,0,0,48,3223
"13147960400",3185,923,989,811,21,21,16,28,5994
"13147960500",3085,973,1159,709,393,5,327,159,6810
"13149970100",2914,1008,268,83,159,29,210,5,4676
"13149970200",3040,811,198,117,27,4,19,8,4224
"13149970300",1731,642,330,79,86,40,0,0,2908
"13151070104",3765,158,5156,735,1580,773,434,0,12601
"13151070106",2973,478,1492,129,322,0,187,0,5581
"13151070107",1842,324,4453,217,205,31,146,0,7218
"13151070108",768,91,3389,177,226,0,381,0,5032
"13151070109",1793,63,1101,66,93,49,62,0,3227
"13151070110",4012,359,2105,562,509,0,383,0,7930
"13151070111",2491,188,4351,824,375,51,1033,147,9460
"13151070113",2167,340,557,77,484,71,732,71,4499
"13151070114",1187,99,2839,532,647,93,116,85,5598
"13151070202",8641,434,1434,51,341,58,384,0,11343
"13151070203",10629,605,3027,86,541,0,539,0,15427
"13151070204",2912,96,997,50,167,0,124,0,4346
"13151070205",4204,1088,3310,168,773,859,163,992,11557
"13151070304",3448,601,4368,2107,318,105,325,212,11484
"13151070305",3776,171,2920,420,1492,171,663,0,9613
"13151070306",4846,492,3324,54,762,76,577,330,10461
"13151070307",2214,74,1629,52,343,1,354,1,4668
"13151070309",2925,28,2611,237,1237,106,487,0,7631
"13151070310",3044,317,537,1,101,19,196,0,4215
"13151070311",3446,385,5849,923,809,221,621,284,12538
"13151070402",10039,943,1361,159,306,22,265,22,13117
"13151070403",7408,628,2288,21,207,24,424,40,11040
"13151070404",3931,82,1957,723,278,24,107,24,7126
"13151070501",2473,1035,1882,330,426,211,157,367,6881
"13151070502",7118,1186,3633,864,745,39,640,30,14255
"13153020105",2341,910,1395,1069,111,69,154,24,6073
"13153020106",1748,302,823,22,155,5,66,26,3147
"13153020108",3292,601,750,73,347,33,132,50,5278
"13153020109",4534,466,1898,441,1189,39,683,39,9289
"13153020200",2580,1015,863,880,193,68,295,63,5957
"13153020300",1201,505,2478,1542,322,320,193,398,6959
"13153020400",876,321,850,560,316,711,360,696,4690
"13153020600",689,23,113,0,75,7,99,0,1006
"13153020700",749,199,1282,698,257,180,115,165,3645
"13153020800",1166,239,842,182,170,132,156,176,3063
"13153020900",2486,255,756,182,104,29,135,0,3947
"13153021000",3358,692,1123,483,420,83,341,0,6500
"13153021103",6928,202,1508,134,705,0,525,0,10002
"13153021104",4409,661,1423,450,465,272,502,120,8302
"13153021105",3113,318,1867,299,884,175,874,0,7530
"13153021107",4904,449,1880,435,422,12,335,175,8612
"13153021108",4438,376,1200,282,306,93,142,133,6970
"13153021113",11744,162,3506,345,1487,75,551,33,17903
"13153021201",5333,242,1013,0,699,0,151,102,7540
"13153021202",3489,268,2109,444,10,0,228,74,6622
"13153021300",1860,315,1070,820,75,160,21,64,4385
"13153021400",5595,235,1245,396,292,33,321,49,8166
"13153021500",2916,302,921,192,84,0,35,13,4463
"13155950100",2013,339,49,0,9,0,3,21,2434
"13155950200",3289,730,1526,748,58,55,49,10,6465
"13157010101",4729,778,122,0,128,0,342,0,6099
"13157010102",5551,245,101,11,498,7,227,0,6640
"13157010103",4848,385,237,34,148,53,566,74,6345
"13157010200",3495,863,56,133,327,40,149,160,5223
"13157010300",2729,845,425,385,211,83,400,52,5130
"13157010400",3426,898,101,178,130,40,105,0,4878
"13157010500",3576,914,94,55,78,4,98,418,5237
"13157010600",5832,1681,491,192,148,43,313,412,9112
"13157010701",1582,162,208,5,0,13,13,0,1983
"13157010702",7573,711,315,631,500,17,432,0,10179
"13157010703",2397,76,294,58,86,0,107,0,3018
"13159010100",1349,314,256,211,61,28,72,5,2296
"13159010200",2425,483,10,24,36,0,6,0,2984
"13159010500",4696,845,1685,701,159,349,22,435,8892
"13161960100",4650,1321,304,0,59,382,265,592,7573
"13161960200",3240,927,1105,697,463,12,602,27,7073
"13161960300",1186,270,183,39,61,0,61,0,1800
"13163960100",2146,192,1230,887,238,0,206,17,4916
"13163960200",1318,178,403,92,12,4,156,0,2163
"13163960300",1786,281,1489,2250,33,0,55,0,5894
"13163960400",983,85,1394,1098,20,6,20,56,3662
"13165960100",2618,655,1594,734,76,219,38,309,6243
"13165960200",1442,375,212,430,74,90,35,90,2748
"13167960100",2016,419,107,114,38,0,0,0,2694
"13167960200",1789,138,1321,774,182,45,0,0,4249
"13167960300",1048,209,288,273,11,34,9,0,1872
"13169030101",2320,273,205,19,94,17,267,0,3195
"13169030103",1974,235,47,31,13,0,0,0,2300
"13169030104",2808,1254,2307,838,74,16,18,0,7315
"13169030200",1714,260,784,113,22,13,0,0,2906
"13169030301",4694,170,1555,308,107,31,19,31,6915
"13169030302",4339,853,578,248,0,20,0,0,6038
"13171970100",4613,1278,603,193,248,1,228,28,7192
"13171970200",2861,571,1763,352,77,0,0,0,5624
"13171970300",2002,285,1436,518,160,4,34,4,4443
"13173950100",1205,465,176,11,208,139,34,45,2283
"13173950200",4386,1004,1155,775,125,242,102,279,8068
"13175950100",1746,488,891,239,0,17,79,17,3477
"13175950201",3316,268,507,391,158,98,27,0,4765
"13175950202",2776,205,721,94,187,26,92,41,4142
"13175950300",336,32,662,749,5,29,0,19,1832
"13175950400",1097,216,1000,826,238,12,24,0,3413
"13175950500",1871,411,944,367,31,0,64,0,3688
"13175950600",1258,224,448,119,68,0,109,0,2226
"13175950700",1706,580,106,101,0,6,0,6,2505
"13175950800",1372,221,1553,717,91,0,118,42,4114
"13175950900",28,16,1152,1551,35,0,0,14,2796
"13175951000",4225,1138,1536,913,59,45,178,92,8186
"13175951100",2823,724,402,317,83,1,84,0,4434
"13175951400",1800,299,138,177,31,0,6,97,2548
"13177020100",4900,467,1234,70,110,0,166,0,6947
"13177020200",553,171,425,90,1,0,0,0,1240
"13177020300",4128,529,546,223,181,140,129,108,5984
"13177020402",5514,483,898,507,374,18,81,0,7875
"13177020403",4236,354,784,10,365,0,65,16,5830
"13179010101",2740,1370,1080,251,683,126,984,168,7402
"13179010102",239,18,121,37,140,46,42,0,643
"13179010103",555,60,623,7,55,16,157,0,1473
"13179010202",1512,343,1335,384,780,136,552,87,5129
"13179010204",542,272,1455,463,209,236,118,114,3409
"13179010205",1868,243,1562,663,510,129,303,160,5438
"13179010206",2159,309,1335,866,306,30,191,67,5263
"13179010207",1596,139,2192,722,893,0,614,70,6226
"13179010208",1833,431,2301,428,686,160,804,26,6669
"13179010300",3067,185,2049,877,1212,54,823,137,8404
"13179010400",2988,220,2962,887,623,212,810,141,8843
"13179010501",3037,335,242,10,112,0,0,0,3736
"13179010502",2261,381,1465,334,156,5,175,15,4792
"13179010600",290,33,1179,269,8,0,14,0,1793
"13179990000",0,0,0,0,0,0,0,0,0
"13181970100",1655,544,760,594,54,12,4,8,3631
"13181970200",2482,446,762,419,33,56,0,13,4211
"13183970100",4729,696,1814,263,523,435,809,579,9848
"13183970200",3673,671,1145,683,275,147,335,110,7039
"13183980000",0,0,0,0,0,0,0,0,0
"13185010101",2469,365,770,600,332,43,200,147,4926
"13185010102",3161,307,1030,415,121,250,114,250,5648
"13185010103",2137,119,682,29,224,87,114,0,3392
"13185010201",1794,137,242,0,44,0,35,0,2252
"13185010202",8959,457,877,298,693,93,789,186,12352
"13185010301",3227,528,788,185,452,22,201,77,5480
"13185010302",2540,157,28,11,58,0,66,0,2860
"13185010401",1375,129,155,54,20,0,68,12,1813
"13185010402",1356,145,3299,1535,555,253,178,0,7321
"13185010500",620,165,2146,1687,108,15,191,62,4994
"13185010601",1732,580,1366,752,338,280,224,0,5272
"13185010604",2719,267,1183,513,406,95,255,0,5438
"13185010700",2656,229,609,108,55,27,98,0,3782
"13185010800",379,136,2490,2221,153,9,277,110,5775
"13185010900",285,34,912,643,24,25,0,0,1923
"13185011000",92,79,1898,1313,182,238,42,185,4029
"13185011100",834,659,134,166,50,49,10,13,1915
"13185011200",2665,1087,433,174,241,26,245,80,4951
"13185011301",948,1377,813,1684,87,161,39,267,5376
"13185011302",350,388,861,652,86,30,49,40,2456
"13185011401",1092,93,600,320,47,4,12,0,2168
"13185011402",834,214,277,243,80,4,50,19,1721
"13185011403",4561,853,1294,862,121,126,189,34,8040
"13185011500",2954,460,342,57,108,26,121,5,4073
"13185011600",3122,424,150,131,155,47,192,45,4266
"13187960101",5509,1186,0,303,192,159,196,173,7718
"13187960102",5859,833,0,0,147,77,475,106,7497
"13187960201",7284,911,0,0,170,35,284,35,8719
"13187960202",4199,1453,131,177,135,94,12,41,6242
"13189950100",1924,219,139,34,40,16,0,0,2372
"13189950200",1804,160,1876,1043,18,101,143,101,5246
"13189950300",1210,141,1087,531,15,0,0,48,3032
"13189950400",2056,302,1565,1389,77,46,0,7,5442
"13189950500",3791,665,940,77,30,0,190,27,5720
"13191110100",2665,276,1090,40,309,0,0,0,4380
"13191110200",2404,371,1051,455,48,0,0,24,4353
"13191110300",2417,383,1605,548,294,11,201,0,5459
"13191980000",0,0,0,0,0,0,0,0,0
"13191990000",0,0,0,0,0,0,0,0,0
"13193000100",593,27,967,422,7,5,50,0,2071
"13193000200",911,192,607,366,57,10,3,7,2153
"13193000300",911,298,1306,625,28,183,0,123,3474
"13193000400",1506,360,2048,1262,145,41,0,313,5675
"13195020100",3682,1420,59,19,0,0,25,0,5205
"13195020200",3628,567,36,88,78,32,54,0,4483
"13195020300",2571,480,598,80,40,194,21,4,3988
"13195020400",3909,904,499,3,647,0,741,196,6899
"13195020500",4607,652,477,298,377,11,126,0,6548
"13195020600",1655,104,17,57,26,71,0,0,1930
"13197920100",3094,667,302,76,278,13,130,17,4577
"13197920200",1172,185,1550,803,441,14,372,46,4583
"13199970500",2546,415,1387,1056,6,0,0,0,5410
"13199970600",1582,268,660,285,106,24,30,3,2958
"13199970700",4203,650,1875,771,116,35,36,10,7696
"13199970800",2054,280,2059,642,15,23,14,9,5096
"13201950100",1057,248,122,184,0,0,36,0,1647
"13201950200",707,81,523,448,28,0,0,0,1787
"13201950300",1845,202,253,191,0,0,0,0,2491
"13205090100",1818,606,708,454,0,0,172,0,3758
"13205090200",1767,389,587,347,110,325,177,112,3814
"13205090300",456,48,1579,840,0,0,125,27,3075
"13205090400",1994,307,2025,992,98,0,101,19,5536
"13205090500",2583,530,1871,605,13,85,0,85,5772
"13207050101",4715,384,745,129,49,0,191,0,6213
"13207050102",2437,213,790,436,17,25,17,25,3960
"13207050200",1844,188,1176,1179,138,14,103,0,4642
"13207050301",3685,223,573,211,118,0,77,0,4887
"13207050302",5080,207,482,0,178,50,69,43,6109
"13209950100",1470,299,63,130,9,12,25,53,2061
"13209950200",2058,502,988,490,32,0,140,162,4372
"13209950300",1385,418,193,155,35,17,39,64,2306
"13211010100",2002,244,276,145,39,0,38,0,2744
"13211010200",2602,267,559,173,45,0,0,0,3646
"13211010300",3825,394,1584,953,231,0,310,0,7297
"13211010400",2129,271,328,130,11,20,59,7,2955
"13211010500",1180,110,97,9,45,0,79,0,1520
"13213010100",2868,528,22,0,147,0,301,86,3952
"13213010201",1716,415,0,0,5,0,0,50,2186
"13213010202",6852,2091,0,9,227,109,1065,637,10990
"13213010300",2905,675,70,12,52,43,35,80,3872
"13213010400",3701,1300,24,154,426,179,593,603,6980
"13213010500",4138,721,0,0,154,11,796,359,6179
"13213010600",3233,729,0,38,92,0,222,22,4336
"13213010700",3479,1699,76,0,91,42,379,50,5816
"13215000200",2144,421,231,5,203,11,160,217,3392
"13215000300",388,232,295,299,243,12,300,53,1822
"13215000400",2087,186,104,0,229,6,71,0,2683
"13215000800",805,162,499,588,115,22,111,13,2315
"13215000900",1263,238,626,83,127,31,248,16,2632
"13215001000",2285,357,254,315,225,54,207,64,3761
"13215001100",2330,42,183,3,46,0,0,0,2604
"13215001200",2042,152,814,288,55,14,133,47,3545
"13215001400",720,235,456,409,95,43,89,26,2073
"13215001600",387,278,500,1191,28,77,11,65,2537
"13215001800",388,242,363,287,19,15,29,0,1343
"13215002000",148,1,2496,652,200,0,116,0,3613
"13215002100",1080,225,811,147,138,11,83,0,2495
"13215002200",100,110,1434,1011,0,15,0,0,2670
"13215002300",467,9,567,230,55,0,15,3,1346
"13215002400",61,55,594,564,0,0,0,38,1312
"13215002500",96,113,393,1270,17,6,52,8,1955
"13215002700",57,91,837,1301,66,16,0,0,2368
"13215002800",27,6,929,485,77,0,55,0,1579
"13215002901",442,38,1642,529,88,154,32,146,3071
"13215002902",139,170,1245,860,175,54,168,121,2932
"13215003000",244,0,885,985,280,0,157,37,2588
"13215003200",227,129,839,496,76,80,210,123,2180
"13215003301",177,200,509,239,5,5,0,23,1158
"13215003302",432,60,1320,1044,88,25,115,0,3084
"13215003400",318,282,712,872,102,158,146,190,2780
"13215010104",2897,159,2123,140,706,152,474,58,6709
"13215010106",3003,162,1393,302,608,159,531,100,6258
"13215010107",4566,55,1816,107,787,12,220,0,7563
"13215010201",4570,226,479,0,795,203,411,36,6720
"13215010203",5210,366,1252,161,935,20,259,0,8203
"13215010204",4169,55,859,93,431,0,740,76,6423
"13215010205",2045,270,234,0,48,0,65,0,2662
"13215010301",1842,36,10,0,357,0,83,0,2328
"13215010302",4600,626,928,18,508,175,184,61,7100
"13215010401",4910,140,389,255,480,10,354,0,6538
"13215010402",2683,129,513,293,306,110,483,0,4517
"13215010501",3016,346,2059,253,201,30,197,0,6102
"13215010502",732,96,803,92,51,0,115,0,1889
"13215010602",1022,326,2846,371,613,95,249,11,5533
"13215010605",151,30,3631,453,320,21,262,0,4868
"13215010606",4,3,26,14,0,0,0,0,47
"13215010607",650,368,3205,1154,132,154,156,148,5967
"13215010608",363,8,2917,514,199,50,38,39,4128
"13215010701",667,264,4304,935,53,0,104,35,6362
"13215010702",259,110,3455,735,208,63,126,45,5001
"13215010703",322,48,4197,1137,116,145,30,0,5995
"13215010801",1032,137,245,114,126,17,156,0,1827
"13215010802",2416,62,883,39,890,0,753,0,5043
"13215011100",344,266,277,254,7,5,26,2,1181
"13215011200",703,212,316,485,68,137,3,98,2022
"13215011400",956,622,279,155,16,29,0,112,2169
"13215011500",1418,925,2004,871,728,244,428,857,7475
"13217100100",7500,749,2076,214,228,0,112,0,10879
"13217100201",5260,355,171,107,222,0,28,15,6158
"13217100202",3833,327,513,1,102,64,50,0,4890
"13217100300",4371,1123,2436,858,94,116,596,557,10151
"13217100400",1110,210,772,616,128,5,122,0,2963
"13217100501",2494,598,9581,1539,665,239,529,460,16105
"13217100502",2792,297,3641,735,159,93,664,32,8413
"13217100600",2273,695,2455,310,264,0,262,33,6292
"13217100700",1641,177,2291,1397,86,30,158,30,5810
"13217100800",5622,943,2134,189,530,107,191,87,9803
"13217100901",5104,442,3310,510,373,22,6,0,9767
"13217100902",3140,276,1523,396,257,20,346,47,6005
"13217100903",2452,403,2033,863,289,25,110,176,6351
"13219030100",8765,684,599,18,707,150,515,147,11585
"13219030200",4218,404,111,216,318,9,121,264,5661
"13219030300",4262,433,38,35,164,11,178,102,5223
"13219030400",5829,610,341,44,408,36,60,34,7362
"13219030500",1875,46,70,36,7,0,7,0,2041
"13219030600",1998,337,216,0,7,0,62,0,2620
"13221960100",1250,446,199,190,24,84,0,64,2257
"13221960201",4764,562,499,179,331,49,246,0,6630
"13221960202",3018,442,438,242,137,35,197,0,4509
"13221960300",891,48,576,90,46,29,63,0,1743
"13223120101",9058,1438,1069,103,480,0,178,18,12344
"13223120102",8494,564,649,173,532,0,551,0,10963
"13223120103",7393,717,795,0,176,42,243,161,9527
"13223120104",2088,78,0,0,176,0,48,0,2390
"13223120202",4605,297,1780,419,287,145,193,0,7726
"13223120203",4736,250,278,135,74,11,226,13,5723
"13223120204",4650,407,825,0,144,11,133,0,6170
"13223120301",3220,464,1042,343,0,0,340,0,5409
"13223120302",7254,1724,1997,1005,222,135,785,542,13664
"13223120303",1194,64,547,27,37,5,98,0,1972
"13223120400",13448,1086,2063,426,660,0,407,9,18099
"13223120501",4195,978,1019,52,288,0,199,476,7207
"13223120502",6978,665,1221,369,173,33,558,159,10156
"13223120503",3668,396,641,43,232,0,195,0,5175
"13223120601",2493,69,1251,183,126,31,220,0,4373
"13223120602",6139,930,2468,565,226,0,299,308,10935
"13223120603",4161,142,1821,102,191,27,258,49,6751
"13223120604",3751,706,623,299,20,0,37,365,5801
"13223120605",4505,614,378,30,41,0,225,122,5915
"13225040101",1157,167,102,8,52,0,0,0,1486
"13225040102",6311,606,1989,245,224,132,166,169,9842
"13225040200",1633,171,1125,934,183,411,509,472,5438
"13225040301",1446,136,593,279,403,2,326,0,3185
"13225040302",478,110,561,935,137,10,112,27,2370
"13225040400",382,10,2003,1923,9,54,0,100,4481
"13227050100",4148,150,52,0,9,0,79,0,4438
"13227050200",5174,616,9,9,547,5,461,5,6826
"13227050300",3674,445,82,0,21,0,247,0,4469
"13227050400",2764,974,0,3,81,17,20,0,3859
"13227050500",3692,404,25,0,28,0,36,0,4185
"13227050600",5111,833,112,0,49,1,0,0,6106
"13229960100",2031,567,179,23,22,2,14,49,2887
"13229960200",1387,275,0,16,36,185,134,179,2212
"13229960300",3992,839,684,682,349,68,240,0,6854
"13229960400",5795,1084,0,51,266,16,290,0,7502
"13231010100",5324,501,715,150,157,13,85,0,6945
"13231010200",3076,49,63,17,0,0,51,2,3258
"13231010300",2942,510,358,284,56,0,47,0,4197
"13231010400",2516,356,240,70,21,0,26,0,3229
"13233010100",3931,643,475,4,209,7,85,4,5358
"13233010200",5162,918,306,161,876,559,919,512,9413
"13233010300",3142,892,314,53,224,338,381,791,6135
"13233010400",3055,1590,700,566,264,512,600,1051,8338
"13233010500",3262,465,790,199,98,0,474,70,5358
"13233010600",3731,988,683,185,168,39,0,53,5847
"13233010700",3404,1066,347,336,32,7,8,76,5276
"13235950100",913,188,306,135,0,0,47,28,1617
"13235950200",3963,849,1779,348,311,0,179,353,7782
"13235950300",1099,30,237,58,12,0,9,0,1445
"13237960101",2906,186,256,40,34,0,66,0,3488
"13237960102",4296,265,156,37,159,0,190,56,5159
"13237960201",565,126,158,60,393,0,416,0,1718
"13237960202",2014,409,3089,1425,92,111,380,194,7714
"13237960300",3446,254,414,0,103,21,70,0,4308
"13239960300",868,146,866,486,30,0,0,0,2396
"13241970100",4188,627,14,97,232,159,432,196,5945
"13241970201",2762,734,0,0,122,0,143,99,3860
"13241970202",2003,697,0,34,174,0,378,0,3286
"13241970301",2077,680,11,10,82,54,10,18,2942
"13241970302",972,376,0,0,0,0,0,0,1348
"13243790100",770,123,530,374,0,0,0,0,1797
"13243790200",1501,132,2183,1197,379,0,16,0,5408
"13245000100",1915,470,625,602,137,0,61,0,3810
"13245000200",472,486,388,888,174,95,11,32,2546
"13245000300",389,212,240,179,3,23,19,0,1065
"13245000600",386,89,688,545,33,0,19,10,1770
"13245000700",41,22,616,643,0,0,33,0,1355
"13245000900",1,2,719,441,9,0,0,0,1172
"13245001000",859,639,703,282,57,56,88,89,2773
"13245001100",1635,78,14,48,26,17,29,0,1847
"13245001200",1383,649,1263,641,83,0,28,0,4047
"13245001300",546,65,706,148,34,9,96,0,1604
"13245001400",4,56,873,1126,9,0,9,17,2094
"13245001500",16,5,583,356,0,0,0,0,960
"13245001601",969,452,1729,665,111,74,85,175,4260
"13245001602",2597,269,638,245,95,55,85,0,3984
"13245010101",2647,183,703,236,185,21,267,0,4242
"13245010104",1832,175,836,454,287,10,124,27,3745
"13245010105",3251,352,876,253,123,78,123,153,5209
"13245010106",2813,253,1575,325,575,84,159,20,5804
"13245010107",1107,162,565,173,123,247,31,0,2408
"13245010201",3690,502,426,171,122,0,34,0,4945
"13245010203",1257,363,1889,268,264,35,65,50,4191
"13245010204",4147,959,5020,511,1110,0,842,362,12951
"13245010300",421,307,2574,1737,59,43,151,230,5522
"13245010400",596,48,1724,1869,0,30,68,57,4392
"13245010504",1407,378,2355,2479,58,52,57,219,7005
"13245010506",1183,288,1679,1572,184,39,126,26,5097
"13245010507",882,203,2983,1289,133,10,106,10,5616
"13245010508",1167,145,1238,842,104,78,79,44,3697
"13245010509",1557,174,1670,724,231,29,45,0,4430
"13245010510",2240,552,1462,883,152,9,45,0,5343
"13245010511",748,404,1104,646,9,73,7,7,2998
"13245010512",299,193,3501,1410,24,17,0,59,5503
"13245010513",356,176,2166,459,100,20,54,0,3331
"13245010600",81,25,2317,1875,6,53,32,15,4404
"13245010706",1609,609,1575,999,372,87,0,48,5299
"13245010707",187,94,1436,614,140,178,50,178,2877
"13245010708",854,80,3428,863,396,280,534,44,6479
"13245010709",190,1,4463,774,321,29,196,0,5974
"13245010710",1516,451,1970,1383,119,154,146,0,5739
"13245010711",609,460,1652,562,181,46,241,170,3921
"13245010712",1097,15,6228,652,578,237,225,67,9099
"13245010800",1701,507,1142,70,725,177,528,185,5035
"13245010903",2546,711,1432,219,302,38,96,80,5424
"13245010904",1443,271,1048,304,45,0,26,96,3233
"13245010905",3207,827,779,14,120,97,110,0,5154
"13245010906",4250,193,1694,240,628,55,412,33,7505
"13245011000",409,257,314,267,40,19,33,21,1360
"13247060101",2306,354,510,45,20,4,130,36,3405
"13247060102",3055,533,1056,166,409,67,448,0,5734
"13247060201",1429,784,1032,112,425,509,1117,1241,6649
"13247060202",3222,285,4782,803,511,95,319,98,10115
"13247060304",1280,187,2387,759,142,17,92,47,4911
"13247060305",1228,495,2241,623,476,171,518,546,6298
"13247060306",614,111,1954,142,61,0,7,6,2895
"13247060307",2563,293,6478,593,633,73,305,25,10963
"13247060308",2058,699,3728,951,283,381,580,909,9589
"13247060309",1591,286,2619,819,337,51,558,87,6348
"13247060403",1682,88,1105,182,312,0,120,13,3502
"13247060404",3238,218,1805,232,516,41,239,31,6320
"13247060405",3701,227,2346,162,247,8,180,8,6879
"13247060406",3248,113,1705,182,122,0,399,14,5783
"13247060407",2248,490,418,122,127,0,176,36,3617
"13249960100",1325,342,576,498,182,31,175,106,3235
"13249960200",1620,89,168,105,8,49,8,49,2096
"13251970200",801,44,667,255,2,0,2,0,1771
"13251970300",1760,292,726,406,20,6,45,0,3255
"13251970400",1967,536,957,972,42,248,64,57,4843
"13251970500",1206,256,769,455,2,0,5,0,2693
"13251970600",916,105,418,220,31,0,26,0,1716
"13253200100",1973,497,123,36,16,29,24,13,2711
"13253200200",1381,181,709,1080,52,142,14,162,3721
"13253200300",1444,69,731,234,16,0,19,0,2513
"13255160100",4537,793,251,4,76,34,439,70,6204
"13255160200",3600,658,1081,164,158,57,115,35,5868
"13255160300",496,316,1473,674,52,65,27,0,3103
"13255160400",1079,570,1820,1110,294,106,154,18,5151
"13255160500",3376,349,1748,735,647,9,221,167,7252
"13255160600",3486,453,164,117,34,109,70,24,4457
"13255160700",2586,446,2696,755,242,0,200,0,6925
"13255160800",667,703,1943,1171,0,184,129,276,5073
"13255160900",1135,392,512,182,35,66,0,115,2437
"13255161000",4338,496,452,19,18,32,11,97,5463
"13255161100",3172,424,290,35,154,66,276,0,4417
"13255161200",5343,383,1358,1814,50,0,0,0,8948
"13257970100",4421,876,394,442,171,0,117,0,6421
"13257970200",4909,812,164,130,95,0,138,126,6374
"13257970301",1581,291,657,547,64,0,0,0,3140
"13257970302",1637,593,430,51,0,0,0,0,2711
"13257970400",5062,1126,277,55,85,0,65,0,6670
"13259950100",568,54,1012,804,7,6,9,0,2460
"13259950400",950,12,955,682,19,0,12,0,2630
"13261950100",484,234,361,92,38,0,0,0,1209
"13261950200",1393,660,1114,1228,52,311,20,219,4997
"13261950300",1338,199,3504,2036,176,30,0,100,7383
"13261950400",1453,415,765,387,15,0,90,137,3262
"13261950500",2257,176,541,354,72,65,159,65,3689
"13261950600",724,101,585,389,133,6,131,0,2069
"13261950700",1726,462,1514,1704,177,228,267,312,6390
"13261950800",1235,423,659,193,41,0,130,0,2681
"13263960100",1034,74,1059,336,33,0,0,0,2536
"13263960200",708,127,1317,545,0,4,44,0,2745
"13263960300",495,204,534,160,35,0,0,0,1428
"13265010200",571,161,588,362,63,0,56,15,1816
"13267950100",2072,444,415,407,35,142,104,145,3764
"13267950201",2260,751,968,930,32,53,429,55,5478
"13267950202",2032,599,223,38,90,666,297,605,4550
"13267950300",2075,389,332,336,315,0,183,103,3733
"13267950400",3159,579,591,182,204,63,258,184,5220
"13269950100",899,134,396,45,0,0,0,0,1474
"13269950200",1302,173,455,366,17,6,52,23,2394
"13269950300",1910,559,969,1006,21,54,16,82,4617
"13271950100",4281,1013,2028,1678,55,0,306,0,9361
"13271950200",792,261,19,82,11,0,11,0,1176
"13271950500",1179,426,371,300,3,75,46,165,2565
"13273120200",1083,51,249,319,7,0,0,1,1710
"13273120300",451,49,1429,1168,30,0,126,0,3253
"13273120400",744,67,931,910,26,0,0,0,2678
"13273120500",818,92,252,109,58,48,18,34,1429
"13275960100",450,118,279,542,15,63,98,76,1641
"13275960200",2515,1115,258,121,100,135,18,110,4372
"13275960300",1265,98,277,278,13,29,6,18,1984
"13275960400",1409,273,321,215,14,10,19,18,2279
"13275960500",4143,755,1089,403,252,57,177,91,6967
"13275960600",2974,365,1111,303,40,24,32,3,4852
"13275960700",1872,412,1793,2057,106,129,0,170,6539
"13275960800",1953,152,1735,1748,171,21,328,22,6130
"13275960900",1433,295,1246,446,53,34,10,10,3527
"13275961000",2619,435,355,404,46,24,43,0,3926
"13275961100",1277,89,924,401,30,37,93,37,2888
"13277960100",1727,138,221,75,0,0,0,0,2161
"13277960200",2048,393,399,56,20,3,22,75,3016
"13277960300",3883,648,630,375,326,441,66,166,6535
"13277960400",2773,848,1165,506,227,459,442,518,6938
"13277960500",3476,756,252,0,46,66,26,0,4622
"13277960600",428,453,2400,2120,194,22,212,39,5868
"13277960700",1119,393,1395,1000,799,135,978,209,6028
"13277960800",1207,977,54,85,287,149,466,517,3742
"13277960900",2372,644,406,92,215,44,356,84,4213
"13279970100",2022,948,642,831,551,105,531,542,6172
"13279970200",2846,406,389,1310,19,0,255,115,5340
"13279970300",3928,205,981,375,216,0,359,1,6065
"13279970400",1774,645,1002,710,187,42,21,25,4406
"13279970500",2127,974,159,117,97,25,423,440,4362
"13279970600",2386,399,199,29,132,122,233,140,3640
"13281960100",2794,507,3,50,10,0,0,12,3376
"13281960200",2275,242,0,0,39,54,26,54,2690
"13281960300",3038,640,0,7,32,93,37,82,3929
"13283960100",1086,119,88,0,0,0,0,0,1293
"13283960200",2767,468,780,955,4,100,0,0,5074
"13285960100",2963,1198,711,922,217,60,31,9,6111
"13285960201",2344,300,248,19,78,0,36,0,3025
"13285960202",1578,41,246,83,26,0,53,0,2027
"13285960300",3500,152,196,0,71,122,116,122,4279
"13285960400",2787,561,1607,473,609,101,43,68,6249
"13285960501",1496,632,1391,581,217,53,181,190,4741
"13285960502",3311,1058,1308,811,566,91,308,102,7555
"13285960600",1291,296,2121,1482,11,20,53,0,5274
"13285960700",2242,305,1167,731,554,102,315,93,5509
"13285960800",737,405,1023,918,17,65,128,0,3293
"13285960901",1027,314,1229,872,103,45,168,61,3819
"13285960902",5451,313,1088,55,132,0,18,0,7057
"13285961000",2856,719,1457,1179,30,0,53,24,6318
"13285961100",2249,465,116,56,0,0,33,0,2919
"13287970200",2018,411,1588,1137,61,34,192,98,5539
"13287970300",2183,159,585,82,50,10,10,6,3085
"13289060100",2608,622,900,603,64,15,0,0,4812
"13289060200",1200,442,1424,818,2,0,0,0,3886
"13291000101",2156,545,0,0,0,0,0,0,2701
"13291000102",4475,557,66,0,7,0,42,0,5147
"13291000201",1994,413,0,2,164,0,48,14,2635
"13291000203",1678,276,0,0,176,0,86,0,2216
"13291000204",2667,649,0,0,136,0,62,0,3514
"13291000205",3742,1217,0,5,23,44,0,290,5321
"13293010100",2505,213,507,34,0,23,90,0,3372
"13293010201",3022,595,905,364,0,7,191,158,5242
"13293010202",2383,425,70,1,60,0,0,0,2939
"13293010300",2990,193,164,91,26,5,26,0,3495
"13293010400",3016,475,1108,937,105,72,109,0,5822
"13293010500",1647,565,1468,1213,18,66,0,25,5002
"13293010600",487,43,395,85,80,0,0,0,1090
"13295020100",4508,1220,249,69,249,51,48,14,6408
"13295020200",2010,1122,78,58,207,116,73,42,3706
"13295020301",3772,1124,191,16,203,0,157,0,5463
"13295020302",3951,705,17,0,69,0,9,0,4751
"13295020400",2992,322,19,7,57,0,36,6,3439
"13295020501",6157,728,353,21,183,20,112,12,7586
"13295020502",5810,1247,83,0,50,73,36,11,7310
"13295020601",5610,331,111,11,73,22,101,0,6259
"13295020602",3177,508,94,116,270,18,166,125,4474
"13295020700",4731,1548,131,252,123,29,75,0,6889
"13295020800",2665,314,203,88,68,0,0,0,3338
"13295020901",5359,697,151,43,33,31,19,18,6351
"13295020902",1567,236,86,14,55,0,35,0,1993
"13297110100",7204,785,456,56,505,83,184,181,9454
"13297110200",3489,425,379,12,125,0,5,80,4515
"13297110300",3033,425,1496,1145,109,204,150,136,6698
"13297110400",2525,575,1679,1522,146,20,61,14,6542
"13297110503",2875,298,94,0,13,0,146,0,3426
"13297110504",3376,228,291,0,466,312,191,182,5046
"13297110505",3547,297,208,0,81,171,94,182,4580
"13297110506",4528,385,138,56,329,0,223,0,5659
"13297110507",5813,286,570,216,547,76,296,104,7908
"13297110508",3779,426,230,6,39,26,63,25,4594
"13297110601",4102,242,198,86,52,0,51,0,4731
"13297110602",3907,483,585,21,133,0,134,0,5263
"13297110603",3314,769,177,66,162,141,39,138,4806
"13297110700",4418,594,1093,254,25,42,138,27,6591
"13297110800",4445,240,1086,521,27,0,41,0,6360
"13299950100",1531,163,11,0,6,0,0,0,1711
"13299950200",4229,1166,200,0,134,73,142,214,6158
"13299950300",1341,190,243,178,0,9,0,6,1967
"13299950400",134,49,898,829,0,0,0,27,1937
"13299950500",2496,574,874,462,27,48,28,19,4528
"13299950600",4251,405,761,252,284,0,53,0,6006
"13299950700",123,118,504,456,119,20,112,17,1469
"13299950800",2752,524,1207,1183,175,0,236,28,6105
"13299950900",2227,792,650,499,40,121,136,121,4586
"13301970400",904,45,637,1056,128,0,0,0,2770
"13301970500",871,256,1289,417,15,0,2,0,2850
"13303950100",1338,61,333,206,69,0,0,0,2007
"13303950300",1498,239,1498,1017,38,0,212,0,4502
"13303950400",1722,115,1603,1222,39,0,12,22,4735
"13303950500",2012,230,1279,610,91,23,59,36,4340
"13303950700",1627,201,1391,928,12,0,33,0,4192
"13305970100",3117,952,78,7,17,55,22,26,4274
"13305970200",4821,1174,1018,561,114,137,217,100,8142
"13305970300",2728,375,664,912,102,22,167,100,5070
"13305970400",2376,408,473,61,152,10,171,7,3658
"13305970500",1499,516,920,274,20,342,20,375,3966
"13305970600",3339,322,142,217,16,0,67,11,4114
"13307960100",677,133,467,173,0,10,0,0,1460
"13307960200",606,85,388,219,0,0,0,33,1331
"13309780100",1343,289,88,300,1,0,0,0,2021
"13309780200",1123,549,321,185,27,0,3,0,2208
"13311950100",2102,388,66,18,22,21,12,0,2629
"13311950201",5606,2131,338,45,110,58,202,188,8678
"13311950202",3049,149,0,0,8,18,44,0,3268
"13311950203",3803,606,234,0,13,0,0,0,4656
"13311950300",6173,1789,1,0,0,177,50,186,8376
"13313000101",3200,619,1,5,20,171,86,128,4230
"13313000102",6510,1098,275,10,736,77,1265,132,10103
"13313000200",3133,482,0,3,87,60,182,219,4166
"13313000301",3161,508,91,15,385,176,1272,387,5995
"13313000302",7916,937,305,75,319,80,2094,532,12258
"13313000400",4825,2152,195,59,984,284,3824,1823,14146
"13313000501",3052,413,30,31,437,76,895,81,5015
"13313000502",3143,1672,515,415,163,335,2139,1002,9384
"13313000600",3014,478,155,35,155,28,112,269,4246
"13313000700",3979,539,127,0,160,32,151,39,5027
"13313000800",6239,683,306,38,488,96,834,51,8735
"13313000900",2966,261,191,22,233,0,181,125,3979
"13313001000",2179,977,161,236,96,145,1697,1001,6492
"13313001100",2556,1399,69,1,467,78,1137,1029,6736
"13313001200",4355,1857,161,12,566,391,1988,1490,10820
"13313001300",1623,1743,133,94,201,187,1213,1522,6716
"13313001400",5108,631,45,0,694,72,2364,431,9345
"13313001500",4291,844,74,0,231,84,721,363,6608
"13315960100",1185,333,342,235,15,0,0,0,2110
"13315960200",728,63,248,325,35,20,10,20,1449
"13315960300",1014,293,83,195,9,0,0,0,1594
"13315960400",962,250,442,243,26,0,0,0,1923
"13317010101",941,230,359,238,23,13,0,0,1804
"13317010102",754,171,284,286,134,116,185,116,2046
"13317010301",1301,220,513,179,62,0,49,0,2324
"13317010302",1411,265,1465,987,58,41,17,0,4244
"13319960200",1279,361,1178,815,0,0,84,113,3830
"13319960300",2626,333,914,235,205,31,21,0,4365
"13319960400",876,167,330,66,2,0,9,0,1450
"13321950100",1837,223,317,390,36,0,21,0,2824
"13321950200",4275,666,1436,508,28,0,140,149,7202
"13321950400",3233,656,779,278,194,35,0,19,5194
"13321950500",1832,278,1418,791,47,17,9,6,4398
"13321950600",1553,407,149,53,23,35,17,35,2272
"15001020100",1673,325,11,38,2619,677,414,152,5909
"15001020202",579,86,0,0,1086,237,127,19,2134
"15001020300",759,382,14,0,1841,870,369,112,4347
"15001020400",381,230,41,0,2220,1206,260,509,4847
"15001020500",508,328,0,45,2882,843,196,356,5158
"15001020600",435,126,51,0,4630,580,389,58,6269
"15001020701",279,75,0,0,3587,228,298,46,4513
"15001020702",605,0,39,0,4073,124,395,0,5236
"15001020801",740,84,0,0,3199,86,204,9,4322
"15001020802",1180,147,0,0,3900,1062,285,245,6819
"15001020900",920,109,19,0,3702,486,555,161,5952
"15001021003",1478,437,30,8,3578,1267,514,400,7712
"15001021005",2235,1183,263,0,3997,1902,665,1390,11635
"15001021010",2039,750,35,106,1974,1449,486,712,7551
"15001021011",1596,322,0,0,1028,517,441,233,4137
"15001021013",573,200,0,4,3251,979,300,97,5404
"15001021101",1480,394,0,0,770,461,346,169,3620
"15001021106",1116,552,22,55,3560,1766,454,662,8187
"15001021202",2026,716,0,4,3471,1301,529,164,8211
"15001021300",2234,463,9,0,3110,719,400,23,6958
"15001021402",701,83,30,0,2955,380,427,90,4666
"15001021502",1982,209,52,14,2427,306,452,83,5525
"15001021504",931,23,1,3,2902,801,438,89,5188
"15001021507",4168,451,19,0,3761,727,1305,122,10553
"15001021509",2581,440,0,11,1855,949,278,339,6453
"15001021601",3219,356,85,0,3733,487,584,124,8588
"15001021604",3401,368,93,0,3600,288,1114,21,8885
"15001021702",3796,231,0,0,4987,897,779,137,10827
"15001021704",3929,288,28,0,3322,283,415,31,8296
"15001021800",1032,238,18,0,4318,947,841,118,7512
"15001021902",1084,150,0,0,2870,319,302,0,4725
"15001022000",1020,53,0,0,1711,235,68,43,3130
"15001022102",472,33,0,0,1457,221,233,0,2416
"15001990000",0,0,0,0,0,0,0,0,0
"15001990100",0,0,0,0,0,0,0,0,0
"15001990300",0,0,0,0,0,0,0,0,0
"15001990400",0,0,0,0,0,0,0,0,0
"15001990500",0,0,0,0,0,0,0,0,0
"15001990600",0,0,0,0,0,0,0,0,0
"15001990700",0,0,0,0,0,0,0,0,0
"15001990800",0,0,0,0,0,0,0,0,0
"15001990900",0,0,0,0,0,0,0,0,0
"15001991000",0,0,0,0,0,0,0,0,0
"15001991100",0,0,0,0,0,0,0,0,0
"15001991200",0,0,0,0,0,0,0,0,0
"15001991300",0,0,0,0,0,0,0,0,0
"15001991400",0,0,0,0,0,0,0,0,0
"15001991500",0,0,0,0,0,0,0,0,0
"15001991600",0,0,0,0,0,0,0,0,0
"15001991700",0,0,0,0,0,0,0,0,0
"15003000106",2380,165,162,0,5187,197,474,34,8599
"15003000107",706,0,0,0,2119,11,59,0,2895
"15003000108",1280,36,15,0,1911,78,187,0,3507
"15003000110",1211,124,25,0,2788,89,66,0,4303
"15003000111",701,45,0,0,3871,31,117,24,4789
"15003000112",1349,281,0,0,3676,36,163,34,5539
"15003000114",803,40,0,0,752,18,65,0,1678
"15003000200",1151,48,0,15,4363,145,330,37,6089
"15003000301",636,8,24,0,2333,77,121,0,3199
"15003000302",478,2,0,0,2688,129,85,0,3382
"15003000401",569,115,0,0,1910,27,1,50,2672
"15003000402",848,11,0,0,2915,41,165,2,3982
"15003000500",1188,44,9,0,2297,53,267,0,3858
"15003000600",515,15,0,0,922,14,0,0,1466
"15003000700",179,6,0,0,2511,175,208,0,3079
"15003000800",367,72,12,0,3316,153,130,0,4050
"15003000901",553,9,0,0,2026,178,81,0,2847
"15003000902",1093,49,69,0,2575,106,187,42,4121
"15003000903",486,84,19,0,2214,137,135,8,3083
"15003001000",568,101,0,0,2302,218,259,0,3448
"15003001100",320,7,0,0,3168,845,198,158,4696
"15003001201",306,19,0,0,2479,122,208,11,3145
"15003001202",254,20,0,0,2789,129,250,0,3442
"15003001300",605,126,46,0,3341,302,240,0,4660
"15003001400",276,16,24,0,2097,68,24,1,2506
"15003001500",590,82,0,0,2717,99,131,0,3619
"15003001600",659,59,0,0,2603,125,200,11,3657
"15003001700",1087,112,37,0,695,99,75,0,2105
"15003001801",438,151,8,2,469,243,75,31,1417
"15003001803",1146,73,188,15,1282,174,139,11,3028
"15003001804",741,97,32,0,568,107,92,14,1651
"15003001901",306,37,0,6,80,26,11,0,466
"15003001903",1318,64,0,0,1645,220,223,16,3486
"15003001904",1752,152,54,0,1576,90,151,0,3775
"15003002003",769,238,34,17,717,517,57,36,2385
"15003002004",602,140,0,26,638,56,159,26,1647
"15003002005",710,247,82,0,877,169,82,0,2167
"15003002006",704,160,50,0,1023,328,163,9,2437
"15003002100",468,122,16,0,2739,428,206,55,4034
"15003002201",438,42,0,0,2807,313,161,32,3793
"15003002202",987,67,12,20,2226,126,164,0,3602
"15003002300",371,212,45,0,3550,676,357,254,5465
"15003002401",165,61,12,33,2373,409,122,20,3195
"15003002402",381,67,0,0,2180,529,77,16,3250
"15003002500",484,101,47,0,2331,717,102,53,3835
"15003002600",459,202,18,0,2962,319,223,44,4227
"15003002701",258,39,118,0,1572,347,165,34,2533
"15003002702",816,114,12,34,3208,607,229,60,5080
"15003002800",1030,112,0,0,2584,112,217,48,4103
"15003002900",601,59,0,0,1588,52,107,0,2407
"15003003000",1042,128,0,0,2949,246,256,26,4647
"15003003101",480,29,32,0,2907,81,90,12,3631
"15003003102",771,13,0,0,2616,109,74,3,3586
"15003003200",395,25,3,0,399,81,11,0,914
"15003003300",247,27,0,0,818,52,20,0,1164
"15003003403",1080,150,85,0,3833,558,443,61,6210
"15003003404",705,36,59,0,3560,342,428,53,5183
"15003003405",925,312,13,0,1819,502,189,51,3811
"15003003406",636,285,0,26,4207,865,450,28,6497
"15003003407",259,14,0,0,365,49,15,5,707
"15003003501",351,58,45,0,1431,186,74,0,2145
"15003003502",355,72,5,0,2969,453,81,0,3935
"15003003601",696,118,102,11,2839,371,212,9,4358
"15003003603",249,30,0,0,1827,637,39,0,2782
"15003003604",361,13,48,0,1580,244,80,0,2326
"15003003700",1468,121,4,18,3389,366,451,24,5841
"15003003800",810,26,25,4,2725,136,63,17,3806
"15003003900",113,0,42,12,167,69,8,0,411
"15003004000",518,95,86,21,588,84,6,8,1406
"15003004100",620,32,282,0,3286,429,248,0,4897
"15003004200",886,70,9,0,2156,227,130,0,3478
"15003004300",727,221,112,13,3469,682,127,53,5404
"15003004400",481,15,0,0,4522,370,336,8,5732
"15003004500",895,0,0,0,3504,87,172,0,4658
"15003004600",377,28,0,0,3455,87,98,0,4045
"15003004700",453,133,0,0,3896,194,222,13,4911
"15003004800",432,70,34,0,5470,784,484,91,7365
"15003004900",150,10,24,0,2935,220,136,94,3569
"15003005000",264,102,47,0,3284,274,91,64,4126
"15003005100",468,26,0,0,1872,634,41,0,3041
"15003005200",254,61,29,0,1947,638,69,11,3009
"15003005300",170,25,111,65,2320,814,144,63,3712
"15003005400",0,4,0,0,718,957,97,70,1846
"15003005500",17,5,0,0,1776,314,88,18,2218
"15003005600",136,20,0,0,5546,1016,240,0,6958
"15003005700",148,214,8,25,1438,483,50,44,2410
"15003005800",33,29,0,0,2504,976,84,34,3660
"15003005900",24,0,0,0,1905,150,10,0,2089
"15003006000",160,28,66,0,5521,228,321,0,6324
"15003006100",76,4,0,6,3626,586,148,89,4535
"15003006201",125,20,11,0,4633,1043,203,31,6066
"15003006202",18,38,0,3,598,1388,27,257,2329
"15003006301",117,24,10,0,3132,205,107,27,3622
"15003006302",24,0,0,0,1342,1118,54,139,2677
"15003006401",14,10,0,0,2446,80,116,7,2673
"15003006402",430,57,0,52,6013,547,501,104,7704
"15003006500",448,10,29,0,4112,106,258,3,4966
"15003006600",174,0,99,0,335,0,0,0,608
"15003006701",468,66,96,0,4751,221,90,10,5702
"15003006702",786,14,121,0,1289,118,171,14,2513
"15003006802",392,9,235,0,6296,485,336,10,7763
"15003006804",1255,151,890,99,856,256,522,0,4029
"15003006805",603,89,208,0,4097,218,340,0,5555
"15003006806",22,14,0,0,1632,30,0,13,1711
"15003006808",404,11,259,0,3595,241,94,7,4611
"15003006809",290,22,0,0,3509,1056,333,250,5460
"15003006900",2096,389,272,0,1082,1,582,88,4510
"15003007000",2302,135,418,0,1104,205,700,33,4897
"15003007100",2066,42,425,56,425,66,434,28,3542
"15003007302",2843,288,180,12,657,26,493,0,4499
"15003007303",25,0,0,0,0,0,0,0,25
"15003007400",1938,104,77,47,446,45,258,35,2950
"15003007502",136,1,23,3,113,6,57,0,339
"15003007503",393,10,45,0,4152,412,380,171,5563
"15003007504",110,15,0,0,2465,731,120,143,3584
"15003007505",851,11,7,0,4170,298,285,114,5736
"15003007506",153,0,31,0,84,0,50,0,318
"15003007701",804,118,0,0,2921,224,154,62,4283
"15003007702",772,29,0,0,4028,84,117,10,5040
"15003007804",139,2,0,0,1692,21,164,0,2018
"15003007805",455,9,67,0,4458,220,623,48,5880
"15003007807",1043,54,125,15,4038,369,1008,0,6652
"15003007808",287,13,23,0,2483,131,461,31,3429
"15003007809",220,15,0,0,2810,97,240,0,3382
"15003007810",703,18,15,0,4471,64,179,16,5466
"15003007811",802,38,58,0,3878,156,257,20,5209
"15003008001",46,10,18,0,1443,306,233,165,2221
"15003008002",117,1,0,0,2529,282,50,49,3028
"15003008003",1222,0,141,0,3516,509,620,14,6022
"15003008005",866,72,0,1,5824,273,913,2,7951
"15003008006",234,24,20,0,4660,121,499,0,5558
"15003008007",274,45,34,0,4963,212,247,36,5811
"15003008301",1632,181,392,47,2275,292,556,103,5478
"15003008302",647,67,27,0,5044,784,533,157,7259
"15003008402",692,46,38,6,5630,1470,633,110,8625
"15003008405",1142,0,31,0,3144,70,216,29,4632
"15003008406",965,24,695,0,4435,259,554,0,6932
"15003008407",875,43,758,0,1750,144,215,37,3822
"15003008408",2322,17,263,78,2697,41,529,0,5947
"15003008410",505,19,161,0,2243,67,185,6,3186
"15003008411",567,59,17,0,2760,99,304,84,3890
"15003008412",1012,100,54,16,3935,96,730,60,6003
"15003008502",845,142,130,24,844,390,111,246,2732
"15003008606",1093,52,462,0,7825,192,797,12,10433
"15003008609",609,39,29,0,1161,63,201,32,2134
"15003008610",1000,16,25,0,181,28,44,0,1294
"15003008611",61,0,0,0,94,63,39,0,257
"15003008612",1803,24,510,23,3426,115,911,19,6831
"15003008613",142,12,32,1,1053,152,190,42,1624
"15003008614",1417,38,389,0,6403,261,1194,52,9754
"15003008617",524,133,157,0,9271,636,1418,0,12139
"15003008622",787,60,0,0,3339,65,367,0,4618
"15003008701",422,33,42,24,7968,458,378,33,9358
"15003008702",135,9,0,0,4259,536,426,72,5437
"15003008703",632,54,0,16,4254,2034,732,261,7983
"15003008800",400,147,0,11,7560,678,207,48,9051
"15003008906",688,19,133,0,3188,105,382,8,4523
"15003008907",800,40,147,34,3035,317,163,113,4649
"15003008908",1309,32,44,0,4432,87,701,0,6605
"15003008909",478,12,46,0,3053,45,653,0,4287
"15003008912",0,20,0,0,2304,154,37,0,2515
"15003008913",97,19,0,0,3335,346,340,113,4250
"15003008914",217,77,147,0,5148,790,532,45,6956
"15003008915",786,30,91,0,3371,664,346,76,5364
"15003008917",614,10,35,0,4010,0,282,0,4951
"15003008918",939,107,208,0,4124,91,274,99,5842
"15003008920",747,38,84,0,3137,85,506,0,4597
"15003008921",195,7,23,0,2661,138,597,5,3626
"15003008922",1028,0,291,0,6290,84,403,45,8141
"15003008923",550,0,113,0,3724,110,489,0,4986
"15003008924",891,34,80,0,6253,223,361,33,7875
"15003008925",938,16,224,0,5761,425,577,175,8116
"15003008926",702,23,83,0,942,5,49,0,1804
"15003008927",636,8,26,0,4352,39,194,0,5255
"15003008928",521,0,59,0,3021,0,475,0,4076
"15003008929",895,1,112,0,3786,215,650,0,5659
"15003008930",467,0,0,0,2097,5,102,0,2671
"15003008931",509,1,56,0,2761,17,213,0,3557
"15003009000",1384,253,207,0,517,30,348,50,2789
"15003009100",339,58,94,0,4399,372,284,35,5581
"15003009200",646,45,0,0,5885,371,863,97,7907
"15003009300",408,112,177,0,3282,668,550,190,5387
"15003009400",602,135,135,19,3541,1016,488,73,6009
"15003009501",2544,536,1232,34,962,200,1394,248,7150
"15003009502",2451,312,343,260,979,196,799,193,5533
"15003009503",421,46,59,17,141,0,70,0,754
"15003009504",879,43,305,0,136,9,179,0,1551
"15003009507",947,234,390,13,385,171,417,118,2675
"15003009603",826,179,78,53,5902,1869,892,263,10062
"15003009608",384,40,63,94,3998,1231,274,350,6434
"15003009701",503,88,23,36,3327,2031,511,503,7022
"15003009703",311,67,114,0,4858,853,401,250,6854
"15003009704",224,80,29,0,2562,517,370,92,3874
"15003009801",528,178,100,91,734,594,186,257,2668
"15003009802",443,139,47,13,3863,1792,567,323,7187
"15003009902",981,173,61,21,2081,168,415,48,3948
"15003009904",1847,160,39,10,2851,181,496,44,5628
"15003010000",1983,396,273,0,880,210,562,86,4390
"15003010100",3200,330,54,17,4329,293,515,104,8842
"15003010201",1677,100,46,33,2731,778,554,10,5929
"15003010202",887,203,52,0,3637,618,264,6,5667
"15003010303",828,67,41,0,3557,315,336,7,5151
"15003010305",966,74,0,0,3347,681,652,35,5755
"15003010306",1507,202,65,0,4428,138,527,13,6880
"15003010308",508,40,0,0,2675,23,192,11,3449
"15003010503",162,35,26,0,1305,64,143,11,1746
"15003010504",484,155,0,0,3389,312,240,67,4647
"15003010505",848,0,0,0,2333,2,172,0,3355
"15003010507",769,71,128,0,4015,636,744,172,6535
"15003010508",1079,96,9,0,1489,83,158,33,2947
"15003010601",471,45,16,0,2954,260,291,20,4057
"15003010602",682,22,32,0,4353,250,378,68,5785
"15003010701",1671,138,0,70,1988,40,201,0,4108
"15003010702",603,21,39,0,2652,122,378,0,3815
"15003010801",1410,47,38,0,441,192,344,63,2535
"15003010802",3037,538,385,0,917,174,842,140,6033
"15003010901",2339,43,24,9,932,22,152,0,3521
"15003010903",1168,373,77,8,2463,313,242,23,4667
"15003010904",1569,96,66,5,1788,158,212,29,3923
"15003010905",882,234,0,0,1386,135,300,0,2937
"15003011000",1182,8,12,0,2153,51,221,0,3627
"15003011103",985,22,0,1,2782,42,119,0,3951
"15003011104",1456,138,0,4,2893,235,217,2,4945
"15003011105",1830,110,128,22,1254,43,180,22,3589
"15003011106",1792,81,28,0,4185,72,320,0,6478
"15003011201",2756,212,0,0,1385,48,509,7,4917
"15003011202",919,79,0,0,566,45,28,23,1660
"15003011300",677,83,16,24,3979,932,360,65,6136
"15003011400",1403,50,133,0,518,285,359,182,2930
"15003011500",713,64,405,0,4481,103,824,0,6590
"15003940001",435,23,0,0,3876,394,494,16,5238
"15003940002",188,58,26,0,5784,1196,843,242,8337
"15003980000",0,0,0,0,2,1,0,0,3
"15003980200",0,0,0,0,0,0,0,0,0
"15003980300",0,0,0,0,0,0,0,0,0
"15003980600",92,0,0,0,0,0,0,0,92
"15003980700",0,0,0,0,0,0,0,0,0
"15003980800",0,0,0,0,0,0,0,0,0
"15003981000",0,0,0,0,0,0,0,0,0
"15003981100",13,0,0,0,0,0,0,0,13
"15003981200",0,0,0,0,0,0,0,0,0
"15003981300",0,0,0,0,0,0,0,0,0
"15003981400",0,0,0,0,0,0,0,0,0
"15003990001",0,0,0,0,0,0,0,0,0
"15005031900",30,2,0,0,28,8,2,0,70
"15005990000",0,0,0,0,0,0,0,0,0
"15007040103",3903,651,16,0,2051,91,510,56,7278
"15007040104",491,130,0,0,198,10,90,0,919
"15007040204",2068,208,0,0,2436,210,132,0,5054
"15007040205",1177,233,0,0,2374,132,211,133,4260
"15007040300",1971,418,101,0,5131,681,853,197,9352
"15007040400",1256,269,60,43,6593,464,888,56,9629
"15007040500",1578,174,67,0,4007,719,274,13,6832
"15007040603",1061,59,14,0,1524,74,171,28,2931
"15007040604",1259,90,4,0,1562,214,349,67,3545
"15007040700",2007,354,0,0,4903,1067,1186,244,9761
"15007040800",674,49,17,0,3263,176,448,15,4642
"15007040900",1132,113,0,6,3405,377,325,9,5367
"15007041200",0,0,0,0,0,0,0,0,0
"15007940000",898,192,0,0,2218,277,279,66,3930
"15007990100",0,0,0,0,0,0,0,0,0
"15007990200",0,0,0,0,0,0,0,0,0
"15007990300",0,0,0,0,0,0,0,0,0
"15009030100",614,58,0,0,1064,148,47,83,2014
"15009030201",1366,206,0,0,624,59,90,105,2450
"15009030202",3791,616,0,29,3515,261,512,44,8768
"15009030301",4000,515,12,0,3343,541,523,211,9145
"15009030303",2782,326,25,0,797,33,76,10,4049
"15009030402",2755,268,0,0,5261,162,730,22,9198
"15009030403",1321,174,7,0,1812,14,236,0,3564
"15009030404",1499,398,10,0,2799,694,600,92,6092
"15009030501",983,121,0,0,1284,52,157,0,2597
"15009030705",867,72,0,0,2790,126,283,93,4231
"15009030706",906,401,12,36,822,257,96,290,2820
"15009030707",4555,413,81,0,3090,388,1048,29,9604
"15009030708",1150,225,0,0,1362,0,154,68,2959
"15009030709",2475,494,47,0,1100,61,291,246,4714
"15009030710",1113,270,0,0,364,516,83,138,2484
"15009030800",1376,82,2,0,5143,175,806,23,7607
"15009030901",355,143,10,0,2121,360,303,242,3534
"15009030902",560,48,13,0,1920,350,417,148,3456
"15009030903",550,58,51,0,6555,463,567,11,8255
"15009031000",1659,204,128,0,6454,508,922,279,10154
"15009031101",473,265,0,0,6590,659,953,174,9114
"15009031102",703,67,0,0,3684,287,576,129,5446
"15009031103",664,0,0,0,6186,580,360,36,7826
"15009031402",729,52,0,15,2225,81,85,15,3202
"15009031404",1669,271,22,26,1205,171,230,43,3637
"15009031405",793,121,0,0,3631,379,469,7,5400
"15009031501",953,32,0,0,1196,46,126,0,2353
"15009031502",2678,54,4,0,1405,26,476,8,4651
"15009031503",1609,98,0,44,672,32,442,19,2916
"15009031601",371,26,0,0,2589,289,535,49,3859
"15009031700",783,65,13,2,2533,827,199,210,4632
"15009031801",329,29,13,13,1875,532,190,34,3015
"15009031900",608,55,61,0,3762,887,340,27,5740
"15009032000",776,42,0,0,151,18,77,7,1071
"15009980000",0,0,0,0,0,0,0,0,0
"15009990000",0,0,0,0,0,0,0,0,0
"15009990200",0,0,0,0,0,0,0,0,0
"15009991200",0,0,0,0,0,0,0,0,0
"16001000100",2039,1257,0,108,256,447,187,115,4409
"16001000201",2715,311,15,0,42,0,25,0,3108
"16001000202",5044,377,18,0,218,15,262,28,5962
"16001000302",2301,430,25,37,92,51,64,67,3067
"16001000303",1420,256,0,0,72,60,181,87,2076
"16001000304",5595,408,28,0,160,92,285,0,6568
"16001000400",4126,1247,130,0,229,127,236,76,6171
"16001000500",4738,727,56,0,443,108,310,201,6583
"16001000600",4651,662,32,21,169,0,234,34,5803
"16001000701",4045,337,0,0,478,102,161,30,5153
"16001000702",2339,79,68,0,163,0,112,0,2761
"16001000802",4838,555,21,0,381,39,409,79,6322
"16001000803",3543,362,138,11,695,70,108,0,4927
"16001000804",4328,1161,53,90,756,72,167,11,6638
"16001000805",2949,59,0,0,275,0,72,0,3355
"16001000900",2424,1864,45,33,229,228,482,247,5552
"16001001000",4159,1403,88,0,617,54,293,130,6744
"16001001100",2493,1188,0,0,237,260,595,385,5158
"16001001201",2845,388,15,0,181,33,259,46,3767
"16001001202",4903,1218,67,142,314,116,683,149,7592
"16001001400",3251,1046,86,0,443,374,302,310,5812
"16001001500",2830,594,0,0,44,54,208,129,3859
"16001001600",3208,715,0,36,189,119,123,44,4434
"16001001700",3295,1499,73,60,642,123,499,188,6379
"16001001800",3385,754,28,33,221,97,206,85,4809
"16001001900",3894,857,71,0,439,100,199,14,5574
"16001002000",2311,1202,51,232,196,512,292,617,5413
"16001002100",2064,98,0,0,51,16,112,0,2341
"16001002221",7370,803,0,32,390,13,208,139,8955
"16001002222",4602,399,112,0,470,149,213,167,6112
"16001002223",3750,64,18,0,237,0,44,0,4113
"16001002224",4969,459,67,0,559,201,724,19,6998
"16001002302",5891,1780,33,0,625,168,457,680,9634
"16001002310",7221,879,0,85,973,25,802,224,10209
"16001002312",3872,426,55,0,188,241,345,229,5356
"16001002313",2811,578,56,0,451,34,366,168,4464
"16001002410",6467,181,110,0,203,139,316,75,7491
"16001002411",4327,519,0,0,258,10,217,99,5430
"16001002412",2631,546,0,0,79,14,97,115,3482
"16001002413",6618,1005,278,57,388,140,492,152,9130
"16001010100",4958,271,65,0,129,31,62,0,5516
"16001010201",8167,490,43,0,227,301,358,219,9805
"16001010221",5900,238,0,0,465,24,235,62,6924
"16001010223",5133,793,15,0,226,0,213,0,6380
"16001010224",4014,127,0,0,150,78,201,39,4609
"16001010225",7151,795,0,0,408,43,257,151,8805
"16001010313",17347,590,75,0,628,40,1226,150,20056
"16001010321",5275,592,16,0,490,106,260,108,6847
"16001010322",5099,1463,172,21,88,78,603,16,7540
"16001010331",16354,644,234,0,1552,400,393,12,19589
"16001010332",10764,1018,51,0,423,292,704,329,13581
"16001010333",9824,723,55,0,417,38,735,0,11792
"16001010334",5473,487,64,0,206,58,412,17,6717
"16001010335",18601,1606,110,0,894,80,920,119,22330
"16001010401",15710,3964,0,0,866,72,1016,404,22032
"16001010402",9749,816,47,0,625,129,509,283,12158
"16001010501",2055,286,0,0,77,46,286,45,2795
"16001010503",3322,416,0,0,639,0,403,350,5130
"16001010504",6220,238,0,0,477,95,315,13,7358
"16003950100",1203,291,0,0,89,0,7,0,1590
"16003950200",1883,278,0,0,46,72,13,48,2340
"16005000200",3360,50,0,38,164,0,53,0,3665
"16005000300",6966,1246,0,0,567,225,893,35,9932
"16005000400",4804,457,7,0,350,7,335,33,5993
"16005000500",1661,111,0,0,68,0,56,32,1928
"16005000600",2406,575,26,0,130,189,51,216,3593
"16005000700",2349,692,10,10,111,49,79,0,3300
"16005000800",1168,1029,0,46,275,186,217,253,3174
"16005000900",1546,764,38,38,120,18,130,26,2680
"16005001000",2547,607,19,0,107,62,168,86,3596
"16005001101",6529,615,13,0,339,0,478,1,7975
"16005001102",2748,585,76,0,232,24,224,36,3925
"16005001200",2083,579,0,0,254,0,153,70,3139
"16005001300",2018,143,6,0,259,179,445,168,3218
"16005001400",3000,687,0,29,134,110,98,36,4094
"16005001500",4899,437,0,0,316,66,147,40,5905
"16005001601",1610,664,25,13,183,44,155,186,2880
"16005001602",2863,495,55,0,188,183,139,195,4118
"16005001603",1960,441,15,0,78,21,125,21,2661
"16005001700",3455,75,13,0,136,0,25,0,3704
"16005001900",3901,488,16,0,62,32,68,9,4576
"16005940000",742,18,0,0,1272,177,151,5,2365
"16005981800",195,33,0,0,0,14,0,0,242
"16007950100",2695,555,0,0,72,8,149,26,3505
"16007950200",2309,187,7,0,47,13,51,0,2614
"16009940000",2732,499,50,7,658,240,89,68,4343
"16009950100",4041,576,88,8,170,0,21,77,4981
"16011940000",300,98,0,0,1578,574,195,79,2824
"16011950100",6813,846,36,0,462,10,1081,94,9342
"16011950200",3055,622,0,0,198,41,301,119,4336
"16011950300",4409,798,0,0,515,104,1092,514,7432
"16011950400",5252,916,3,0,167,4,580,401,7323
"16011950500",5970,936,56,0,464,291,729,536,8982
"16011950600",4203,734,6,5,569,75,1012,305,6909
"16011950700",3930,560,0,18,293,228,636,191,5856
"16013960100",3997,505,0,0,263,125,599,373,5862
"16013960200",7560,671,4,2,1735,16,2381,209,12578
"16013960300",3167,209,0,0,264,1,413,0,4054
"16013960500",2302,229,0,0,134,0,227,56,2948
"16015950200",5534,1086,19,10,150,74,197,40,7110
"16017950100",1699,311,0,0,39,75,10,10,2144
"16017950200",7686,802,70,0,273,85,257,0,9173
"16017950300",2661,655,0,0,100,62,159,32,3669
"16017950400",5664,871,0,0,116,16,176,12,6855
"16017950500",2288,609,0,0,75,0,89,0,3061
"16017950600",1883,234,0,0,37,0,0,0,2154
"16017950700",3390,769,0,0,176,14,60,21,4430
"16017950800",4522,767,9,0,286,91,9,12,5696
"16017950900",3017,727,0,0,71,11,86,0,3912
"16019970100",4292,328,1,0,80,13,46,0,4760
"16019970300",6024,427,30,0,200,67,302,58,7108
"16019970401",2250,98,25,0,227,10,291,11,2912
"16019970402",3015,386,0,0,79,15,127,59,3681
"16019970403",8886,774,241,0,1376,37,1924,201,13439
"16019970501",6603,485,82,0,468,154,612,174,8578
"16019970502",4005,324,25,0,413,48,363,48,5226
"16019970503",4196,300,12,0,179,51,204,65,5007
"16019970601",2351,443,0,0,194,115,448,139,3690
"16019970602",3505,957,0,0,241,283,299,347,5632
"16019970603",1761,112,21,0,20,39,110,54,2117
"16019970700",3584,899,13,0,518,249,676,268,6207
"16019970800",2876,668,0,0,91,190,198,159,4182
"16019970900",3647,468,73,0,317,8,241,172,4926
"16019971000",4644,465,7,0,229,23,579,108,6055
"16019971100",3149,347,0,0,65,26,458,28,4073
"16019971200",2480,654,83,0,438,111,758,191,4715
"16019971301",4970,674,43,73,436,276,524,207,7203
"16019971302",4087,481,14,37,467,232,479,205,6002
"16019971400",7691,247,0,0,713,14,1006,0,9671
"16019971500",1211,267,0,0,44,15,83,120,1740
"16021970100",4710,613,0,0,173,167,194,46,5903
"16021970200",3750,973,20,0,245,0,149,15,5152
"16023970100",2248,335,37,0,21,96,89,15,2841
"16025970100",954,177,0,0,115,19,151,52,1468
"16027020100",554,426,31,0,17,16,50,45,1139
"16027020200",1647,1800,23,0,314,315,805,1242,6146
"16027020300",2554,1030,69,0,306,190,719,652,5520
"16027020401",6092,2344,81,0,571,235,1714,1203,12240
"16027020402",3272,984,64,0,540,369,646,374,6249
"16027020501",2708,636,0,0,115,109,586,259,4413
"16027020503",2603,418,49,0,26,0,376,200,3672
"16027020504",2951,2154,0,0,273,327,374,596,6675
"16027020601",3832,942,0,0,313,18,808,340,6253
"16027020602",4580,1698,16,0,343,192,1165,455,8449
"16027020700",3226,137,0,0,97,25,244,25,3754
"16027020901",10354,1725,0,0,1249,56,3084,175,16643
"16027020902",10971,1972,60,0,907,373,2319,555,17157
"16027021001",9407,1948,19,0,816,214,2594,1113,16111
"16027021002",6674,1452,29,0,418,137,829,650,10189
"16027021100",12297,1527,0,22,923,418,2296,637,18120
"16027021200",4396,1793,0,0,339,406,893,1642,9469
"16027021300",1486,1176,6,26,266,78,1302,991,5331
"16027021500",2640,1308,0,28,283,193,652,568,5672
"16027021600",3093,1193,0,0,98,75,835,638,5932
"16027021700",8245,952,110,62,500,109,2857,423,13258
"16027021800",4697,715,0,0,367,20,882,70,6751
"16027021901",3901,654,0,0,439,97,384,49,5524
"16027021903",8341,835,0,0,356,74,627,154,10387
"16027021904",2381,997,0,7,137,80,562,771,4935
"16027022100",3251,989,0,0,469,88,649,313,5759
"16027022200",3790,684,0,0,277,165,1216,414,6546
"16027022300",5039,961,0,0,259,46,964,263,7532
"16027022400",3768,461,0,0,36,27,180,224,4696
"16029960100",3559,350,4,0,60,8,181,58,4220
"16029960200",2506,162,0,0,23,0,66,0,2757
"16031950100",2647,264,0,0,167,2,414,102,3596
"16031950200",2548,479,5,0,142,0,279,340,3793
"16031950300",3701,497,54,0,406,19,963,172,5812
"16031950400",2166,867,11,0,582,59,1355,385,5425
"16031950500",4145,842,0,0,245,136,579,573,6520
"16031950600",2062,356,0,0,121,60,317,217,3133
"16033950100",633,112,0,0,6,0,290,61,1102
"16035940000",3725,659,17,0,217,53,112,26,4809
"16035970100",2724,240,3,0,114,19,24,16,3140
"16037960200",3524,673,0,0,67,16,70,34,4384
"16039960100",2229,275,0,0,119,102,374,86,3185
"16039960200",6355,993,126,0,338,750,290,831,9683
"16039960300",2732,538,22,0,507,194,433,212,4638
"16039960400",5269,901,350,0,851,327,1189,361,9248
"16039960500",2073,101,131,0,423,11,133,0,2872
"16041970100",5085,559,0,0,243,50,140,40,6117
"16041970200",5731,910,17,0,98,39,304,347,7446
"16043970100",1198,144,0,0,10,0,0,0,1352
"16043970200",2999,482,0,0,22,197,346,311,4357
"16043970300",6370,704,6,0,378,27,619,220,8324
"16045960100",3295,570,0,0,215,34,210,88,4412
"16045960200",4166,879,0,0,34,137,137,39,5392
"16045960300",5511,1258,0,0,281,132,468,375,8025
"16047960100",4989,1374,0,0,491,320,1088,828,9090
"16047960200",5472,897,2,0,929,537,1730,645,10212
"16049940000",3401,661,3,0,263,281,77,7,4693
"16049960100",1512,300,0,0,75,21,0,0,1908
"16049960200",4872,941,8,0,112,0,184,2,6119
"16049960300",1538,325,3,6,33,5,17,42,1969
"16049960400",1182,201,0,0,20,15,12,34,1464
"16051960100",2766,558,13,10,383,130,691,344,4895
"16051960200",3537,422,8,0,229,46,172,74,4488
"16051960300",5985,1227,0,0,142,10,296,215,7875
"16051960400",9410,792,0,0,347,247,636,246,11678
"16053970100",2597,247,4,0,189,27,702,78,3844
"16053970200",3285,392,0,0,218,299,1394,380,5968
"16053970300",3423,1193,0,36,525,213,872,490,6752
"16053970400",2019,603,0,0,407,174,1131,576,4910
"16053970500",5188,746,0,0,309,126,1191,314,7874
"16055000100",4892,706,11,0,255,71,135,9,6079
"16055000200",7672,641,15,0,456,173,77,0,9034
"16055000301",4715,565,18,0,323,22,221,13,5877
"16055000302",5204,1137,10,0,97,82,209,251,6990
"16055000401",4881,653,0,0,242,64,190,36,6066
"16055000402",6635,816,19,0,263,3,184,2,7922
"16055000500",9213,1661,58,0,191,72,298,59,11552
"16055000601",3895,429,0,0,136,41,252,33,4786
"16055000602",4098,1281,0,153,145,124,156,126,6083
"16055000700",14115,1053,0,0,670,51,1085,25,16999
"16055000800",3877,322,0,6,387,22,87,11,4712
"16055000900",3005,2152,0,0,213,130,42,55,5597
"16055001001",5422,490,0,0,125,41,92,0,6170
"16055001002",3522,505,0,0,76,68,41,2,4214
"16055001100",1470,168,0,0,22,3,8,0,1671
"16055001200",4604,775,0,0,70,126,273,71,5919
"16055001300",3171,684,0,24,106,41,495,0,4521
"16055001400",2001,405,0,0,84,229,152,6,2877
"16055001500",2467,499,0,0,83,23,121,8,3201
"16055001600",2157,334,0,0,95,86,7,62,2741
"16055001700",3863,299,19,0,166,0,145,41,4533
"16055001800",7240,355,22,21,272,13,225,0,8148
"16055001900",2122,486,23,0,40,13,27,9,2720
"16055002000",3077,203,0,0,181,29,22,29,3541
"16055940000",1786,187,5,0,418,156,23,24,2599
"16057005100",4971,2526,10,55,332,77,69,23,8063
"16057005200",4952,838,33,0,294,101,192,0,6410
"16057005300",5178,979,0,0,88,128,283,80,6736
"16057005400",1589,1149,18,18,219,163,25,80,3261
"16057005500",3465,278,1,0,242,2,188,2,4178
"16057005600",3166,347,0,0,89,7,133,9,3751
"16057005700",2729,320,0,3,65,37,44,0,3198
"16059970100",1772,488,0,0,131,56,34,5,2486
"16059970200",1857,1015,9,0,8,1,51,59,3000
"16059970300",2081,242,0,0,62,0,36,0,2421
"16061940001",1338,281,0,0,160,76,85,8,1948
"16061940002",1546,270,0,0,51,35,24,8,1934
"16061950300",12,15,0,0,0,0,0,0,27
"16063950100",3882,606,17,0,377,246,1130,348,6606
"16065950100",5064,523,11,0,48,0,402,64,6112
"16065950200",1774,1268,0,0,153,151,172,22,3540
"16065950301",1068,3722,0,48,31,217,10,182,5278
"16065950302",5853,4237,60,0,192,255,144,327,11068
"16065950400",4662,1497,75,0,46,171,13,263,6727
"16065950500",4308,770,8,0,50,198,382,225,5941
"16067970100",2754,647,0,0,349,6,787,289,4832
"16067970200",3919,522,0,0,353,24,1354,293,6465
"16067970300",2500,189,0,12,211,124,738,160,3934
"16067970400",2803,390,30,9,760,85,1308,121,5506
"16067970500",2945,439,0,3,610,256,1094,394,5741
"16069940000",2504,373,13,9,1655,413,212,56,5235
"16069960200",274,15,0,0,0,0,0,0,289
"16069960300",2809,928,0,0,365,38,33,184,4357
"16069960400",2558,178,0,0,242,24,176,9,3187
"16069960500",3140,232,0,0,53,20,30,37,3512
"16069960600",4088,527,14,0,192,27,18,27,4893
"16069960700",4695,431,18,0,142,35,42,0,5363
"16069960800",3334,231,29,0,119,66,69,97,3945
"16069960900",2823,477,10,0,21,53,33,25,3442
"16069961000",4992,191,12,0,182,18,64,0,5459
"16071960100",3429,654,0,0,115,25,54,30,4307
"16073950101",2914,948,0,0,267,194,1141,420,5884
"16073950102",2423,498,0,0,140,33,399,199,3692
"16073950200",2498,872,0,0,360,194,271,516,4711
"16075960100",3633,1428,0,0,217,176,429,711,6594
"16075960200",2132,931,0,8,385,120,660,151,4387
"16075960300",6613,908,0,0,410,68,817,373,9189
"16075960400",4302,816,4,0,230,14,295,17,5678
"16077960100",1515,285,0,0,376,7,220,121,2524
"16077960200",4381,520,5,0,350,257,1592,411,7516
"16079960200",3530,672,6,1,42,13,66,10,4340
"16079960300",2686,728,16,0,116,140,84,34,3804
"16079960400",3536,534,0,0,131,26,122,21,4370
"16081960100",8724,1120,0,0,119,49,1362,361,11735
"16083000200",5006,768,41,0,300,74,285,116,6590
"16083000300",4670,759,0,0,203,11,696,267,6606
"16083000400",3130,773,4,0,237,152,581,369,5246
"16083000500",4456,730,9,0,177,137,190,212,5911
"16083000600",2594,190,0,0,40,0,181,0,3005
"16083000700",8932,964,57,0,535,305,707,473,11973
"16083000800",5101,820,0,0,207,121,810,165,7224
"16083000900",4074,162,60,0,226,53,64,32,4671
"16083001000",6503,1425,0,24,573,480,975,343,10323
"16083001100",2208,408,76,81,242,79,135,124,3353
"16083001200",4815,1283,13,0,773,120,1671,459,9134
"16083001300",6132,941,0,3,260,35,729,194,8294
"16083001400",805,149,0,0,48,6,311,94,1413
"16083001500",2346,415,11,0,19,11,281,143,3226
"16085970100",2467,328,0,0,52,3,6,0,2856
"16085970200",2548,68,0,0,13,0,180,0,2809
"16085970300",3499,496,0,0,59,12,143,37,4246
"16087970100",1251,173,0,0,67,15,20,0,1526
"16087970200",2787,489,0,0,144,70,409,114,4013
"16087970300",3699,694,0,0,491,50,964,167,6065
"17001000100",4078,349,0,4,162,0,200,0,4793
"17001000201",1585,285,55,16,8,0,13,0,1962
"17001000202",1956,277,84,0,261,20,70,0,2668
"17001000400",2317,890,250,170,71,0,39,0,3737
"17001000500",1243,249,112,257,14,0,7,0,1882
"17001000600",3242,214,58,6,49,14,24,0,3607
"17001000700",528,347,309,19,0,147,0,0,1350
"17001000800",1276,860,119,225,122,66,1,30,2699
"17001000900",1853,416,13,144,86,0,0,0,2512
"17001001001",2878,587,51,36,69,19,12,26,3678
"17001001002",2472,459,46,0,71,0,10,1,3059
"17001001100",6579,629,72,35,472,147,184,0,8118
"17001010100",3508,367,0,0,13,9,48,22,3967
"17001010200",3007,460,0,0,66,17,10,0,3560
"17001010300",5640,410,48,2,13,0,76,0,6189
"17001010400",3083,244,0,0,9,0,0,0,3336
"17001010500",2866,54,27,12,28,0,0,0,2987
"17001010600",5016,896,11,15,41,1,0,0,5980
"17003957600",1704,379,206,65,97,11,5,0,2467
"17003957700",1441,297,254,146,4,4,11,64,2221
"17003957800",428,31,595,534,30,44,3,44,1709
"17003957900",213,266,206,580,13,42,4,0,1324
"17005951200",2367,388,100,14,48,56,5,0,2978
"17005951300",4392,863,30,4,627,66,98,69,6149
"17005951400",2621,375,37,0,30,3,62,77,3205
"17005951500",3953,575,0,65,185,53,198,12,5041
"17007010100",5718,848,29,189,1218,368,2315,558,11243
"17007010200",4491,863,102,19,318,0,1731,258,7782
"17007010300",4838,1183,142,34,220,205,1401,828,8851
"17007010400",5759,464,136,0,626,0,1456,34,8475
"17007010500",8634,377,488,0,469,0,412,86,10466
"17007010601",3248,372,0,0,191,10,515,42,4378
"17007010602",10487,1093,113,0,409,30,1230,29,13391
"17009970400",2539,225,0,0,86,43,31,0,2924
"17009970500",1896,367,23,0,16,6,0,0,2308
"17011964700",2553,246,2,0,38,16,47,0,2902
"17011964800",3103,403,0,0,10,19,95,16,3646
"17011964900",2156,183,19,2,24,12,26,23,2445
"17011965000",3309,328,19,2,142,66,1185,144,5195
"17011965100",3480,517,41,0,186,2,296,94,4616
"17011965200",2839,278,77,6,231,0,401,15,3847
"17011965300",2693,736,0,0,94,7,78,38,3646
"17011965400",2959,420,18,9,114,22,68,10,3620
"17011965500",3170,304,0,0,89,4,84,18,3669
"17011965600",2659,368,3,0,65,5,42,4,3146
"17013951200",2396,331,0,0,18,27,6,0,2778
"17013951300",1941,229,0,2,28,4,3,3,2210
"17015960100",3165,361,19,0,92,21,119,9,3786
"17015960200",1794,388,0,0,17,13,5,0,2217
"17015960300",2243,695,18,0,78,9,155,9,3207
"17015960400",1877,243,8,0,108,8,37,4,2285
"17015960500",2198,129,0,2,46,35,50,0,2460
"17015960600",1153,134,57,0,11,0,71,0,1426
"17017960100",2113,371,21,0,27,8,39,0,2579
"17017960200",2282,196,26,0,24,10,102,0,2640
"17017960300",2608,72,69,19,129,0,275,16,3188
"17017960400",1636,469,38,3,175,275,410,435,3441
"17017960500",1665,366,187,84,325,102,859,231,3819
"17019000200",90,53,930,354,48,21,0,0,1496
"17019000301",420,2690,0,325,114,612,74,259,4494
"17019000302",336,947,206,46,558,909,71,97,3170
"17019000401",173,893,0,0,41,136,67,29,1339
"17019000402",479,2267,21,208,20,446,9,149,3599
"17019000500",2415,723,164,18,317,142,148,73,4000
"17019000700",1536,438,757,370,395,105,810,142,4553
"17019000800",1782,666,629,703,1165,70,88,452,5555
"17019000901",1184,557,1508,1008,237,146,107,283,5030
"17019000902",3984,437,888,324,628,188,187,86,6722
"17019001000",2894,280,256,487,275,175,37,0,4404
"17019001100",3336,37,286,0,259,0,150,0,4068
"17019001201",3610,240,917,542,1204,342,194,83,7132
"17019001203",3577,271,476,22,329,46,71,25,4817
"17019001204",2754,48,43,0,726,0,122,0,3693
"17019001205",4092,215,221,89,944,157,321,0,6039
"17019001206",1636,9,32,0,98,0,68,0,1843
"17019001301",4390,337,356,19,681,109,117,94,6103
"17019001302",2790,126,205,0,437,77,142,0,3777
"17019001400",2132,235,120,68,906,116,282,0,3859
"17019005300",709,1144,1423,1005,406,1448,35,122,6292
"17019005401",2682,286,162,608,255,41,341,0,4375
"17019005402",2188,345,143,0,179,65,141,0,3061
"17019005500",3515,538,331,372,562,43,185,56,5602
"17019005600",3364,756,825,691,420,28,188,19,6291
"17019005701",2660,414,450,280,312,157,110,0,4383
"17019005702",2130,223,336,254,87,13,18,0,3061
"17019005800",1957,1084,58,113,209,257,177,74,3929
"17019005900",400,1022,115,156,165,513,48,129,2548
"17019006000",202,123,16,50,449,407,0,20,1267
"17019010100",2863,594,327,428,229,167,408,0,5016
"17019010204",2452,941,390,215,205,28,394,495,5120
"17019010300",1567,522,983,505,280,51,219,82,4209
"17019010400",3998,549,79,22,61,13,82,69,4873
"17019010500",4022,281,10,0,102,3,48,11,4477
"17019010601",5581,410,10,0,87,44,86,1,6219
"17019010603",6020,299,52,0,340,33,27,0,6771
"17019010604",2311,340,72,85,149,29,0,0,2986
"17019010700",7493,259,0,1,152,1,121,33,8060
"17019010800",3957,570,33,0,66,14,53,80,4773
"17019010900",8421,658,96,62,215,34,366,37,9889
"17019011000",2709,393,127,232,123,150,186,131,4051
"17019011100",684,688,3,0,477,478,47,199,2576
"17021958100",2383,393,11,0,64,7,41,0,2899
"17021958200",3394,558,1,0,104,24,29,0,4110
"17021958300",3707,333,20,0,97,30,32,30,4249
"17021958400",2782,653,0,6,56,0,21,0,3518
"17021958500",2351,323,19,0,20,25,91,30,2859
"17021958600",1834,356,5,0,0,13,20,57,2285
"17021958700",2974,461,10,6,27,0,5,1,3484
"17021958800",2040,726,0,0,5,11,5,0,2787
"17021958900",1788,641,0,44,30,37,0,0,2540
"17021959000",4049,226,3,0,43,0,39,0,4360
"17023060100",4277,528,5,0,102,0,11,0,4923
"17023060200",3445,556,0,0,41,8,10,62,4122
"17023060300",4442,667,4,16,109,7,77,20,5342
"17023060400",1494,174,0,0,4,0,0,0,1672
"17025971900",2057,227,0,2,35,3,9,0,2333
"17025972000",2475,298,0,15,25,14,0,0,2827
"17025972100",3949,952,22,26,56,107,0,0,5112
"17025972200",2672,456,0,0,67,0,20,0,3215
"17027900100",5697,186,5,6,105,10,74,29,6112
"17027900200",1928,124,0,3,8,3,14,0,2080
"17027900300",6066,570,0,0,119,11,182,0,6948
"17027900401",1232,105,14,0,15,10,0,0,1376
"17027900402",4315,474,64,52,100,72,91,14,5182
"17027900500",4340,794,80,51,172,30,135,0,5602
"17027900601",2269,68,0,1,21,0,35,0,2394
"17027900602",5847,416,96,118,170,80,205,29,6961
"17029000100",2542,500,0,0,45,4,72,3,3166
"17029000200",5442,765,31,0,30,1,16,0,6285
"17029000300",3884,562,6,40,31,50,53,0,4626
"17029000400",1683,524,10,0,21,27,34,27,2326
"17029000500",4050,1890,0,2,123,44,88,0,6197
"17029000600",3363,272,17,0,70,49,12,2,3785
"17029000700",3707,2031,391,187,143,97,75,34,6665
"17029000800",596,1003,57,217,119,98,80,80,2250
"17029000900",3583,463,97,41,101,50,42,6,4383
"17029001000",2729,492,193,6,175,36,87,96,3814
"17029001100",2508,468,47,13,67,0,72,0,3175
"17029001200",2480,783,0,0,79,114,1,30,3487
"17031010100",1756,428,1353,931,388,116,312,283,5567
"17031010201",2165,644,2128,1264,597,511,951,860,9120
"17031010202",933,272,504,259,216,150,376,234,2944
"17031010300",2092,594,857,568,1001,180,604,263,6159
"17031010400",1915,537,490,97,332,68,349,58,3846
"17031010501",1930,420,789,328,257,83,154,2,3963
"17031010502",1189,1035,477,107,397,478,418,165,4266
"17031010503",1036,600,199,27,136,217,294,14,2523
"17031010600",2944,641,1823,650,529,275,1183,536,8581
"17031010701",2364,13,568,116,730,138,1626,126,5681
"17031010702",1749,1147,841,340,1075,357,1688,1150,8347
"17031020100",1615,112,639,910,650,256,404,43,4629
"17031020200",3946,692,292,81,1413,110,268,158,6960
"17031020301",3894,256,235,33,771,44,632,0,5865
"17031020302",2579,262,397,58,605,297,640,54,4892
"17031020400",2334,279,561,132,1028,33,1045,0,5412
"17031020500",1958,458,933,225,1640,591,1659,239,7703
"17031020601",3461,733,306,110,1367,592,485,761,7815
"17031020602",1168,327,213,176,1543,497,797,415,5136
"17031020701",918,283,137,12,378,192,141,127,2188
"17031020702",3138,992,85,4,3131,547,533,581,9011
"17031020801",2171,1015,66,1,1366,178,1044,804,6645
"17031020802",1744,774,321,28,2916,1462,663,514,8422
"17031020901",1989,428,406,401,1447,692,1119,335,6817
"17031020902",1798,609,665,90,1032,78,391,95,4758
"17031030101",1738,531,549,202,707,128,599,244,4698
"17031030102",1492,290,413,202,561,100,453,98,3609
"17031030103",633,412,280,0,429,11,302,9,2076
"17031030104",725,235,246,174,273,319,68,18,2058
"17031030200",4361,303,366,115,448,110,722,76,6501
"17031030300",1606,259,308,71,346,341,796,414,4141
"17031030400",1419,354,208,71,427,110,474,251,3314
"17031030500",3906,813,382,34,1107,212,1385,669,8508
"17031030601",1317,458,442,177,417,172,126,139,3248
"17031030603",637,232,585,192,304,173,119,33,2275
"17031030604",1385,118,405,95,610,247,68,10,2938
"17031030701",734,42,180,120,567,153,63,35,1894
"17031030702",1119,74,53,0,280,12,22,0,1560
"17031030703",1411,415,362,75,333,24,146,15,2781
"17031030706",1704,211,510,153,657,104,444,62,3845
"17031030800",2526,323,45,2,824,343,395,235,4693
"17031030900",2120,72,46,30,1000,8,689,0,3965
"17031031000",2159,298,70,0,583,62,273,228,3673
"17031031100",2602,279,86,99,1059,10,604,21,4760
"17031031200",1411,877,672,942,731,471,390,193,5687
"17031031300",2614,655,1177,598,1595,423,512,266,7840
"17031031400",3717,321,286,58,545,109,494,27,5557
"17031031501",995,432,359,608,376,470,153,36,3429
"17031031502",1377,594,1191,742,310,240,583,180,5217
"17031031700",3203,636,557,1074,487,479,352,473,7261
"17031031800",1241,278,10,4,195,42,191,115,2076
"17031031900",1629,206,82,63,232,60,87,138,2497
"17031032100",4269,992,543,208,648,230,366,362,7618
"17031040100",2640,305,225,34,544,122,783,109,4762
"17031040201",3991,713,72,2,644,218,627,252,6519
"17031040202",3340,589,470,94,1437,790,734,563,8017
"17031040300",1407,107,178,2,659,125,189,0,2667
"17031040401",1916,210,65,0,620,171,461,129,3572
"17031040402",3144,365,172,58,619,73,431,214,5076
"17031040600",2007,159,45,34,242,42,379,30,2938
"17031040700",2574,135,68,7,281,103,696,77,3941
"17031040800",1336,54,0,0,270,4,70,5,1739
"17031040900",1712,134,0,1,327,0,318,29,2521
"17031050100",2337,39,46,0,136,0,307,9,2874
"17031050200",3988,197,174,0,686,27,1410,38,6520
"17031050300",2009,192,0,15,221,75,340,44,2896
"17031050500",4567,105,25,7,500,0,401,2,5607
"17031050600",2058,200,55,0,190,0,177,32,2712
"17031050700",1365,43,17,0,49,14,135,14,1637
"17031050800",1178,58,5,0,91,17,65,17,1431
"17031050900",1457,79,0,0,81,27,42,13,1699
"17031051000",1269,49,10,15,200,0,200,0,1743
"17031051100",1325,95,93,11,159,0,228,52,1963
"17031051200",1255,124,82,20,138,0,147,35,1801
"17031051300",2401,114,32,21,138,24,382,0,3112
"17031051400",1835,181,14,53,290,0,444,46,2863
"17031060100",2225,127,105,55,49,21,330,0,2912
"17031060200",1341,226,29,39,126,74,148,94,2077
"17031060300",3007,148,10,0,105,0,77,0,3347
"17031060400",3650,279,0,0,223,10,445,55,4662
"17031060500",761,173,33,10,63,117,51,38,1246
"17031060800",3630,224,221,14,629,103,218,19,5058
"17031060900",4830,352,353,42,882,98,1052,31,7640
"17031061000",1313,122,25,0,104,108,273,0,1945
"17031061100",1048,142,0,0,51,12,27,19,1299
"17031061200",1751,278,20,12,213,22,40,33,2369
"17031061500",1775,97,28,0,128,0,151,28,2207
"17031061800",847,121,0,13,39,48,95,5,1168
"17031061901",2840,229,30,109,419,140,364,52,4183
"17031061902",2909,341,169,28,405,39,259,14,4164
"17031062000",2203,206,121,18,187,27,146,10,2918
"17031062100",2390,392,10,17,424,80,129,29,3471
"17031062200",2445,302,42,0,235,41,248,0,3313
"17031062300",1346,211,0,0,103,8,78,0,1746
"17031062400",1550,8,25,0,121,5,120,4,1833
"17031062500",1054,96,0,0,96,0,29,21,1296
"17031062600",1811,184,21,0,250,6,198,169,2639
"17031062700",2027,406,13,11,205,34,138,33,2867
"17031062800",2837,279,79,52,363,20,272,31,3933
"17031062900",3364,624,10,0,272,8,168,0,4446
"17031063000",2276,549,46,12,284,100,148,59,3474
"17031063100",1725,292,8,55,248,51,93,55,2527
"17031063200",4381,490,215,24,519,430,108,45,6212
"17031063301",1495,480,83,69,248,43,133,13,2564
"17031063302",3238,378,50,1,373,0,186,0,4226
"17031063303",1154,55,37,0,21,5,6,0,1278
"17031063400",1414,383,27,101,133,12,102,50,2222
"17031070101",3233,496,37,36,304,25,22,0,4153
"17031070102",1703,135,178,43,241,55,340,15,2710
"17031070103",1303,300,38,0,131,23,114,81,1990
"17031070200",3147,381,110,0,300,27,244,16,4225
"17031070300",2378,485,0,29,337,141,112,25,3507
"17031070400",2991,304,61,47,25,72,251,54,3805
"17031070500",2455,164,33,9,163,43,132,33,3032
"17031070600",2669,60,47,0,58,0,139,6,2979
"17031070700",2687,344,58,41,488,55,426,190,4289
"17031071000",1591,547,17,5,146,47,115,98,2566
"17031071100",1982,395,0,2,127,25,69,18,2618
"17031071200",1496,292,9,77,184,31,150,50,2289
"17031071300",2880,325,87,15,202,24,80,0,3613
"17031071400",3659,401,49,102,379,76,208,26,4900
"17031071500",4533,377,160,68,407,17,192,83,5837
"17031071600",1316,151,70,10,121,34,13,15,1730
"17031071700",1319,66,134,120,145,0,170,0,1954
"17031071800",1913,100,286,70,203,0,196,0,2768
"17031080100",5313,370,285,0,448,30,391,0,6837
"17031080201",2905,179,177,0,190,12,21,50,3534
"17031080202",2851,150,175,0,320,25,83,0,3604
"17031080300",3336,228,136,190,569,37,216,41,4753
"17031080400",1380,217,451,2135,269,17,62,62,4593
"17031081000",3965,854,487,265,722,365,345,170,7173
"17031081100",2522,418,127,253,221,111,94,102,3848
"17031081201",3339,260,96,2,529,135,135,93,4589
"17031081202",2696,239,0,0,333,0,198,0,3466
"17031081300",3720,237,258,12,650,117,121,11,5126
"17031081401",1332,280,386,19,274,20,49,0,2360
"17031081402",2978,187,183,0,579,145,120,21,4213
"17031081403",4559,237,95,17,1727,151,304,127,7217
"17031081500",3003,333,13,10,739,78,78,24,4278
"17031081600",2250,322,58,0,596,159,199,67,3651
"17031081700",2292,49,86,80,641,77,519,59,3803
"17031081800",5905,286,167,21,828,36,340,32,7615
"17031081900",438,13,176,498,172,0,31,0,1328
"17031090100",2893,90,0,0,139,0,264,0,3386
"17031090200",5893,134,0,0,280,24,384,12,6727
"17031090300",1302,103,0,0,26,0,26,0,1457
"17031100100",4932,290,27,0,717,23,1020,0,7009
"17031100200",5565,168,185,0,867,58,1061,98,8002
"17031100300",5096,447,26,0,315,27,759,28,6698
"17031100400",2581,304,0,4,70,0,253,28,3240
"17031100500",4613,64,0,3,480,2,837,5,6004
"17031100600",4132,146,19,0,585,56,627,103,5668
"17031100700",3652,456,0,2,494,86,508,41,5239
"17031110100",4466,282,76,0,1069,100,995,218,7206
"17031110200",1977,389,0,14,492,21,308,36,3237
"17031110300",4398,170,37,0,633,72,1023,24,6357
"17031110400",3634,240,21,5,771,7,1052,0,5730
"17031110501",3671,190,152,1,815,0,1173,22,6024
"17031110502",2294,329,0,34,526,224,598,207,4212
"17031120100",3467,141,0,3,307,17,214,0,4149
"17031120200",3689,87,38,0,693,19,353,0,4879
"17031120300",4727,224,42,70,1355,95,430,147,7090
"17031120400",2271,154,0,0,963,348,851,218,4805
"17031130100",3714,272,0,62,1735,182,528,61,6554
"17031130200",1216,80,48,10,121,55,273,0,1803
"17031130300",2327,377,138,0,2250,311,1014,108,6525
"17031140100",1123,544,107,304,1337,619,1396,914,6344
"17031140200",1643,284,83,35,2161,936,2111,792,8045
"17031140301",933,115,43,0,1201,447,1384,505,4628
"17031140302",1403,234,283,44,1382,979,1278,679,6282
"17031140400",3323,801,73,0,2945,205,1760,572,9679
"17031140500",2013,459,145,0,1397,225,1719,435,6393
"17031140601",924,85,18,113,1600,547,1808,366,5461
"17031140602",1907,510,207,81,2250,759,2903,1097,9714
"17031140701",1311,140,66,2,686,91,967,130,3393
"17031140702",2605,775,178,185,1974,437,3143,804,10101
"17031140800",4334,234,114,0,2081,841,2456,538,10598
"17031150200",4543,412,186,58,1290,1101,1358,973,9921
"17031150300",4452,731,72,31,1697,34,2012,125,9154
"17031150401",3149,489,23,0,812,187,782,300,5742
"17031150402",2521,173,0,0,688,260,1589,274,5505
"17031150501",2844,158,0,4,889,37,1337,0,5269
"17031150502",2680,177,17,6,1408,328,1769,326,6711
"17031150600",2684,254,0,0,719,161,1215,167,5200
"17031150700",2994,333,30,0,1042,15,1731,203,6348
"17031150800",2971,472,25,0,1652,150,2377,480,8127
"17031151001",646,384,53,0,752,586,933,783,4137
"17031151002",2024,271,0,6,2212,494,2916,459,8382
"17031151100",2519,520,35,0,1853,228,2298,416,7869
"17031151200",2614,302,136,0,643,12,1227,0,4934
"17031160100",2115,135,0,1,557,11,556,38,3413
"17031160200",2274,222,109,11,1113,11,831,13,4584
"17031160300",1642,361,330,235,702,402,579,353,4604
"17031160400",2543,752,149,4,1060,584,1547,934,7573
"17031160501",2374,471,114,36,980,314,2284,688,7261
"17031160502",2463,324,25,0,1427,322,2393,449,7403
"17031160601",2373,380,13,1,1127,102,1904,325,6225
"17031160602",2162,520,108,0,898,223,1463,517,5891
"17031160700",3411,666,200,1,1180,133,2251,571,8413
"17031160800",3827,500,55,0,1291,25,2971,412,9081
"17031160900",1832,142,7,1,428,58,547,93,3108
"17031161000",1362,204,4,2,160,21,387,87,2227
"17031161100",1603,150,26,10,404,22,343,44,2602
"17031161200",1980,191,14,0,575,63,1295,173,4291
"17031161300",2816,511,19,53,338,17,1875,370,5999
"17031170100",1465,230,0,4,82,16,167,48,2012
"17031170200",3077,140,0,1,695,117,1240,59,5329
"17031170300",3721,505,0,0,529,307,625,446,6133
"17031170400",2911,615,10,0,174,6,613,50,4379
"17031170500",4190,249,139,10,111,0,906,41,5646
"17031170600",2115,115,20,42,420,40,472,39,3263
"17031170700",2179,389,0,0,219,21,346,133,3287
"17031170800",2840,417,10,0,287,154,748,231,4687
"17031170900",1386,50,88,0,136,80,280,75,2095
"17031171000",5732,526,34,95,1042,0,2007,0,9436
"17031171100",2906,231,0,0,1357,57,1747,155,6453
"17031180100",3389,282,62,15,1156,402,2068,321,7695
"17031190100",852,126,61,0,1335,286,1827,364,4851
"17031190200",1860,354,24,83,2394,1113,3175,1160,10163
"17031190300",2599,453,0,0,1709,344,2631,611,8347
"17031190401",2694,217,0,0,1084,243,2252,285,6775
"17031190402",1946,454,151,19,1700,461,2462,803,7996
"17031190601",1466,75,14,143,2027,1019,2694,1014,8452
"17031190602",1947,67,147,234,1926,529,3185,595,8630
"17031190701",1270,70,10,76,1274,33,2028,53,4814
"17031190702",1525,195,199,55,2216,715,3076,819,8800
"17031190800",1780,157,206,43,3535,1180,4579,1202,12682
"17031190900",705,22,76,152,908,291,1460,313,3927
"17031191000",904,184,75,54,1197,461,1999,641,5515
"17031191100",1527,501,368,183,3728,1254,4960,1662,14183
"17031191200",598,388,14,58,1953,870,2359,1136,7376
"17031191301",1376,354,494,196,2815,726,4011,1069,11041
"17031191302",1858,322,248,18,1645,942,3477,1239,9749
"17031200100",1723,189,53,0,2236,404,3392,443,8440
"17031200200",1174,72,39,0,3287,787,4047,828,10234
"17031200300",501,305,21,0,1097,307,1413,607,4251
"17031200401",1511,256,48,0,1751,501,3122,757,7946
"17031200402",662,387,42,32,2098,677,2563,1058,7519
"17031210100",2418,583,155,3,656,110,1383,372,5680
"17031210400",1911,502,44,5,393,119,1659,425,5058
"17031210501",2987,771,202,0,652,94,2732,423,7861
"17031210502",3467,1148,51,4,298,67,2750,823,8608
"17031210601",2128,290,47,1,734,32,1947,240,5419
"17031210602",2750,893,60,6,272,51,2196,754,6982
"17031210700",3342,521,13,0,312,60,2357,409,7014
"17031210800",658,181,15,2,198,72,472,179,1777
"17031210900",1851,347,196,0,665,48,1485,316,4908
"17031220300",1555,169,77,7,319,26,448,44,2645
"17031220400",1847,224,24,0,461,62,616,178,3412
"17031220500",1965,411,69,92,152,42,617,183,3531
"17031220601",909,227,158,5,136,14,462,183,2094
"17031220602",2575,995,205,74,598,101,704,889,6141
"17031220701",2305,876,274,78,133,19,1781,729,6195
"17031220702",2956,638,40,146,297,186,2596,645,7504
"17031220901",1380,1079,233,75,404,161,1375,1093,5800
"17031220902",1839,838,23,205,266,34,1809,629,5643
"17031221000",1949,637,224,132,276,44,1670,642,5574
"17031221100",2725,721,238,330,397,198,1613,613,6835
"17031221200",1656,390,136,0,566,60,970,249,4027
"17031221300",1655,466,67,92,299,24,741,387,3731
"17031221400",2359,548,11,100,78,91,1490,484,5161
"17031221500",1886,451,82,10,241,25,1004,280,3979
"17031221600",2310,346,21,3,367,31,659,95,3832
"17031222200",1643,53,17,7,189,11,144,6,2070
"17031222500",1031,184,55,68,70,41,739,197,2385
"17031222600",983,238,136,47,191,41,608,123,2367
"17031222700",1624,545,59,169,112,116,1204,602,4431
"17031222800",329,301,148,106,0,18,275,363,1540
"17031222900",497,240,49,97,139,0,554,195,1771
"17031230100",465,193,149,52,621,108,796,200,2584
"17031230200",632,17,148,129,593,193,1059,193,2964
"17031230300",164,145,14,14,591,107,742,239,2016
"17031230400",891,88,168,14,870,490,1632,550,4703
"17031230500",936,210,189,133,1260,696,2119,980,6523
"17031230600",1206,289,919,1462,2299,1432,3208,1848,12663
"17031230700",1503,275,288,305,1937,631,3301,890,9130
"17031230800",500,41,58,12,403,37,757,75,1883
"17031230900",1054,417,616,809,1361,669,1896,967,7789
"17031231100",183,17,468,301,54,16,149,27,1215
"17031231200",323,237,1718,1676,727,372,906,541,6500
"17031231500",96,61,3778,1970,235,64,203,61,6468
"17031240200",1350,103,10,5,178,13,388,38,2085
"17031240300",1227,62,0,0,118,0,65,0,1472
"17031240500",1747,104,0,14,356,7,322,0,2550
"17031240600",845,302,20,17,43,256,169,553,2205
"17031240700",685,554,47,43,426,46,476,572,2849
"17031240800",829,356,91,33,218,61,828,364,2780
"17031240900",496,56,76,44,221,93,413,102,1501
"17031241000",863,127,314,328,164,118,611,197,2722
"17031241100",2126,418,293,162,646,131,1155,338,5269
"17031241200",1235,174,67,77,390,66,267,105,2381
"17031241300",1142,131,98,137,148,69,177,135,2037
"17031241400",3238,430,404,401,495,87,411,226,5692
"17031241500",2343,214,21,25,411,88,541,2,3645
"17031241600",2359,454,139,17,353,99,559,194,4174
"17031242000",2187,321,659,221,520,136,739,163,4946
"17031242100",2363,238,121,13,359,34,475,19,3622
"17031242200",3029,410,144,83,350,31,516,260,4823
"17031242300",2763,183,54,20,293,74,547,45,3979
"17031242400",2306,241,35,0,275,2,213,24,3096
"17031242500",2632,388,79,40,764,140,1588,349,5980
"17031242600",2892,409,246,297,1017,360,1806,439,7466
"17031242700",486,149,286,267,316,324,382,482,2692
"17031242800",1167,181,8,1,178,12,228,22,1797
"17031242900",1208,213,102,7,287,130,418,223,2588
"17031243000",1812,360,2,0,311,11,955,316,3767
"17031243100",1357,334,97,8,747,10,1095,262,3910
"17031243200",1463,181,15,0,487,26,707,130,3009
"17031243300",1685,223,90,8,271,65,409,189,2940
"17031243400",1796,172,166,16,605,92,938,97,3882
"17031243500",2352,106,103,267,289,51,255,37,3460
"17031250200",322,81,1510,328,401,335,859,422,4258
"17031250300",170,0,2854,771,325,728,353,728,5929
"17031250400",215,0,3677,1268,437,332,724,365,7018
"17031250500",3842,397,1893,380,1063,0,1927,59,9561
"17031250600",58,41,3498,661,195,74,219,74,4820
"17031250700",77,0,3463,2215,117,0,187,42,6101
"17031250800",43,22,1542,476,39,129,75,119,2445
"17031251000",95,0,794,321,0,0,92,0,1302
"17031251100",237,19,2684,1481,86,136,288,87,5018
"17031251200",93,5,2847,871,314,0,111,0,4241
"17031251300",144,17,2828,1552,132,0,243,2,4918
"17031251400",119,32,2316,1368,86,0,116,1,4038
"17031251500",138,34,2565,1267,0,96,69,104,4273
"17031251600",29,11,2002,1047,158,0,171,2,3420
"17031251700",56,52,640,812,37,220,56,272,2145
"17031251800",6,3,2815,2081,0,27,0,0,4932
"17031251900",8,21,3259,2416,88,27,88,54,5961
"17031252000",183,87,3920,1992,0,10,149,79,6420
"17031252101",11,0,1222,429,157,0,110,0,1929
"17031252102",0,0,3860,2065,13,0,0,0,5938
"17031252201",35,7,1515,865,8,3,8,0,2441
"17031252202",57,12,3028,1375,7,25,0,25,4529
"17031260100",21,53,573,505,0,0,2,0,1154
"17031260200",30,0,482,530,0,0,25,0,1067
"17031260300",15,18,680,678,48,11,48,0,1498
"17031260400",8,0,670,797,12,2,0,1,1490
"17031260500",2,4,1187,617,0,2,0,0,1812
"17031260600",18,74,1418,1280,27,0,8,6,2831
"17031260700",30,0,978,954,18,15,5,10,2010
"17031260800",0,0,1190,1267,5,0,0,20,2482
"17031260900",14,48,763,921,0,12,0,11,1769
"17031261000",0,0,1613,1026,14,0,14,0,2667
"17031270500",22,69,721,929,39,15,0,54,1849
"17031271200",18,0,930,470,0,14,0,14,1446
"17031271300",7,3,599,552,4,0,0,3,1168
"17031271400",31,11,862,440,19,0,19,0,1382
"17031271500",4,0,616,621,8,0,0,0,1249
"17031271800",18,0,495,390,0,0,0,0,903
"17031280100",4489,309,222,5,681,24,440,46,6216
"17031280400",87,28,400,577,40,4,15,8,1159
"17031280800",51,2,355,257,11,0,11,0,687
"17031280900",62,20,251,453,41,0,54,0,881
"17031281900",2002,256,304,29,1000,533,251,0,4375
"17031282700",508,336,763,469,372,54,614,301,3417
"17031282800",847,44,430,12,392,76,261,39,2101
"17031283100",443,210,996,467,490,213,78,0,2897
"17031283200",351,135,326,203,284,61,83,10,1453
"17031283800",894,104,1149,470,503,129,237,111,3597
"17031290900",6,39,1796,2018,54,0,17,10,3940
"17031291200",22,10,1095,1142,0,0,0,0,2269
"17031291600",162,67,95,47,359,93,502,112,1437
"17031292200",63,0,1496,1490,16,0,0,0,3065
"17031292400",61,47,933,992,5,0,12,0,2050
"17031292500",43,9,2458,1641,9,0,10,54,4224
"17031300500",1393,491,42,36,977,70,2303,561,5873
"17031300600",1470,503,394,55,687,92,2127,595,5923
"17031300700",1982,1131,45,32,573,702,2438,1833,8736
"17031300800",1613,1002,0,17,974,529,2559,1522,8216
"17031300900",1393,1221,61,2,564,363,1929,1491,7024
"17031301100",1013,793,45,51,452,451,1423,1243,5471
"17031301200",1376,974,206,32,717,228,1969,1134,6636
"17031301600",1905,1310,4,128,651,323,2488,1627,8436
"17031301701",2392,903,1,1,205,113,2510,1015,7140
"17031301702",1398,1280,0,0,522,358,1826,1638,7022
"17031301801",2283,921,0,185,304,336,2484,1254,7767
"17031301802",1070,644,0,13,831,57,1871,682,5168
"17031301803",1738,1354,0,0,1141,388,2816,1715,9152
"17031310200",710,176,30,1,419,63,654,190,2243
"17031310300",543,72,53,33,535,188,713,149,2286
"17031310400",738,48,54,14,379,62,842,90,2227
"17031310500",522,305,7,0,415,340,868,624,3081
"17031310600",1680,854,433,144,1822,631,2733,1167,9464
"17031310700",477,239,12,74,335,57,643,258,2095
"17031310800",1775,735,33,1,1823,271,3245,880,8763
"17031310900",1658,954,92,17,1755,496,2844,1383,9199
"17031320100",6115,413,721,23,1568,494,514,145,9993
"17031320400",541,20,1,0,115,25,17,0,719
"17031320600",2312,241,395,188,765,114,204,19,4238
"17031330100",8380,586,2847,545,3410,429,1089,0,17286
"17031330200",1702,156,1126,125,718,151,118,33,4129
"17031340300",331,36,5,4,1182,361,76,0,1995
"17031340400",206,18,0,2,1009,653,62,1,1951
"17031340500",724,72,145,58,184,328,247,72,1830
"17031340600",0,0,305,956,0,5,0,0,1266
"17031350100",170,7,972,127,397,267,57,7,2004
"17031350400",0,0,269,715,29,55,29,22,1119
"17031351000",99,24,2150,484,452,553,0,0,3762
"17031351100",8,0,570,1290,12,0,0,0,1880
"17031351400",163,26,455,757,24,12,84,0,1521
"17031351500",28,25,154,25,48,31,0,0,311
"17031360200",0,0,552,816,119,0,26,0,1513
"17031380100",178,8,1083,652,0,28,0,0,1949
"17031380200",94,31,1091,418,9,47,22,16,1728
"17031380500",3,0,572,263,3,0,0,0,841
"17031380700",196,7,621,257,12,0,0,0,1093
"17031381200",27,0,1594,331,36,20,38,0,2046
"17031381400",5,0,1159,510,13,0,31,0,1718
"17031381500",0,3,108,51,16,0,0,0,178
"17031381700",0,0,0,0,0,0,0,0,0
"17031381800",111,2,567,306,267,19,246,9,1527
"17031381900",95,0,877,330,33,0,0,0,1335
"17031390100",35,0,1189,98,50,4,46,0,1422
"17031390200",89,24,1079,510,44,0,12,1,1759
"17031390300",72,2,1319,1218,54,0,34,0,2699
"17031390400",98,10,1472,1070,81,0,33,0,2764
"17031390500",280,39,941,210,112,39,29,6,1656
"17031390600",753,118,643,126,308,21,120,21,2110
"17031390700",1346,658,2541,75,646,378,251,184,6079
"17031400300",0,0,966,414,6,6,6,6,1404
"17031400400",0,0,849,734,11,0,19,0,1613
"17031400500",0,0,932,1362,11,13,0,0,2318
"17031400800",0,2,1182,1673,0,27,0,1,2885
"17031410100",425,96,746,160,129,241,164,207,2168
"17031410200",262,103,149,52,154,175,12,12,919
"17031410500",567,176,1111,422,180,128,50,52,2686
"17031410600",688,377,882,100,211,77,25,22,2382
"17031410700",814,157,415,64,327,133,45,10,1965
"17031410800",896,249,1056,354,512,140,191,51,3449
"17031410900",1387,279,747,172,214,72,120,67,3058
"17031411000",1462,320,678,182,320,105,84,17,3168
"17031411100",1284,100,57,41,365,137,13,8,2005
"17031411200",1041,260,208,25,194,74,12,5,1819
"17031420100",60,0,636,522,16,11,40,0,1285
"17031420200",156,57,694,277,162,0,11,0,1357
"17031420300",135,114,664,184,19,68,6,8,1198
"17031420400",243,104,375,352,217,72,76,16,1455
"17031420500",0,11,1109,981,61,66,7,0,2235
"17031420600",13,51,606,923,0,14,0,0,1607
"17031420700",46,52,1728,1111,0,48,1,30,3016
"17031420800",42,0,1344,839,69,0,23,0,2317
"17031421200",0,0,1119,506,0,16,0,16,1657
"17031430101",80,0,3027,735,383,8,10,0,4243
"17031430102",49,1,2355,802,55,0,15,0,3277
"17031430200",22,0,2031,2198,210,6,131,3,4601
"17031430300",4,0,1476,889,0,41,0,0,2410
"17031430400",9,10,1826,1267,56,41,0,21,3230
"17031430500",28,2,1932,1417,52,7,50,0,3488
"17031430600",12,8,1239,460,50,5,0,0,1774
"17031430700",11,0,1532,765,21,61,10,8,2408
"17031430800",18,10,1262,418,49,12,3,10,1782
"17031430900",0,20,1041,372,6,0,0,0,1439
"17031431200",50,2,2571,226,43,35,46,35,3008
"17031431301",38,0,1506,1435,94,30,24,1,3128
"17031431302",0,2,1981,1110,170,47,99,48,3457
"17031431400",108,89,4092,1699,46,44,25,95,6198
"17031440101",0,15,2154,1554,41,0,48,0,3812
"17031440102",25,0,1917,1027,0,0,7,0,2976
"17031440201",0,24,3833,1540,42,10,0,11,5460
"17031440202",0,7,2515,957,85,0,8,0,3572
"17031440300",76,19,3766,481,123,31,1,0,4497
"17031440600",18,0,1641,478,4,14,9,0,2164
"17031440700",5,0,1127,430,27,0,0,0,1589
"17031440800",0,0,1181,798,5,22,0,22,2028
"17031440900",1,2,1935,296,14,0,19,0,2267
"17031450300",151,0,2730,701,28,0,34,0,3644
"17031460100",516,133,1609,934,180,17,548,318,4255
"17031460200",770,305,546,649,108,44,714,340,3476
"17031460301",454,173,1415,725,192,142,599,306,4006
"17031460302",52,20,1602,1454,220,0,163,12,3523
"17031460400",8,0,2703,568,0,20,0,0,3299
"17031460500",75,29,4167,510,118,0,40,0,4939
"17031460600",110,51,463,431,60,0,105,45,1265
"17031460700",616,253,403,1281,213,273,739,499,4277
"17031461000",379,259,592,540,99,58,561,234,2722
"17031470100",18,0,1574,1245,0,0,0,0,2837
"17031480100",36,0,1644,216,7,5,11,0,1919
"17031480200",0,0,1055,228,6,0,0,0,1289
"17031480300",21,3,913,231,30,0,66,0,1264
"17031480400",69,0,5590,616,103,0,56,0,6434
"17031480500",269,20,2090,391,63,244,200,355,3632
"17031490300",42,0,1744,451,84,4,12,9,2346
"17031490400",0,0,857,70,22,0,0,0,949
"17031490500",0,0,2079,158,0,0,112,0,2349
"17031490600",1,3,1150,175,21,0,0,1,1351
"17031490700",25,0,2021,758,51,18,0,0,2873
"17031490800",127,0,2714,737,64,27,20,0,3689
"17031490901",26,42,2642,1182,58,0,0,3,3953
"17031490902",29,0,4523,755,38,0,0,0,5345
"17031491000",31,1,2764,2302,7,0,0,45,5150
"17031491100",35,15,3586,828,22,0,22,54,4562
"17031491200",4,0,2108,617,13,0,21,0,2763
"17031491300",10,20,1595,734,29,12,31,6,2437
"17031491400",15,20,1521,1007,12,0,0,0,2575
"17031500100",10,13,2625,638,26,0,68,0,3380
"17031500200",80,10,1096,871,26,15,69,10,2177
"17031500300",779,89,384,91,144,25,480,48,2040
"17031510100",1488,497,53,128,1082,241,2328,695,6512
"17031510200",310,107,1811,514,0,130,221,197,3290
"17031510300",33,1,3987,1717,63,166,12,68,6047
"17031520100",942,480,97,35,191,309,978,743,3775
"17031520200",1773,997,130,276,236,173,1550,1196,6331
"17031520300",3788,1545,44,0,998,376,4234,1787,12772
"17031520400",2408,374,134,52,681,208,2679,459,6995
"17031520500",3338,442,0,28,541,28,2420,365,7162
"17031520600",2044,168,0,0,608,53,1948,218,5039
"17031530100",599,171,683,655,267,83,828,178,3464
"17031530200",0,0,2948,2762,0,26,0,0,5736
"17031530300",47,10,3219,821,42,0,0,0,4139
"17031530400",19,0,1508,486,17,4,17,4,2055
"17031530501",42,37,2789,2292,104,0,13,8,5285
"17031530502",11,0,1178,239,0,0,0,0,1428
"17031530503",11,40,3837,1502,78,15,19,39,5541
"17031530600",9,91,1718,1166,11,0,9,79,3083
"17031540101",149,31,1011,2347,14,2,149,72,3775
"17031540102",0,0,1404,1920,17,9,17,0,3367
"17031550100",4737,743,512,199,594,328,2915,686,10714
"17031550200",2159,285,28,2,155,67,1160,298,4154
"17031560100",591,66,33,40,201,93,550,62,1636
"17031560200",329,6,1194,218,45,5,181,0,1978
"17031560300",1487,115,389,0,1094,109,1678,148,5020
"17031560400",709,232,0,0,415,0,652,222,2230
"17031560700",2431,268,1,3,623,188,1420,338,5272
"17031560800",4741,111,25,31,900,83,2470,83,8444
"17031560900",4129,278,20,0,853,2,1442,95,6819
"17031561000",3802,251,0,0,619,226,1563,242,6703
"17031561100",4802,144,0,0,836,27,2111,86,8006
"17031570100",925,125,0,0,244,41,862,128,2325
"17031570200",1367,89,19,0,448,20,1355,85,3383
"17031570300",3618,670,0,0,1651,490,3972,966,11367
"17031570400",953,199,13,1,514,63,1267,214,3224
"17031570500",1186,254,193,0,773,207,1413,393,4419
"17031580100",1222,650,6,9,924,334,1508,688,5341
"17031580200",1031,348,15,38,1009,581,1726,820,5568
"17031580300",1015,270,0,0,840,77,1543,296,4041
"17031580400",1958,427,18,87,926,446,2281,705,6848
"17031580501",2813,739,8,77,1003,304,3150,822,8916
"17031580502",2703,691,181,29,821,428,2841,822,8516
"17031580600",3147,1132,183,59,1086,272,3744,1301,10924
"17031580700",2826,1508,33,0,1546,302,3738,1767,11720
"17031580800",670,393,16,4,427,90,1060,453,3113
"17031590500",930,155,19,5,516,252,935,174,2986
"17031590600",1785,257,37,0,1720,211,2212,348,6570
"17031590700",1466,304,123,82,984,251,1850,362,5422
"17031600400",1261,168,8,9,2464,687,521,141,5259
"17031600600",499,465,0,0,1184,337,304,427,3216
"17031600700",1102,149,75,54,935,93,906,10,3324
"17031600900",1196,369,333,89,1196,258,622,317,4380
"17031610300",2109,1270,149,116,1301,543,2922,1691,10101
"17031610400",717,324,0,54,368,131,1070,423,3087
"17031610800",1224,265,19,0,54,0,108,77,1747
"17031611000",181,61,184,489,16,190,145,247,1513
"17031611100",787,727,206,237,304,246,1049,917,4473
"17031611200",926,425,218,274,155,301,996,641,3936
"17031611300",1027,633,255,147,616,333,1423,916,5350
"17031611400",1675,465,0,180,994,445,2465,825,7049
"17031611500",1518,253,140,90,591,251,2041,467,5351
"17031611600",224,6,802,707,45,101,269,107,2261
"17031611700",220,67,585,406,57,53,247,93,1728
"17031611800",326,257,846,444,101,304,287,497,3062
"17031611900",175,42,964,899,40,0,199,0,2319
"17031612000",5,1,828,627,124,8,121,0,1714
"17031612100",102,0,664,385,0,29,24,0,1204
"17031620100",2292,471,159,50,1402,341,3010,834,8559
"17031620200",1256,263,10,0,917,59,1483,277,4265
"17031620300",3631,929,55,17,1981,320,4026,1057,12016
"17031620400",2970,166,78,9,1138,883,3578,1034,9856
"17031630100",544,61,70,157,119,118,624,179,1872
"17031630200",885,241,0,10,593,402,1338,612,4081
"17031630300",3165,808,0,18,1412,312,4329,1039,11083
"17031630400",2245,986,0,0,2498,1266,4432,2222,13649
"17031630500",2305,964,100,6,2601,242,4691,1116,12025
"17031630800",2382,1404,125,192,2092,571,4111,1939,12816
"17031630900",1961,420,48,12,1578,753,3334,1150,9256
"17031640100",761,49,0,0,294,0,715,0,1819
"17031640300",5178,348,12,0,1202,77,2737,292,9846
"17031640400",2323,124,0,0,902,126,1242,156,4873
"17031640500",2549,93,62,1,301,104,774,149,4033
"17031640600",2819,419,0,0,592,289,1017,433,5569
"17031640700",1992,229,0,0,805,23,1660,122,4831
"17031640800",870,210,87,0,432,110,1046,200,2955
"17031650100",1130,576,0,139,2424,525,3122,816,8732
"17031650200",2412,845,44,58,3278,502,4477,1162,12778
"17031650301",2585,353,0,61,2344,386,3824,698,10251
"17031650302",1704,284,117,0,1693,318,2964,552,7632
"17031650400",1930,244,276,44,3510,1250,4691,1456,13401
"17031650500",1775,220,252,101,1396,387,2239,564,6934
"17031660301",110,129,443,544,532,159,636,157,2710
"17031660302",623,324,644,292,3253,521,3742,797,10196
"17031660400",1449,106,151,89,2230,1503,3473,1558,10559
"17031660500",1005,528,515,434,2321,628,3035,1132,9598
"17031660600",225,125,2047,1979,1314,441,1463,513,8107
"17031660700",27,84,1167,1010,97,14,0,24,2423
"17031660800",525,40,2294,1202,1566,874,1953,891,9345
"17031660900",137,73,2336,1576,165,284,112,163,4846
"17031661000",96,0,4112,1191,241,0,93,0,5733
"17031661100",1190,291,2405,595,928,417,1759,692,8277
"17031670100",8,42,914,732,0,0,0,0,1696
"17031670200",32,0,638,358,0,56,32,56,1172
"17031670300",59,11,533,579,0,57,20,0,1259
"17031670400",22,84,796,776,43,130,65,123,2039
"17031670500",0,10,614,537,51,0,56,0,1268
"17031670600",0,0,789,657,141,12,76,12,1687
"17031670700",41,0,944,469,12,17,55,0,1538
"17031670800",0,1,807,818,34,0,34,0,1694
"17031670900",0,0,1055,368,17,0,0,0,1440
"17031671100",3,0,464,1057,0,0,0,0,1524
"17031671200",14,0,545,400,7,29,0,0,995
"17031671300",0,0,1158,1133,23,12,0,0,2326
"17031671400",0,36,1258,367,0,6,0,66,1733
"17031671500",57,3,2269,1302,26,0,27,1,3685
"17031671600",12,47,1110,958,125,0,114,0,2366
"17031671800",0,0,632,423,64,0,10,0,1129
"17031671900",0,0,1020,278,4,0,0,0,1302
"17031672000",24,0,2830,826,114,0,110,0,3904
"17031680500",48,53,677,492,0,52,48,52,1422
"17031680600",0,0,747,912,88,13,0,0,1760
"17031680900",10,8,1596,1695,37,22,38,1,3407
"17031681000",1,2,1219,1560,0,76,0,76,2934
"17031681100",7,26,1725,1671,0,0,0,21,3450
"17031681200",8,0,1206,1193,10,97,0,0,2514
"17031681300",0,0,1559,1172,22,57,0,12,2822
"17031681400",0,0,1657,1497,12,0,0,0,3166
"17031690300",0,9,1050,760,9,0,0,9,1837
"17031690400",16,7,2033,1417,38,12,103,18,3644
"17031690500",0,0,618,388,0,5,0,0,1011
"17031690900",30,56,3020,1549,79,0,52,0,4786
"17031691000",18,9,1778,601,7,21,7,0,2441
"17031691100",22,1,1462,1514,23,72,56,0,3150
"17031691200",0,0,1535,1257,14,146,0,0,2952
"17031691300",0,0,2430,239,0,0,7,0,2676
"17031691400",20,27,2427,712,43,7,0,7,3243
"17031691500",0,36,1148,782,0,68,14,108,2156
"17031700100",381,37,1880,142,342,208,501,208,3699
"17031700200",1806,608,890,44,2937,607,3793,993,11678
"17031700301",2751,309,707,26,1423,848,2734,1063,9861
"17031700302",2891,326,988,262,1129,210,2090,497,8393
"17031700401",1279,252,3263,133,1055,50,1558,147,7737
"17031700402",729,55,2105,371,395,190,569,196,4610
"17031700501",417,35,6701,413,54,0,170,0,7790
"17031700502",98,20,2646,112,10,95,0,95,3076
"17031710100",68,1,425,882,0,0,68,0,1444
"17031710200",76,0,3047,3076,80,0,83,0,6362
"17031710300",0,0,1030,516,0,0,0,0,1546
"17031710400",37,0,3770,1280,91,36,51,11,5276
"17031710500",10,0,2912,1216,43,109,33,25,4348
"17031710600",0,0,937,882,0,0,0,0,1819
"17031710700",12,1,1715,856,96,2,26,0,2708
"17031710800",0,35,4197,344,104,59,69,35,4843
"17031710900",10,0,1318,1236,6,13,5,0,2588
"17031711000",21,0,2439,990,17,0,42,0,3509
"17031711100",0,0,2151,1169,0,0,0,11,3331
"17031711200",15,0,3899,1118,12,0,0,0,5044
"17031711300",0,0,1150,381,78,18,101,16,1744
"17031711400",2,1,1462,633,10,0,15,56,2179
"17031711500",0,0,2171,368,39,0,0,0,2578
"17031720100",2530,3,1458,0,122,22,490,10,4635
"17031720200",1505,76,2394,339,244,0,175,0,4733
"17031720300",2473,23,1135,0,79,1,297,15,4023
"17031720400",1959,10,64,1,82,8,109,1,2234
"17031720500",1999,51,62,0,37,0,116,0,2265
"17031720600",1431,40,290,13,6,10,19,0,1809
"17031720700",1098,37,1935,119,85,0,35,37,3346
"17031730100",6,0,1904,480,44,4,14,4,2456
"17031730201",65,2,3928,1449,185,45,110,0,5784
"17031730202",0,46,2403,670,0,48,0,94,3261
"17031730300",4,0,842,197,0,0,4,0,1047
"17031730400",6,1,2882,531,97,0,26,0,3543
"17031730500",145,2,3536,741,27,8,29,0,4488
"17031730600",0,0,2994,262,47,30,0,0,3333
"17031730700",9,7,1711,571,0,0,0,0,2298
"17031740100",2715,65,0,0,46,0,135,0,2961
"17031740200",5388,168,62,13,22,16,275,16,5960
"17031740300",4471,59,82,0,0,0,332,10,4954
"17031740400",3599,144,510,61,384,12,271,1,4982
"17031750100",201,0,2906,1211,35,26,107,11,4497
"17031750200",1174,32,1395,144,128,20,34,9,2936
"17031750300",2467,34,362,0,87,0,213,0,3163
"17031750400",2212,94,792,49,85,0,42,0,3274
"17031750500",1381,178,3618,715,203,0,25,1,6121
"17031750600",28,3,2435,1038,44,41,16,0,3605
"17031760801",2465,781,108,0,829,89,295,0,4567
"17031760802",1874,237,0,0,80,0,213,31,2435
"17031760803",4588,1292,66,1,910,380,887,314,8438
"17031770201",4202,234,35,41,1143,126,978,0,6759
"17031770202",4308,352,48,1,351,1,653,0,5714
"17031770300",5949,307,148,0,772,20,633,0,7829
"17031770400",3118,252,26,0,968,131,642,163,5300
"17031770500",1040,347,58,14,1931,357,2417,610,6774
"17031770601",2407,25,0,1,487,1,452,0,3373
"17031770602",2855,193,41,0,940,715,1485,839,7068
"17031770700",2040,296,91,12,241,0,266,11,2957
"17031770800",4053,491,154,41,953,170,965,316,7143
"17031770901",4380,431,0,0,265,0,223,160,5459
"17031770902",2728,303,10,1,276,10,159,22,3509
"17031800100",2343,69,0,0,97,0,75,8,2592
"17031800200",5517,291,93,1,367,0,147,0,6416
"17031800300",3031,13,18,0,178,0,105,0,3345
"17031800400",3402,67,0,0,427,29,99,0,4024
"17031800500",4609,153,0,1,273,1,145,1,5183
"17031800600",2560,34,18,0,56,4,65,0,2737
"17031800700",4325,115,0,0,568,0,145,0,5153
"17031800800",1576,86,0,0,355,0,40,0,2057
"17031800900",2920,232,94,0,1250,19,319,15,4849
"17031801000",3708,107,25,30,894,69,41,30,4904
"17031801100",4354,24,33,0,333,9,172,0,4925
"17031801200",3130,64,18,0,204,0,121,0,3537
"17031801300",3862,113,65,17,328,13,102,13,4513
"17031801400",2366,16,11,0,545,33,339,33,3343
"17031801500",5117,296,35,0,572,93,159,0,6272
"17031801601",3471,7,62,1,598,19,100,6,4264
"17031801603",1925,54,206,151,1047,339,43,0,3765
"17031801605",4174,186,59,0,952,0,68,9,5448
"17031801606",5008,278,0,1,653,0,156,20,6116
"17031801607",3688,139,140,20,1242,75,155,12,5471
"17031801608",4875,343,0,0,832,68,289,0,6407
"17031801701",2991,44,0,0,549,0,127,0,3711
"17031801702",4096,65,0,0,548,168,163,0,5040
"17031801800",5048,132,0,0,336,54,27,2,5599
"17031801901",3135,109,60,12,648,12,645,12,4633
"17031801902",2973,49,0,0,232,16,122,0,3392
"17031802002",4128,259,60,0,702,37,272,0,5458
"17031802003",1815,246,57,0,618,15,253,238,3242
"17031802004",3252,487,89,0,1099,360,586,251,6124
"17031802100",3021,40,40,2,202,0,56,0,3361
"17031802200",3825,137,34,0,207,0,170,0,4373
"17031802300",3766,357,32,2,1110,31,210,14,5522
"17031802402",3246,902,31,0,764,262,1299,715,7219
"17031802403",1209,31,19,0,147,14,56,14,1490
"17031802404",4244,706,29,0,1990,127,2629,146,9871
"17031802503",3683,224,139,0,1217,44,379,0,5686
"17031802504",4836,215,32,0,1412,46,2180,168,8889
"17031802505",3289,410,83,40,2719,448,2979,634,10602
"17031802506",1692,373,0,0,588,74,1313,286,4326
"17031802605",5360,184,281,6,1170,1,499,1,7502
"17031802607",1169,21,0,0,122,17,86,17,1432
"17031802608",5856,161,0,0,423,0,390,0,6830
"17031802609",3354,1003,12,38,1503,96,1977,899,8882
"17031802610",941,3,0,0,526,28,124,0,1622
"17031802701",5007,98,29,0,1505,225,1297,129,8290
"17031802702",3551,127,16,25,1161,46,167,24,5117
"17031802801",4135,253,19,0,618,0,255,192,5472
"17031802802",5404,103,47,0,776,0,117,0,6447
"17031802900",5625,237,0,0,266,18,36,0,6182
"17031803005",2299,179,44,29,92,0,10,0,2653
"17031803007",4221,429,0,1,374,0,350,224,5599
"17031803008",3928,134,103,5,440,1,511,1,5123
"17031803010",3814,192,0,0,735,0,412,1,5154
"17031803012",1994,16,120,0,166,54,418,0,2768
"17031803013",4272,247,67,0,577,27,403,120,5713
"17031803014",2735,203,0,0,605,0,408,37,3988
"17031803015",3822,282,14,26,376,146,248,213,5127
"17031803016",1478,79,51,2,633,0,172,0,2415
"17031803017",4449,140,0,9,725,127,478,25,5953
"17031803100",3072,43,80,4,179,18,151,0,3547
"17031803200",5004,145,61,1,371,37,741,37,6397
"17031803300",4700,285,0,3,820,46,517,67,6438
"17031803400",5717,265,34,4,188,44,279,118,6649
"17031803500",5784,71,0,0,253,0,119,4,6231
"17031803603",5451,64,55,0,1089,0,193,38,6890
"17031803604",3456,139,72,79,470,0,107,42,4365
"17031803605",5333,336,172,47,1166,329,867,345,8595
"17031803606",3607,2145,411,232,1734,1123,3007,2892,15151
"17031803607",4500,143,36,0,339,7,151,0,5176
"17031803608",5591,43,356,216,1301,94,928,54,8583
"17031803610",5280,384,215,115,1571,85,717,132,8499
"17031803611",3049,320,167,0,1723,575,1880,577,8291
"17031803612",2070,135,216,103,983,105,1220,135,4967
"17031803701",2002,164,13,0,415,0,130,43,2767
"17031803702",4739,232,0,0,937,78,349,0,6335
"17031803800",4307,304,1,1,406,116,668,117,5920
"17031803901",2478,198,64,2,352,12,260,45,3411
"17031803902",3393,124,41,55,43,0,547,12,4215
"17031804000",3593,121,38,1,526,28,549,2,4858
"17031804102",5485,225,0,7,965,27,180,16,6905
"17031804104",3199,144,14,5,1534,54,229,0,5179
"17031804105",3535,59,86,0,600,0,222,0,4502
"17031804106",4860,231,63,0,1558,0,249,36,6997
"17031804108",1590,250,333,34,1521,49,362,30,4169
"17031804109",2098,159,104,20,420,65,198,37,3101
"17031804201",5868,259,43,5,1329,356,359,76,8295
"17031804202",6557,110,0,0,968,100,602,0,8337
"17031804305",4563,484,268,0,2755,34,2709,170,10983
"17031804306",3781,85,0,57,1720,127,2151,52,7973
"17031804308",3401,107,164,0,1700,30,545,15,5962
"17031804309",1464,134,1,2,1310,53,1240,128,4332
"17031804310",5538,191,374,0,3053,32,1462,34,10684
"17031804311",4502,253,32,0,3287,189,2626,179,11068
"17031804403",3830,574,357,11,1589,209,1836,556,8962
"17031804404",2483,236,137,1,2194,228,3265,168,8712
"17031804405",915,135,300,243,1368,535,1512,618,5626
"17031804406",2562,220,178,38,2733,460,2397,505,9093
"17031804505",2478,167,72,0,775,0,486,0,3978
"17031804506",3859,117,225,10,1257,35,456,0,5959
"17031804507",7698,165,186,135,3914,99,1163,33,13393
"17031804508",745,112,44,82,698,666,386,666,3399
"17031804509",2625,173,60,0,1979,622,2410,576,8445
"17031804510",2606,98,211,72,2698,717,3769,808,10979
"17031804511",713,154,183,0,1120,441,1216,475,4302
"17031804603",2591,640,305,0,1493,125,975,132,6261
"17031804606",5613,90,18,10,1588,0,337,0,7656
"17031804607",5630,122,17,0,967,139,231,50,7156
"17031804608",2511,147,90,22,994,29,352,0,4145
"17031804609",3051,424,22,0,2138,0,428,0,6063
"17031804610",1666,163,0,0,355,18,92,0,2294
"17031804611",3265,123,44,0,651,262,155,41,4541
"17031804701",2154,194,691,97,3070,359,1898,65,8528
"17031804705",2079,206,140,119,1269,145,502,89,4549
"17031804706",2000,71,0,0,370,0,127,0,2568
"17031804709",3509,162,466,61,1809,46,741,0,6794
"17031804710",3586,91,0,0,656,6,512,0,4851
"17031804711",3504,392,575,73,3087,208,1114,115,9068
"17031804712",3797,90,137,15,1523,196,505,196,6459
"17031804713",2540,138,154,52,1206,51,98,0,4239
"17031804714",2792,15,108,0,499,0,442,0,3856
"17031804715",1149,15,75,47,1918,265,1536,8,5013
"17031804716",3107,36,121,0,2203,217,1139,178,7001
"17031804803",4359,343,115,0,1131,0,399,0,6347
"17031804804",3423,284,251,0,2247,196,946,53,7400
"17031804805",4921,110,465,54,1782,82,1249,37,8700
"17031804806",1899,139,283,181,981,88,949,93,4613
"17031804807",3622,311,325,60,853,0,506,0,5677
"17031804808",2254,80,9,0,110,0,341,0,2794
"17031804809",3437,83,37,0,510,0,101,52,4220
"17031804810",4545,272,288,18,1700,110,910,83,7926
"17031804901",5946,215,30,32,411,91,368,8,7101
"17031804902",4010,54,0,0,1644,0,804,0,6512
"17031805001",4248,202,84,0,200,35,172,0,4941
"17031805002",4231,372,285,62,1581,389,631,163,7714
"17031805105",3480,190,300,70,2104,1240,2155,1204,10743
"17031805106",1958,128,80,9,278,9,34,0,2496
"17031805107",3311,403,106,105,2421,376,1642,368,8732
"17031805108",2951,280,284,37,3505,290,2778,419,10544
"17031805109",3615,185,40,0,390,0,69,8,4307
"17031805110",3473,49,24,12,461,0,181,18,4218
"17031805111",3244,399,192,0,2794,407,1775,214,9025
"17031805112",2031,115,0,0,933,74,241,15,3409
"17031805201",2223,109,36,0,545,77,191,1,3182
"17031805202",2611,174,84,30,1012,85,323,0,4319
"17031805301",1982,224,0,0,1015,137,283,14,3655
"17031805302",2165,146,52,0,1129,56,188,0,3736
"17031805401",3276,99,0,0,486,40,397,0,4298
"17031805402",3754,232,1,1,938,0,404,0,5330
"17031805501",2957,324,79,0,315,0,122,56,3853
"17031805502",3588,124,0,1,8,3,159,51,3934
"17031805600",4389,133,13,10,80,0,197,0,4822
"17031805701",4777,155,0,0,202,18,284,0,5436
"17031805702",1753,79,1,1,107,1,34,15,1991
"17031805801",2068,16,20,1,182,61,0,3,2351
"17031805802",4607,220,0,0,231,73,670,73,5874
"17031805901",3339,166,0,1,535,36,432,0,4509
"17031805902",4513,93,215,1,621,474,298,81,6296
"17031806001",2748,398,215,46,2265,549,479,306,7006
"17031806002",3765,369,277,23,3102,260,848,117,8761
"17031806003",3854,194,136,11,3184,198,819,32,8428
"17031806004",5040,203,148,81,1500,535,925,139,8571
"17031806102",3055,143,329,1,753,20,678,39,5018
"17031806103",3733,312,0,0,899,184,290,87,5505
"17031806104",2088,561,261,133,1005,353,296,219,4916
"17031806201",3013,215,91,0,883,258,566,356,5382
"17031806202",3896,334,55,4,199,18,182,21,4709
"17031806300",3667,188,0,0,601,19,707,81,5263
"17031806400",1867,288,0,0,233,26,337,203,2954
"17031806501",1423,168,13,1,700,52,856,142,3355
"17031806502",3453,392,5,0,553,0,1245,347,5995
"17031806600",2390,81,90,0,750,122,756,105,4294
"17031806700",3330,59,176,23,684,18,277,0,4567
"17031806801",2042,227,410,75,679,39,359,44,3875
"17031806802",2011,0,211,24,716,0,242,0,3204
"17031806900",2953,345,24,11,1523,20,241,21,5138
"17031807000",2688,445,183,278,1496,284,425,24,5823
"17031807100",2673,341,408,92,330,0,197,181,4222
"17031807200",3602,286,503,26,1286,76,872,54,6705
"17031807300",3439,744,270,117,2390,502,316,148,7926
"17031807400",3923,1065,163,3,1683,92,568,287,7784
"17031807500",1931,76,111,17,1145,85,341,34,3740
"17031807600",3265,141,76,7,2619,294,727,27,7156
"17031807700",3094,1088,391,42,1199,238,605,506,7163
"17031807800",2036,77,0,1,480,6,337,13,2950
"17031807900",2914,29,0,0,1090,143,430,63,4669
"17031808001",2415,67,5,0,1231,29,352,0,4099
"17031808002",2789,176,189,0,1327,154,180,0,4815
"17031808100",2379,209,42,34,300,0,26,21,3011
"17031808200",3222,675,0,0,1507,193,248,0,5845
"17031808301",3259,283,68,2,1634,295,232,190,5963
"17031808302",2410,154,120,22,1288,48,314,0,4356
"17031808400",2531,114,18,17,1470,180,196,149,4675
"17031808500",2341,143,42,39,1635,33,251,15,4499
"17031808600",1688,38,8,0,256,0,67,0,2057
"17031808702",485,178,21,0,47,159,50,15,955
"17031808800",2834,132,23,0,281,8,131,13,3422
"17031808900",3630,130,21,30,236,61,203,0,4311
"17031809000",3676,44,28,0,97,11,0,0,3856
"17031809100",2935,41,190,0,189,0,81,0,3436
"17031809200",1231,190,2706,369,203,240,967,127,6033
"17031809300",1731,1301,139,131,390,723,53,253,4721
"17031809400",2664,647,128,43,828,417,67,77,4871
"17031809500",2469,272,155,51,428,99,114,59,3647
"17031809600",1471,86,986,310,359,150,413,141,3916
"17031809700",2441,134,1124,0,301,88,1223,62,5373
"17031809800",1882,236,173,104,412,30,329,43,3209
"17031809900",2660,83,80,0,181,78,82,0,3164
"17031810000",3368,404,105,69,597,181,99,0,4823
"17031810100",3031,217,582,114,554,31,658,51,5238
"17031810200",1928,289,2428,545,481,14,235,178,6098
"17031810301",1540,137,1098,138,649,21,598,90,4271
"17031810302",2044,53,786,22,349,18,173,0,3445
"17031810400",4933,251,0,1,155,0,370,12,5722
"17031810501",4392,425,0,5,167,0,434,31,5454
"17031810502",3961,435,7,0,613,0,286,87,5389
"17031810600",3631,618,22,0,326,21,739,35,5392
"17031810701",3467,390,8,0,861,68,1142,94,6030
"17031810702",3348,165,18,0,277,9,416,48,4281
"17031810800",4522,324,22,16,694,0,1133,24,6735
"17031810900",4305,284,139,0,1056,273,1320,270,7647
"17031811000",3636,351,77,25,342,0,711,13,5155
"17031811100",4398,842,33,6,653,48,1148,111,7239
"17031811200",3934,579,71,0,1007,191,1694,275,7751
"17031811301",2861,86,156,46,1616,282,2361,277,7685
"17031811302",1407,240,311,136,976,345,1620,531,5566
"17031811401",3963,365,25,50,968,180,2012,341,7904
"17031811402",3039,216,14,0,794,370,1197,489,6119
"17031811500",3959,436,43,0,1288,103,1682,267,7778
"17031811600",4131,559,15,0,1016,207,1291,429,7648
"17031811701",2073,282,23,0,925,185,1760,441,5689
"17031811702",2623,271,73,18,2057,70,2505,110,7727
"17031811800",3366,184,12,9,1040,265,2090,314,7280
"17031811900",4147,195,380,5,353,70,165,22,5337
"17031812000",4161,327,180,0,428,35,220,0,5351
"17031812100",2383,115,1128,405,479,146,180,71,4907
"17031812200",3151,34,411,74,242,18,229,0,4159
"17031812301",2201,195,615,63,398,48,320,0,3840
"17031812302",1866,119,380,12,182,39,121,22,2741
"17031812400",2865,13,339,27,290,0,126,0,3660
"17031812500",1778,228,911,370,369,61,308,54,4079
"17031812600",1894,160,801,197,337,13,171,60,3633
"17031812700",2107,109,563,50,272,98,103,78,3380
"17031812801",1816,138,458,53,266,23,101,16,2871
"17031812802",2014,57,221,37,211,222,248,65,3075
"17031812900",3530,253,395,193,533,16,181,22,5123
"17031813000",2265,170,605,178,226,38,142,0,3624
"17031813100",2338,129,1615,121,504,25,337,30,5099
"17031813200",3216,134,479,62,443,0,196,0,4530
"17031813301",839,370,114,59,1579,403,2208,767,6339
"17031813302",1159,255,68,186,1734,286,2753,529,6970
"17031813400",2712,671,259,212,3621,798,5753,1432,15458
"17031813500",2662,665,222,0,3938,257,5820,749,14313
"17031813600",975,480,80,16,2664,605,3366,1062,9248
"17031813701",674,460,220,123,1858,302,2468,614,6719
"17031813702",1088,305,156,181,1949,385,2873,667,7604
"17031813801",1097,168,27,0,1492,221,2477,384,5866
"17031813802",1984,479,81,21,2217,588,3944,856,10170
"17031813900",2084,554,66,67,2888,740,4546,1280,12225
"17031814000",2165,167,78,130,1749,563,3403,701,8956
"17031814100",863,696,63,0,2057,524,2771,1078,8052
"17031814200",1913,599,81,78,3109,1128,4618,1638,13164
"17031814300",1122,367,52,19,2497,532,3361,845,8795
"17031814400",3200,893,79,0,3103,463,5000,1193,13931
"17031814500",2394,332,91,1,1581,73,3315,343,8130
"17031814600",2905,347,302,35,1466,183,3157,295,8690
"17031814700",3392,431,101,55,1960,295,3772,607,10613
"17031814800",4184,223,361,166,732,169,2983,251,9069
"17031814900",3308,721,971,130,983,373,2575,865,9926
"17031815000",1840,578,318,358,752,325,1854,674,6699
"17031815100",2644,130,184,129,1064,385,2710,409,7655
"17031815200",3710,533,159,169,1930,98,4016,329,10944
"17031815300",2595,232,60,0,805,157,1932,242,6023
"17031815400",3960,398,121,15,608,274,1510,288,7174
"17031815500",5301,387,16,0,1591,830,4011,1138,13274
"17031815600",4120,447,140,34,336,0,1442,186,6705
"17031815701",3596,78,0,0,279,0,413,32,4398
"17031815702",4027,225,76,0,635,0,712,134,5809
"17031815800",1368,12,25,0,27,0,47,6,1485
"17031815900",1947,119,1543,198,554,212,263,13,4849
"17031816000",2007,170,823,91,186,6,228,9,3520
"17031816100",3035,275,1766,207,780,92,697,188,7040
"17031816200",2408,129,255,257,596,20,1080,114,4859
"17031816300",2286,352,114,22,1975,357,2832,550,8488
"17031816401",1963,392,0,17,2177,572,3724,929,9774
"17031816402",1165,473,105,79,2263,396,3094,748,8323
"17031816500",1925,269,72,82,1642,546,2842,737,8115
"17031816600",1853,221,0,31,2026,626,3515,783,9055
"17031816700",1418,109,66,84,929,243,1823,304,4976
"17031816800",2417,89,1453,39,1164,152,1468,124,6906
"17031816900",1025,139,3364,327,617,387,1203,262,7324
"17031817000",706,163,3417,466,317,161,871,298,6399
"17031817101",236,85,3418,501,186,59,82,61,4628
"17031817102",164,0,2543,384,319,32,356,32,3830
"17031817200",151,0,2799,956,114,232,203,200,4655
"17031817300",262,14,1399,550,244,56,438,36,2999
"17031817400",1373,214,1059,394,1265,20,1983,197,6505
"17031817500",330,50,2278,775,279,223,457,239,4631
"17031817600",416,14,2441,906,235,1,466,0,4479
"17031817700",258,12,4194,433,12,112,239,125,5385
"17031817900",1095,25,3525,507,324,0,366,101,5943
"17031818000",1670,63,1828,182,394,153,580,153,5023
"17031818100",1567,108,237,2,327,8,260,17,2526
"17031818200",2379,177,1222,39,847,86,889,163,5802
"17031818300",1674,188,2118,519,1207,402,1541,484,8133
"17031818401",1332,113,1210,143,608,0,417,0,3823
"17031818402",1886,76,434,65,530,12,486,10,3499
"17031818500",4266,219,406,1,400,20,485,0,5797
"17031818600",3972,236,564,149,128,28,736,7,5820
"17031818700",3215,182,104,1,161,1,427,1,4092
"17031818800",4658,714,89,6,48,13,640,93,6261
"17031818900",3931,214,122,27,75,11,501,76,4957
"17031819000",4205,110,20,14,190,0,202,0,4741
"17031819100",3340,239,160,24,682,24,1888,136,6493
"17031819200",4438,802,337,6,550,34,2427,522,9116
"17031819300",2609,156,0,0,130,15,488,36,3434
"17031819400",4039,448,23,73,703,17,1028,101,6432
"17031819500",2245,201,368,79,94,3,335,62,3387
"17031819600",3418,89,184,27,138,0,198,27,4081
"17031819700",5388,277,0,0,130,51,51,0,5897
"17031819801",5287,45,10,0,77,0,178,0,5597
"17031819802",2575,6,6,0,91,0,80,0,2758
"17031819900",3100,161,8,0,76,0,133,0,3478
"17031820000",1545,56,13,0,328,13,123,24,2102
"17031820101",6436,187,118,14,288,32,114,67,7256
"17031820103",3354,260,107,1,238,33,1076,20,5089
"17031820104",3015,608,137,6,304,0,524,248,4842
"17031820201",6270,630,253,12,774,0,544,141,8624
"17031820202",3017,333,13,0,345,92,1041,272,5113
"17031820300",3457,589,127,5,914,223,2634,508,8457
"17031820400",3205,769,619,301,875,144,3549,855,10317
"17031820501",4679,857,20,1,650,2,1154,104,7467
"17031820502",3604,488,221,0,387,0,641,0,5341
"17031820603",3878,307,136,65,491,55,673,69,5674
"17031820604",2776,631,187,3,273,0,417,57,4344
"17031820605",1406,360,1627,626,199,43,267,113,4641
"17031820606",3019,258,31,9,455,42,302,85,4201
"17031820700",4980,228,9,66,1277,174,3142,200,10076
"17031820800",2655,117,23,111,946,138,1597,198,5785
"17031820901",4259,469,10,17,968,0,1583,70,7376
"17031820902",3136,433,31,92,938,199,1638,68,6535
"17031821001",4077,513,30,41,524,0,1003,12,6200
"17031821002",4120,552,27,14,540,44,1472,44,6813
"17031821101",3652,472,8,3,458,46,1145,246,6030
"17031821102",2601,498,22,12,917,91,1147,296,5584
"17031821200",1464,348,2098,497,893,113,1539,333,7285
"17031821300",2325,455,1270,416,1027,405,2244,739,8881
"17031821401",166,228,2584,567,13,17,96,237,3908
"17031821402",224,37,3054,457,8,0,39,9,3828
"17031821500",70,2,1344,730,14,10,46,4,2220
"17031821600",2161,239,1367,225,313,34,508,89,4936
"17031821700",4032,275,386,17,112,30,226,56,5134
"17031821800",3751,281,936,18,359,80,766,208,6399
"17031821900",3823,279,491,233,195,0,362,92,5475
"17031822000",4002,161,0,0,119,37,787,41,5147
"17031822101",3563,385,27,49,315,15,740,134,5228
"17031822102",3296,82,378,36,509,0,1539,0,5840
"17031822200",2934,586,28,0,518,18,614,330,5028
"17031822301",3365,144,30,10,231,65,468,69,4382
"17031822302",2810,305,267,27,341,179,572,21,4522
"17031822400",4678,1367,209,7,92,86,617,122,7178
"17031822500",3806,115,51,1,451,21,659,9,5113
"17031822601",3652,514,38,6,204,49,420,158,5041
"17031822602",5396,545,308,1,534,125,801,65,7775
"17031822701",3129,407,446,0,124,24,636,30,4796
"17031822702",2411,129,266,128,431,11,366,11,3753
"17031822801",3340,66,135,0,198,17,928,0,4684
"17031822802",3170,88,163,9,71,1,498,31,4031
"17031822900",1513,297,44,0,63,0,393,191,2501
"17031823001",3799,632,406,104,854,68,1176,82,7121
"17031823002",4923,625,179,6,487,15,902,17,7154
"17031823101",3430,370,13,19,373,111,434,103,4853
"17031823102",3204,537,0,0,11,0,90,84,3926
"17031823200",4091,317,207,8,322,10,424,23,5402
"17031823302",2909,755,1553,149,817,18,1433,160,7794
"17031823303",3531,411,324,50,556,50,770,50,5742
"17031823304",3528,835,809,12,785,6,934,372,7281
"17031823400",1720,669,837,109,1158,141,1883,491,7008
"17031823500",3458,319,366,127,350,216,1954,411,7201
"17031823602",5326,163,14,12,131,92,363,79,6180
"17031823603",127,390,760,273,427,310,525,675,3487
"17031823604",3136,191,97,0,148,12,49,8,3641
"17031823605",3346,302,30,33,114,40,280,0,4145
"17031823702",4659,753,581,190,505,124,560,45,7417
"17031823703",4857,1230,47,34,1143,94,441,260,8106
"17031823704",3228,279,11,8,354,99,560,21,4560
"17031823705",3213,995,47,133,276,55,477,142,5338
"17031823801",4706,318,0,8,554,0,84,0,5670
"17031823803",5943,548,51,17,507,90,389,222,7767
"17031823805",2579,254,54,0,65,0,127,0,3079
"17031823806",2794,288,224,80,96,2,164,193,3841
"17031823901",3468,42,85,0,199,17,0,0,3811
"17031823903",4134,90,75,0,67,0,91,0,4457
"17031823904",3760,66,14,1,140,0,247,0,4228
"17031824003",5673,22,0,1,106,0,157,1,5960
"17031824004",4618,266,127,32,208,12,311,34,5608
"17031824005",4906,126,46,0,560,56,512,56,6262
"17031824006",3885,129,0,0,80,19,232,20,4365
"17031824105",5452,177,137,0,598,9,226,37,6636
"17031824106",5948,238,185,0,767,72,661,201,8072
"17031824107",5580,437,475,1,461,0,506,0,7460
"17031824108",5673,540,362,1,1162,101,641,0,8480
"17031824113",5693,349,29,0,623,0,794,199,7687
"17031824114",3985,467,113,0,301,0,215,114,5195
"17031824115",2885,105,0,0,150,112,55,73,3380
"17031824116",4226,309,13,0,211,134,425,127,5445
"17031824117",8460,160,115,1,1034,0,550,19,10339
"17031824119",5144,179,111,0,414,0,416,0,6264
"17031824120",7261,549,223,0,458,13,241,0,8745
"17031824121",3136,121,20,0,112,53,52,11,3505
"17031824122",5033,266,177,0,527,0,310,52,6365
"17031824123",7100,237,317,23,632,0,701,80,9090
"17031824300",72,125,3288,1079,25,107,56,154,4906
"17031824400",927,152,682,292,122,0,350,29,2554
"17031824503",5626,218,171,0,273,0,423,0,6711
"17031824505",5843,350,272,13,705,15,804,48,8050
"17031824506",6659,425,46,16,610,0,642,0,8398
"17031824507",3362,174,80,37,574,49,588,37,4901
"17031824601",3939,139,158,20,147,29,535,4,4971
"17031824602",5724,214,275,24,197,264,949,235,7882
"17031824701",2753,10,247,126,667,14,814,0,4631
"17031824702",3677,625,276,276,577,275,1379,304,7389
"17031824800",3212,509,1431,635,1124,267,3287,569,11034
"17031824900",862,46,1660,394,99,97,242,76,3476
"17031825000",3690,390,214,123,508,3,794,236,5958
"17031825200",1262,158,92,30,248,7,406,0,2203
"17031825302",4767,381,35,0,352,304,881,305,7025
"17031825303",2857,439,63,16,366,213,353,275,4582
"17031825304",3483,104,191,0,152,73,224,61,4288
"17031825400",4666,329,108,48,483,18,691,18,6361
"17031825501",919,66,4184,877,101,98,396,98,6739
"17031825503",850,1,4272,970,232,512,183,441,7461
"17031825504",263,0,3123,546,20,22,109,0,4083
"17031825505",587,0,3452,816,26,0,136,0,5017
"17031825600",849,137,3493,808,201,45,398,102,6033
"17031825700",852,228,1946,532,268,42,680,223,4771
"17031825801",190,59,2371,947,79,83,79,0,3808
"17031825802",553,197,3300,467,72,150,212,217,5168
"17031825803",721,59,3189,620,417,21,621,64,5712
"17031825900",901,154,1171,647,372,0,806,21,4072
"17031826000",712,520,1429,737,339,19,712,558,5026
"17031826100",1814,647,3241,611,332,232,987,652,8516
"17031826201",263,86,2538,694,36,0,46,10,3673
"17031826202",1775,190,2975,985,456,0,951,43,7375
"17031826301",455,50,3088,291,146,13,468,35,4546
"17031826303",225,1,3446,563,37,19,33,13,4337
"17031826304",111,8,2123,591,163,0,213,12,3221
"17031826401",97,160,3348,555,174,0,95,157,4586
"17031826402",454,16,3571,823,199,0,335,0,5398
"17031826500",234,37,3870,2012,70,91,60,42,6416
"17031826600",297,12,3932,1286,143,29,85,12,5796
"17031826700",152,18,4224,1005,96,21,15,0,5531
"17031826800",914,773,1665,299,659,642,1164,1109,7225
"17031826901",16,18,993,433,53,16,44,32,1605
"17031826902",0,1,676,348,0,7,0,2,1034
"17031827000",0,73,2410,1399,21,64,28,137,4132
"17031827100",44,24,1490,722,208,256,0,24,2768
"17031827200",974,157,1940,924,70,211,661,267,5204
"17031827300",172,136,1568,1002,131,29,148,158,3344
"17031827400",44,38,2489,1253,322,39,322,39,4546
"17031827500",961,393,2425,859,430,601,1095,893,7657
"17031827600",66,7,2274,1036,15,0,7,7,3412
"17031827700",501,67,1463,680,201,0,221,0,3133
"17031827801",1497,131,2638,238,110,0,426,0,5040
"17031827802",511,3,2592,342,81,0,66,0,3595
"17031827804",459,0,2377,54,25,0,17,0,2932
"17031827805",477,26,2284,170,0,27,19,32,3035
"17031827901",204,27,1931,103,37,0,31,0,2333
"17031827902",1990,329,1681,204,299,10,900,142,5555
"17031828000",2792,119,1042,352,558,40,912,66,5881
"17031828100",3444,350,645,58,196,56,312,155,5216
"17031828201",1931,328,1595,503,217,0,240,87,4901
"17031828202",2300,183,1344,291,252,39,325,75,4809
"17031828300",2223,277,745,57,304,4,455,8,4073
"17031828401",2493,112,676,158,155,50,218,11,3873
"17031828402",1751,100,1230,335,402,53,529,76,4476
"17031828503",1241,150,2036,771,85,24,303,25,4635
"17031828504",1416,171,2558,1208,397,330,445,305,6830
"17031828505",3048,243,1967,335,509,119,772,27,7020
"17031828506",2348,1145,4470,1378,117,209,392,677,10736
"17031828601",2864,264,570,0,236,14,334,158,4440
"17031828602",1931,58,1951,174,437,93,204,82,4930
"17031828701",1348,134,1648,248,145,0,136,0,3659
"17031828702",903,129,3314,665,82,14,124,100,5331
"17031828801",2279,420,1660,23,512,57,341,322,5614
"17031828802",1906,249,612,79,216,83,415,245,3805
"17031828900",764,271,859,682,851,339,1024,554,5344
"17031829000",0,8,486,1025,11,11,0,11,1552
"17031829100",1440,420,465,166,618,779,1872,1019,6779
"17031829200",2501,491,926,692,1248,217,2512,380,8967
"17031829301",1757,142,1052,164,310,93,496,133,4147
"17031829302",593,155,1539,1110,160,339,508,593,4997
"17031829401",23,0,687,716,54,53,83,45,1661
"17031829402",1064,70,1411,577,210,0,128,22,3482
"17031829500",1801,443,469,190,1066,57,1298,306,5630
"17031829600",2164,308,126,0,423,29,531,36,3617
"17031829700",901,14,1611,1298,149,25,54,0,4052
"17031829800",2973,100,3133,101,729,0,174,0,7210
"17031829901",2566,139,4845,797,551,80,429,145,9552
"17031829902",1160,18,4821,306,80,0,0,0,6385
"17031830001",1628,105,130,0,37,0,23,0,1923
"17031830003",427,66,6079,1041,95,310,136,307,8461
"17031830004",754,19,5347,519,116,0,110,0,6865
"17031830005",1140,48,2635,145,148,37,39,17,4209
"17031830006",890,71,1347,107,148,21,91,0,2675
"17031830007",930,38,2120,837,164,31,213,39,4372
"17031830008",537,0,3797,216,108,8,73,8,4747
"17031830100",592,49,1861,446,421,68,388,27,3852
"17031830201",947,36,3928,536,283,0,121,26,5877
"17031830202",907,189,1483,654,135,13,37,11,3429
"17031830300",1219,62,2632,869,98,0,148,1,5029
"17031830400",1347,134,2021,469,227,72,168,41,4479
"17031830500",2047,1096,0,32,937,19,2956,1086,8173
"17031830600",2153,805,536,297,941,372,1199,1048,7351
"17031830700",1482,396,545,555,286,202,338,120,3924
"17031830800",1698,124,106,82,493,0,186,0,2689
"17031830900",2019,209,37,6,358,20,808,154,3611
"17031831000",1936,9,97,0,405,11,164,0,2622
"17031831100",4555,1155,267,1,1554,162,3577,1008,12279
"17031831200",1708,513,142,83,2000,603,3467,997,9513
"17031831300",138,53,329,78,443,186,546,239,2012
"17031831400",206,39,1125,792,99,24,146,0,2431
"17031831500",2008,251,153,41,1276,41,2080,189,6039
"17031831600",3491,568,461,38,1856,394,3062,800,10670
"17031831700",1200,81,34,61,737,102,1135,131,3481
"17031831800",2636,97,337,0,1994,752,946,482,7244
"17031831900",2179,105,0,1,254,27,79,0,2645
"17031832000",1487,226,46,34,121,100,168,96,2278
"17031832100",1848,337,400,300,322,42,164,25,3438
"17031832200",2534,175,64,18,227,48,532,0,3598
"17031832300",1833,104,62,1,204,29,444,28,2705
"17031832400",2341,573,79,0,417,32,1100,529,5071
"17031832500",2285,461,45,184,120,136,161,213,3605
"17031832600",3544,425,49,51,185,13,224,27,4518
"17031832900",1034,555,70,0,412,384,111,112,2678
"17031833000",1856,101,153,183,221,20,33,5,2572
"17031833100",4535,400,335,483,996,130,272,51,7202
"17031833300",989,490,68,95,302,323,200,130,2597
"17031833900",773,191,499,579,110,290,849,492,3783
"17031834000",70,16,2887,695,143,0,122,16,3949
"17031834200",29,11,3047,1656,0,16,60,0,4819
"17031834300",40,3,5041,1118,60,15,0,1,6278
"17031834400",114,12,2676,998,143,0,26,21,3990
"17031834500",28,12,712,756,99,0,44,12,1663
"17031834600",0,67,1902,1162,10,9,0,0,3150
"17031834700",0,31,1051,863,12,61,0,37,2055
"17031834800",0,3,885,883,4,9,0,0,1784
"17031834900",0,29,1207,1038,0,48,0,16,2338
"17031835000",650,213,1658,1728,949,443,1375,657,7673
"17031835100",2251,375,736,153,1402,575,3593,882,9967
"17031835200",1008,159,0,6,535,61,883,104,2756
"17031835500",21,66,823,482,147,6,137,60,1742
"17031835600",24,0,708,521,0,0,8,0,1261
"17031835700",0,0,0,210,0,20,0,0,230
"17031835800",25,0,847,499,29,0,29,0,1429
"17031835900",80,4,1824,1320,138,122,139,0,3627
"17031836000",39,1,1646,809,105,53,6,41,2700
"17031836100",13,0,1017,603,0,0,82,0,1715
"17031836200",219,33,0,1,44,11,0,0,308
"17031836300",306,76,941,129,103,0,5,21,1581
"17031836400",133,0,1845,1014,100,0,111,10,3213
"17031836500",19,53,921,653,0,0,0,53,1699
"17031836600",601,54,415,340,509,296,921,334,3470
"17031836700",83,169,1314,625,175,114,276,257,3013
"17031836800",68,34,1148,1247,55,0,38,0,2590
"17031836900",44,0,1035,544,50,0,60,0,1733
"17031837000",137,5,1271,862,46,5,119,0,2445
"17031837100",220,24,1043,646,125,0,130,5,2193
"17031837300",33,4,804,862,61,0,24,16,1804
"17031837400",70,46,1071,799,0,14,3,8,2011
"17031837800",366,18,1564,808,361,40,272,38,3467
"17031838000",465,31,639,1318,470,0,306,0,3229
"17031838100",502,39,470,380,370,92,174,22,2049
"17031838200",410,115,43,0,213,146,210,14,1151
"17031838300",452,69,328,335,73,23,248,23,1551
"17031838600",19,3,767,776,0,0,19,0,1584
"17031838700",234,13,2383,1799,137,0,234,42,4842
"17031838800",832,368,920,1022,172,91,890,402,4697
"17031839000",3931,628,663,302,1423,541,122,250,7860
"17031839100",2107,272,383,146,489,392,89,22,3900
"17031839200",192,31,1395,331,221,54,50,0,2274
"17031839500",212,8,858,270,45,0,40,0,1433
"17031839600",58,36,1196,374,21,0,6,17,1708
"17031839700",1690,625,71,38,1645,902,1561,830,7362
"17031839800",1414,193,7,0,989,262,728,184,3777
"17031839900",2277,418,36,10,734,203,757,88,4523
"17031840000",1290,41,43,0,967,283,412,56,3092
"17031840100",746,130,0,0,1308,818,215,412,3629
"17031840200",670,168,21,2,1227,386,410,88,2972
"17031840300",1510,470,38,74,1420,701,1892,861,6966
"17031840400",958,353,0,110,1213,594,799,593,4620
"17031840700",1753,1437,48,75,663,267,2113,1646,8002
"17031840800",1806,818,2,6,539,427,2297,1214,7109
"17031841000",107,0,214,169,178,21,0,0,689
"17031841100",353,100,174,59,4205,2644,34,16,7585
"17031841200",2233,612,79,225,1429,1062,3288,1553,10481
"17031841300",1521,516,23,60,1657,613,2780,1079,8249
"17031841400",55,41,532,668,88,7,93,27,1511
"17031841500",30,20,1270,1352,34,89,27,97,2919
"17031841600",12,0,370,372,0,0,0,0,754
"17031841700",55,283,573,304,134,0,168,283,1800
"17031841800",14,6,1526,740,71,12,157,6,2532
"17031841900",1761,227,280,339,649,54,399,44,3753
"17031842000",112,91,442,169,82,53,26,3,978
"17031842100",490,478,2643,1530,610,893,1218,1351,9213
"17031842200",1418,47,408,314,385,29,258,51,2910
"17031842300",2137,409,410,110,333,8,70,179,3656
"17031842400",0,0,2298,1156,0,0,0,0,3454
"17031842500",1,1,689,1765,3,0,3,0,2462
"17031842600",2936,921,34,2,880,101,1341,380,6595
"17031842800",2788,1154,0,1,2259,1297,4416,2270,14185
"17031842900",156,65,699,864,238,143,298,118,2581
"17031843000",0,8,1424,1507,10,20,21,27,3017
"17031843100",63,40,1464,593,81,41,61,0,2343
"17031843200",1205,239,21,6,1250,512,2175,673,6081
"17031843300",268,90,331,510,221,5,449,92,1966
"17031843400",22,25,1086,194,155,108,185,53,1828
"17031843500",395,248,0,0,154,201,530,449,1977
"17031843600",60,1,1641,774,51,16,12,29,2584
"17031843700",1812,217,16,0,160,13,312,43,2573
"17031843800",435,220,650,382,188,11,290,50,2226
"17031843900",98,1,2426,684,73,75,115,54,3526
"17031980000",0,0,0,0,0,0,0,0,0
"17031980100",0,0,0,0,0,0,0,0,0
"17031990000",0,0,0,0,0,0,0,0,0
"17033880100",2560,267,0,3,122,0,6,0,2958
"17033880200",2927,261,0,0,139,0,6,0,3333
"17033880300",2938,402,3,0,75,7,0,0,3425
"17033880400",2170,931,69,28,229,16,43,164,3650
"17033880500",2212,355,0,0,30,62,8,0,2667
"17033880600",2457,352,15,0,59,4,37,0,2924
"17035972400",2580,438,0,0,17,0,0,0,3035
"17035972500",2820,647,3,0,6,6,49,2,3533
"17035972600",3847,294,0,0,37,112,11,24,4325
"17037000100",5924,502,0,0,288,132,324,156,7326
"17037000200",4138,327,13,0,133,16,138,66,4831
"17037000300",2242,166,19,0,100,5,68,12,2612
"17037000400",7423,538,155,2,412,218,325,501,9574
"17037000500",2709,537,108,0,658,124,570,101,4807
"17037000600",4390,431,89,33,339,77,265,119,5743
"17037000700",3258,334,104,12,236,160,285,138,4527
"17037000800",4556,979,362,68,805,299,926,306,8301
"17037000900",3644,460,303,0,292,339,369,108,5515
"17037001001",1896,1324,612,1222,444,547,383,518,6946
"17037001002",972,2597,443,656,255,558,172,329,5982
"17037001300",3528,961,31,14,237,584,65,525,5945
"17037001400",5286,440,273,178,269,128,488,97,7159
"17037001500",2916,207,40,0,188,318,275,307,4251
"17037001600",3518,357,14,21,297,88,480,112,4887
"17037001700",2885,398,23,0,36,0,102,0,3444
"17037001800",3174,321,52,117,146,19,73,26,3928
"17037001900",2112,186,16,32,107,50,164,10,2677
"17037002000",4466,360,0,0,85,0,486,0,5397
"17037002100",1749,310,0,23,157,164,220,326,2949
"17037002200",234,534,0,1,39,148,75,111,1142
"17039971400",2409,257,0,0,9,27,0,0,2702
"17039971500",2406,118,0,0,22,11,4,0,2561
"17039971600",3388,406,0,0,33,9,8,0,3844
"17039971700",2687,491,12,0,26,51,82,49,3398
"17039971800",2776,768,2,21,90,100,121,59,3937
"17041952000",1865,227,7,1,24,31,12,8,2175
"17041952100",3606,393,2,0,85,1,122,1,4210
"17041952200",3710,424,29,0,180,47,148,79,4617
"17041952300",5100,418,3,0,42,0,87,86,5736
"17041952400",2725,418,5,2,262,66,672,73,4223
"17043840000",1952,346,187,0,601,50,1640,310,5086
"17043840101",4453,359,49,35,663,427,1667,570,8223
"17043840102",3981,180,0,0,254,84,795,70,5364
"17043840103",5444,661,49,0,522,0,659,378,7713
"17043840104",4286,1295,22,0,569,0,2710,1044,9926
"17043840201",4358,130,24,1,966,143,591,143,6356
"17043840202",3905,174,0,0,980,5,576,0,5640
"17043840303",3111,514,253,0,206,97,783,431,5395
"17043840304",3165,298,77,1,587,0,941,97,5166
"17043840600",4005,99,29,0,476,0,294,0,4903
"17043840703",3280,132,187,51,270,68,1476,13,5477
"17043840704",2246,809,20,0,175,2,731,696,4679
"17043840705",2495,24,121,0,769,1,591,1,4002
"17043840706",2334,162,238,16,640,24,208,0,3622
"17043840801",1506,308,16,115,313,6,1118,163,3545
"17043840802",3921,808,108,82,822,27,2259,733,8760
"17043840901",2581,198,32,0,428,59,293,3,3594
"17043840904",1761,239,202,337,1074,152,867,162,4794
"17043840906",2010,385,212,23,177,26,828,181,3842
"17043840907",2233,395,92,441,1247,95,645,263,5411
"17043840908",2601,322,139,34,882,392,698,182,5250
"17043840910",4087,479,248,146,699,167,2219,416,8461
"17043840911",1838,92,413,0,1063,181,945,166,4698
"17043841002",2643,64,27,22,91,0,103,0,2950
"17043841003",2449,120,157,0,417,0,245,20,3408
"17043841004",3092,55,128,8,105,8,535,0,3931
"17043841102",4115,270,515,115,1010,12,696,221,6954
"17043841103",3201,60,190,231,296,36,604,52,4670
"17043841104",3647,103,73,0,484,0,243,0,4550
"17043841108",2769,31,369,373,1004,71,1289,96,6002
"17043841109",2951,169,296,3,622,190,578,0,4809
"17043841110",3052,54,51,0,193,0,390,0,3740
"17043841111",3177,126,28,20,299,99,193,0,3942
"17043841112",2273,186,45,0,654,26,389,2,3575
"17043841113",2731,207,0,87,980,50,517,6,4578
"17043841114",2647,77,206,7,785,23,283,13,4041
"17043841204",2989,428,252,177,2310,146,1109,348,7759
"17043841205",3586,256,6,0,624,0,633,181,5286
"17043841206",4438,472,69,0,742,89,670,482,6962
"17043841207",2205,145,96,0,707,0,1120,114,4387
"17043841208",2763,436,282,99,1240,120,825,344,6109
"17043841209",2704,28,29,212,906,0,166,0,4045
"17043841210",2365,610,165,25,918,143,548,357,5131
"17043841307",5401,265,154,0,222,26,276,0,6344
"17043841308",3833,154,47,0,564,6,470,0,5074
"17043841310",3105,41,101,0,515,0,225,0,3987
"17043841312",2063,353,35,0,1672,54,1500,396,6073
"17043841313",2130,105,42,0,360,13,335,0,2985
"17043841314",5348,152,18,65,641,39,511,0,6774
"17043841315",2351,83,221,0,279,264,521,37,3756
"17043841316",3182,31,0,0,269,0,228,0,3710
"17043841318",2197,117,28,0,602,0,428,0,3372
"17043841320",1431,243,86,113,718,90,451,156,3288
"17043841321",2133,0,56,0,373,75,176,0,2813
"17043841322",2286,41,307,48,1705,260,640,0,5287
"17043841323",2438,6,0,0,531,208,527,0,3710
"17043841324",2148,13,34,0,551,22,207,0,2975
"17043841325",4529,125,108,0,1357,26,412,18,6575
"17043841326",2608,53,0,0,476,46,143,12,3338
"17043841327",3829,15,29,0,427,7,237,0,4544
"17043841401",4792,527,31,7,395,48,1964,351,8115
"17043841403",3375,278,60,13,68,0,334,22,4150
"17043841404",2670,211,0,0,325,11,113,7,3337
"17043841501",5024,617,0,269,374,16,3189,538,10027
"17043841503",2755,490,0,0,510,15,2586,474,6830
"17043841504",2165,474,80,120,213,0,1359,273,4684
"17043841603",3078,321,50,11,877,88,1340,282,6047
"17043841604",2828,108,435,78,712,294,812,151,5418
"17043841605",2559,861,0,52,285,147,507,823,5234
"17043841606",1562,123,23,0,315,0,19,0,2042
"17043841607",3870,475,102,10,512,39,1069,203,6280
"17043841703",3539,819,801,122,1548,313,1534,462,9138
"17043841704",3207,129,298,257,383,9,126,119,4528
"17043841705",3933,234,0,67,1270,68,987,109,6668
"17043841706",2024,342,347,196,960,144,524,330,4867
"17043841801",4124,234,143,1,176,245,110,1,5034
"17043841802",4741,27,85,8,253,0,244,0,5358
"17043841901",2304,32,0,0,118,0,74,0,2528
"17043841902",1562,251,50,37,128,15,68,36,2147
"17043842000",3844,145,165,0,101,17,29,0,4301
"17043842100",5218,386,19,0,306,23,223,0,6175
"17043842200",4447,146,14,22,145,84,281,0,5139
"17043842300",3573,12,37,9,76,13,133,0,3853
"17043842400",3983,442,309,92,660,107,406,47,6046
"17043842500",2413,245,80,27,171,24,106,0,3066
"17043842601",4227,95,58,0,335,0,75,0,4790
"17043842602",4364,65,36,0,192,0,105,0,4762
"17043842603",2417,135,64,0,346,11,160,11,3144
"17043842604",3383,190,72,147,223,137,327,42,4521
"17043842605",3317,86,39,0,320,19,150,0,3931
"17043842702",3442,204,198,85,761,47,389,0,5126
"17043842703",3867,72,78,0,278,0,319,0,4614
"17043842704",3923,219,194,19,342,131,187,70,5085
"17043842706",4129,87,140,0,335,0,361,0,5052
"17043842708",1905,44,221,0,279,6,136,0,2591
"17043842709",2606,31,457,23,362,0,271,0,3750
"17043842710",2817,261,145,12,398,66,176,0,3875
"17043842711",2570,95,0,0,193,0,119,0,2977
"17043842800",4008,86,0,0,501,12,278,0,4885
"17043842900",3970,296,0,23,317,0,41,11,4658
"17043843000",3862,240,132,0,156,21,353,0,4764
"17043843100",2979,184,137,53,526,93,768,146,4886
"17043843200",3942,369,323,130,596,43,1154,133,6690
"17043843301",3098,419,128,0,234,13,809,333,5034
"17043843302",2744,267,15,107,145,0,94,0,3372
"17043843400",3140,78,44,6,172,0,168,9,3617
"17043843500",5164,145,0,11,330,20,264,26,5960
"17043843601",3310,400,51,2,22,1,328,259,4373
"17043843602",3021,70,25,125,65,0,171,0,3477
"17043843700",4161,205,0,0,155,15,500,23,5059
"17043843800",2930,56,20,115,285,77,225,0,3708
"17043843900",3764,78,0,0,197,0,222,0,4261
"17043844001",3310,106,14,1,176,0,162,0,3769
"17043844002",4653,19,0,0,75,0,97,0,4844
"17043844100",3655,206,8,0,42,13,166,145,4235
"17043844201",4660,293,74,0,344,125,537,45,6078
"17043844202",2258,42,0,0,375,0,157,0,2832
"17043844301",4323,204,448,0,848,22,102,0,5947
"17043844304",2096,326,450,0,1052,116,110,1,4151
"17043844305",2841,213,242,0,414,11,326,74,4121
"17043844306",2430,55,352,22,974,431,1271,133,5668
"17043844307",2064,157,51,30,546,186,208,69,3311
"17043844401",2826,133,72,0,287,0,81,0,3399
"17043844402",2996,235,244,0,906,193,301,84,4959
"17043844501",2902,224,134,0,304,189,373,21,4147
"17043844502",2236,123,38,0,620,21,24,7,3069
"17043844601",3064,83,81,0,470,43,76,26,3843
"17043844602",2885,126,268,0,611,9,213,0,4112
"17043844701",3267,186,9,0,656,67,432,44,4661
"17043844702",4539,100,23,0,461,36,179,9,5347
"17043844801",3925,173,0,1,101,2,151,0,4353
"17043844802",3051,45,0,0,77,36,106,0,3315
"17043844901",2879,124,7,2,199,3,138,4,3356
"17043844902",3666,308,7,13,213,10,37,0,4254
"17043845000",4269,428,76,29,655,78,462,56,6053
"17043845100",5427,459,35,2,496,0,161,287,6867
"17043845200",4466,85,0,0,476,21,286,21,5355
"17043845300",3003,33,0,0,98,26,66,0,3226
"17043845401",2555,153,118,0,373,53,298,10,3560
"17043845402",2291,208,177,0,462,114,114,72,3438
"17043845502",3678,344,512,0,464,44,341,176,5559
"17043845505",2900,66,334,0,642,226,244,195,4607
"17043845506",2532,170,381,71,478,296,24,260,4212
"17043845507",3135,61,14,0,339,0,108,0,3657
"17043845508",2713,263,0,0,530,101,88,11,3706
"17043845509",1918,18,270,0,1136,0,90,0,3432
"17043845510",1971,123,266,14,1027,92,217,55,3765
"17043845601",3243,74,458,41,443,38,333,36,4666
"17043845602",4296,222,135,32,84,0,41,0,4810
"17043845701",3158,148,151,0,309,24,143,0,3933
"17043845702",4318,69,0,0,269,0,114,0,4770
"17043845703",3386,261,228,100,738,52,336,124,5225
"17043845704",3732,111,105,33,458,0,401,0,4840
"17043845802",2974,131,35,0,402,0,162,0,3704
"17043845803",2704,126,1726,298,966,76,538,68,6502
"17043845805",2989,113,103,9,541,0,366,0,4121
"17043845807",4925,525,89,16,647,10,259,0,6471
"17043845808",2531,34,6,0,1110,0,339,0,4020
"17043845809",3108,79,80,0,679,0,221,0,4167
"17043845810",2571,243,365,185,738,18,256,50,4426
"17043845811",3346,135,270,23,280,19,338,0,4411
"17043845901",2297,212,79,0,595,0,222,0,3405
"17043845902",2837,146,29,0,484,0,50,0,3546
"17043846002",3574,282,93,61,323,15,525,32,4905
"17043846003",3665,292,18,0,306,0,142,150,4573
"17043846004",2707,130,264,10,442,7,200,0,3760
"17043846102",2614,261,149,99,655,180,333,25,4316
"17043846103",3936,151,112,1,555,27,254,1,5037
"17043846104",3130,164,43,3,1028,117,272,124,4881
"17043846105",2978,10,90,0,320,0,207,0,3605
"17043846106",2464,222,246,0,987,0,18,179,4116
"17043846201",4667,68,300,97,527,67,277,0,6003
"17043846202",3629,113,331,0,1240,14,240,0,5567
"17043846203",3065,101,81,82,766,25,84,0,4204
"17043846205",2833,124,90,1,619,0,134,0,3801
"17043846206",3770,82,105,0,349,0,127,20,4453
"17043846207",4874,84,121,0,518,30,185,18,5830
"17043846208",2663,96,29,0,385,0,179,0,3352
"17043846209",2877,67,20,0,314,0,94,0,3372
"17043846304",3658,187,203,0,2069,131,257,0,6505
"17043846305",4576,56,162,73,836,11,531,0,6245
"17043846307",2838,240,525,78,790,27,693,8,5199
"17043846308",1634,234,669,0,926,0,605,11,4079
"17043846310",3175,116,404,169,658,19,798,13,5352
"17043846311",4106,163,619,0,648,51,628,126,6341
"17043846312",3292,218,234,26,397,114,86,38,4405
"17043846313",3309,22,146,12,1276,41,454,0,5260
"17043846314",2850,92,25,0,481,16,175,38,3677
"17043846315",3835,17,83,0,459,0,269,0,4663
"17043846404",3805,454,542,0,623,321,257,432,6434
"17043846405",2726,39,139,0,783,0,75,0,3762
"17043846408",2381,35,137,0,1559,0,99,0,4211
"17043846409",2893,46,418,0,976,10,376,0,4719
"17043846410",2860,115,326,4,1828,143,709,103,6088
"17043846411",2497,80,290,117,799,0,666,0,4449
"17043846412",3066,54,306,85,786,9,213,0,4519
"17043846413",2779,68,80,0,313,40,237,44,3561
"17043846504",4317,221,383,266,480,17,720,6,6410
"17043846507",1764,39,217,58,851,0,241,0,3170
"17043846509",2065,243,609,111,1310,66,677,81,5162
"17043846510",2211,83,86,19,470,0,765,55,3689
"17043846511",4521,121,1154,26,1000,0,1510,0,8332
"17043846513",1798,35,193,0,710,102,199,0,3037
"17043846514",2398,75,58,0,1632,36,494,0,4693
"17043846515",2711,387,518,171,1620,123,1122,47,6699
"17043846517",3895,12,665,11,1552,131,705,0,6971
"17043846518",3078,13,8,10,451,27,368,26,3981
"17043846519",1731,46,255,0,1085,119,236,17,3489
"17043846521",4067,264,165,0,1077,122,243,2,5940
"17043846522",2024,57,313,64,793,34,383,27,3695
"17043846523",2695,29,0,0,45,0,53,1,2823
"17043846524",3043,215,115,27,1311,72,52,22,4857
"17043846603",3013,506,34,265,704,11,2920,438,7891
"17043846604",2870,76,68,0,244,85,1097,73,4513
"17043846701",3242,338,60,17,300,116,1294,334,5701
"17043846702",3021,594,214,74,370,80,871,419,5643
"17045070100",2213,373,0,15,13,6,7,15,2642
"17045070200",1678,345,0,0,10,5,3,67,2108
"17045070300",3091,1141,0,5,46,0,30,0,4313
"17045070400",4119,992,0,14,95,6,60,6,5292
"17045070500",3381,409,8,0,54,0,5,0,3857
"17047956900",2337,152,18,0,3,3,3,0,2516
"17047957000",1586,282,0,0,29,9,12,0,1918
"17047957100",1853,299,8,0,70,12,0,33,2275
"17049950100",3823,176,0,3,52,9,11,7,4081
"17049950200",4237,341,0,0,123,0,97,0,4798
"17049950300",3714,285,0,0,70,0,35,0,4104
"17049950400",3363,361,0,0,66,8,2,0,3800
"17049950500",3948,272,0,0,242,5,169,14,4650
"17049950600",4603,508,0,3,98,9,134,9,5364
"17049950700",2707,619,0,9,38,37,22,43,3475
"17049950800",3404,410,0,0,74,11,42,11,3952
"17051950500",2384,545,0,0,0,16,8,0,2953
"17051950600",1925,506,0,0,72,42,14,0,2559
"17051950700",3779,551,0,0,211,140,8,0,4689
"17051950800",2884,336,14,3,40,45,59,8,3389
"17051950900",1394,399,13,2,149,38,11,38,2044
"17051951000",1752,214,0,0,6,0,17,0,1989
"17051951100",2624,711,0,0,21,0,8,29,3393
"17053961600",1608,316,0,0,22,2,45,18,2011
"17053961700",1763,282,0,0,16,0,103,0,2164
"17053961800",3765,336,9,16,36,0,80,0,4242
"17053961900",1706,127,9,0,4,2,41,19,1908
"17053962000",3100,237,0,0,50,98,0,0,3485
"17055040100",2365,426,0,0,85,46,22,0,2944
"17055040200",2684,302,0,0,10,7,27,10,3040
"17055040300",2344,711,0,0,0,0,6,0,3061
"17055040400",3113,802,0,0,13,14,40,5,3987
"17055040500",2265,474,0,0,47,0,22,0,2808
"17055040600",2271,534,0,0,44,26,84,120,3079
"17055040700",3143,1002,0,0,6,116,52,0,4319
"17055040800",3002,400,6,6,17,7,33,0,3471
"17055040900",1889,638,2,4,47,114,12,14,2720
"17055041000",1856,705,0,1,22,79,0,0,2663
"17055041100",2822,512,0,0,94,10,0,21,3459
"17055041200",3254,461,0,3,18,10,36,0,3782
"17057952800",2218,303,10,0,64,0,77,47,2719
"17057952900",2639,219,0,0,21,0,0,4,2883
"17057953000",1829,384,2,5,157,7,59,16,2459
"17057953100",2353,152,0,0,40,9,19,9,2582
"17057953200",2474,315,2,14,70,4,27,3,2909
"17057953300",3117,382,0,1,63,0,16,0,3579
"17057953400",1393,386,4,0,18,10,0,3,1814
"17057953500",2192,622,19,13,68,44,0,3,2961
"17057953600",3801,709,39,26,69,24,29,26,4723
"17057953700",2076,228,0,0,30,5,22,0,2361
"17057953800",2379,326,0,1,25,2,81,6,2820
"17057953900",2523,318,9,20,73,37,21,18,3019
"17059972700",1931,408,0,0,87,4,0,0,2430
"17059972800",2426,489,4,14,38,14,15,3,3003
"17061973600",3085,361,0,2,63,4,47,0,3562
"17061973700",1482,311,0,0,35,4,10,11,1853
"17061973800",1664,278,0,0,5,3,33,2,1985
"17061973900",2015,530,0,0,31,6,0,0,2582
"17061974000",3259,276,0,0,13,0,0,0,3548
"17063000102",6681,362,0,0,202,236,601,319,8401
"17063000103",5208,543,248,28,79,0,583,0,6689
"17063000200",5986,210,92,90,165,9,477,12,7041
"17063000300",2918,320,0,0,196,0,727,60,4221
"17063000400",4432,488,0,25,152,17,285,66,5465
"17063000500",2572,152,0,6,81,0,130,16,2957
"17063000600",2389,354,0,0,83,0,113,92,3031
"17063000700",5147,834,0,83,106,54,103,110,6437
"17063000800",4718,303,60,0,235,0,333,10,5659
"17063000900",3251,348,3,0,123,6,143,22,3896
"17065973100",2124,618,24,1,73,0,69,0,2909
"17065973200",2175,481,0,24,8,0,17,0,2705
"17065973300",2439,289,0,0,20,0,23,0,2771
"17067953700",1952,283,0,0,31,2,3,0,2271
"17067953800",2258,300,0,0,5,17,15,0,2595
"17067953900",1677,262,2,1,8,2,20,16,1988
"17067954000",2006,467,18,16,74,20,25,30,2656
"17067954100",2660,268,0,0,75,0,28,15,3046
"17067954200",2153,353,0,0,42,8,54,6,2616
"17067954300",3122,521,2,1,26,14,4,0,3690
"17069970900",1470,523,0,2,35,129,0,14,2173
"17069971000",1690,326,0,12,18,0,1,0,2047
"17071973300",2159,305,3,0,101,27,40,0,2635
"17071973400",1608,55,0,0,22,0,5,0,1690
"17071973500",2362,366,0,6,24,40,21,12,2831
"17073030100",4679,703,3,41,263,86,352,0,6127
"17073030201",4485,226,8,0,35,12,36,0,4802
"17073030202",3244,282,8,0,98,0,59,6,3697
"17073030203",4168,71,19,0,17,9,55,9,4348
"17073030300",6437,360,0,1,185,108,147,70,7308
"17073030400",2186,244,0,0,40,1,32,3,2506
"17073030500",2057,148,30,7,49,15,40,7,2353
"17073030600",2139,206,91,53,603,0,712,42,3846
"17073030800",1867,809,85,136,127,71,157,207,3459
"17073030900",3066,319,20,21,49,38,342,9,3864
"17073031000",2810,600,65,67,0,30,57,39,3668
"17073031100",2434,223,0,6,20,0,12,7,2702
"17073031200",2567,284,17,0,80,2,57,0,3007
"17075950100",2307,338,9,157,51,24,56,27,2969
"17075950200",3468,241,15,0,81,1,54,0,3860
"17075950300",2968,248,25,0,32,10,53,38,3374
"17075950400",2930,720,43,0,31,48,85,34,3891
"17075950500",3075,811,1,28,67,1,67,8,4058
"17075950600",2716,432,17,0,177,117,721,271,4451
"17075950700",2396,172,2,0,70,6,80,22,2748
"17075950800",2204,246,3,4,12,8,72,7,2556
"17075950900",2048,288,0,0,52,22,38,40,2488
"17077010100",3152,319,0,0,18,10,121,10,3630
"17077010200",3135,698,19,11,44,105,51,74,4137
"17077010300",2166,316,4,0,12,38,6,0,2542
"17077010400",3959,405,29,20,51,12,25,0,4501
"17077010600",4762,1164,87,289,56,68,223,14,6663
"17077010700",1645,612,103,337,28,179,25,14,2943
"17077010800",1961,785,582,106,209,21,130,26,3820
"17077010900",957,340,718,385,16,42,40,32,2530
"17077011000",4294,429,507,219,617,229,201,0,6496
"17077011100",668,1102,61,581,110,317,120,182,3141
"17077011200",1116,1230,534,1707,31,147,75,235,5075
"17077011400",967,1524,80,142,412,338,18,140,3621
"17077011600",3002,425,211,8,398,0,13,10,4067
"17077011700",980,1251,145,303,332,497,110,318,3936
"17079977300",2585,149,0,0,81,11,54,11,2891
"17079977400",2607,258,0,5,9,0,5,0,2884
"17079977500",3617,195,0,0,54,17,17,0,3900
"17081050100",3472,484,0,0,78,3,47,0,4084
"17081050200",2615,381,0,0,27,21,11,8,3063
"17081050300",3846,364,3,3,127,25,79,2,4449
"17081050400",3337,548,0,30,62,0,64,0,4041
"17081050500",2669,619,166,21,90,72,13,0,3650
"17081050600",2547,136,99,69,163,81,26,0,3121
"17081050700",2699,621,137,27,112,18,40,0,3654
"17081050800",3838,469,14,11,68,21,11,11,4443
"17081050900",1387,468,407,232,306,79,260,27,3166
"17081051000",444,152,219,404,0,130,16,6,1371
"17081051100",1379,482,327,92,27,18,16,0,2341
"17083010100",3884,629,0,0,129,0,19,124,4785
"17083010200",3476,170,0,0,0,0,54,0,3700
"17083010300",3175,226,36,0,65,0,2,0,3504
"17083010401",6270,270,0,0,36,0,10,3,6589
"17083010402",1711,169,0,0,71,2,0,0,1953
"17083010500",1248,195,0,0,81,7,20,0,1551
"17085020100",3856,496,1,2,21,10,84,1,4471
"17085020200",4448,366,6,11,172,12,83,0,5098
"17085020300",3941,426,12,0,180,25,268,82,4934
"17085020401",2147,29,18,0,20,0,20,0,2234
"17085020402",2502,401,4,0,30,15,50,10,3012
"17085020500",2875,326,5,0,20,2,11,18,3257
"17087977600",3667,492,9,0,80,1,4,0,4253
"17087977700",2546,306,0,0,35,0,25,0,2912
"17087977800",2744,668,15,13,27,20,8,5,3500
"17087980000",45,0,0,0,0,0,0,0,45
"17089850101",4420,449,62,152,1010,566,2285,827,9771
"17089850103",4580,251,105,0,858,0,521,14,6329
"17089850105",5800,371,43,0,1148,0,682,58,8102
"17089850106",7195,176,153,0,642,110,1508,110,9894
"17089850201",2253,268,25,178,1421,202,2467,384,7198
"17089850202",3331,406,205,163,2225,541,4583,884,12338
"17089850301",3394,374,118,1426,1358,310,3401,488,10869
"17089850302",3043,357,265,185,828,178,1524,394,6774
"17089850400",2048,175,0,0,97,0,256,85,2661
"17089850500",2929,164,256,0,101,147,132,171,3900
"17089850600",6046,223,190,35,736,174,497,11,7912
"17089850701",13972,187,141,0,3385,733,2500,707,21625
"17089850702",12896,230,52,10,966,10,1687,14,15865
"17089850703",2077,210,19,1,30,0,22,27,2386
"17089850800",5664,421,143,74,988,33,3629,204,11156
"17089851000",3836,332,270,31,1025,245,1825,155,7719
"17089851101",2644,420,50,4,868,144,1556,357,6043
"17089851102",2362,426,232,65,448,214,1246,500,5493
"17089851301",2437,290,122,46,1155,316,2565,475,7406
"17089851302",1377,401,243,117,1051,91,1960,449,5689
"17089851400",3049,367,394,290,2089,471,3865,708,11233
"17089851500",738,185,24,0,132,138,327,280,1824
"17089851600",3993,973,340,136,808,301,2093,931,9575
"17089851801",6434,352,143,112,485,0,1222,180,8928
"17089851904",5114,725,134,15,887,331,2093,949,10248
"17089851905",9154,86,194,0,2309,26,1236,0,13005
"17089851907",5252,286,522,0,1245,0,1577,78,8960
"17089851908",2413,491,480,239,1051,105,1068,403,6250
"17089851909",3076,104,58,0,931,11,1143,11,5334
"17089851910",2982,265,153,72,794,193,1236,360,6055
"17089852001",3322,230,66,2,164,21,415,21,4241
"17089852002",6142,115,102,0,732,0,552,0,7643
"17089852003",7283,196,0,0,303,8,197,0,7987
"17089852101",6629,93,73,1,432,0,56,0,7284
"17089852102",7943,134,54,0,718,0,460,0,9309
"17089852201",4679,142,0,0,133,0,323,37,5314
"17089852202",6169,206,121,27,1277,130,1620,159,9709
"17089852300",1756,204,0,0,28,8,153,21,2170
"17089852401",7949,345,2,0,259,44,479,96,9174
"17089852402",7827,390,38,0,142,23,117,0,8537
"17089852403",4773,245,21,14,163,15,135,0,5366
"17089852500",5491,384,116,2,365,48,357,54,6817
"17089852601",6479,490,0,0,208,0,313,59,7549
"17089852606",4165,64,15,2,36,0,42,0,4324
"17089852700",6246,377,132,26,515,92,648,174,8210
"17089852803",3638,684,164,210,99,126,101,279,5301
"17089852805",3911,49,504,21,638,134,376,96,5729
"17089852806",6537,54,255,0,348,0,356,0,7550
"17089852807",2412,84,0,0,590,65,78,0,3229
"17089852808",6376,168,63,55,422,110,298,164,7656
"17089852903",3849,114,447,182,1691,27,2258,149,8717
"17089852904",668,56,129,243,968,548,1508,568,4688
"17089852905",1847,335,511,894,1013,453,1496,654,7203
"17089852906",3078,468,235,177,859,90,914,388,6209
"17089852907",2460,524,267,153,1808,529,2820,886,9447
"17089853001",1789,93,125,35,756,28,755,0,3581
"17089853004",2257,125,122,50,349,31,449,0,3383
"17089853005",3305,478,554,220,680,1030,1289,1031,8587
"17089853006",1965,100,388,6,654,400,1041,203,4757
"17089853007",1967,490,745,153,2031,575,2585,779,9325
"17089853008",2098,548,498,0,1475,89,2263,341,7312
"17089853100",1326,248,210,132,797,265,1326,457,4761
"17089853200",2057,507,473,367,2700,506,3139,538,10287
"17089853300",2682,213,55,53,1334,789,3268,1015,9409
"17089853400",2594,511,500,0,3955,1383,6230,1725,16898
"17089853500",1714,689,289,24,2739,828,3920,1375,11578
"17089853600",1980,575,450,132,3628,1412,5096,1902,15175
"17089853900",4089,765,388,4,726,172,981,0,7125
"17089854001",3857,213,207,5,325,38,652,77,5374
"17089854002",3005,479,344,149,615,429,1115,597,6733
"17089854100",1628,184,116,60,2666,414,3448,552,9068
"17089854200",1789,303,326,159,2292,687,3080,906,9542
"17089854301",2087,186,261,52,2963,1133,3995,1251,11928
"17089854302",1831,436,329,15,1862,806,2681,1084,9044
"17089854400",6835,895,1756,471,3427,1902,4973,2390,22649
"17089854501",13616,338,207,0,1021,69,817,56,16124
"17089854503",9164,364,495,0,1838,0,2087,291,14239
"17089854504",6836,109,107,0,501,0,472,10,8035
"17089854600",1229,765,261,422,833,294,1436,744,5984
"17089854700",866,364,260,154,541,251,782,366,3584
"17089854800",7367,70,69,0,694,0,234,0,8434
"17089854900",3113,325,570,308,678,384,1096,351,6825
"17091010100",2280,192,2,1,35,9,47,9,2575
"17091010201",1723,85,5,0,7,0,0,0,1820
"17091010202",8425,375,49,145,535,0,590,15,10134
"17091010300",3724,202,5,0,38,9,94,0,4072
"17091010400",4687,172,84,0,64,7,37,0,5051
"17091010500",5386,433,157,116,183,33,316,0,6624
"17091010601",3883,130,919,0,429,0,169,10,5540
"17091010602",4021,869,361,50,211,235,337,149,6233
"17091010701",3682,91,547,136,152,60,555,47,5270
"17091010702",6163,427,313,3,292,95,320,95,7708
"17091010800",2461,462,412,77,172,137,380,374,4475
"17091010900",3488,623,81,47,277,0,229,29,4774
"17091011000",201,110,974,667,53,105,17,45,2172
"17091011100",1744,309,7,2,107,4,227,69,2469
"17091011200",1825,151,57,0,92,5,56,12,2198
"17091011300",1898,117,121,4,12,0,61,0,2213
"17091011400",589,123,310,507,220,40,274,19,2082
"17091011500",242,151,783,747,33,54,187,94,2291
"17091011600",89,71,641,803,8,0,8,50,1670
"17091011700",1671,440,153,732,98,52,332,140,3618
"17091011800",2463,215,0,0,29,51,165,0,2923
"17091011900",1316,120,3,1,6,11,80,0,1537
"17091012000",2126,707,65,421,101,106,44,211,3781
"17091012100",2399,198,109,78,77,308,219,383,3771
"17091012200",2077,592,629,180,62,0,294,184,4018
"17091012300",1216,985,1155,1303,426,91,853,584,6613
"17091012400",2261,270,1181,449,511,328,874,422,6296
"17091012500",1321,519,195,69,78,3,136,187,2508
"17091012600",3881,377,64,32,28,19,10,35,4446
"17093890101",13017,315,2013,125,3050,177,2548,413,21658
"17093890102",11305,318,314,114,597,55,1023,108,13834
"17093890201",3367,340,189,0,484,49,930,49,5408
"17093890202",2399,197,93,0,209,46,672,47,3663
"17093890301",5074,293,334,159,535,0,1103,0,7498
"17093890302",5447,340,81,0,137,163,527,55,6750
"17093890400",21939,536,1006,1,2501,426,4029,692,31130
"17093890500",9501,821,785,8,1816,140,3104,332,16507
"17093890600",8506,255,341,0,354,34,513,33,10036
"17093890700",12646,546,1006,11,1072,71,1942,143,17437
"17095000100",2975,111,0,0,27,2,32,0,3147
"17095000200",2597,217,9,4,89,11,30,5,2962
"17095000300",3652,317,150,25,53,25,75,78,4375
"17095000400",3477,387,214,71,217,0,139,0,4505
"17095000500",2843,173,72,221,129,29,309,40,3816
"17095000600",2901,616,29,9,63,0,46,8,3672
"17095000700",1252,273,122,118,185,124,139,63,2276
"17095000800",828,550,93,74,38,63,38,65,1749
"17095000900",751,915,424,152,45,9,95,224,2615
"17095001000",2711,715,264,23,288,105,445,177,4728
"17095001100",958,718,107,694,0,0,62,23,2562
"17095001200",1466,88,17,0,77,0,21,0,1669
"17095001300",3240,238,8,0,14,0,26,0,3526
"17095001400",1488,184,13,0,51,0,14,0,1750
"17095001500",2911,438,61,0,104,66,72,0,3652
"17095001600",3290,269,4,2,10,32,4,3,3614
"17097860101",4492,253,2664,76,1351,31,1745,85,10697
"17097860103",3106,129,27,11,161,0,155,29,3618
"17097860104",2772,344,45,71,146,0,187,12,3577
"17097860200",2359,90,319,191,265,20,310,20,3574
"17097860301",1293,269,764,451,694,35,1134,282,4922
"17097860302",1157,67,838,428,523,98,734,81,3926
"17097860400",2960,290,1110,304,660,98,1340,11,6773
"17097860500",1601,396,1315,440,1020,157,1173,136,6238
"17097860600",4594,488,544,226,910,21,1323,184,8290
"17097860805",1407,105,0,6,63,32,6,8,1627
"17097860806",4507,487,17,0,100,7,469,30,5617
"17097860807",3061,252,0,0,45,0,206,0,3564
"17097860808",2277,179,0,0,162,0,191,0,2809
"17097860809",2860,212,31,0,138,0,72,0,3313
"17097860810",5761,697,328,0,562,0,238,40,7626
"17097860811",3333,254,316,7,297,5,199,10,4421
"17097860903",4669,916,0,0,423,23,475,0,6506
"17097860904",5168,338,0,0,107,18,446,54,6131
"17097860905",4566,644,25,0,526,24,795,183,6763
"17097860906",7435,386,147,7,1010,46,1189,175,10395
"17097861007",3468,43,150,0,621,0,228,0,4510
"17097861008",4459,73,90,111,443,1,458,129,5764
"17097861009",4258,151,68,10,459,105,344,9,5404
"17097861010",4736,359,119,0,588,24,936,62,6824
"17097861011",6420,49,398,0,652,23,1324,26,8892
"17097861012",4859,355,63,0,106,24,321,25,5753
"17097861013",2514,86,0,56,278,0,193,0,3127
"17097861014",2911,275,133,9,517,31,343,201,4420
"17097861105",3661,67,89,81,340,47,423,0,4708
"17097861106",5888,306,194,19,1513,103,667,138,8828
"17097861107",3480,44,77,0,322,0,191,0,4114
"17097861108",5624,129,62,0,483,59,400,4,6761
"17097861201",5582,542,0,131,858,37,4089,362,11601
"17097861202",3209,551,0,38,164,275,1092,703,6032
"17097861301",3587,448,51,181,319,134,1404,258,6382
"17097861303",3114,1348,71,9,481,9,2235,1069,8336
"17097861304",2502,807,0,0,194,0,1932,654,6089
"17097861402",6081,640,434,32,1175,316,2276,426,11380
"17097861403",1749,200,68,99,456,171,1376,196,4315
"17097861404",3825,829,43,264,866,168,2341,743,9079
"17097861504",3571,230,396,25,3195,254,3195,348,11214
"17097861505",2935,9,231,20,539,5,227,0,3966
"17097861506",3141,182,684,62,1248,10,1097,77,6501
"17097861507",1908,314,335,13,553,0,625,8,3756
"17097861508",2463,167,566,43,681,24,536,62,4542
"17097861509",2819,157,407,38,319,62,589,84,4475
"17097861510",3348,373,267,113,884,128,1120,327,6560
"17097861603",4988,125,242,0,571,0,175,0,6101
"17097861604",4101,191,293,0,999,97,863,79,6623
"17097861607",3369,317,157,84,552,0,538,116,5133
"17097861608",2713,175,78,14,222,0,392,0,3594
"17097861609",2964,253,126,67,1152,0,470,164,5196
"17097861610",2987,24,292,0,373,17,216,0,3909
"17097861611",3127,25,313,0,763,73,243,0,4544
"17097861701",1764,61,150,54,157,0,512,8,2706
"17097861702",2610,149,448,54,794,188,1357,204,5804
"17097861803",3082,678,600,232,1813,351,2811,819,10386
"17097861804",1504,266,321,101,952,165,1623,357,5289
"17097861901",2753,314,249,60,844,12,1682,222,6136
"17097861902",2978,244,1088,307,1385,78,2635,321,9036
"17097862000",2650,115,719,408,1694,146,3536,205,9473
"17097862100",2316,309,786,580,984,107,2308,303,7693
"17097862200",1531,345,343,440,463,226,1016,300,4664
"17097862300",304,1048,673,492,371,47,530,1031,4496
"17097862401",1880,415,189,212,672,165,1982,692,6207
"17097862402",1381,637,231,143,908,169,2129,666,6264
"17097862501",1665,318,166,121,1156,78,2605,291,6400
"17097862502",544,727,239,101,650,112,1062,674,4109
"17097862603",4022,606,1158,215,1618,237,3671,609,12136
"17097862604",2414,387,374,64,1031,369,2732,632,8003
"17097862605",919,318,833,1620,513,48,528,138,4917
"17097862700",1117,578,428,151,926,374,1889,933,6396
"17097862800",302,25,933,358,485,162,600,152,3017
"17097862901",1154,339,523,244,1023,283,1968,590,6124
"17097862902",455,134,898,229,416,367,730,407,3636
"17097863003",71,16,0,0,4,0,4,13,108
"17097863004",1881,253,470,120,892,179,689,0,4484
"17097863005",48,0,0,0,0,0,0,0,48
"17097863006",0,0,0,0,0,0,0,0,0
"17097863100",608,154,983,648,841,0,1227,45,4506
"17097863201",534,364,1166,602,728,259,1037,609,5299
"17097863202",3970,399,160,0,708,14,390,47,5688
"17097863300",2396,168,0,0,148,0,0,0,2712
"17097863400",2985,214,39,0,8,0,79,0,3325
"17097863500",3778,222,0,0,156,22,105,0,4283
"17097863601",3008,144,78,6,323,0,58,1,3618
"17097863603",2814,73,21,1,522,7,210,1,3649
"17097863604",2556,53,92,0,77,21,158,0,2957
"17097863701",3774,354,9,0,305,8,168,6,4624
"17097863702",2732,76,31,30,705,11,127,0,3712
"17097863801",4175,128,15,0,204,21,232,28,4803
"17097863902",3826,99,85,0,1488,0,332,4,5834
"17097863903",4049,197,18,1,225,38,28,0,4556
"17097863904",4682,10,9,0,1415,14,131,0,6261
"17097864001",5559,447,10,0,619,2,2008,339,8984
"17097864002",4267,701,36,3,992,130,3208,767,10104
"17097864101",9381,412,171,5,1656,21,664,208,12518
"17097864105",4598,9,366,54,821,0,591,44,6483
"17097864106",3898,71,43,0,195,0,1005,28,5240
"17097864107",3813,468,42,0,451,41,774,58,5647
"17097864108",4649,225,0,3,686,71,1892,10,7536
"17097864203",3737,118,10,0,421,208,523,200,5217
"17097864204",3501,614,59,8,180,109,771,1,5243
"17097864205",7827,380,61,1,928,0,1211,91,10499
"17097864206",2869,323,24,3,100,63,968,144,4494
"17097864303",4297,63,60,0,146,0,355,0,4921
"17097864305",3619,48,0,11,231,0,95,0,4004
"17097864306",2160,82,0,0,127,0,97,19,2485
"17097864307",1526,145,0,0,134,0,43,0,1848
"17097864308",3552,381,11,0,158,9,90,190,4391
"17097864402",6037,408,80,0,671,44,396,28,7664
"17097864403",3793,215,191,10,458,13,156,2,4838
"17097864407",5137,102,35,8,484,22,80,0,5868
"17097864408",5073,341,14,0,447,40,945,191,7051
"17097864409",3622,174,0,0,614,28,356,99,4893
"17097864410",4397,264,0,0,596,40,39,101,5437
"17097864411",4609,74,0,0,224,9,43,0,4959
"17097864412",3704,46,40,0,290,47,97,0,4224
"17097864505",5356,148,141,45,998,139,443,0,7270
"17097864510",3047,221,81,0,890,78,1455,215,5987
"17097864511",4114,190,11,0,1856,102,823,176,7272
"17097864512",3712,308,0,0,502,45,681,56,5304
"17097864513",4278,61,49,0,977,0,195,23,5583
"17097864514",1657,64,0,0,880,54,106,0,2761
"17097864515",1734,18,45,0,406,0,12,0,2215
"17097864516",3437,103,0,0,753,13,103,0,4409
"17097864517",3038,81,8,0,767,32,36,0,3962
"17097864518",4219,55,8,0,989,74,103,0,5448
"17097864519",3620,127,16,13,795,149,55,0,4775
"17097864520",3852,33,106,2,1393,40,260,0,5686
"17097864521",1657,49,53,0,544,0,34,8,2345
"17097864522",4001,104,0,0,399,47,87,0,4638
"17097864601",3358,199,50,0,209,2,29,0,3847
"17097864602",3419,98,11,0,369,0,82,0,3979
"17097864700",2565,89,162,1,99,1,136,0,3053
"17097864801",4486,54,11,0,245,34,489,0,5319
"17097864802",2322,72,0,15,358,1,73,2,2843
"17097864901",3689,122,59,1,146,9,100,12,4138
"17097864903",4426,108,0,0,193,49,12,0,4788
"17097864904",2232,77,0,0,211,0,298,0,2818
"17097865000",1200,11,0,0,27,0,8,0,1246
"17097865200",3318,885,184,0,951,193,1857,564,7952
"17097865300",3025,33,54,0,213,0,364,0,3689
"17097865400",3466,551,39,10,80,19,395,265,4825
"17097865501",1875,123,234,23,82,4,225,38,2604
"17097865502",2032,146,25,0,168,15,244,27,2657
"17097865600",3132,156,0,0,107,0,37,41,3473
"17097865700",5183,779,48,0,219,0,79,190,6498
"17097865801",2797,115,0,2,105,51,137,0,3207
"17097865802",2749,20,0,0,155,0,16,0,2940
"17097866000",5227,106,696,14,695,0,857,0,7595
"17097866100",1173,469,435,289,880,350,1769,801,6166
"17097866200",4422,428,14,11,473,14,223,22,5607
"17097990000",0,0,0,0,0,0,0,0,0
"17099961701",6201,240,0,0,29,9,192,0,6671
"17099961702",2659,209,1,2,23,12,112,32,3050
"17099961800",3476,639,0,0,53,0,321,6,4495
"17099961900",3518,388,56,57,115,50,570,181,4935
"17099962000",2660,497,0,1,515,121,1044,153,4991
"17099962100",3938,558,0,0,181,5,183,13,4878
"17099962200",4028,557,12,6,130,13,137,177,5060
"17099962300",5869,433,0,0,60,62,202,19,6645
"17099962400",3394,353,0,0,26,88,165,45,4071
"17099962500",1857,200,0,0,53,0,89,0,2199
"17099962600",4169,605,128,114,298,0,678,212,6204
"17099962700",1510,620,99,59,131,0,139,158,2716
"17099962800",2840,562,51,99,114,120,100,57,3943
"17099962900",2416,430,0,0,66,118,298,10,3338
"17099963000",3811,561,21,45,268,0,106,35,4847
"17099963100",2748,171,0,0,32,0,130,12,3093
"17099963200",2802,247,4,0,93,9,239,0,3394
"17099963300",1909,375,1,0,95,0,375,26,2781
"17099963400",3517,284,0,242,6,2,171,8,4230
"17099963500",3984,433,30,0,55,33,170,11,4716
"17099963600",3073,162,107,12,24,0,107,0,3485
"17099963700",4734,635,37,0,72,9,149,0,5636
"17099963800",3701,483,26,1,135,78,562,18,5004
"17099963900",4591,427,2,107,323,66,731,157,6404
"17099964000",1972,145,1,0,41,0,83,4,2246
"17099964100",3568,420,21,2,26,12,69,100,4218
"17099964200",2041,392,0,30,240,0,344,29,3076
"17099964300",2074,738,3,60,138,15,117,50,3195
"17101880700",1947,420,6,1,11,1,44,1,2431
"17101880800",2226,289,10,6,17,1,2,0,2551
"17101880900",1409,249,0,0,1,0,24,0,1683
"17101881000",1412,230,13,0,58,0,55,0,1768
"17101881100",2319,253,34,12,57,0,10,0,2685
"17103000100",2479,326,26,3,77,8,63,44,3026
"17103000200",3113,149,1,1,148,19,52,0,3483
"17103000300",3186,398,0,6,229,42,222,14,4097
"17103000400",4650,398,74,72,61,70,321,138,5784
"17103000500",4432,208,221,0,113,0,256,10,5240
"17103000600",2499,626,197,37,174,0,76,20,3629
"17103000700",1894,304,0,11,15,1,53,36,2314
"17103000800",3042,425,0,2,5,0,145,57,3676
"17103000900",2899,407,25,8,19,10,69,10,3447
"17105960100",3546,382,20,14,30,42,57,39,4130
"17105960200",3144,221,9,0,44,14,66,0,3498
"17105960300",2552,233,10,0,7,0,163,0,2965
"17105960400",2898,219,0,0,76,4,64,25,3286
"17105960500",2330,334,0,14,22,5,88,72,2865
"17105960600",3380,660,8,2,16,1,94,1,4162
"17105960700",3167,374,26,10,38,14,48,24,3701
"17105960800",5243,311,0,6,55,34,92,54,5795
"17105960900",2122,294,0,0,26,0,61,30,2533
"17105961000",1929,329,0,0,40,16,76,11,2401
"17107952900",2340,377,54,1,84,17,4,1,2878
"17107953000",1818,108,5,0,59,8,11,1,2010
"17107953100",2340,560,16,70,179,21,0,0,3186
"17107953200",2928,646,25,98,219,96,29,2,4043
"17107953300",2585,328,22,0,150,157,0,0,3242
"17107953400",3249,380,14,42,26,11,69,11,3802
"17107953500",1798,85,1,0,75,5,5,3,1972
"17107953600",2129,201,0,0,75,17,3,0,2425
"17109010100",3063,508,50,32,30,109,10,32,3834
"17109010200",1713,169,2,0,43,0,2,2,1931
"17109010300",1957,50,27,0,57,0,15,0,2106
"17109010400",2075,2448,172,230,74,171,27,251,5448
"17109010500",29,81,0,23,0,9,4,0,146
"17109010600",1353,466,84,97,50,23,0,24,2097
"17109010700",3537,554,0,14,257,0,1,0,4363
"17109010900",1899,581,0,32,73,112,39,48,2784
"17109011000",2061,279,6,0,39,0,30,18,2433
"17109011100",2371,327,7,9,47,0,0,0,2761
"17111870101",6214,417,91,5,137,26,321,13,7224
"17111870102",6291,215,15,0,238,0,396,20,7175
"17111870200",4802,470,0,8,630,480,770,608,7768
"17111870301",3025,892,0,0,626,244,1026,817,6630
"17111870302",2396,1069,0,6,291,531,1059,919,6271
"17111870401",6646,802,78,0,666,0,877,5,9074
"17111870402",4056,437,10,162,484,328,1155,566,7198
"17111870500",7807,822,0,0,374,0,250,207,9460
"17111870603",4095,253,8,7,197,31,410,31,5032
"17111870604",5384,248,61,0,130,0,501,0,6324
"17111870605",5139,501,0,0,579,357,684,357,7617
"17111870606",2507,631,16,25,716,272,662,380,5209
"17111870702",6026,772,0,0,434,81,477,215,8005
"17111870703",5133,301,15,0,221,3,322,68,6063
"17111870704",3572,299,0,0,7,0,88,37,4003
"17111870803",7097,323,0,17,217,0,170,0,7824
"17111870807",4245,510,41,18,420,16,457,193,5900
"17111870808",3611,55,118,13,111,0,318,0,4226
"17111870809",6142,249,37,0,636,0,254,8,7326
"17111870810",4028,341,56,0,164,15,276,121,5001
"17111870811",4034,344,0,0,183,6,445,45,5057
"17111870812",4324,190,48,0,305,0,466,23,5356
"17111870902",6430,742,101,20,350,62,558,318,8581
"17111870903",2537,261,0,0,392,20,1046,0,4256
"17111870904",3784,540,5,0,159,20,315,149,4972
"17111870905",3888,325,94,6,818,226,1308,153,6818
"17111871003",3697,278,32,0,131,20,421,0,4579
"17111871004",5383,483,5,69,352,129,580,134,7135
"17111871104",13691,715,477,0,2533,58,2191,0,19665
"17111871105",4619,90,151,0,264,0,233,0,5357
"17111871106",8162,221,327,0,488,46,1123,66,10433
"17111871107",4942,47,94,8,548,0,150,0,5789
"17111871108",5056,49,0,0,360,0,306,35,5806
"17111871109",4516,306,120,0,380,0,553,132,6007
"17111871201",6046,283,0,2,229,20,566,57,7203
"17111871202",4302,242,531,6,510,227,1246,242,7306
"17111871205",3693,702,90,0,357,0,392,0,5234
"17111871206",5800,43,0,0,650,0,375,0,6868
"17111871207",3987,172,23,0,579,0,580,60,5401
"17111871208",3760,171,16,0,243,0,147,0,4337
"17111871209",2910,131,0,0,132,0,94,41,3308
"17111871301",4198,136,11,0,281,62,627,16,5331
"17111871304",3031,117,0,0,161,0,40,0,3349
"17111871305",6120,247,32,12,155,0,809,65,7440
"17111871306",7198,225,12,5,631,2,667,0,8740
"17111871307",4318,235,0,0,218,473,332,450,6026
"17111871310",4113,346,0,0,27,0,237,0,4723
"17111871311",3423,80,175,0,744,72,970,38,5502
"17111871402",5201,463,2,2,333,193,265,175,6634
"17111871404",3800,148,135,35,276,40,327,77,4838
"17111871500",9787,746,93,0,257,0,560,18,11461
"17111871600",4178,369,2,2,218,0,271,54,5094
"17113000102",4004,1944,201,198,445,123,210,145,7270
"17113000104",6884,1909,788,534,968,246,778,143,12250
"17113000105",3813,123,24,0,98,46,117,13,4234
"17113000200",61,792,0,5,0,30,0,27,915
"17113000301",1661,1199,291,78,281,112,76,75,3773
"17113000302",4321,192,733,525,335,56,199,132,6493
"17113000400",1297,1420,38,17,58,45,214,131,3220
"17113000501",1483,1320,16,65,58,0,35,0,2977
"17113000502",2270,232,0,0,115,0,53,0,2670
"17113000504",3350,596,420,108,360,0,304,62,5200
"17113000505",4782,33,52,0,995,25,74,0,5961
"17113001103",1978,173,386,31,562,21,123,0,3274
"17113001104",6505,229,434,73,1102,0,139,140,8622
"17113001105",3743,97,367,31,856,0,199,0,5293
"17113001106",1929,114,536,61,218,43,211,1,3113
"17113001200",2025,255,21,62,82,10,370,72,2897
"17113001301",1349,206,65,56,117,0,100,30,1923
"17113001302",363,372,38,0,53,42,28,10,906
"17113001303",941,323,39,30,64,0,16,0,1413
"17113001402",2902,112,272,85,254,0,140,18,3783
"17113001403",2545,438,503,434,144,12,154,63,4293
"17113001404",3006,358,308,37,208,104,208,0,4229
"17113001500",896,387,456,274,106,33,84,1,2237
"17113001600",934,461,222,497,62,0,40,89,2305
"17113001700",1585,368,29,157,57,28,170,61,2455
"17113001800",2692,142,68,4,227,43,64,9,3249
"17113002101",3334,532,232,0,280,0,397,0,4775
"17113002102",1611,254,28,7,50,18,106,99,2173
"17113005101",6634,174,225,20,1859,18,366,0,9296
"17113005102",6787,333,3,0,182,9,42,14,7370
"17113005201",1042,11,52,0,18,0,24,0,1147
"17113005202",2782,76,55,0,85,0,104,0,3102
"17113005400",8569,225,26,19,200,0,152,0,9191
"17113005501",2213,159,0,0,25,0,38,0,2435
"17113005502",2144,101,0,0,26,0,22,0,2293
"17113005601",1594,202,5,3,33,13,10,2,1862
"17113005602",2195,130,4,2,79,0,28,3,2441
"17113005700",4408,538,6,59,58,0,152,13,5234
"17113005800",2776,201,372,79,1050,42,234,15,4769
"17113005900",3101,520,296,787,205,21,113,0,5043
"17113006000",3306,300,0,0,138,22,57,11,3834
"17115000200",862,533,519,671,58,132,0,36,2811
"17115000300",796,845,1225,629,79,71,76,0,3721
"17115000400",193,93,446,359,106,48,9,0,1254
"17115000500",812,999,190,681,53,125,57,28,2945
"17115000600",263,91,861,652,120,29,39,0,2055
"17115000900",547,226,738,475,65,0,21,34,2106
"17115001000",879,103,66,238,17,7,0,0,1310
"17115001100",2406,312,145,99,311,1,42,1,3317
"17115001200",1617,685,366,68,11,12,0,60,2819
"17115001300",2101,36,87,0,48,5,22,0,2299
"17115001400",2053,69,131,75,14,0,0,0,2342
"17115001500",3543,133,198,131,107,29,0,0,4141
"17115001600",1082,49,241,17,52,0,56,0,1497
"17115001700",1644,534,406,66,92,259,7,12,3020
"17115001801",1777,52,511,22,21,0,69,0,2452
"17115001802",1754,507,186,2,132,45,51,0,2677
"17115001900",1161,394,406,464,228,76,43,5,2777
"17115002000",1380,482,814,272,125,209,55,156,3493
"17115002100",838,322,141,57,60,0,0,115,1533
"17115002200",3951,734,300,38,222,57,69,0,5371
"17115002300",2542,169,0,0,59,40,72,12,2894
"17115002401",2280,38,144,2,133,0,27,0,2624
"17115002402",4845,263,197,89,65,0,0,0,5459
"17115002500",6596,241,82,0,36,83,78,83,7199
"17115002601",3813,59,24,0,73,0,53,10,4032
"17115002602",1921,122,0,0,38,2,7,0,2090
"17115002700",2153,187,0,0,0,0,0,7,2347
"17115002800",3886,401,4,15,102,13,31,48,4500
"17115002901",3512,135,98,7,401,144,57,144,4498
"17115002902",3459,243,306,0,106,0,0,0,4114
"17115002903",2050,583,741,310,307,30,51,44,4116
"17115002904",3857,612,148,198,223,128,63,0,5229
"17115003000",3262,150,6,3,42,12,69,3,3547
"17115003100",221,198,406,845,89,65,23,2,1849
"17117956000",2688,545,10,0,34,0,0,0,3277
"17117956100",2950,428,7,0,39,2,8,12,3446
"17117956200",2152,318,0,0,19,2,7,0,2498
"17117956300",2436,300,4,0,13,8,10,4,2775
"17117956400",4504,647,0,0,41,0,0,23,5215
"17117956500",2448,108,39,0,83,3,44,0,2725
"17117956600",4353,323,24,0,46,13,9,25,4793
"17117956700",3739,319,97,27,56,6,62,16,4322
"17117956800",2032,384,0,0,93,74,19,0,2602
"17117956900",2822,716,0,0,115,5,40,0,3698
"17117957000",3235,614,39,0,68,23,55,19,4053
"17117957100",2393,223,0,0,0,3,0,0,2619
"17117957200",3914,560,0,0,56,63,68,10,4671
"17119400101",1926,113,285,28,90,0,57,0,2499
"17119400102",3865,898,406,181,221,135,176,181,6063
"17119400200",2344,995,388,208,137,54,199,9,4334
"17119400600",825,342,945,825,170,85,20,83,3295
"17119400700",8,14,851,792,12,20,3,0,1700
"17119400801",1737,58,22,0,53,0,35,0,1905
"17119400802",4858,1642,47,31,94,0,170,0,6842
"17119400903",3632,782,246,300,196,0,602,63,5821
"17119400904",2827,490,9,0,37,25,101,9,3498
"17119400951",4132,411,39,0,115,0,80,13,4790
"17119400952",2492,427,192,195,83,9,123,79,3600
"17119401000",1868,628,3,2,30,2,5,69,2607
"17119401100",4909,991,0,0,145,0,158,0,6203
"17119401200",1619,220,0,0,55,0,17,0,1911
"17119401300",3485,1419,0,0,110,62,15,0,5091
"17119401400",2474,276,52,81,72,20,156,8,3139
"17119401500",1715,598,84,177,28,53,14,12,2681
"17119401701",1594,769,30,221,75,36,28,0,2753
"17119401721",4700,773,25,0,123,0,161,12,5794
"17119401722",2596,354,0,37,25,109,0,0,3121
"17119401800",5443,372,50,19,11,42,137,20,6094
"17119401901",1348,265,0,0,30,0,25,5,1673
"17119401903",4027,625,21,3,85,30,94,3,4888
"17119401904",710,5,0,0,0,0,0,0,715
"17119402000",2156,850,660,225,103,88,0,28,4110
"17119402100",1207,209,1098,610,12,160,31,46,3373
"17119402200",1816,626,372,191,110,17,69,0,3201
"17119402300",1367,166,152,67,88,18,99,6,1963
"17119402400",1102,181,236,209,121,127,33,8,2017
"17119402500",802,266,735,379,120,26,35,34,2397
"17119402600",1736,227,491,83,33,100,31,9,2710
"17119402701",5489,848,689,74,91,46,88,0,7325
"17119402721",6820,488,134,48,239,0,86,0,7815
"17119402722",2846,67,42,1,48,0,54,2,3060
"17119402801",3186,129,68,0,51,0,0,0,3434
"17119402802",7256,452,81,0,220,0,0,0,8009
"17119402803",2962,257,7,0,55,0,7,0,3288
"17119402900",3075,495,366,26,120,26,21,0,4129
"17119403001",3743,933,363,16,260,60,105,0,5480
"17119403002",6028,465,423,0,384,9,345,9,7663
"17119403101",2904,525,25,98,111,58,7,0,3728
"17119403121",7083,717,661,269,357,18,65,162,9332
"17119403122",4187,174,133,220,467,19,122,0,5322
"17119403200",3552,597,107,29,82,10,175,0,4552
"17119403300",2198,480,322,28,117,8,79,0,3232
"17119403401",2687,474,405,93,119,38,129,0,3945
"17119403402",4125,654,668,447,160,15,88,0,6157
"17119403502",5098,281,310,153,114,56,344,56,6412
"17119403531",6435,445,28,162,258,126,439,119,8012
"17119403532",4119,67,27,0,65,0,60,18,4356
"17119403533",8350,441,293,15,415,0,209,0,9723
"17119403534",3672,198,32,66,75,21,124,0,4188
"17119403601",2931,274,17,0,58,0,151,0,3431
"17119403603",1660,56,0,0,95,0,0,0,1811
"17119403604",5331,684,9,9,138,0,20,311,6502
"17119403701",5933,239,0,0,102,0,104,0,6378
"17119403702",5867,90,0,0,97,3,45,0,6102
"17119403801",4377,320,81,0,84,26,0,0,4888
"17119403802",3769,339,11,2,26,9,8,10,4174
"17119404000",1494,657,104,151,35,10,362,26,2839
"17119404100",2661,129,0,40,10,0,12,16,2868
"17121951600",2755,601,0,0,105,0,40,0,3501
"17121951700",2487,233,0,0,19,5,16,9,2769
"17121951800",1669,517,1,6,52,6,21,0,2272
"17121951900",2533,340,61,3,101,6,11,5,3060
"17121952000",3414,675,3,7,46,29,34,0,4208
"17121952100",2061,705,0,0,106,91,28,36,3027
"17121952200",3517,343,0,0,61,4,56,9,3990
"17121952300",3244,276,46,34,39,0,19,0,3658
"17121952400",2949,251,166,25,121,32,27,0,3571
"17121952500",1606,1032,104,7,1,56,29,90,2925
"17121952600",1296,389,92,22,64,61,73,0,1997
"17121952700",1857,826,448,257,111,58,51,34,3642
"17123961100",2128,285,0,0,34,38,41,11,2537
"17123961200",2107,273,0,0,56,8,16,3,2463
"17123961300",2066,274,22,0,41,0,42,0,2445
"17123961400",2577,274,0,0,4,0,4,0,2859
"17123961500",1605,118,30,0,124,63,128,63,2131
"17125956300",2868,301,0,0,13,0,77,0,3259
"17125956400",1628,202,0,0,19,0,20,0,1869
"17125956500",2422,722,0,120,11,0,0,0,3275
"17125956600",1614,234,0,0,0,0,0,0,1848
"17125956700",1681,177,14,0,15,0,0,0,1887
"17125956800",1613,545,0,1,49,21,11,0,2240
"17127970100",4018,473,80,17,178,23,8,0,4797
"17127970200",3044,622,149,81,70,23,0,0,3989
"17127970300",2874,262,267,68,159,91,41,0,3762
"17127970400",1546,693,147,77,72,28,18,0,2581
"17129010100",5775,374,68,0,79,0,88,0,6384
"17129010200",3284,468,0,0,67,38,11,18,3886
"17129010300",1983,315,0,0,0,26,14,0,2338
"17131040100",4181,248,2,12,86,0,90,0,4619
"17131040200",3441,270,0,0,50,4,16,8,3789
"17131040300",2985,689,0,0,94,29,84,36,3917
"17131040400",3582,351,3,0,52,20,69,6,4083
"17133600101",6524,209,0,0,90,89,118,77,7107
"17133600102",4580,158,0,0,63,78,67,33,4979
"17133600401",6382,95,0,0,25,0,35,23,6560
"17133600402",4092,206,0,0,168,0,122,0,4588
"17133600501",6056,417,0,2,27,0,2,1,6505
"17133600502",2944,479,0,0,33,47,0,0,3503
"17135957300",2891,363,2,1,37,0,44,0,3338
"17135957400",1829,238,0,3,13,0,3,0,2086
"17135957500",2048,412,0,0,53,11,34,11,2569
"17135957600",2885,149,0,0,2,46,41,1,3124
"17135957700",2441,494,24,0,22,14,41,0,3036
"17135957800",2422,858,47,2,46,0,23,0,3398
"17135957900",3646,402,27,9,106,64,166,3,4423
"17135958000",2469,378,1,0,49,0,11,29,2937
"17137951400",2339,233,4,0,19,7,2,7,2611
"17137951500",2843,294,0,0,81,14,9,0,3241
"17137951600",1886,537,262,222,82,62,28,0,3079
"17137951700",1956,421,218,42,29,68,33,59,2826
"17137951800",2360,448,169,227,89,75,107,0,3475
"17137951900",4641,323,225,0,52,0,34,0,5275
"17137952000",1749,562,148,44,33,18,103,14,2671
"17137952100",3116,221,0,0,15,45,0,0,3397
"17137952200",2638,264,8,0,30,0,13,0,2953
"17137952300",2770,542,0,6,36,6,10,2,3372
"17139976900",4288,493,0,0,104,0,86,0,4971
"17139977000",2197,196,16,1,33,8,26,0,2477
"17139977100",2694,316,0,0,0,0,34,0,3044
"17139977200",3212,837,19,0,33,0,0,0,4101
"17141960700",4241,156,42,0,150,45,12,0,4646
"17141960800",3305,338,0,0,73,18,63,0,3797
"17141960900",3815,724,5,0,47,69,143,160,4963
"17141961000",6019,380,64,6,189,0,530,54,7242
"17141961100",3839,1019,34,55,328,19,814,355,6463
"17141961200",4538,667,62,0,227,17,577,298,6386
"17141961300",4457,268,0,0,38,0,66,15,4844
"17141961400",3433,558,10,1,69,8,12,0,4091
"17141961500",3777,375,14,0,25,0,177,49,4417
"17141961600",2670,697,67,57,112,31,725,590,4949
"17141961700",4534,399,0,0,81,0,126,0,5140
"17143000100",184,104,172,481,39,206,81,142,1409
"17143000200",538,130,418,352,3,0,77,0,1518
"17143000300",802,499,366,455,92,114,324,107,2759
"17143000500",462,113,282,666,2,54,223,9,1811
"17143000600",490,252,1073,1060,24,12,4,134,3049
"17143000900",373,214,613,1147,28,24,0,69,2468
"17143001200",504,237,74,557,117,32,69,20,1610
"17143001300",637,389,212,640,154,232,394,243,2901
"17143001500",627,479,290,397,70,51,64,109,2087
"17143001600",1251,307,789,838,225,114,345,38,3907
"17143001800",918,568,747,453,39,77,75,29,2906
"17143001900",710,507,116,24,52,36,0,53,1498
"17143002000",869,470,36,35,99,0,60,114,1683
"17143002100",1121,640,1337,1053,89,140,66,73,4519
"17143002200",2335,167,754,260,332,155,122,129,4254
"17143002300",3701,313,305,124,55,204,87,92,4881
"17143002400",2961,183,1038,323,216,0,0,53,4774
"17143002500",1037,283,1009,252,135,7,23,2,2748
"17143002600",1529,149,196,3,15,32,77,21,2022
"17143002701",1731,298,952,562,137,220,209,139,4248
"17143002702",2020,327,936,439,224,153,128,0,4227
"17143002800",2222,209,576,263,277,64,86,3,3700
"17143002900",2750,283,507,223,171,133,17,1,4085
"17143003000",3255,379,315,43,343,16,189,65,4605
"17143003101",3866,67,862,204,530,14,31,10,5584
"17143003102",3834,241,548,30,1188,30,133,18,6022
"17143003200",3316,338,471,53,433,118,88,0,4817
"17143003300",2858,112,25,0,111,0,44,0,3150
"17143003401",7895,1093,165,0,2078,90,155,0,11476
"17143003402",3465,143,10,0,120,14,42,0,3794
"17143003601",2369,191,0,6,165,1,51,1,2784
"17143003602",4816,661,0,3,130,11,284,11,5916
"17143003700",3452,92,64,30,57,0,72,30,3797
"17143003800",3250,254,31,1,30,0,77,3,3646
"17143003900",6061,221,73,0,348,9,127,1,6840
"17143004000",4053,203,44,1,58,12,80,0,4451
"17143004101",5195,121,338,62,803,0,236,22,6777
"17143004102",1508,353,600,117,155,84,126,91,3034
"17143004200",3135,210,28,17,121,26,21,15,3573
"17143004300",1581,367,186,28,43,50,32,82,2369
"17143004400",3067,752,443,357,353,66,193,20,5251
"17143004500",3402,367,356,210,238,29,32,24,4658
"17143004600",4965,665,14,0,29,0,99,0,5772
"17143004801",4019,419,35,1,124,25,15,16,4654
"17143004802",3306,219,422,286,91,25,228,17,4594
"17143004901",3503,308,15,0,65,9,17,1,3918
"17143004902",4683,93,2,10,113,0,217,0,5118
"17143005000",237,83,981,1226,15,204,151,7,2904
"17145030100",2660,553,55,0,61,1,59,0,3389
"17145030200",4747,948,0,0,82,0,66,0,5843
"17145030300",1689,338,0,0,19,0,32,7,2085
"17145030400",1849,442,156,313,39,74,56,69,2998
"17145030500",2053,192,45,0,40,7,0,0,2337
"17145030600",2653,737,86,26,70,39,0,6,3617
"17147954500",4137,333,0,0,55,19,22,21,4587
"17147954600",5604,151,0,0,35,0,66,0,5856
"17147954700",2913,311,0,0,91,15,59,0,3389
"17147954800",2488,193,15,0,73,0,5,0,2774
"17149952400",2227,485,54,25,41,18,36,23,2909
"17149952500",1999,306,3,0,27,10,17,26,2388
"17149952600",2952,455,0,0,98,2,0,0,3507
"17149952700",3526,773,0,0,56,9,0,11,4375
"17149952800",2142,522,0,0,18,11,6,6,2705
"17151971200",1869,293,11,36,0,9,49,38,2305
"17151971300",1586,322,7,34,20,21,8,6,2004
"17153971000",2035,349,423,117,93,0,81,3,3101
"17153971100",1267,166,932,475,64,11,8,0,2923
"17155954500",2424,279,0,1,56,141,105,81,3087
"17155954600",2560,412,4,1,6,5,48,40,3076
"17157950500",1754,358,30,27,57,0,28,0,2254
"17157950600",2788,331,619,517,16,4,10,1,4286
"17157950700",1993,256,15,0,14,0,181,0,2459
"17157950800",4674,135,13,0,9,0,63,0,4894
"17157950900",2973,400,1,0,68,4,38,6,3490
"17157951000",2767,220,2,0,16,0,17,0,3022
"17157951100",3014,259,0,0,57,26,115,21,3492
"17157951200",2213,234,137,79,61,0,16,14,2754
"17157951300",2719,782,16,2,47,60,15,118,3759
"17159977900",3087,409,0,1,48,0,65,0,3610
"17159978000",1800,453,12,13,0,0,32,0,2310
"17159978100",3291,558,0,9,206,4,37,8,4113
"17159978200",2001,487,14,0,48,0,0,0,2550
"17159978300",3109,337,0,0,79,0,0,0,3525
"17161020100",6278,367,13,10,173,42,167,96,7146
"17161020200",2708,285,108,293,242,76,196,117,4025
"17161020300",4576,603,414,31,658,38,568,363,7251
"17161020400",3654,562,186,117,465,41,670,21,5716
"17161020600",1342,419,255,64,621,52,1077,97,3927
"17161020700",876,391,61,98,413,31,502,105,2477
"17161020800",4250,134,342,34,284,112,747,18,5921
"17161020900",3987,361,393,167,348,132,375,185,5948
"17161021000",1912,483,272,317,617,121,290,146,4158
"17161021100",2728,295,454,2,172,9,166,33,3859
"17161021200",3360,163,142,10,354,84,415,67,4595
"17161021300",3289,268,524,127,134,140,162,159,4803
"17161021400",814,206,235,0,52,0,180,16,1503
"17161021500",3339,237,143,62,404,32,392,64,4673
"17161021600",2080,317,28,15,477,0,621,114,3652
"17161021700",3165,563,98,29,461,34,1051,85,5486
"17161021800",4006,155,228,0,227,0,182,134,4932
"17161021900",1491,234,42,13,83,20,166,25,2074
"17161022000",3259,327,22,0,404,20,365,0,4397
"17161022100",1985,107,42,16,494,13,386,0,3043
"17161022200",2984,284,0,0,308,235,1092,268,5171
"17161022300",1017,239,18,45,535,121,1047,169,3191
"17161022600",530,305,667,365,324,82,228,141,2642
"17161022800",2901,413,279,21,402,26,616,19,4677
"17161022900",2215,205,51,137,94,16,173,18,2909
"17161023000",3225,101,109,9,202,0,95,32,3773
"17161023100",2388,9,171,37,85,0,84,0,2774
"17161023200",3489,334,525,197,54,58,352,68,5077
"17161023300",2052,717,282,70,75,89,133,32,3450
"17161023500",752,188,559,330,96,0,167,44,2136
"17161023600",184,155,583,629,300,206,243,100,2400
"17161023700",977,214,529,266,359,116,174,146,2781
"17161024000",3662,311,57,1,72,0,72,11,4186
"17161024101",3264,248,120,0,44,12,81,13,3782
"17161024102",4201,624,22,178,51,62,100,45,5283
"17161024103",3837,270,8,0,49,6,45,0,4215
"17161024200",2950,589,327,8,125,86,124,65,4274
"17161024300",2640,282,2,127,18,5,1,0,3075
"17161024400",1120,273,310,225,76,81,151,20,2256
"17161024500",787,367,104,105,402,24,408,35,2232
"17163500400",0,2,790,1056,0,9,0,2,1859
"17163500500",2,4,1438,1626,1,27,0,30,3128
"17163500900",48,73,1305,2103,49,169,0,11,3758
"17163501100",0,0,698,684,28,0,5,47,1462
"17163501200",0,9,2247,1528,17,0,0,0,3801
"17163501300",12,0,2396,1169,0,16,68,0,3661
"17163501400",48,1,1534,1158,102,1,58,1,2903
"17163501501",681,115,657,166,2,0,9,3,1633
"17163501502",1538,164,683,261,118,11,35,12,2822
"17163501602",3045,706,1141,357,62,94,195,4,5604
"17163501603",2505,893,1184,490,210,141,120,1,5544
"17163501604",2127,283,1167,522,320,60,165,0,4644
"17163501605",1972,43,308,26,56,0,27,0,2432
"17163501700",1724,290,411,507,36,29,21,33,3051
"17163501800",4145,732,490,455,416,166,82,0,6486
"17163501900",2757,264,220,59,212,57,18,0,3587
"17163502100",1375,842,0,0,164,121,933,931,4366
"17163502200",105,17,1031,972,0,48,0,11,2184
"17163502300",2570,361,1535,1763,201,0,222,76,6728
"17163502401",0,5,1036,576,0,0,0,0,1617
"17163502404",1578,787,539,208,384,14,562,380,4452
"17163502500",0,0,702,583,5,0,0,0,1290
"17163502602",1970,278,1436,1758,229,157,204,36,6068
"17163502603",886,147,1444,1494,23,21,9,124,4148
"17163502700",9,0,759,575,0,11,0,0,1354
"17163502800",8,11,1388,1003,0,14,14,14,2452
"17163502900",13,0,1596,312,0,3,0,0,1924
"17163503100",6068,1217,75,32,147,28,121,37,7725
"17163503202",4336,770,660,214,56,0,0,0,6036
"17163503203",6233,302,0,0,88,0,24,0,6647
"17163503211",3362,190,722,33,167,19,46,13,4552
"17163503301",2548,378,520,162,172,27,26,15,3848
"17163503304",4952,370,907,280,328,34,232,0,7103
"17163503322",4978,363,868,151,709,28,141,11,7249
"17163503323",4837,268,798,163,283,42,246,18,6655
"17163503324",2991,66,2065,242,331,0,182,0,5877
"17163503332",2985,456,1070,382,298,19,252,18,5480
"17163503334",3690,218,1346,292,371,11,142,19,6089
"17163503402",4434,214,1501,316,475,13,367,9,7329
"17163503404",3945,41,410,80,382,21,163,0,5042
"17163503411",2408,280,341,43,117,0,8,1,3198
"17163503412",4678,666,321,69,233,21,100,0,6088
"17163503413",3780,112,1477,83,255,11,96,11,5825
"17163503414",2832,682,1042,145,214,10,226,137,5288
"17163503800",857,0,34,9,69,0,49,0,1018
"17163503903",3056,114,41,8,106,0,179,0,3504
"17163503904",7516,252,1561,67,522,167,555,43,10683
"17163503905",2765,118,0,0,0,8,0,0,2891
"17163503906",4982,276,0,0,134,0,102,67,5561
"17163504001",4381,206,16,7,17,0,79,0,4706
"17163504002",5304,529,26,1,84,30,46,27,6047
"17163504302",5461,297,331,567,412,2,100,1,7171
"17163504303",6466,667,332,26,220,49,98,0,7858
"17163504351",2425,171,200,240,276,0,57,0,3369
"17163504352",3385,205,374,51,150,100,49,30,4344
"17163504353",3457,155,198,46,336,37,158,13,4400
"17163504354",4482,193,1481,0,333,27,70,0,6586
"17163504355",4214,93,305,397,178,171,267,0,5625
"17163504500",53,57,2443,2132,48,114,0,0,4847
"17163504600",1,24,1145,777,0,0,0,2,1949
"17165955100",1697,434,27,24,22,9,15,24,2252
"17165955500",1512,683,0,0,9,86,0,0,2290
"17165955600",2070,333,0,0,0,0,21,2,2426
"17165955700",1942,646,0,0,8,13,2,0,2611
"17165955800",2165,402,16,91,35,42,17,30,2798
"17165955900",1846,471,51,117,98,11,12,31,2637
"17165956000",2344,425,14,113,147,17,38,7,3105
"17165956100",1895,383,179,83,146,23,0,0,2709
"17165956200",3180,187,60,0,3,2,109,0,3541
"17167000100",2950,234,168,156,112,137,23,11,3791
"17167000201",1810,130,330,1,36,0,90,19,2416
"17167000202",2002,754,447,239,57,27,36,17,3579
"17167000300",1566,378,233,87,82,57,33,59,2495
"17167000400",1997,254,376,408,75,35,21,0,3166
"17167000501",1934,163,230,22,46,0,22,0,2417
"17167000503",2740,460,146,44,31,0,24,31,3476
"17167000504",2400,295,149,0,222,11,29,0,3106
"17167000600",3410,1325,277,91,223,115,179,0,5620
"17167000700",1407,347,270,75,38,18,0,0,2155
"17167000800",514,227,779,671,26,61,24,0,2302
"17167000900",547,397,263,592,58,0,10,7,1874
"17167001001",1586,82,395,73,59,0,41,0,2236
"17167001003",1313,57,0,0,11,0,5,0,1386
"17167001004",3544,189,538,29,508,67,212,25,5112
"17167001100",1875,236,38,14,6,66,0,59,2294
"17167001200",2511,569,382,119,219,54,83,15,3952
"17167001300",994,380,309,103,259,11,0,23,2079
"17167001400",466,186,54,37,4,0,8,0,755
"17167001500",65,131,336,349,0,8,0,11,900
"17167001600",561,319,1224,1556,19,8,0,0,3687
"17167001700",162,180,486,360,35,110,7,13,1353
"17167001800",1250,489,188,259,5,5,19,101,2316
"17167001900",1863,511,213,192,56,35,131,15,3016
"17167002000",5171,247,139,95,263,14,47,58,6034
"17167002100",2867,106,296,119,85,8,55,2,3538
"17167002200",2667,352,53,52,138,0,87,29,3378
"17167002300",714,152,667,332,81,241,51,31,2269
"17167002400",733,345,1639,616,170,5,17,0,3525
"17167002500",2732,280,1267,473,38,86,47,18,4941
"17167002600",1540,520,162,146,131,136,4,0,2639
"17167002700",2714,667,120,28,137,63,20,29,3778
"17167002801",2055,292,194,137,62,92,10,18,2860
"17167002802",1566,726,442,399,100,161,151,152,3697
"17167002900",3836,198,488,51,234,17,36,19,4879
"17167003000",3422,550,545,363,107,50,15,28,5080
"17167003100",6128,300,152,0,151,19,163,0,6913
"17167003201",4020,197,97,30,294,155,138,8,4939
"17167003202",3773,209,25,9,114,0,127,28,4285
"17167003203",5189,105,9,18,66,0,183,0,5570
"17167003300",4663,348,17,0,120,11,46,0,5205
"17167003400",5534,488,0,0,44,0,14,13,6093
"17167003500",4661,354,3,3,75,17,71,0,5184
"17167003601",2701,114,10,0,64,0,6,0,2895
"17167003602",4118,119,59,35,239,0,36,0,4606
"17167003603",4403,275,26,57,428,5,32,5,5231
"17167003604",3931,107,595,0,333,0,130,0,5096
"17167003700",7958,81,19,0,285,0,62,0,8405
"17167003801",2197,371,0,10,94,22,26,0,2720
"17167003802",4829,893,8,0,56,42,71,71,5970
"17167003901",4839,7,0,0,97,18,0,0,4961
"17167003902",3643,66,12,12,62,51,129,0,3975
"17167004000",3616,372,26,10,77,15,6,4,4126
"17169970100",1537,455,0,74,0,0,21,10,2097
"17169970200",2669,449,0,0,83,0,12,0,3213
"17169970300",1752,175,0,0,61,0,66,2,2056
"17171970600",1683,168,0,0,0,0,7,0,1858
"17171970700",2854,458,0,0,17,13,0,0,3342
"17173959100",3135,445,24,0,31,0,5,5,3645
"17173959200",2499,258,0,0,5,0,4,0,2766
"17173959300",4836,552,0,4,38,35,90,0,5555
"17173959400",2876,409,43,0,17,21,23,0,3389
"17173959500",2915,491,0,0,41,0,3,11,3461
"17173959600",2886,368,3,0,16,0,20,27,3320
"17175951400",2689,386,6,7,39,16,12,15,3170
"17175951500",2368,224,0,0,42,10,21,9,2674
"17177000100",3993,486,30,6,21,12,124,38,4710
"17177000200",3062,254,0,0,46,2,18,20,3402
"17177000300",3295,419,0,0,40,31,9,0,3794
"17177000400",2615,311,0,0,58,0,62,13,3059
"17177000500",2762,151,56,0,92,0,18,3,3082
"17177000600",2892,365,36,0,56,48,0,18,3415
"17177000700",657,271,413,345,10,171,0,0,1867
"17177000800",1485,670,387,479,57,145,33,10,3266
"17177000900",3684,654,438,83,102,111,149,86,5307
"17177001000",3922,160,116,91,205,0,48,26,4568
"17177001100",2447,350,120,107,39,27,46,40,3176
"17177001200",2224,315,387,121,256,90,123,55,3571
"17177001300",2317,707,505,347,180,44,388,96,4584
"17179020100",2117,436,43,0,69,51,103,21,2840
"17179020301",3812,570,0,0,204,0,0,0,4586
"17179020302",4423,644,94,0,195,13,114,90,5573
"17179020400",4607,708,37,0,54,7,13,0,5426
"17179020500",4396,313,5,4,60,53,61,0,4892
"17179020600",1434,248,0,0,25,0,6,0,1713
"17179020700",4147,317,0,3,34,0,37,13,4551
"17179020800",2770,516,0,13,30,9,42,53,3433
"17179020900",1585,507,13,8,80,0,80,20,2293
"17179021000",4930,696,30,3,0,17,54,0,5730
"17179021101",5166,1255,0,3,133,25,69,43,6694
"17179021102",5333,712,9,2,80,0,95,0,6231
"17179021201",3899,268,0,0,128,36,69,0,4400
"17179021202",3089,84,46,4,79,13,30,28,3373
"17179021203",3770,695,12,3,141,48,75,88,4832
"17179021500",6254,422,0,8,126,0,193,79,7082
"17179021603",4904,48,50,0,120,0,20,0,5142
"17179021604",1689,141,0,0,127,0,11,0,1968
"17179021605",2461,218,57,0,0,0,77,0,2813
"17179021606",4912,179,117,0,178,0,97,0,5483
"17179021701",5617,193,14,0,199,0,269,0,6292
"17179021702",5359,199,0,21,160,0,42,0,5781
"17179021801",3481,594,3,0,114,0,7,3,4202
"17179021802",2197,45,0,0,12,0,0,0,2254
"17179021900",4155,312,37,3,44,21,52,5,4629
"17179022000",3888,295,6,1,37,5,18,6,4256
"17179022100",3079,378,0,2,62,0,61,0,3582
"17179022200",4548,203,12,0,106,16,20,0,4905
"17179022300",4762,76,0,0,237,78,203,58,5414
"17179022400",4507,208,20,0,78,200,26,0,5039
"17181950100",3264,658,119,67,155,56,425,84,4828
"17181950200",1954,515,6,31,57,9,54,65,2691
"17181950300",1508,582,0,11,25,11,48,0,2185
"17181950400",3670,915,36,36,32,2,0,25,4716
"17181950500",3159,468,1,12,3,8,128,10,3789
"17183000100",900,212,152,199,165,27,27,27,1709
"17183000200",618,226,497,503,33,0,147,0,2024
"17183000300",1297,305,549,327,120,12,334,70,3014
"17183000400",816,190,647,1606,116,52,143,25,3595
"17183000500",1954,313,542,512,231,112,329,46,4039
"17183000600",671,339,757,779,14,62,71,0,2693
"17183000700",2772,110,376,16,246,12,12,0,3544
"17183000800",1809,117,173,15,88,17,71,27,2317
"17183000900",1733,439,70,214,27,58,21,100,2662
"17183001200",2251,311,278,7,68,96,0,0,3011
"17183001300",2726,277,50,96,299,0,158,0,3606
"17183010100",2733,430,0,0,23,0,5,0,3191
"17183010200",4352,974,0,2,156,22,558,205,6269
"17183010300",4465,489,10,0,108,20,38,2,5132
"17183010400",2182,78,0,1,74,0,109,0,2444
"17183010500",2947,756,13,0,43,33,0,33,3825
"17183010600",3663,379,9,0,63,0,45,1,4160
"17183010701",2089,621,0,0,192,52,150,105,3209
"17183010702",2859,150,5,92,0,12,16,0,3134
"17183010800",3086,336,16,0,40,10,118,13,3619
"17183010900",2823,164,0,0,14,0,1,0,3002
"17183011000",3218,895,47,0,8,14,9,40,4231
"17183011100",2516,209,0,2,16,0,3,2,2748
"17183011200",2039,1177,446,944,211,71,49,174,5111
"17185957200",3373,291,0,0,81,7,86,1,3839
"17185957300",2723,435,0,1,29,0,8,0,3196
"17185957400",1771,127,0,0,74,55,11,13,2051
"17185957500",2118,558,1,1,68,21,4,34,2805
"17187870100",1795,206,9,1,0,6,26,0,2043
"17187870200",2228,222,3,0,17,32,13,0,2515
"17187870300",2806,88,0,0,0,0,19,0,2913
"17187870400",3013,668,32,12,203,22,325,89,4364
"17187870500",3309,795,199,201,283,361,649,307,6104
"17189950100",3004,329,9,29,61,11,38,0,3481
"17189950200",3356,192,23,0,20,2,63,0,3656
"17189950300",2580,508,0,0,56,0,18,0,3162
"17189950400",3697,368,6,0,65,23,48,14,4221
"17191954900",2707,274,0,0,37,12,34,17,3081
"17191955000",3683,479,0,0,35,0,22,0,4219
"17191955100",2219,580,0,11,2,11,0,19,2842
"17191955200",2556,599,15,38,116,0,17,18,3359
"17191955300",2669,425,5,0,18,3,47,12,3179
"17193958000",1661,594,0,0,43,18,0,0,2316
"17193958100",2630,563,0,0,0,0,31,0,3224
"17193958200",2531,320,0,0,60,0,16,3,2930
"17193958300",2313,243,22,10,10,0,17,10,2625
"17193958400",2786,478,0,0,0,4,61,0,3329
"17195000100",3586,131,61,0,111,12,176,12,4089
"17195000200",2688,101,24,15,69,0,112,1,3010
"17195000300",2670,387,0,14,123,16,168,17,3395
"17195000400",2685,177,43,0,83,14,61,0,3063
"17195000500",3090,373,13,29,91,0,34,0,3630
"17195000600",3533,222,56,67,94,112,97,10,4191
"17195000700",2398,199,0,4,68,12,118,38,2837
"17195000800",1867,182,0,0,30,0,24,0,2103
"17195000900",2837,247,7,0,380,37,614,127,4249
"17195001000",1961,354,56,20,479,187,771,304,4132
"17195001100",3945,634,60,67,195,91,1059,248,6299
"17195001200",2889,433,27,12,235,41,596,126,4359
"17195001300",1942,400,21,49,100,9,223,0,2744
"17195001400",2084,108,0,0,6,37,48,10,2293
"17195001500",2461,470,53,0,140,33,311,22,3490
"17195001600",2172,307,0,0,265,0,450,40,3234
"17195001700",2205,995,12,4,145,129,370,155,4015
"17195001800",2055,112,8,0,36,0,103,65,2379
"17197880105",4291,138,1825,0,1920,23,1956,16,10169
"17197880106",2535,80,859,230,776,124,1399,145,6148
"17197880107",2898,86,1009,54,1127,332,1998,293,7797
"17197880109",3148,132,1398,168,511,180,434,232,6203
"17197880111",2405,37,425,81,496,0,1530,0,4974
"17197880112",1332,96,239,3,388,122,510,198,2888
"17197880113",1219,296,689,136,1144,249,1230,456,5419
"17197880114",822,153,500,0,760,492,962,601,4290
"17197880115",1120,56,662,146,875,171,940,186,4156
"17197880116",1754,0,608,106,281,139,449,110,3447
"17197880117",1624,408,948,407,318,264,903,512,5384
"17197880118",4022,11,163,0,813,54,9,0,5072
"17197880119",3429,65,88,69,858,25,463,0,4997
"17197880120",4865,89,1436,87,2560,45,1166,15,10263
"17197880121",4801,294,1917,0,2103,11,1699,11,10836
"17197880202",2934,357,239,22,516,122,763,152,5105
"17197880203",2546,66,57,0,1310,74,1570,75,5698
"17197880204",3794,376,854,22,789,56,865,216,6972
"17197880303",3471,81,64,0,437,12,205,43,4313
"17197880304",4557,53,88,0,814,33,326,0,5871
"17197880305",4582,48,0,6,779,7,509,0,5931
"17197880306",4147,311,620,0,1846,191,512,0,7627
"17197880307",3169,274,642,165,1118,257,398,90,6113
"17197880308",5910,0,1078,57,1052,305,36,68,8506
"17197880309",4146,27,12,64,1041,0,253,0,5543
"17197880310",8742,176,637,0,2043,169,1183,107,13057
"17197880312",6870,55,389,0,2494,48,454,0,10310
"17197880313",7716,319,337,337,2671,60,1257,143,12840
"17197880314",6057,63,335,0,722,0,573,0,7750
"17197880404",8315,496,1083,7,487,519,787,154,11848
"17197880408",3806,156,449,53,921,201,1641,101,7328
"17197880410",4489,728,1326,38,1840,101,2389,693,11604
"17197880411",2862,18,28,0,273,0,343,0,3524
"17197880412",3929,34,216,0,393,9,798,9,5388
"17197880414",3712,228,31,0,402,20,596,120,5109
"17197880415",5815,223,474,30,1014,60,1532,155,9303
"17197880416",2312,12,99,0,493,9,457,9,3391
"17197880417",2288,62,6,0,305,0,434,0,3095
"17197880418",4633,9,110,0,285,0,1133,0,6170
"17197880419",6330,253,565,0,1431,0,1579,30,10188
"17197880420",7662,348,633,18,1260,253,2362,235,12771
"17197880421",4739,602,139,41,572,37,497,114,6741
"17197880502",4529,365,0,0,187,145,284,0,5510
"17197880503",3063,115,258,0,594,0,683,41,4754
"17197880505",5851,428,345,0,951,395,2495,555,11020
"17197880507",3298,181,739,66,2128,888,2263,72,9635
"17197880601",3245,10,15,0,15,0,99,0,3384
"17197880602",2662,397,11,1,78,14,169,14,3346
"17197880701",3801,323,47,214,194,20,570,66,5235
"17197880702",1185,156,783,275,449,111,714,152,3825
"17197880901",5273,678,259,0,224,0,705,514,7653
"17197880903",1771,260,284,67,149,177,286,215,3209
"17197880905",1971,88,93,12,248,1,331,26,2770
"17197881001",4538,138,65,0,257,0,421,15,5434
"17197881002",4687,140,34,0,139,107,183,123,5413
"17197881005",3184,7,0,12,132,14,73,0,3422
"17197881006",2546,46,0,0,105,0,272,0,2969
"17197881007",5076,54,540,4,287,0,644,0,6605
"17197881009",6833,10,126,0,172,87,587,0,7815
"17197881010",3362,65,0,0,65,1,300,0,3793
"17197881011",2986,154,0,0,124,0,147,0,3411
"17197881012",2921,4,64,0,64,0,39,0,3092
"17197881105",5396,175,54,0,323,0,352,0,6300
"17197881107",2534,183,46,2,253,0,293,0,3311
"17197881108",5872,234,28,4,206,0,602,0,6946
"17197881109",4337,263,8,0,68,0,207,5,4888
"17197881111",2730,61,0,0,428,1,218,0,3438
"17197881112",4840,69,1,0,214,0,443,0,5567
"17197881113",3400,217,26,1,57,0,118,0,3819
"17197881115",3824,115,16,0,273,0,456,0,4684
"17197881116",3681,147,10,0,297,0,246,0,4381
"17197881200",904,495,2384,1042,332,155,711,534,6557
"17197881301",1134,433,160,86,681,413,1716,751,5374
"17197881302",777,295,170,0,608,168,1179,456,3653
"17197881401",2003,115,93,297,532,94,867,89,4090
"17197881402",2489,93,139,0,199,12,637,30,3599
"17197881500",2698,332,83,27,208,19,693,184,4244
"17197881601",1397,100,93,39,82,0,168,0,1879
"17197881603",1443,65,712,317,429,0,659,0,3625
"17197881604",1468,192,937,55,48,92,321,24,3137
"17197881700",2823,219,46,0,142,11,203,66,3510
"17197881800",2141,235,280,90,1080,156,1847,254,6083
"17197881900",1084,462,507,1017,551,187,1062,383,5253
"17197882000",677,347,493,469,512,193,892,511,4094
"17197882100",1071,605,155,55,611,433,1552,892,5374
"17197882200",2217,549,414,107,887,288,2064,334,6860
"17197882300",2570,702,287,72,538,105,1152,308,5734
"17197882400",677,370,1284,323,604,270,1095,527,5150
"17197882500",367,76,788,780,9,159,355,113,2647
"17197882601",2242,180,62,50,383,12,959,0,3888
"17197882602",1371,694,183,191,285,685,810,590,4809
"17197882701",2102,52,117,0,255,0,831,12,3369
"17197882702",1611,349,455,5,236,70,546,234,3506
"17197882801",1700,162,62,73,342,71,420,82,2912
"17197882802",1206,145,920,248,301,44,271,14,3149
"17197882900",1782,239,44,17,222,31,684,64,3083
"17197883000",985,233,1498,129,476,23,663,111,4118
"17197883100",1472,314,1705,354,359,44,632,157,5037
"17197883206",3107,276,498,20,466,10,510,93,4980
"17197883208",2067,327,149,19,353,185,378,249,3727
"17197883209",2393,16,337,11,273,0,421,0,3451
"17197883210",1821,90,315,0,192,0,96,0,2514
"17197883211",4743,49,978,0,511,0,1023,0,7304
"17197883212",4857,244,596,0,250,65,555,39,6606
"17197883213",4436,290,111,0,267,0,186,39,5329
"17197883214",2047,278,55,0,423,0,377,149,3329
"17197883215",6998,157,1059,13,1631,56,2222,10,12146
"17197883216",2426,20,176,0,256,22,218,35,3153
"17197883303",3687,22,7,0,116,19,79,19,3949
"17197883304",1604,174,0,0,0,0,39,55,1872
"17197883305",2745,16,23,0,35,0,56,0,2875
"17197883306",3359,97,37,0,181,0,220,0,3894
"17197883307",3525,341,19,27,189,0,309,0,4410
"17197883401",3215,402,63,0,69,9,263,38,4059
"17197883402",1861,198,13,1,82,39,197,72,2463
"17197883504",4532,50,229,24,0,0,42,0,4877
"17197883505",6631,464,723,129,625,12,451,0,9035
"17197883507",3454,281,222,0,39,0,31,0,4027
"17197883509",3430,219,0,13,103,0,182,0,3947
"17197883510",5180,121,0,0,138,29,274,29,5771
"17197883511",4078,227,47,0,323,0,319,3,4997
"17197883513",4596,409,8,0,229,20,164,0,5426
"17197883514",5952,164,395,0,723,0,573,21,7828
"17197883515",3669,90,0,0,56,0,172,0,3987
"17197883516",6159,311,225,0,180,0,194,0,7069
"17197883517",3063,41,1,0,77,30,171,0,3383
"17197883519",5083,238,0,0,127,0,429,0,5877
"17197883521",3313,63,129,18,335,73,244,9,4184
"17197883522",3120,64,0,0,111,0,24,0,3319
"17197883602",4236,243,568,0,363,0,534,0,5944
"17197883603",1076,97,1690,253,31,106,69,118,3440
"17197883605",99,55,2125,924,37,59,0,17,3316
"17197883606",668,35,2359,220,286,43,195,26,3832
"17197883700",1969,300,149,88,395,10,573,17,3501
"17197883803",509,23,1407,549,149,90,82,0,2809
"17197883804",1479,204,373,0,220,328,272,301,3177
"17197883806",2378,168,763,49,229,0,344,0,3931
"17197883808",1766,133,147,0,28,27,140,0,2241
"17197883809",2065,220,531,32,7,12,86,32,2985
"17197883810",2318,58,1070,68,165,0,44,0,3723
"17197883811",2460,87,240,115,201,77,219,13,3412
"17197883902",5170,445,281,0,229,8,329,0,6462
"17197883903",1909,61,0,0,0,7,5,7,1989
"17197883904",4249,171,0,0,15,0,36,0,4471
"17197884003",3779,405,0,2,58,0,93,0,4337
"17197884004",2129,478,12,0,46,21,138,27,2851
"17197884005",1240,87,0,0,22,19,14,0,1382
"17197884006",1807,298,0,0,45,8,68,0,2226
"17197884101",2144,41,318,39,202,99,351,0,3194
"17197884103",1801,193,268,124,774,28,1020,134,4342
"17197980000",0,0,0,0,0,0,0,0,0
"17197980100",123,0,0,0,47,0,37,0,207
"17199020100",2688,542,171,126,20,46,65,0,3658
"17199020201",4364,837,84,21,69,97,32,10,5514
"17199020202",2028,327,10,102,147,17,55,24,2710
"17199020300",3690,472,109,0,42,4,21,0,4338
"17199020400",2892,765,10,55,26,21,5,65,3839
"17199020500",2693,469,0,0,0,18,48,34,3262
"17199020600",3398,496,21,0,106,21,58,0,4100
"17199020700",3976,880,23,2,153,138,19,95,5286
"17199020800",5630,946,0,0,81,13,32,9,6711
"17199020900",3802,215,440,4,122,11,33,10,4637
"17199021000",3143,741,211,142,105,118,125,3,4588
"17199021100",2244,405,28,249,155,120,80,44,3325
"17199021200",3706,771,53,160,187,11,35,0,4923
"17199021300",4297,353,43,8,32,0,140,0,4873
"17199021400",3466,283,3,0,0,35,172,0,3959
"17201000101",3678,892,96,76,137,54,128,160,5221
"17201000103",2219,357,10,15,68,92,67,121,2949
"17201000104",2383,477,61,0,45,53,143,136,3298
"17201000105",3754,172,81,29,89,13,120,25,4283
"17201000200",2543,679,12,11,52,55,45,24,3421
"17201000300",3205,551,174,32,61,82,199,45,4349
"17201000401",1579,71,88,0,285,20,151,4,2198
"17201000402",2385,66,199,7,138,0,197,1,2993
"17201000403",2762,522,376,230,213,18,82,193,4396
"17201000501",4035,91,587,343,259,0,603,44,5962
"17201000502",2545,348,416,127,260,34,334,46,4110
"17201000504",5339,292,130,124,393,28,428,0,6734
"17201000506",3482,99,170,64,303,0,187,16,4321
"17201000507",2122,494,210,166,327,191,166,400,4076
"17201000510",2626,147,83,1,314,0,61,66,3298
"17201000511",1715,85,360,12,509,12,317,18,3028
"17201000512",3740,318,506,25,347,15,357,15,5323
"17201000513",2935,382,154,0,207,0,55,225,3958
"17201000514",3096,223,46,0,245,7,109,82,3808
"17201000600",3520,363,145,21,79,0,389,39,4556
"17201000700",2493,225,112,55,242,65,160,19,3371
"17201000800",1405,571,111,310,46,109,253,190,2995
"17201001000",612,460,54,429,122,586,205,374,2842
"17201001100",351,397,147,172,44,10,36,40,1197
"17201001200",860,614,152,205,340,184,434,407,3196
"17201001300",771,356,266,467,264,204,139,230,2697
"17201001400",2193,860,71,257,351,9,392,244,4377
"17201001500",3484,614,134,0,492,249,724,640,6337
"17201001600",3014,816,653,547,170,34,426,262,5922
"17201001700",2524,217,64,129,194,158,757,195,4238
"17201001800",2103,1090,434,417,623,523,624,741,6555
"17201001900",2187,648,364,19,147,10,463,51,3889
"17201002000",1377,787,25,133,135,211,289,617,3574
"17201002100",529,526,87,798,100,173,106,211,2530
"17201002200",1042,408,744,510,528,108,591,389,4320
"17201002301",857,439,719,233,101,190,234,142,2915
"17201002302",778,208,36,13,130,129,197,114,1605
"17201002400",106,211,1064,550,161,25,151,77,2345
"17201002500",300,563,1146,1738,79,148,33,492,4499
"17201002600",322,380,718,1141,58,150,138,257,3164
"17201002700",1164,703,536,258,543,259,1371,874,5708
"17201002800",414,278,228,214,309,225,612,476,2756
"17201002900",500,298,156,95,5,68,0,88,1210
"17201003000",1417,67,22,90,94,0,90,0,1780
"17201003100",1378,628,737,876,258,222,379,504,4982
"17201003200",553,489,1350,903,146,240,218,317,4216
"17201003300",1670,659,731,509,274,361,647,435,5286
"17201003400",3271,533,481,229,319,17,743,19,5612
"17201003500",1990,89,416,0,115,0,157,0,2767
"17201003601",1181,373,30,47,0,0,34,14,1679
"17201003602",2159,575,575,622,210,0,358,175,4674
"17201003604",1837,307,551,153,55,0,379,39,3321
"17201003605",819,201,293,101,39,29,27,6,1515
"17201003606",1652,288,254,442,234,0,587,86,3543
"17201003705",4331,265,68,27,273,0,302,20,5286
"17201003706",4406,490,326,0,1049,102,529,112,7014
"17201003707",2388,414,328,82,397,77,420,72,4178
"17201003708",1647,431,472,202,239,149,290,253,3683
"17201003709",1251,399,181,61,111,23,374,0,2400
"17201003710",2065,43,74,35,175,0,308,0,2700
"17201003711",3838,289,220,0,123,112,84,0,4666
"17201003801",5212,467,216,15,291,55,249,7,6512
"17201003805",6583,530,35,0,437,0,411,46,8042
"17201003806",4274,110,109,0,51,0,164,0,4708
"17201003807",5798,481,334,0,637,0,262,0,7512
"17201003808",3544,262,95,0,224,0,291,13,4429
"17201003809",4146,342,214,2,17,0,296,0,5017
"17201003901",4217,211,206,30,131,3,59,0,4857
"17201003903",5715,70,38,0,139,56,141,0,6159
"17201003904",4323,237,35,0,237,0,18,0,4850
"17201004001",7480,945,74,51,355,1,341,156,9403
"17201004002",5743,376,80,0,103,0,146,0,6448
"17201004003",1348,524,71,0,150,46,185,283,2607
"17201004100",4584,242,4,23,136,0,36,0,5025
"17201004200",5553,199,90,13,405,0,159,0,6419
"17201004300",4810,221,0,0,116,14,76,0,5237
"17201980000",0,0,0,0,0,0,0,0,0
"17203030100",2341,97,3,0,194,0,25,0,2660
"17203030200",2643,235,0,0,14,0,14,2,2908
"17203030300",2557,126,0,0,32,31,48,18,2812
"17203030400",5160,500,0,2,39,0,29,0,5730
"17203030501",6678,343,132,0,259,23,184,6,7625
"17203030502",2215,304,0,0,71,3,23,0,2616
"17203030601",4723,840,0,50,49,19,41,33,5755
"17203030602",3350,128,33,0,26,0,33,2,3572
"17203030700",3903,586,0,21,21,8,66,34,4639
"18001030100",3881,416,59,44,184,0,127,25,4736
"18001030200",3971,709,0,20,106,43,320,162,5331
"18001030300",4513,785,0,0,95,0,308,113,5814
"18001030400",2669,530,0,0,0,0,88,0,3287
"18001030500",4389,1572,0,0,29,0,10,0,6000
"18001030600",2712,496,0,27,108,24,171,37,3575
"18001030700",5021,1429,0,27,18,8,19,8,6530
"18003000100",1828,355,28,0,162,95,41,85,2594
"18003000300",2372,447,102,9,177,137,157,51,3452
"18003000400",1924,471,238,26,29,6,86,14,2794
"18003000500",1338,446,64,195,194,301,409,140,3087
"18003000600",1139,585,88,103,107,100,142,90,2354
"18003000701",2154,835,49,33,40,189,65,91,3456
"18003000704",1640,181,171,105,326,48,127,24,2622
"18003000800",2987,420,63,21,229,109,128,25,3982
"18003000900",1948,473,130,26,172,53,264,43,3109
"18003001000",802,371,0,6,12,26,23,9,1249
"18003001100",1200,298,123,76,69,26,44,0,1836
"18003001200",380,375,25,79,30,77,0,86,1052
"18003001300",332,58,137,311,109,26,14,0,987
"18003001600",611,444,186,412,106,401,123,173,2456
"18003001700",379,150,504,594,41,114,229,197,2208
"18003002000",964,656,367,232,189,161,183,263,3015
"18003002100",970,831,18,172,163,328,341,410,3233
"18003002200",2535,529,414,356,155,262,641,262,5154
"18003002300",776,763,1594,710,222,459,147,486,5157
"18003002500",2272,164,81,72,342,132,376,130,3569
"18003002600",1402,683,289,591,233,251,296,92,3837
"18003002800",394,71,764,1023,40,135,374,139,2940
"18003002900",151,483,815,438,140,256,119,264,2666
"18003003000",565,362,1295,1392,310,185,770,276,5155
"18003003100",882,553,632,397,122,242,299,321,3448
"18003003200",4376,297,396,268,563,0,634,66,6600
"18003003301",2028,453,105,25,213,74,99,0,2997
"18003003304",2604,395,231,390,365,137,192,51,4365
"18003003400",3319,506,359,158,105,40,67,74,4628
"18003003500",1906,445,328,430,332,236,118,18,3813
"18003003600",2050,350,1499,730,390,257,538,71,5885
"18003003700",1614,259,98,257,124,6,113,74,2545
"18003003800",1762,565,255,299,120,36,81,30,3148
"18003003901",2809,335,153,36,142,70,168,28,3741
"18003003902",1596,200,475,88,299,73,264,117,3112
"18003004000",594,89,1496,634,136,61,88,57,3155
"18003004101",1358,76,214,282,137,18,32,0,2117
"18003004103",3334,521,141,101,580,88,168,12,4945
"18003004300",446,262,800,310,285,205,252,184,2744
"18003004400",526,304,776,975,329,376,618,447,4351
"18003010100",4323,472,18,0,23,0,78,0,4914
"18003010201",6609,82,44,0,207,21,107,16,7086
"18003010202",5233,406,51,0,104,0,30,0,5824
"18003010304",5829,354,113,35,174,0,71,0,6576
"18003010305",5292,124,308,0,599,1,259,1,6584
"18003010306",4743,194,0,0,178,0,125,0,5240
"18003010307",4786,236,109,0,611,0,145,0,5887
"18003010308",4822,158,78,0,450,14,394,13,5929
"18003010400",3557,88,7,0,41,0,69,0,3762
"18003010500",2271,144,0,0,112,19,20,0,2566
"18003010601",2837,84,121,7,252,0,114,27,3442
"18003010602",2768,661,34,2,98,17,75,0,3655
"18003010603",1395,64,0,0,176,4,57,0,1696
"18003010604",1432,1157,0,0,141,30,201,548,3509
"18003010705",3676,486,211,48,244,0,236,77,4978
"18003010706",3648,359,235,85,455,23,388,23,5216
"18003010707",3942,317,339,28,293,0,62,32,5013
"18003010803",4111,249,263,9,351,46,199,10,5238
"18003010804",3398,166,188,77,265,88,53,19,4254
"18003010807",3570,272,294,21,150,70,175,74,4626
"18003010808",4731,98,183,0,231,90,198,0,5531
"18003010809",4234,262,387,61,377,34,67,0,5422
"18003010811",4408,250,376,87,111,2,366,2,5602
"18003010812",3842,125,348,0,45,0,12,34,4406
"18003010813",3514,391,193,27,260,86,150,138,4759
"18003010815",3651,162,27,0,421,28,23,10,4322
"18003010816",4325,193,312,0,150,0,0,0,4980
"18003010817",3419,246,264,0,72,6,205,0,4212
"18003010819",3186,299,285,69,206,17,28,0,4090
"18003010821",2842,170,849,346,381,3,150,0,4741
"18003010900",5998,418,0,1,76,0,45,0,6538
"18003011000",2296,156,0,0,94,0,113,0,2659
"18003011100",2256,406,69,1,18,2,87,1,2840
"18003011201",1221,759,87,0,65,0,69,199,2400
"18003011202",2445,205,24,0,123,167,28,167,3159
"18003011204",2642,248,184,46,34,112,59,53,3378
"18003011205",3060,255,19,0,65,0,92,0,3491
"18003011302",1169,144,1956,758,449,1003,234,30,5743
"18003011303",595,231,468,206,577,227,271,132,2707
"18003011304",2105,164,1351,582,670,93,553,19,5537
"18003011501",2824,519,113,132,134,38,377,149,4286
"18003011502",2306,315,7,0,146,14,76,28,2892
"18003011603",5766,208,52,0,197,0,0,0,6223
"18003011604",3606,238,0,10,184,18,179,55,4290
"18003011605",2497,117,81,0,136,0,59,0,2890
"18003011606",3698,272,220,1,355,53,182,0,4781
"18003011607",4434,60,169,21,423,0,358,0,5465
"18003011608",5508,53,164,179,571,0,424,0,6899
"18003011609",5594,11,96,0,897,49,30,0,6677
"18003011701",2746,509,50,0,78,0,0,0,3383
"18003011702",2998,125,83,65,83,0,319,0,3673
"18003011801",3550,292,17,1,59,5,95,38,4057
"18003011802",1666,71,0,0,18,0,82,0,1837
"18003011900",1648,180,0,0,24,0,11,0,1863
"18003980001",44,65,3,0,0,0,0,0,112
"18003980002",26,20,0,0,0,22,0,0,68
"18005010100",2667,838,295,11,528,33,514,42,4928
"18005010200",3523,318,76,22,338,0,220,0,4497
"18005010300",2835,92,103,0,307,0,95,2,3434
"18005010400",4215,425,88,0,754,39,140,164,5825
"18005010500",4521,189,174,4,259,22,0,32,5201
"18005010600",4397,587,108,42,305,51,55,38,5583
"18005010700",2542,627,99,23,356,73,127,113,3960
"18005010800",1861,1033,29,11,726,0,115,188,3963
"18005010900",4411,117,101,0,719,0,231,0,5579
"18005011000",4389,220,57,0,68,0,82,0,4816
"18005011100",5558,1052,21,0,462,1195,541,1151,9980
"18005011200",4981,598,8,0,85,12,0,0,5684
"18005011300",4453,424,41,0,57,164,32,37,5208
"18005011400",3551,424,13,0,258,25,341,115,4727
"18005011500",6355,562,65,58,479,72,363,61,8015
"18007100100",3001,402,0,1,24,0,35,7,3470
"18007100200",2620,229,46,12,14,11,68,29,3029
"18007100300",1975,293,0,2,27,14,237,72,2620
"18009975100",2624,542,0,0,11,16,26,14,3233
"18009975200",2054,279,0,0,115,8,0,0,2456
"18009975300",2299,676,0,0,18,25,61,0,3079
"18009975400",3178,432,18,0,29,0,40,0,3697
"18011810100",3122,334,0,0,199,63,63,1,3782
"18011810200",3590,268,0,0,13,6,56,0,3933
"18011810300",5374,167,0,36,0,10,13,0,5600
"18011810400",4747,889,0,2,73,36,246,133,6126
"18011810500",4962,999,0,13,245,124,348,0,6691
"18011810601",4386,526,95,30,144,0,67,57,5305
"18011810603",11003,102,81,125,818,0,144,0,12273
"18011810604",4766,0,48,0,222,0,53,0,5089
"18011810605",4523,177,201,0,260,0,153,0,5314
"18011810700",4234,392,0,0,36,0,40,9,4711
"18013974600",2666,199,0,0,42,9,58,41,3015
"18013974700",2944,633,0,0,22,21,0,0,3620
"18013974800",3150,512,9,1,182,19,6,2,3881
"18013974900",3759,780,0,0,28,7,60,32,4666
"18015959300",2886,455,0,0,8,0,4,0,3353
"18015959400",2306,216,0,0,0,0,0,0,2522
"18015959500",1786,328,0,2,93,1,9,1,2220
"18015959600",2572,465,28,1,68,0,286,95,3515
"18015959700",2864,213,0,0,0,0,83,100,3260
"18015959800",2456,197,27,0,0,0,62,3,2745
"18015959900",2535,245,27,0,46,0,33,78,2964
"18017950900",4228,609,51,6,66,152,0,158,5270
"18017951000",2296,279,0,0,38,57,75,115,2860
"18017951100",2529,440,5,8,55,81,87,0,3205
"18017951200",1629,403,7,27,106,61,387,104,2724
"18017951300",1631,436,53,44,518,131,387,131,3331
"18017951400",1670,355,42,0,188,1,339,134,2729
"18017951500",2053,1011,123,12,815,252,970,447,5683
"18017951600",4080,715,38,5,472,297,846,400,6853
"18017951700",2444,246,0,2,63,1,17,0,2773
"18017951800",2695,367,42,45,338,0,342,11,3840
"18017951900",3286,191,0,0,16,17,16,1,3527
"18019050100",786,364,38,65,48,0,32,0,1333
"18019050200",1609,303,434,432,79,49,107,85,3098
"18019050303",1868,319,221,92,277,0,20,0,2797
"18019050304",2901,293,618,156,248,189,18,17,4440
"18019050305",2620,262,142,26,13,151,9,17,3240
"18019050306",1257,479,276,212,23,14,30,1,2292
"18019050401",2090,439,49,1,182,18,0,18,2797
"18019050403",2520,169,182,0,194,0,406,35,3506
"18019050404",2932,480,126,23,83,25,123,0,3792
"18019050501",1455,142,18,0,0,0,27,0,1642
"18019050503",3859,931,220,95,355,36,806,544,6846
"18019050504",1702,662,256,13,295,0,385,67,3380
"18019050603",5237,772,782,104,195,18,816,0,7924
"18019050604",4502,383,596,75,263,58,146,0,6023
"18019050605",4557,399,504,2,252,32,86,37,5869
"18019050606",3371,68,148,0,156,0,126,0,3869
"18019050701",4503,132,508,0,281,34,53,37,5548
"18019050703",5280,447,169,0,61,0,159,93,6209
"18019050704",5072,470,0,1,228,0,7,1,5779
"18019050801",5677,377,0,0,239,2,223,2,6520
"18019050803",4624,387,0,0,13,0,78,0,5102
"18019050804",3129,504,0,0,0,83,0,0,3716
"18019050902",3668,500,0,0,182,117,77,202,4746
"18019050903",2456,630,98,271,117,145,79,139,3935
"18019050904",5076,201,147,31,49,17,248,17,5786
"18019051000",4066,644,7,0,53,40,43,0,4853
"18021040100",4051,1297,30,13,52,40,35,77,5595
"18021040200",4729,1208,0,0,167,24,8,0,6136
"18021040300",2953,416,0,0,49,1,3,0,3422
"18021040400",3932,156,8,8,25,0,116,0,4245
"18021040500",3271,471,0,0,16,47,23,47,3875
"18021040600",2814,493,10,0,88,0,0,0,3405
"18023950100",2834,399,0,0,33,7,61,0,3334
"18023950200",4462,474,0,0,91,61,299,111,5498
"18023950300",4180,600,27,0,87,10,59,57,5020
"18023950400",3700,291,0,0,103,0,118,9,4221
"18023950500",3592,668,0,16,217,140,1062,437,6132
"18023950600",2963,448,104,7,148,14,632,103,4419
"18023950700",2651,409,101,0,451,37,609,54,4312
"18023950800",1860,781,8,0,206,127,573,296,3851
"18025951900",2991,616,0,11,39,8,53,23,3741
"18025952000",3127,979,0,0,34,27,59,6,4232
"18025952100",2237,355,2,0,25,67,0,0,2686
"18027954300",3241,476,0,0,27,8,35,0,3787
"18027954400",2654,173,12,0,0,22,15,15,2891
"18027954500",7565,1077,0,0,47,0,30,0,8719
"18027954600",3804,300,20,0,123,0,34,0,4281
"18027954700",2867,616,10,35,189,49,602,90,4458
"18027954800",2595,910,173,6,69,4,78,309,4144
"18027954900",3727,358,10,0,113,0,89,7,4304
"18029080101",2850,55,0,1,12,0,0,0,2918
"18029080103",5212,460,0,0,69,0,122,0,5863
"18029080104",3835,91,0,0,92,13,90,0,4121
"18029080201",2312,30,0,0,30,0,72,0,2444
"18029080202",6303,311,36,0,66,0,12,0,6728
"18029080300",3788,677,51,12,44,0,18,0,4590
"18029080400",4901,741,115,23,137,27,122,14,6080
"18029080500",3324,484,0,0,82,44,24,0,3958
"18029080600",6016,636,0,2,180,108,32,0,6974
"18029080700",5236,734,0,0,42,4,0,4,6020
"18031969000",4317,412,18,49,421,3,178,0,5398
"18031969100",2820,631,1,0,42,0,25,0,3519
"18031969200",3825,919,19,4,16,59,16,0,4858
"18031969300",2903,576,44,0,0,0,62,18,3603
"18031969400",4559,559,0,2,44,0,74,55,5293
"18031969500",2831,377,0,0,72,0,1,11,3292
"18033020100",3891,384,0,0,157,22,147,0,4601
"18033020200",3327,951,21,0,82,56,117,46,4600
"18033020300",3465,794,0,0,91,14,15,6,4385
"18033020400",6126,620,15,8,247,91,274,74,7455
"18033020500",4875,951,0,0,179,4,230,3,6242
"18033020601",2779,329,0,0,79,9,28,0,3224
"18033020602",3887,374,0,0,77,40,0,0,4378
"18033020700",3135,223,0,0,30,0,83,0,3471
"18033020800",4145,296,0,0,11,9,39,0,4500
"18035000300",217,232,603,215,73,39,0,0,1379
"18035000400",791,613,131,251,55,130,25,0,1996
"18035000500",2782,1088,0,12,86,225,26,61,4280
"18035000600",694,340,32,184,95,93,23,10,1471
"18035000700",986,2012,17,33,93,143,55,107,3446
"18035000800",2757,1159,88,100,97,74,93,67,4435
"18035000902",4,115,0,0,16,116,0,0,251
"18035000903",1289,1347,131,127,100,138,25,67,3224
"18035000904",4493,797,49,2,247,291,0,0,5879
"18035001000",1977,1894,45,52,93,112,42,48,4263
"18035001100",2196,701,41,41,160,134,9,47,3329
"18035001200",264,217,681,359,258,175,45,14,2013
"18035001300",1949,971,98,29,190,38,14,38,3327
"18035001400",1297,490,25,68,8,49,6,9,1952
"18035001500",1691,375,279,0,136,0,94,17,2592
"18035001600",1418,679,18,41,136,108,4,0,2404
"18035001700",871,398,0,50,4,19,0,14,1356
"18035002000",3333,910,187,194,375,138,232,64,5433
"18035002100",2038,348,84,155,198,21,0,6,2850
"18035002200",5333,515,2,0,95,19,182,0,6146
"18035002301",3294,269,0,0,114,13,24,0,3714
"18035002302",3680,209,17,0,52,7,38,0,4003
"18035002401",4221,546,16,31,181,81,0,0,5076
"18035002402",7684,567,110,0,359,31,196,27,8974
"18035002500",4647,637,0,0,14,3,100,3,5404
"18035002601",6345,428,159,0,199,7,80,0,7218
"18035002602",2475,286,0,0,52,13,23,17,2866
"18035002700",4539,274,0,0,85,12,38,0,4948
"18035002800",1014,790,145,111,14,185,31,15,2305
"18035002900",3820,527,171,8,77,203,0,18,4824
"18037953200",6235,331,1,1,72,0,183,54,6877
"18037953300",5603,604,25,35,175,87,217,44,6790
"18037953400",4490,353,0,0,409,0,401,17,5670
"18037953500",4838,288,0,0,0,0,186,0,5312
"18037953600",5381,183,59,0,0,0,102,0,5725
"18037953700",6526,318,0,0,0,0,38,0,6882
"18037953800",3899,848,0,28,108,344,817,451,6495
"18039000100",1951,593,46,123,458,194,625,112,4102
"18039000200",3454,1753,146,0,320,599,551,1602,8425
"18039000301",3320,384,21,0,400,0,909,82,5116
"18039000302",3918,963,0,67,115,0,627,336,6026
"18039000400",3751,620,32,4,435,45,278,438,5603
"18039000501",4718,601,324,35,810,359,1759,487,9093
"18039000502",3318,593,182,8,619,55,936,136,5847
"18039000600",8313,1198,0,0,213,0,362,411,10497
"18039000700",5759,547,75,4,487,52,526,6,7456
"18039000801",3116,159,0,0,273,0,402,29,3979
"18039000802",7373,1060,0,0,190,129,195,230,9177
"18039000900",7052,375,0,3,96,102,125,45,7798
"18039001000",3863,362,7,0,67,4,69,12,4384
"18039001100",4459,596,0,0,33,21,117,181,5407
"18039001200",4407,380,62,0,81,0,103,0,5033
"18039001300",6644,369,91,0,342,0,174,74,7694
"18039001400",7841,1058,292,0,220,0,517,192,10120
"18039001501",2745,1361,206,353,297,12,407,114,5495
"18039001502",5056,317,93,0,634,0,374,0,6474
"18039001601",3448,931,140,0,644,99,679,265,6206
"18039001602",3298,369,390,84,244,39,184,53,4661
"18039001701",2901,417,50,153,0,0,292,188,4001
"18039001702",3697,1029,0,40,303,0,390,223,5682
"18039001801",3231,255,60,0,159,171,141,141,4158
"18039001802",4828,287,500,0,450,117,326,46,6554
"18039001901",3673,1742,173,472,431,265,738,738,8232
"18039001902",3145,237,31,53,185,18,273,80,4022
"18039002000",5391,512,161,96,257,24,448,82,6971
"18039002101",2806,176,25,79,183,277,326,343,4215
"18039002102",2076,802,317,468,516,533,835,818,6365
"18039002200",3782,1002,1237,516,1509,333,2739,782,11900
"18039002300",1444,217,377,209,550,53,582,36,3468
"18039002400",2856,654,149,169,275,14,425,2,4544
"18039002600",1132,738,942,1701,574,254,1037,664,7042
"18039002700",854,493,150,351,136,37,257,229,2507
"18039002900",3606,543,38,73,240,59,229,66,4854
"18041954000",3384,419,0,0,10,10,0,0,3823
"18041954100",1790,777,46,25,0,0,86,0,2724
"18041954200",2723,659,15,14,9,0,9,87,3516
"18041954300",1885,428,13,0,17,18,12,20,2393
"18041954400",2616,1535,86,0,187,58,0,21,4503
"18041954500",2470,552,66,2,63,3,0,0,3156
"18041954600",2772,906,24,0,0,10,0,1,3713
"18043070200",992,608,16,82,32,33,66,52,1881
"18043070301",2538,390,45,0,86,43,210,8,3320
"18043070302",2750,154,74,159,286,13,43,13,3492
"18043070400",1510,509,97,75,126,27,63,0,2407
"18043070500",1700,652,55,181,183,132,191,68,3162
"18043070600",2073,201,12,0,9,11,0,0,2306
"18043070700",1183,316,300,175,28,58,48,0,2108
"18043070801",1409,1127,125,236,178,231,90,136,3532
"18043070802",2917,636,202,131,42,180,58,64,4230
"18043070901",5004,828,329,11,109,22,74,119,6496
"18043070902",1022,339,6,9,17,73,74,0,1540
"18043071003",6487,219,221,0,95,0,28,0,7050
"18043071004",3857,133,0,0,38,15,8,0,4051
"18043071005",4527,171,109,0,449,0,18,28,5302
"18043071006",2659,759,185,124,220,26,60,332,4365
"18043071007",3526,117,326,65,242,21,145,0,4442
"18043071101",5335,194,0,0,79,7,26,0,5641
"18043071103",3855,121,0,3,80,0,0,0,4059
"18043071104",4430,131,5,4,27,0,37,0,4634
"18043071200",1809,101,6,0,72,0,0,1,1989
"18045957600",2401,397,0,0,37,8,88,0,2931
"18045957700",1886,278,17,9,26,14,26,10,2266
"18045957800",3421,285,7,0,75,7,12,0,3807
"18045957900",3888,484,0,0,67,0,101,19,4559
"18045958000",2885,401,17,2,64,117,49,77,3612
"18047960100",4490,443,7,0,61,0,60,7,5068
"18047969600",4922,808,0,0,41,67,44,0,5882
"18047969700",2147,551,0,0,10,0,2,33,2743
"18047969800",5299,387,28,0,101,0,19,0,5834
"18047969900",2686,802,0,0,18,44,31,18,3599
"18049953000",2852,302,0,0,13,71,30,0,3268
"18049953100",4233,1139,0,0,74,0,187,103,5736
"18049953200",2691,837,114,29,47,43,87,27,3875
"18049953300",1600,309,56,0,52,5,11,5,2038
"18049953400",2324,217,0,2,12,0,21,0,2576
"18049953500",2933,210,0,0,306,0,441,9,3899
"18051050100",3434,278,24,31,146,0,60,0,3973
"18051050200",7541,606,60,7,41,0,0,0,8255
"18051050300",4335,862,38,0,75,55,41,56,5462
"18051050401",2837,277,66,14,10,35,0,0,3239
"18051050402",3825,305,44,0,94,7,35,0,4310
"18051050501",2331,687,0,7,84,0,43,0,3152
"18051050502",3345,392,167,121,377,52,231,0,4685
"18053000100",2581,551,259,193,194,45,51,61,3935
"18053000200",1465,711,1016,421,222,71,326,95,4327
"18053000400",2148,1258,196,205,151,179,113,40,4290
"18053000500",3898,398,75,17,358,80,30,0,4856
"18053000600",1799,662,101,39,78,140,187,156,3162
"18053000700",2201,671,389,234,29,53,106,113,3796
"18053000800",2682,584,651,285,52,0,204,0,4458
"18053000900",1439,602,120,69,138,60,135,64,2627
"18053010100",4785,392,12,9,236,16,162,116,5728
"18053010200",3671,318,2,11,78,2,45,13,4140
"18053010300",3475,554,8,0,79,44,34,0,4194
"18053010400",2441,539,0,0,40,9,19,9,3057
"18053010500",4215,1050,32,0,136,84,102,71,5690
"18053010600",2651,516,2,3,31,13,38,13,3267
"18053010700",3691,425,24,19,3,31,27,59,4279
"18053010800",4313,353,6,0,140,0,72,0,4884
"18055954701",4234,715,11,0,39,0,0,0,4999
"18055954702",3352,330,0,0,0,27,0,0,3709
"18055954800",2573,533,0,0,22,4,23,4,3159
"18055954900",4577,396,0,6,88,3,37,5,5112
"18055955000",2277,728,0,0,0,8,27,0,3040
"18055955100",2278,568,0,0,48,0,0,0,2894
"18055955200",1795,336,15,0,67,15,8,25,2261
"18055955300",3474,454,0,0,108,32,81,19,4168
"18055955400",3020,418,0,0,62,0,86,29,3615
"18057110100",8132,874,500,486,414,97,476,85,11064
"18057110201",3804,350,12,7,35,25,17,53,4303
"18057110202",5252,519,0,0,273,61,264,0,6369
"18057110300",11150,680,142,5,314,506,203,372,13372
"18057110401",2696,194,0,0,277,0,316,82,3565
"18057110403",7971,828,462,0,744,20,478,0,10503
"18057110404",4563,144,75,20,155,0,59,17,5033
"18057110505",6926,189,81,0,173,40,95,59,7563
"18057110506",7930,612,196,8,270,158,460,116,9750
"18057110507",10146,163,250,0,610,69,244,32,11514
"18057110508",7953,195,306,163,359,0,338,39,9353
"18057110509",4412,107,0,0,268,12,432,0,5231
"18057110511",4988,183,118,0,112,56,33,0,5490
"18057110512",4755,34,144,0,105,46,38,19,5141
"18057110600",3309,542,0,0,38,5,42,74,4010
"18057110700",2173,554,75,9,115,114,24,35,3099
"18057110804",11356,464,610,0,448,0,235,0,13113
"18057110805",6961,104,160,0,728,0,72,0,8025
"18057110806",10360,304,758,52,1164,0,310,122,13070
"18057110807",4484,209,792,0,345,0,128,0,5958
"18057110808",15309,622,716,15,2353,455,664,0,20134
"18057110809",8131,464,140,45,353,16,355,151,9655
"18057110810",5385,153,448,0,255,16,30,1,6288
"18057110811",3525,102,242,0,323,0,270,0,4462
"18057110812",5352,124,152,22,645,81,539,12,6927
"18057110903",8308,258,304,0,2779,52,584,52,12337
"18057110904",4179,115,121,0,182,0,56,9,4662
"18057110905",2530,236,21,0,442,18,70,0,3317
"18057110906",5704,151,148,0,283,0,161,0,6447
"18057110907",4752,67,40,0,209,0,168,0,5236
"18057110908",8327,83,470,0,2141,115,490,0,11626
"18057111001",9243,209,290,19,1481,0,241,37,11520
"18057111003",4331,25,87,0,267,22,49,0,4781
"18057111004",2506,161,106,0,159,0,111,0,3043
"18057111006",3380,162,76,24,183,0,84,0,3909
"18057111007",2374,553,122,0,386,228,40,213,3916
"18057111008",3815,140,406,97,639,42,71,0,5210
"18057111101",3491,109,19,0,403,0,116,0,4138
"18057111102",6513,233,340,11,855,0,42,0,7994
"18059410100",3729,449,0,14,21,0,50,0,4263
"18059410200",8974,1157,362,38,349,78,420,86,11464
"18059410300",10318,411,129,1,256,0,165,0,11280
"18059410400",5397,856,0,132,84,28,0,0,6497
"18059410500",2304,343,0,0,70,10,39,10,2776
"18059410600",4338,617,41,0,104,45,76,205,5426
"18059410700",5433,109,0,0,126,0,0,0,5668
"18059410800",8687,266,0,0,124,35,20,0,9132
"18059410900",7430,361,461,0,158,30,113,22,8575
"18059411000",5055,291,265,0,106,18,38,0,5773
"18061060100",5197,819,0,4,105,21,74,4,6224
"18061060200",6716,1031,83,0,60,0,2,0,7892
"18061060300",4312,445,0,3,174,73,111,23,5141
"18061060400",5513,1336,25,0,35,68,59,75,7111
"18061060500",5164,426,0,0,39,32,51,0,5712
"18061060600",5966,838,12,0,119,3,203,0,7141
"18063210102",14060,191,1575,74,1049,0,554,54,17557
"18063210103",3572,74,0,0,13,0,130,0,3789
"18063210104",7038,225,671,0,187,0,146,0,8267
"18063210201",3311,129,17,127,263,60,71,0,3978
"18063210202",7444,301,150,45,157,0,305,45,8447
"18063210300",5851,227,123,0,131,28,72,0,6432
"18063210400",4369,350,33,0,49,0,73,0,4874
"18063210501",6255,81,0,0,100,0,26,0,6462
"18063210502",4740,646,1,10,167,0,106,0,5670
"18063210603",7165,200,588,0,406,74,118,0,8551
"18063210604",12276,403,457,25,657,22,553,34,14427
"18063210605",9419,275,296,0,205,7,280,0,10482
"18063210606",7974,792,1297,207,1501,48,963,288,13070
"18063210607",3137,285,494,0,81,422,206,77,4702
"18063210608",2690,126,287,0,233,0,103,0,3439
"18063210700",7410,307,140,0,399,23,15,8,8302
"18063210801",3131,82,16,0,182,0,114,0,3525
"18063210802",3599,195,41,0,132,2,76,0,4045
"18063210900",3592,294,62,0,55,2,72,0,4077
"18063211000",5221,374,68,0,130,70,99,0,5962
"18063211100",3236,526,19,5,21,0,12,0,3819
"18065975500",2672,441,0,0,5,0,0,0,3118
"18065975600",3712,475,1,0,88,6,84,2,4368
"18065975700",4021,412,0,0,9,3,45,0,4490
"18065975800",3633,801,24,0,29,14,19,14,4534
"18065975900",3992,434,9,0,47,0,0,0,4482
"18065976000",1967,714,63,8,115,19,90,0,2976
"18065976100",1728,595,34,0,82,0,0,31,2470
"18065976300",1132,512,23,21,26,8,0,0,1722
"18065976400",3486,1134,20,6,69,0,54,0,4769
"18065976500",1538,703,8,5,0,0,9,122,2385
"18065976600",1762,342,7,0,26,25,23,0,2185
"18065976700",3748,672,16,0,38,0,5,0,4479
"18065976800",4019,467,3,3,19,0,10,0,4521
"18067000200",942,785,1145,489,75,38,131,100,3705
"18067000300",1870,601,153,26,102,114,80,40,2986
"18067000400",2290,613,144,131,99,221,22,26,3546
"18067000500",2673,723,51,53,40,7,198,0,3745
"18067000600",1865,296,271,145,81,47,56,7,2768
"18067000700",3940,439,161,67,123,48,20,41,4839
"18067000800",4835,430,334,17,32,31,38,38,5755
"18067000900",2786,1176,78,198,126,45,186,29,4624
"18067001000",1325,130,35,95,26,59,63,9,1742
"18067001100",2963,402,249,615,163,142,207,15,4756
"18067001200",1828,1137,92,79,163,105,37,56,3497
"18067001300",1555,264,66,141,315,25,65,19,2450
"18067001400",3550,339,432,0,55,89,195,2,4662
"18067001500",2469,374,42,151,232,0,4,25,3297
"18067010100",6051,315,8,0,139,18,213,7,6751
"18067010200",5390,1146,25,0,69,0,32,14,6676
"18067010300",3335,263,77,0,129,13,100,0,3917
"18067010400",3443,294,9,0,22,7,30,0,3805
"18067010500",4892,243,46,0,149,5,49,0,5384
"18067010600",3707,405,141,0,288,0,89,0,4630
"18069961300",4217,324,5,2,93,15,16,7,4679
"18069961400",3093,553,0,0,26,4,6,9,3691
"18069961500",3707,538,2,38,26,10,45,21,4387
"18069961600",2674,464,0,0,8,0,85,9,3240
"18069961700",4151,262,3,7,34,1,12,2,4472
"18069961800",2725,717,7,0,276,110,121,86,4042
"18069961900",3709,448,45,6,33,0,62,0,4303
"18069962000",3602,569,4,0,57,0,39,4,4275
"18069962100",2774,197,0,0,87,16,61,27,3162
"18071967500",6365,642,0,0,403,30,0,30,7470
"18071967600",2979,377,0,0,311,0,172,4,3843
"18071967700",3311,336,0,0,53,44,116,126,3986
"18071967800",1532,427,0,0,277,94,185,35,2550
"18071967901",2587,894,8,6,550,414,698,728,5885
"18071967902",2477,368,136,0,84,0,89,0,3154
"18071968000",4904,286,0,0,50,0,52,0,5292
"18071968100",3549,408,0,0,82,0,44,0,4083
"18071968200",3697,573,0,0,23,0,23,67,4383
"18071968300",2816,463,0,0,61,55,112,4,3511
"18073100400",1127,130,0,0,16,0,233,0,1506
"18073100800",3942,622,8,0,35,14,295,19,4935
"18073100901",2969,255,13,0,0,0,103,0,3340
"18073100902",5315,364,74,0,239,0,250,0,6242
"18073101000",6207,181,0,0,10,0,709,6,7113
"18073101100",3485,284,0,0,77,22,32,33,3933
"18073101200",3315,358,56,3,39,2,43,33,3849
"18073101300",2919,241,1,0,11,0,31,0,3203
"18075962700",3076,247,0,0,43,2,0,0,3368
"18075962800",2567,421,0,2,16,50,49,4,3109
"18075962900",2312,494,11,0,45,3,2,0,2867
"18075963000",1863,251,0,0,49,3,21,0,2187
"18075963100",3764,597,0,0,20,10,215,160,4766
"18075963200",2093,411,0,0,10,0,14,4,2532
"18075963300",1986,586,0,0,7,5,34,23,2641
"18077966000",3643,377,0,8,44,0,0,0,4072
"18077966100",4757,914,0,0,238,240,213,345,6707
"18077966200",3915,604,30,0,75,0,53,0,4677
"18077966300",1989,701,70,23,41,10,18,23,2875
"18077966400",4653,516,198,10,88,11,30,0,5506
"18077966500",4578,566,16,27,141,3,19,0,5350
"18077966600",1544,98,9,0,95,15,0,0,1761
"18079960200",4053,754,17,0,0,0,24,69,4917
"18079960301",3146,348,0,0,73,0,0,0,3567
"18079960302",3417,1110,32,0,85,0,260,62,4966
"18079960400",5655,1154,20,185,90,56,39,7,7206
"18079960500",2080,578,12,5,13,80,46,0,2814
"18079960600",4522,374,0,0,29,0,80,0,5005
"18081610100",10901,821,147,256,1505,259,383,375,14647
"18081610201",3649,446,0,0,80,123,65,140,4503
"18081610202",7364,1398,320,0,986,185,319,705,11277
"18081610300",2586,622,0,0,50,93,0,26,3377
"18081610401",4389,724,341,51,287,89,294,77,6252
"18081610403",3785,1158,61,0,199,88,72,175,5538
"18081610404",3747,670,99,0,24,0,37,10,4587
"18081610500",7785,452,0,0,141,82,117,0,8577
"18081610603",6299,135,1,0,104,23,11,30,6603
"18081610604",7719,407,0,0,407,18,310,0,8861
"18081610605",4606,203,76,0,103,0,76,0,5064
"18081610606",5449,177,0,0,12,51,59,0,5748
"18081610701",10936,292,59,0,321,21,216,0,11845
"18081610702",4519,584,0,0,55,92,0,0,5250
"18081610801",6226,190,52,0,62,10,8,0,6548
"18081610802",5606,919,73,130,91,83,105,18,7025
"18081610900",3810,538,87,19,69,241,0,220,4984
"18081611000",2606,636,0,114,51,0,18,0,3425
"18081611100",2834,263,37,0,13,61,28,1,3237
"18081611200",3885,396,2,26,272,8,154,28,4771
"18081611300",2783,912,7,53,98,0,113,152,4118
"18081611400",6178,504,46,87,75,23,62,4,6979
"18083955000",2422,583,1,2,0,0,0,0,3008
"18083955100",2364,168,0,0,41,13,41,13,2640
"18083955200",5267,365,23,5,79,55,15,66,5875
"18083955300",1104,497,79,24,46,34,44,0,1828
"18083955400",1181,317,91,7,152,15,130,0,1893
"18083955500",2768,535,149,0,0,0,13,0,3465
"18083955600",2594,418,25,58,20,18,0,0,3133
"18083955700",3720,821,136,0,11,20,56,0,4764
"18083955800",3411,187,0,2,34,0,33,0,3667
"18083955900",4521,760,0,0,229,75,52,98,5735
"18085960900",2373,399,0,0,52,0,24,0,2848
"18085961000",3748,299,56,0,168,22,394,0,4687
"18085961100",4863,622,15,75,133,50,276,250,6284
"18085961200",4559,695,0,0,489,177,531,177,6628
"18085961300",2856,359,0,0,75,11,112,11,3424
"18085961400",2556,364,16,9,217,8,139,8,3317
"18085961500",2451,332,0,0,17,13,17,0,2830
"18085961600",1324,135,0,0,0,9,0,0,1468
"18085961700",3884,179,0,0,156,276,263,276,5034
"18085961800",4431,408,138,11,546,0,764,0,6298
"18085961900",1893,614,8,33,80,163,334,242,3367
"18085962000",3278,622,0,50,347,145,139,143,4724
"18085962100",6350,583,45,9,415,115,473,123,8113
"18085962200",3913,570,36,0,172,78,253,134,5156
"18085962300",4358,216,0,0,327,0,143,14,5058
"18085962400",2519,244,0,0,324,24,331,26,3468
"18085962500",2103,222,0,0,71,30,38,10,2474
"18085962600",2475,169,0,0,0,40,40,17,2741
"18085962700",3168,620,0,3,5,37,61,28,3922
"18087970100",4403,1258,0,14,196,165,311,245,6592
"18087970200",4292,700,6,3,45,97,444,54,5641
"18087970300",6234,1261,1,0,13,3,102,43,7657
"18087970401",3711,664,0,0,11,0,0,0,4386
"18087970402",4119,630,0,0,122,23,40,0,4934
"18087970500",2975,665,0,0,24,0,40,0,3704
"18087970600",2242,139,0,0,32,3,35,2,2453
"18087970700",2415,487,0,0,74,0,36,0,3012
"18089010100",1250,177,2063,532,123,0,34,0,4179
"18089010201",489,256,2732,1782,89,302,124,14,5788
"18089010203",40,0,1369,1226,55,84,98,29,2901
"18089010205",31,15,477,803,90,0,57,16,1489
"18089010302",74,52,1930,900,70,36,22,76,3160
"18089010304",247,0,1784,939,52,97,315,97,3531
"18089010400",0,13,1587,1223,0,25,35,9,2892
"18089010500",89,52,405,367,17,21,10,45,1006
"18089010600",32,11,537,590,49,9,68,0,1296
"18089010900",9,0,483,465,3,0,3,0,963
"18089011000",18,4,1096,427,67,0,26,0,1638
"18089011100",16,77,2852,1441,89,31,59,22,4587
"18089011200",15,0,2705,1177,70,94,12,33,4106
"18089011300",11,17,992,931,21,28,23,28,2051
"18089011400",0,47,656,533,0,14,0,68,1318
"18089011500",198,93,1594,552,68,17,121,17,2660
"18089011600",2,0,1328,991,11,0,2,0,2334
"18089011700",31,6,519,226,20,8,8,1,819
"18089011800",0,0,690,713,14,0,0,23,1440
"18089011900",12,10,823,1065,4,2,0,16,1932
"18089012000",15,6,650,311,8,0,0,39,1029
"18089012100",37,10,761,405,0,10,0,10,1233
"18089012200",0,0,617,859,0,0,13,0,1489
"18089012300",208,203,1528,1309,116,0,104,48,3516
"18089012400",177,146,2103,1716,284,107,186,200,4919
"18089012500",357,70,3052,1480,27,25,156,40,5207
"18089012600",127,57,1410,1064,226,0,279,8,3171
"18089012700",145,96,2183,881,119,40,110,54,3628
"18089012800",96,55,1209,883,34,22,63,41,2403
"18089020100",2809,336,49,2,1086,251,1412,383,6328
"18089020200",1828,88,23,0,521,261,696,267,3684
"18089020300",2831,743,281,50,1388,959,2074,1188,9514
"18089020400",1457,530,213,193,1735,1007,2223,1234,8592
"18089020500",868,425,503,398,1208,541,1714,743,6400
"18089020600",242,399,386,808,144,257,213,284,2733
"18089020700",1211,383,1850,823,823,264,1108,615,7077
"18089020800",393,201,1994,881,421,219,578,201,4888
"18089020900",2178,149,687,67,475,124,594,96,4370
"18089021000",2909,623,500,20,786,493,1524,570,7425
"18089021100",1515,277,310,135,802,19,962,69,4089
"18089021300",1511,122,1139,227,642,44,824,58,4567
"18089021400",1931,403,617,641,975,562,1764,560,7453
"18089021500",1173,161,181,121,209,365,316,389,2915
"18089021600",2406,323,187,2,378,184,958,223,4661
"18089021700",2330,462,603,295,702,268,999,338,5997
"18089021800",2058,262,569,340,506,93,589,243,4660
"18089021900",3117,246,601,99,898,319,1428,407,7115
"18089022000",2580,193,996,365,483,120,889,86,5712
"18089030100",0,0,176,736,8,50,8,76,1054
"18089030200",72,87,401,720,350,40,391,119,2180
"18089030300",37,147,714,1403,107,187,144,328,3067
"18089030400",587,395,329,269,1529,323,1831,516,5779
"18089030500",861,314,487,696,1380,364,1917,537,6556
"18089030600",2285,838,712,311,903,458,2479,855,8841
"18089030700",429,80,712,121,584,52,771,51,2800
"18089030800",733,195,956,503,1356,818,2000,961,7522
"18089030900",624,121,1275,318,680,328,1187,409,4942
"18089031000",113,44,412,570,92,5,189,49,1474
"18089040100",926,187,46,37,197,4,244,35,1676
"18089040200",2126,222,42,41,987,147,1363,237,5165
"18089040300",6442,342,209,24,474,478,681,516,9166
"18089040401",4035,239,85,27,403,22,257,24,5092
"18089040402",3130,97,266,17,762,9,210,33,4524
"18089040403",5118,218,42,0,710,58,549,23,6718
"18089040501",2494,180,524,17,297,24,514,7,4057
"18089040502",2592,209,143,26,135,0,411,7,3523
"18089040600",3009,235,23,90,351,0,368,29,4105
"18089040700",4261,153,39,10,741,151,956,136,6447
"18089040801",3288,118,23,0,439,19,654,74,4615
"18089040802",3369,101,0,0,413,0,691,0,4574
"18089040900",5672,256,98,1,770,182,654,170,7803
"18089041001",2247,146,1668,591,538,141,686,70,6087
"18089041002",3398,537,37,22,291,98,596,112,5091
"18089041100",1441,647,75,0,235,145,325,70,2938
"18089041200",1502,743,23,340,207,52,250,19,3136
"18089041302",1929,461,226,120,135,56,247,75,3249
"18089041400",1624,452,196,227,177,39,260,21,2996
"18089041500",298,221,594,382,26,61,50,145,1777
"18089041600",3066,753,88,32,458,157,1020,240,5814
"18089041700",2828,513,30,165,489,176,1136,168,5505
"18089041800",4603,862,10,5,546,266,1459,322,8073
"18089041900",4337,264,0,10,180,0,533,44,5368
"18089042000",4876,461,441,9,519,32,576,0,6914
"18089042100",4033,741,390,0,498,37,751,0,6450
"18089042200",5297,912,48,57,499,0,777,243,7833
"18089042300",4543,599,1069,33,739,28,778,142,7931
"18089042401",1803,167,2816,394,670,337,454,265,6906
"18089042402",2988,211,2302,369,752,62,1047,151,7882
"18089042403",824,167,2484,559,220,241,265,312,5072
"18089042501",2772,639,966,1490,337,39,852,61,7156
"18089042503",1592,175,987,246,194,0,450,7,3651
"18089042504",4241,384,1032,186,635,1,704,16,7199
"18089042505",2460,102,2465,319,558,188,464,226,6782
"18089042602",5305,157,345,1,527,38,875,4,7252
"18089042605",6780,233,110,1,381,43,858,43,8449
"18089042606",2111,313,214,28,419,74,568,28,3755
"18089042607",5487,119,26,0,429,198,557,23,6839
"18089042608",3837,131,10,0,703,4,835,36,5556
"18089042609",7824,326,0,15,233,199,647,177,9421
"18089042702",4594,169,432,0,356,15,329,0,5895
"18089042703",3364,172,110,8,239,268,250,282,4693
"18089042704",3873,310,46,20,290,16,503,7,5065
"18089042801",8186,175,280,36,572,24,873,1,10147
"18089042802",4940,130,0,1,256,1,498,1,5827
"18089042901",5793,98,2,0,40,108,132,108,6281
"18089042902",5614,272,49,13,296,186,424,49,6903
"18089043001",4148,300,54,0,166,6,282,16,4972
"18089043002",4827,524,15,0,89,6,264,0,5725
"18089043101",2518,196,11,27,182,0,247,13,3194
"18089043102",6291,181,58,0,324,12,197,8,7071
"18089043201",3164,247,0,0,198,26,225,47,3907
"18089043202",6651,428,257,2,327,151,282,65,8163
"18089043300",8453,311,439,0,709,31,895,0,10838
"18089043401",6086,477,0,0,222,4,330,44,7163
"18089043403",5821,675,0,21,112,260,244,272,7405
"18089043404",1251,319,9,33,40,6,25,4,1687
"18089043405",4665,229,29,0,173,0,407,0,5503
"18089990000",0,0,0,0,0,0,0,0,0
"18091040100",771,168,415,273,44,63,26,46,1806
"18091040300",1409,490,272,171,153,174,81,35,2785
"18091040400",2501,150,98,186,120,81,227,2,3365
"18091040500",2405,342,172,177,146,25,110,0,3377
"18091040600",2726,840,446,514,125,8,40,180,4879
"18091040700",1075,49,152,184,155,0,179,0,1794
"18091040800",2095,468,129,176,142,54,151,24,3239
"18091040900",405,105,1100,572,94,78,6,0,2360
"18091041100",1981,118,91,5,112,2,65,0,2374
"18091041200",1027,68,8,0,15,0,11,0,1129
"18091041300",1328,590,210,250,93,58,0,43,2572
"18091041400",2155,317,655,463,97,63,125,74,3949
"18091041500",4465,200,82,0,134,9,103,0,4993
"18091041600",5620,454,0,1,9,11,133,0,6228
"18091041700",3023,216,17,9,18,17,165,17,3482
"18091041800",5159,610,16,5,99,186,340,195,6610
"18091041900",4974,353,58,0,151,168,90,160,5954
"18091042000",1928,199,74,25,54,24,62,65,2431
"18091042100",5053,1148,0,0,310,191,671,257,7630
"18091042200",2687,359,17,24,123,19,382,62,3673
"18091042300",1319,641,3,0,8,9,115,64,2159
"18091042400",5105,1253,67,54,222,17,276,232,7226
"18091042500",4023,786,28,0,17,21,48,129,5052
"18091042600",3509,688,37,6,73,0,144,16,4473
"18091042700",4767,404,55,38,54,108,110,55,5591
"18091042800",2811,135,0,0,36,13,73,43,3111
"18091042900",3095,327,9,0,86,59,69,40,3685
"18091043000",993,298,441,491,66,84,135,12,2520
"18091990000",0,0,0,0,0,0,0,0,0
"18093950400",3213,175,0,7,54,36,0,32,3517
"18093950500",4553,361,0,0,13,21,0,0,4948
"18093950600",6187,908,23,5,183,0,6,3,7315
"18093950700",6581,1059,8,0,29,162,0,50,7889
"18093950800",2603,779,5,28,48,101,35,106,3705
"18093950900",1714,456,0,27,4,18,0,27,2246
"18093951000",2838,742,29,5,52,67,55,0,3788
"18093951100",2320,333,0,0,138,0,68,0,2859
"18093951200",4894,548,31,8,105,0,173,0,5759
"18093951300",2745,989,0,4,49,45,8,48,3888
"18095000300",1279,750,96,214,70,140,76,95,2720
"18095000400",479,362,766,384,202,118,6,52,2369
"18095000500",1049,984,471,377,98,221,102,214,3516
"18095000800",1173,713,74,11,38,56,71,45,2181
"18095000900",1044,563,66,42,95,17,48,63,1938
"18095001000",1683,863,49,155,51,97,0,127,3025
"18095001100",1196,343,122,68,93,52,61,144,2079
"18095001200",2175,427,168,64,103,6,75,0,3018
"18095001300",3704,230,293,72,52,92,160,0,4603
"18095001400",2963,716,81,11,257,28,125,150,4331
"18095001500",2903,467,240,37,203,0,3,26,3879
"18095001600",2508,116,45,11,26,7,13,41,2767
"18095001700",2001,195,730,451,78,13,8,21,3497
"18095001800",3600,538,204,43,34,185,232,109,4945
"18095001900",3963,987,337,143,65,25,183,22,5725
"18095002000",2450,760,145,15,384,127,69,75,4025
"18095010100",2698,249,0,0,5,3,88,0,3043
"18095010200",3807,743,0,0,365,56,166,42,5179
"18095010300",2397,687,0,0,17,11,102,18,3232
"18095010400",2353,271,0,0,65,26,54,0,2769
"18095010500",3167,434,5,28,33,18,24,18,3727
"18095010600",3944,921,51,40,0,19,166,91,5232
"18095010700",2804,258,0,0,37,0,0,0,3099
"18095010800",2681,391,5,31,75,19,59,0,3261
"18095010900",1697,213,0,0,161,0,79,40,2190
"18095011000",1723,172,0,0,25,42,0,43,2005
"18095011100",3226,437,0,0,127,45,26,0,3861
"18095011200",5917,219,85,33,25,0,153,0,6432
"18095011300",2082,295,5,0,126,9,34,0,2551
"18095011400",3248,480,0,0,39,45,0,12,3824
"18095011501",4489,149,36,0,42,123,38,0,4877
"18095011502",3408,144,31,0,11,10,0,0,3604
"18095011600",4,0,0,0,0,0,0,0,4
"18095011700",2112,119,0,0,91,187,0,0,2509
"18095011800",6415,609,110,16,276,7,156,0,7589
"18095011900",523,519,158,59,15,150,5,95,1524
"18095012000",1460,615,378,262,141,27,60,90,3033
"18097310103",4229,523,1625,29,468,16,134,0,7024
"18097310104",1902,261,1028,79,454,0,208,0,3932
"18097310105",1631,192,1248,138,238,0,135,37,3619
"18097310106",1302,491,1329,27,374,206,262,277,4268
"18097310108",2655,95,337,51,209,0,82,0,3429
"18097310110",1162,57,903,161,249,235,105,144,3016
"18097310111",1171,133,1209,58,505,31,441,17,3565
"18097310201",1834,243,1315,134,749,81,940,105,5401
"18097310203",1929,424,1388,848,972,145,977,131,6814
"18097310204",1220,209,3242,326,828,322,485,404,7036
"18097310305",1441,366,2600,783,738,809,889,1010,8636
"18097310306",823,400,2367,1212,1132,660,1077,928,8599
"18097310308",788,18,1519,284,551,80,452,80,3772
"18097310309",366,199,1157,1299,484,222,94,232,4053
"18097310310",2033,47,1785,222,279,0,598,0,4964
"18097310311",1373,242,2930,128,388,55,283,224,5623
"18097310312",806,258,2739,401,719,369,612,575,6479
"18097320105",2827,343,531,310,229,19,140,33,4432
"18097320106",1803,25,470,12,312,124,229,97,3072
"18097320107",1397,94,40,6,93,58,7,0,1695
"18097320108",1258,290,2183,621,653,461,456,387,6309
"18097320109",1880,213,92,3,115,48,42,0,2393
"18097320202",3251,160,15,0,100,0,13,0,3539
"18097320203",2075,205,401,70,426,23,329,43,3572
"18097320204",3153,573,539,206,312,424,193,633,6033
"18097320301",2953,196,82,44,265,28,75,24,3667
"18097320303",1953,367,363,203,462,16,272,43,3679
"18097320304",5245,182,188,0,235,0,203,0,6053
"18097320400",1794,247,657,165,107,56,69,60,3155
"18097320500",1712,151,518,228,460,32,356,66,3523
"18097320600",2269,145,44,22,187,20,168,4,2859
"18097320700",1461,165,78,22,9,0,0,0,1735
"18097320800",2612,159,35,0,86,10,52,0,2954
"18097320901",2981,368,1642,328,710,245,488,330,7092
"18097320902",1599,141,1170,583,564,221,667,332,5277
"18097320903",528,118,1986,653,835,634,723,358,5835
"18097321001",758,263,1214,196,48,307,160,307,3253
"18097321002",2087,123,1541,183,119,111,82,46,4292
"18097321100",1955,211,1174,303,99,19,59,8,3828
"18097321200",4091,194,123,13,113,0,107,0,4641
"18097321300",2029,213,14,0,31,0,0,0,2287
"18097321400",3406,385,980,41,315,207,211,152,5697
"18097321600",2057,236,1873,317,177,0,75,0,4735
"18097321700",3003,267,510,58,479,3,82,0,4402
"18097321800",3006,137,82,0,223,7,58,0,3513
"18097321900",2161,700,651,49,84,42,68,31,3786
"18097322000",811,344,1618,458,72,148,58,37,3546
"18097322100",941,25,1225,430,68,170,0,194,3053
"18097322200",1086,69,616,58,126,0,49,0,2004
"18097322300",1643,219,292,74,111,18,31,0,2388
"18097322400",1348,343,1032,240,211,68,240,58,3540
"18097322500",286,115,509,304,29,126,4,110,1483
"18097322600",352,50,1900,1000,165,101,70,93,3731
"18097322700",199,5,1818,108,73,11,0,11,2225
"18097330103",3402,641,543,46,322,109,444,298,5805
"18097330105",3200,681,359,189,321,0,193,390,5333
"18097330106",2240,508,1182,192,65,150,234,204,4775
"18097330107",5150,133,449,0,364,0,148,0,6244
"18097330108",3216,72,197,0,252,0,21,0,3758
"18097330109",3702,162,338,21,285,38,166,12,4724
"18097330202",2884,409,4467,1315,374,41,462,338,10290
"18097330203",5019,225,312,18,385,0,146,0,6105
"18097330204",3961,134,1589,14,277,14,528,0,6517
"18097330206",3848,156,910,0,160,4,224,0,5302
"18097330208",2449,112,270,0,156,0,19,0,3006
"18097330209",6463,351,1578,141,164,381,307,56,9441
"18097330401",4523,170,1496,0,0,10,133,0,6332
"18097330500",1519,133,3130,215,387,0,271,0,5655
"18097330600",2674,359,751,1003,419,0,115,0,5321
"18097330700",3528,1444,263,99,634,269,1367,831,8435
"18097330803",524,478,1225,1498,126,272,141,682,4946
"18097330804",485,342,1157,1085,120,44,252,343,3828
"18097330805",1113,609,610,751,106,115,229,492,4025
"18097330806",883,246,1221,747,274,101,363,205,4040
"18097330900",375,106,3138,1065,251,0,144,0,5079
"18097331000",89,69,3207,846,134,20,0,0,4365
"18097340101",2932,192,133,0,135,63,29,54,3538
"18097340102",1645,139,1125,570,212,0,67,8,3766
"18097340108",484,96,489,432,207,254,437,257,2656
"18097340109",656,11,339,72,252,182,299,175,1986
"18097340110",1788,261,1563,174,850,282,839,289,6046
"18097340111",1499,129,576,39,419,67,209,31,2969
"18097340112",2580,529,867,284,339,0,272,0,4871
"18097340113",3031,101,255,19,175,0,91,40,3712
"18097340114",3501,324,512,0,363,0,249,0,4949
"18097340201",1433,336,659,535,209,191,328,392,4083
"18097340202",1834,207,1198,189,246,156,247,165,4242
"18097340300",2130,822,1130,1016,1652,701,2146,1117,10714
"18097340400",1303,261,712,373,650,152,872,257,4580
"18097340500",826,82,2416,498,250,49,127,37,4285
"18097340600",889,299,2614,540,342,163,292,277,5416
"18097340700",1260,467,780,709,457,353,522,642,5190
"18097340800",1261,230,21,0,40,8,17,0,1577
"18097340901",2613,164,925,45,284,11,390,11,4443
"18097340902",3037,583,1541,566,461,442,353,358,7341
"18097341000",1682,56,80,0,17,0,35,0,1870
"18097341100",647,524,356,219,176,176,146,246,2490
"18097341200",216,156,1005,482,44,32,172,40,2147
"18097341600",241,39,863,549,35,55,62,0,1844
"18097341700",2091,967,280,272,258,248,340,448,4904
"18097341902",2688,62,447,133,228,35,197,2,3792
"18097341903",2046,675,722,545,773,690,993,939,7383
"18097341904",680,342,169,9,628,590,528,760,3706
"18097342000",4169,303,1649,438,906,12,861,50,8388
"18097342101",2671,483,637,350,736,93,589,269,5828
"18097342200",3169,837,323,462,625,226,860,275,6777
"18097342300",3589,1977,149,137,244,321,117,423,6957
"18097342400",1234,373,35,1,8,261,0,111,2023
"18097342500",2989,1196,0,2,270,610,319,418,5804
"18097342600",1542,519,128,127,282,383,427,377,3785
"18097350100",64,0,930,244,20,30,0,0,1288
"18097350300",232,134,777,699,34,12,0,0,1888
"18097350400",560,74,1226,389,62,12,6,0,2329
"18097350500",39,18,1346,907,9,6,94,6,2425
"18097350600",145,84,3535,962,188,73,0,0,4987
"18097350700",5,29,768,496,120,28,32,34,1512
"18097350800",57,17,788,1017,0,0,0,0,1879
"18097350900",71,82,844,214,2,0,0,0,1213
"18097351000",400,103,974,1007,126,116,126,43,2895
"18097351200",12,84,1161,798,77,52,77,0,2261
"18097351500",394,75,471,271,126,5,27,17,1386
"18097351600",1060,215,577,349,111,37,68,91,2508
"18097351700",389,175,891,754,177,38,23,0,2447
"18097351900",159,65,1657,514,85,10,23,48,2561
"18097352100",61,138,1266,895,41,0,49,6,2456
"18097352300",21,41,984,488,183,39,181,0,1937
"18097352400",931,495,498,1030,24,85,75,162,3300
"18097352500",2044,518,220,88,129,51,116,17,3183
"18097352600",1251,677,255,563,29,213,99,278,3365
"18097352700",977,429,443,616,82,156,77,104,2884
"18097352800",57,52,580,442,63,0,0,0,1194
"18097353300",1219,265,252,237,120,104,107,9,2313
"18097353500",292,316,684,543,86,184,12,33,2150
"18097353600",106,213,929,593,52,62,20,24,1999
"18097354200",2784,741,370,356,202,80,335,40,4908
"18097354400",809,168,165,61,32,5,44,21,1305
"18097354500",1432,649,54,103,179,51,264,105,2837
"18097354700",622,286,201,306,71,0,232,0,1718
"18097354800",315,396,91,599,39,53,132,22,1647
"18097354900",735,407,249,591,330,52,296,45,2705
"18097355000",818,567,83,360,179,105,300,333,2745
"18097355100",758,589,93,312,49,238,127,239,2405
"18097355300",1388,660,185,152,41,104,210,111,2851
"18097355400",1252,698,293,402,107,392,125,411,3680
"18097355500",2204,574,105,145,40,147,33,362,3610
"18097355600",875,303,54,102,209,47,189,77,1856
"18097355700",1211,826,232,115,82,213,391,300,3370
"18097355900",1285,599,318,24,29,23,163,104,2545
"18097356200",863,184,48,61,138,10,21,5,1330
"18097356400",1688,1247,368,173,157,392,518,645,5188
"18097356900",1402,850,125,183,8,129,81,54,2832
"18097357000",1332,767,416,91,42,34,58,24,2764
"18097357100",1152,756,99,67,34,75,183,300,2666
"18097357200",1031,1471,113,386,76,138,143,493,3851
"18097357300",795,538,369,448,45,0,41,0,2236
"18097357400",1939,1027,612,377,25,191,65,298,4534
"18097357500",2806,629,44,23,106,16,47,0,3671
"18097357600",3937,1545,630,526,275,2,53,454,7422
"18097357800",903,495,0,53,59,112,101,55,1778
"18097357900",2754,506,128,201,162,421,177,431,4780
"18097358000",769,256,123,63,34,6,0,49,1300
"18097358100",1591,856,136,8,115,48,236,0,2990
"18097360101",475,463,503,759,42,132,35,264,2673
"18097360102",153,160,945,674,46,15,11,0,2004
"18097360201",1216,606,1044,889,198,36,14,0,4003
"18097360202",1117,89,1284,534,154,0,153,50,3381
"18097360301",1617,145,894,542,47,172,290,160,3867
"18097360302",401,297,837,700,0,58,79,127,2499
"18097360401",1396,368,2596,668,265,58,154,80,5585
"18097360402",325,61,877,505,4,8,3,0,1783
"18097360404",1906,717,2770,1204,635,234,769,766,9001
"18097360405",2369,184,2829,645,244,135,268,153,6827
"18097360501",4254,408,1304,351,410,98,516,111,7452
"18097360502",3588,441,1391,407,174,70,184,183,6438
"18097360601",3714,142,383,20,438,67,361,29,5154
"18097360602",3500,876,649,163,379,275,368,245,6455
"18097360700",1301,161,180,27,50,6,7,6,1738
"18097360800",1442,246,159,235,11,36,187,69,2385
"18097360900",2655,570,694,411,97,9,420,259,5115
"18097361000",1875,128,21,0,31,3,58,0,2116
"18097361100",2480,353,59,120,57,32,89,8,3198
"18097361200",2379,597,131,83,53,0,117,0,3360
"18097361300",1627,576,16,37,70,0,172,0,2498
"18097361400",6981,736,1532,808,643,12,284,132,11128
"18097361600",5211,122,1662,221,562,25,28,0,7831
"18097370201",2909,533,95,29,338,0,84,0,3988
"18097370202",4733,1163,310,792,116,180,147,180,7621
"18097370301",5856,466,1017,6,428,269,232,220,8494
"18097370302",7334,889,140,0,197,313,252,380,9505
"18097380100",12566,1279,308,16,1200,277,1079,45,16770
"18097380200",1984,551,230,57,29,220,90,376,3537
"18097380300",2398,1750,112,428,138,178,317,51,5372
"18097380402",3032,993,170,71,132,219,264,179,5060
"18097380403",3382,456,0,0,6,0,0,0,3844
"18097380404",3429,409,67,33,72,30,68,5,4113
"18097380501",2037,450,0,0,6,0,56,195,2744
"18097380502",1908,759,423,26,316,296,284,209,4221
"18097380600",2590,606,318,494,815,424,626,211,6084
"18097380700",4056,677,214,152,826,19,91,56,6091
"18097380800",2109,333,34,0,26,14,13,33,2562
"18097380901",4778,196,24,0,245,0,183,0,5426
"18097380902",5126,287,276,0,129,0,151,14,5983
"18097381001",3473,800,442,120,925,1803,222,247,8032
"18097381002",2412,128,5,0,25,228,20,244,3062
"18097381101",4352,298,154,0,183,0,75,66,5128
"18097381102",4977,695,0,0,144,137,49,36,6038
"18097381201",5930,315,69,57,288,0,211,0,6870
"18097381203",1400,325,20,61,595,496,158,406,3461
"18097381204",1584,694,69,41,250,49,101,180,2968
"18097381205",4113,655,121,171,1160,211,318,69,6818
"18097390101",6636,992,437,0,280,0,389,0,8734
"18097390102",4025,350,128,400,176,14,91,78,5262
"18097390200",2580,230,115,0,173,0,31,0,3129
"18097390300",4768,166,87,0,327,0,98,0,5446
"18097390402",11076,226,275,242,1094,239,629,0,13781
"18097390403",9065,540,71,0,744,0,83,0,10503
"18097390404",4142,471,38,12,289,43,547,109,5651
"18097390405",2902,141,336,35,467,44,138,44,4107
"18097390500",239,32,1223,920,28,62,56,23,2583
"18097390600",1614,319,1740,883,455,63,150,225,5449
"18097390700",1347,741,189,190,721,228,822,506,4744
"18097390800",2949,196,146,0,38,264,73,282,3948
"18097390900",823,199,581,280,92,40,51,10,2076
"18097391000",1894,913,219,202,390,222,62,121,4023
"18099020101",4376,362,23,10,246,57,322,59,5455
"18099020102",3125,459,60,0,35,0,55,0,3734
"18099020201",3712,445,0,0,112,4,153,4,4430
"18099020202",2517,160,15,0,127,0,59,0,2878
"18099020301",3455,359,29,0,84,13,76,26,4042
"18099020302",2614,291,10,8,80,20,136,4,3163
"18099020400",2031,507,16,55,143,14,231,82,3079
"18099020500",2080,1076,0,8,282,477,665,842,5430
"18099020600",3577,786,0,0,275,315,245,589,5787
"18099020701",3124,381,0,14,66,0,71,66,3722
"18099020702",2592,446,16,0,56,3,140,0,3253
"18099020800",4303,686,25,0,63,68,83,89,5317
"18101950100",2063,385,0,0,11,9,15,0,2483
"18101950200",3032,676,0,0,112,10,20,0,3850
"18101950300",3455,384,0,0,7,16,0,0,3862
"18103952000",4053,723,0,0,120,31,10,7,4944
"18103952100",3712,540,11,0,90,151,91,93,4688
"18103952200",2096,463,145,53,78,52,34,0,2921
"18103952300",1881,417,390,7,90,14,43,0,2842
"18103952400",1484,540,409,0,53,6,39,35,2566
"18103952500",1498,451,9,0,54,11,9,11,2043
"18103952600",3019,299,0,0,14,0,16,0,3348
"18103952700",6025,1022,6,71,278,202,208,201,8013
"18103952800",1629,473,7,2,40,14,0,0,2165
"18103952900",1315,416,107,0,31,10,26,12,1917
"18105000100",1294,3061,0,13,93,288,11,40,4800
"18105000201",97,111,3,13,367,636,0,29,1256
"18105000202",11,50,0,12,0,7,0,0,80
"18105000301",2129,2170,77,71,186,260,29,64,4986
"18105000302",1561,1239,0,0,184,113,57,61,3215
"18105000401",2471,1255,109,31,163,133,80,162,4404
"18105000402",2450,935,166,36,393,77,56,9,4122
"18105000501",2925,695,192,102,348,32,143,52,4489
"18105000502",2356,632,84,0,96,60,36,97,3361
"18105000601",1745,1422,72,230,199,120,133,50,3971
"18105000602",876,1121,149,440,277,66,212,66,3207
"18105000700",2493,106,61,0,172,0,116,0,2948
"18105000800",4152,722,144,0,414,341,160,26,5959
"18105000901",1530,950,38,7,208,105,137,46,3021
"18105000903",2981,1286,146,20,349,267,69,177,5295
"18105000904",2914,1070,59,115,374,1030,16,99,5677
"18105001001",3993,323,204,0,596,65,229,7,5417
"18105001002",4273,456,118,0,704,58,216,59,5884
"18105001101",3187,830,148,106,184,279,0,12,4746
"18105001102",3176,604,196,88,248,60,57,0,4429
"18105001103",2773,129,28,0,247,0,26,0,3203
"18105001200",5229,285,0,73,293,0,245,0,6125
"18105001301",4872,389,0,0,68,86,12,17,5444
"18105001303",5499,219,25,0,46,40,0,0,5829
"18105001304",3300,372,109,0,234,0,146,0,4161
"18105001305",1995,193,12,0,47,0,0,0,2247
"18105001401",1956,137,4,0,61,0,0,0,2158
"18105001402",4532,537,41,0,199,0,47,0,5356
"18105001501",4965,396,0,8,13,0,0,0,5382
"18105001502",2251,125,0,0,12,0,16,0,2404
"18105001600",606,3782,51,54,170,200,0,295,5158
"18107956700",3075,327,7,2,20,0,196,0,3627
"18107956800",2947,277,0,0,15,0,12,33,3284
"18107956900",4178,662,1,0,98,48,259,0,5246
"18107957000",2974,747,17,198,19,0,87,26,4068
"18107957100",3479,1241,0,0,33,77,31,145,5006
"18107957200",2637,1398,19,0,244,129,368,323,5118
"18107957300",3548,517,0,1,21,0,35,127,4249
"18107957400",4110,192,112,0,24,0,0,0,4438
"18107957500",2945,349,0,0,65,0,24,11,3394
"18109510100",9283,226,0,0,71,135,68,49,9832
"18109510201",3684,285,0,0,67,0,103,0,4139
"18109510202",3051,660,48,0,58,0,0,0,3817
"18109510300",4406,606,13,18,40,2,49,2,5136
"18109510401",3680,338,0,0,71,0,0,0,4089
"18109510402",4841,371,41,0,90,0,116,0,5459
"18109510500",3720,486,4,0,57,21,105,0,4393
"18109510600",6963,814,9,0,92,2,22,2,7904
"18109510701",2403,429,2,0,151,0,122,0,3107
"18109510702",5698,294,0,0,117,0,5,0,6114
"18109510800",3130,582,0,0,48,32,0,0,3792
"18109510900",2423,1274,0,23,0,40,23,55,3838
"18109511000",6216,1023,0,0,122,177,30,98,7666
"18111100400",5472,543,12,0,43,21,519,13,6623
"18111100500",2692,324,0,6,119,18,71,19,3249
"18111100600",2180,392,0,0,48,22,44,41,2727
"18111100700",1776,241,0,0,49,0,44,4,2114
"18113971700",5288,519,0,0,226,15,341,21,6410
"18113971800",2353,846,0,6,70,30,59,5,3369
"18113971900",3686,1179,1,6,56,1,309,76,5314
"18113972000",2470,360,0,0,64,14,45,42,2995
"18113972100",4014,441,0,0,213,0,479,26,5173
"18113972200",3364,1201,0,4,273,0,1704,889,7435
"18113972300",3834,861,22,0,130,20,262,173,5302
"18113972400",4205,639,0,3,29,2,61,6,4945
"18113972500",5577,309,0,1,215,4,3,32,6141
"18113972600",3732,147,0,0,54,0,13,0,3946
"18115965700",2075,369,33,0,19,10,8,0,2514
"18115965800",3258,116,8,0,67,0,88,0,3537
"18117951300",2600,489,24,30,37,15,0,0,3195
"18117951400",2874,489,6,0,27,0,41,0,3437
"18117951500",1967,678,90,92,70,28,44,15,2984
"18117951600",2931,546,20,0,20,8,0,0,3525
"18117951700",2450,424,12,0,7,20,51,36,3000
"18117951800",2746,641,0,0,25,17,25,0,3454
"18119955500",3301,144,0,0,4,2,8,2,3461
"18119955600",3387,503,0,0,32,68,0,0,3990
"18119955700",3864,762,0,61,87,32,14,0,4820
"18119955800",3390,708,4,4,84,10,36,69,4305
"18119955900",3887,635,0,0,24,14,88,0,4648
"18121030100",3758,404,0,0,11,0,15,0,4188
"18121030200",2678,456,0,0,9,0,31,28,3202
"18121030300",2401,414,0,43,46,4,0,24,2932
"18121030400",4625,743,0,12,20,2,80,2,5484
"18123952200",3680,379,25,0,58,0,0,6,4148
"18123952300",3077,160,0,0,21,0,5,9,3272
"18123952400",3395,611,0,1,67,49,1,0,4124
"18123952500",3552,137,91,12,58,38,1,21,3910
"18123952600",1692,525,0,0,41,20,17,6,2301
"18125953900",3143,264,0,0,11,0,0,0,3418
"18125954000",2308,451,0,0,0,1,0,0,2760
"18125954100",2692,278,0,0,0,9,0,0,2979
"18125954200",2767,582,0,4,23,3,0,0,3379
"18127050101",7897,841,82,0,348,123,269,28,9588
"18127050103",7399,312,6,20,420,0,261,11,8429
"18127050202",5153,499,270,31,140,20,246,4,6363
"18127050203",5443,623,21,2,254,79,255,112,6789
"18127050300",5714,933,0,5,107,48,257,75,7139
"18127050402",6563,770,241,302,246,92,1469,484,10167
"18127050405",1139,41,6,0,20,0,25,7,1238
"18127050407",2771,850,268,52,114,19,443,165,4682
"18127050501",4666,527,174,121,190,46,778,17,6519
"18127050503",4257,555,90,0,49,0,436,35,5422
"18127050505",1957,223,28,6,131,37,358,25,2765
"18127050506",4976,406,468,34,201,39,1139,210,7473
"18127050507",2912,588,331,51,168,26,658,49,4783
"18127050508",3296,708,763,72,268,152,496,145,5900
"18127050509",3844,299,210,30,148,122,538,163,5354
"18127050602",3736,851,23,7,227,0,187,453,5484
"18127050603",2855,42,8,0,78,10,154,0,3147
"18127050604",7499,428,75,0,341,0,458,0,8801
"18127050702",5926,815,149,302,353,206,581,105,8437
"18127050703",3076,211,11,9,0,0,125,0,3432
"18127050704",4217,240,187,31,146,25,96,47,4989
"18127050800",5089,788,108,75,183,161,513,112,7029
"18127050900",1478,546,112,53,98,111,185,44,2627
"18127051002",7347,379,16,18,427,0,658,0,8845
"18127051005",4091,186,46,0,82,8,180,8,4601
"18127051006",3908,323,4,0,225,0,300,75,4835
"18127051007",6658,220,60,0,243,0,427,25,7633
"18127051008",2120,52,42,0,0,38,100,38,2390
"18127051101",5311,582,9,191,57,0,56,0,6206
"18127051102",4177,114,13,0,85,26,148,0,4563
"18127980001",0,0,0,0,0,0,0,0,0
"18127980002",0,0,0,0,0,0,0,0,0
"18127990000",0,0,0,0,0,0,0,0,0
"18129040100",5371,481,0,0,43,10,18,20,5943
"18129040200",1989,122,10,0,47,0,7,4,2179
"18129040300",2408,52,0,0,14,0,13,0,2487
"18129040400",4844,617,45,0,49,0,16,0,5571
"18129040500",2819,208,0,0,0,0,0,5,3032
"18129040600",2714,507,37,137,89,46,67,0,3597
"18129040700",2221,285,114,2,98,64,89,0,2873
"18131958900",1923,181,18,0,0,0,30,0,2152
"18131959000",2945,649,0,0,58,49,72,17,3790
"18131959100",3313,627,0,0,193,1,89,63,4286
"18131959200",2642,300,0,0,29,8,64,4,3047
"18133956000",2952,326,0,0,43,0,2,0,3323
"18133956100",2029,268,0,0,0,0,0,0,2297
"18133956200",3613,321,1,3,26,15,8,0,3987
"18133956300",4780,786,0,11,86,9,78,24,5774
"18133956400",6354,663,28,89,63,7,47,11,7262
"18133956500",5708,515,28,0,63,7,50,11,6382
"18133956600",3160,94,0,0,142,0,104,37,3537
"18135951400",2367,369,7,2,11,0,8,4,2768
"18135951500",2369,526,0,0,11,1,124,0,3031
"18135951600",2655,1022,3,24,85,136,214,196,4335
"18135951700",2234,630,0,0,34,41,0,0,2939
"18135951800",2016,320,0,0,28,67,37,6,2474
"18135951900",3627,497,1,0,46,12,51,1,4235
"18135952000",2812,343,13,0,86,0,79,4,3337
"18135952100",2586,449,20,4,71,10,19,40,3199
"18137968400",6523,510,1,0,171,7,93,56,7361
"18137968500",4237,159,0,43,175,0,52,0,4666
"18137968600",4274,577,3,2,92,63,99,63,5173
"18137968700",2993,574,4,0,21,0,10,0,3602
"18137968800",2722,394,47,0,23,10,34,0,3230
"18137968900",4171,306,0,0,49,0,32,0,4558
"18139974100",2580,208,14,0,4,0,0,0,2806
"18139974200",3234,516,0,0,49,0,36,0,3835
"18139974300",2718,755,38,0,78,57,0,57,3703
"18139974400",2278,458,48,10,0,3,56,33,2886
"18139974500",3287,553,0,4,32,57,0,12,3945
"18141000100",1023,80,387,378,185,18,166,27,2264
"18141000200",833,217,1004,897,324,140,155,197,3767
"18141000301",1703,286,173,268,44,52,21,111,2658
"18141000302",1009,195,596,623,228,45,167,102,2965
"18141000400",532,372,745,400,149,168,55,195,2616
"18141000500",316,231,515,527,42,0,28,159,1818
"18141000600",641,128,230,391,150,43,279,31,1893
"18141000700",896,134,226,112,93,0,66,0,1527
"18141000800",1543,130,24,5,52,0,60,0,1814
"18141000900",467,478,86,26,88,43,23,48,1259
"18141001000",994,331,746,736,165,65,175,89,3301
"18141001100",2910,287,635,673,249,145,183,140,5222
"18141001200",1955,138,199,6,125,4,116,0,2543
"18141001300",1646,206,517,137,243,22,335,9,3115
"18141001400",2127,694,421,148,165,19,163,252,3989
"18141001500",1542,439,348,446,96,183,42,61,3157
"18141001600",1996,52,58,23,188,0,141,0,2458
"18141001700",394,342,369,264,22,27,10,11,1439
"18141001900",224,199,320,484,31,17,15,94,1384
"18141002000",281,161,513,505,21,143,53,42,1719
"18141002100",297,169,208,279,15,34,86,80,1168
"18141002200",1385,290,249,248,494,253,1298,436,4653
"18141002300",129,279,473,320,3,255,21,114,1594
"18141002400",780,583,536,179,426,248,630,634,4016
"18141002500",656,188,382,219,141,137,359,158,2240
"18141002600",1715,385,424,256,241,118,373,354,3866
"18141002700",326,381,79,69,88,64,231,232,1470
"18141002800",929,414,422,200,119,151,387,452,3074
"18141002900",89,113,313,270,42,171,53,182,1233
"18141003000",598,215,377,195,108,170,140,150,1953
"18141003100",1893,1007,368,168,125,234,155,38,3988
"18141003200",3657,311,383,42,273,136,185,128,5115
"18141003300",1755,552,484,193,120,56,85,29,3274
"18141003400",1623,646,673,563,229,193,665,167,4759
"18141003500",1533,260,263,429,185,228,105,66,3069
"18141010100",2051,522,105,2,46,148,85,22,2981
"18141010200",3305,1395,116,263,140,32,201,47,5499
"18141010300",3667,461,492,73,262,241,105,44,5345
"18141010400",2718,299,45,9,74,33,70,33,3281
"18141010500",2654,152,82,0,54,0,0,0,2942
"18141010600",2418,697,61,21,114,93,117,42,3563
"18141010700",2407,505,124,0,135,98,45,0,3314
"18141010800",4167,294,11,0,100,2,127,5,4706
"18141010900",6424,628,436,0,230,15,582,39,8354
"18141011000",5017,239,572,7,559,0,321,0,6715
"18141011100",5535,976,69,17,317,0,508,73,7495
"18141011201",506,111,43,7,51,49,26,0,793
"18141011202",487,241,10,9,36,60,1,22,866
"18141011301",2987,954,217,11,306,222,64,273,5034
"18141011302",4902,387,692,1,148,12,263,0,6405
"18141011303",3667,410,227,336,262,24,355,0,5281
"18141011304",2006,41,121,0,22,0,63,0,2253
"18141011305",3258,107,118,57,238,0,112,0,3890
"18141011306",2245,77,37,0,171,0,97,0,2627
"18141011403",4823,274,99,62,665,0,171,18,6112
"18141011404",5731,96,162,0,1011,0,133,0,7133
"18141011405",3386,94,170,0,88,0,21,0,3759
"18141011406",4588,190,53,0,59,12,40,12,4954
"18141011501",1490,533,513,442,87,401,61,704,4231
"18141011503",1558,69,10,0,45,7,43,0,1732
"18141011504",1312,74,42,0,115,0,83,0,1626
"18141011505",1977,223,82,91,377,23,171,0,2944
"18141011506",3498,661,523,54,150,207,196,222,5511
"18141011601",7682,212,0,0,156,0,180,54,8284
"18141011602",6630,452,46,7,243,80,233,55,7746
"18141011701",2838,1141,68,42,96,51,38,52,4326
"18141011702",5711,810,942,285,259,289,40,0,8336
"18141011801",1300,27,140,0,38,8,31,8,1552
"18141011802",5253,409,394,13,264,101,174,29,6637
"18141011900",3559,214,17,1,41,24,106,24,3986
"18141012000",3485,297,108,0,70,29,142,29,4160
"18141012100",3181,393,32,10,174,0,60,0,3850
"18141012200",2368,325,19,0,38,16,89,50,2905
"18141012300",2931,548,9,15,97,17,64,32,3713
"18141012400",1910,177,24,0,32,4,32,4,2183
"18143966700",3681,738,0,0,54,0,65,0,4538
"18143966800",3017,902,60,185,27,0,27,13,4231
"18143966900",3625,578,0,0,31,0,45,11,4290
"18143967000",4004,1112,0,2,78,34,143,60,5433
"18143967100",4452,942,0,0,65,0,0,0,5459
"18145710100",3099,399,0,0,46,0,45,0,3589
"18145710200",5496,203,0,2,97,0,57,2,5857
"18145710300",4127,512,3,3,113,0,86,1,4845
"18145710400",2564,591,0,1,123,76,145,75,3575
"18145710500",3130,427,94,0,287,134,281,134,4487
"18145710601",2102,823,1,4,377,130,226,87,3750
"18145710602",1933,655,95,31,62,184,44,184,3188
"18145710700",5242,563,191,28,90,125,72,149,6460
"18145710800",4041,210,17,4,104,8,0,5,4389
"18145710900",4593,522,0,0,15,6,13,0,5149
"18147952700",6735,413,42,0,143,261,126,261,7981
"18147952800",2338,486,29,21,100,1,70,0,3045
"18147952900",2235,350,0,0,12,21,30,0,2648
"18147953000",4039,371,0,0,12,0,0,0,4422
"18147953100",2308,611,37,2,0,51,8,14,3031
"18149953600",2094,438,0,0,79,0,73,0,2684
"18149953700",3101,500,0,0,89,0,187,0,3877
"18149953800",3274,390,27,19,105,47,32,29,3923
"18149953900",1859,247,0,0,71,0,30,0,2207
"18149954000",2634,908,0,15,7,8,13,53,3638
"18149954100",2753,566,0,4,70,33,120,33,3579
"18149954200",3021,662,12,4,11,54,145,62,3971
"18151970800",3153,480,0,0,231,22,87,0,3973
"18151970900",1963,126,0,0,184,0,43,0,2316
"18151971000",2997,457,0,0,92,2,54,0,3602
"18151971100",2541,180,0,0,90,0,19,0,2830
"18151971200",2699,183,7,0,110,78,52,0,3129
"18151971300",4219,522,39,0,262,0,62,9,5113
"18151971400",3050,721,0,0,168,97,173,24,4233
"18151971500",2748,346,0,12,153,18,22,112,3411
"18151971600",3981,461,0,55,302,24,169,20,5012
"18153050100",4628,1153,170,66,25,3,19,20,6084
"18153050200",2757,157,0,0,22,12,0,24,2972
"18153050300",3952,1344,0,0,63,38,52,0,5449
"18153050400",2162,228,0,0,13,0,5,1,2409
"18153050500",1835,406,0,0,6,0,4,0,2251
"18155965700",3717,1120,0,3,102,69,107,0,5118
"18155965800",2417,441,18,0,11,0,0,0,2887
"18155965900",1775,663,3,0,49,9,1,40,2540
"18157000100",1267,535,126,298,21,9,80,39,2375
"18157000200",1150,342,0,4,25,26,93,108,1748
"18157000300",2451,187,241,7,147,0,143,34,3210
"18157000400",1728,1223,406,128,230,172,250,125,4262
"18157000700",1773,607,117,241,64,56,93,237,3188
"18157000800",1374,247,75,0,122,0,237,0,2055
"18157001000",1151,157,68,4,79,0,45,0,1504
"18157001100",2738,195,48,25,109,14,100,0,3229
"18157001200",2477,500,67,47,247,56,501,182,4077
"18157001300",3363,829,95,0,198,234,276,202,5197
"18157001400",2958,160,26,100,330,33,790,47,4444
"18157001501",2476,921,516,284,114,145,318,207,4981
"18157001502",4670,1041,239,64,167,0,328,202,6711
"18157001600",9613,725,75,67,643,16,663,153,11955
"18157001700",4064,1279,516,588,952,69,936,474,8878
"18157001800",2376,698,192,0,263,4,666,245,4444
"18157001900",3564,216,103,68,70,16,130,82,4249
"18157005101",1769,222,122,1,815,273,51,40,3293
"18157005102",3720,333,0,0,969,171,148,49,5390
"18157005200",2989,662,69,22,559,45,83,0,4429
"18157005300",1242,912,69,0,322,224,42,31,2842
"18157005400",676,2094,0,47,157,1033,25,122,4154
"18157005500",542,1981,14,32,202,641,21,146,3579
"18157010100",5176,297,13,0,187,109,288,0,6070
"18157010201",4914,207,75,0,252,0,308,43,5799
"18157010203",4758,3165,274,197,384,347,187,805,10117
"18157010204",7018,3750,53,219,700,1132,320,299,13491
"18157010300",116,238,0,22,6,285,14,33,714
"18157010400",0,0,0,0,0,0,0,0,0
"18157010500",143,276,33,0,813,394,93,7,1759
"18157010600",5085,229,6,4,70,3,63,0,5460
"18157010700",4079,430,259,0,285,220,508,131,5912
"18157010800",4552,184,32,0,48,11,239,0,5066
"18157010901",6799,190,0,29,244,82,387,0,7731
"18157010902",3671,182,11,19,10,21,39,51,4004
"18157011000",3848,192,0,0,93,3,45,0,4181
"18157011100",2350,881,218,112,184,110,165,112,4132
"18159020100",2686,287,0,1,0,0,19,100,3093
"18159020200",2993,107,16,0,95,0,120,9,3340
"18159020300",2527,136,0,0,5,50,64,0,2782
"18159020400",5666,886,0,0,169,0,60,6,6787
"18161960700",3312,610,2,0,121,8,32,2,4087
"18161960800",2882,310,0,0,81,0,0,0,3273
"18163000100",1445,134,6,10,24,124,28,76,1847
"18163000201",6600,363,517,102,356,0,47,0,7985
"18163000202",1473,120,123,42,95,0,33,0,1886
"18163000300",1818,565,111,91,35,103,25,101,2849
"18163000400",1811,271,24,0,22,0,8,0,2136
"18163000500",1801,54,61,0,47,0,77,17,2057
"18163000600",1494,189,133,108,126,85,48,32,2215
"18163000800",1602,214,340,301,60,30,11,0,2558
"18163000900",4004,558,582,289,158,106,455,211,6363
"18163001000",2295,618,482,787,275,25,197,0,4679
"18163001100",837,301,648,481,44,56,0,0,2367
"18163001200",809,236,338,299,46,6,0,6,1740
"18163001300",587,166,464,346,16,95,0,0,1674
"18163001400",761,327,348,470,63,0,147,0,2116
"18163001500",316,67,839,541,20,33,0,0,1816
"18163001700",985,506,398,291,16,37,64,0,2297
"18163001800",212,106,7,16,8,26,0,26,401
"18163001900",457,266,19,90,102,53,18,0,1005
"18163002000",550,256,69,27,13,0,0,0,915
"18163002100",1582,601,135,21,71,42,176,30,2658
"18163002300",1917,724,63,33,24,72,13,0,2846
"18163002400",2778,403,50,59,170,0,0,0,3460
"18163002500",1267,579,250,89,49,89,18,21,2362
"18163002600",1631,953,275,188,7,1,1,0,3056
"18163002800",2003,363,116,47,23,0,0,0,2552
"18163002900",859,145,0,61,0,15,0,0,1080
"18163003000",3851,602,57,0,13,14,21,14,4572
"18163003100",2042,504,0,2,22,24,0,0,2594
"18163003200",3206,937,17,6,40,46,33,38,4323
"18163003300",2713,630,47,193,226,6,28,27,3870
"18163003400",2554,137,0,0,0,28,20,0,2739
"18163003500",2176,303,34,0,94,6,97,20,2730
"18163003600",3323,399,589,103,30,56,156,32,4688
"18163003701",1429,156,78,26,110,10,107,59,1975
"18163003702",2523,770,282,543,140,181,91,186,4716
"18163003801",3908,362,362,49,245,67,145,1,5139
"18163003803",4465,342,113,0,245,27,206,39,5437
"18163003804",4854,307,379,251,361,13,0,0,6165
"18163003900",2940,190,0,0,0,0,11,0,3141
"18163010100",4096,985,418,249,233,247,32,115,6375
"18163010201",9276,288,294,2,525,1,79,1,10466
"18163010202",2705,212,220,0,173,0,30,0,3340
"18163010203",7263,921,181,0,359,114,61,66,8965
"18163010403",3140,710,53,65,96,138,28,0,4230
"18163010404",5831,478,0,17,236,0,136,0,6698
"18163010500",6950,421,0,0,67,0,0,0,7438
"18163010600",1834,117,0,0,47,0,1,23,2022
"18163010700",7796,355,37,6,369,16,131,0,8710
"18163980100",0,0,0,0,0,0,0,0,0
"18165020100",2770,417,0,5,82,0,23,0,3297
"18165020200",2755,275,1,0,24,4,1,25,3085
"18165020300",2536,331,5,1,12,10,32,4,2931
"18165020400",1762,148,0,0,0,10,17,0,1937
"18165020500",3214,1259,12,3,57,24,54,0,4623
"18167000300",684,609,0,152,53,100,14,4,1616
"18167000400",1960,941,245,189,79,14,102,60,3590
"18167000500",762,546,130,132,79,133,22,54,1858
"18167000600",1076,690,154,225,0,74,7,110,2336
"18167000700",886,526,267,185,71,218,26,14,2193
"18167000900",1913,563,0,178,7,0,35,7,2703
"18167001000",2994,459,51,31,55,31,18,0,3639
"18167001100",1663,987,103,101,56,0,55,29,2994
"18167001200",1914,184,107,56,128,13,20,0,2422
"18167001300",1703,367,10,0,118,0,0,6,2204
"18167001400",2586,211,209,49,74,173,60,47,3409
"18167001500",3107,423,33,4,77,32,57,0,3733
"18167001600",4422,214,158,15,0,103,49,1,4962
"18167001700",3035,588,145,0,249,101,36,85,4239
"18167001800",1543,747,34,204,107,18,33,0,2686
"18167001900",1074,607,24,141,27,160,58,24,2115
"18167010100",4247,348,70,0,90,0,13,0,4768
"18167010201",3891,367,66,0,67,180,23,67,4661
"18167010202",2589,577,23,0,67,0,0,0,3256
"18167010300",2978,401,33,0,51,0,10,0,3473
"18167010400",3064,140,0,0,168,0,0,0,3372
"18167010500",1900,681,21,0,29,12,71,0,2714
"18167010600",3929,1306,128,95,192,21,44,20,5735
"18167010701",5162,700,361,17,267,0,113,7,6627
"18167010702",4420,627,131,0,428,21,50,0,5677
"18167011000",3411,218,0,0,141,0,89,0,3859
"18167011100",1204,1205,149,274,98,239,60,27,3256
"18167011200",4844,731,118,40,370,87,71,30,6291
"18169102200",3773,885,32,56,41,113,0,278,5178
"18169102300",3222,709,0,0,114,14,45,14,4118
"18169102400",2912,226,0,0,94,18,0,0,3250
"18169102500",3823,393,0,0,67,16,118,16,4433
"18169102600",2451,671,0,0,43,4,50,0,3219
"18169102700",3214,631,0,0,121,51,1,1,4019
"18169102800",2748,535,11,0,28,0,21,0,3343
"18169102900",3211,305,0,0,175,13,135,6,3845
"18171951000",4462,345,0,0,146,0,66,0,5019
"18171951100",3095,251,0,0,42,0,17,0,3405
"18173030100",2878,321,0,0,28,13,11,9,3260
"18173030200",3175,211,0,0,23,38,10,0,3457
"18173030300",4346,228,0,0,21,9,38,0,4642
"18173030400",1893,283,0,0,12,289,28,25,2530
"18173030500",6638,296,0,0,133,56,99,0,7222
"18173030600",5301,716,0,71,22,150,68,17,6345
"18173030702",5858,238,144,37,368,0,18,0,6663
"18173030703",4510,642,94,0,171,203,73,50,5743
"18173030704",3588,326,132,0,195,0,147,0,4388
"18173030705",7399,330,78,0,457,0,177,0,8441
"18173030800",6018,848,9,0,199,0,199,0,7273
"18175967200",4205,360,0,10,117,0,49,3,4744
"18175967300",3489,734,2,47,27,26,0,0,4325
"18175967400",3733,711,0,0,38,34,182,3,4701
"18175967500",2375,558,0,0,28,7,21,13,3002
"18175967600",3523,721,0,0,31,18,34,18,4345
"18175967700",5830,926,0,12,10,0,14,0,6792
"18177000200",1729,1115,44,257,171,290,235,131,3972
"18177000400",2093,691,93,160,95,0,0,11,3143
"18177000500",2344,1327,220,175,214,116,197,118,4711
"18177000600",1414,363,103,4,0,2,53,9,1948
"18177000700",4721,802,124,21,109,143,43,17,5980
"18177000800",2377,530,44,12,202,164,25,107,3461
"18177000900",3079,1477,439,107,57,427,39,79,5704
"18177001000",2066,1432,286,35,345,289,145,146,4744
"18177001100",5152,560,402,50,382,93,105,12,6756
"18177010100",2321,406,6,0,20,0,0,71,2824
"18177010200",3000,403,61,0,24,3,0,0,3491
"18177010300",2599,474,20,0,2,19,0,12,3126
"18177010400",3043,326,0,9,49,14,13,0,3454
"18177010500",2118,304,0,0,42,0,38,12,2514
"18177010600",3932,813,4,0,36,12,35,0,4832
"18177010700",3586,330,13,7,23,33,0,0,3992
"18177010800",2224,425,0,24,111,82,27,57,2950
"18179040100",5224,357,5,0,89,0,190,31,5896
"18179040200",3477,199,0,0,31,0,40,7,3754
"18179040300",3605,348,4,0,32,20,42,1,4052
"18179040400",2783,383,22,0,100,21,39,14,3362
"18179040500",2366,372,11,3,2,0,21,11,2786
"18179040600",2979,730,7,13,61,51,81,73,3995
"18179040700",3314,388,0,0,45,11,29,5,3792
"18181958100",2219,432,0,0,156,0,251,0,3058
"18181958200",2054,515,0,0,55,72,256,287,3239
"18181958300",1854,200,2,0,40,35,36,48,2215
"18181958400",1881,48,0,0,65,0,156,0,2150
"18181958500",3421,333,0,0,120,0,79,0,3953
"18181958600",4272,412,0,0,117,31,562,44,5438
"18181958700",2328,254,7,0,50,0,7,0,2646
"18181958800",2847,268,9,0,58,0,36,0,3218
"18183050100",4690,487,0,0,80,2,43,4,5306
"18183050200",4712,170,0,0,19,0,0,1,4902
"18183050300",4950,465,9,14,124,6,45,2,5615
"18183050400",6050,778,28,71,360,9,138,0,7434
"18183050500",4006,362,6,0,129,82,197,65,4847
"18183050600",1762,183,6,0,22,0,0,0,1973
"18183050700",3100,75,0,0,19,0,27,0,3221
"19001960100",2310,313,0,3,36,28,40,0,2730
"19001960200",1644,101,0,0,0,0,0,0,1745
"19001960300",2654,246,19,0,54,13,20,0,3006
"19003950100",1609,58,0,1,17,2,3,1,1691
"19003950200",1800,349,5,4,28,28,30,15,2259
"19005960100",1696,136,1,0,35,0,42,0,1910
"19005960200",2148,186,0,3,65,69,59,0,2530
"19005960300",3308,509,0,0,97,5,45,14,3978
"19005960400",2196,184,0,0,18,1,2,1,2402
"19005960500",2458,492,0,31,102,124,350,269,3826
"19007950100",2268,441,5,0,72,0,17,13,2816
"19007950200",1610,158,4,1,2,1,0,4,1780
"19007950300",1988,448,47,2,50,56,77,45,2713
"19007950400",2611,644,0,0,39,0,12,6,3312
"19007950500",1983,163,0,0,26,10,2,0,2184
"19009070100",1775,167,0,0,40,0,23,0,2005
"19009070200",2048,170,0,0,27,13,0,13,2271
"19009070300",1331,189,12,0,15,15,0,0,1562
"19011960100",2690,209,8,0,18,0,0,0,2925
"19011960200",2871,297,0,0,16,27,60,0,3271
"19011960300",4533,597,18,25,68,82,35,33,5391
"19011960400",2643,349,0,0,0,0,0,0,2992
"19011960500",5607,177,48,0,44,0,30,0,5906
"19011960600",2462,92,0,0,78,0,39,0,2671
"19011960700",2221,303,12,0,198,1,69,30,2834
"19013000100",396,406,145,448,31,54,0,90,1570
"19013000200",1754,250,323,368,203,177,366,36,3477
"19013000300",1049,959,84,123,114,120,52,71,2572
"19013000400",1175,211,26,10,16,10,0,0,1448
"19013000500",840,287,377,125,218,17,206,0,2070
"19013000700",610,229,392,373,18,0,437,172,2231
"19013000800",3211,555,180,123,429,102,571,31,5202
"19013000900",829,312,269,196,79,132,89,172,2078
"19013001000",3255,186,39,0,204,20,176,48,3928
"19013001100",2385,388,13,168,0,59,216,78,3307
"19013001200",2096,58,51,0,92,9,47,0,2353
"19013001301",2666,451,127,108,125,229,141,85,3932
"19013001302",3101,398,94,93,179,0,22,0,3887
"19013001400",3804,257,131,187,199,0,106,0,4684
"19013001501",2203,236,169,217,101,156,26,49,3157
"19013001502",3398,399,52,224,149,12,43,0,4277
"19013001503",2970,505,57,13,71,20,18,0,3654
"19013001600",1835,184,452,211,133,58,26,0,2899
"19013001701",381,246,850,376,128,87,69,10,2147
"19013001702",1302,56,668,227,22,0,59,0,2334
"19013001800",109,21,1018,405,11,2,36,0,1602
"19013001900",1079,302,668,128,124,75,144,75,2595
"19013002000",4433,461,316,0,190,1,16,38,5455
"19013002200",3243,558,87,99,91,0,98,15,4191
"19013002301",1703,293,71,4,47,8,82,0,2208
"19013002303",519,1043,21,0,0,67,0,58,1708
"19013002304",1609,841,0,0,116,13,58,13,2650
"19013002400",3699,211,28,1,37,12,43,0,4031
"19013002500",4385,520,70,175,426,0,18,0,5594
"19013002601",2878,683,0,117,149,110,10,10,3957
"19013002603",7435,2064,0,12,363,65,116,226,10281
"19013002604",3841,187,35,35,68,9,28,0,4203
"19013002700",3454,133,38,0,35,4,28,4,3696
"19013002800",2896,126,92,0,48,0,56,0,3218
"19013002901",1233,70,0,0,19,0,5,0,1327
"19013002902",3644,200,0,0,159,6,172,8,4189
"19013003001",3290,622,162,0,63,64,96,0,4297
"19013003002",3669,136,0,0,54,0,28,0,3887
"19015020100",2625,104,2,0,20,4,63,0,2818
"19015020200",3791,268,0,0,0,3,113,0,4175
"19015020300",5149,436,21,174,105,45,0,1,5931
"19015020400",1876,461,0,0,101,4,23,11,2476
"19015020500",3833,372,0,0,7,0,47,12,4271
"19015020600",1703,421,0,0,5,0,5,150,2284
"19015020700",3745,284,0,0,28,6,45,0,4108
"19017004000",1087,257,0,0,22,0,0,0,1366
"19017004100",3169,105,185,2,18,51,33,8,3571
"19017004200",3398,355,0,0,51,0,84,0,3888
"19017004300",1726,73,0,0,31,0,10,0,1840
"19017004400",2683,254,0,0,19,23,38,0,3017
"19017004500",2305,111,50,5,12,19,34,19,2555
"19017004600",4504,218,4,11,42,0,0,12,4791
"19017004700",1772,165,0,0,30,6,6,0,1979
"19019950100",2165,352,2,1,22,35,20,36,2633
"19019950200",3261,392,6,5,24,0,11,0,3699
"19019950300",3167,315,40,0,66,10,39,0,3637
"19019950400",2132,156,0,0,5,0,0,0,2293
"19019950500",3269,584,28,0,97,10,125,10,4123
"19019950600",4240,159,81,14,5,3,6,5,4513
"19021960100",1260,179,2,0,25,14,13,9,1502
"19021960200",1324,187,16,1,100,0,119,30,1777
"19021960300",1642,185,0,0,148,12,79,25,2091
"19021960400",3480,573,118,158,1370,570,2014,613,8896
"19021960500",2724,204,64,58,971,43,1425,69,5558
"19021960600",3293,254,3,0,118,4,268,59,3999
"19023070100",3068,220,12,9,0,0,3,0,3312
"19023070200",1680,279,0,0,40,20,6,5,2030
"19023070300",2285,408,2,0,52,0,46,3,2796
"19023070400",3248,326,9,0,13,0,23,0,3619
"19023070500",2738,180,4,0,50,0,53,0,3025
"19025950100",1881,302,15,0,16,12,3,17,2246
"19025950200",2595,404,0,19,50,11,62,44,3185
"19025950300",1668,215,0,0,16,0,4,0,1903
"19025950400",1837,265,5,15,21,15,12,0,2170
"19027960100",3565,203,5,8,24,16,8,16,3845
"19027960200",2241,92,0,0,34,34,8,34,2443
"19027960300",5325,564,70,95,61,0,77,9,6201
"19027960400",3185,380,12,0,73,92,78,101,3921
"19027960500",1674,182,0,18,3,10,23,0,1910
"19027960600",2074,247,1,0,21,13,16,14,2386
"19029190100",2317,174,0,0,2,0,19,9,2521
"19029190200",2107,233,0,0,57,15,14,7,2433
"19029190300",1362,289,0,0,9,2,3,0,1665
"19029190400",3489,304,29,0,92,8,130,14,4066
"19029190500",2420,511,11,2,93,7,72,19,3135
"19031450100",2605,285,5,0,76,9,43,4,3027
"19031450200",3323,236,0,0,30,20,30,3,3642
"19031450300",2981,295,0,0,54,72,7,72,3481
"19031450400",2592,249,0,0,65,25,39,23,2993
"19031450500",4946,253,31,0,39,17,48,38,5372
"19033950102",3257,784,49,1,215,1,281,1,4589
"19033950200",4956,1111,11,0,403,21,239,117,6858
"19033950300",3247,944,86,83,186,43,77,103,4769
"19033950402",3564,336,4,0,204,3,134,19,4264
"19033950600",1963,158,62,0,80,7,26,7,2303
"19033950700",3322,362,20,0,60,0,105,22,3891
"19033950800",3984,749,0,37,133,60,80,156,5199
"19033950900",1675,73,0,0,29,0,30,0,1807
"19033951000",2544,207,36,0,29,8,62,14,2900
"19033951400",3156,232,17,1,67,28,7,0,3508
"19033951600",3771,347,41,44,41,0,186,0,4430
"19035080100",4473,490,0,1,121,26,113,47,5271
"19035080200",2250,139,0,0,76,5,23,0,2493
"19035080300",1610,127,0,0,3,1,22,0,1763
"19035080400",1882,321,0,0,60,13,88,19,2383
"19037070100",3035,367,4,2,14,21,26,0,3469
"19037070200",2286,148,5,0,33,0,8,0,2480
"19037070300",2383,236,0,0,31,6,48,38,2742
"19037070400",3043,415,0,21,114,36,127,27,3783
"19039960100",4126,792,0,0,13,0,544,309,5784
"19039960200",1656,140,7,0,128,1,105,0,2037
"19039960300",1853,266,0,0,1,39,0,0,2159
"19041080100",1814,185,0,0,21,17,10,3,2050
"19041080200",4321,530,0,0,207,2,101,51,5212
"19041080300",5548,435,0,0,166,51,144,121,6465
"19041080400",2582,207,8,10,75,6,14,3,2905
"19043070100",2461,267,8,0,75,32,54,13,2910
"19043070200",2907,552,0,7,67,21,40,59,3653
"19043070300",2858,281,0,29,24,10,58,10,3270
"19043070400",1976,245,0,0,25,0,0,10,2256
"19043070500",1897,293,5,0,22,17,13,17,2264
"19043070600",3110,427,0,6,21,20,6,20,3610
"19045000100",1622,817,115,246,36,144,78,31,3089
"19045000200",1634,392,24,39,41,39,157,26,2352
"19045000300",3626,991,276,8,111,129,77,20,5238
"19045000400",3115,323,55,27,115,47,67,35,3784
"19045000500",3665,529,128,64,52,7,25,88,4558
"19045000600",3104,244,85,101,33,71,58,0,3696
"19045000700",3150,285,125,40,272,25,198,0,4095
"19045000800",4387,759,19,0,33,0,49,0,5247
"19045000900",5839,539,2,29,59,62,35,171,6736
"19045001000",3639,286,4,0,64,9,11,1,4014
"19045001100",2112,301,0,0,54,10,60,3,2540
"19045001200",3736,144,41,0,48,11,67,5,4052
"19047070100",1578,190,1,0,48,12,99,30,1958
"19047070200",1884,242,0,0,10,30,55,59,2280
"19047070300",2065,316,0,0,3,2,75,23,2484
"19047070400",5888,1515,13,114,832,75,2877,1079,12393
"19047070500",1845,144,5,0,42,28,48,28,2140
"19049050100",3999,273,50,0,177,2,55,11,4567
"19049050200",3602,135,0,0,6,12,22,6,3783
"19049050300",2994,416,65,124,899,163,1310,260,6231
"19049050400",2340,382,0,0,381,35,822,182,4142
"19049050500",1884,114,0,0,11,43,0,43,2095
"19049050600",2620,234,12,0,100,26,54,0,3046
"19049050700",3969,247,0,3,119,0,129,0,4467
"19049050803",5669,126,133,0,486,0,75,0,6489
"19049050805",5309,123,34,0,357,0,270,14,6107
"19049050807",5942,216,68,0,511,58,186,0,6981
"19049050809",5486,741,85,0,198,11,355,6,6882
"19049050811",7310,481,117,54,927,0,187,22,9098
"19049050812",1793,0,0,0,63,20,24,0,1900
"19049050901",3108,82,0,0,73,0,88,0,3351
"19049050902",3496,244,0,0,123,62,55,11,3991
"19051080100",3102,580,0,0,59,3,53,27,3824
"19051080200",3561,1237,7,0,38,0,4,0,4847
"19053960100",1936,343,0,3,94,19,46,1,2442
"19053960200",2356,619,41,36,46,52,52,5,3207
"19053960300",1572,404,20,0,28,0,17,0,2041
"19055950100",3302,321,5,0,60,12,17,32,3749
"19055950200",2768,154,0,0,49,1,7,0,2979
"19055950300",4300,632,0,12,66,20,34,20,5084
"19055950400",5252,299,1,0,8,1,12,25,5598
"19057000200",2291,383,209,54,104,0,27,73,3141
"19057000300",2702,493,23,244,116,0,84,0,3662
"19057000400",2756,617,220,408,227,118,222,82,4650
"19057000500",3325,566,442,16,106,0,20,22,4497
"19057000600",3542,492,29,12,64,0,83,174,4396
"19057000700",2177,423,24,93,120,45,76,45,3003
"19057000800",2352,455,0,118,99,0,28,0,3052
"19057000900",3011,222,49,0,225,0,0,0,3507
"19057001000",3689,519,0,0,58,0,79,0,4345
"19057001100",3474,79,159,0,23,7,28,7,3777
"19057001200",2388,89,0,0,73,0,25,0,2575
"19059450200",1830,30,9,0,44,6,37,0,1956
"19059450500",4408,493,0,0,129,1,68,0,5099
"19059450800",2930,406,21,0,10,16,15,7,3405
"19059451000",2302,88,0,0,41,0,18,0,2449
"19059451100",3374,219,7,0,49,19,49,15,3732
"19061000100",1558,508,174,174,98,125,145,78,2860
"19061000300",1548,168,70,0,71,0,37,0,1894
"19061000400",3050,788,0,2,162,97,45,5,4149
"19061000500",2034,563,39,189,438,454,58,221,3996
"19061000600",2149,314,33,36,237,98,5,23,2895
"19061000701",1835,638,0,48,18,62,30,26,2657
"19061000702",2073,343,64,63,205,12,18,0,2778
"19061000801",3737,384,0,0,78,46,24,0,4269
"19061000802",3277,165,0,0,35,0,69,0,3546
"19061000900",2911,245,0,0,35,184,73,24,3472
"19061001101",3400,256,0,0,118,7,30,30,3841
"19061001102",6207,526,0,0,36,0,49,15,6833
"19061001201",3211,334,8,0,68,9,49,0,3679
"19061001202",1360,180,20,4,24,5,27,12,1632
"19061001204",1990,0,4,45,37,6,0,0,2082
"19061001205",3591,139,22,0,379,1,0,0,4132
"19061010101",1478,378,0,0,32,0,29,0,1917
"19061010103",2473,306,0,0,16,0,0,0,2795
"19061010104",3908,185,37,0,253,13,124,0,4520
"19061010105",3679,44,6,0,97,1,46,0,3873
"19061010201",5030,205,0,33,137,55,41,27,5528
"19061010202",3964,221,5,0,66,9,6,0,4271
"19061010300",2945,267,2,0,11,4,14,37,3280
"19061010400",3249,267,0,0,47,36,9,36,3644
"19061010500",3883,423,0,0,0,0,6,63,4375
"19061010600",2983,216,0,0,12,10,214,5,3440
"19063070100",1750,132,0,9,37,0,9,0,1937
"19063070200",1483,104,0,0,18,14,12,2,1633
"19063070300",2239,384,0,0,289,0,423,231,3566
"19063070400",2463,500,22,17,12,26,40,103,3183
"19065080100",2425,232,0,0,46,19,0,0,2722
"19065080200",2439,430,0,47,59,25,57,15,3072
"19065080300",2341,121,3,0,13,0,2,0,2480
"19065080400",2671,202,0,7,91,56,179,0,3206
"19065080500",2973,509,10,0,15,49,0,93,3649
"19065080600",2013,205,2,0,42,8,0,0,2270
"19065080700",2549,364,0,2,28,31,15,12,3001
"19067480100",2448,323,0,0,11,0,52,70,2904
"19067480200",2380,232,2,8,22,25,16,11,2696
"19067480300",2356,165,26,0,33,0,3,7,2590
"19067480400",2421,572,0,10,52,15,36,20,3126
"19067480500",3961,372,116,233,62,49,45,77,4915
"19069360100",2701,323,5,0,148,0,119,0,3296
"19069360200",3939,429,0,15,265,122,538,347,5655
"19069360300",2097,254,25,0,133,21,154,31,2715
"19071970100",2066,174,0,0,24,2,20,0,2286
"19071970200",2296,287,24,7,36,12,60,4,2726
"19071970300",1859,245,5,0,68,0,61,39,2277
"19073080100",1629,412,0,0,10,0,33,0,2084
"19073080200",2138,301,0,0,0,42,14,0,2495
"19073080300",2487,215,0,0,12,23,62,0,2799
"19073080500",1583,163,0,0,42,28,87,0,1903
"19075960100",4008,247,13,8,71,16,92,0,4455
"19075960200",2905,150,0,0,38,12,0,0,3105
"19075960300",2581,314,0,0,0,0,0,0,2895
"19075960400",1737,109,0,0,35,0,33,7,1921
"19077950100",3710,299,3,13,109,27,80,21,4262
"19077950200",2012,280,0,2,11,2,9,0,2316
"19077950300",3619,442,9,14,46,9,78,26,4243
"19079960100",1709,119,5,0,68,0,19,0,1920
"19079960200",3043,152,2,8,107,245,142,245,3944
"19079960300",2368,545,26,0,107,218,76,113,3453
"19079960400",4262,421,0,0,104,0,114,58,4959
"19079960500",1533,152,0,0,50,9,0,9,1753
"19081270100",3183,367,0,0,39,0,25,51,3665
"19081270200",2243,300,0,10,27,56,28,8,2672
"19081270300",2327,107,0,0,124,86,103,86,2833
"19081270400",1933,205,0,4,16,15,82,19,2274
"19083480100",2287,239,0,0,34,19,104,61,2744
"19083480200",1578,246,48,0,10,0,29,0,1911
"19083480300",3300,198,0,0,74,0,64,52,3688
"19083480400",2728,179,0,0,9,0,37,0,2953
"19083480500",2598,233,34,0,82,4,204,23,3178
"19083480600",2197,298,0,0,188,13,22,19,2737
"19085290100",2075,262,5,0,96,3,17,2,2460
"19085290200",3202,398,0,0,57,0,78,16,3751
"19085290300",2561,245,0,1,83,15,50,0,2955
"19085290400",2797,368,0,0,8,0,20,11,3204
"19085290500",2134,79,0,0,19,6,0,0,2238
"19087970100",3140,498,0,74,202,74,156,55,4199
"19087970200",2638,449,0,12,46,0,2,0,3147
"19087970300",2895,894,51,86,221,44,20,229,4440
"19087970400",3082,583,42,51,134,77,141,170,4280
"19087970500",3028,545,0,0,127,8,32,0,3740
"19089960100",3242,565,0,9,29,30,0,42,3917
"19089960200",2399,223,45,0,6,0,0,0,2673
"19089960300",2525,259,0,0,26,1,89,0,2900
"19091970100",2058,91,0,0,71,2,22,0,2244
"19091970200",1501,201,0,0,16,32,28,29,1807
"19091970300",2348,398,0,0,48,33,69,24,2920
"19091970400",2515,214,0,0,35,1,160,23,2948
"19093090100",2293,179,0,0,25,0,24,3,2524
"19093090200",1626,379,0,0,45,0,0,0,2050
"19093090300",1880,421,0,10,21,3,16,71,2422
"19095960100",3376,124,19,0,23,35,94,0,3671
"19095960200",3094,552,0,0,14,50,73,25,3808
"19095960300",3071,239,16,2,1,6,20,0,3355
"19095960400",4616,714,15,0,32,20,111,0,5508
"19097950100",2245,179,0,0,14,6,0,0,2444
"19097950200",3239,267,20,0,22,16,78,0,3642
"19097950300",3111,276,0,0,53,22,54,3,3519
"19097950400",3502,215,1,0,5,7,0,0,3730
"19097950500",3315,601,1,0,57,97,84,0,4155
"19097950600",1802,314,0,23,78,24,18,5,2264
"19099040100",3436,310,1,0,10,12,42,12,3823
"19099040200",3291,297,0,0,17,1,83,113,3802
"19099040300",1999,394,0,0,23,22,3,0,2441
"19099040400",3681,993,57,0,72,0,18,0,4821
"19099040500",4140,837,24,18,62,41,27,13,5162
"19099040600",2470,302,0,11,153,8,0,0,2944
"19099040700",4573,420,3,0,53,11,47,0,5107
"19099040800",3603,355,2,0,13,10,18,3,4004
"19099040900",2850,60,0,0,4,3,5,0,2922
"19101090100",2457,447,0,0,187,5,6,0,3102
"19101090200",3011,241,1,0,8,0,13,5,3279
"19101090300",3701,594,59,28,225,103,132,30,4872
"19101090400",3192,434,26,43,498,0,43,40,4276
"19103000100",3867,1138,50,97,436,37,313,117,6055
"19103000200",1774,306,145,66,178,44,137,0,2650
"19103000301",6889,343,266,16,913,20,200,100,8747
"19103000302",3269,643,833,280,579,228,280,133,6245
"19103000400",3544,664,205,638,1077,485,170,27,6810
"19103000500",5137,1086,81,164,1036,82,198,23,7807
"19103000600",1575,985,31,19,471,100,101,21,3303
"19103001100",1408,2017,67,35,15,180,10,56,3788
"19103001200",1748,159,5,19,42,24,100,0,2097
"19103001300",2627,214,0,0,205,0,132,0,3178
"19103001400",3539,268,142,133,246,55,171,0,4554
"19103001500",2225,307,49,0,95,66,26,62,2830
"19103001600",1507,4407,144,165,338,462,1,132,7156
"19103001700",2521,468,122,0,126,0,104,0,3341
"19103001801",3114,266,457,174,807,246,620,220,5904
"19103001802",2399,281,462,292,205,114,374,117,4244
"19103002100",296,1159,0,42,17,152,6,18,1690
"19103002300",1604,443,0,8,158,107,25,26,2371
"19103010100",6596,142,41,0,133,4,84,0,7000
"19103010200",4287,99,6,0,83,0,16,0,4491
"19103010301",8558,373,70,291,618,67,372,57,10406
"19103010302",10487,541,353,52,749,15,561,164,12922
"19103010400",5828,474,83,37,69,77,181,0,6749
"19103010500",5668,243,24,49,963,132,829,59,7967
"19105070100",3939,417,13,38,66,18,66,0,4557
"19105070300",3089,331,0,0,80,19,41,0,3560
"19105070400",4201,340,0,0,48,10,48,0,4647
"19105070500",2117,223,3,0,64,6,19,4,2436
"19105070600",3941,185,0,0,45,0,0,0,4171
"19107080100",1947,232,0,0,11,8,24,0,2222
"19107080200",2110,361,0,0,20,9,8,9,2517
"19107080300",2189,402,1,55,54,0,71,0,2772
"19107080400",2526,281,0,0,18,0,0,0,2825
"19109950100",2176,150,16,0,25,3,29,2,2401
"19109950200",2204,136,0,0,66,5,26,20,2457
"19109950300",1889,273,5,0,49,27,38,0,2281
"19109950400",2277,406,0,0,76,0,3,97,2859
"19109950500",2875,252,0,1,0,0,14,0,3142
"19109950600",2158,62,2,0,7,0,15,0,2244
"19111490100",3205,534,61,125,169,19,114,8,4235
"19111490200",3414,791,117,1,229,44,310,101,5007
"19111490300",1844,286,0,0,9,0,13,0,2152
"19111490400",2467,198,1,0,21,1,63,0,2751
"19111490500",3074,296,0,0,11,1,29,0,3411
"19111490600",3084,276,5,0,47,0,0,0,3412
"19111490700",3854,391,45,0,112,9,95,0,4506
"19111490800",1257,795,28,70,22,7,20,7,2206
"19111490900",1612,441,51,141,17,93,55,59,2469
"19111491000",1530,348,120,14,134,20,82,0,2248
"19111491100",2488,361,254,0,196,0,152,0,3451
"19113000100",11090,794,11,0,610,88,29,24,12646
"19113000201",4266,670,165,98,373,12,42,0,5626
"19113000203",6744,174,110,2,528,0,61,0,7619
"19113000205",3653,212,49,0,85,15,0,0,4014
"19113000206",6864,137,107,0,496,0,73,59,7736
"19113000207",3640,485,200,302,744,0,481,206,6058
"19113000300",4665,386,79,90,298,0,210,0,5728
"19113000400",4554,98,45,0,346,0,207,1,5251
"19113000500",5413,526,175,60,221,0,129,0,6524
"19113000600",2693,158,0,0,61,23,51,10,2996
"19113000700",1703,281,81,6,97,36,63,44,2311
"19113000800",3585,499,111,58,313,12,236,0,4814
"19113000901",4822,301,137,76,219,0,38,54,5647
"19113000902",5533,129,173,15,424,0,383,0,6657
"19113001001",3676,182,167,1,82,0,77,8,4193
"19113001002",2977,308,146,77,158,65,32,46,3809
"19113001003",4499,945,317,268,504,137,370,108,7148
"19113001101",3817,163,67,32,99,0,36,0,4214
"19113001102",2586,476,109,0,170,6,106,0,3453
"19113001200",980,160,140,20,92,0,75,0,1467
"19113001300",2465,140,83,193,169,60,0,42,3152
"19113001400",2950,327,5,65,106,0,54,0,3507
"19113001500",2686,95,4,25,106,8,35,0,2959
"19113001600",4739,289,73,0,141,0,72,0,5314
"19113001700",4050,265,893,280,829,123,221,13,6674
"19113001800",2447,436,226,161,77,27,8,0,3382
"19113001900",754,306,174,115,109,107,79,81,1725
"19113002200",885,230,82,170,56,162,52,88,1725
"19113002300",3021,587,95,0,99,79,24,0,3905
"19113002400",3141,113,68,244,184,0,96,2,3848
"19113002500",2443,343,83,51,55,0,27,0,3002
"19113002600",2040,260,104,30,95,153,93,0,2775
"19113002700",828,403,135,87,164,17,7,0,1641
"19113002800",3215,198,121,52,106,7,93,0,3792
"19113002900",3755,579,626,115,190,16,152,16,5449
"19113003001",7484,780,384,96,555,27,464,83,9873
"19113003002",4752,1439,23,141,368,105,148,82,7058
"19113010100",2527,295,0,0,10,0,4,15,2851
"19113010200",4050,249,34,6,44,0,10,0,4393
"19113010300",3378,253,0,0,76,0,11,24,3742
"19113010400",2615,138,0,0,47,0,0,0,2800
"19113010500",3347,429,0,0,86,9,54,0,3925
"19113010600",5973,132,3,0,4,0,39,1,6152
"19113010700",5720,80,6,0,117,0,84,0,6007
"19113010800",5485,478,0,12,294,52,108,18,6447
"19115450100",2605,266,8,4,69,11,192,62,3217
"19115450200",3151,381,28,20,458,133,1066,300,5537
"19115450300",3426,411,4,0,66,137,127,68,4239
"19117950100",1627,276,3,0,5,12,0,7,1930
"19117950200",2124,276,0,4,37,0,0,27,2468
"19117950300",1560,177,0,0,0,16,0,0,1753
"19117950400",1782,708,0,0,50,0,18,0,2558
"19119950100",2338,311,0,0,25,7,35,0,2716
"19119950200",3054,221,0,0,27,30,0,13,3345
"19119950300",4960,332,3,0,153,15,160,27,5650
"19121060100",5873,395,28,23,29,24,26,14,6412
"19121060200",4146,712,0,0,114,0,118,0,5090
"19121060300",3726,189,8,5,64,11,34,3,4040
"19123950100",2702,235,0,0,33,2,31,1,3004
"19123950200",3080,308,0,0,59,4,34,12,3497
"19123950300",3195,322,0,5,7,0,9,0,3538
"19123950400",2417,167,0,0,59,54,14,37,2748
"19123950500",2688,682,5,0,53,51,12,33,3524
"19123950600",2010,729,0,123,25,101,14,65,3067
"19123950700",1657,632,140,0,136,47,48,35,2695
"19125030100",6680,277,0,0,175,2,54,0,7188
"19125030200",5903,377,48,0,139,41,0,29,6537
"19125030300",1597,252,35,15,113,0,40,0,2052
"19125030401",3668,691,0,0,97,0,278,25,4759
"19125030402",3449,375,7,0,57,0,33,0,3921
"19125030500",1467,325,39,0,123,20,43,19,2036
"19125030600",2550,261,0,0,12,0,0,0,2823
"19125030700",2414,275,11,4,101,8,9,0,2822
"19127950100",2781,199,4,0,34,2,31,0,3051
"19127950200",2793,277,0,0,99,13,195,13,3390
"19127950300",3121,167,16,0,79,6,83,4,3476
"19127950400",2720,141,13,0,18,6,86,0,2984
"19127950500",2183,951,288,50,839,335,1581,714,6941
"19127950600",2706,592,87,0,624,276,964,315,5564
"19127950700",3154,523,35,0,417,89,694,151,5063
"19127950800",5748,130,0,0,530,0,475,21,6904
"19127950900",2825,359,0,0,431,120,1159,204,5098
"19127951000",2675,225,91,145,474,204,402,207,4423
"19129040100",2648,266,2,0,23,0,33,12,2984
"19129040201",1948,165,28,0,33,0,19,2,2195
"19129040202",3184,118,0,0,32,59,197,0,3590
"19129040301",2543,83,0,15,68,0,7,0,2716
"19129040302",3028,304,8,9,62,7,111,0,3529
"19131560100",3033,216,0,0,8,9,12,17,3295
"19131560200",3281,199,0,0,58,0,17,0,3555
"19131560300",3304,293,4,29,43,0,40,0,3713
"19133960100",2047,210,0,0,8,3,0,0,2268
"19133960200",1733,144,0,0,13,2,24,13,1929
"19133960300",2433,292,20,0,175,28,51,0,2999
"19133960400",1671,112,0,0,13,15,20,0,1831
"19135070100",2770,382,0,0,89,0,0,0,3241
"19135070200",2132,370,0,0,23,0,45,0,2570
"19135070300",1742,172,0,0,122,0,120,0,2156
"19137960100",1934,82,0,0,2,0,2,0,2020
"19137960200",2061,389,0,0,68,77,9,37,2641
"19137960300",2249,715,0,0,58,32,114,120,3288
"19137960400",2332,369,0,0,21,6,52,0,2780
"19139050100",2817,406,0,0,130,0,198,0,3551
"19139050200",4603,316,3,0,10,0,255,8,5195
"19139050300",3808,601,103,0,443,64,1524,394,6937
"19139050400",3525,599,5,0,108,8,407,133,4785
"19139050500",3519,848,130,60,152,12,361,239,5321
"19139050600",4394,407,70,24,151,11,116,57,5230
"19139050700",4129,652,67,0,410,14,702,237,6211
"19139050800",2444,579,59,14,309,12,867,15,4299
"19139050900",1959,467,30,0,179,84,198,63,2980
"19139051000",2001,726,0,0,401,145,777,282,4332
"19141490100",2107,553,0,3,103,87,160,121,3134
"19141490200",3205,305,0,0,25,51,26,52,3664
"19141490300",4478,282,10,0,192,13,99,0,5074
"19141490400",2170,224,0,18,51,32,41,42,2578
"19143460100",2743,342,0,2,191,0,273,87,3638
"19143460200",2720,179,17,3,2,10,40,2,2973
"19145490100",2244,325,0,0,29,0,4,0,2602
"19145490200",1747,463,0,0,103,77,107,0,2497
"19145490300",2342,318,0,0,178,50,121,47,3056
"19145490400",1935,330,24,20,64,5,3,5,2386
"19145490500",1961,244,10,0,8,0,0,38,2261
"19145490600",1911,206,6,0,36,0,53,14,2226
"19147960100",1645,117,0,0,15,3,14,26,1820
"19147960200",1815,98,29,0,16,1,20,1,1980
"19147960300",3281,423,0,0,23,6,52,16,3801
"19147960400",1296,156,0,0,57,20,2,0,1531
"19149970100",5592,332,37,0,308,93,206,80,6648
"19149970200",2943,318,34,0,161,69,178,177,3880
"19149970300",2864,198,23,0,0,0,3,9,3097
"19149970400",3065,132,0,0,56,0,18,0,3271
"19149970500",2867,156,0,0,22,0,14,19,3078
"19149970600",4909,273,0,0,110,0,73,10,5375
"19151780100",1515,323,49,9,24,41,6,38,2005
"19151780200",2503,355,11,4,2,22,34,26,2957
"19151780300",1931,238,11,0,19,10,62,27,2298
"19153000101",2032,715,329,176,140,111,81,9,3593
"19153000102",3078,299,125,38,231,22,344,105,4242
"19153000103",1652,225,23,0,23,164,69,0,2156
"19153000201",2163,59,26,10,334,35,512,0,3139
"19153000202",2595,481,222,7,252,23,232,192,4004
"19153000300",2136,374,330,35,453,113,480,213,4134
"19153000400",3415,236,345,16,673,139,753,27,5604
"19153000500",2867,504,362,166,380,413,596,201,5489
"19153000600",2959,457,55,114,334,56,332,247,4554
"19153000701",1210,150,416,603,560,112,211,76,3338
"19153000702",2185,153,305,241,206,10,46,0,3146
"19153000703",2443,302,64,35,100,8,92,0,3044
"19153000704",2505,40,180,10,167,46,324,0,3272
"19153000801",4605,306,431,70,442,77,255,18,6204
"19153000802",3118,119,44,0,36,17,106,0,3440
"19153000803",2747,189,75,108,478,64,137,8,3806
"19153000901",2513,233,127,40,531,0,52,22,3518
"19153000902",2568,218,91,78,65,8,28,12,3068
"19153001000",2846,518,173,15,152,185,158,34,4081
"19153001100",1755,552,454,710,255,326,714,290,5056
"19153001200",913,468,884,495,514,194,650,305,4423
"19153001500",2160,567,155,20,320,82,355,24,3683
"19153001700",993,274,605,292,502,45,813,104,3628
"19153001800",1464,272,103,7,183,7,44,35,2115
"19153001900",2773,751,175,51,37,187,110,269,4353
"19153002100",3093,752,100,230,466,307,751,210,5909
"19153002600",920,422,170,247,432,177,565,179,3112
"19153002700",1212,490,532,546,93,91,72,12,3048
"19153002800",2082,696,108,170,212,176,118,220,3782
"19153002900",2808,587,130,81,125,414,173,250,4568
"19153003001",1605,54,46,19,73,20,65,0,1882
"19153003002",3055,95,0,22,79,0,52,1,3304
"19153003100",1654,104,0,0,73,6,19,0,1856
"19153003200",2088,131,30,0,41,38,52,0,2380
"19153003901",1524,469,194,301,893,296,632,585,4894
"19153003902",3051,858,574,184,562,280,544,159,6212
"19153004001",2245,537,451,369,141,7,63,7,3820
"19153004004",2910,80,64,0,188,0,74,0,3316
"19153004100",2681,335,20,0,179,0,82,0,3297
"19153004200",1168,452,171,5,49,0,192,199,2236
"19153004300",4772,516,358,39,59,26,163,247,6180
"19153004400",2582,619,195,276,101,367,434,410,4984
"19153004501",2870,569,67,116,418,186,169,128,4523
"19153004502",2069,186,2,11,354,103,242,17,2984
"19153004602",4201,543,646,79,278,160,732,158,6797
"19153004603",2460,358,203,12,184,69,117,0,3403
"19153004701",3604,342,64,0,237,166,397,298,5108
"19153004702",1273,592,130,257,613,58,577,107,3607
"19153004800",1348,367,139,108,518,390,818,401,4089
"19153004900",785,540,209,198,406,25,294,423,2880
"19153005000",601,329,1061,499,886,170,605,232,4383
"19153005100",2394,828,330,276,180,209,364,137,4718
"19153005200",1890,774,260,223,362,149,929,260,4847
"19153005300",1626,470,189,25,337,2,204,0,2853
"19153010101",3985,198,0,0,15,17,10,5,4230
"19153010102",5630,133,0,0,183,0,123,0,6069
"19153010203",19435,750,119,0,1350,0,268,27,21949
"19153010205",5241,615,78,0,224,0,184,29,6371
"19153010207",3943,246,0,43,135,15,6,0,4388
"19153010208",3639,316,70,0,176,66,139,21,4427
"19153010209",5109,448,32,1,74,63,28,14,5769
"19153010211",3221,264,66,0,89,0,0,0,3640
"19153010212",3572,459,55,0,103,0,8,0,4197
"19153010404",3945,133,111,0,459,0,264,0,4912
"19153010405",5501,392,589,6,401,0,70,5,6964
"19153010406",3556,99,213,34,134,8,76,0,4120
"19153010407",4345,96,45,89,14,15,123,0,4727
"19153010408",3413,95,154,154,238,29,115,0,4198
"19153010409",3909,239,8,0,82,0,138,0,4376
"19153010500",4632,355,0,0,118,21,187,0,5313
"19153010600",6775,981,0,0,464,182,190,54,8646
"19153010702",4687,467,3,4,69,10,102,4,5346
"19153010703",3868,506,67,0,73,0,75,38,4627
"19153010705",4367,38,5,0,37,0,102,0,4549
"19153010706",5840,150,33,0,336,29,175,0,6563
"19153010802",7135,822,212,216,1278,31,586,200,10480
"19153010803",4159,169,193,140,245,90,170,105,5271
"19153010804",3958,276,30,0,275,0,220,244,5003
"19153011001",2542,407,132,51,181,17,494,136,3960
"19153011021",3936,134,174,0,143,10,97,0,4494
"19153011025",3473,37,16,0,289,0,38,0,3853
"19153011026",5491,93,0,0,131,0,217,0,5932
"19153011027",6207,359,360,2,625,15,411,26,8005
"19153011028",4068,242,0,16,551,0,208,0,5085
"19153011111",3956,342,174,66,422,350,298,209,5817
"19153011112",3644,169,53,0,90,51,240,0,4247
"19153011113",1608,73,227,67,193,98,28,0,2294
"19153011114",3035,192,204,160,1020,34,773,0,5418
"19153011201",4025,472,80,1,240,127,68,129,5142
"19153011203",3454,46,0,0,198,0,23,0,3721
"19153011205",2227,314,252,17,744,101,824,128,4607
"19153011206",3256,26,14,0,123,0,64,0,3483
"19153011300",13082,714,134,0,663,111,355,98,15157
"19153011404",5350,247,59,56,364,0,111,0,6187
"19153011500",5416,61,0,0,103,0,58,0,5638
"19153011600",0,0,0,0,0,0,0,0,0
"19153011701",7503,378,0,0,808,0,38,88,8815
"19153011702",2666,164,0,0,89,0,25,0,2944
"19155021200",2935,532,7,0,171,93,388,11,4137
"19155021400",3125,105,0,0,71,0,36,0,3337
"19155021501",2228,240,0,0,10,17,52,0,2547
"19155021502",2390,229,0,0,51,16,34,0,2720
"19155021602",2564,40,0,0,11,0,0,0,2615
"19155021603",2285,138,0,0,29,0,18,0,2470
"19155021701",1945,176,0,0,81,0,106,8,2316
"19155021702",1900,159,0,0,40,9,4,0,2112
"19155030100",5148,626,21,0,119,0,269,0,6183
"19155030200",2507,352,0,12,146,105,29,19,3170
"19155030300",2747,180,0,52,41,43,187,0,3250
"19155030401",2884,647,15,84,142,12,407,253,4444
"19155030402",2225,499,19,13,88,147,43,39,3073
"19155030501",1742,295,44,0,59,0,47,34,2221
"19155030502",2090,204,57,0,39,7,236,41,2674
"19155030601",1740,352,0,16,19,5,113,0,2245
"19155030602",1668,534,0,0,215,298,297,48,3060
"19155030700",2208,525,0,0,46,22,398,157,3356
"19155030800",2627,673,36,0,71,120,263,200,3990
"19155030900",1082,610,0,15,83,10,56,78,1934
"19155031000",1688,230,99,6,68,0,100,0,2191
"19155031100",2016,675,0,0,114,172,235,340,3552
"19155031200",2804,265,53,24,16,0,121,9,3292
"19155031300",2037,701,0,0,149,62,649,0,3598
"19155031400",2620,725,0,0,59,28,187,20,3639
"19155031601",4145,140,16,0,149,0,35,0,4485
"19155031602",2441,84,0,0,13,108,90,0,2736
"19155031700",3163,365,71,56,150,0,182,41,4028
"19155031800",2864,461,22,0,64,72,23,0,3506
"19155031900",3494,82,43,0,58,0,93,0,3770
"19157370100",2709,280,2,0,39,2,24,2,3058
"19157370200",2807,69,0,0,21,0,22,0,2919
"19157370300",3532,321,42,16,90,49,66,45,4161
"19157370400",2623,922,0,20,197,43,76,32,3913
"19157370500",2792,451,6,0,9,11,59,10,3338
"19159950100",1823,383,0,0,8,0,5,4,2223
"19159950200",2456,266,2,2,20,0,11,0,2757
"19161080100",2337,167,10,6,45,15,115,29,2724
"19161080200",2327,282,9,17,0,0,14,0,2649
"19161080300",2063,181,11,0,0,8,37,0,2300
"19161080400",2275,189,31,3,19,0,18,0,2535
"19163010101",3318,169,0,8,93,24,12,0,3624
"19163010102",6440,160,39,0,249,61,171,0,7120
"19163010201",5301,343,152,0,16,57,114,0,5983
"19163010202",5449,331,39,19,183,35,186,1,6243
"19163010300",2350,147,11,0,39,0,10,0,2557
"19163010401",4905,277,0,0,99,9,185,9,5484
"19163010402",3436,142,0,7,64,0,15,11,3675
"19163010600",738,640,305,306,156,108,143,77,2473
"19163010700",543,226,317,158,69,114,170,19,1616
"19163010800",1422,558,183,186,403,187,455,307,3701
"19163010900",919,246,73,43,112,151,234,27,1805
"19163011000",1267,640,58,122,128,78,382,48,2723
"19163011100",3006,208,69,0,68,0,203,49,3603
"19163011200",1173,456,309,70,185,6,143,79,2421
"19163011300",1280,471,479,345,428,75,43,19,3140
"19163011400",1214,562,300,351,170,240,64,146,3047
"19163011500",1286,257,479,0,100,127,138,68,2455
"19163011600",2640,588,153,11,58,441,11,301,4203
"19163011700",2716,167,8,147,139,29,258,47,3511
"19163011800",1667,322,0,0,76,0,138,0,2203
"19163011900",2066,108,118,59,54,26,92,0,2523
"19163012000",3246,182,175,90,73,31,262,17,4076
"19163012100",2970,305,171,62,289,33,375,146,4351
"19163012200",1879,325,114,0,60,10,230,48,2666
"19163012300",1207,175,24,152,50,22,219,52,1901
"19163012400",1083,177,5,0,38,0,24,21,1348
"19163012501",2595,323,306,329,294,34,376,11,4268
"19163012502",2765,412,206,13,138,2,213,165,3914
"19163012601",3820,660,462,272,123,97,93,3,5530
"19163012602",2542,703,298,629,230,101,121,87,4711
"19163012701",1917,455,295,55,500,0,111,0,3333
"19163012702",2598,136,38,73,80,96,116,1,3138
"19163012801",3079,381,603,349,166,53,215,0,4846
"19163012802",3275,423,644,130,227,0,457,0,5156
"19163012901",3242,530,342,39,68,39,57,68,4385
"19163012902",4457,235,212,158,173,70,414,0,5719
"19163013000",4193,256,204,56,161,4,115,9,4998
"19163013100",1568,123,13,0,16,0,61,0,1781
"19163013200",1526,54,3,0,120,0,65,0,1768
"19163013300",2947,326,87,76,21,0,36,0,3493
"19163013400",2734,286,0,0,23,6,9,33,3091
"19163013500",2684,261,236,148,68,16,65,0,3478
"19163013600",2316,109,53,0,55,0,105,0,2638
"19163013702",5135,204,76,0,528,60,70,0,6073
"19163013703",2595,0,0,0,115,8,163,0,2881
"19163013705",3903,374,153,1,457,2,286,1,5177
"19163013706",3662,97,165,0,351,0,163,0,4438
"19165960100",2756,206,0,0,40,0,10,19,3031
"19165960200",2738,249,0,3,57,0,5,1,3053
"19165960300",2975,214,0,0,210,47,153,42,3641
"19165960400",1711,555,20,0,0,0,0,0,2286
"19167070100",3486,245,0,0,56,6,144,35,3972
"19167070200",3657,265,5,0,169,46,189,77,4408
"19167070300",5099,529,39,0,96,0,104,41,5908
"19167070400",3189,418,7,0,249,199,379,473,4914
"19167070500",2621,79,24,0,74,73,106,74,3051
"19167070600",4282,360,16,0,301,0,288,94,5341
"19167070700",5134,284,4,21,433,67,723,204,6870
"19169000100",8869,534,293,0,1262,114,550,0,11622
"19169000200",2880,149,154,13,162,56,120,0,3534
"19169000300",2546,459,83,0,133,148,44,33,3446
"19169000400",2064,178,0,0,162,25,11,0,2440
"19169000500",315,1325,47,151,308,464,17,73,2700
"19169000600",3536,574,147,56,212,13,67,39,4644
"19169000700",1345,1674,15,4,184,302,12,34,3570
"19169000800",0,4,0,0,0,0,0,0,4
"19169000900",2683,430,79,92,156,46,35,2,3523
"19169001000",1989,979,117,117,452,740,12,102,4508
"19169001100",1521,2076,43,0,197,195,62,20,4114
"19169001200",60,7,0,0,0,0,0,0,67
"19169001301",4748,3304,100,177,850,247,143,185,9754
"19169001302",3447,647,107,71,272,10,87,125,4766
"19169010100",6621,412,11,0,71,2,148,6,7271
"19169010200",3515,302,0,0,79,15,60,9,3980
"19169010300",3740,355,19,0,113,14,0,0,4241
"19169010400",2628,230,26,6,20,0,256,0,3166
"19169010500",1642,170,3,0,66,22,0,0,1903
"19169010600",4951,297,10,27,128,17,56,25,5511
"19171290100",2818,182,16,0,42,0,16,5,3079
"19171290200",2711,190,0,0,21,0,87,5,3014
"19171290300",2344,138,15,0,36,24,3,5,2565
"19171290400",1772,430,4,2,306,84,210,204,3012
"19171290500",1884,556,0,2,818,242,363,306,4171
"19171290600",2203,80,0,0,234,39,99,13,2668
"19173180100",1719,371,0,0,81,34,225,121,2551
"19173180200",1688,268,4,2,36,60,15,46,2119
"19173180300",1693,146,0,0,9,3,0,0,1851
"19175190100",1920,319,10,0,20,0,68,21,2358
"19175190200",2845,918,11,111,18,18,75,0,3996
"19175190300",1995,107,0,0,4,0,0,0,2106
"19175190400",3380,501,31,0,45,0,86,0,4043
"19177950100",3347,741,0,4,15,6,60,13,4186
"19177950200",2749,449,15,0,55,24,10,0,3302
"19179960100",2710,259,28,19,5,58,134,9,3222
"19179960200",1510,625,13,0,324,56,508,44,3080
"19179960300",3428,142,26,0,114,0,141,0,3851
"19179960400",2475,727,75,40,207,194,400,134,4252
"19179960500",1372,866,93,50,109,0,246,346,3082
"19179960600",2255,373,0,0,226,0,338,57,3249
"19179960700",2840,571,0,0,69,0,95,174,3749
"19179960800",2398,592,0,16,110,37,144,0,3297
"19179960900",1999,728,21,84,158,121,222,103,3436
"19179961000",2721,588,0,0,48,5,38,80,3480
"19179961100",2494,426,7,0,79,5,16,7,3034
"19181020100",1938,132,31,0,14,0,46,6,2167
"19181020200",6666,230,0,0,153,20,252,20,7341
"19181020300",4377,137,0,0,190,0,26,0,4730
"19181020400",3766,205,0,126,33,41,29,0,4200
"19181020500",2122,143,0,0,40,0,38,0,2343
"19181020600",2674,99,0,0,55,0,0,9,2837
"19181020700",3102,304,0,0,100,92,64,104,3766
"19181020800",2652,113,0,0,0,0,36,0,2801
"19181020900",2873,458,41,22,103,0,60,0,3557
"19181021000",2408,475,0,0,0,0,0,0,2883
"19181021100",4479,353,0,0,91,13,87,30,5053
"19181021200",3604,295,0,0,92,0,57,16,4064
"19183960100",5716,673,8,0,58,17,21,0,6493
"19183960200",4176,387,3,3,31,9,59,0,4668
"19183960300",2626,496,13,28,243,22,330,7,3765
"19183960400",3029,240,102,0,309,24,347,7,4058
"19183960500",2880,182,0,0,95,8,178,84,3427
"19185070100",2123,232,4,0,14,11,51,0,2435
"19185070200",1442,148,0,0,28,7,19,0,1644
"19185070300",1865,342,0,0,6,34,0,0,2247
"19187000100",5687,404,61,0,92,0,74,12,6330
"19187000200",3144,332,25,0,201,0,44,0,3746
"19187000300",1022,304,0,0,4,54,13,84,1481
"19187000400",1612,457,113,175,65,160,108,172,2862
"19187000500",1143,476,0,105,85,0,104,70,1983
"19187000600",3525,931,83,0,335,54,218,0,5146
"19187000700",757,496,58,94,41,14,41,232,1733
"19187000900",1911,356,31,158,70,24,19,108,2677
"19187010100",2060,92,0,0,59,0,44,0,2255
"19187010200",1740,76,8,0,0,0,0,0,1824
"19187010300",2841,354,49,0,64,3,42,9,3362
"19187010400",2781,450,0,0,0,5,4,12,3252
"19189680100",3432,432,9,0,100,4,88,0,4065
"19189680200",2522,215,0,5,34,0,46,0,2822
"19189680300",2811,464,33,0,107,42,128,96,3681
"19191950100",3231,208,0,0,36,35,19,14,3543
"19191950200",2947,438,66,0,58,0,15,0,3524
"19191950300",3270,222,23,0,15,50,85,25,3690
"19191950400",4268,239,0,0,132,4,188,0,4831
"19191950500",2951,313,19,55,34,4,66,0,3442
"19193000100",2654,671,75,0,837,185,740,244,5406
"19193000200",5270,660,0,24,399,359,286,464,7462
"19193000300",5404,224,105,35,700,235,700,170,7573
"19193000400",4094,185,21,0,279,114,282,0,4975
"19193000500",2461,249,6,0,237,4,0,0,2957
"19193000600",2334,319,8,0,18,16,39,16,2750
"19193000700",1953,451,0,18,145,230,298,143,3238
"19193000800",1830,477,259,179,593,423,616,596,4973
"19193000900",1782,74,22,0,12,5,221,5,2121
"19193001000",776,212,187,48,449,21,223,0,1916
"19193001100",2478,880,156,11,475,428,806,884,6118
"19193001200",969,388,114,23,962,566,951,615,4588
"19193001300",527,303,79,114,217,103,333,110,1786
"19193001400",2363,829,215,117,1119,252,1667,363,6925
"19193001500",673,407,201,27,505,400,204,295,2712
"19193001800",4086,809,59,0,435,434,660,336,6819
"19193001900",2541,231,17,1,143,11,165,5,3114
"19193002000",4022,352,101,0,53,106,216,135,4985
"19193002101",2738,98,0,0,89,0,0,0,2925
"19193002102",5609,150,22,0,271,0,223,50,6325
"19193003100",3465,616,0,0,84,23,40,24,4252
"19193003200",4382,294,15,2,89,0,61,0,4843
"19193003300",5640,899,0,0,288,0,78,0,6905
"19193003500",3636,171,30,0,40,57,15,0,3949
"19193003600",997,734,263,30,551,248,470,410,3703
"19193940200",0,0,0,0,0,0,0,0,0
"19195690100",1940,327,0,35,13,28,66,0,2409
"19195690200",2017,176,0,0,30,0,55,0,2278
"19195690300",2522,279,0,0,41,11,36,11,2900
"19197680100",3070,251,0,0,46,8,106,66,3547
"19197680200",1479,73,2,0,12,18,0,24,1608
"19197680300",2465,505,15,5,125,39,153,208,3515
"19197680400",1083,75,0,0,44,22,65,15,1304
"19197680500",2990,357,15,0,103,65,338,269,4137
"20001952600",1782,269,0,1,27,8,28,0,2115
"20001952700",1661,380,0,0,71,5,24,0,2141
"20001952800",2756,376,28,65,128,95,30,22,3500
"20001952900",1744,737,69,0,65,29,43,0,2687
"20001953000",2125,184,21,0,158,25,149,36,2698
"20003953600",3979,579,0,1,214,79,11,2,4865
"20003953700",2658,330,2,2,12,16,1,0,3021
"20005081600",3897,393,20,3,86,35,93,2,4529
"20005081700",3659,412,333,27,126,61,71,71,4760
"20005081800",2187,620,85,66,30,3,36,0,3027
"20005081900",2231,1033,163,8,215,33,8,0,3691
"20007968100",2674,259,7,1,46,36,46,33,3102
"20007968200",1521,197,0,1,84,18,47,6,1874
"20009971100",3449,429,0,18,53,42,167,0,4158
"20009971200",1652,99,2,0,21,0,4,0,1778
"20009971300",2688,281,0,2,37,14,0,15,3037
"20009971400",2101,201,94,7,155,11,163,9,2741
"20009971500",2823,496,50,0,104,9,121,67,3670
"20009971600",3223,457,0,84,119,4,192,45,4124
"20009971700",2113,498,43,24,562,176,1182,452,5050
"20009971800",3848,577,0,0,152,323,654,635,6189
"20011955600",2115,455,18,0,35,11,52,0,2686
"20011955700",2041,224,0,5,111,61,5,1,2448
"20011955800",2549,340,74,0,21,0,65,1,3050
"20011955900",2813,671,16,254,85,117,48,89,4093
"20011956000",1809,675,61,0,40,8,0,40,2633
"20013480600",1828,324,35,10,483,317,38,57,3092
"20013480700",2468,683,33,16,169,23,114,16,3522
"20013480800",2673,426,39,5,192,56,53,52,3496
"20015020100",4657,344,0,0,128,9,102,11,5251
"20015020201",5582,729,0,0,187,25,223,0,6746
"20015020202",7091,248,295,0,269,0,305,41,8249
"20015020203",5731,114,0,0,364,0,256,16,6481
"20015020300",2939,142,29,0,210,10,190,0,3520
"20015020400",1854,419,37,24,72,138,92,63,2699
"20015020500",4408,1154,0,0,121,9,245,0,5937
"20015020600",6234,613,52,0,378,14,124,10,7425
"20015020700",3473,329,0,0,205,64,127,32,4230
"20015020800",2239,374,24,56,294,123,206,73,3389
"20015020901",3754,142,34,0,241,7,176,0,4354
"20015020902",3663,10,0,0,203,0,185,0,4061
"20015020903",3359,277,0,0,113,0,35,15,3799
"20017960600",2220,340,10,0,49,4,73,0,2696
"20019964600",2693,459,9,0,268,75,45,45,3594
"20021958100",2231,318,0,0,216,111,6,0,2882
"20021958200",1540,464,0,0,103,72,23,15,2217
"20021958300",2844,656,0,8,241,160,66,75,4050
"20021958400",2890,534,60,11,206,83,19,0,3803
"20021958500",3170,578,8,0,33,8,209,0,4006
"20021958600",3083,781,0,0,516,79,15,0,4474
"20023950200",2335,284,0,0,30,13,131,24,2817
"20025967100",1775,174,9,6,75,91,121,98,2349
"20027458100",3345,391,71,0,22,14,43,9,3895
"20027458200",3545,759,39,0,146,0,112,24,4625
"20029977100",2089,219,0,10,13,0,7,0,2338
"20029977200",1701,354,3,0,23,52,0,16,2149
"20029977300",2355,545,0,7,20,27,155,76,3185
"20029977400",1160,216,0,4,19,0,8,5,1412
"20031966100",2361,265,19,5,95,0,0,45,2790
"20031966200",2677,145,3,0,47,21,18,0,2911
"20031966300",2367,292,0,14,37,24,115,0,2849
"20033967600",1666,107,0,0,53,11,77,0,1914
"20035493100",2414,373,0,0,98,5,124,5,3019
"20035493200",2490,355,0,0,86,41,66,43,3081
"20035493300",2467,167,18,0,17,15,134,0,2818
"20035493400",1793,338,55,0,251,0,45,0,2482
"20035493500",2754,704,102,62,238,140,255,107,4362
"20035493600",2820,622,45,3,524,153,188,80,4435
"20035493700",2519,614,91,0,163,47,404,94,3932
"20035493800",2926,548,157,189,148,252,246,329,4795
"20035493900",2799,354,36,0,325,0,108,72,3694
"20035494000",1225,394,0,0,230,243,110,244,2446
"20035494100",1215,287,0,33,165,86,370,120,2276
"20037956600",3302,852,20,0,82,41,25,21,4343
"20037956700",3224,417,5,0,97,4,32,10,3789
"20037956800",2613,255,2,8,148,83,102,66,3277
"20037956900",3435,458,0,0,85,85,297,0,4360
"20037957000",2588,626,39,14,87,16,97,149,3616
"20037957100",1516,817,34,14,190,152,163,220,3106
"20037957200",2044,261,10,0,71,8,86,31,2511
"20037957300",1987,640,27,41,124,16,76,0,2911
"20037957400",1883,261,28,44,18,21,171,0,2426
"20037957500",1118,738,71,34,365,105,76,31,2538
"20037957600",4160,1470,216,91,63,109,27,62,6198
"20039951100",896,105,0,0,4,1,0,0,1006
"20039951200",1575,178,17,0,44,0,18,9,1841
"20041084100",3469,485,0,0,167,21,81,7,4230
"20041084200",2002,250,0,0,116,0,93,13,2474
"20041084300",2040,110,23,1,56,92,86,1,2409
"20041084400",4224,529,28,0,162,27,174,43,5187
"20041084500",2748,180,3,0,53,11,95,21,3111
"20041084600",1966,395,8,0,153,15,151,50,2738
"20043020100",1502,232,8,1,124,15,50,0,1932
"20043020200",1860,159,2,0,25,4,21,0,2071
"20043020300",2697,365,44,85,73,30,76,23,3393
"20045000100",2348,219,102,0,44,17,104,0,2834
"20045000200",4153,964,110,79,563,249,455,43,6616
"20045000300",1849,3581,134,21,135,38,130,138,6026
"20045000400",142,145,0,16,259,59,29,9,659
"20045000501",2005,458,242,32,235,304,42,64,3382
"20045000502",2430,1304,12,40,279,125,203,11,4404
"20045000603",4923,368,227,7,640,34,116,48,6363
"20045000604",3325,722,94,0,297,37,147,0,4622
"20045000702",4023,1513,238,208,596,173,602,63,7416
"20045000797",4051,462,108,28,339,60,313,0,5361
"20045000801",3342,818,368,70,880,226,168,98,5970
"20045000802",3751,1565,113,44,398,117,422,488,6898
"20045000901",2661,1373,346,35,803,482,501,260,6461
"20045000902",1309,237,180,68,274,115,41,24,2248
"20045001001",1428,221,57,5,192,36,30,14,1983
"20045001002",3949,634,388,20,685,152,326,11,6165
"20045001201",1546,67,8,8,29,0,42,0,1700
"20045001202",6511,456,0,0,262,0,97,0,7326
"20045001203",5370,438,0,0,166,53,31,24,6082
"20045001400",4224,275,40,0,151,41,61,0,4792
"20045001500",1979,198,48,0,101,18,47,2,2393
"20045001600",7109,449,266,50,790,83,203,48,8998
"20047969600",1190,167,0,0,64,19,250,66,1756
"20047969700",1234,184,1,0,38,3,154,83,1697
"20049965100",2093,486,13,0,108,16,55,31,2802
"20051072600",2437,272,0,0,39,4,60,66,2878
"20051072701",4654,935,83,7,47,23,0,200,5949
"20051072702",2337,302,2,0,4,2,46,0,2693
"20051072800",6292,804,96,0,223,263,144,340,8162
"20051072900",3361,1451,20,0,453,180,355,99,5919
"20051073000",2983,171,20,4,24,30,38,0,3270
"20053086600",1823,90,4,0,33,0,107,16,2073
"20053086700",3091,262,1,18,76,0,61,0,3509
"20055960100",3724,291,27,0,200,9,684,16,4951
"20055960200",4422,994,203,106,918,33,3285,712,10673
"20055960300",2102,302,7,2,181,44,899,122,3659
"20055960401",1387,12,28,0,193,144,263,144,2171
"20055960403",1902,198,0,0,442,14,870,81,3507
"20055960404",2107,295,138,0,408,219,786,49,4002
"20055960501",1703,328,0,0,326,32,1375,290,4054
"20055960503",991,14,0,0,103,134,183,145,1570
"20055960505",965,337,0,0,183,56,617,355,2513
"20055960507",966,353,4,0,290,9,459,221,2302
"20055960508",1205,273,0,0,593,204,1150,462,3887
"20055960600",3767,1077,71,68,820,242,3078,952,10075
"20057961600",1901,136,0,0,40,7,229,5,2318
"20057961700",1840,234,3,5,60,31,139,24,2336
"20057961800",6125,898,59,13,815,0,3286,307,11503
"20057961900",6438,1206,13,75,474,363,3763,1033,13365
"20057962000",3721,856,0,0,339,180,2317,720,8133
"20057962101",2790,689,260,63,669,32,2817,543,7863
"20057962102",2372,248,0,73,348,76,2110,257,5484
"20059954100",5734,627,7,44,357,58,68,3,6898
"20059954200",1814,821,50,6,43,11,85,11,2841
"20059954300",4044,480,17,20,425,161,282,161,5590
"20059954400",3827,443,6,55,105,36,166,25,4663
"20059954500",5248,504,7,0,141,10,69,5,5984
"20061000100",1245,420,184,94,355,117,298,113,2826
"20061000200",1506,575,644,101,425,128,371,306,4056
"20061000300",2794,404,952,74,756,176,378,40,5574
"20061000400",4061,473,1217,126,575,47,618,86,7203
"20061000500",1293,288,336,35,464,105,145,133,2799
"20061000600",4055,563,449,44,656,74,1155,0,6996
"20061000700",1974,178,303,43,306,26,212,17,3059
"20061000800",4212,90,1041,0,699,32,713,32,6819
"20063955100",1493,198,8,1,22,2,7,7,1738
"20063955200",946,78,7,0,13,7,10,1,1062
"20065952100",781,109,12,25,19,3,0,0,949
"20065952200",1370,111,33,20,68,21,52,15,1690
"20067963600",1274,109,0,0,15,38,131,103,1670
"20067963700",4769,545,0,0,714,323,2670,610,9631
"20069962600",2238,476,0,0,68,3,343,273,3401
"20069962700",2822,164,0,0,116,20,243,20,3385
"20071958100",1077,47,0,5,35,12,165,12,1353
"20073965600",1664,398,0,2,31,12,93,84,2284
"20073965700",2256,283,0,0,47,24,52,0,2662
"20073965800",1346,308,0,0,72,15,0,0,1741
"20075958600",2127,289,0,0,206,6,614,142,3384
"20077961600",1576,284,0,2,36,10,117,69,2094
"20077961700",1192,191,0,0,76,5,77,29,1570
"20077961800",1904,410,0,0,28,51,6,23,2422
"20079030100",2809,887,27,42,478,231,428,219,5121
"20079030200",5084,522,138,0,135,16,549,64,6508
"20079030300",4443,471,9,23,262,113,800,238,6359
"20079030400",3426,783,133,5,260,43,670,237,5557
"20079030500",5161,320,4,0,118,54,164,0,5821
"20079030600",6375,694,54,0,117,69,266,10,7585
"20081463100",3126,334,0,0,617,100,923,226,5326
"20083461100",1802,95,0,0,18,4,192,0,2111
"20085082600",4813,315,3,0,226,50,84,26,5517
"20085082700",2984,363,37,59,142,89,125,36,3835
"20085082800",2817,173,15,16,898,174,156,49,4298
"20087020101",5775,184,28,0,319,3,110,0,6419
"20087020102",2368,325,3,3,127,6,118,0,2950
"20087020200",3539,363,0,0,79,14,52,7,4054
"20087020300",4778,535,9,0,110,3,73,3,5511
"20089576100",892,184,0,3,6,3,2,24,1114
"20089576200",1718,146,0,0,27,43,21,16,1971
"20091050000",4540,175,21,1,173,3,405,30,5348
"20091050100",3270,312,84,0,175,24,237,13,4115
"20091050200",2988,274,115,37,220,0,343,0,3977
"20091050301",2839,543,99,51,400,246,406,320,4904
"20091050302",1254,67,0,11,87,0,61,0,1480
"20091050400",3528,856,128,71,252,262,291,388,5776
"20091050500",2250,122,41,7,123,0,248,0,2791
"20091050600",4228,99,64,1,137,2,353,2,4886
"20091050700",4705,99,33,0,94,49,124,35,5139
"20091050800",2431,155,0,0,53,0,49,0,2688
"20091050900",4299,57,23,56,27,0,126,9,4597
"20091051000",3493,77,0,3,169,0,118,0,3860
"20091051100",3087,26,153,37,247,5,582,3,4140
"20091051200",3243,536,100,0,190,104,335,36,4544
"20091051300",3285,253,141,0,267,149,164,37,4296
"20091051400",2995,31,0,0,75,0,40,16,3157
"20091051500",3402,231,136,16,122,32,213,0,4152
"20091051600",5008,138,19,0,60,15,18,20,5278
"20091051700",4159,184,14,0,144,0,70,0,4571
"20091051801",3175,92,0,0,165,0,25,0,3457
"20091051802",5191,236,147,0,783,133,960,37,7487
"20091051803",3588,240,60,0,199,23,108,57,4275
"20091051804",3672,749,225,0,301,0,530,453,5930
"20091051805",4655,182,157,0,270,22,303,46,5635
"20091051806",4333,94,53,23,157,17,133,0,4810
"20091051902",3417,148,283,16,196,89,209,0,4358
"20091051903",2005,182,540,0,177,10,306,9,3229
"20091051904",4678,371,203,0,239,13,134,0,5638
"20091051906",3937,295,449,200,475,170,1009,82,6617
"20091051907",2242,516,646,12,397,44,237,258,4352
"20091051908",1228,23,27,301,65,0,5,0,1649
"20091051909",4814,165,74,53,463,52,218,0,5839
"20091052001",1587,241,194,8,144,64,116,0,2354
"20091052003",4767,716,219,120,533,122,872,247,7596
"20091052004",1173,282,158,4,24,0,141,160,1942
"20091052101",1718,101,120,0,38,0,111,0,2088
"20091052102",2314,229,139,12,33,2,235,0,2964
"20091052201",2417,391,359,211,283,37,223,60,3981
"20091052202",3056,38,133,0,103,0,220,6,3556
"20091052303",5563,374,323,110,583,116,649,73,7791
"20091052304",3789,331,180,0,213,36,121,48,4718
"20091052305",4184,172,11,11,106,70,574,0,5128
"20091052306",3054,107,117,0,223,68,78,0,3647
"20091052405",5340,640,454,16,694,24,811,306,8285
"20091052410",4435,196,76,0,263,0,165,0,5135
"20091052411",2877,31,72,0,295,20,142,0,3437
"20091052414",3787,56,82,0,155,22,139,0,4241
"20091052415",2610,51,299,0,220,0,63,0,3243
"20091052416",4162,637,34,14,64,1,339,158,5409
"20091052417",2009,451,315,146,386,20,461,247,4035
"20091052418",1971,679,238,169,264,11,209,274,3815
"20091052419",3204,1002,483,31,351,31,240,502,5844
"20091052421",3438,101,30,0,128,0,48,0,3745
"20091052502",1456,23,0,0,117,0,23,0,1619
"20091052504",3429,353,477,0,531,89,87,165,5131
"20091052601",6637,221,232,0,516,0,106,0,7712
"20091052603",14806,350,598,38,893,48,272,48,17053
"20091052604",1446,42,7,0,24,0,91,0,1610
"20091052606",1577,132,105,0,175,16,150,13,2168
"20091052607",1926,49,8,0,17,1,33,8,2042
"20091052700",5788,837,38,118,382,150,617,149,8079
"20091052801",8669,52,444,0,497,21,582,0,10265
"20091052802",7443,20,92,0,878,31,679,0,9143
"20091052803",2520,159,686,7,340,45,560,30,4347
"20091052904",2738,202,275,0,176,10,252,50,3703
"20091052905",2340,626,374,107,551,0,851,470,5319
"20091052906",3558,338,381,39,251,418,414,46,5445
"20091052907",2856,299,387,83,405,223,298,174,4725
"20091052908",4863,671,211,2,286,13,716,529,7291
"20091052910",2943,203,120,0,535,13,276,0,4090
"20091053002",4079,141,189,68,476,0,149,18,5120
"20091053004",3017,88,325,14,106,9,258,0,3817
"20091053005",1063,55,240,7,243,5,14,0,1627
"20091053006",2690,257,76,15,334,50,42,18,3482
"20091053007",4222,124,328,57,343,10,269,37,5390
"20091053008",3695,299,373,0,365,46,193,14,4985
"20091053009",3880,117,141,50,280,29,115,0,4612
"20091053010",4166,31,39,0,442,76,39,44,4837
"20091053011",1793,69,74,0,292,0,27,18,2273
"20091053101",3258,77,161,20,346,40,222,9,4133
"20091053102",3401,138,225,8,628,29,245,0,4674
"20091053105",1937,223,377,77,766,94,412,30,3916
"20091053108",2889,269,156,0,922,0,153,0,4389
"20091053109",1453,3,142,0,817,0,99,0,2514
"20091053110",3122,99,43,0,604,0,182,0,4050
"20091053201",1807,20,33,0,122,0,22,0,2004
"20091053202",2720,120,135,31,91,39,50,0,3186
"20091053203",3705,132,244,0,841,1,148,1,5072
"20091053301",4805,164,73,0,325,56,57,0,5480
"20091053302",6614,133,0,0,371,14,127,0,7259
"20091053403",2863,85,333,0,547,0,493,35,4356
"20091053406",7292,338,326,2,957,4,259,96,9274
"20091053409",2866,110,66,150,263,0,61,0,3516
"20091053410",8839,191,348,52,876,35,598,0,10939
"20091053411",4106,143,60,9,290,0,96,0,4704
"20091053413",3249,19,131,0,548,0,0,0,3947
"20091053414",2522,57,78,0,863,151,56,0,3727
"20091053415",2582,43,25,0,691,14,71,0,3426
"20091053417",3290,9,74,0,711,0,125,0,4209
"20091053418",2648,139,23,0,731,0,319,0,3860
"20091053419",1353,23,7,15,88,0,12,0,1498
"20091053421",2846,115,379,0,618,0,61,0,4019
"20091053422",2043,12,89,0,123,0,63,0,2330
"20091053423",4758,65,0,0,552,25,150,10,5560
"20091053424",3673,44,0,0,215,60,12,0,4004
"20091053502",1694,351,144,3,276,28,197,170,2863
"20091053505",6434,117,220,57,827,32,571,0,8258
"20091053506",3389,161,41,31,196,0,236,15,4069
"20091053507",4609,229,276,1,281,0,160,0,5556
"20091053508",5490,301,220,0,293,92,160,101,6657
"20091053509",5517,395,383,0,663,0,279,195,7432
"20091053510",4899,39,57,0,616,0,661,0,6272
"20091053555",1397,372,98,30,15,12,149,59,2132
"20091053556",1989,414,96,18,195,188,983,440,4323
"20091053557",1243,460,14,38,81,121,148,105,2210
"20091053601",1459,196,224,0,448,159,662,302,3450
"20091053602",4395,626,297,0,797,65,615,256,7051
"20091053701",2012,310,0,1,70,23,92,8,2516
"20091053703",2225,43,282,0,250,0,141,0,2941
"20091053705",2838,151,41,4,45,77,196,0,3352
"20091053707",3853,292,84,0,414,0,157,0,4800
"20091053709",4825,163,45,0,273,0,184,43,5533
"20091053711",2972,140,0,0,237,0,225,0,3574
"20091053712",3713,8,9,0,172,0,309,0,4211
"20091053801",5043,267,22,40,89,0,13,0,5474
"20091053803",3283,171,0,0,82,0,128,0,3664
"20091053804",2186,14,25,0,27,0,101,0,2353
"20091980001",0,0,0,0,0,0,0,0,0
"20091980002",0,0,0,0,0,0,0,0,0
"20091980003",0,0,0,0,0,0,0,0,0
"20093959100",3093,332,3,0,377,60,878,265,5008
"20095961100",2178,222,8,0,52,0,6,0,2466
"20095961200",2713,510,0,0,79,18,157,7,3484
"20095961300",1603,191,2,4,20,8,34,0,1862
"20097969100",2013,272,0,0,50,16,73,33,2457
"20099950100",2316,247,167,32,205,92,46,31,3136
"20099950200",1543,316,142,79,101,12,97,24,2314
"20099950300",2117,337,77,46,55,57,62,74,2825
"20099950400",2546,539,142,25,182,33,108,161,3736
"20099950500",2958,331,0,1,409,18,160,4,3881
"20099950600",1860,256,0,0,96,148,50,0,2410
"20099950700",1608,219,13,19,123,23,36,14,2055
"20099950800",855,314,18,0,86,48,0,7,1328
"20101956600",1343,140,1,0,77,23,97,10,1691
"20103070100",837,496,95,184,299,15,176,30,2132
"20103070200",1679,430,195,148,86,219,117,35,2909
"20103070300",4744,229,497,19,203,70,211,0,5973
"20103070400",2369,380,248,66,302,71,173,71,3680
"20103070500",2389,812,519,437,198,318,159,0,4832
"20103070700",3659,212,386,142,377,11,253,6,5046
"20103070900",2637,293,30,0,177,32,119,0,3288
"20103071000",3514,197,46,0,155,17,95,0,4024
"20103071101",7116,481,640,65,695,0,507,0,9504
"20103071102",2354,273,60,52,348,125,19,7,3238
"20103071202",3189,124,21,0,114,0,72,20,3540
"20103071203",6169,518,117,0,174,55,154,138,7325
"20103071400",3366,209,0,0,56,0,100,0,3731
"20103071600",2406,104,0,0,15,0,0,0,2525
"20103071800",5514,386,0,0,306,0,341,0,6547
"20103981900",4036,249,571,22,464,146,486,163,6137
"20105086100",2657,376,0,3,47,17,34,38,3172
"20107955100",4485,589,46,2,121,11,125,25,5404
"20107955200",3439,607,3,0,111,10,28,0,4198
"20109954600",2220,326,0,0,154,21,16,12,2749
"20111000100",2209,634,32,88,708,238,1092,65,5066
"20111000200",5652,1030,82,70,185,93,958,111,8181
"20111000300",3398,1147,77,0,626,87,1364,494,7193
"20111000400",1420,1030,58,0,90,250,183,116,3147
"20111000500",3139,883,29,20,397,170,1399,599,6636
"20111000600",1935,205,0,0,92,73,123,0,2428
"20111000700",2138,434,8,0,46,38,87,104,2855
"20111000800",3195,346,10,4,76,5,58,4,3698
"20113788100",2678,320,13,4,158,0,4,4,3181
"20113788200",2766,185,0,46,49,13,233,10,3302
"20113788300",2572,343,5,0,56,2,77,43,3098
"20113788400",5667,356,45,0,113,27,135,41,6384
"20113788500",1330,139,4,17,68,2,107,7,1674
"20113788600",4586,400,80,1,275,44,256,35,5677
"20113788700",4992,365,3,0,65,23,39,6,5493
"20115489500",1591,242,2,1,19,18,14,1,1888
"20115489600",2946,260,38,7,61,6,78,2,3398
"20115489700",2202,397,0,0,10,17,11,92,2729
"20115489800",3169,408,0,18,179,20,103,13,3910
"20117040701",1668,86,0,0,25,0,10,0,1789
"20117060510",2932,422,0,8,76,65,111,0,3614
"20117070182",1768,394,4,0,53,0,40,11,2270
"20117090186",2083,227,0,0,32,2,33,2,2379
"20119966600",2108,254,0,18,378,11,467,96,3332
"20119966700",1448,91,5,30,8,12,71,0,1665
"20121100100",3344,117,129,7,58,0,27,0,3682
"20121100200",4118,36,24,0,266,0,99,0,4543
"20121100300",2778,130,0,0,39,0,41,0,2988
"20121100400",3487,480,0,0,24,0,85,0,4076
"20121100500",4012,258,25,0,141,12,193,12,4653
"20121100601",4799,767,64,49,55,86,228,21,6069
"20121100602",1471,62,0,0,44,0,54,11,1642
"20121100700",3888,949,29,0,83,65,80,0,5094
"20123176600",3488,443,0,0,32,23,31,76,4093
"20123176700",1902,114,0,1,6,1,8,3,2035
"20125950100",1806,204,0,0,118,38,11,19,2196
"20125950200",1753,517,0,0,78,86,25,0,2459
"20125950300",2825,357,150,8,524,57,304,0,4225
"20125950400",1394,735,89,6,33,0,122,353,2732
"20125950500",865,191,161,62,68,70,170,55,1642
"20125950600",2649,830,97,12,89,118,158,87,4040
"20125950700",3335,223,3,0,339,81,36,22,4039
"20125950800",3708,307,17,67,455,11,12,42,4619
"20125950900",541,58,53,283,33,24,23,0,1015
"20125951000",794,447,240,91,151,131,71,19,1944
"20125951100",1604,551,164,23,288,137,79,132,2978
"20125951200",471,179,195,50,176,72,79,0,1222
"20125951300",1753,501,0,0,172,0,19,0,2445
"20127963600",2886,268,0,0,123,15,115,30,3437
"20127963700",2215,185,0,0,41,9,56,14,2520
"20129964600",2243,308,32,0,470,40,601,28,3722
"20131480100",2954,379,30,17,11,13,40,0,3444
"20131480200",3665,347,4,11,19,8,62,28,4144
"20131480300",1848,322,3,0,90,24,8,0,2295
"20133951600",2902,635,3,0,108,24,28,73,3773
"20133951700",1669,842,36,34,42,11,15,129,2778
"20133951800",2792,569,0,0,29,62,94,149,3695
"20133951900",2738,523,26,18,44,47,102,33,3531
"20133952000",2098,474,0,0,116,52,67,7,2814
"20135956100",1189,238,0,0,26,0,50,158,1661
"20135956200",1392,140,0,7,36,0,38,2,1615
"20137951700",4220,424,4,6,60,12,46,1,4773
"20139010100",3728,356,0,0,101,36,62,51,4334
"20139010200",2560,322,0,14,36,10,39,0,2981
"20139010300",1825,136,0,0,15,34,13,17,2040
"20139010400",2397,347,0,4,141,0,36,0,2925
"20139010500",3422,412,0,24,109,4,109,19,4099
"20141474100",3024,631,3,0,51,11,32,15,3767
"20143085600",1974,117,9,0,55,0,73,0,2228
"20143085700",3268,428,0,0,73,19,55,2,3845
"20145970200",3866,147,91,1,138,20,310,19,4592
"20145970300",1568,215,2,0,25,2,21,2,1835
"20147475100",1043,78,2,0,21,16,0,4,1164
"20147475200",1364,182,0,0,63,23,33,21,1686
"20147475300",2364,148,2,0,28,96,28,33,2699
"20149000100",6018,841,250,22,227,5,343,94,7800
"20149000200",5148,283,0,0,177,32,195,32,5867
"20149000300",3611,415,39,0,326,19,278,0,4688
"20149000400",3798,325,33,2,93,3,74,12,4340
"20151968600",1905,160,7,0,40,24,49,3,2188
"20151968700",2859,395,0,11,22,50,89,49,3475
"20151968800",3329,338,7,0,89,102,262,108,4235
"20153950600",2187,278,6,3,36,9,38,56,2613
"20155000100",2771,366,20,0,170,39,174,51,3591
"20155000200",3275,122,4,0,101,12,274,6,3794
"20155000300",5841,671,0,0,212,18,420,85,7247
"20155000400",2787,351,57,137,87,179,122,154,3874
"20155000500",5031,422,108,123,119,51,420,75,6349
"20155000600",1532,410,28,66,223,84,382,121,2846
"20155000700",4128,668,193,197,496,170,691,438,6981
"20155000800",1207,583,25,115,224,65,236,117,2572
"20155001000",2017,452,29,0,30,79,304,74,2985
"20155001100",4700,141,0,0,77,0,184,0,5102
"20155001200",2878,225,42,0,260,36,122,0,3563
"20155001300",2201,199,8,7,79,4,173,8,2679
"20155001400",4244,387,26,4,139,0,81,33,4914
"20155001500",2875,246,6,0,67,3,37,1,3235
"20155001600",1536,387,0,0,53,0,44,51,2071
"20155001700",1670,351,21,5,41,46,69,29,2232
"20155001800",1851,156,0,0,45,30,30,0,2112
"20157978100",1053,179,0,0,0,4,0,5,1241
"20157978200",1480,132,0,0,16,3,5,2,1638
"20157978300",1612,235,0,0,49,46,15,34,1991
"20159967100",1979,288,15,0,154,63,40,8,2547
"20159967200",2787,562,0,0,238,203,578,264,4632
"20159967300",2825,301,11,0,77,2,76,3,3295
"20161000200",6153,1036,716,85,768,54,530,18,9360
"20161000303",496,517,0,67,103,102,50,46,1381
"20161000304",3196,1165,176,48,299,190,380,57,5511
"20161000500",1831,2371,0,82,224,370,214,27,5119
"20161000600",7001,197,332,12,727,52,266,12,8599
"20161000700",2502,803,70,58,240,59,97,309,4138
"20161000801",2020,1865,116,186,153,128,66,96,4630
"20161000802",1301,555,93,43,46,45,132,16,2231
"20161000900",4417,470,538,31,152,17,570,115,6310
"20161001002",3306,717,814,64,356,430,581,214,6482
"20161001100",2951,1637,208,78,504,377,98,46,5899
"20161001301",2297,646,85,0,489,11,407,104,4039
"20161001302",4317,247,45,2,151,41,82,0,4885
"20161980000",0,0,0,0,0,0,0,0,0
"20163974600",1469,486,0,0,25,78,8,10,2076
"20163974700",2581,340,0,0,38,18,3,0,2980
"20165972100",1094,119,0,0,20,5,11,2,1251
"20165972200",1598,246,0,20,36,14,2,13,1929
"20167973800",3577,719,21,32,128,59,80,29,4645
"20167973900",2081,190,5,0,23,0,11,15,2325
"20169000100",3966,979,258,51,203,143,321,152,6073
"20169000200",1214,611,151,59,70,95,301,163,2664
"20169000300",3748,1083,53,53,131,338,270,576,6252
"20169000400",2634,285,39,21,97,89,260,96,3521
"20169000500",3529,1136,130,65,646,802,1084,519,7911
"20169000600",1627,577,76,5,290,25,246,94,2940
"20169000700",4468,301,247,44,314,114,365,0,5853
"20169000800",3611,303,30,13,185,23,187,47,4399
"20169000900",4803,1294,128,0,233,9,50,344,6861
"20169001000",4474,322,49,0,187,34,64,34,5164
"20169001100",3656,187,13,0,128,16,178,0,4178
"20169001200",3234,342,2,3,141,9,100,0,3831
"20171957100",4087,520,0,0,204,26,630,103,5570
"20173000100",1211,1120,84,41,509,210,1326,1300,5801
"20173000200",2040,339,0,0,564,106,818,146,4013
"20173000300",2126,644,101,119,1138,453,2068,664,7313
"20173000400",1018,759,518,172,455,369,1004,936,5231
"20173000600",145,131,791,781,68,39,77,102,2134
"20173000700",458,389,1386,666,67,175,441,177,3759
"20173000800",156,188,904,1015,0,71,0,168,2502
"20173000900",492,297,846,352,370,214,233,146,2950
"20173001000",1833,344,1019,356,178,260,370,261,4621
"20173001100",783,88,587,413,72,93,248,71,2355
"20173001400",3597,198,94,0,316,0,414,0,4619
"20173001500",1595,765,50,2,437,136,597,322,3904
"20173001800",580,432,287,229,511,161,454,307,2961
"20173001900",1285,183,195,40,185,150,218,154,2410
"20173002000",1697,211,0,0,9,4,25,0,1946
"20173002100",2731,112,493,0,91,0,161,0,3588
"20173002200",1786,124,44,0,125,9,10,77,2175
"20173002300",1529,364,61,17,156,24,166,124,2441
"20173002400",930,293,116,280,40,37,121,120,1937
"20173002600",811,499,54,87,90,31,371,180,2123
"20173002700",999,375,0,8,40,121,211,265,2019
"20173002800",1883,787,50,28,458,111,266,231,3814
"20173002900",1811,298,60,156,299,92,637,154,3507
"20173003000",1495,365,130,30,183,59,567,79,2908
"20173003100",1084,566,69,154,117,71,216,128,2405
"20173003200",1326,800,128,83,177,752,449,699,4414
"20173003400",1396,668,6,32,1288,68,1141,277,4876
"20173003500",1156,192,57,155,165,10,59,0,1794
"20173003600",1635,469,192,130,211,121,515,231,3504
"20173003700",1001,456,25,4,365,279,374,283,2787
"20173003800",1559,655,217,10,217,171,310,337,3476
"20173003900",2932,705,231,140,343,103,1185,308,5947
"20173004000",3283,1038,192,330,454,267,960,536,7060
"20173004300",1570,562,137,98,225,39,261,214,3106
"20173005100",2709,736,216,175,251,303,527,234,5151
"20173005200",2678,521,164,399,372,132,318,219,4803
"20173005300",4538,811,536,0,312,24,696,149,7066
"20173005400",3458,1197,116,18,711,145,265,271,6181
"20173005501",4125,435,0,0,249,0,246,53,5108
"20173005502",4392,652,17,0,183,130,125,212,5711
"20173005600",3990,305,104,11,287,73,212,37,5019
"20173005700",4010,547,82,54,664,39,539,0,5935
"20173005800",2406,1341,14,30,425,133,316,139,4804
"20173005900",2808,787,264,24,487,169,625,43,5207
"20173006000",1846,1380,429,370,669,277,356,859,6186
"20173006100",1720,863,145,15,255,177,527,598,4300
"20173006200",1759,366,261,95,394,159,749,197,3980
"20173006300",1341,524,160,82,317,12,89,74,2599
"20173006400",1217,165,14,0,214,45,120,114,1889
"20173006500",998,1378,249,151,864,637,733,1409,6419
"20173006600",1223,257,270,260,316,132,417,112,2987
"20173006700",1614,306,217,97,129,46,168,130,2707
"20173006800",1849,778,565,804,113,137,442,596,5284
"20173006900",1165,405,299,150,348,116,297,161,2941
"20173007000",1805,256,997,485,221,264,320,137,4485
"20173007101",974,455,631,125,165,55,53,281,2739
"20173007102",2290,506,1236,512,1019,0,510,139,6212
"20173007201",2753,561,28,0,607,96,243,162,4450
"20173007203",3283,232,778,140,1552,109,667,51,6812
"20173007204",4159,153,763,97,2729,197,615,0,8713
"20173007301",3376,271,9,21,272,90,177,8,4224
"20173007302",2532,201,596,86,256,22,129,22,3844
"20173007400",687,22,0,9,26,0,0,0,744
"20173007500",292,210,1203,438,416,193,192,110,3054
"20173007600",2503,180,765,222,228,40,98,10,4046
"20173007700",2894,584,2657,169,1609,379,142,254,8688
"20173007800",86,185,1277,1114,55,83,15,231,3046
"20173008000",5106,437,132,8,250,12,378,47,6370
"20173008100",4248,535,50,0,98,0,276,126,5333
"20173008200",2299,920,106,131,1001,988,1567,1385,8397
"20173008300",3675,249,131,0,217,24,860,92,5248
"20173008400",2287,356,61,19,502,134,430,158,3947
"20173008500",2010,117,0,0,201,17,139,0,2484
"20173008600",2529,211,22,7,466,49,625,88,3997
"20173008700",2313,624,177,47,417,191,439,305,4513
"20173008800",3437,606,56,0,439,44,530,311,5423
"20173008900",1936,840,42,0,379,99,324,91,3711
"20173009000",1957,387,93,0,184,22,378,50,3071
"20173009100",4178,1183,299,410,990,151,1065,192,8468
"20173009200",2369,566,12,17,120,0,64,0,3148
"20173009301",4965,263,92,0,297,110,564,0,6291
"20173009302",4203,494,144,172,494,114,330,48,5999
"20173009401",3688,151,20,0,68,24,254,13,4218
"20173009402",2025,200,30,47,75,0,188,0,2565
"20173009503",8445,120,73,0,1093,60,1071,0,10862
"20173009504",3736,244,31,0,258,0,220,0,4489
"20173009505",3056,58,31,0,42,6,90,0,3283
"20173009506",4046,331,168,0,314,0,325,40,5224
"20173009507",4785,66,142,0,484,93,411,0,5981
"20173009508",2593,262,9,0,274,53,433,31,3655
"20173009509",5391,173,49,8,227,34,241,46,6169
"20173009510",3915,26,21,0,301,36,161,0,4460
"20173009511",5996,194,173,0,551,139,427,27,7507
"20173009512",4030,95,128,0,236,2,238,0,4729
"20173009513",4445,216,0,0,281,13,482,0,5437
"20173009603",2170,34,12,0,561,207,456,0,3440
"20173009604",2488,152,0,0,43,0,12,10,2705
"20173009605",4384,153,62,1,254,0,326,0,5180
"20173009700",5528,298,0,0,260,63,356,0,6505
"20173009801",3944,442,17,0,287,32,408,30,5160
"20173009802",6445,756,58,0,553,3,343,0,8158
"20173009900",9447,221,123,0,682,9,467,0,10949
"20173010001",4084,9,59,0,476,0,45,0,4673
"20173010002",2621,231,147,0,537,56,56,0,3648
"20173010003",1309,20,245,10,448,0,225,10,2267
"20173010004",5436,123,138,0,426,14,344,13,6494
"20173010005",3267,191,275,7,118,0,349,10,4217
"20173010106",1792,190,126,0,310,119,17,0,2554
"20173010107",2948,302,278,18,162,57,121,0,3886
"20173010108",1972,42,101,2,315,24,144,1,2601
"20173010109",1113,407,319,91,270,63,185,177,2625
"20173010110",1225,34,0,6,148,0,72,8,1493
"20173010111",5422,212,661,46,618,8,358,0,7325
"20173010113",2658,259,258,0,466,0,97,207,3945
"20173010115",5570,93,277,1,915,0,350,0,7206
"20173010116",1772,228,128,4,58,0,28,0,2218
"20173010200",8552,398,22,40,125,112,103,0,9352
"20173010300",10238,633,354,0,472,571,537,206,13011
"20173010400",1887,349,29,0,45,40,80,7,2437
"20173010500",4107,78,0,0,88,4,62,0,4339
"20173010600",3411,75,0,0,81,14,62,4,3647
"20173010700",3110,116,9,0,77,0,177,0,3489
"20173010801",1796,42,371,49,341,52,207,0,2858
"20173010802",1283,229,379,125,422,57,81,63,2639
"20175965600",1823,76,4,4,501,105,1032,139,3684
"20175965700",3213,206,103,0,415,168,984,238,5327
"20175965800",2175,338,225,16,909,764,1346,1026,6799
"20175965900",3095,1133,453,0,1811,175,3502,1032,11201
"20175966000",1698,568,91,39,1669,793,2601,1251,8710
"20177000400",1077,1205,543,258,533,462,400,743,5221
"20177000500",804,587,300,44,481,123,455,28,2822
"20177000600",1154,631,241,111,94,174,135,142,2682
"20177000700",1982,548,58,54,76,183,65,81,3047
"20177000800",1930,1024,45,114,358,120,547,143,4281
"20177000900",2445,721,32,0,286,160,570,348,4562
"20177001000",1783,675,89,19,578,124,938,370,4576
"20177001100",1038,773,291,312,87,262,829,610,4202
"20177001200",645,386,419,221,461,277,556,433,3398
"20177001300",2373,389,531,92,509,379,781,248,5302
"20177001500",896,345,413,231,158,46,110,68,2267
"20177001601",1694,516,44,2,96,38,75,44,2509
"20177001603",1739,283,133,351,198,82,183,33,3002
"20177001604",2713,313,177,43,221,0,78,0,3545
"20177001800",2517,325,46,8,314,0,290,30,3530
"20177001900",2842,217,37,12,51,28,116,7,3310
"20177002100",2330,487,174,61,219,214,134,93,3712
"20177002200",1948,379,0,12,74,7,133,21,2574
"20177002400",4282,462,141,41,294,44,230,10,5504
"20177002500",2102,197,168,48,143,0,80,23,2761
"20177002601",2711,237,359,74,309,54,151,0,3895
"20177002602",4466,475,251,114,349,491,159,235,6540
"20177002701",3350,523,201,310,170,0,338,91,4983
"20177002702",3162,219,190,8,538,29,246,10,4402
"20177002800",2466,603,231,148,274,240,119,197,4278
"20177002900",960,1003,549,441,155,297,69,626,4100
"20177003001",1790,397,456,286,318,276,590,361,4474
"20177003002",4296,182,740,35,291,90,682,43,6359
"20177003100",2527,674,747,747,560,277,844,343,6719
"20177003301",2169,84,43,0,62,10,50,12,2430
"20177003302",3275,216,0,0,32,38,47,0,3608
"20177003400",8674,561,106,75,552,0,324,0,10292
"20177003500",5440,189,13,0,370,25,262,3,6302
"20177003601",4415,139,3,0,212,3,312,6,5090
"20177003604",3162,156,78,25,226,0,161,0,3808
"20177003605",3681,70,40,0,374,5,105,0,4275
"20177003606",3465,346,72,76,240,0,495,0,4694
"20177003607",5934,108,146,0,362,58,296,0,6904
"20177003700",6468,1286,181,20,346,99,437,351,9188
"20177003901",6323,213,73,9,365,17,377,17,7394
"20177003902",3871,158,31,14,102,14,161,45,4396
"20177004000",641,604,438,298,187,402,241,147,2958
"20177004100",2708,342,141,51,183,14,196,22,3657
"20179952600",868,136,11,0,51,0,31,0,1097
"20179952700",1187,188,0,0,67,0,18,43,1503
"20181453600",935,155,0,0,1,0,13,18,1122
"20181453700",3633,836,120,0,215,2,527,114,5447
"20183475800",1411,286,0,15,8,0,8,13,1741
"20183475900",1671,230,0,0,55,41,17,0,2014
"20185470600",1536,310,0,0,46,13,62,92,2059
"20185470700",1927,318,18,0,123,8,331,66,2791
"20187964100",1440,66,13,0,626,20,845,56,3066
"20189965100",1281,63,27,0,68,63,159,70,1731
"20189965200",2620,208,0,0,781,514,1116,508,5747
"20191962100",4106,450,10,0,96,18,106,7,4793
"20191962200",4578,580,24,0,245,42,20,11,5500
"20191962300",2008,367,0,3,116,15,10,12,2531
"20191962400",3389,570,0,7,79,99,322,24,4490
"20191962500",3184,753,0,0,212,57,405,188,4799
"20191962600",2168,143,0,0,58,41,23,2,2435
"20193953100",4819,678,43,1,130,0,233,14,5918
"20193953400",1677,164,0,1,27,2,84,29,1984
"20195955800",2628,183,1,1,69,9,48,5,2944
"20197483100",4049,306,15,0,171,19,125,29,4714
"20197483200",2170,112,30,0,22,7,15,4,2360
"20199954100",1409,124,2,0,2,5,112,6,1660
"20201978600",2867,245,14,0,54,9,53,7,3249
"20201978700",2063,311,31,3,9,5,64,29,2515
"20203957600",1880,213,0,0,98,4,486,117,2798
"20205097100",1775,371,0,0,22,2,83,11,2264
"20205097200",1298,147,0,0,22,20,21,0,1508
"20205097300",2034,439,5,0,70,39,45,8,2640
"20205097400",2046,553,3,0,153,36,37,6,2834
"20207096600",1231,317,0,0,58,51,12,46,1715
"20207096700",1238,251,0,0,31,3,0,0,1523
"20209040001",0,0,0,0,0,0,0,0,0
"20209040002",0,0,0,0,0,0,0,0,0
"20209040200",61,90,384,239,247,55,209,138,1423
"20209040300",0,0,366,244,0,0,0,0,610
"20209040400",149,224,920,443,160,7,213,160,2276
"20209040500",570,163,608,261,264,16,207,75,2164
"20209040600",408,245,1222,383,98,39,218,208,2821
"20209040700",300,284,708,441,54,153,324,417,2681
"20209040800",15,150,133,60,57,1,51,127,594
"20209040900",222,86,203,492,195,38,148,59,1443
"20209041000",114,67,314,539,27,74,102,72,1309
"20209041100",36,22,544,787,192,0,92,12,1685
"20209041200",277,40,649,381,25,10,231,50,1663
"20209041300",1423,774,1290,380,404,449,1349,822,6891
"20209041500",1203,477,223,282,309,112,1064,361,4031
"20209041600",2352,681,689,98,379,309,1765,761,7034
"20209041700",1159,421,131,130,487,158,880,577,3943
"20209041800",48,91,291,223,32,103,12,10,810
"20209041900",1178,368,97,4,303,168,735,216,3069
"20209042001",220,454,21,87,221,385,176,684,2248
"20209042002",332,422,10,94,578,192,665,396,2689
"20209042100",1335,502,30,104,445,208,1157,494,4275
"20209042200",835,760,77,11,202,101,641,781,3408
"20209042300",1071,828,149,181,466,388,1080,881,5044
"20209042400",865,425,210,223,974,281,1447,595,5020
"20209042501",0,0,0,0,0,0,0,0,0
"20209042502",0,0,0,0,0,0,0,0,0
"20209042600",1218,394,0,6,421,279,952,486,3756
"20209042700",1568,744,244,468,305,115,1237,448,5129
"20209042800",1808,575,295,806,201,66,1110,438,5299
"20209043000",31,26,0,3,0,0,0,0,60
"20209043301",1909,534,280,306,508,81,1006,361,4985
"20209043400",1405,454,102,0,77,58,306,315,2717
"20209043500",1374,145,15,0,74,7,135,0,1750
"20209043600",4258,1058,265,50,558,255,1145,855,8444
"20209043700",1271,149,148,0,392,16,483,16,2475
"20209043802",990,157,0,0,57,43,35,85,1367
"20209043803",2275,358,104,81,192,0,238,59,3307
"20209043804",5,0,0,0,0,0,5,0,10
"20209043903",1171,629,668,145,309,187,643,262,4014
"20209043904",538,348,1411,515,141,186,209,207,3555
"20209043905",701,274,331,394,79,13,72,28,1892
"20209044001",2111,246,812,83,217,35,460,62,4026
"20209044003",1883,448,143,228,100,12,356,292,3462
"20209044004",428,207,0,0,21,0,85,43,784
"20209044101",298,15,470,284,17,6,49,6,1145
"20209044102",1533,301,536,52,343,0,552,191,3508
"20209044103",1115,66,1037,159,278,27,113,6,2801
"20209044104",736,45,1178,539,267,76,330,40,3211
"20209044201",2455,187,1155,152,164,7,419,11,4550
"20209044202",1868,136,1252,217,157,44,169,27,3870
"20209044301",1046,295,413,177,109,45,151,148,2384
"20209044302",803,68,592,185,23,13,214,0,1898
"20209044303",698,212,876,212,200,114,120,92,2524
"20209044400",822,212,867,209,373,251,255,114,3103
"20209044500",990,86,789,128,222,0,18,5,2238
"20209044601",1998,132,292,0,225,44,229,0,2920
"20209044602",0,0,0,0,0,0,0,0,0
"20209044603",0,0,0,0,0,0,0,0,0
"20209044702",3605,223,58,42,234,8,205,8,4383
"20209044703",1498,38,547,0,150,0,229,0,2462
"20209044704",1126,113,357,0,92,1,265,109,2063
"20209044803",4253,189,603,7,146,13,182,111,5504
"20209044804",3220,100,757,0,79,0,282,81,4519
"20209044805",2006,399,127,0,139,46,338,27,3082
"20209044806",710,6,0,0,66,0,12,0,794
"20209044900",3073,186,306,0,200,56,326,14,4161
"20209045000",1761,1041,135,308,738,166,1078,640,5867
"20209045100",783,391,278,394,136,316,488,347,3133
"20209045200",2224,424,128,130,299,47,456,226,3934
"21001970100",1513,282,0,0,24,0,16,42,1877
"21001970200",1241,118,20,15,9,8,9,8,1428
"21001970300",2294,721,0,0,35,19,0,0,3069
"21001970401",3025,766,217,0,26,13,19,0,4066
"21001970402",2826,438,51,12,99,65,195,1,3687
"21001970500",1766,538,14,0,15,34,0,0,2367
"21001970600",1071,339,9,0,0,0,0,0,1419
"21003920100",2988,497,22,0,125,4,31,0,3667
"21003920200",2238,358,0,0,16,0,28,7,2647
"21003920300",3462,814,10,67,33,0,5,14,4405
"21003920400",3275,873,138,0,42,12,142,0,4482
"21003920500",1044,209,0,0,107,0,85,12,1457
"21003920600",2591,802,0,0,14,45,0,0,3452
"21005950100",6772,677,376,95,6,0,93,0,8019
"21005950201",4643,470,36,0,176,0,32,47,5404
"21005950202",3006,636,13,16,35,47,0,0,3753
"21005950300",1841,139,9,0,23,0,80,0,2092
"21005950400",1994,323,17,0,23,15,0,55,2427
"21007950100",3430,558,90,57,31,3,55,4,4228
"21007950200",1157,274,3,39,30,17,6,18,1544
"21007950300",2044,172,52,25,33,12,12,0,2350
"21009950100",2785,430,36,0,59,0,17,0,3327
"21009950200",2512,918,215,64,75,41,7,37,3869
"21009950300",1890,546,104,67,6,128,0,0,2741
"21009950400",3317,1374,501,196,127,13,76,0,5604
"21009950500",2349,745,99,18,26,6,180,0,3423
"21009950600",3863,1521,89,199,33,80,222,64,6071
"21009950700",5670,761,41,0,37,42,124,0,6675
"21009950800",3143,279,0,0,16,0,189,6,3633
"21009950900",2957,600,23,0,68,6,94,6,3754
"21009951000",2865,602,0,0,70,0,6,111,3654
"21011970100",1131,513,77,41,30,18,9,4,1823
"21011970200",4501,1339,57,11,83,13,80,0,6084
"21011970300",2433,1259,0,0,20,49,0,46,3807
"21013960100",1436,1145,0,0,21,0,0,0,2602
"21013960200",3018,1496,31,4,80,10,0,0,4639
"21013960300",1905,466,0,10,15,0,99,0,2495
"21013960400",1434,238,6,0,38,28,38,28,1810
"21013960500",1548,694,12,57,0,0,28,0,2339
"21013960600",2294,1922,97,32,155,28,0,0,4528
"21013960700",1615,725,158,55,169,5,27,0,2754
"21013960800",2306,1220,0,0,0,17,0,0,3543
"21013961100",1775,1010,32,6,19,0,0,0,2842
"21015070100",4813,869,400,238,484,16,349,74,7243
"21015070200",4726,1172,188,1,149,33,0,122,6391
"21015070301",3230,1300,100,197,0,180,486,556,6049
"21015070305",5007,379,82,0,338,0,414,17,6237
"21015070307",9638,268,379,0,797,0,84,0,11166
"21015070308",8000,569,167,104,907,58,175,167,10147
"21015070309",5469,85,59,0,530,0,192,0,6335
"21015070311",1972,313,6,0,136,0,10,0,2437
"21015070312",2346,308,173,0,214,41,16,23,3121
"21015070313",3280,27,26,0,40,0,116,0,3489
"21015070314",4076,230,160,0,179,0,267,0,4912
"21015070401",8080,310,121,0,1065,0,563,0,10139
"21015070402",7219,681,192,0,181,0,188,98,8559
"21015070502",4143,336,136,0,27,0,20,22,4684
"21015070503",5577,514,16,298,309,76,116,60,6966
"21015070504",6586,339,177,0,47,196,11,60,7416
"21015070601",2272,379,0,0,0,0,0,0,2651
"21015070604",2548,303,0,0,6,0,6,0,2863
"21015070605",4947,206,15,0,243,0,123,0,5534
"21015070606",3347,487,33,0,124,30,40,0,4061
"21015070607",3669,261,43,0,49,0,22,0,4044
"21015980100",0,0,0,0,0,0,0,0,0
"21017030100",2355,722,550,341,11,17,180,108,4284
"21017030200",3991,900,114,30,272,0,386,82,5775
"21017030300",2588,186,40,0,200,0,311,0,3325
"21017030400",2155,168,54,1,15,0,0,0,2393
"21017030500",1734,604,28,37,39,13,30,0,2485
"21017030600",2019,342,86,6,37,17,189,62,2758
"21019030200",645,514,20,16,50,0,75,0,1320
"21019030300",1474,502,59,20,35,6,83,0,2179
"21019030400",1508,456,7,7,101,51,41,10,2181
"21019030500",3620,513,8,21,233,25,39,14,4473
"21019030600",3266,569,92,4,8,0,0,0,3939
"21019030700",2879,396,14,97,81,125,57,0,3649
"21019030800",2094,1549,16,64,17,111,17,0,3868
"21019030900",3894,1258,0,25,29,106,0,0,5312
"21019031001",1022,206,0,0,9,0,0,0,1237
"21019031002",4475,1019,2,1,161,10,65,0,5733
"21019031100",6760,800,0,0,67,0,46,0,7673
"21019031200",2957,341,0,0,0,0,67,0,3365
"21019031300",1928,493,3,2,4,3,22,0,2455
"21021930100",3153,887,301,185,133,173,0,0,4832
"21021930200",3407,337,61,61,177,70,67,70,4250
"21021930300",1056,400,216,33,46,19,92,77,1939
"21021930400",2750,649,292,55,173,52,56,62,4089
"21021930500",2931,252,64,0,74,3,178,103,3605
"21021930600",3058,478,53,11,33,4,41,0,3678
"21021930700",3460,998,87,4,46,160,39,8,4802
"21023950100",1943,583,0,0,0,2,9,91,2628
"21023950200",1530,278,0,0,15,0,0,2,1825
"21023950300",3517,548,0,0,0,0,8,0,4073
"21025920100",769,483,0,0,15,0,0,0,1267
"21025920200",1468,528,0,13,0,6,59,0,2074
"21025920300",1954,1378,0,0,66,0,0,10,3408
"21025920400",945,349,0,0,5,3,0,0,1302
"21025920500",1052,398,0,0,16,12,0,0,1478
"21025920600",1076,701,0,0,0,14,0,14,1805
"21025920700",1645,460,0,0,4,0,0,0,2109
"21027960100",3645,985,162,13,130,155,19,62,5171
"21027960200",4313,1064,226,18,23,0,0,39,5683
"21027960300",2543,519,14,32,16,5,4,0,3133
"21027960400",1286,136,0,0,0,0,0,0,1422
"21027960501",1171,324,0,0,13,0,63,0,1571
"21027960502",2330,617,0,0,11,0,26,0,2984
"21029020101",3143,188,0,0,213,0,211,0,3755
"21029020102",2525,661,0,0,72,17,27,0,3302
"21029020103",2823,62,0,0,99,0,59,0,3043
"21029020201",5470,339,58,0,138,0,0,0,6005
"21029020202",3435,187,0,0,91,0,20,0,3733
"21029020300",4301,129,13,0,17,82,18,0,4560
"21029020400",6089,342,25,0,134,0,0,57,6647
"21029020500",5118,465,5,0,73,93,22,93,5869
"21029020601",4948,458,11,0,34,73,49,0,5573
"21029020602",1314,64,12,0,47,26,3,26,1492
"21029020701",4403,1142,253,65,103,0,84,2,6052
"21029020702",1829,230,6,0,18,0,13,0,2096
"21029020800",4395,1224,61,0,98,0,0,0,5778
"21029020900",2230,441,0,0,43,0,33,0,2747
"21029021101",5279,542,0,0,530,0,228,0,6579
"21029021102",3634,245,0,0,4,0,0,0,3883
"21029021200",3876,561,0,0,90,11,173,0,4711
"21029980100",0,0,0,0,0,0,0,0,0
"21031930100",2797,995,0,0,108,0,0,0,3900
"21031930200",1049,326,0,0,0,0,0,11,1386
"21031930300",2914,1364,42,19,7,41,165,121,4673
"21031930400",1424,224,0,0,0,0,0,9,1657
"21031930500",979,154,0,0,7,0,0,0,1140
"21033920100",1780,410,19,0,29,0,19,0,2257
"21033920200",3542,827,218,18,85,13,41,99,4843
"21033920300",4192,1154,55,309,94,0,71,0,5875
"21035010100",3208,722,124,17,30,29,21,29,4180
"21035010200",4006,375,44,34,45,0,16,5,4525
"21035010301",210,226,0,0,0,175,0,0,611
"21035010302",3417,2122,230,8,176,211,18,103,6285
"21035010400",1065,473,195,51,65,49,91,80,2069
"21035010500",2188,509,75,123,30,80,8,31,3044
"21035010600",5723,502,144,0,202,22,121,122,6836
"21035010700",2956,460,28,17,124,49,134,27,3795
"21035010800",2869,561,0,0,23,13,0,21,3487
"21037050100",638,489,112,60,37,19,109,63,1527
"21037050400",1644,289,111,26,41,54,56,31,2252
"21037050500",1101,465,152,36,18,90,0,0,1862
"21037050600",1168,649,103,125,8,7,8,37,2105
"21037051101",1620,664,0,0,25,10,19,34,2372
"21037051102",1077,59,0,0,216,9,0,0,1361
"21037051200",1007,431,0,0,11,28,13,14,1504
"21037051300",3940,198,11,0,37,0,219,0,4405
"21037051901",4723,201,27,0,69,0,0,0,5020
"21037051903",4374,223,17,0,326,9,72,0,5021
"21037051904",4001,336,50,6,36,0,43,0,4472
"21037052001",4012,527,42,0,197,7,83,0,4868
"21037052002",2405,163,1,0,4,0,0,0,2573
"21037052100",3042,342,0,0,105,0,159,0,3648
"21037052200",1960,206,0,0,53,0,6,0,2225
"21037052301",3899,403,0,1,38,22,0,24,4387
"21037052302",4795,197,0,72,227,0,0,0,5291
"21037052400",1780,545,24,36,44,0,0,101,2530
"21037052500",4458,550,176,260,134,114,0,70,5762
"21037052800",2748,206,9,301,65,0,5,0,3334
"21037052900",4884,401,6,0,12,41,34,1,5379
"21037053100",5051,826,2,0,146,98,100,23,6246
"21037053200",1573,237,59,22,88,40,103,7,2129
"21037053301",4279,307,38,176,66,167,39,0,5072
"21037053302",3343,522,0,65,10,130,29,0,4099
"21039960100",1342,121,22,0,54,0,19,0,1558
"21039960200",1451,391,24,0,0,21,8,25,1920
"21039960300",1271,275,13,0,4,0,43,0,1606
"21041950100",1945,416,20,11,44,32,39,1,2508
"21041950200",3511,1587,41,50,226,131,299,396,6241
"21041950300",1503,882,0,0,0,0,0,0,2385
"21043960100",2606,643,17,0,0,0,28,0,3294
"21043960200",3316,1006,0,4,0,7,0,0,4333
"21043960300",2226,701,0,0,0,13,172,16,3128
"21043960400",1508,445,0,0,0,0,0,0,1953
"21043960500",3009,872,0,62,44,32,0,0,4019
"21043960600",5088,932,0,1,190,6,0,0,6217
"21043960700",3201,685,0,0,50,1,0,0,3937
"21045950100",901,361,0,0,0,31,0,31,1324
"21045950200",1725,355,0,0,84,0,52,0,2216
"21045950300",4078,1990,12,40,59,35,25,126,6365
"21045950400",2562,716,0,2,10,13,0,18,3321
"21045950500",1924,622,64,17,0,4,117,0,2748
"21047200100",1048,311,855,851,158,175,153,63,3614
"21047200200",1711,492,539,579,98,4,226,201,3850
"21047200300",1259,503,510,921,39,109,25,15,3381
"21047200400",485,426,1228,960,126,0,257,175,3657
"21047200500",2912,487,193,135,206,224,201,76,4434
"21047200600",3176,545,510,24,138,62,29,121,4605
"21047200700",4438,876,582,12,258,83,386,83,6718
"21047200800",776,271,932,623,9,0,0,0,2611
"21047200900",4737,309,586,112,252,20,149,0,6165
"21047201000",1341,346,51,25,36,0,7,0,1806
"21047201100",3015,705,112,45,67,53,67,63,4127
"21047201200",2361,544,86,0,68,0,62,0,3121
"21047201301",2252,319,265,34,69,30,69,10,3048
"21047201302",4010,804,1177,277,841,63,417,15,7604
"21047201400",2129,112,98,20,220,0,131,0,2710
"21047201501",3214,570,1093,131,491,143,496,162,6300
"21047201502",2997,617,550,42,351,60,336,325,5278
"21047201503",0,0,0,0,0,0,0,0,0
"21047980100",0,0,0,0,0,0,0,0,0
"21049020101",4155,719,110,30,133,0,32,45,5224
"21049020103",3596,84,56,0,72,0,28,0,3836
"21049020105",2793,272,33,0,45,0,29,0,3172
"21049020106",2395,468,30,10,33,23,59,126,3144
"21049020201",1583,793,921,345,0,27,137,79,3885
"21049020202",2875,1141,36,21,41,0,41,16,4171
"21049020300",2230,116,0,4,98,0,29,0,2477
"21049020400",2608,355,48,0,21,56,21,0,3109
"21049020500",2261,384,0,0,23,0,12,144,2824
"21049020600",3248,499,137,0,70,36,129,0,4119
"21051950100",1182,617,14,0,31,9,0,0,1853
"21051950200",3837,2102,7,0,0,163,0,0,6109
"21051950300",3004,1283,120,31,15,3,2,0,4458
"21051950400",2146,1170,0,0,0,10,0,10,3336
"21051950500",1271,1542,28,0,15,0,0,0,2856
"21051950600",625,498,0,2,0,0,0,0,1125
"21053970100",2252,502,41,0,39,0,9,0,2843
"21053970201",2126,1139,12,0,3,0,0,0,3280
"21053970202",2881,796,0,3,252,9,222,0,4163
"21055930100",1590,259,0,0,10,49,2,0,1910
"21055930200",3032,842,12,42,65,0,35,0,4028
"21055930300",1409,359,0,0,10,0,7,8,1793
"21055930400",1073,314,0,0,6,32,0,8,1433
"21057950100",2500,999,126,66,22,13,6,12,3744
"21057950200",2459,471,1,0,32,39,14,0,3016
"21059000100",1617,987,392,24,83,87,139,28,3357
"21059000200",1833,784,438,115,47,188,413,172,3990
"21059000300",781,256,22,196,47,90,15,77,1484
"21059000400",4211,1715,232,394,217,29,112,0,6910
"21059000500",1278,374,132,130,2,0,82,0,1998
"21059000600",4399,577,273,28,83,175,18,97,5650
"21059000700",3342,306,76,14,184,0,10,0,3932
"21059000800",2897,438,127,179,51,39,79,98,3908
"21059000900",3445,783,40,0,191,18,20,0,4497
"21059001000",2011,337,142,51,151,5,117,82,2896
"21059001100",1670,203,81,0,23,8,10,30,2025
"21059001200",3013,207,345,0,132,0,116,0,3813
"21059001300",4853,640,302,34,156,18,75,0,6078
"21059001401",4230,361,41,0,111,0,0,0,4743
"21059001402",4346,536,42,43,63,0,57,0,5087
"21059001501",3358,651,0,0,14,9,44,9,4085
"21059001502",3479,123,0,3,51,0,30,0,3686
"21059001601",3897,38,0,0,253,0,33,0,4221
"21059001602",4086,717,3,7,7,0,0,0,4820
"21059001701",4184,814,140,151,187,0,154,18,5648
"21059001702",2787,290,73,0,152,77,60,0,3439
"21059001703",3841,558,0,0,95,7,0,10,4511
"21059001800",5225,504,45,14,44,8,0,262,6102
"21061920200",3924,824,0,0,29,0,0,0,4777
"21061920300",1053,233,47,110,0,29,0,0,1472
"21061920400",4933,723,43,1,28,5,33,75,5841
"21061980100",0,3,2,0,0,0,0,2,7
"21063920100",3200,1429,0,0,0,35,0,29,4693
"21063920200",1385,673,0,0,0,0,25,0,2083
"21065920100",1059,389,0,0,55,2,0,0,1505
"21065920200",4228,1543,0,0,30,26,3,0,5830
"21065920300",3974,1480,0,0,23,46,0,0,5523
"21065920400",1116,408,0,38,52,0,0,0,1614
"21067000101",1186,834,319,187,19,131,0,28,2704
"21067000102",997,383,198,195,25,0,39,14,1851
"21067000200",984,387,625,623,128,81,79,0,2907
"21067000300",683,415,841,1060,118,43,106,96,3362
"21067000400",510,158,270,320,26,101,74,48,1507
"21067000500",2946,206,84,0,108,36,18,0,3398
"21067000600",3766,391,0,41,27,0,0,1,4226
"21067000700",1120,1203,0,106,200,25,148,76,2878
"21067000801",46,30,0,5,196,129,23,8,437
"21067000802",539,1518,0,107,54,227,11,5,2461
"21067000900",920,2980,319,251,150,322,21,41,5004
"21067001000",770,295,386,125,45,8,57,37,1723
"21067001100",588,919,1797,504,307,242,365,726,5448
"21067001300",925,555,415,113,128,90,217,195,2638
"21067001400",1135,520,385,133,81,28,155,217,2654
"21067001500",1363,496,110,46,93,103,221,0,2432
"21067001600",1625,361,182,128,165,27,272,32,2792
"21067001700",1419,284,82,7,185,0,0,0,1977
"21067001800",678,1541,134,51,341,157,0,22,2924
"21067001900",1416,1294,637,554,139,542,101,262,4945
"21067002001",1642,698,237,61,1931,807,2020,844,8240
"21067002002",1118,55,167,129,403,320,521,346,3059
"21067002200",1329,123,94,13,50,257,25,111,2002
"21067002302",3960,524,99,0,390,47,11,0,5031
"21067002303",2940,443,345,194,148,458,87,248,4863
"21067002304",2027,16,3,0,12,0,20,0,2078
"21067002400",2629,308,149,46,472,187,66,57,3914
"21067002500",2642,920,37,0,63,86,0,0,3748
"21067002600",3171,665,201,0,394,298,209,397,5335
"21067002700",3206,318,31,92,216,43,286,0,4192
"21067002800",2929,516,30,17,73,176,149,164,4054
"21067002900",3292,507,102,0,72,0,13,0,3986
"21067003000",4187,468,155,84,703,401,652,364,7014
"21067003101",1860,356,568,178,84,1,78,59,3184
"21067003102",1099,115,927,76,53,63,50,0,2383
"21067003201",1265,219,105,0,63,0,0,0,1652
"21067003202",4327,869,471,359,49,50,120,189,6434
"21067003300",1954,150,377,201,20,90,140,0,2932
"21067003402",2599,676,373,364,448,71,166,38,4735
"21067003404",2142,716,400,869,190,141,83,39,4580
"21067003405",3380,582,763,631,171,33,288,52,5900
"21067003406",5522,652,653,97,25,0,377,21,7347
"21067003407",2377,169,261,106,246,6,114,0,3279
"21067003501",2106,792,481,187,182,68,171,119,4106
"21067003503",1467,349,175,84,89,103,161,65,2493
"21067003504",2165,299,810,51,110,0,147,0,3582
"21067003600",4156,69,80,0,111,5,106,0,4527
"21067003701",809,217,20,0,22,98,94,78,1338
"21067003702",2060,81,296,207,554,104,372,104,3778
"21067003703",3605,49,644,12,311,20,366,0,5007
"21067003704",2864,93,1275,0,264,0,179,0,4675
"21067003802",1525,109,126,88,114,69,162,155,2348
"21067003803",1513,32,1202,0,392,17,229,36,3421
"21067003804",648,872,2206,804,316,696,580,1285,7407
"21067003906",3892,80,54,0,152,45,156,0,4379
"21067003908",2719,217,551,47,423,5,146,0,4108
"21067003909",1683,393,250,484,588,32,140,5,3575
"21067003910",606,449,449,80,353,180,347,323,2787
"21067003911",1424,210,575,861,205,28,188,75,3566
"21067003912",3019,131,483,332,184,43,83,0,4275
"21067003913",4833,61,481,86,643,0,270,0,6374
"21067003914",1278,130,202,220,270,0,131,0,2231
"21067003915",2220,91,300,2,237,0,0,0,2850
"21067003916",641,22,9,0,0,0,0,0,672
"21067003917",787,0,380,0,8,0,12,0,1187
"21067003918",1612,147,324,34,149,2,0,0,2268
"21067004001",3575,1004,651,517,141,321,143,137,6489
"21067004003",3563,447,290,0,511,0,58,0,4869
"21067004005",1769,46,51,0,41,24,36,0,1967
"21067004006",1125,0,32,0,4,6,0,0,1167
"21067004007",1620,92,18,0,138,0,21,0,1889
"21067004103",1205,113,35,15,146,4,106,0,1624
"21067004104",2954,624,322,148,153,26,0,168,4395
"21067004105",3710,170,187,35,83,30,80,17,4312
"21067004106",3494,223,184,53,459,8,43,0,4464
"21067004107",4495,362,159,9,537,0,59,0,5621
"21067004204",3848,655,717,35,402,51,179,172,6059
"21067004205",5463,65,404,24,519,30,127,0,6632
"21067004207",3291,119,126,6,160,35,35,7,3779
"21067004208",5794,232,11,0,1150,39,193,0,7419
"21067004209",3659,35,56,29,103,0,26,0,3908
"21067004210",3459,11,250,22,700,72,110,0,4624
"21069920100",2574,846,92,111,105,45,70,33,3876
"21069920200",3147,523,0,0,0,25,0,0,3695
"21069920300",2048,629,0,7,32,0,59,0,2775
"21069920400",3135,996,0,0,29,0,0,0,4160
"21071920100",2149,982,0,36,88,19,27,32,3333
"21071920200",1672,744,0,0,7,16,0,0,2439
"21071920300",3748,939,92,0,20,20,30,18,4867
"21071920400",2951,1451,0,0,0,0,0,0,4402
"21071920500",1625,1080,41,20,58,24,0,10,2858
"21071920600",2302,724,0,0,0,8,0,0,3034
"21071920700",2219,959,0,0,0,12,0,0,3190
"21071920800",4617,1277,0,1,3,8,0,0,5906
"21071920900",1332,440,0,0,0,83,0,71,1926
"21071921000",4497,2234,0,70,64,27,0,44,6936
"21073070100",3574,312,678,258,655,197,591,58,6323
"21073070401",1939,327,139,0,61,0,0,0,2466
"21073070402",3784,1048,338,71,147,0,0,0,5388
"21073070500",1154,400,185,226,139,30,39,29,2202
"21073070600",1884,398,597,503,181,101,35,133,3832
"21073070701",2664,392,414,135,3,62,0,0,3670
"21073070702",3985,214,207,63,476,185,294,38,5462
"21073070800",4049,580,121,13,57,31,10,0,4861
"21073071000",4383,561,121,147,321,0,18,0,5551
"21073071100",5405,537,10,0,190,12,14,0,6168
"21073071200",1474,975,106,38,102,68,33,5,2801
"21075960100",2338,353,545,272,128,26,0,0,3662
"21075960200",1555,355,316,342,24,51,69,3,2715
"21077960101",4554,987,35,13,144,346,56,336,6471
"21077960102",1868,395,6,0,62,0,0,0,2331
"21079970100",4661,845,0,0,6,8,14,96,5630
"21079970200",3251,929,221,0,28,9,64,4,4506
"21079970300",2073,1011,209,36,30,0,32,27,3418
"21079970400",2875,317,5,0,140,26,121,26,3510
"21081920100",5935,1463,0,35,155,61,116,36,7801
"21081920200",5465,982,96,0,330,10,224,13,7120
"21081920300",5759,1205,8,0,193,8,138,0,7311
"21081920400",1885,589,25,0,40,0,17,1,2557
"21083020100",2125,883,163,262,93,227,26,213,3992
"21083020200",3125,402,406,200,10,0,312,150,4605
"21083020300",4312,1813,259,27,214,0,825,241,7691
"21083020400",2585,473,1,0,174,0,103,42,3378
"21083020500",3097,570,84,0,105,0,19,3,3878
"21083020600",2056,384,23,0,13,0,25,0,2501
"21083020700",3754,556,0,39,69,10,48,21,4497
"21083020800",4477,619,0,0,78,92,19,34,5319
"21083020900",2431,240,6,7,20,0,6,78,2788
"21085950100",2119,362,0,0,36,33,0,0,2550
"21085950200",2556,617,19,0,0,25,0,0,3217
"21085950300",2710,853,0,0,28,0,9,0,3600
"21085950400",5076,1382,38,152,0,118,22,0,6788
"21085950500",1927,556,0,0,0,0,0,0,2483
"21085950600",2781,1293,3,64,16,48,40,30,4275
"21085950700",1962,215,2,0,81,166,14,166,2606
"21087930100",2096,680,33,36,40,8,0,0,2893
"21087930200",2999,819,65,72,40,19,0,0,4014
"21087930300",1899,496,30,0,36,126,8,92,2687
"21087930400",1421,166,19,10,9,0,0,0,1625
"21089040100",3645,347,71,0,128,0,59,0,4250
"21089040201",2257,205,38,0,0,0,0,0,2500
"21089040202",3603,825,0,0,51,147,70,0,4696
"21089040300",3595,663,3,0,79,0,5,35,4380
"21089040400",4657,776,0,0,56,104,54,0,5647
"21089040501",2686,597,0,0,0,6,0,11,3300
"21089040502",3588,889,60,59,103,22,50,20,4791
"21089040600",2424,867,0,0,44,0,0,29,3364
"21089040700",2632,931,0,0,0,26,0,0,3589
"21091960100",2479,325,33,0,73,0,0,0,2910
"21091960200",2596,496,55,9,32,40,36,52,3316
"21091960300",2056,345,0,0,3,0,16,4,2424
"21093000100",689,252,0,0,29,30,38,8,1046
"21093000201",785,7,184,0,3,3,92,3,1077
"21093000202",2660,307,995,18,562,63,500,138,5243
"21093000300",2189,164,860,276,580,68,188,0,4325
"21093000400",2718,452,515,538,347,384,401,243,5598
"21093000500",805,260,349,420,258,100,173,20,2385
"21093000600",1904,312,698,317,131,43,169,71,3645
"21093000700",2811,649,755,173,400,144,419,60,5411
"21093000800",3225,84,710,129,289,64,160,56,4717
"21093000901",8201,779,585,71,550,34,384,16,10620
"21093000902",2949,311,1002,38,444,169,309,97,5319
"21093001001",5102,1033,93,105,217,111,507,28,7196
"21093001002",7400,832,84,267,152,71,66,12,8884
"21093001100",2426,342,235,279,243,181,138,31,3875
"21093001200",3847,415,824,17,547,27,202,0,5879
"21093001300",3807,966,252,0,282,44,90,230,5671
"21093001401",2663,557,171,10,358,28,28,0,3815
"21093001402",2004,938,242,105,391,44,68,0,3792
"21093001500",966,460,310,187,146,30,47,30,2176
"21093001600",6258,1783,114,4,216,0,105,13,8493
"21093001700",7227,624,183,8,32,0,0,0,8074
"21093980100",9,0,0,0,3,0,3,0,15
"21095970100",1261,369,148,109,11,22,0,0,1920
"21095970200",1975,1262,47,7,28,9,11,2,3341
"21095970300",752,289,0,0,0,0,0,0,1041
"21095970400",821,145,12,0,0,0,0,0,978
"21095970500",982,213,10,4,27,0,16,5,1257
"21095970600",1972,778,0,0,92,14,44,17,2917
"21095970700",2752,1480,0,0,34,0,2,36,4304
"21095970800",859,344,83,6,9,2,0,2,1305
"21095970900",3391,1035,65,71,5,109,22,67,4765
"21095971000",2391,1628,47,78,28,100,0,0,4272
"21095971300",1810,869,0,0,0,0,0,0,2679
"21097950100",2246,493,0,0,53,108,0,98,2998
"21097950200",2048,299,0,0,72,0,0,0,2419
"21097950300",3556,1034,76,86,20,172,21,0,4965
"21097950400",2238,985,50,77,28,62,99,100,3639
"21097950500",3725,940,14,0,54,0,45,0,4778
"21099970100",1340,291,0,0,0,0,22,0,1653
"21099970200",1997,673,17,4,37,0,17,0,2745
"21099970300",3369,968,95,150,9,27,110,34,4762
"21099970400",3010,1602,313,154,97,20,42,7,5245
"21099970500",2821,787,107,75,24,55,37,0,3906
"21101020100",901,683,169,84,45,17,11,23,1933
"21101020200",972,398,127,31,27,7,73,0,1635
"21101020300",966,513,252,97,121,37,47,23,2056
"21101020400",1128,582,273,230,43,101,116,10,2483
"21101020500",1713,212,233,76,149,37,13,0,2433
"21101020601",5341,786,255,17,233,121,147,0,6900
"21101020602",2916,717,318,307,64,208,27,45,4602
"21101020701",4617,673,302,30,54,9,8,0,5693
"21101020702",5870,565,0,0,87,32,54,0,6608
"21101020800",3544,353,15,1,56,17,171,24,4181
"21101020900",6029,994,333,37,80,63,97,2,7635
"21103090100",2005,221,33,10,20,7,0,7,2303
"21103090200",2764,579,50,21,47,54,22,65,3602
"21103090301",2264,309,50,0,85,0,27,0,2735
"21103090302",2464,704,192,98,140,120,181,117,4016
"21103090400",2351,462,57,1,32,0,15,39,2957
"21105970100",3414,694,253,142,127,16,62,16,4724
"21107970100",2779,203,25,0,34,37,3,0,3081
"21107970200",3188,460,7,2,38,0,4,14,3713
"21107970300",4674,584,442,120,209,184,134,12,6359
"21107970400",970,374,316,151,61,68,34,0,1974
"21107970500",3986,530,48,233,36,28,222,0,5083
"21107970600",1525,836,333,263,230,128,6,110,3431
"21107970700",3790,491,127,102,220,0,113,0,4843
"21107970800",2569,421,69,20,39,0,70,0,3188
"21107970900",2091,775,264,77,40,14,17,0,3278
"21107971000",2396,402,0,0,0,0,0,0,2798
"21107971100",2258,801,0,19,68,40,19,0,3205
"21107971300",4266,1183,83,38,67,23,8,10,5678
"21109960100",3080,2068,0,0,72,0,4,9,5233
"21109960200",2281,684,0,0,0,0,27,10,3002
"21109960300",3324,1750,0,0,0,48,47,0,5169
"21111000200",1296,922,235,355,16,0,21,16,2861
"21111000300",1003,337,694,164,77,0,0,0,2275
"21111000400",803,361,2924,766,83,9,49,0,4995
"21111000600",106,24,732,710,139,71,0,0,1782
"21111000700",116,28,1670,1006,34,7,0,0,2861
"21111000800",15,5,1565,700,7,3,0,0,2295
"21111000900",89,6,1604,429,50,0,0,0,2178
"21111001000",54,37,1475,1035,36,44,42,0,2723
"21111001100",68,44,2581,598,44,36,13,0,3384
"21111001200",26,30,1894,719,13,20,0,0,2702
"21111001400",4,23,1586,691,14,0,21,0,2339
"21111001500",238,0,1760,853,35,0,0,0,2886
"21111001600",97,128,1341,906,0,0,0,79,2551
"21111001700",71,70,1226,563,40,162,0,40,2172
"21111001800",6,57,736,752,11,47,0,13,1622
"21111002100",1078,636,172,498,10,20,31,10,2455
"21111002300",743,923,419,289,18,66,30,0,2488
"21111002400",122,145,2320,1911,94,226,0,0,4818
"21111002700",48,142,1354,1456,84,130,0,0,3214
"21111002800",99,137,813,473,18,41,0,0,1581
"21111003000",62,168,414,2592,23,120,0,0,3379
"21111003500",405,311,402,1826,10,71,0,11,3036
"21111003600",2333,937,939,1340,106,57,503,110,6325
"21111003700",707,353,392,202,85,14,102,14,1869
"21111003800",2089,464,418,167,294,94,21,30,3577
"21111003900",1929,769,671,474,39,115,244,61,4302
"21111004000",977,390,331,35,84,39,30,0,1886
"21111004100",1321,497,362,199,294,18,28,166,2885
"21111004301",578,753,1332,1279,218,69,33,100,4362
"21111004302",449,280,386,268,62,81,97,0,1623
"21111004400",2907,382,345,671,289,18,219,105,4936
"21111004500",2178,548,286,212,131,58,562,112,4087
"21111004600",2332,224,345,142,602,165,471,0,4281
"21111004900",743,399,573,519,114,49,86,49,2532
"21111005000",416,186,420,548,28,38,0,13,1649
"21111005100",1376,669,363,747,67,12,101,20,3355
"21111005200",1732,675,347,159,71,122,130,56,3292
"21111005300",344,255,66,107,118,16,0,0,906
"21111005600",2014,384,716,576,661,595,522,85,5553
"21111005900",784,440,1063,1131,44,286,0,15,3763
"21111006200",128,145,765,882,55,53,6,0,2034
"21111006300",1404,387,38,26,77,0,11,0,1943
"21111006400",1417,189,14,0,25,6,35,7,1693
"21111006500",725,333,887,782,22,122,24,0,2895
"21111006600",1030,261,275,222,45,69,64,0,1966
"21111006800",1646,426,96,87,3,0,39,0,2297
"21111006900",1502,344,59,56,9,0,135,0,2105
"21111007000",1762,200,60,35,7,0,33,0,2097
"21111007100",2154,964,374,217,672,327,192,138,5038
"21111007400",1389,370,8,52,60,50,29,0,1958
"21111007501",4911,83,24,0,119,3,57,2,5199
"21111007502",4371,383,202,0,358,0,33,0,5347
"21111007601",1482,241,171,25,99,9,52,0,2079
"21111007602",1719,764,521,142,289,100,14,155,3704
"21111007603",1526,267,335,93,97,21,42,0,2381
"21111007700",2619,506,131,0,27,226,31,0,3540
"21111007800",2759,212,79,0,7,0,0,0,3057
"21111007900",1452,151,6,0,15,8,10,10,1652
"21111008100",2559,296,116,21,99,13,108,13,3225
"21111008200",3569,285,103,0,207,13,39,67,4283
"21111008300",1801,239,27,0,108,6,0,0,2181
"21111008400",2529,233,0,0,8,33,37,11,2851
"21111008500",1740,217,23,0,44,0,88,0,2112
"21111008700",3508,74,7,2,68,0,76,0,3735
"21111008800",2646,309,26,0,131,11,96,0,3219
"21111008900",3056,135,123,1,181,0,66,0,3562
"21111009000",3719,1099,742,80,904,77,572,366,7559
"21111009103",921,110,173,127,197,111,3,8,1650
"21111009105",1393,1023,436,89,133,238,459,225,3996
"21111009106",3914,521,363,18,361,0,93,0,5270
"21111009300",4168,263,7,30,89,23,12,0,4592
"21111009400",5497,898,19,278,79,50,29,190,7040
"21111009600",3811,295,12,0,78,0,24,0,4220
"21111009700",2229,337,36,0,64,0,47,0,2713
"21111009800",2434,48,0,0,7,11,10,11,2521
"21111009900",2216,242,67,63,111,0,19,4,2722
"21111010001",4256,113,187,0,139,0,65,0,4760
"21111010004",3052,287,380,125,116,12,168,0,4140
"21111010005",3462,317,70,2,332,25,129,32,4369
"21111010006",2595,234,446,82,180,0,134,33,3704
"21111010007",3671,115,91,0,163,24,205,6,4275
"21111010008",2779,293,319,213,244,35,74,39,3996
"21111010102",3921,50,81,0,84,0,17,0,4153
"21111010103",3378,331,422,44,94,55,45,200,4569
"21111010104",2353,132,207,23,170,69,265,78,3297
"21111010307",4455,297,231,0,310,15,197,15,5520
"21111010309",3525,46,381,8,773,0,61,0,4794
"21111010311",4254,341,1359,123,905,292,199,264,7737
"21111010312",2954,69,60,0,87,0,157,0,3327
"21111010313",3111,117,226,0,430,21,190,0,4095
"21111010314",5313,59,373,0,526,0,232,0,6503
"21111010315",2315,133,70,0,465,50,46,0,3079
"21111010316",3881,245,306,20,350,40,52,9,4903
"21111010317",4064,45,21,17,418,0,65,0,4630
"21111010318",5301,134,247,0,346,20,267,0,6315
"21111010319",3374,177,625,5,325,14,285,48,4853
"21111010320",1680,39,1263,89,407,54,169,38,3739
"21111010402",5057,244,389,66,309,173,94,0,6332
"21111010403",3217,91,188,55,242,6,169,0,3968
"21111010405",3010,587,302,59,69,75,63,0,4165
"21111010406",4626,233,337,333,328,0,126,32,6015
"21111010500",2994,304,162,14,155,32,22,33,3716
"21111010601",2569,374,16,10,82,0,45,0,3096
"21111010602",2538,446,177,0,160,203,141,92,3757
"21111010701",3677,262,294,1,643,0,51,1,4929
"21111010702",4299,196,489,56,392,84,113,90,5719
"21111010705",4215,394,702,0,563,0,68,55,5997
"21111010706",2897,111,90,0,148,141,83,141,3611
"21111010800",2762,237,383,49,94,11,196,9,3741
"21111010901",2665,498,846,117,63,295,222,366,5072
"21111010902",3344,263,349,100,222,0,108,21,4407
"21111011002",1979,783,1109,629,296,89,476,302,5663
"21111011003",4233,237,753,199,142,0,168,0,5732
"21111011004",4084,644,819,58,121,0,143,209,6078
"21111011005",1653,276,623,45,82,20,38,80,2817
"21111011102",5358,508,223,12,319,19,421,103,6963
"21111011106",4922,659,438,180,504,0,570,137,7410
"21111011109",1619,59,241,53,89,0,42,0,2103
"21111011110",4981,319,375,0,146,88,123,0,6032
"21111011111",4090,299,816,99,272,0,219,71,5866
"21111011112",2425,76,410,208,136,0,34,36,3325
"21111011113",1662,257,447,7,227,0,34,0,2634
"21111011114",3420,232,1356,461,149,0,85,0,5703
"21111011200",2608,455,995,647,261,46,337,248,5597
"21111011301",465,427,1059,304,150,10,125,112,2652
"21111011302",696,755,3209,1899,102,250,132,185,7228
"21111011403",1371,280,2,19,42,0,36,0,1750
"21111011404",1058,563,513,423,215,165,283,141,3361
"21111011405",1868,401,1876,524,613,58,1019,172,6531
"21111011406",2200,280,1061,546,415,109,764,162,5537
"21111011505",4062,525,1099,367,305,68,425,357,7208
"21111011506",3626,465,824,254,399,14,186,118,5886
"21111011508",3477,240,862,120,129,77,54,0,4959
"21111011509",2142,460,762,110,104,174,319,23,4094
"21111011513",3415,502,525,80,159,20,237,86,5024
"21111011514",2324,148,618,2,78,37,5,0,3212
"21111011515",3713,294,439,19,176,0,41,0,4682
"21111011516",3362,383,229,0,50,0,59,0,4083
"21111011517",4280,401,618,18,328,17,250,0,5912
"21111011518",2299,5,118,0,94,0,123,0,2639
"21111011519",3919,184,517,0,298,0,144,0,5062
"21111011520",3390,74,39,0,89,0,32,0,3624
"21111011601",5045,48,537,0,373,17,71,0,6091
"21111011603",3980,45,53,0,85,0,40,0,4203
"21111011604",2471,9,82,0,18,0,52,0,2632
"21111011706",3207,149,119,8,126,0,254,90,3953
"21111011707",3989,488,1088,96,54,92,88,0,5895
"21111011708",3688,168,340,0,140,0,109,0,4445
"21111011709",3798,200,61,0,36,47,60,11,4213
"21111011710",1963,444,188,188,43,0,22,0,2848
"21111011711",4313,597,369,25,155,11,194,120,5784
"21111011712",3436,248,271,70,282,0,302,11,4620
"21111011713",1712,640,151,0,136,14,18,165,2836
"21111011800",1531,353,380,169,159,186,59,179,3016
"21111011901",479,508,0,0,174,34,340,373,1908
"21111011904",2086,162,105,109,150,176,410,42,3240
"21111011905",4590,1116,498,507,718,399,399,129,8356
"21111011906",1654,532,404,243,221,67,621,349,4091
"21111011907",3688,271,211,44,152,63,78,5,4512
"21111012001",2880,511,5,9,52,6,49,6,3518
"21111012002",4479,842,17,13,379,134,218,330,6412
"21111012003",2790,576,22,0,176,39,122,242,3967
"21111012103",2632,382,41,72,120,0,9,0,3256
"21111012104",2819,427,198,3,61,0,0,24,3532
"21111012105",4086,366,38,0,196,38,105,0,4829
"21111012106",7023,880,210,0,73,0,220,0,8406
"21111012107",4668,770,0,8,14,0,91,167,5718
"21111012202",3784,772,971,43,366,77,298,0,6311
"21111012203",4772,668,359,65,206,16,86,0,6172
"21111012204",3262,245,106,220,94,0,60,0,3987
"21111012301",2362,141,622,42,61,56,105,92,3481
"21111012302",4012,371,524,323,199,11,132,14,5586
"21111012406",4975,304,196,16,161,0,67,0,5719
"21111012407",3578,215,560,339,102,0,97,0,4891
"21111012408",1789,213,219,8,93,24,30,61,2437
"21111012409",2358,568,375,38,101,14,76,0,3530
"21111012410",3138,185,972,66,31,0,18,0,4410
"21111012411",4994,676,1109,220,0,23,36,0,7058
"21111012501",1189,361,353,152,99,0,0,0,2154
"21111012502",3765,729,460,472,161,299,110,343,6339
"21111012503",2458,460,490,187,78,71,0,0,3744
"21111012601",1818,210,3792,994,259,104,224,0,7401
"21111012603",1015,132,790,339,206,18,9,0,2509
"21111012604",2542,390,1629,340,111,169,284,0,5465
"21111012701",1097,351,1347,449,98,33,44,20,3439
"21111012702",1153,415,156,51,26,0,0,14,1815
"21111012703",4015,1086,568,256,323,0,92,0,6340
"21111012801",363,158,1936,893,23,40,0,0,3413
"21111012802",403,449,1394,331,126,148,68,329,3248
"21111013100",1910,31,9,0,56,6,13,0,2025
"21111980100",0,0,0,0,0,0,0,0,0
"21113060101",6046,1232,238,83,67,60,204,111,8041
"21113060102",4831,1176,220,61,89,14,51,0,6442
"21113060200",3169,616,26,22,33,14,100,31,4011
"21113060300",1928,655,54,0,19,103,0,0,2759
"21113060400",5215,831,32,57,379,139,166,0,6819
"21113060502",4521,948,318,66,173,195,47,195,6463
"21113060503",3480,603,70,31,27,186,20,91,4508
"21113060504",2571,525,38,35,36,0,92,96,3393
"21113060600",5226,275,92,0,318,26,128,0,6065
"21115960100",2254,1061,0,0,45,0,28,0,3388
"21115960200",2075,464,0,0,0,0,0,0,2539
"21115960300",2705,735,53,0,29,0,39,0,3561
"21115960400",3774,1532,0,0,58,82,0,33,5479
"21115960500",2621,490,0,0,0,0,0,0,3111
"21115960600",3534,1183,18,6,106,0,22,0,4869
"21117060300",981,348,108,19,59,37,74,37,1663
"21117060700",709,250,144,80,56,143,6,92,1480
"21117060900",1173,847,117,181,85,269,46,221,2939
"21117061000",935,525,245,236,27,16,56,11,2051
"21117061100",1051,270,18,71,24,0,56,0,1490
"21117061200",1808,422,10,4,33,0,48,0,2325
"21117061300",1626,399,49,5,143,8,72,6,2308
"21117061400",2985,401,38,16,47,76,47,0,3610
"21117061600",709,330,38,46,36,86,66,73,1384
"21117063603",6829,832,75,26,503,144,451,207,9067
"21117063604",5103,687,52,52,44,162,340,0,6440
"21117063605",9912,808,354,0,284,0,136,0,11494
"21117063606",3972,291,54,0,18,16,25,0,4376
"21117063701",2771,146,0,0,68,0,84,0,3069
"21117063702",3381,605,0,0,3,24,0,0,4013
"21117063800",2525,611,21,66,67,21,26,0,3337
"21117064000",5522,365,53,0,299,34,148,37,6458
"21117064100",4430,292,56,41,355,95,24,0,5293
"21117064200",1246,26,0,0,40,0,0,0,1312
"21117064300",2828,268,24,7,67,0,13,0,3207
"21117064400",2711,756,233,123,330,92,87,62,4394
"21117064500",3325,149,14,0,12,0,0,0,3500
"21117064600",4327,353,286,82,154,69,71,71,5413
"21117064700",5049,90,184,0,397,0,0,0,5720
"21117064800",2931,252,45,0,188,22,72,47,3557
"21117064900",2228,246,0,139,265,44,250,46,3218
"21117065000",2645,582,194,126,149,188,133,164,4181
"21117065100",1449,799,293,622,17,176,5,115,3476
"21117065200",3405,132,101,0,105,33,134,3,3913
"21117065300",8329,987,35,10,125,83,35,83,9687
"21117065400",940,36,48,0,4,0,0,0,1028
"21117065501",4112,35,22,0,38,0,0,0,4207
"21117065502",3728,117,12,1,40,0,13,0,3911
"21117065600",4129,318,548,279,208,185,35,185,5887
"21117065700",1826,211,0,0,103,8,99,0,2247
"21117065800",2701,174,13,0,21,0,0,0,2909
"21117065900",1320,222,0,0,11,1,0,0,1554
"21117066800",6793,650,198,0,413,42,133,0,8229
"21117066900",3064,909,6,3,3,46,13,17,4061
"21117067000",1480,478,197,148,42,31,15,0,2391
"21117067100",496,373,279,444,100,137,0,49,1878
"21119960100",1516,622,0,0,73,0,71,0,2282
"21119960200",2183,423,0,0,25,4,0,0,2635
"21119960300",2931,1110,8,3,23,0,28,10,4113
"21119960400",1868,547,0,0,6,3,0,0,2424
"21119960500",3315,744,0,109,10,33,0,0,4211
"21121930100",1195,839,0,0,11,0,6,0,2051
"21121930200",2699,1507,27,0,0,71,0,0,4304
"21121930300",1655,1184,0,0,10,0,0,0,2849
"21121930400",5036,1850,0,0,46,22,0,0,6954
"21121930500",2904,1552,0,0,76,8,44,0,4584
"21121930601",3769,2115,0,88,0,13,332,116,6433
"21121930602",1428,577,64,75,11,0,0,0,2155
"21121930700",1427,911,0,0,22,0,0,0,2360
"21123960101",1193,321,54,0,0,0,0,0,1568
"21123960102",4122,724,192,161,126,105,79,83,5592
"21123960200",2543,454,12,0,41,0,20,0,3070
"21123960300",3062,453,7,22,173,111,123,101,4052
"21125970100",2239,753,0,0,6,0,164,0,3162
"21125970200",4864,1815,62,27,149,117,51,0,7085
"21125970300",3875,661,0,0,0,0,0,0,4536
"21125970400",2786,509,0,0,70,0,10,0,3375
"21125970500",3372,1152,112,78,14,12,32,9,4781
"21125970600",2026,812,38,13,11,0,46,107,3053
"21125970700",4337,1178,45,0,158,145,151,114,6128
"21125970800",3570,734,0,0,86,0,0,0,4390
"21125970900",2615,754,0,0,4,9,0,0,3382
"21125971001",2591,1106,0,0,32,0,0,0,3729
"21125971002",4406,1651,0,0,102,17,0,0,6176
"21125971101",1930,176,0,0,44,0,33,0,2183
"21125971102",5942,908,0,0,167,105,54,0,7176
"21127930100",5413,1498,0,12,30,49,30,0,7032
"21127930200",1154,442,0,0,20,7,0,0,1623
"21127930300",1206,471,0,0,0,0,0,6,1683
"21127930400",1819,968,0,0,4,0,0,0,2791
"21127930500",1764,750,0,0,87,61,0,0,2662
"21129950100",2134,1127,29,0,28,0,0,0,3318
"21129950200",1033,543,0,1,24,0,0,17,1618
"21129950300",903,801,0,16,48,0,0,0,1768
"21131920100",4137,1068,0,18,0,6,0,0,5229
"21131920200",2142,767,0,0,0,81,0,0,2990
"21131920300",2193,539,0,0,39,7,0,0,2778
"21133950100",2199,759,7,8,31,0,43,0,3047
"21133950200",3475,1180,16,29,12,16,17,16,4761
"21133950300",990,418,0,0,27,0,0,0,1435
"21133950401",2189,505,0,0,14,14,29,0,2751
"21133950402",3104,1100,0,21,57,0,38,0,4320
"21133950500",1592,408,0,27,19,39,4,0,2089
"21133950600",4074,1492,2,0,0,0,0,0,5568
"21135930100",2808,1212,0,0,4,20,0,2,4046
"21135930200",2626,1133,0,38,26,0,0,0,3823
"21135930300",2336,821,0,0,44,61,6,61,3329
"21135930400",1708,644,0,0,0,0,0,12,2364
"21137920101",1427,329,234,0,17,0,0,0,2007
"21137920102",2728,869,180,69,125,38,175,48,4232
"21137920103",1170,873,0,73,0,27,24,0,2167
"21137920200",5325,655,0,3,49,0,49,0,6081
"21137920300",3582,2058,0,10,118,0,77,0,5845
"21137920400",3030,1164,62,0,62,0,3,0,4321
"21139040100",2218,535,12,41,58,32,47,0,2943
"21139040200",5462,973,0,0,33,0,34,46,6548
"21141960100",4514,712,68,16,66,16,66,5,5463
"21141960200",2755,706,16,0,16,0,0,0,3493
"21141960300",3444,1269,597,96,27,0,151,19,5603
"21141960400",3890,589,219,26,66,0,0,3,4793
"21141960500",2472,664,189,579,67,23,17,23,4034
"21141960600",2283,874,141,37,50,6,96,268,3755
"21143960100",4290,786,47,3,10,90,10,0,5236
"21143960200",1464,262,0,0,2,36,3,36,1803
"21143980100",0,0,0,0,0,0,0,0,0
"21145030100",462,409,77,59,17,10,17,6,1057
"21145030200",725,311,390,376,77,57,0,12,1948
"21145030300",662,209,68,18,24,14,0,14,1009
"21145030400",418,193,355,544,15,163,32,32,1752
"21145030500",578,193,484,80,35,23,0,9,1402
"21145030600",1733,751,316,288,94,309,12,17,3520
"21145030700",2384,465,757,292,168,52,30,0,4148
"21145030800",3918,367,315,0,233,0,174,22,5029
"21145030900",1791,594,462,72,100,111,77,56,3263
"21145031000",3424,807,98,103,71,22,131,0,4656
"21145031100",4775,438,86,0,150,0,98,0,5547
"21145031200",4341,340,20,66,61,4,0,0,4832
"21145031301",4092,309,173,145,154,43,202,0,5118
"21145031302",5231,229,234,63,187,75,74,24,6117
"21145031400",4938,627,165,11,199,99,231,40,6310
"21145031500",5589,802,350,0,158,25,31,0,6955
"21145031600",2675,238,0,0,79,0,70,0,3062
"21147960100",1528,814,0,0,14,0,0,59,2415
"21147960200",796,356,0,0,35,12,0,0,1199
"21147960300",4877,1622,0,0,70,42,0,0,6611
"21147960400",4071,1951,18,137,19,34,0,19,6249
"21149970100",2399,586,17,0,71,20,59,7,3159
"21149970200",2669,660,1,0,0,12,0,0,3342
"21149970500",2442,477,18,4,34,11,42,9,3037
"21151010101",1895,138,0,0,5,0,0,0,2038
"21151010102",5710,883,64,0,315,106,89,19,7186
"21151010200",2009,1557,96,155,252,9,88,10,4176
"21151010300",4359,1625,441,247,384,442,112,322,7932
"21151010400",942,371,137,90,27,54,0,0,1621
"21151010500",149,74,5,9,24,19,0,0,280
"21151010600",3933,831,59,51,0,172,54,0,5100
"21151010701",2694,922,107,466,11,44,0,13,4257
"21151010702",3203,268,16,0,35,0,113,18,3653
"21151010800",3929,591,20,0,52,23,50,0,4665
"21151010901",3028,161,20,0,42,0,69,71,3391
"21151010902",1802,552,49,0,210,0,41,0,2654
"21151010903",2367,993,230,135,186,78,185,17,4191
"21151011000",4724,709,208,18,39,0,56,0,5754
"21151011100",5849,967,14,0,44,5,28,0,6907
"21151011200",3749,1471,162,72,56,0,20,0,5530
"21151011301",1476,858,9,0,23,19,0,138,2523
"21151011302",2464,970,53,2,129,95,92,86,3891
"21151011400",3327,490,0,0,199,0,12,0,4028
"21153970100",1052,693,0,0,0,0,18,0,1763
"21153970200",4395,1326,0,0,5,51,61,0,5838
"21153970300",2267,837,0,0,0,0,0,0,3104
"21153970400",1517,757,0,0,44,55,0,0,2373
"21155970200",2884,587,525,106,159,6,55,0,4322
"21155970300",1727,215,129,0,99,6,99,0,2275
"21155970400",2410,516,25,30,19,0,0,3,3003
"21155970500",1593,178,0,0,0,0,0,0,1771
"21155970700",3774,845,272,471,0,0,156,0,5518
"21155970800",1732,192,0,0,92,1,116,0,2133
"21157950100",4173,545,0,6,64,8,18,18,4832
"21157950200",4336,602,0,1,71,0,40,0,5050
"21157950300",4097,438,0,0,68,0,188,0,4791
"21157950400",4422,659,0,0,67,0,24,0,5172
"21157950500",4717,577,45,0,84,0,34,0,5457
"21157950600",4985,676,0,2,43,40,0,40,5786
"21159950100",2414,1092,0,0,27,3,0,0,3536
"21159950200",4281,2600,0,29,2,0,60,14,6986
"21159950300",584,264,0,0,54,0,0,0,902
"21161960100",2471,658,6,23,60,0,0,0,3218
"21161960200",2085,684,376,122,23,9,0,9,3308
"21161960300",2671,409,379,197,90,118,44,9,3917
"21161960400",3925,702,112,65,82,18,0,0,4904
"21161960500",1496,252,0,29,3,4,0,0,1784
"21163970100",652,298,19,69,30,32,35,7,1142
"21163970200",1805,142,435,0,391,19,296,10,3098
"21163970301",2450,492,55,27,0,64,0,0,3088
"21163970302",4641,954,56,0,242,79,59,0,6031
"21163970401",3776,1183,81,228,0,8,20,94,5390
"21163970402",5927,874,42,115,58,50,346,34,7446
"21163970500",3093,226,82,0,49,0,50,0,3500
"21163980100",45,17,0,0,0,0,0,0,62
"21165960100",2544,1005,0,0,62,66,89,34,3800
"21165960200",1850,530,10,32,0,62,0,14,2498
"21167960100",3561,249,40,0,261,12,114,0,4237
"21167960200",4359,1073,77,346,17,0,145,86,6103
"21167960300",2968,381,0,0,34,8,8,0,3399
"21167960400",3030,811,224,58,106,36,69,40,4374
"21167960500",2843,471,10,20,25,69,12,0,3450
"21169960100",1566,411,49,9,27,18,27,0,2107
"21169960200",2393,580,0,27,30,165,0,68,3263
"21169960300",3749,716,81,30,20,23,32,0,4651
"21171930100",1463,390,0,0,0,0,10,50,1913
"21171930200",1561,665,5,4,27,11,46,38,2357
"21171930300",1829,569,142,0,21,47,14,11,2633
"21171930400",2876,973,52,25,33,15,128,0,4102
"21173920100",2425,561,102,0,10,0,54,26,3178
"21173920200",4666,1535,277,58,368,187,351,117,7559
"21173920301",2177,321,31,26,21,0,0,0,2576
"21173920302",4034,1535,143,32,133,27,75,0,5979
"21173920400",3063,1551,0,9,2,7,14,0,4646
"21173920500",2220,731,48,0,9,13,41,9,3071
"21175950100",1834,633,0,0,0,0,0,0,2467
"21175950200",1464,706,0,0,9,0,0,0,2179
"21175950300",1255,412,0,0,5,0,0,0,1672
"21175950400",2516,939,0,0,75,2,16,10,3558
"21175950500",1271,741,0,0,21,3,12,0,2048
"21177960100",702,267,9,22,8,0,0,0,1008
"21177960200",4193,1586,122,310,159,87,101,17,6575
"21177960300",3740,524,0,0,46,18,71,0,4399
"21177960400",3853,539,103,115,91,136,48,107,4992
"21177960500",2758,495,100,14,51,27,21,0,3466
"21177960600",2188,638,24,59,6,12,14,0,2941
"21177960700",2546,698,53,0,38,52,0,0,3387
"21177960800",1719,328,74,0,6,0,0,0,2127
"21177960900",1232,145,0,12,0,12,0,0,1401
"21179930100",3095,535,73,14,18,68,7,90,3900
"21179930200",6446,804,114,1,54,7,45,2,7473
"21179930301",3863,809,115,1,0,111,0,111,5010
"21179930302",5753,1197,241,623,194,0,16,237,8261
"21179930303",2001,1128,354,75,70,79,30,158,3895
"21179930400",2230,531,379,128,19,24,0,0,3311
"21179930500",5318,631,135,0,16,67,155,0,6322
"21179930600",2252,524,0,0,51,20,25,0,2872
"21179930700",2751,544,0,0,51,24,14,15,3399
"21181960100",1578,313,0,1,14,0,23,0,1929
"21181960200",4144,792,28,0,54,0,48,43,5109
"21183920100",2613,628,0,0,3,24,0,92,3360
"21183920200",2525,575,5,0,184,0,148,94,3531
"21183920300",3026,708,40,13,55,0,45,46,3933
"21183920400",1106,418,0,0,0,11,0,0,1535
"21183920500",5686,1397,362,192,43,15,325,0,8020
"21183920600",1726,344,0,0,31,53,25,53,2232
"21183920700",1428,226,8,0,0,14,0,0,1676
"21185030100",1794,205,36,0,54,0,6,0,2095
"21185030200",1006,79,21,47,98,0,156,30,1437
"21185030301",2122,101,62,0,283,0,286,48,2902
"21185030302",3252,854,196,0,151,332,140,332,5257
"21185030401",5624,323,262,7,299,80,105,0,6700
"21185030402",2471,10,114,37,47,41,0,0,2720
"21185030501",3470,257,14,17,124,95,124,95,4196
"21185030502",4454,125,76,0,54,11,103,0,4823
"21185030601",5336,320,140,54,290,123,37,123,6423
"21185030602",4614,255,14,0,224,0,207,0,5314
"21185030701",2191,66,0,0,102,0,0,0,2359
"21185030702",4780,230,76,9,296,0,142,0,5533
"21185030801",3596,98,168,0,36,0,2,0,3900
"21185030802",4418,54,117,22,168,0,105,0,4884
"21187970100",2521,417,63,0,81,0,61,51,3194
"21187970200",3989,707,69,6,16,39,77,0,4903
"21187970300",2276,575,0,0,0,0,0,65,2916
"21189930100",1622,956,15,7,0,108,0,0,2708
"21189930200",1246,673,9,8,0,0,0,0,1936
"21191930100",5992,441,3,9,35,80,92,0,6652
"21191930200",2364,496,6,0,10,0,0,0,2876
"21191930300",3798,1199,8,11,31,35,58,0,5140
"21193970300",2195,516,0,0,43,0,0,0,2754
"21193970400",2569,805,34,11,69,18,0,21,3527
"21193970500",4203,1414,89,16,401,0,178,0,6301
"21193970600",3571,1601,113,7,0,0,0,0,5292
"21193970700",1319,738,0,0,58,33,0,0,2148
"21193970800",1975,564,0,0,0,8,0,0,2547
"21193970900",1271,352,0,0,30,0,0,0,1653
"21193971000",2798,852,0,4,0,67,19,0,3740
"21195930100",2440,635,0,0,9,0,0,0,3084
"21195930200",4814,850,6,11,198,9,155,0,6043
"21195930300",1652,876,91,0,113,26,0,0,2758
"21195930400",2553,1004,9,11,60,33,0,0,3670
"21195930500",2219,599,42,0,47,43,64,43,3057
"21195930600",2751,768,0,15,23,0,0,0,3557
"21195930700",1894,550,0,0,15,0,16,0,2475
"21195930800",2114,988,0,0,16,17,0,0,3135
"21195930900",1695,425,15,0,16,0,0,0,2151
"21195931000",1896,205,0,0,10,0,0,0,2111
"21195931100",3787,1033,0,0,3,0,0,27,4850
"21195931200",3484,997,0,0,0,0,0,0,4481
"21195931300",2334,687,0,0,0,0,0,0,3021
"21195931400",1963,577,54,0,149,28,0,28,2799
"21195931500",2721,935,47,18,0,98,18,8,3845
"21195931600",1244,508,0,0,5,0,0,11,1768
"21195931700",3001,1315,0,0,0,0,0,0,4316
"21195931800",2477,820,0,0,20,0,37,0,3354
"21195931900",2363,712,6,0,47,0,17,0,3145
"21197970100",4130,1071,63,0,101,29,41,80,5515
"21197970200",4038,2787,0,9,50,0,25,0,6909
"21199930100",4356,1776,47,2,103,44,10,287,6625
"21199930200",3717,1049,0,5,55,2,38,0,4866
"21199930300",4013,918,0,25,65,36,0,0,5057
"21199930401",2660,505,20,2,87,0,92,0,3366
"21199930402",4601,848,32,0,0,0,20,50,5551
"21199930501",5278,662,29,32,179,6,179,32,6397
"21199930502",4751,1464,16,16,224,74,192,0,6737
"21199930600",2224,1330,116,2,46,7,59,43,3827
"21199930700",3603,859,25,121,127,14,23,0,4772
"21199930800",3599,1922,75,0,143,84,81,112,6016
"21199930900",2128,835,0,0,34,18,12,18,3045
"21199931000",1196,408,4,0,81,0,0,0,1689
"21199931101",2308,491,0,0,32,19,54,19,2923
"21199931102",1776,900,18,0,32,11,0,0,2737
"21201970100",1708,497,0,0,2,8,0,0,2215
"21203950100",2892,435,0,0,59,32,0,2,3420
"21203950200",4710,1871,5,0,93,53,0,0,6732
"21203950300",2994,974,0,0,22,0,31,0,4021
"21203950400",1605,850,0,13,0,0,0,0,2468
"21205950100",4046,1171,0,16,184,25,106,0,5548
"21205950200",4457,1572,18,0,132,68,68,50,6365
"21205950300",2915,2022,42,27,218,100,87,0,5411
"21205950400",2699,916,35,0,24,8,0,0,3682
"21207960101",2936,753,10,1,0,0,0,0,3700
"21207960102",3244,1483,0,0,64,50,368,0,5209
"21207960200",1298,332,0,0,17,0,18,14,1679
"21207960300",2800,1218,6,4,57,62,122,23,4292
"21207960400",2158,860,42,0,21,0,0,0,3081
"21209040100",3192,909,293,294,168,98,145,247,5346
"21209040203",3891,21,175,67,151,0,120,0,4425
"21209040204",2893,518,60,150,120,0,20,0,3761
"21209040205",2596,422,84,9,347,276,366,236,4336
"21209040206",2079,645,215,230,50,32,23,32,3306
"21209040301",2412,163,17,83,151,33,238,28,3125
"21209040302",1363,0,0,0,12,0,0,0,1375
"21209040303",1160,66,60,139,120,19,0,43,1607
"21209040400",2407,360,25,0,38,0,69,7,2906
"21209040501",2130,297,5,2,64,97,40,0,2635
"21209040502",3355,330,26,0,50,0,39,0,3800
"21209040601",2384,130,90,2,68,0,23,0,2697
"21209040602",3562,66,84,0,68,0,0,0,3780
"21209040603",4128,314,167,0,465,0,227,0,5301
"21211040101",3262,342,0,2,10,0,0,0,3616
"21211040102",4327,472,0,0,92,0,14,6,4911
"21211040200",5822,289,315,91,326,51,413,213,7520
"21211040301",2884,913,508,255,895,245,987,713,7400
"21211040302",1606,589,432,59,269,155,308,426,3844
"21211040401",4274,535,492,31,226,182,113,182,6035
"21211040402",3118,86,183,16,57,2,61,0,3523
"21211040501",2198,17,116,0,53,0,91,0,2475
"21211040502",4251,387,333,337,212,62,207,86,5875
"21213970100",1672,225,15,16,10,0,4,8,1950
"21213970200",3017,835,310,0,149,0,0,0,4311
"21213970300",3174,540,373,144,20,60,24,99,4434
"21213970400",4254,1122,241,460,313,41,25,87,6543
"21215080101",3485,273,70,0,44,0,80,65,4017
"21215080102",4888,161,111,1,139,0,29,0,5329
"21215080103",1632,329,0,0,58,0,0,0,2019
"21215080200",5127,530,121,12,72,9,101,9,5981
"21217920100",1936,639,16,0,0,0,28,0,2619
"21217920200",2151,421,3,10,15,0,74,0,2674
"21217920300",3208,599,94,93,57,29,30,6,4116
"21217920400",5407,1479,128,36,138,73,16,31,7308
"21217920500",4792,1414,331,259,199,54,161,16,7226
"21219950100",2336,482,0,0,24,16,18,0,2876
"21219950200",3814,840,278,224,215,18,190,14,5593
"21219950300",1819,418,346,142,41,122,129,79,3096
"21219950400",865,173,37,17,3,62,0,59,1216
"21221970100",1969,398,263,32,0,0,0,0,2662
"21221970200",4761,995,559,222,145,37,197,0,6916
"21221970300",4029,572,0,10,166,0,0,0,4777
"21221980100",0,4,0,7,0,2,0,0,13
"21221980200",0,0,0,0,0,0,0,0,0
"21223100100",3005,370,0,0,66,2,59,2,3504
"21223100200",4092,956,15,152,71,30,10,182,5508
"21225950100",1414,214,35,58,31,0,0,0,1752
"21225950201",2899,1198,147,712,67,106,23,184,5336
"21225950202",1858,416,416,233,82,32,0,0,3037
"21225950300",3952,674,122,161,19,16,45,0,4989
"21227010100",701,703,77,269,61,30,40,3,1884
"21227010200",766,519,598,796,374,388,169,148,3758
"21227010300",1210,1119,297,354,433,723,572,553,5261
"21227010400",131,145,24,0,45,42,0,2,389
"21227010500",1207,705,163,33,49,12,21,0,2190
"21227010600",2754,372,219,38,292,106,210,98,4089
"21227010701",2967,632,82,516,883,289,261,0,5630
"21227010702",4205,336,310,151,392,239,242,224,6099
"21227010801",1876,184,27,0,333,351,67,387,3225
"21227010802",5121,79,7,0,350,33,32,0,5622
"21227010803",3753,1365,451,257,51,218,74,149,6318
"21227010900",2651,755,285,93,32,11,59,0,3886
"21227011001",1638,906,436,128,529,82,183,48,3950
"21227011002",3253,545,869,215,204,206,66,96,5454
"21227011100",4450,876,365,41,530,0,344,0,6606
"21227011200",2113,1298,659,263,238,25,316,60,4972
"21227011300",2912,603,221,103,126,49,66,67,4147
"21227011401",5846,426,47,0,219,10,87,0,6635
"21227011402",2431,325,0,20,43,25,43,0,2887
"21227011500",5774,624,75,36,58,24,127,0,6718
"21227011600",4710,415,209,9,128,0,111,0,5582
"21227011700",5948,892,408,0,210,0,119,0,7577
"21227011800",5262,503,0,0,51,13,161,0,5990
"21227011900",4654,289,370,16,101,0,39,0,5469
"21229930100",2707,210,7,1,81,0,165,0,3171
"21229930200",4581,833,602,72,59,152,21,199,6519
"21229930300",1731,339,0,8,31,5,13,0,2127
"21231920100",4154,421,258,0,15,21,26,21,4916
"21231920200",3471,1442,0,34,157,293,106,385,5888
"21231920300",2833,1286,0,0,99,19,29,0,4266
"21231920400",2299,948,0,0,0,0,0,0,3247
"21231920700",2024,469,0,0,91,0,17,0,2601
"21233960100",3451,591,12,0,274,18,315,106,4767
"21233960200",2172,220,33,33,30,0,86,0,2574
"21233960300",2129,321,0,0,4,9,26,7,2496
"21233960400",2823,550,344,212,48,19,44,7,4047
"21235920100",2140,584,2,3,76,0,66,0,2871
"21235920200",2010,614,0,3,130,14,86,0,2857
"21235920300",4611,1109,51,2,108,36,24,26,5967
"21235920400",3847,1332,10,0,34,0,0,0,5223
"21235920500",4449,2220,8,5,29,0,0,0,6711
"21235920600",3257,826,6,9,119,97,0,21,4335
"21235920700",2977,1394,0,43,86,25,18,0,4543
"21235920800",1342,575,0,0,13,0,58,0,1988
"21237930100",1979,1386,0,0,12,21,0,0,3398
"21237930200",2252,1495,0,0,12,0,0,0,3759
"21239050103",1408,318,260,94,1089,41,1059,41,4310
"21239050104",3098,502,167,52,47,12,27,173,4078
"21239050105",2914,120,2,156,6,23,0,0,3221
"21239050106",2521,474,244,32,68,2,0,43,3384
"21239050107",2877,219,264,0,71,0,0,0,3431
"21239050200",3168,350,21,0,0,0,0,154,3693
"21239050300",1843,233,18,0,16,0,41,0,2151
"21239050400",1573,166,100,0,34,73,30,64,2040
"22001960100",2978,1042,872,1089,104,166,90,93,6434
"22001960200",5532,179,56,176,2,10,9,0,5964
"22001960300",2760,500,206,0,85,0,26,0,3577
"22001960400",5488,605,139,28,62,13,0,0,6335
"22001960500",4992,774,355,136,286,184,237,71,7035
"22001960600",4226,315,954,130,237,7,79,4,5952
"22001960700",1476,402,1290,664,21,0,0,0,3853
"22001960800",2707,643,514,324,316,117,0,60,4681
"22001960900",2109,360,1530,968,116,8,0,0,5091
"22001961000",2614,1457,399,388,215,61,273,66,5473
"22001961100",3101,301,182,35,39,2,86,13,3759
"22001961200",3246,268,160,1,43,0,7,0,3725
"22003950100",4452,522,40,16,102,29,0,4,5165
"22003950200",2041,507,298,171,78,26,14,17,3152
"22003950300",1153,518,678,104,118,14,3,8,2596
"22003950400",3068,289,339,307,208,28,65,0,4304
"22003950500",4187,478,784,161,350,273,65,20,6318
"22005030101",5917,308,317,436,97,0,225,0,7300
"22005030102",4264,537,172,44,5,0,258,289,5569
"22005030103",5503,421,19,52,38,14,183,41,6271
"22005030203",8561,450,1439,0,393,32,261,0,11136
"22005030204",8324,639,1357,325,119,11,179,93,11047
"22005030205",8026,676,1543,25,324,152,820,170,11736
"22005030206",6239,333,1219,378,383,130,389,137,9208
"22005030300",9182,571,3412,242,299,0,727,19,14452
"22005030401",2849,550,844,199,96,47,276,224,5085
"22005030402",2532,465,2005,1295,244,173,173,3,6890
"22005030500",6990,791,579,10,189,309,94,93,9055
"22005030600",3259,405,851,217,128,65,252,60,5237
"22005030900",1183,378,1545,1222,22,0,163,69,4582
"22005031000",1736,90,3178,1367,0,0,42,0,6413
"22007050100",1699,149,1201,700,38,0,27,95,3909
"22007050200",4728,556,0,0,87,29,0,0,5400
"22007050300",1442,217,1575,584,44,0,21,0,3883
"22007050400",1966,187,500,430,6,83,15,0,3187
"22007050500",1234,149,807,494,180,0,198,0,3062
"22007050600",2694,609,448,122,51,6,44,92,4066
"22009030100",1988,673,26,30,32,29,24,0,2802
"22009030200",2260,275,0,0,34,0,9,0,2578
"22009030300",2311,447,438,264,8,36,161,12,3677
"22009030400",2903,696,1595,896,368,212,11,19,6700
"22009030500",4076,512,1140,600,128,4,116,0,6576
"22009030600",2162,660,1585,795,32,9,49,14,5306
"22009030700",3613,339,857,985,272,21,6,15,6108
"22009030800",2112,406,0,4,8,27,71,28,2656
"22009030900",1123,232,514,427,20,48,17,0,2381
"22011960100",4615,863,0,0,145,0,3,0,5626
"22011960200",3604,409,158,0,113,98,115,0,4497
"22011960300",1714,365,1232,747,241,65,182,21,4567
"22011960400",1728,289,641,259,55,36,32,33,3073
"22011960500",3296,699,811,55,298,138,166,235,5698
"22011960600",2310,539,108,68,105,25,39,153,3347
"22011960700",7378,1144,0,0,121,0,69,13,8725
"22013970100",1051,165,1071,1044,57,12,49,0,3449
"22013970200",473,56,825,251,14,6,0,0,1625
"22013970300",1502,319,739,734,7,161,8,85,3555
"22013970400",1892,398,184,46,8,83,23,39,2673
"22013970500",1656,199,652,253,23,5,8,8,2804
"22015010400",449,144,678,544,74,32,74,73,2068
"22015010500",2850,179,669,878,128,26,207,60,4997
"22015010601",2250,1044,2822,1007,842,117,568,354,9004
"22015010602",1067,546,466,369,138,1,148,91,2826
"22015010701",2009,371,818,525,341,238,315,24,4641
"22015010702",1640,167,946,458,279,124,347,171,4132
"22015010801",1384,282,469,690,303,67,338,55,3588
"22015010804",5571,155,1168,0,437,0,275,0,7606
"22015010805",1447,135,577,191,477,35,57,16,2935
"22015010806",3480,196,112,30,434,36,224,11,4523
"22015010900",1680,47,179,32,251,155,185,49,2578
"22015011001",5518,464,1040,566,240,98,220,21,8167
"22015011002",3710,260,496,26,112,0,261,23,4888
"22015011103",6199,269,540,242,68,0,74,61,7453
"22015011105",5214,802,368,1,527,15,614,225,7766
"22015011106",6140,944,978,343,83,201,279,80,9048
"22015011107",791,158,701,112,111,24,145,44,2086
"22015011108",10341,235,1022,44,1039,52,789,37,13559
"22015011109",5998,535,501,35,107,0,196,71,7443
"22015011110",5938,656,919,158,133,114,293,0,8211
"22015011200",3534,231,1219,448,66,0,28,0,5526
"22015011300",254,131,707,817,26,46,88,0,2069
"22017020500",144,6,1952,1019,34,0,11,17,3183
"22017020600",0,3,524,541,12,0,0,0,1080
"22017020700",11,0,809,260,18,11,0,0,1109
"22017021000",825,235,221,419,84,8,80,0,1872
"22017021100",740,178,1026,694,70,15,0,0,2723
"22017021200",2071,425,659,122,159,14,110,0,3560
"22017021300",336,4,1354,950,96,85,97,85,3007
"22017021400",1129,146,558,47,514,0,420,0,2814
"22017021500",1561,221,231,215,55,51,95,51,2480
"22017021600",2885,237,117,92,102,28,81,0,3542
"22017021700",220,25,652,548,69,3,35,0,1552
"22017021800",24,8,847,697,0,0,0,0,1576
"22017021900",64,0,1199,322,45,0,45,0,1675
"22017022000",4,0,1152,871,70,9,0,0,2106
"22017022100",178,29,3693,2241,14,52,14,0,6221
"22017022200",756,38,2749,1611,22,28,84,0,5288
"22017022300",183,139,1295,1074,0,7,0,7,2705
"22017022400",194,67,2287,1137,95,6,0,0,3786
"22017022500",627,57,2758,1164,172,76,218,33,5105
"22017022600",2736,71,174,23,63,0,73,0,3140
"22017022700",2098,226,21,0,10,0,0,32,2387
"22017022800",3694,315,155,3,114,9,72,15,4377
"22017022900",3708,532,556,221,259,57,233,69,5635
"22017023000",4156,155,257,22,269,27,100,27,5013
"22017023100",1188,24,231,70,0,0,0,0,1513
"22017023200",196,167,645,503,65,45,0,0,1621
"22017023300",48,137,1151,726,0,10,9,22,2103
"22017023400",466,80,4409,1500,154,8,155,0,6772
"22017023500",0,0,2480,728,31,0,0,0,3239
"22017023600",26,11,1843,907,8,9,7,24,2835
"22017023700",469,104,4052,2028,63,12,85,0,6813
"22017023800",1712,443,2906,934,391,0,434,142,6962
"22017023901",4358,237,934,123,384,0,101,0,6137
"22017023903",2955,190,367,313,120,64,45,18,4072
"22017023904",2026,136,551,164,262,58,88,0,3285
"22017023905",2906,361,686,200,493,47,119,40,4852
"22017024000",9102,354,450,25,545,6,210,0,10692
"22017024102",2717,174,864,215,259,0,190,31,4450
"22017024104",1902,184,2826,1239,352,67,260,0,6830
"22017024106",3713,384,2490,727,242,47,316,53,7972
"22017024107",2270,222,2466,248,299,0,50,0,5555
"22017024108",3805,268,1678,704,313,41,139,0,6948
"22017024109",2653,86,237,257,167,0,166,18,3584
"22017024201",944,23,2343,295,382,0,240,0,4227
"22017024202",5170,97,1375,81,307,85,154,16,7285
"22017024203",3264,311,566,25,91,36,0,0,4293
"22017024301",1655,348,4602,968,90,23,133,0,7819
"22017024303",1638,179,3100,602,116,55,191,0,5881
"22017024304",2998,274,1379,201,147,49,119,32,5199
"22017024400",2197,147,2379,479,8,12,0,0,5222
"22017024503",2621,828,1417,592,108,0,79,0,5645
"22017024504",4322,767,327,70,211,46,198,31,5972
"22017024601",433,31,2365,2281,13,0,0,14,5137
"22017024602",21,15,2683,1784,32,47,10,47,4639
"22017024700",1386,98,343,112,6,0,10,0,1955
"22017024800",606,29,141,86,30,0,18,9,919
"22017024900",2381,169,217,131,12,4,26,5,2945
"22017025000",1799,522,987,259,98,57,0,11,3733
"22017025100",950,158,331,350,63,59,19,0,1930
"22017025200",107,1,619,355,0,0,0,0,1082
"22017025300",164,331,345,576,8,16,0,8,1448
"22017025405",3079,214,381,149,71,4,46,0,3944
"22017025406",3072,596,416,139,291,8,141,0,4663
"22017980000",0,0,0,0,0,0,0,0,0
"22019000100",802,295,374,138,32,0,48,0,1689
"22019000200",101,16,874,570,9,76,10,0,1656
"22019000300",125,6,723,868,0,0,124,0,1846
"22019000400",1,2,726,584,21,0,0,0,1334
"22019000500",2408,194,409,183,104,34,44,34,3410
"22019000600",498,200,3472,1626,268,27,52,0,6143
"22019000700",1659,452,1531,710,119,77,309,58,4915
"22019000800",1282,347,928,378,108,75,68,0,3186
"22019000900",910,47,2632,330,193,0,40,0,4152
"22019001000",3495,382,14,52,108,0,67,14,4132
"22019001100",1834,742,508,677,301,87,14,20,4183
"22019001201",1138,289,1921,922,259,67,28,0,4624
"22019001202",253,46,2075,1146,49,17,53,20,3659
"22019001300",5007,528,550,122,358,117,283,0,6965
"22019001400",428,93,3325,1353,50,119,1,15,5384
"22019001500",27,23,962,505,0,0,23,0,1540
"22019001600",430,118,2010,604,14,11,14,0,3201
"22019001700",5496,944,1574,270,249,175,134,157,8999
"22019001801",7889,414,543,319,406,93,286,1,9951
"22019001901",2547,262,85,44,171,0,65,0,3174
"22019001903",4549,505,575,61,648,47,9,57,6451
"22019001904",4531,143,441,0,335,0,200,0,5650
"22019002000",6639,806,1094,173,51,117,79,0,8959
"22019002100",1822,165,499,373,94,0,32,0,2985
"22019002201",6664,555,106,0,94,0,76,12,7507
"22019002203",5515,278,214,7,488,91,503,91,7187
"22019002204",4743,212,254,58,180,0,102,14,5563
"22019002300",2281,85,100,0,27,0,64,0,2557
"22019002400",3995,1033,833,164,45,54,9,16,6149
"22019002500",2945,267,147,70,47,0,50,0,3526
"22019002600",3099,682,775,145,32,88,177,49,5047
"22019002700",6021,1424,557,284,530,62,80,0,8958
"22019002800",2567,1336,286,106,68,42,73,192,4670
"22019002900",1426,240,34,19,263,10,288,5,2285
"22019003000",3331,649,126,488,112,48,10,32,4796
"22019003101",4437,404,40,3,33,0,39,0,4956
"22019003102",2210,69,101,119,64,0,65,0,2628
"22019003200",1791,451,98,30,4,27,36,72,2509
"22019003300",3724,1058,271,44,51,0,29,0,5177
"22019003400",4254,353,0,0,44,51,110,51,4863
"22019003500",2293,323,442,472,92,0,270,29,3921
"22019003600",2860,686,87,98,89,14,87,3,3924
"22019980000",0,0,0,0,0,0,0,0,0
"22019980100",0,0,0,0,0,0,0,0,0
"22021000100",1894,329,357,32,13,0,76,6,2707
"22021000200",1957,244,519,195,63,43,66,37,3124
"22021000300",2756,741,131,336,22,28,14,40,4068
"22023970100",4356,461,101,11,0,0,54,0,4983
"22023970201",1684,112,0,0,20,0,71,0,1887
"22023990000",0,0,0,0,0,0,0,0,0
"22025000100",2350,422,455,468,20,21,22,33,3791
"22025000200",681,177,1035,491,82,3,14,1,2484
"22025000300",2499,468,257,0,19,13,20,0,3276
"22027950100",1939,243,779,969,69,0,0,14,4013
"22027950200",1007,218,574,142,23,68,23,79,2134
"22027950300",1276,118,616,683,28,13,0,0,2734
"22027950400",810,89,1171,1249,104,90,0,0,3513
"22027950500",1534,227,701,416,74,0,25,41,3018
"22029000100",1545,389,663,336,58,0,0,0,2991
"22029000200",992,41,1758,2502,11,0,0,0,5304
"22029000300",2148,520,619,334,34,11,33,12,3711
"22029000400",2600,632,607,615,31,57,89,40,4671
"22029000500",1949,545,18,108,0,0,3,0,2623
"22031950100",5782,609,1343,723,275,79,149,113,9073
"22031950200",2885,398,615,423,172,45,57,62,4657
"22031950300",1267,175,581,434,35,13,12,0,2517
"22031950400",952,91,943,307,17,224,33,208,2775
"22031950500",340,56,1063,634,1,7,0,19,2120
"22031950600",343,116,1222,1259,23,0,0,0,2963
"22031950700",2174,164,383,221,13,0,10,13,2978
"22033000100",34,81,1012,644,0,9,0,0,1780
"22033000200",636,54,4127,2142,68,66,0,0,7093
"22033000300",89,5,1073,354,10,11,10,0,1552
"22033000400",210,2,2102,851,0,0,0,0,3165
"22033000500",27,29,2012,2562,42,3,1,16,4692
"22033000601",122,39,1986,1382,9,53,0,0,3591
"22033000602",63,31,2815,1440,19,0,19,0,4387
"22033000701",291,0,1595,441,84,49,90,37,2587
"22033000702",47,8,2380,794,14,0,11,0,3254
"22033000900",33,9,3154,1202,78,97,18,0,4591
"22033001000",0,1,2279,1418,42,0,0,0,3740
"22033001102",307,75,1753,780,143,22,20,13,3113
"22033001103",331,0,1805,875,0,0,66,0,3077
"22033001104",191,65,1610,2036,0,40,122,34,4098
"22033001600",1755,258,1092,366,80,26,107,9,3693
"22033001700",3047,207,834,378,168,0,17,0,4651
"22033001800",1492,311,344,133,308,65,307,108,3068
"22033001900",2067,76,84,16,42,0,24,11,2320
"22033002000",2720,70,477,0,226,107,34,0,3634
"22033002200",78,19,758,270,9,19,0,6,1159
"22033002300",2371,155,228,1,120,7,108,0,2990
"22033002400",312,437,850,764,31,71,29,60,2554
"22033002500",424,858,1335,729,94,116,16,75,3647
"22033002601",2686,563,110,15,94,40,75,39,3622
"22033002602",2776,300,356,276,68,11,25,11,3823
"22033002700",470,0,774,325,0,0,8,0,1577
"22033002801",239,368,319,221,943,433,69,116,2708
"22033002802",261,614,34,83,66,106,33,39,1236
"22033003000",0,22,1883,1375,0,10,0,0,3290
"22033003101",25,0,2783,1620,0,49,0,28,4505
"22033003103",0,0,633,594,0,0,0,0,1227
"22033003201",870,14,2029,878,0,0,37,0,3828
"22033003202",1434,62,2080,99,31,0,11,0,3717
"22033003300",3,13,3329,1859,89,11,0,0,5304
"22033003400",196,28,3556,1957,73,71,68,71,6020
"22033003501",635,206,1749,392,113,32,341,153,3621
"22033003504",184,15,4984,1049,66,0,0,0,6298
"22033003505",624,133,2409,836,59,6,306,52,4425
"22033003506",615,34,5539,1028,568,121,240,121,8266
"22033003507",661,185,3916,380,305,126,0,0,5573
"22033003601",732,97,1998,162,385,32,147,30,3583
"22033003603",624,263,791,905,100,50,151,43,2927
"22033003604",600,194,2695,1650,166,357,153,152,5967
"22033003701",3637,188,1139,0,492,0,244,95,5795
"22033003702",1837,78,1051,194,399,41,57,0,3657
"22033003703",3136,153,1382,107,1289,20,141,0,6228
"22033003801",3797,459,1631,198,415,75,108,153,6836
"22033003802",3490,185,1142,43,230,23,74,0,5187
"22033003804",3397,459,256,0,243,0,222,0,4577
"22033003805",4496,516,666,361,347,84,0,18,6488
"22033003904",2370,192,2174,1109,395,133,122,0,6495
"22033003906",6999,137,1641,44,483,10,222,74,9610
"22033003907",3368,154,1242,225,691,81,320,0,6081
"22033003908",2659,108,1003,134,89,7,282,47,4329
"22033003909",2162,258,876,966,254,33,376,77,5002
"22033003910",950,319,891,201,609,86,693,308,4057
"22033004005",2786,401,2145,107,544,0,358,75,6416
"22033004006",5522,429,966,246,713,20,604,14,8514
"22033004009",4637,220,1687,387,660,0,308,13,7912
"22033004010",3787,147,462,486,164,24,179,30,5279
"22033004011",1980,919,1321,1078,133,171,661,515,6778
"22033004013",1086,663,389,861,454,328,32,98,3911
"22033004014",4438,5048,545,169,351,338,53,224,11166
"22033004015",1904,577,2946,1533,430,180,571,180,8321
"22033004016",5563,124,591,238,693,26,155,0,7390
"22033004201",676,111,3935,755,164,0,28,0,5669
"22033004203",527,200,2015,809,61,0,20,0,3632
"22033004204",877,221,2736,504,150,13,98,193,4792
"22033004205",981,27,3930,1034,176,19,85,10,6262
"22033004301",4858,297,789,150,44,0,62,0,6200
"22033004302",4676,373,38,3,115,24,179,0,5408
"22033004401",3993,242,774,27,213,0,121,0,5370
"22033004402",4608,486,430,182,124,2,89,0,5921
"22033004403",4375,172,729,160,81,29,70,9,5625
"22033004503",2471,72,3361,764,43,182,594,195,7682
"22033004504",2935,362,1251,37,582,53,250,275,5745
"22033004505",3680,112,2391,1512,560,25,160,28,8468
"22033004507",3904,141,930,163,145,0,121,0,5404
"22033004508",7241,178,635,0,206,0,165,0,8425
"22033004509",4138,322,1406,241,316,50,273,13,6759
"22033004510",6195,207,477,11,280,0,173,0,7343
"22033004602",2969,210,2665,237,93,30,76,0,6280
"22033004603",2258,66,1978,343,95,0,57,0,4797
"22033004604",6681,237,3380,455,369,7,98,0,11227
"22033004700",4041,356,1215,718,42,0,257,0,6629
"22033004800",1840,934,40,60,282,116,74,0,3346
"22033004900",3590,481,108,42,376,0,293,11,4901
"22033005000",2498,220,384,9,176,0,38,6,3331
"22033005100",837,215,1220,426,24,80,57,1,2860
"22033005200",436,72,936,741,31,0,0,0,2216
"22033005300",517,188,1127,644,102,38,47,16,2679
"22033980000",0,0,0,0,0,0,0,0,0
"22035000100",772,48,337,1428,0,0,0,0,2585
"22035000200",798,236,246,116,24,0,0,92,1512
"22035000300",21,38,1186,1264,19,9,32,9,2578
"22037951300",1214,177,1475,526,0,14,0,0,3406
"22037951400",1441,229,1024,571,42,48,0,0,3355
"22037951501",761,79,224,17,20,18,3,0,1122
"22037951502",2710,222,1665,344,48,21,94,0,5104
"22037951600",2877,387,1405,464,45,0,79,22,5279
"22039950100",4602,852,381,0,88,0,82,0,6005
"22039950200",1540,350,40,0,26,15,0,0,1971
"22039950300",2794,502,571,210,17,126,0,70,4290
"22039950400",3420,845,741,859,121,5,127,4,6122
"22039950500",808,159,721,1249,27,8,0,0,2972
"22039950600",859,282,799,1120,0,5,44,21,3130
"22039950700",2946,243,216,186,56,0,15,11,3673
"22039950800",2372,240,650,453,28,2,0,15,3760
"22041950100",2775,647,304,300,13,0,21,0,4060
"22041950200",2440,385,324,329,0,8,0,0,3486
"22041950300",1153,684,1224,1930,0,0,0,9,5000
"22041950400",2021,323,156,104,0,0,0,0,2604
"22041950500",1290,283,35,8,24,0,18,0,1658
"22041950600",1012,173,569,507,0,0,3,0,2264
"22043020100",2054,316,11,3,44,12,17,4,2461
"22043020200",2491,355,193,102,61,4,0,0,3206
"22043020300",971,70,945,639,60,9,9,10,2713
"22043020401",4702,1033,61,2,74,0,60,44,5976
"22043020402",3971,655,29,18,167,88,25,1,4954
"22045030100",2624,677,2094,1157,130,19,31,0,6732
"22045030200",4550,403,1307,242,182,7,63,16,6770
"22045030301",2131,297,471,14,204,29,25,0,3171
"22045030302",4113,912,283,412,543,124,411,8,6806
"22045030400",4117,665,1420,711,432,209,180,0,7734
"22045030500",2877,430,618,299,170,7,223,38,4662
"22045030600",4873,126,658,309,332,0,179,0,6477
"22045030700",3362,433,267,111,76,62,131,0,4442
"22045030800",32,86,1369,760,31,8,0,0,2286
"22045030900",886,395,1110,872,183,264,265,23,3998
"22045031000",252,164,1350,811,46,196,0,33,2852
"22045031100",2320,483,1252,915,125,74,144,177,5490
"22045031200",2079,561,629,106,26,33,195,6,3635
"22045031300",3983,353,769,329,233,82,150,0,5899
"22045031600",923,64,1145,574,70,39,19,22,2856
"22045990000",0,0,0,0,0,0,0,0,0
"22047952600",1013,108,1244,387,2,0,50,5,2809
"22047952700",3580,286,2203,161,119,14,152,0,6515
"22047952900",3029,611,1523,735,33,0,35,63,6029
"22047953000",1186,125,377,432,20,0,61,14,2215
"22047953101",2090,168,1734,1245,121,0,193,1,5552
"22047953102",859,89,1332,530,15,0,7,0,2832
"22047953200",1737,313,1478,424,239,43,5,97,4336
"22049970100",1407,357,721,274,31,12,14,0,2816
"22049970200",2308,239,539,440,25,15,0,0,3566
"22049970300",3171,470,99,24,33,78,179,0,4054
"22049970400",1078,228,1366,632,30,0,19,0,3353
"22049970500",1293,220,200,200,6,0,0,0,1919
"22051020101",2356,186,45,78,146,2,436,106,3355
"22051020102",2612,225,46,0,99,0,208,0,3190
"22051020201",1337,343,191,0,261,7,210,157,2506
"22051020202",844,387,723,272,511,138,559,361,3795
"22051020203",5607,396,298,0,486,360,1118,416,8681
"22051020301",2595,64,33,0,346,196,360,0,3594
"22051020302",4164,189,40,13,965,8,734,38,6151
"22051020303",3259,183,0,1,338,121,422,59,4383
"22051020400",3014,11,0,0,162,0,458,0,3645
"22051020502",4722,641,577,54,672,109,2002,186,8963
"22051020505",298,58,1152,350,0,0,95,31,1984
"22051020506",2800,384,62,424,412,115,754,210,5161
"22051020507",3193,285,192,0,258,0,711,49,4688
"22051020508",5213,214,1133,312,604,40,1245,145,8906
"22051020511",2673,274,371,206,577,44,566,94,4805
"22051020512",1616,123,68,38,283,164,435,145,2872
"22051020513",2954,293,459,285,597,228,868,227,5911
"22051020514",3468,110,0,1,200,0,385,0,4164
"22051020515",2247,116,326,29,439,9,895,9,4070
"22051020516",1906,286,1348,462,466,141,895,378,5882
"22051020517",3557,43,146,0,213,0,319,0,4278
"22051020600",1087,253,2113,1119,127,121,834,306,5960
"22051020700",321,65,499,86,68,100,36,117,1292
"22051021000",1253,269,497,298,188,4,291,9,2809
"22051021100",1510,460,108,51,105,26,307,27,2594
"22051021200",1326,164,292,165,311,14,545,14,2831
"22051021300",2333,178,162,0,136,11,313,0,3133
"22051021400",1708,155,37,29,157,13,55,12,2166
"22051021500",938,486,638,165,267,224,133,157,3008
"22051021600",4150,636,691,310,239,246,1198,497,7967
"22051021700",3780,890,265,14,261,310,584,423,6527
"22051021801",1828,44,114,50,104,54,296,11,2501
"22051021803",1589,503,1062,874,215,348,632,288,5511
"22051021804",950,331,454,59,258,37,731,228,3048
"22051021900",937,125,340,3,321,22,329,44,2121
"22051022001",1775,474,1982,234,712,30,436,136,5779
"22051022002",2230,137,98,0,133,1,48,1,2648
"22051022101",1312,2,0,2,135,0,7,0,1458
"22051022102",1835,208,58,181,188,0,61,27,2558
"22051022200",2010,199,1,0,7,0,54,0,2271
"22051022301",2424,188,13,36,100,0,558,0,3319
"22051022302",1245,111,86,38,140,0,116,17,1753
"22051022303",1759,740,230,77,521,116,812,536,4791
"22051022400",3225,233,60,2,57,20,266,0,3863
"22051022500",2078,194,82,23,51,2,135,23,2588
"22051022600",2990,145,0,72,92,0,56,0,3355
"22051022700",2550,193,0,0,40,0,115,14,2912
"22051022800",2260,344,0,1,219,15,442,19,3300
"22051022900",1957,535,148,10,95,0,142,230,3117
"22051023001",1774,46,30,0,47,0,114,0,2011
"22051023002",3907,276,186,2,98,55,666,135,5325
"22051023003",2700,59,22,20,106,0,117,0,3024
"22051023100",2054,229,9,33,128,10,311,24,2798
"22051023200",2116,365,71,7,100,42,229,135,3065
"22051023300",1521,108,5,3,88,0,155,10,1890
"22051023400",3011,89,0,0,87,0,190,0,3377
"22051023500",3884,75,65,28,201,0,430,25,4708
"22051023600",3566,128,394,274,815,0,791,18,5986
"22051023700",0,42,1605,442,41,8,61,42,2241
"22051023800",1617,351,1073,407,63,0,207,59,3777
"22051023901",2220,142,7,0,8,24,54,30,2485
"22051023902",2257,53,27,0,75,0,168,0,2580
"22051023903",2126,87,0,0,35,2,267,1,2518
"22051023904",2453,174,102,1,31,0,182,60,3003
"22051024001",2507,293,0,0,20,16,64,0,2900
"22051024002",2658,380,0,1,148,0,66,0,3253
"22051024100",2843,272,0,11,43,0,224,0,3393
"22051024201",1727,148,275,1,65,0,95,0,2311
"22051024202",1760,114,836,30,559,25,381,0,3705
"22051024300",2221,441,182,0,4,29,244,83,3204
"22051024400",1826,292,399,72,93,56,109,217,3064
"22051024500",1297,195,46,28,104,0,80,23,1773
"22051024600",200,48,682,294,40,0,64,48,1376
"22051024700",942,151,302,53,107,36,257,51,1899
"22051024800",2960,286,0,0,67,0,158,46,3517
"22051024900",891,204,226,59,78,19,98,60,1635
"22051025001",1938,274,4053,982,1123,270,768,0,9408
"22051025002",1582,238,503,118,634,42,483,175,3775
"22051025003",2139,180,631,451,451,99,630,173,4754
"22051025102",2554,335,787,60,365,0,202,10,4313
"22051025103",1792,258,794,353,409,286,546,35,4473
"22051025104",1850,169,1136,62,510,105,842,23,4697
"22051025201",650,9,481,842,375,155,518,159,3189
"22051025202",1903,272,1009,1064,1387,200,1353,257,7445
"22051025300",1342,194,184,16,234,99,372,199,2640
"22051025400",1381,138,1184,334,672,498,916,425,5548
"22051025500",623,256,909,713,294,207,259,237,3498
"22051025600",726,271,174,69,82,39,103,21,1485
"22051025700",140,160,639,323,100,35,31,24,1452
"22051025800",672,131,452,502,34,0,38,0,1829
"22051025900",1133,278,620,381,49,44,72,77,2654
"22051026000",982,417,119,148,284,28,255,22,2255
"22051026100",909,410,836,1011,262,306,246,498,4478
"22051026200",26,0,1059,580,34,16,5,0,1720
"22051026300",1789,325,45,168,32,50,55,0,2464
"22051026400",1337,42,113,0,93,28,57,0,1670
"22051026500",1257,239,78,166,64,2,74,6,1886
"22051026600",1355,174,64,5,221,105,401,71,2396
"22051026700",947,279,327,170,208,12,113,138,2194
"22051026800",427,128,965,737,166,118,114,176,2831
"22051026900",34,15,1973,956,44,0,8,0,3030
"22051027000",1950,194,1740,574,855,106,264,0,5683
"22051027100",1952,360,120,37,63,14,37,12,2595
"22051027200",3518,644,548,408,204,73,129,73,5597
"22051027501",2430,366,2187,1390,75,53,89,0,6590
"22051027502",0,1,2831,737,25,0,0,0,3594
"22051027601",2240,475,1251,677,491,271,103,102,5610
"22051027602",583,81,1591,1129,316,245,194,9,4148
"22051027701",79,23,3509,2551,6,0,21,122,6311
"22051027703",1390,316,1020,1146,314,54,347,221,4808
"22051027803",715,267,820,602,334,347,432,455,3972
"22051027804",4004,0,2526,9,1271,69,1270,0,9149
"22051027805",2151,276,3929,833,1542,85,602,36,9454
"22051027806",3676,643,754,1175,1036,27,798,22,8131
"22051027807",5468,323,2077,0,1107,33,686,39,9733
"22051027809",3600,591,2249,370,475,0,335,36,7656
"22051027810",516,28,2751,381,608,48,444,0,4776
"22051027811",207,13,2721,323,103,0,54,0,3421
"22051027812",419,82,2110,1504,53,15,94,0,4277
"22051027901",2360,353,10,15,148,27,49,6,2968
"22051027902",1984,193,0,0,1,0,0,0,2178
"22051028000",2526,302,644,174,625,0,328,120,4719
"22051028100",259,73,1305,687,45,16,0,1,2386
"22051028200",1682,510,970,316,397,94,430,134,4533
"22051980000",0,0,0,0,0,0,0,0,0
"22051990000",0,0,0,0,0,0,0,0,0
"22051990100",0,0,0,0,0,0,0,0,0
"22053000100",3072,721,653,126,168,164,51,32,4987
"22053000200",3662,467,153,0,200,6,42,0,4530
"22053000300",3221,578,779,141,180,35,63,0,4997
"22053000400",4898,975,334,362,90,0,173,31,6863
"22053000500",3137,372,383,442,41,40,0,0,4415
"22053000600",1811,313,529,512,73,58,26,129,3451
"22053000700",1050,192,547,287,46,0,16,0,2138
"22055000100",1083,187,385,369,2,21,3,29,2079
"22055000200",356,78,1108,525,22,0,62,1,2152
"22055000500",2006,360,17,40,47,2,99,0,2571
"22055000602",2987,761,394,398,111,104,125,145,5025
"22055000603",1830,397,313,135,19,0,296,91,3081
"22055000604",3811,979,1217,167,551,81,475,32,7313
"22055000700",452,141,1394,1144,206,61,260,54,3712
"22055000800",135,24,1474,1101,34,12,34,0,2814
"22055000900",0,88,925,670,4,18,0,0,1705
"22055001001",2367,611,1467,486,172,81,175,0,5359
"22055001002",1213,154,912,668,165,37,143,37,3329
"22055001003",2171,174,1327,88,43,8,22,21,3854
"22055001100",852,465,2801,2150,255,38,103,0,6664
"22055001200",947,270,4545,1107,75,0,14,52,7010
"22055001300",1254,509,1716,1163,40,40,40,16,4778
"22055001401",7630,398,292,97,386,170,338,32,9343
"22055001402",6225,370,396,0,217,157,0,67,7432
"22055001403",4165,174,286,174,438,16,299,0,5552
"22055001404",7975,297,521,110,330,0,93,0,9326
"22055001405",5491,639,1408,506,211,0,221,81,8557
"22055001406",3333,250,480,700,286,0,108,12,5169
"22055001407",4216,230,345,1,332,0,120,0,5244
"22055001409",6628,518,839,597,487,132,501,46,9748
"22055001410",9989,695,719,577,213,133,256,51,12633
"22055001411",1473,243,183,33,45,5,19,0,2001
"22055001500",4495,397,94,163,88,0,147,53,5437
"22055001600",2710,180,0,0,49,0,16,0,2955
"22055001700",5421,352,396,145,79,78,417,45,6933
"22055001801",2049,469,614,353,143,117,157,122,4024
"22055001802",2587,779,390,436,296,0,273,65,4826
"22055001901",4274,301,439,97,156,165,32,97,5561
"22055001902",5586,683,654,274,177,0,324,108,7806
"22055001903",3822,761,1084,286,280,66,806,460,7565
"22055001904",3484,214,254,236,324,103,214,46,4875
"22055001905",3317,932,930,104,253,17,141,54,5748
"22055002001",2776,587,1121,874,430,42,96,41,5967
"22055002002",3456,554,2147,2,84,0,74,76,6393
"22055002101",2821,367,1373,454,75,114,80,15,5299
"22055002102",3496,485,995,245,22,1,166,1,5411
"22055002103",1967,191,1083,405,67,15,53,6,3787
"22055002104",4474,184,666,236,167,0,48,16,5791
"22055002200",2273,781,216,98,291,123,45,19,3846
"22055980000",19,0,0,0,0,0,0,0,19
"22057020100",1912,151,524,85,0,15,17,0,2704
"22057020202",2483,126,592,15,51,0,82,0,3349
"22057020400",668,87,1045,365,36,0,0,0,2201
"22057020500",2880,334,1538,527,63,73,0,9,5424
"22057020600",1702,113,262,199,0,18,59,50,2403
"22057020702",1678,565,210,415,140,146,7,0,3161
"22057020703",3553,136,717,511,226,0,176,39,5358
"22057020704",4644,590,295,9,291,19,115,47,6010
"22057020800",3229,334,35,0,101,64,64,0,3827
"22057020900",895,68,943,341,23,12,1,0,2283
"22057021000",2405,324,176,6,202,0,5,0,3118
"22057021100",6174,642,1,42,532,16,163,0,7570
"22057021200",3048,744,24,21,415,147,282,36,4717
"22057021300",1761,279,0,0,423,13,130,0,2606
"22057021400",2690,527,13,1,574,88,294,33,4220
"22057021500",3372,305,128,53,271,328,152,231,4840
"22057021601",5868,318,201,0,311,43,306,0,7047
"22057021602",3182,101,0,0,1002,198,754,40,5277
"22057021700",2784,510,184,60,191,43,175,20,3967
"22057021800",2874,336,847,845,22,172,59,59,5214
"22057021901",5011,960,593,0,195,53,192,0,7004
"22057021902",3435,433,279,0,0,52,0,0,4199
"22057022000",1053,241,168,77,0,0,0,0,1539
"22057990000",0,0,0,0,0,0,0,0,0
"22059970100",2935,353,3,162,20,53,11,4,3541
"22059970200",4021,483,921,274,45,8,94,11,5857
"22059970300",3762,625,0,0,96,0,8,0,4491
"22061960100",2427,448,485,151,148,91,47,26,3823
"22061960200",2346,224,1092,247,149,73,323,4,4458
"22061960300",422,13,2084,1797,9,65,0,14,4404
"22061960400",2646,1033,723,493,425,223,11,38,5592
"22061960500",2781,330,406,266,94,51,11,53,3992
"22061960600",2248,734,827,895,97,212,211,76,5300
"22061960700",4308,581,507,154,52,39,52,63,5756
"22061960800",442,474,1454,1213,55,61,17,5,3721
"22061960900",324,76,966,901,10,0,10,0,2287
"22061961000",1793,549,766,1746,36,10,8,81,4989
"22063040100",7178,2263,491,242,68,0,67,23,10332
"22063040201",4282,579,73,82,89,0,23,0,5128
"22063040202",3781,725,64,3,45,3,53,14,4688
"22063040301",7943,886,100,16,102,0,284,0,9331
"22063040303",9284,346,179,0,345,13,388,0,10555
"22063040304",5049,649,19,0,76,0,122,37,5952
"22063040401",5794,1369,0,385,88,28,62,0,7726
"22063040402",6209,521,572,59,164,14,54,14,7607
"22063040500",9635,1287,586,85,322,198,584,112,12809
"22063040600",5670,620,694,597,366,92,54,50,8143
"22063040700",3092,945,0,4,15,0,264,17,4337
"22063040802",4714,537,7,99,215,0,33,0,5605
"22063040804",12131,930,1131,90,676,104,566,97,15725
"22063040805",4657,440,63,15,75,125,449,122,5946
"22063040806",5682,771,26,6,65,0,298,102,6950
"22063040901",4695,1128,547,182,42,12,42,34,6682
"22063040902",4110,693,398,16,34,0,14,0,5265
"22065960100",1174,205,185,464,42,0,57,4,2131
"22065960200",920,466,459,578,0,0,0,0,2423
"22065960300",0,0,1067,1438,45,146,0,0,2696
"22065960400",14,44,956,356,0,22,0,0,1392
"22065960500",710,181,749,270,7,105,0,105,2127
"22067950100",1160,131,200,93,13,82,0,52,1731
"22067950200",3872,546,867,335,67,1,67,0,5755
"22067950300",1545,402,426,161,0,15,0,21,2570
"22067950400",325,85,1309,1611,0,0,0,0,3330
"22067950500",1652,297,1694,867,72,51,0,0,4633
"22067950600",1444,391,471,286,61,0,0,49,2702
"22067950700",1339,193,1182,243,10,0,34,10,3011
"22067950800",223,95,1625,1169,18,9,0,40,3179
"22069000100",1666,218,310,209,121,7,13,7,2551
"22069000200",1979,206,496,527,61,21,0,0,3290
"22069000300",2832,492,476,431,197,101,142,75,4746
"22069000400",553,125,2365,1227,73,15,27,12,4397
"22069000500",2424,283,668,189,205,5,97,8,3879
"22069000600",2010,948,2652,1861,51,58,4,122,7706
"22069000700",470,380,1351,1137,48,8,8,3,3405
"22069000800",3111,658,474,193,142,18,18,53,4667
"22069000900",2414,275,810,280,328,91,94,13,4305
"22071000100",1789,258,268,111,45,161,105,150,2887
"22071000200",197,74,707,208,29,18,102,17,1352
"22071000300",63,42,592,313,0,4,10,0,1024
"22071000400",318,28,1153,617,53,0,38,0,2207
"22071000601",0,0,326,592,0,0,0,0,918
"22071000602",176,38,1661,1153,29,0,25,0,3082
"22071000603",25,32,459,391,414,69,346,101,1837
"22071000604",488,10,2989,1239,126,41,152,6,5051
"22071000605",547,59,762,559,0,0,28,0,1955
"22071000606",1524,124,1753,428,201,16,231,0,4277
"22071000607",2098,130,1535,159,0,26,206,0,4154
"22071000611",9,52,2551,770,664,260,251,99,4656
"22071000612",1010,32,226,248,281,0,106,0,1903
"22071000613",448,90,2325,1821,20,19,21,51,4795
"22071000615",936,87,1940,685,145,0,42,0,3835
"22071000616",1426,72,2011,738,59,0,47,35,4388
"22071000617",442,21,2732,432,123,0,75,0,3825
"22071000618",1409,57,1780,217,327,0,102,2,3894
"22071000701",14,2,400,111,0,0,0,0,527
"22071000702",59,36,936,586,10,0,0,0,1627
"22071000800",32,6,741,369,37,0,0,0,1185
"22071000901",0,0,415,232,0,0,0,0,647
"22071000902",0,2,354,72,0,0,0,0,428
"22071000903",0,0,248,72,0,0,0,0,320
"22071000904",0,12,390,336,48,0,19,0,805
"22071001100",866,116,487,136,74,21,25,21,1746
"22071001200",1014,240,193,17,59,31,25,1,1580
"22071001301",282,41,688,560,12,7,0,0,1590
"22071001302",27,16,502,394,7,0,4,5,955
"22071001401",11,0,645,434,56,0,0,0,1146
"22071001402",120,32,954,515,86,10,52,0,1769
"22071001500",113,14,463,246,0,17,11,0,864
"22071001600",0,0,0,0,0,0,0,0,0
"22071001701",6,0,1058,534,10,0,6,0,1614
"22071001702",254,125,1483,497,0,32,34,0,2425
"22071001720",20,12,1789,1270,91,0,0,0,3182
"22071001722",73,27,2604,964,200,13,184,0,4065
"22071001723",170,57,3050,1551,134,37,0,0,4999
"22071001724",158,82,2305,1368,180,48,64,29,4234
"22071001725",127,11,3988,2079,95,204,60,204,6768
"22071001730",25,0,470,265,13,0,0,0,773
"22071001734",543,11,0,0,97,26,28,0,705
"22071001735",2,57,1086,741,10,0,0,14,1910
"22071001736",7,58,957,540,25,0,18,52,1657
"22071001737",135,50,1887,742,9,5,0,0,2828
"22071001739",0,12,1220,324,0,0,0,0,1556
"22071001740",38,25,3172,947,235,104,29,2,4552
"22071001741",43,6,639,236,526,39,0,0,1489
"22071001743",41,0,1425,568,27,0,0,0,2061
"22071001744",76,3,1874,1601,22,11,28,0,3615
"22071001745",136,23,2231,1106,44,155,17,102,3814
"22071001746",39,22,2667,1139,14,0,24,0,3905
"22071001747",10,5,2647,122,697,114,39,0,3634
"22071001748",165,9,3011,1072,123,150,49,74,4653
"22071001749",75,74,725,294,1462,448,129,320,3527
"22071001750",299,215,516,338,1336,739,352,473,4268
"22071001751",68,58,163,282,44,26,81,59,781
"22071001800",1097,181,37,34,92,0,102,0,1543
"22071001900",244,119,399,506,32,0,163,35,1498
"22071002000",122,24,434,405,18,18,0,24,1045
"22071002100",24,3,316,344,0,12,0,0,699
"22071002200",19,9,483,246,0,0,11,4,772
"22071002300",15,94,1018,461,0,25,0,0,1613
"22071002401",83,72,1295,218,39,65,33,15,1820
"22071002402",225,109,1682,730,23,0,25,0,2794
"22071002501",307,7,1151,162,33,0,135,0,1795
"22071002502",49,25,1218,691,6,15,4,0,2008
"22071002503",519,97,1199,314,23,0,21,20,2193
"22071002504",495,51,1224,329,108,0,78,0,2285
"22071002600",889,159,37,110,24,54,66,0,1339
"22071002700",249,33,611,687,43,46,84,78,1831
"22071002800",7,0,920,676,9,2,0,0,1614
"22071002900",85,0,796,527,0,0,35,0,1443
"22071003000",36,5,623,547,18,12,44,5,1290
"22071003100",11,12,447,395,108,3,5,0,981
"22071003301",736,118,564,368,103,33,150,55,2127
"22071003302",163,50,2358,676,95,102,80,6,3530
"22071003303",337,55,1043,349,110,0,118,24,2036
"22071003304",133,41,801,485,8,0,24,26,1518
"22071003307",11,0,1025,254,47,0,66,0,1403
"22071003308",37,1,2249,667,214,133,79,109,3489
"22071003400",238,71,408,407,23,22,35,16,1220
"22071003500",101,30,739,316,9,7,0,0,1202
"22071003600",140,39,943,708,95,11,21,6,1963
"22071003701",572,67,1129,498,54,0,49,5,2374
"22071003702",789,122,1227,1146,136,29,65,13,3527
"22071003800",1187,57,42,3,38,0,50,0,1377
"22071003900",393,39,376,319,85,6,118,1,1337
"22071004000",235,150,831,409,18,17,135,48,1843
"22071004100",1233,79,104,87,23,45,28,47,1646
"22071004401",45,27,570,614,6,0,16,0,1278
"22071004402",0,0,0,64,0,0,0,0,64
"22071004500",489,33,909,545,117,0,146,0,2239
"22071004600",2301,262,99,100,97,11,213,29,3112
"22071004800",0,1,209,1083,23,60,0,0,1376
"22071004900",156,80,629,684,64,32,213,14,1872
"22071005000",434,156,202,418,171,201,349,280,2211
"22071005400",1158,203,256,134,46,25,211,14,2047
"22071005500",1872,258,139,0,173,6,294,18,2760
"22071005601",1618,120,65,0,222,39,261,0,2325
"22071005602",2015,110,82,0,24,0,78,0,2309
"22071005603",1257,116,77,0,10,0,136,4,1600
"22071005604",1238,98,0,0,19,4,15,0,1374
"22071006000",76,95,553,401,109,35,35,79,1383
"22071006300",361,127,379,597,172,43,390,114,2183
"22071006400",784,370,738,398,115,29,221,169,2824
"22071006500",1283,217,267,473,289,91,402,29,3051
"22071006900",0,8,261,511,0,0,0,8,788
"22071007000",37,27,259,288,0,0,33,0,644
"22071007101",238,255,642,429,22,8,181,134,1909
"22071007200",32,31,906,895,108,5,22,20,2019
"22071007501",31,0,1579,783,31,0,0,0,2424
"22071007502",0,0,1678,746,0,59,0,6,2489
"22071007604",1586,31,52,0,46,0,67,26,1808
"22071007605",68,81,670,540,7,0,7,0,1373
"22071007606",2492,329,399,28,288,54,276,18,3884
"22071007700",1537,265,461,111,147,7,216,34,2778
"22071007800",950,203,63,4,144,45,246,92,1747
"22071008200",1097,135,98,67,81,20,82,75,1655
"22071008300",915,55,147,88,36,8,59,36,1344
"22071008400",391,96,520,243,65,21,59,0,1395
"22071008500",11,17,499,627,97,87,29,44,1411
"22071008600",18,20,325,360,28,20,33,0,804
"22071008800",873,168,435,176,73,6,75,0,1806
"22071009000",1566,121,50,1,148,12,0,27,1925
"22071009100",663,102,611,955,154,138,116,114,2853
"22071009200",12,9,691,437,24,0,0,0,1173
"22071009400",22,46,610,523,0,0,17,10,1228
"22071009600",902,242,408,97,26,0,91,1,1767
"22071009700",553,88,561,184,109,107,45,81,1728
"22071009900",2190,367,163,26,133,17,215,55,3166
"22071010000",229,95,644,846,27,0,38,0,1879
"22071010100",1249,304,438,73,33,23,76,49,2245
"22071010200",136,53,694,600,14,17,0,5,1519
"22071010300",229,27,1361,773,30,43,28,5,2496
"22071010600",565,77,353,65,134,0,136,2,1332
"22071010700",1181,95,232,20,60,76,87,20,1771
"22071010800",1226,92,39,24,30,0,27,11,1449
"22071010900",1557,291,1323,83,114,115,181,115,3779
"22071011100",331,43,719,485,29,50,8,50,1715
"22071011200",758,144,354,95,144,5,252,0,1752
"22071011400",1463,157,106,2,84,10,115,0,1937
"22071011500",1080,115,6,71,43,0,41,0,1356
"22071011600",1327,55,0,0,68,0,13,0,1463
"22071011700",2332,157,0,0,129,0,115,11,2744
"22071011900",1165,430,28,25,60,19,86,32,1845
"22071012000",1034,253,18,65,24,0,66,8,1468
"22071012101",1284,351,42,61,135,140,131,54,2198
"22071012102",606,528,37,0,38,11,66,21,1307
"22071012200",1456,152,177,7,278,1,152,14,2237
"22071012300",862,102,530,338,78,46,128,76,2160
"22071012400",811,57,344,585,30,0,148,7,1982
"22071012500",813,175,234,133,115,46,47,15,1578
"22071012600",1285,290,80,46,116,82,61,0,1960
"22071012700",1368,197,376,260,8,29,80,0,2318
"22071012800",1408,151,267,133,102,59,139,1,2260
"22071012900",718,149,191,193,67,43,32,16,1409
"22071013000",639,120,584,460,9,0,4,0,1816
"22071013100",106,99,533,695,0,5,90,72,1600
"22071013200",605,318,1021,293,0,35,69,41,2382
"22071013301",3403,120,62,0,136,0,284,0,4005
"22071013302",1216,132,320,90,187,56,68,16,2085
"22071013400",1036,184,183,354,165,172,86,19,2199
"22071013500",1848,207,64,1,124,22,93,102,2461
"22071013600",406,55,344,218,6,0,65,0,1094
"22071013700",24,69,872,1214,5,0,25,62,2271
"22071013800",40,18,824,623,9,0,0,0,1514
"22071013900",657,117,540,176,181,16,198,0,1885
"22071014000",93,80,631,967,22,0,93,27,1913
"22071014100",555,186,672,475,6,19,58,0,1971
"22071014200",800,132,475,138,19,0,20,17,1601
"22071014300",56,17,597,725,11,1,60,0,1467
"22071014400",735,140,711,127,274,90,292,26,2395
"22071014500",0,0,0,0,0,0,0,0,0
"22071980000",1,0,0,1,0,1,0,0,3
"22071980100",0,0,0,0,0,0,0,0,0
"22071990000",0,0,0,0,0,0,0,0,0
"22073000100",2296,714,1015,278,178,78,159,61,4779
"22073000200",4320,558,381,24,43,0,13,0,5339
"22073000401",246,164,683,194,87,47,6,0,1427
"22073000402",696,91,821,467,92,20,81,0,2268
"22073000500",1527,275,291,722,36,16,27,0,2894
"22073000600",9,0,2084,1913,0,0,0,0,4006
"22073000700",0,26,1138,615,0,0,25,0,1804
"22073000900",2,0,667,837,4,1,0,1,1512
"22073001100",59,0,1341,2075,50,57,17,57,3656
"22073001400",58,107,1079,974,37,0,9,0,2264
"22073001500",106,78,649,795,0,6,0,0,1634
"22073001700",1446,265,686,316,263,169,64,0,3209
"22073005100",1639,245,0,43,63,0,22,0,2012
"22073005201",3350,276,0,1,51,11,27,0,3716
"22073005203",2382,320,172,388,104,0,0,0,3366
"22073005204",5224,386,0,0,65,0,0,0,5675
"22073005301",5860,283,126,97,77,0,198,18,6659
"22073005302",4504,685,303,215,137,51,111,74,6080
"22073005400",1518,228,118,116,83,0,117,0,2180
"22073005500",1347,350,501,606,106,44,23,0,2977
"22073005800",1379,245,641,238,174,13,192,12,2894
"22073005900",1594,813,5,25,15,93,40,36,2621
"22073010101",3352,353,518,416,145,0,7,0,4791
"22073010102",2531,433,2044,732,193,80,28,36,6077
"22073010201",2038,371,2630,468,247,0,73,0,5827
"22073010202",4632,232,723,39,213,0,69,0,5908
"22073010301",2460,159,203,205,45,36,91,0,3199
"22073010302",2373,310,949,437,31,18,74,5,4197
"22073010400",8251,790,152,79,199,0,413,0,9884
"22073010502",3533,404,48,0,84,0,64,78,4211
"22073010503",1360,73,62,0,0,29,89,0,1613
"22073010504",6110,1640,241,1,253,12,265,12,8534
"22073010603",346,109,2217,1472,54,10,0,0,4208
"22073010604",1196,96,587,100,15,0,19,0,2013
"22073010700",18,4,1343,1375,0,5,0,0,2745
"22073010800",116,148,763,444,0,8,0,0,1479
"22073010900",163,0,3151,1618,37,0,0,0,4969
"22073011000",50,67,1868,2723,38,0,48,39,4833
"22073011100",551,391,1334,688,11,45,0,37,3057
"22073980000",0,0,0,0,0,0,0,0,0
"22075050100",469,77,823,281,0,0,22,0,1672
"22075050200",7219,501,183,0,796,123,571,198,9591
"22075050300",3279,276,534,28,342,0,293,89,4841
"22075050400",1774,260,1522,103,58,155,14,0,3886
"22075050500",273,27,659,277,181,23,0,0,1440
"22075050600",587,4,176,87,18,33,18,0,923
"22075050700",678,55,0,16,42,84,0,0,875
"22075050800",382,363,68,115,118,59,25,0,1130
"22075990000",0,0,0,0,0,0,0,0,0
"22077951900",1438,56,2697,1230,0,0,0,0,5421
"22077952000",1105,144,841,663,19,0,81,36,2889
"22077952100",3264,312,790,212,133,42,105,17,4875
"22077952200",2429,211,477,18,16,0,22,40,3213
"22077952300",951,47,171,347,69,0,71,0,1656
"22077952400",3447,565,572,82,71,54,119,0,4910
"22079010100",7533,1020,420,2,71,32,80,32,9190
"22079010300",3518,1315,147,3,60,0,172,183,5398
"22079010400",1947,159,105,1,15,0,76,0,2303
"22079010500",2371,523,2301,1652,169,3,0,0,7019
"22079010600",3803,680,24,28,139,9,3,6,4692
"22079010700",3350,262,492,63,89,15,105,0,4376
"22079011000",191,197,1249,1110,116,82,29,10,2984
"22079011300",1731,308,203,55,123,26,0,0,2446
"22079011500",5368,717,888,92,411,0,175,0,7651
"22079011600",1190,250,412,147,113,38,75,0,2225
"22079011700",790,363,570,257,218,18,0,0,2216
"22079012000",0,8,1140,718,27,0,0,0,1893
"22079012100",820,167,1171,611,85,209,0,5,3068
"22079012200",1281,111,1470,1115,72,36,33,0,4118
"22079012301",3853,319,706,35,188,0,41,0,5142
"22079012302",2795,125,268,111,93,119,0,62,3573
"22079012400",2588,120,1098,15,62,91,75,0,4049
"22079012500",1690,611,3017,906,194,0,59,0,6477
"22079012600",872,77,764,176,190,0,32,0,2111
"22079012700",63,30,2183,1345,0,7,0,0,3628
"22079012800",0,0,668,177,31,0,0,0,876
"22079012900",8,0,1360,1175,45,0,0,0,2588
"22079013000",240,63,1712,535,6,9,43,8,2616
"22079013100",1060,356,744,411,89,34,18,43,2755
"22079013200",6601,745,337,59,286,0,167,0,8195
"22079013300",2953,352,1176,467,0,69,175,0,5192
"22079013400",2785,211,158,0,108,15,17,8,3302
"22079013500",5249,742,485,223,215,93,1252,236,8495
"22079013600",2219,489,0,0,72,0,0,0,2780
"22079013700",2426,593,72,35,330,145,92,13,3706
"22079013800",1997,208,596,650,94,52,100,0,3697
"22079013900",188,191,1413,847,0,0,0,0,2639
"22079980000",28,9,0,0,0,0,0,0,37
"22081960100",3520,566,705,187,39,10,25,0,5052
"22081960300",964,161,1600,995,67,1,22,0,3810
"22083970100",980,74,1227,613,23,23,82,10,3032
"22083970200",1041,317,655,103,11,0,111,2,2240
"22083970300",2647,310,219,88,8,0,0,0,3272
"22083970400",2517,138,40,144,5,4,0,0,2848
"22083970500",1187,133,1674,1468,34,0,7,0,4503
"22083970600",2804,563,539,263,54,6,149,15,4393
"22085000100",1812,276,297,169,299,136,73,27,3089
"22085000200",2117,588,22,0,707,369,118,31,3952
"22085000300",620,203,639,505,458,101,109,53,2688
"22085000400",3630,451,338,76,459,128,198,80,5360
"22085000500",1073,393,774,703,73,146,0,10,3172
"22085000600",2392,496,330,92,127,84,89,20,3630
"22085000700",2432,232,0,0,11,0,26,0,2701
"22087030103",2798,549,677,182,54,0,315,0,4575
"22087030104",1337,304,27,0,94,0,268,44,2074
"22087030105",84,52,1,8,0,0,36,11,192
"22087030203",1871,335,76,82,132,199,149,223,3067
"22087030204",1340,183,2044,676,29,115,270,57,4714
"22087030206",1043,594,49,0,63,13,66,30,1858
"22087030207",2387,316,205,90,362,18,164,18,3560
"22087030208",1965,140,270,0,486,0,189,5,3055
"22087030209",2389,235,339,103,0,0,287,0,3353
"22087030300",1129,208,57,66,37,6,253,44,1800
"22087030400",744,169,22,0,18,6,60,10,1029
"22087030500",1018,349,320,38,99,19,114,42,1999
"22087030601",429,252,175,144,131,10,9,29,1179
"22087030602",1560,344,230,59,138,15,378,20,2744
"22087030603",679,125,369,271,0,7,150,96,1697
"22087030700",1133,168,91,46,12,0,45,6,1501
"22087030800",2213,287,256,403,262,11,241,38,3711
"22087990000",0,0,0,0,0,0,0,0,0
"22089060100",1444,69,410,20,18,25,83,19,2088
"22089062100",3114,505,1928,409,29,33,249,61,6328
"22089062200",967,29,1591,623,17,80,32,0,3339
"22089062301",4662,120,692,95,451,0,503,0,6523
"22089062302",3259,314,766,378,119,0,424,10,5270
"22089062400",1088,39,346,104,0,0,61,0,1638
"22089062500",2567,272,61,96,46,7,46,0,3095
"22089062700",1687,386,1609,554,116,13,103,90,4558
"22089062800",1879,465,1624,936,140,6,436,56,5542
"22089062900",1880,86,245,0,50,23,113,0,2397
"22089063000",836,5,290,66,7,0,57,0,1261
"22089063100",6113,184,354,0,265,16,238,16,7186
"22089063200",4179,657,226,0,234,0,46,103,5445
"22091951100",2209,224,1116,521,22,32,0,0,4124
"22091951200",2123,311,2279,1882,135,8,31,0,6769
"22093040100",1924,149,848,689,26,0,32,8,3676
"22093040200",1766,30,1033,523,0,0,95,0,3447
"22093040300",2647,55,348,157,77,0,39,0,3323
"22093040400",690,97,755,867,20,10,9,8,2456
"22093040500",78,16,1813,579,0,0,0,0,2486
"22093040600",774,17,1787,249,0,0,99,0,2926
"22093040700",2304,66,1188,33,0,0,0,0,3591
"22095070100",1792,25,867,91,26,0,151,0,2952
"22095070200",1108,29,5336,837,142,0,325,22,7799
"22095070300",3418,477,1929,183,273,0,359,188,6827
"22095070400",2893,115,987,251,85,0,235,0,4566
"22095070500",2108,34,2960,642,172,0,519,0,6435
"22095070600",954,266,491,481,0,0,0,0,2192
"22095070700",2512,243,1067,166,102,24,216,0,4330
"22095070800",209,3,1286,1057,37,5,0,0,2597
"22095070900",901,129,794,720,16,22,103,0,2685
"22095071000",1409,351,693,200,96,7,57,10,2823
"22095071100",271,63,2307,705,0,0,0,0,3346
"22097960100",1202,245,453,664,22,18,0,30,2634
"22097960200",2533,231,673,322,31,25,0,16,3831
"22097960300",1847,528,784,509,30,12,38,0,3748
"22097960400",1506,385,0,0,10,21,12,21,1955
"22097960500",3718,709,243,163,63,0,89,72,5057
"22097960600",2404,460,1833,1848,127,0,175,0,6847
"22097960700",3097,350,1229,904,100,0,8,0,5688
"22097960800",2529,554,484,116,119,41,75,0,3918
"22097960900",1143,605,1561,470,25,57,38,36,3935
"22097961000",1521,222,205,206,72,61,135,0,2422
"22097961100",2036,487,403,230,71,94,199,0,3520
"22097961200",2622,205,1600,1084,126,10,41,0,5688
"22097961300",525,105,1160,2135,84,61,8,0,4078
"22097961400",608,74,2042,1596,11,0,0,0,4331
"22097961500",1734,137,1396,1352,17,13,7,56,4712
"22097961600",148,171,2046,1463,48,23,14,5,3918
"22097961700",3937,590,1556,338,135,188,85,56,6885
"22097961800",4942,808,549,204,60,260,91,52,6966
"22097961900",1436,132,1323,530,32,60,0,0,3513
"22099020100",4297,1011,63,155,46,190,73,190,6025
"22099020200",4723,395,2100,572,356,0,0,0,8146
"22099020301",2872,254,878,46,21,0,48,0,4119
"22099020302",4873,679,964,219,338,86,302,111,7572
"22099020400",3433,376,946,662,244,62,94,19,5836
"22099020501",2146,354,1586,1146,10,17,0,0,5259
"22099020502",2212,258,637,608,75,92,0,0,3882
"22099020600",2062,120,2050,1064,0,100,22,0,5418
"22099020800",1351,97,984,89,83,62,139,0,2805
"22099020900",1118,177,488,283,9,7,68,1,2151
"22099021000",1223,229,0,0,42,3,24,0,1521
"22101040100",1213,209,457,511,446,40,474,26,3376
"22101040200",3148,328,432,197,238,133,350,128,4954
"22101040300",1476,222,940,422,120,113,322,136,3751
"22101040400",2093,630,695,342,223,172,99,38,4292
"22101040500",3488,450,256,210,350,173,255,105,5287
"22101040600",3641,703,155,271,235,62,211,44,5322
"22101040700",1333,169,1102,484,192,68,146,50,3544
"22101040800",3063,330,1011,191,129,132,23,17,4896
"22101040900",1960,176,801,227,130,35,48,0,3377
"22101041000",1932,319,738,78,600,29,106,10,3812
"22101041100",659,209,572,488,171,56,23,59,2237
"22101041200",552,175,698,366,62,43,45,0,1941
"22101041300",883,90,520,137,134,31,49,34,1878
"22101041400",962,312,1282,704,82,66,17,68,3493
"22101041500",1037,84,651,188,123,4,13,46,2146
"22101041600",105,35,933,699,16,51,0,0,1839
"22101990000",0,0,0,0,0,0,0,0,0
"22103040102",7758,1140,227,108,170,81,167,24,9675
"22103040103",4371,263,0,1,0,0,99,0,4734
"22103040104",5503,680,33,0,73,0,180,77,6546
"22103040201",6311,748,506,83,839,19,314,2,8822
"22103040202",5282,588,25,19,158,12,149,13,6246
"22103040303",7603,473,136,21,529,136,507,56,9461
"22103040304",6275,81,0,0,171,23,202,12,6764
"22103040305",10433,292,241,92,195,0,359,0,11612
"22103040400",5905,602,188,206,71,26,235,24,7257
"22103040501",1022,244,1061,752,0,10,25,32,3146
"22103040502",2513,168,619,243,28,16,96,0,3683
"22103040601",1849,70,0,0,4,12,11,0,1946
"22103040602",2099,146,0,0,32,11,275,28,2591
"22103040604",6014,1629,286,21,286,57,526,69,8888
"22103040605",5244,445,421,201,190,23,273,101,6898
"22103040701",6906,302,1608,183,391,0,585,23,9998
"22103040704",3694,925,448,200,135,134,91,86,5713
"22103040705",4094,394,890,123,127,47,137,49,5861
"22103040706",4012,718,126,0,113,60,140,4,5173
"22103040708",5200,204,662,29,281,21,199,0,6596
"22103040709",3838,88,103,18,181,7,330,0,4565
"22103040710",4499,256,573,208,632,20,222,12,6422
"22103040801",2840,435,581,488,548,250,563,103,5808
"22103040802",5402,285,672,0,564,0,115,0,7038
"22103040803",3067,1163,4040,576,654,110,436,246,10292
"22103040900",1068,228,1113,526,71,40,132,5,3183
"22103041002",2347,513,52,1,51,34,51,101,3150
"22103041003",4357,247,383,111,84,20,190,20,5412
"22103041004",3718,178,83,1,160,0,334,40,4514
"22103041101",3088,174,290,445,65,9,109,0,4180
"22103041102",3894,760,1724,298,175,42,372,1,7266
"22103041103",1567,689,652,269,203,41,233,248,3902
"22103041104",2497,240,476,27,139,0,80,0,3459
"22103041202",1352,460,419,340,226,65,208,8,3078
"22103041204",5569,640,931,226,106,176,267,101,8016
"22103041207",3519,154,139,0,352,6,181,17,4368
"22103041208",4012,71,0,0,168,9,204,0,4464
"22103041209",4603,100,301,7,134,0,113,0,5258
"22103041210",2221,18,179,0,83,0,0,0,2501
"22103041211",5610,154,90,1,307,0,404,0,6566
"22103041212",3389,50,42,33,62,0,326,5,3907
"22103041300",4803,314,526,2,386,71,308,115,6525
"22103990000",0,0,0,0,0,0,0,0,0
"22105953200",1425,287,331,764,0,8,18,0,2833
"22105953300",1014,164,1542,726,12,12,0,12,3482
"22105953400",2170,190,2177,1363,51,87,37,14,6089
"22105953500",5387,849,1076,140,243,91,86,0,7872
"22105953600",1325,418,2385,1428,23,197,122,112,6010
"22105953700",8479,958,363,97,375,36,99,0,10407
"22105953800",3229,1007,503,561,29,19,153,336,5837
"22105953900",5196,1212,1685,676,312,102,527,6,9716
"22105954001",1904,495,699,694,55,65,96,33,4041
"22105954002",2826,410,1730,338,41,11,115,75,5546
"22105954101",2283,310,1063,1233,129,50,62,0,5130
"22105954102",6819,757,859,873,305,16,120,242,9991
"22105954200",1976,762,156,321,99,57,250,23,3644
"22105954300",782,32,2094,1156,0,0,0,0,4064
"22105954400",1131,323,1636,681,0,40,161,171,4143
"22105954501",3263,458,1295,164,45,0,151,70,5446
"22105954502",4073,602,1520,818,407,0,329,0,7749
"22105954600",8328,1219,621,353,99,0,438,247,11305
"22105954700",3482,443,381,392,100,0,39,17,4854
"22105954800",3522,586,552,136,207,18,173,18,5212
"22107000100",745,63,449,338,8,4,15,0,1622
"22107000200",624,234,92,223,0,0,9,6,1188
"22107000300",392,22,798,740,0,0,26,10,1988
"22109000101",4181,495,1286,110,288,106,353,0,6819
"22109000102",1696,255,1106,365,176,9,198,0,3805
"22109000201",1876,262,516,502,223,358,44,156,3937
"22109000202",5552,315,458,550,335,66,480,80,7836
"22109000300",3003,326,654,336,178,111,42,48,4698
"22109000401",3028,246,448,305,520,78,142,123,4890
"22109000402",3444,154,358,0,126,20,97,0,4199
"22109000500",3048,363,848,928,280,100,486,45,6098
"22109000600",3950,852,506,201,731,420,399,24,7083
"22109000700",2501,555,1746,752,514,206,512,87,6873
"22109000800",3825,696,593,188,423,94,242,0,6061
"22109000900",2229,245,1555,184,189,69,127,147,4745
"22109001000",4390,489,202,185,551,0,0,0,5817
"22109001100",2808,326,1,1,209,112,6,0,3463
"22109001201",2386,164,109,101,202,17,0,0,2979
"22109001202",3035,896,20,0,236,39,71,0,4297
"22109001300",2855,350,617,286,1925,1138,71,120,7362
"22109001400",1488,500,532,494,239,512,12,125,3902
"22109001500",5694,374,330,21,710,0,161,0,7290
"22109001600",1087,261,653,757,0,0,41,0,2799
"22109001700",7891,295,516,601,357,71,82,53,9866
"22109990000",0,0,0,0,0,0,0,0,0
"22111960100",2878,337,688,688,27,0,83,0,4701
"22111960200",1640,610,587,583,122,90,208,304,4144
"22111960300",1359,517,316,372,43,0,8,199,2814
"22111960400",1071,214,831,1250,44,14,28,14,3466
"22111960500",3411,820,147,83,29,98,0,0,4588
"22111960600",2696,387,89,108,32,18,78,17,3425
"22113950100",7438,1334,357,193,348,43,597,0,10310
"22113950200",4462,580,156,94,9,0,0,7,5308
"22113950400",2880,712,461,445,239,87,85,37,4946
"22113950500",4861,282,58,2,154,32,17,17,5423
"22113950600",2866,574,36,18,190,32,0,0,3716
"22113950700",2138,218,466,464,368,110,53,0,3817
"22113950800",1324,176,1920,1315,74,33,112,2,4956
"22113950901",2192,212,142,196,86,0,57,0,2885
"22113950902",4717,820,1323,30,253,145,0,0,7288
"22113951001",3327,611,96,15,238,85,70,11,4453
"22113951002",2879,264,188,94,99,4,147,37,3712
"22113951100",1274,608,0,0,66,5,0,253,2206
"22113990000",0,0,0,0,0,0,0,0,0
"22115950100",4209,939,147,34,361,16,129,28,5863
"22115950200",4066,442,142,3,130,25,91,18,4917
"22115950300",3569,532,132,3,390,32,95,1,4754
"22115950400",1463,242,1155,540,210,13,103,21,3747
"22115950500",2980,587,1280,390,664,136,511,76,6624
"22115950600",2233,276,843,16,550,88,282,38,4326
"22115950701",79,0,0,0,0,0,0,0,79
"22115950702",2272,226,518,90,547,10,767,46,4476
"22115950703",1800,143,439,52,267,15,336,109,3161
"22115950704",2836,339,344,9,472,49,839,49,4937
"22115950800",3351,415,176,35,105,34,106,8,4230
"22115950900",4717,875,500,125,319,20,293,64,6913
"22117950101",1412,508,795,398,0,59,39,3,3214
"22117950102",2860,472,803,537,10,0,25,6,4713
"22117950200",3947,739,1131,211,175,0,0,0,6203
"22117950300",923,419,1325,755,0,63,38,26,3549
"22117950400",2492,433,464,380,72,0,0,24,3865
"22117950500",4302,943,230,206,14,0,0,0,5695
"22117950600",3403,681,132,88,57,68,45,0,4474
"22117950700",3292,769,474,552,141,195,516,136,6075
"22117950800",922,72,1374,1505,29,17,3,5,3927
"22117950900",246,266,275,144,38,0,18,0,987
"22117951000",1279,409,786,667,18,0,0,0,3159
"22119031100",1541,151,59,48,20,0,5,18,1842
"22119031200",1492,200,421,462,22,0,17,2,2616
"22119031300",2373,806,620,1232,18,115,20,104,5288
"22119031400",2527,150,311,126,135,4,27,4,3284
"22119031500",3785,463,788,153,146,4,225,0,5564
"22119031600",2515,256,190,18,16,30,13,20,3058
"22119031700",293,91,1733,1174,0,16,0,16,3323
"22119031800",1619,264,752,125,0,35,68,0,2863
"22119031900",212,101,1423,681,106,5,0,18,2546
"22119032000",1979,132,483,423,89,0,60,0,3166
"22119032100",3988,796,1392,635,58,9,46,0,6924
"22121020100",1617,108,1877,471,40,23,53,0,4189
"22121020200",1012,190,1064,389,261,0,79,0,2995
"22121020300",4270,201,795,379,186,148,339,0,6318
"22121020401",2114,298,1903,867,94,11,33,32,5352
"22121020402",4044,296,521,27,138,0,46,0,5072
"22123000100",3327,561,175,363,64,0,36,74,4600
"22123000200",2352,1006,138,168,21,80,19,38,3822
"22123000300",1570,284,376,180,2,27,4,2,2445
"22125951701",1218,153,1597,246,23,0,0,0,3237
"22125951702",372,106,28,4,0,0,0,0,510
"22125951800",4956,400,1242,972,101,20,147,42,7880
"22127960100",2971,467,176,100,6,1,59,3,3783
"22127960200",3247,482,369,313,116,4,12,0,4543
"22127960300",1338,211,420,546,0,124,0,65,2704
"22127960400",739,182,878,504,0,65,0,38,2406
"23001010100",890,330,0,10,48,82,0,6,1366
"23001010200",3560,355,90,59,108,36,177,0,4385
"23001010300",1218,510,35,207,157,16,14,64,2221
"23001010400",2084,227,44,0,32,13,35,0,2435
"23001010500",1439,429,0,20,98,84,0,23,2093
"23001010600",2516,377,0,0,44,58,14,36,3045
"23001010700",2659,242,34,0,207,24,0,0,3166
"23001010800",3495,296,0,0,257,6,77,0,4131
"23001020100",637,459,11,155,76,87,0,66,1491
"23001020200",871,223,0,0,16,44,12,2,1168
"23001020300",3030,1939,44,337,233,248,123,135,6089
"23001020400",1136,1246,140,142,67,179,35,182,3127
"23001020500",3180,453,97,51,35,106,0,65,3987
"23001020600",2096,400,0,0,81,0,1,0,2578
"23001020700",4425,425,0,0,227,0,28,0,5105
"23001020800",5917,617,24,153,497,73,0,0,7281
"23001020900",3268,440,94,0,106,36,5,0,3949
"23001030100",3771,388,9,0,203,43,0,0,4414
"23001030200",3909,432,9,0,115,37,53,0,4555
"23001040000",3470,263,4,0,58,72,0,0,3867
"23001041000",4571,396,13,0,322,85,0,43,5430
"23001041500",5038,384,4,3,111,53,74,0,5667
"23001042000",5039,400,0,6,68,135,37,135,5820
"23001043000",1780,232,0,0,55,9,24,0,2100
"23001044000",2204,769,0,0,148,33,57,14,3225
"23001045000",1676,250,0,0,114,22,19,0,2081
"23001046000",3775,391,0,0,162,6,0,0,4334
"23001046500",5793,685,0,0,252,16,23,3,6772
"23003950100",2064,333,8,0,37,38,29,2,2511
"23003950200",2215,582,22,0,19,0,26,0,2864
"23003950300",3542,329,0,37,16,18,0,2,3944
"23003950400",1539,137,0,3,4,12,4,1,1700
"23003950600",3195,536,0,0,128,59,6,30,3954
"23003950700",2108,370,16,0,28,16,25,0,2563
"23003950900",1787,294,0,0,58,2,11,0,2152
"23003951000",2990,434,0,3,79,64,47,26,3643
"23003951100",2379,235,0,0,92,9,11,0,2726
"23003951200",2190,368,44,0,0,163,2,0,2767
"23003951300",2560,456,0,13,48,39,10,9,3135
"23003951400",1764,226,0,2,89,13,67,0,2161
"23003951600",1415,400,45,20,62,14,5,23,1984
"23003951700",3548,959,9,0,165,38,69,4,4792
"23003951800",3014,646,3,0,235,40,6,0,3944
"23003951900",2335,266,2,0,34,2,3,0,2642
"23003952000",1780,450,17,0,36,181,0,9,2473
"23003952100",2236,509,19,0,35,22,13,0,2834
"23003952300",2100,299,20,2,136,100,12,12,2681
"23003952400",2728,706,22,0,137,164,7,36,3800
"23003952500",1664,311,0,0,13,29,0,24,2041
"23003952600",2439,504,9,0,30,35,18,0,3035
"23003952700",2230,353,3,0,58,15,15,0,2674
"23003952900",2370,473,2,7,59,3,12,2,2928
"23005000100",1801,430,52,34,133,8,28,0,2486
"23005000200",1944,450,78,0,26,12,85,1,2596
"23005000300",1305,713,171,153,114,88,13,72,2629
"23005000500",948,387,130,606,198,182,121,38,2610
"23005000600",1339,751,189,196,40,56,132,42,2745
"23005001000",1481,630,143,225,98,21,48,9,2655
"23005001100",1982,570,15,23,106,60,34,51,2841
"23005001200",936,351,53,62,36,33,30,0,1501
"23005001300",2225,708,34,213,136,61,114,6,3497
"23005001500",3009,356,34,9,137,145,131,61,3882
"23005001700",3685,353,35,89,204,81,30,4,4481
"23005001800",3464,147,0,0,41,8,94,0,3754
"23005001900",3524,207,19,0,182,100,132,2,4166
"23005002001",2386,181,57,91,546,190,0,2,3453
"23005002002",1564,254,26,63,208,57,83,10,2265
"23005002101",4471,756,43,233,120,170,59,0,5852
"23005002102",3632,723,113,566,209,228,163,502,6136
"23005002200",3765,475,54,0,377,15,0,0,4686
"23005002300",2392,258,344,432,182,30,125,32,3795
"23005002400",1081,127,0,3,19,2,24,41,1297
"23005002501",3268,124,59,0,41,48,89,0,3629
"23005002502",7039,159,21,0,348,18,79,12,7676
"23005002600",3588,132,57,125,29,0,50,14,3995
"23005002700",3002,592,293,66,250,77,165,84,4529
"23005002800",2279,397,0,23,39,0,28,0,2766
"23005002900",4864,1176,0,239,149,6,41,0,6475
"23005003000",4494,966,36,138,696,43,139,32,6544
"23005003100",2909,644,0,100,206,0,26,131,4016
"23005003200",2718,345,66,0,24,0,9,3,3165
"23005003300",2590,143,9,60,299,45,36,10,3192
"23005003400",4147,58,35,0,240,14,18,0,4512
"23005003500",2998,438,9,0,85,20,0,20,3570
"23005003701",3970,105,8,0,230,25,67,12,4417
"23005003702",4327,144,153,24,59,0,67,0,4774
"23005004001",2801,78,47,0,193,0,42,32,3193
"23005004002",5658,187,19,38,143,8,0,0,6053
"23005004100",5438,109,0,0,251,1,22,0,5821
"23005004200",7057,188,0,0,354,17,78,17,7711
"23005004401",4525,98,14,0,114,0,188,0,4939
"23005004402",3198,271,15,0,64,0,39,24,3611
"23005004501",2727,153,24,0,13,0,0,0,2917
"23005004502",4517,222,43,7,133,0,36,0,4958
"23005004600",3389,69,0,2,124,0,23,0,3607
"23005004701",1757,188,0,0,64,0,57,0,2066
"23005004702",4724,912,14,0,108,24,34,0,5816
"23005004801",5764,660,174,25,182,0,20,13,6838
"23005004802",4064,298,129,7,106,15,9,0,4628
"23005004803",4355,514,0,0,36,3,41,5,4954
"23005011100",4183,224,65,0,204,0,59,0,4735
"23005011201",5540,646,28,0,67,50,25,0,6356
"23005011202",4095,801,0,0,288,0,87,36,5307
"23005011300",2040,193,77,0,40,0,20,0,2370
"23005011500",6235,532,16,0,89,49,134,12,7067
"23005012000",4201,212,0,0,42,0,0,0,4455
"23005013000",3086,525,0,0,52,94,0,29,3786
"23005014000",3278,523,33,1,51,0,32,0,3918
"23005015000",2332,302,20,23,73,0,0,0,2750
"23005016000",4130,856,0,0,52,11,0,19,5068
"23005016500",2847,255,0,7,32,8,3,4,3156
"23005017001",5856,317,0,1,80,0,0,0,6254
"23005017002",2914,172,0,0,0,0,2,0,3088
"23005017101",1732,39,0,0,52,0,0,0,1823
"23005017102",2273,608,0,0,0,68,17,0,2966
"23005017301",7367,389,0,0,595,0,95,0,8446
"23005017303",4107,226,0,0,62,0,0,0,4395
"23005017304",5167,235,204,18,394,12,139,13,6182
"23005990000",0,0,0,0,0,0,0,0,0
"23007970101",1735,209,14,0,145,0,0,0,2103
"23007970102",623,93,0,0,9,0,4,0,729
"23007970601",1580,127,3,0,24,8,64,16,1822
"23007970602",2038,557,2,0,28,0,18,0,2643
"23007971000",3501,363,10,4,65,30,33,3,4009
"23007971100",2376,357,0,0,66,2,15,0,2816
"23007971200",4925,1604,7,29,70,0,53,0,6688
"23007971300",2981,874,0,0,183,6,52,0,4096
"23007971400",4406,324,0,0,96,0,0,41,4867
"23009965100",1615,226,1,0,26,0,12,7,1887
"23009965200",2214,161,0,0,14,7,39,0,2435
"23009965300",3846,1037,0,0,26,7,0,12,4928
"23009965400",2391,273,0,0,35,5,6,23,2733
"23009965503",2815,540,0,0,72,6,16,0,3449
"23009965504",3633,359,42,53,13,9,100,0,4209
"23009965700",2225,484,0,4,74,75,3,12,2877
"23009965800",1769,342,0,0,5,5,0,0,2121
"23009965900",4241,391,0,5,256,56,131,0,5080
"23009966000",1878,168,3,0,70,0,14,0,2133
"23009966100",1445,372,0,0,74,44,0,65,2000
"23009966200",1681,325,6,0,37,38,16,1,2104
"23009966300",3550,644,19,6,83,11,20,20,4353
"23009966400",1511,405,0,0,17,0,0,0,1933
"23009966500",2408,333,16,0,39,4,8,31,2839
"23009966600",2569,355,14,0,58,7,0,23,3026
"23009966700",4660,617,0,8,165,23,98,4,5575
"23009990000",0,0,0,0,0,0,0,0,0
"23011010100",3847,756,52,0,200,0,91,172,5118
"23011010200",3395,633,32,0,66,0,0,0,4126
"23011010300",2447,600,51,0,47,166,21,0,3332
"23011010400",1492,628,0,0,131,58,45,31,2385
"23011010500",3148,530,0,0,137,14,44,13,3886
"23011010600",6113,798,11,0,80,0,51,0,7053
"23011010700",1936,248,0,0,28,92,6,0,2310
"23011010801",2395,180,0,0,5,0,0,0,2580
"23011010802",5209,913,0,0,199,73,12,59,6465
"23011010900",982,417,0,0,18,0,0,0,1417
"23011011000",3773,270,64,0,154,25,103,10,4399
"23011012000",3075,287,0,0,141,0,0,0,3503
"23011013000",3578,455,0,0,60,0,27,0,4120
"23011014000",5350,506,0,16,86,46,95,38,6137
"23011014500",1944,165,10,0,22,3,0,0,2144
"23011015000",2401,104,0,5,68,0,0,0,2578
"23011015500",2903,455,9,0,24,1,22,0,3414
"23011016000",2848,226,0,0,55,0,48,0,3177
"23011017000",3708,447,0,0,36,0,28,0,4219
"23011018000",3682,553,23,0,62,9,10,0,4339
"23011019000",2309,200,0,0,33,9,38,0,2589
"23011020000",3689,430,50,0,72,67,58,0,4366
"23011020500",1783,188,0,0,27,0,27,0,2025
"23011021000",2903,530,0,12,0,0,14,12,3471
"23011022000",2289,367,0,0,20,8,96,0,2780
"23011023001",2794,546,0,6,190,4,11,0,3551
"23011023002",3675,362,18,0,129,0,0,0,4184
"23011024101",2825,898,0,0,204,36,150,19,4132
"23011024102",3409,1380,75,143,67,172,0,68,5314
"23011024200",4021,348,115,0,124,17,68,7,4700
"23011025000",5526,481,0,22,88,17,7,0,6141
"23013970200",4485,308,0,0,8,0,8,0,4809
"23013970300",5867,667,25,0,187,8,29,4,6787
"23013970400",5875,786,47,53,88,16,49,50,6964
"23013970500",2950,242,0,0,59,35,123,40,3449
"23013970600",2086,340,11,0,96,0,30,0,2563
"23013970700",3571,709,48,0,141,10,0,0,4479
"23013970800",2748,274,14,2,63,7,11,1,3120
"23013970900",2344,156,0,0,73,20,4,0,2597
"23013971000",2193,300,0,0,18,4,15,0,2530
"23013971100",1421,191,4,0,62,26,6,3,1713
"23013990000",0,0,0,0,0,0,0,0,0
"23015975100",4712,573,15,0,58,37,20,37,5452
"23015975200",4066,885,0,12,51,16,0,57,5087
"23015975300",3124,437,0,0,48,0,12,7,3628
"23015975400",3231,302,36,3,63,7,23,0,3665
"23015975500",4835,684,4,0,362,33,28,6,5952
"23015975600",3392,221,29,0,11,0,43,0,3696
"23015975700",852,98,0,0,0,0,9,0,959
"23015975800",2666,431,0,0,14,0,44,0,3155
"23015976200",2328,221,5,0,11,1,0,5,2571
"23015990000",0,0,0,0,0,0,0,0,0
"23017965100",1059,117,0,0,9,4,0,0,1189
"23017965400",2181,764,0,4,98,54,0,0,3101
"23017965500",1303,402,0,0,17,0,0,1,1723
"23017965600",2976,765,21,0,55,141,86,20,4064
"23017965700",2796,525,0,0,46,23,0,32,3422
"23017965800",3255,440,0,0,91,16,32,0,3834
"23017965900",2597,249,0,0,0,0,0,0,2846
"23017966000",2702,443,29,0,81,0,28,13,3296
"23017966100",1513,258,7,1,26,0,25,0,1830
"23017966200",4050,678,0,33,121,41,89,0,5012
"23017966300",2822,429,0,24,129,5,0,50,3459
"23017966400",5479,547,0,3,5,99,51,0,6184
"23017966500",4006,786,0,0,29,43,40,29,4933
"23017966600",2574,405,4,0,55,6,22,7,3073
"23017966700",2581,382,0,11,97,0,23,0,3094
"23017966800",2024,252,53,0,53,0,22,0,2404
"23017966900",2810,442,13,0,98,7,0,0,3370
"23019000200",2278,1209,29,10,167,5,57,14,3769
"23019000300",3246,271,60,37,163,28,24,0,3829
"23019000400",1789,512,0,27,124,64,51,90,2657
"23019000500",2331,883,38,32,60,4,24,0,3372
"23019000600",1595,880,0,11,21,53,0,0,2560
"23019000700",2326,260,39,12,15,0,6,0,2658
"23019000900",4210,2167,30,173,130,147,44,84,6985
"23019002000",6691,312,17,0,172,33,106,0,7331
"23019003000",3493,219,0,0,24,0,45,0,3781
"23019004100",1264,509,0,8,11,20,13,0,1825
"23019004200",2318,45,0,20,0,64,0,0,2447
"23019004300",4668,299,0,0,43,32,0,0,5042
"23019005000",1561,386,0,0,99,24,13,0,2083
"23019006100",1352,1245,7,18,116,80,0,0,2818
"23019006200",2426,293,0,0,149,0,59,0,2927
"23019006300",658,268,0,0,82,51,0,0,1059
"23019007100",2903,1749,28,19,175,233,34,168,5309
"23019007200",2038,389,5,18,187,52,0,0,2689
"23019008001",3987,349,24,0,91,40,0,3,4494
"23019009000",5622,507,75,0,146,11,108,0,6469
"23019010000",4852,402,24,0,130,0,0,0,5408
"23019011000",2566,156,0,0,57,8,0,0,2787
"23019012000",1338,105,4,0,49,4,11,0,1511
"23019012500",2037,241,0,0,39,20,24,0,2361
"23019013000",2501,685,25,0,13,36,0,0,3260
"23019013500",2240,273,43,4,27,0,7,11,2605
"23019014000",1708,303,0,0,0,0,10,26,2047
"23019015000",2991,731,0,0,52,37,8,20,3839
"23019015500",1621,457,0,2,20,43,4,40,2187
"23019018000",2486,317,0,0,30,0,0,0,2833
"23019020500",2127,398,8,0,59,15,32,20,2659
"23019021500",1657,182,0,0,30,7,0,0,1876
"23019022500",1365,294,8,1,78,31,2,3,1782
"23019024500",2076,369,23,14,46,18,25,0,2571
"23019025500",1490,425,0,0,4,19,16,10,1964
"23019026500",1679,211,0,0,39,5,1,0,1935
"23019027000",3512,1421,0,0,51,0,0,0,4984
"23019028000",1346,187,0,0,109,0,10,0,1652
"23019028500",1167,251,11,0,71,0,12,0,1512
"23019029000",1706,390,0,0,44,23,3,0,2166
"23019030000",3729,446,0,0,211,0,64,0,4450
"23019031000",1355,289,0,0,2,25,0,0,1671
"23019031100",4686,668,2,0,206,107,149,0,5818
"23019031200",3203,517,0,6,46,97,48,1,3918
"23019031300",4921,401,44,0,238,42,100,0,5746
"23019940000",57,43,1,0,466,215,7,29,818
"23021960301",1347,379,0,1,26,137,1,10,1901
"23021960302",582,59,0,0,0,6,0,0,647
"23021960400",1068,182,0,0,32,0,8,0,1290
"23021960500",1288,247,0,0,10,38,18,28,1629
"23021960600",2242,579,0,16,30,10,13,25,2915
"23021960700",3459,413,0,0,30,54,20,0,3976
"23021960800",2708,709,0,0,68,59,45,6,3595
"23021960900",1010,270,0,1,20,0,3,0,1304
"23023970100",2987,287,23,0,40,14,72,0,3423
"23023970200",5300,433,40,0,113,31,126,7,6050
"23023970301",3771,217,12,0,303,37,39,14,4393
"23023970302",3828,355,0,0,126,19,29,1,4358
"23023970400",4128,280,32,0,49,21,9,13,4532
"23023970500",3833,1240,38,0,122,9,0,96,5338
"23023970600",2435,495,30,38,70,42,30,23,3163
"23023970700",3685,368,25,0,51,2,5,11,4147
"23023990000",0,0,0,0,0,0,0,0,0
"23025965301",842,138,0,0,37,0,11,0,1028
"23025965302",1005,219,0,0,33,9,18,0,1284
"23025965600",1556,466,0,0,54,5,6,0,2087
"23025965700",2282,691,5,8,41,9,0,0,3036
"23025965800",2275,589,11,0,109,10,27,0,3021
"23025965900",1379,326,0,0,17,8,11,22,1763
"23025966000",3366,509,8,31,117,0,9,0,4040
"23025966100",2942,438,0,0,13,3,0,0,3396
"23025966200",1456,390,0,0,140,5,6,0,1997
"23025966300",1518,304,23,0,22,17,0,0,1884
"23025966400",1862,571,0,0,23,63,13,0,2532
"23025966500",3858,673,15,22,14,19,0,0,4601
"23025966600",2932,996,18,0,41,6,0,0,3993
"23025966700",3361,841,36,0,138,0,11,25,4412
"23025966800",5427,782,19,0,176,197,44,224,6869
"23025966900",2856,458,22,0,3,0,3,0,3342
"23025967000",1870,268,3,0,27,12,14,0,2194
"23027041000",3427,267,14,2,30,0,0,0,3740
"23027042000",4940,843,19,0,76,59,39,0,5976
"23027043000",4685,1549,13,0,190,89,56,77,6659
"23027044000",3971,325,0,0,57,25,26,5,4409
"23027045000",4869,889,14,3,88,33,43,17,5956
"23027046001",1942,197,2,0,22,22,12,2,2199
"23027046002",3747,974,3,9,49,18,52,4,4856
"23027047000",3477,834,0,32,92,72,9,4,4520
"23029955100",1463,547,39,13,465,436,18,52,3033
"23029955300",1144,191,0,0,26,14,35,0,1410
"23029955400",1284,124,3,0,13,1,13,0,1438
"23029955500",2416,511,0,0,16,9,28,15,2995
"23029955600",1195,252,0,0,414,285,6,0,2152
"23029955700",986,316,1,2,91,2,6,1,1405
"23029955800",1920,524,2,7,47,47,24,12,2583
"23029955900",2301,403,0,0,113,36,6,0,2859
"23029956100",1790,337,4,2,28,2,36,2,2201
"23029956200",2112,354,2,0,40,41,31,4,2584
"23029956300",1955,428,2,4,40,27,31,26,2513
"23029956400",2626,385,17,0,42,15,36,4,3125
"23029956500",2721,813,12,10,97,17,51,25,3746
"23029990000",0,0,0,0,0,0,0,0,0
"23031005100",4639,247,0,0,202,0,76,0,5164
"23031005200",3241,203,0,0,246,170,52,0,3912
"23031005300",5308,955,63,0,462,49,162,0,6999
"23031005400",2296,273,0,42,24,0,4,0,2639
"23031006101",4678,315,69,0,152,0,86,8,5308
"23031006102",2603,741,47,4,0,27,58,19,3499
"23031020000",6614,1011,135,0,265,11,196,113,8345
"23031021000",3894,370,0,0,22,0,7,0,4293
"23031022000",3275,371,32,0,0,0,53,25,3756
"23031022500",2425,534,0,0,71,45,8,0,3083
"23031023000",2515,281,59,0,42,0,0,0,2897
"23031023500",5499,721,0,0,129,133,41,55,6578
"23031024000",6630,657,69,0,279,36,34,0,7705
"23031024500",5768,512,0,0,152,0,0,0,6432
"23031025100",3564,205,12,0,15,0,50,11,3857
"23031025201",4147,556,0,0,434,0,28,15,5180
"23031025202",5343,1385,0,0,250,91,0,0,7069
"23031025300",2704,128,0,0,88,0,20,0,2940
"23031025400",1058,235,0,3,53,0,0,0,1349
"23031026000",3679,183,22,31,85,1,33,0,4034
"23031027000",3291,121,0,0,58,0,39,0,3509
"23031028001",3118,77,10,0,10,0,0,0,3215
"23031028002",7218,243,0,0,65,44,14,0,7584
"23031029000",2456,294,3,4,11,3,5,10,2786
"23031030100",3645,651,0,0,212,35,126,39,4708
"23031030201",2323,548,10,0,79,78,44,0,3082
"23031030202",3785,1113,92,0,401,89,361,46,5887
"23031030203",3469,336,20,0,203,34,64,0,4126
"23031030300",3031,323,0,0,27,0,36,0,3417
"23031031000",5505,524,20,0,0,0,0,0,6049
"23031032000",6488,444,56,16,272,38,121,8,7443
"23031033000",4075,314,31,8,71,0,71,0,4570
"23031034001",5332,261,0,0,118,0,0,0,5711
"23031034002",4705,317,36,0,13,0,8,0,5079
"23031035000",6704,367,13,0,98,62,11,27,7282
"23031036001",6379,403,0,0,64,0,55,0,6901
"23031036002",5300,376,0,3,41,50,194,0,5964
"23031037000",5665,354,53,0,162,0,66,0,6300
"23031038001",5486,467,163,1,141,0,126,0,6384
"23031038002",2734,125,39,0,215,0,33,0,3146
"23031990100",0,0,0,0,0,0,0,0,0
"24001000100",3079,267,132,0,25,0,21,0,3524
"24001000200",2312,385,0,0,46,12,30,12,2797
"24001000300",1911,592,132,8,5,78,0,0,2726
"24001000400",2497,453,186,17,30,0,7,0,3190
"24001000500",1095,949,20,238,15,45,0,18,2380
"24001000600",2422,325,6,9,72,5,12,5,2856
"24001000700",2471,638,116,30,31,0,0,29,3315
"24001000800",1414,465,9,5,93,113,46,32,2177
"24001001000",1696,361,82,42,45,31,0,0,2257
"24001001100",1073,326,15,29,90,21,43,0,1597
"24001001200",2297,253,186,45,147,12,25,12,2977
"24001001300",1590,412,0,0,14,0,0,0,2016
"24001001401",3727,221,34,6,37,12,6,0,4043
"24001001402",1160,171,56,0,23,1,4,1,1416
"24001001502",1582,267,0,0,22,0,41,18,1930
"24001001503",1768,150,25,7,42,0,29,0,2021
"24001001600",1661,210,14,0,2,6,0,0,1893
"24001001700",3021,1153,75,0,120,29,0,0,4398
"24001001800",2319,915,29,389,14,46,8,15,3735
"24001001900",2432,270,49,0,87,0,8,0,2846
"24001002000",5119,412,0,1,64,33,47,0,5676
"24001002100",2890,534,52,0,23,5,15,0,3519
"24001002200",3045,583,0,0,65,5,121,6,3825
"24003701101",3790,187,70,0,168,0,218,0,4433
"24003701102",6603,255,79,75,518,154,450,158,8292
"24003701200",7822,262,137,0,390,0,169,0,8780
"24003701300",6632,94,361,46,290,12,131,0,7566
"24003701400",2888,34,575,55,45,0,95,0,3692
"24003702100",5814,150,225,0,158,0,99,0,6446
"24003702204",4073,114,96,0,144,19,163,0,4609
"24003702205",4170,90,549,65,321,36,82,0,5313
"24003702206",4933,108,845,2,773,16,456,17,7150
"24003702208",4433,66,1887,0,853,0,435,21,7695
"24003702209",3585,281,258,55,386,17,51,0,4633
"24003702300",5363,64,40,0,160,0,124,0,5751
"24003702402",5331,91,225,3,644,0,493,0,6787
"24003702500",2747,62,2257,529,602,135,1127,226,7685
"24003702601",4464,39,615,337,207,0,206,0,5868
"24003702602",4165,226,613,39,869,0,772,0,6684
"24003702701",4126,198,283,0,226,14,166,0,5013
"24003702702",3160,122,56,0,186,0,21,0,3545
"24003706101",2650,154,350,158,56,89,66,77,3600
"24003706301",3103,132,445,117,266,0,359,17,4439
"24003706302",2975,113,113,22,196,12,249,0,3680
"24003706401",3549,465,998,72,1835,75,2615,219,9828
"24003706402",1488,92,532,489,177,0,190,18,2986
"24003706500",2991,221,833,173,737,103,992,241,6291
"24003706600",3784,451,614,276,166,0,197,341,5829
"24003706700",413,15,53,0,245,8,197,0,931
"24003707001",5455,115,737,187,34,19,97,1,6645
"24003707002",4087,282,124,2,377,16,268,1,5157
"24003708001",3623,142,75,22,97,0,60,0,4019
"24003708004",4009,304,1034,73,286,102,296,62,6166
"24003730100",5812,182,531,0,586,135,511,69,7826
"24003730203",2881,507,854,179,616,120,577,150,5884
"24003730204",3132,244,2007,348,483,83,380,37,6714
"24003730300",1940,387,278,222,237,0,320,0,3384
"24003730401",3092,331,516,236,360,0,106,53,4694
"24003730402",3371,446,956,430,626,486,166,58,6539
"24003730502",3577,130,982,465,590,15,110,38,5907
"24003730504",4772,113,1434,72,860,55,254,0,7560
"24003730505",2358,110,1506,129,420,16,872,52,5463
"24003730506",1472,264,1621,55,280,185,219,45,4141
"24003730601",6314,153,0,0,563,0,304,0,7334
"24003730603",2463,183,128,2,308,26,41,1,3152
"24003730604",5749,141,217,19,426,9,9,31,6601
"24003730700",6115,167,284,0,388,0,210,0,7164
"24003730800",2283,88,0,0,38,9,104,0,2522
"24003730901",1899,32,344,20,143,8,60,0,2506
"24003730902",3635,72,61,0,84,23,55,69,3999
"24003731002",2586,58,432,30,123,0,217,58,3504
"24003731003",4100,33,83,0,215,0,91,0,4522
"24003731004",3774,135,124,0,298,0,220,0,4551
"24003731102",6377,121,170,0,468,66,283,45,7530
"24003731103",3898,364,344,33,520,177,303,173,5812
"24003731104",4223,17,174,0,344,0,320,0,5078
"24003731105",2968,91,38,2,186,84,68,16,3453
"24003731201",5575,142,106,2,495,0,19,0,6339
"24003731202",6327,386,38,2,70,4,150,0,6977
"24003731203",6054,371,372,18,435,0,142,42,7434
"24003731204",5386,143,281,7,111,4,173,15,6120
"24003731303",6469,244,211,0,188,0,71,0,7183
"24003731306",5645,290,288,0,88,14,132,13,6470
"24003731307",5647,134,268,5,268,29,184,1,6536
"24003731308",3136,144,67,1,88,0,31,0,3467
"24003731309",4522,546,299,227,108,0,49,0,5751
"24003731310",4398,169,515,3,222,0,245,0,5552
"24003731311",7027,251,152,20,1098,207,491,32,9278
"24003740102",3666,392,1312,80,1712,22,382,0,7566
"24003740103",4227,332,2482,135,1161,17,559,0,8913
"24003740104",2498,137,3211,467,867,434,681,78,8373
"24003740105",442,14,2220,358,310,50,188,0,3582
"24003740201",3521,160,2002,343,815,50,150,0,7041
"24003740203",4134,126,485,27,618,20,228,1,5639
"24003740303",3064,196,407,41,630,16,403,62,4819
"24003740304",2638,168,767,13,378,80,217,7,4268
"24003740305",3257,200,5644,723,1564,41,493,124,12046
"24003740400",0,0,0,0,0,0,0,0,0
"24003740500",3028,53,4374,177,1732,134,462,10,9970
"24003740601",2921,192,1079,0,728,7,479,119,5525
"24003740602",2434,107,719,125,427,13,562,8,4395
"24003740603",417,22,213,0,25,0,72,0,749
"24003740701",3891,236,818,229,300,81,201,0,5756
"24003740702",7199,317,1214,65,1036,29,324,0,10184
"24003740800",3408,97,284,1,219,24,225,0,4258
"24003740900",4821,47,1067,53,1066,0,389,0,7443
"24003741000",1735,0,204,0,286,14,61,0,2300
"24003750101",2643,231,342,374,697,92,353,9,4741
"24003750102",1451,86,371,61,353,0,11,5,2338
"24003750201",1472,155,703,171,176,94,182,0,2953
"24003750202",2351,402,143,6,183,2,165,2,3254
"24003750203",1021,48,132,0,396,0,112,0,1709
"24003750300",2096,164,22,7,99,17,0,0,2405
"24003750400",3783,145,48,26,241,13,49,1,4306
"24003750801",4860,117,195,0,473,0,219,0,5864
"24003750803",2952,523,1804,236,2186,334,2270,45,10350
"24003750804",2812,246,464,52,366,191,271,28,4430
"24003750900",2205,104,308,2,245,83,298,27,3272
"24003751000",2737,413,366,0,216,9,322,203,4266
"24003751102",1945,158,951,144,220,22,82,0,3522
"24003751103",4767,213,176,199,151,58,245,0,5809
"24003751200",3100,315,552,190,8,9,97,0,4271
"24003751400",2670,189,669,4,538,41,156,41,4308
"24003751500",3020,118,1893,289,969,0,1367,0,7656
"24003751600",4412,199,135,66,141,0,59,0,5012
"24003751700",2232,31,242,9,134,5,49,5,2707
"24003980000",4,0,0,0,10,0,10,0,24
"24003990000",0,0,0,0,0,0,0,0,0
"24005400100",3044,223,600,77,440,60,57,0,4501
"24005400200",1960,71,206,179,71,7,63,16,2573
"24005400400",4627,366,65,17,296,18,184,18,5591
"24005400500",2292,57,35,16,63,0,20,16,2499
"24005400600",1842,175,404,125,185,38,0,0,2769
"24005400701",1551,40,693,6,394,11,204,2,2901
"24005400702",921,8,591,64,174,2,79,0,1839
"24005400800",1556,105,746,177,124,0,18,43,2769
"24005400900",1417,279,325,184,114,8,403,157,2887
"24005401000",1652,30,657,3,55,0,38,0,2435
"24005401101",1262,82,4745,294,371,230,15,0,6999
"24005401102",88,27,750,59,116,69,26,1,1136
"24005401200",549,27,2417,179,122,9,37,9,3349
"24005401301",1015,73,1948,153,206,15,115,0,3525
"24005401302",402,17,1811,157,172,25,65,0,2649
"24005401400",1501,49,63,0,93,0,31,0,1737
"24005401503",5405,253,142,53,706,10,365,50,6984
"24005401504",2359,254,2532,44,934,145,95,0,6363
"24005401505",1568,143,1732,52,561,93,521,0,4670
"24005401506",606,1,3550,83,1119,201,0,9,5569
"24005401507",725,7,2679,265,1555,259,510,25,6025
"24005402201",1733,68,1321,442,87,22,69,9,3751
"24005402202",819,40,567,2,166,0,85,0,1679
"24005402302",284,15,4401,131,185,63,61,0,5140
"24005402303",652,271,5378,282,91,246,620,119,7659
"24005402304",177,26,3447,406,5,9,58,10,4138
"24005402305",465,35,1155,318,7,1,31,0,2012
"24005402306",247,44,3061,285,283,9,84,33,4046
"24005402307",741,12,4102,593,285,0,353,0,6086
"24005402403",279,11,1646,417,8,0,117,0,2478
"24005402404",218,1,3920,776,134,0,75,0,5124
"24005402405",679,29,2204,140,157,0,249,16,3474
"24005402406",264,16,5007,779,510,120,360,40,7096
"24005402407",562,101,841,15,31,49,4,0,1603
"24005402503",550,28,2931,877,301,14,124,8,4833
"24005402504",649,9,2937,302,312,0,56,0,4265
"24005402505",171,175,2459,127,67,1,0,1,3001
"24005402506",618,32,3050,315,207,22,32,24,4300
"24005402509",2181,196,5809,47,644,27,605,0,9509
"24005402602",248,42,1552,55,33,13,28,12,1983
"24005402603",876,113,4935,145,225,0,27,0,6321
"24005402604",765,82,4195,360,190,0,384,0,5976
"24005403100",517,16,1560,59,277,11,179,0,2619
"24005403201",326,52,2155,189,67,0,204,0,2993
"24005403202",172,0,1808,71,67,61,0,0,2179
"24005403300",941,62,834,0,249,0,76,0,2162
"24005403401",1703,84,1037,102,224,15,228,3,3396
"24005403402",1789,645,1712,67,343,55,248,46,4905
"24005403500",3852,189,115,57,852,96,106,0,5267
"24005403601",4065,234,176,20,589,0,77,0,5161
"24005403602",3792,191,537,334,767,8,142,28,5799
"24005403701",4616,231,1345,284,342,24,12,0,6854
"24005403702",3025,88,757,62,321,0,87,0,4340
"24005403801",1500,66,44,0,131,0,107,0,1848
"24005403802",2560,91,13,3,46,18,15,0,2746
"24005403803",2795,59,99,0,223,12,26,0,3214
"24005404101",2376,42,1951,52,482,0,263,4,5170
"24005404102",2269,303,2162,119,547,158,425,0,5983
"24005404201",2973,207,1618,291,1064,240,899,0,7292
"24005404202",2021,157,3500,466,1175,165,850,166,8500
"24005404402",4817,44,930,18,414,0,112,0,6335
"24005404403",2491,299,848,450,496,369,638,182,5773
"24005404404",2901,181,781,102,386,60,87,48,4546
"24005404501",4030,498,1303,275,616,217,490,129,7558
"24005404502",1879,162,816,342,344,98,352,9,4002
"24005404600",2288,56,88,11,59,0,119,24,2645
"24005404800",1550,15,285,0,121,0,32,0,2003
"24005404900",4133,354,171,8,266,0,152,0,5084
"24005405000",3949,271,67,11,93,0,28,107,4526
"24005406000",5354,89,62,14,115,0,60,0,5694
"24005407001",2775,216,148,0,85,0,34,0,3258
"24005407002",5613,115,18,14,319,16,262,8,6365
"24005408100",4713,168,416,0,428,0,171,0,5896
"24005408200",1898,25,97,0,52,17,30,0,2119
"24005408302",2380,113,38,0,328,57,20,8,2944
"24005408303",2970,77,256,0,219,0,72,0,3594
"24005408304",4124,138,39,0,412,24,84,0,4821
"24005408400",501,36,35,16,44,29,47,0,708
"24005408502",4346,72,294,1,475,6,221,0,5415
"24005408503",1791,244,336,36,598,161,253,19,3438
"24005408505",2950,212,168,46,608,23,213,101,4321
"24005408506",1882,256,1090,298,808,126,272,0,4732
"24005408507",2698,121,1408,22,1817,312,358,0,6736
"24005408601",3430,29,0,0,428,6,196,11,4100
"24005408602",1852,48,11,0,222,0,121,0,2254
"24005408702",2192,8,53,0,158,0,60,0,2471
"24005408703",5268,122,80,0,682,0,133,0,6285
"24005408704",4338,70,110,0,1079,0,52,0,5649
"24005408800",1926,105,9,15,192,65,0,8,2320
"24005408900",2203,85,191,46,198,0,0,0,2723
"24005410100",5193,280,70,8,113,0,166,0,5830
"24005410200",4124,196,35,139,246,0,43,0,4783
"24005411101",2008,92,89,0,55,0,35,0,2279
"24005411102",2785,58,37,4,47,2,6,16,2955
"24005411201",3083,42,27,1,38,0,127,0,3318
"24005411202",3099,28,44,34,277,0,42,0,3524
"24005411302",2186,228,381,16,656,169,133,0,3769
"24005411303",4775,211,411,63,369,152,133,152,6266
"24005411306",4071,0,768,0,769,112,41,0,5761
"24005411307",2284,91,591,1,744,47,167,0,3925
"24005411308",2741,19,151,52,502,0,140,0,3605
"24005411309",6702,140,569,0,1041,120,74,0,8646
"24005411404",3169,72,82,42,536,9,263,0,4173
"24005411406",3867,278,127,1,222,8,106,0,4609
"24005411407",6894,609,1110,214,827,128,126,0,9908
"24005411408",2122,182,446,22,513,7,160,10,3462
"24005411409",4008,99,339,268,530,48,222,52,5566
"24005411410",3488,46,277,77,750,13,100,0,4751
"24005420100",3054,374,79,38,50,0,60,12,3667
"24005420200",1713,281,68,17,228,0,138,17,2462
"24005420301",1794,121,204,319,364,34,62,0,2898
"24005420302",2417,180,39,0,132,0,176,26,2970
"24005420303",1157,84,5,0,18,0,3,0,1267
"24005420401",4604,300,469,140,648,18,16,18,6213
"24005420402",1774,118,14,30,192,31,98,14,2271
"24005420500",2549,304,104,28,311,0,360,6,3662
"24005420600",2865,735,254,30,92,104,139,43,4262
"24005420701",1894,454,237,0,436,184,58,25,3288
"24005420702",1612,149,27,0,244,64,356,6,2458
"24005420800",2306,408,347,0,97,122,119,106,3505
"24005420900",2236,443,110,171,86,150,75,0,3271
"24005421000",960,483,185,37,71,68,7,0,1811
"24005421101",1888,182,321,11,367,55,163,0,2987
"24005421102",1660,273,125,90,86,20,57,42,2353
"24005421200",1497,111,68,13,18,0,12,0,1719
"24005421300",521,74,1559,541,59,28,20,0,2802
"24005430101",1630,190,889,320,905,119,940,174,5167
"24005430104",2021,185,103,0,362,46,152,0,2869
"24005430200",1737,339,404,163,191,0,58,0,2892
"24005430300",3209,539,1101,1041,316,0,695,51,6952
"24005430400",3354,342,251,269,129,55,312,91,4803
"24005430600",2018,144,14,37,89,8,28,8,2346
"24005430700",4102,140,300,24,377,48,122,0,5113
"24005430800",2693,185,168,1,265,20,12,0,3344
"24005430900",2289,234,1263,10,944,363,184,0,5287
"24005440100",3819,396,191,1,201,85,64,7,4764
"24005440200",1726,172,301,25,143,116,0,0,2483
"24005440300",907,75,715,67,372,11,89,0,2236
"24005440400",3617,356,963,60,351,0,154,10,5511
"24005440500",2528,70,192,0,194,10,35,0,3029
"24005440600",1514,73,285,0,333,16,18,0,2239
"24005440701",1955,275,2429,429,983,129,484,181,6865
"24005440702",3534,62,1079,123,605,18,180,0,5601
"24005440800",1550,55,813,23,665,52,56,0,3214
"24005440900",1181,283,1261,289,397,20,193,58,3682
"24005441000",744,30,1816,426,197,155,14,42,3424
"24005441101",1420,61,432,84,129,0,75,0,2201
"24005441102",2969,152,924,295,441,119,293,102,5295
"24005450100",3318,264,148,7,77,0,99,11,3924
"24005450200",2846,329,170,0,92,9,48,0,3494
"24005450300",2712,209,0,7,321,8,28,0,3285
"24005450400",1816,270,14,0,102,0,167,0,2369
"24005450501",2714,227,241,193,506,50,94,0,4025
"24005450503",1925,266,2164,617,582,53,869,47,6523
"24005450504",1932,167,2450,379,311,52,165,8,5464
"24005450800",2130,428,767,176,140,43,93,235,4012
"24005450900",3357,146,426,49,10,0,0,0,3988
"24005451000",1457,103,34,5,9,0,44,0,1652
"24005451100",974,36,866,341,60,0,39,0,2316
"24005451200",3093,179,258,34,187,32,121,15,3919
"24005451300",2015,439,479,92,133,0,106,164,3428
"24005451401",1221,53,1420,249,672,9,57,0,3681
"24005451402",3455,773,1211,728,87,46,612,470,7382
"24005451500",2422,111,1258,113,231,2,96,26,4259
"24005451600",1749,92,71,0,92,16,0,2,2022
"24005451701",2364,118,93,0,7,0,11,0,2593
"24005451702",1944,31,0,0,8,6,0,0,1989
"24005451801",3775,240,668,136,132,12,72,15,5050
"24005451802",3271,109,85,18,180,0,32,0,3695
"24005451803",3518,198,409,35,80,77,92,21,4430
"24005451900",2228,145,27,0,19,0,0,0,2419
"24005452000",1953,148,116,16,10,0,18,0,2261
"24005452100",2822,509,57,0,18,8,55,0,3469
"24005452300",2234,540,161,65,34,42,226,161,3463
"24005452400",2788,230,218,17,149,13,0,0,3415
"24005452500",2643,405,80,0,345,97,91,63,3724
"24005490100",3606,300,61,3,225,0,120,8,4323
"24005490200",2330,74,72,37,273,1,83,3,2873
"24005490301",3045,1167,344,49,316,209,327,126,5583
"24005490302",1940,128,187,63,216,55,0,0,2589
"24005490400",1359,56,7,5,146,0,27,0,1600
"24005490500",3246,132,0,3,260,0,43,0,3684
"24005490601",1874,52,1,4,134,0,176,0,2241
"24005490602",2361,294,0,15,268,54,269,15,3276
"24005490603",1980,93,17,27,131,5,9,4,2266
"24005490605",67,222,0,20,0,43,0,5,357
"24005490701",1348,54,10,1,20,0,0,0,1433
"24005490703",2318,117,256,33,181,38,66,0,3009
"24005490800",2636,338,100,88,316,55,15,0,3548
"24005490900",2706,510,499,166,412,119,342,8,4762
"24005491000",1974,0,88,0,130,0,74,0,2266
"24005491100",2693,158,754,81,304,0,193,20,4203
"24005491201",1252,144,174,26,188,0,43,0,1827
"24005491202",1408,18,158,14,92,29,11,0,1730
"24005491300",1357,217,536,520,496,91,95,87,3399
"24005491401",610,31,4118,708,53,0,57,0,5577
"24005491402",1007,165,1453,342,169,26,162,0,3324
"24005491500",2011,261,610,160,137,329,108,276,3892
"24005491600",1546,78,597,60,246,14,29,0,2570
"24005491701",3135,161,445,55,121,33,519,0,4469
"24005491900",1617,60,51,27,140,0,119,0,2014
"24005492001",1122,20,203,0,68,0,53,2,1468
"24005492002",2771,165,584,40,214,27,249,27,4077
"24005492101",2529,188,348,28,163,11,220,1,3488
"24005492102",1827,126,197,5,138,0,7,0,2300
"24005492200",3384,98,537,212,97,49,54,68,4499
"24005492300",3026,393,505,47,88,0,314,0,4373
"24005492401",389,50,3386,146,243,0,22,36,4272
"24005492402",2246,16,3182,238,828,0,284,42,6836
"24005492500",35,77,8,9,0,23,0,0,152
"24005492600",2150,118,653,156,197,153,102,0,3529
"24005980000",0,0,0,0,0,0,0,0,0
"24005980100",0,0,0,0,0,0,0,0,0
"24005980200",0,0,0,0,0,0,0,0,0
"24009860101",2398,186,418,10,329,0,0,0,3341
"24009860102",2293,39,216,0,131,0,110,10,2799
"24009860200",5200,78,894,62,125,8,136,10,6513
"24009860300",3294,34,428,18,179,23,0,0,3976
"24009860401",7755,538,607,61,553,169,434,0,10117
"24009860402",2734,227,216,0,128,0,12,0,3317
"24009860501",4810,69,662,9,319,0,129,0,5998
"24009860502",2724,192,223,8,129,0,164,0,3440
"24009860600",5845,160,1011,68,452,0,191,0,7727
"24009860701",1878,146,239,9,205,1,114,0,2592
"24009860702",1689,209,810,282,181,21,40,128,3360
"24009860703",2257,30,1136,104,152,26,57,0,3762
"24009860801",5041,108,930,63,179,0,139,0,6460
"24009860802",4016,225,478,79,108,0,233,0,5139
"24009860900",4904,181,1025,240,138,3,266,3,6760
"24009861001",1218,31,36,0,3,0,118,0,1406
"24009861003",5031,124,804,4,331,6,150,0,6450
"24009861004",5950,432,826,14,499,21,170,32,7944
"24009990100",0,0,0,0,0,0,0,0,0
"24011955000",1852,801,92,2,513,81,584,470,4395
"24011955100",4871,378,355,40,67,14,25,23,5773
"24011955201",2761,249,470,218,190,27,146,27,4088
"24011955202",1801,103,278,50,68,63,15,6,2384
"24011955301",3130,161,105,1,29,0,123,16,3565
"24011955302",1599,237,499,179,270,39,246,39,3108
"24011955400",1698,181,255,60,43,1,10,0,2248
"24011955500",3042,429,478,53,84,91,19,33,4229
"24011955600",2245,577,714,539,117,71,1,0,4264
"24013501001",3756,247,247,0,264,0,54,0,4568
"24013501002",4019,438,113,60,47,139,83,0,4899
"24013502000",3901,124,59,0,122,0,41,0,4247
"24013503000",4873,342,103,0,68,0,9,0,5395
"24013504100",4875,253,112,0,213,0,174,0,5627
"24013504201",5425,278,87,0,468,0,162,0,6420
"24013504202",5587,122,124,16,63,0,247,0,6159
"24013505101",3874,10,335,0,185,0,60,0,4464
"24013505102",5048,127,21,9,409,7,23,0,5644
"24013505203",2589,41,71,13,139,7,146,0,3006
"24013505205",2963,0,55,0,121,0,157,0,3296
"24013505206",3204,134,12,0,161,0,132,0,3643
"24013505207",3218,115,56,0,273,29,91,0,3782
"24013505208",5070,189,124,44,232,41,144,20,5864
"24013506101",4012,38,247,0,280,28,130,0,4735
"24013506102",3658,37,36,15,43,1,78,2,3870
"24013506200",4500,136,99,2,121,0,0,0,4858
"24013507500",2724,141,140,255,150,0,107,111,3628
"24013507601",3877,653,85,68,234,56,272,176,5421
"24013507602",3362,211,73,74,117,0,24,2,3863
"24013507702",3072,290,368,8,77,22,172,7,4016
"24013507703",2719,51,0,8,0,0,14,0,2792
"24013507704",5089,388,279,26,26,176,215,34,6233
"24013507801",4275,699,184,97,142,70,326,65,5858
"24013507802",4065,204,17,13,83,84,18,0,4484
"24013508101",3915,154,181,0,91,0,30,0,4371
"24013508102",2792,185,43,13,103,0,71,20,3227
"24013508200",6461,344,26,0,235,0,242,0,7308
"24013509001",4096,48,0,0,40,0,52,9,4245
"24013509002",2456,313,0,0,7,0,33,0,2809
"24013510000",1009,172,0,0,15,0,6,0,1202
"24013511000",3316,101,84,0,112,6,44,0,3663
"24013512000",1287,63,120,4,28,18,9,20,1549
"24013513001",4063,382,57,0,143,0,56,45,4746
"24013513002",4625,133,126,0,324,34,124,65,5431
"24013514100",3320,138,33,2,234,1,170,0,3898
"24013514201",4749,168,32,6,125,0,73,0,5153
"24013514202",3070,167,129,0,155,0,82,0,3603
"24015030100",4247,811,100,7,153,38,44,12,5412
"24015030200",4302,286,175,17,37,0,169,0,4986
"24015030400",2663,988,514,300,76,13,38,156,4748
"24015030501",3557,97,128,0,37,22,55,0,3896
"24015030503",4148,317,277,0,338,55,172,18,5325
"24015030505",2838,31,400,129,166,0,284,0,3848
"24015030506",5691,766,504,128,685,61,328,0,8163
"24015030601",3583,146,23,0,47,8,288,8,4103
"24015030602",3884,113,889,80,211,0,72,75,5324
"24015030700",4684,245,52,0,189,35,59,0,5264
"24015030903",3730,424,559,0,129,0,54,0,4896
"24015030904",6028,250,133,0,167,0,20,21,6619
"24015030905",2416,610,22,5,46,9,38,0,3146
"24015030906",6752,1294,727,22,171,15,198,55,9234
"24015031201",5721,691,364,34,97,19,387,1,7314
"24015031202",3382,819,434,76,616,61,367,350,6105
"24015031301",3373,269,54,48,86,0,91,36,3957
"24015031302",6347,505,0,0,142,18,141,49,7202
"24015031400",3291,542,50,0,74,0,0,0,3957
"24017850101",1977,87,3289,242,367,24,121,0,6107
"24017850102",1296,134,1012,77,158,97,104,17,2895
"24017850201",609,0,98,0,89,0,86,0,882
"24017850202",2218,103,1917,155,387,52,71,0,4903
"24017850300",1352,16,587,155,94,0,0,0,2204
"24017850400",2027,250,1096,52,64,21,10,0,3520
"24017850500",2210,49,313,35,72,0,4,0,2683
"24017850600",2344,68,1369,38,444,0,40,0,4303
"24017850706",1688,76,2893,0,233,476,158,23,5547
"24017850708",1438,56,2943,22,401,25,56,0,4941
"24017850709",1549,58,4795,419,321,55,433,34,7664
"24017850710",1692,62,2945,299,481,0,338,0,5817
"24017850711",1080,100,2713,301,773,23,286,7,5283
"24017850712",2558,64,2556,74,296,10,152,0,5710
"24017850713",3005,192,2764,151,894,8,661,46,7721
"24017850801",2617,106,1745,27,314,1,79,0,4889
"24017850802",2028,135,1412,58,351,0,256,61,4301
"24017850901",1828,248,2319,754,796,0,217,52,6214
"24017850902",2505,363,1879,241,658,89,522,271,6528
"24017850904",2356,102,2612,83,639,0,338,0,6130
"24017850905",1705,109,2075,103,398,128,310,18,4846
"24017850906",1341,175,2233,629,254,170,51,35,4888
"24017851001",2118,123,381,4,59,7,49,0,2741
"24017851002",5962,270,1623,542,457,67,450,46,9417
"24017851100",2277,40,166,34,109,0,107,9,2742
"24017851200",3203,314,728,113,109,0,92,0,4559
"24017851301",4089,52,332,0,172,0,280,0,4925
"24017851302",3050,202,561,18,210,0,20,0,4061
"24017851400",5839,296,2014,240,442,43,239,84,9197
"24017851500",2351,65,4303,135,911,81,410,7,8263
"24017990000",0,0,0,0,0,0,0,0,0
"24019970100",2114,164,457,90,58,0,26,0,2909
"24019970200",2848,319,1051,370,158,132,44,93,5015
"24019970300",4038,272,369,60,163,0,153,35,5090
"24019970400",1915,289,298,193,265,20,257,9,3246
"24019970500",722,148,1370,1652,157,0,146,29,4224
"24019970600",1679,332,1853,625,191,95,139,24,4938
"24019970702",3351,221,149,39,113,4,37,28,3942
"24019970804",1680,103,85,15,38,16,86,52,2075
"24019970900",1467,128,147,8,71,6,54,0,1881
"24019990000",0,0,0,0,0,0,0,0,0
"24021740200",4367,72,97,71,183,42,161,23,5016
"24021750100",900,166,185,0,50,17,12,27,1357
"24021750200",1215,84,38,23,100,0,59,0,1519
"24021750300",822,212,301,184,40,33,150,46,1788
"24021750503",2586,513,1086,228,1415,2,1666,31,7527
"24021750504",2547,122,1135,432,1476,105,1160,29,7006
"24021750505",2966,783,707,127,1598,600,1718,1038,9537
"24021750506",2415,161,771,0,607,17,492,0,4463
"24021750600",1832,47,44,14,94,0,80,17,2128
"24021750701",3468,96,1129,184,536,4,555,31,6003
"24021750702",1993,168,479,155,350,31,387,33,3596
"24021750801",2024,269,294,94,73,63,53,74,2944
"24021750802",2969,94,356,130,240,16,227,0,4032
"24021750803",4619,157,828,0,508,0,775,27,6914
"24021751001",460,0,432,7,201,0,56,7,1163
"24021751002",3564,43,521,156,415,43,407,43,5192
"24021751003",3429,195,581,330,697,139,314,53,5738
"24021751004",3010,19,881,6,134,9,317,0,4376
"24021751201",3447,62,609,47,522,77,242,62,5068
"24021751202",3926,232,672,190,855,73,406,7,6361
"24021751203",1516,56,73,0,20,78,14,0,1757
"24021751301",2594,100,31,0,83,0,81,0,2889
"24021751302",2492,134,27,0,99,0,232,0,2984
"24021751600",2565,135,36,0,92,0,154,0,2982
"24021751701",2447,25,36,0,26,0,138,10,2682
"24021751702",3278,249,41,10,194,30,112,0,3914
"24021751801",3553,150,243,3,341,0,433,65,4788
"24021751802",3654,77,52,0,115,0,57,0,3955
"24021751901",4068,40,190,0,200,47,195,37,4777
"24021751902",5003,315,68,0,377,79,426,0,6268
"24021751903",5830,0,147,1,246,6,100,0,6330
"24021751904",2953,36,186,0,157,5,103,0,3440
"24021752001",4267,46,160,0,248,0,61,0,4782
"24021752101",3114,29,0,0,158,0,65,16,3382
"24021752102",4238,17,69,0,93,0,264,0,4681
"24021752201",2084,36,119,12,111,0,145,1,2508
"24021752202",2843,60,232,0,770,0,287,0,4192
"24021752204",3994,76,315,12,1666,72,391,0,6526
"24021752301",2512,205,662,154,800,63,396,72,4864
"24021752302",3675,112,97,9,133,0,208,7,4241
"24021752303",2200,50,214,0,252,0,55,3,2774
"24021752501",4512,219,30,20,132,12,86,0,5011
"24021752502",2332,18,72,3,28,0,5,6,2464
"24021752601",3459,32,14,14,279,0,27,0,3825
"24021752602",2539,29,0,23,23,12,108,0,2734
"24021752603",3958,2,40,0,77,0,235,0,4312
"24021752801",2101,101,0,0,0,0,19,0,2221
"24021752802",3133,179,27,0,89,0,128,0,3556
"24021752900",2555,349,13,8,43,4,0,4,2976
"24021753001",4521,225,78,0,121,36,110,46,5137
"24021753002",2723,164,9,9,62,0,39,0,3006
"24021765100",2344,135,852,243,332,220,199,1,4326
"24021766800",3563,326,93,40,52,8,22,0,4104
"24021767500",2432,213,0,0,239,0,31,0,2915
"24021767600",3181,190,15,4,209,0,372,0,3971
"24021770700",3075,153,0,0,76,10,66,0,3380
"24021772200",1288,78,251,236,25,129,178,31,2216
"24021773500",3435,141,261,171,472,28,248,0,4756
"24021775302",3274,238,352,0,151,0,350,24,4389
"24021775400",3176,443,62,0,59,0,62,0,3802
"24021775600",3287,126,54,0,459,0,295,0,4221
"24023000100",3162,671,0,0,27,5,41,5,3911
"24023000200",3527,525,0,0,1,2,17,16,4088
"24023000300",2485,185,0,8,90,12,28,1,2809
"24023000400",2660,321,0,0,52,55,25,25,3138
"24023000500",3280,403,7,0,48,8,0,0,3746
"24023000600",5317,548,0,6,106,15,27,0,6019
"24023000700",4333,1291,10,0,56,11,19,2,5722
"24025301102",2686,289,299,33,183,74,70,0,3634
"24025301105",3771,63,160,37,90,47,176,0,4344
"24025301106",3833,155,40,9,190,16,109,19,4371
"24025301107",2040,235,469,1,163,0,74,0,2982
"24025301108",2521,48,584,61,253,0,33,0,3500
"24025301201",1952,115,55,0,16,0,27,0,2165
"24025301202",5196,359,313,0,1117,7,103,0,7095
"24025301204",3340,66,453,101,237,0,99,0,4296
"24025301205",3027,201,314,0,279,0,300,0,4121
"24025301301",3112,284,926,11,440,36,218,24,5051
"24025301302",2082,493,2432,1401,822,61,192,44,7527
"24025301401",5608,532,733,189,352,0,393,189,7996
"24025301402",1801,46,275,0,96,84,123,0,2425
"24025301601",2978,485,2562,312,432,82,763,128,7742
"24025301602",3763,463,2716,368,543,0,338,0,8191
"24025301702",4694,421,2794,233,502,141,500,244,9529
"24025301703",2934,248,1238,1,370,1,152,46,4990
"24025301704",2244,347,551,107,460,0,175,0,3884
"24025302100",2035,243,31,11,4,0,14,12,2350
"24025302200",2079,167,202,1,74,0,0,0,2523
"24025302400",1714,454,274,116,55,15,0,35,2663
"24025302801",2691,151,529,75,169,0,84,0,3699
"24025302802",2827,222,1230,191,279,102,242,33,5126
"24025302901",893,543,487,307,211,122,155,114,2832
"24025302902",2136,292,1609,110,505,122,255,37,5066
"24025303101",5330,203,247,71,208,0,332,0,6391
"24025303102",2750,10,53,11,180,0,167,0,3171
"24025303201",4968,139,302,1,151,18,68,0,5647
"24025303203",3019,37,59,0,111,0,99,0,3325
"24025303204",4063,94,57,0,433,35,136,0,4818
"24025303205",1472,19,0,0,11,0,49,0,1551
"24025303206",3077,24,48,85,0,0,0,0,3234
"24025303300",5558,51,0,0,83,21,68,0,5781
"24025303400",4108,103,81,13,41,0,124,0,4470
"24025303501",5080,238,207,12,372,12,93,0,6014
"24025303502",3291,53,105,2,230,17,48,0,3746
"24025303602",3237,113,24,0,270,12,34,0,3690
"24025303603",5850,302,242,0,434,0,215,0,7043
"24025303605",4492,376,480,0,326,149,173,198,6194
"24025303606",3282,10,82,0,183,0,298,0,3855
"24025303700",3801,110,22,2,148,0,65,0,4148
"24025303801",2126,295,87,0,0,0,0,0,2508
"24025303802",1189,193,26,0,78,0,21,0,1507
"24025303803",4454,202,73,17,276,0,118,24,5164
"24025303900",2014,67,86,0,134,0,13,16,2330
"24025304101",4127,129,27,0,8,0,69,0,4360
"24025304102",3188,86,90,2,32,1,0,1,3400
"24025304201",5920,184,19,1,202,0,124,2,6452
"24025304202",6222,258,244,233,120,0,99,0,7176
"24025305100",6612,210,139,5,92,0,4,0,7062
"24025305200",2105,381,49,0,70,0,0,16,2621
"24025305300",2038,81,22,0,109,0,99,0,2349
"24025306100",2063,572,538,337,204,145,146,119,4124
"24025306200",1588,216,191,119,96,42,15,101,2368
"24025306300",1599,129,205,0,211,30,69,0,2243
"24025306400",5143,63,1023,0,219,7,164,0,6619
"24025306500",776,97,564,18,477,18,146,0,2096
"24027601103",3325,63,1110,2,1306,97,163,0,6066
"24027601104",4306,39,757,0,1102,0,208,0,6412
"24027601105",2740,2,299,38,970,0,107,0,4156
"24027601107",1812,344,392,87,2080,90,905,14,5724
"24027601108",2430,27,553,40,671,49,154,0,3924
"24027601201",5515,195,1521,38,684,19,343,1,8316
"24027601203",849,14,1087,96,508,162,94,162,2972
"24027601204",3384,147,637,12,912,149,427,0,5668
"24027602100",5707,49,461,1,1567,56,211,0,8052
"24027602201",2372,33,118,0,818,0,81,18,3440
"24027602202",3775,30,208,43,986,33,190,13,5278
"24027602302",3743,56,927,513,1218,16,345,16,6834
"24027602303",2272,21,188,0,1333,7,117,0,3938
"24027602304",3395,53,417,11,999,0,118,0,4993
"24027602305",2862,9,203,0,679,0,80,0,3833
"24027602306",3387,138,702,17,1073,77,137,0,5531
"24027602600",2833,105,851,175,2647,291,839,0,7741
"24027602700",3862,44,443,4,701,44,250,45,5393
"24027602800",3370,155,423,13,1874,402,201,46,6484
"24027602900",1870,70,643,26,1453,227,116,7,4412
"24027603001",3811,18,203,1,1376,1,24,0,5434
"24027603003",3243,48,95,6,490,0,83,11,3976
"24027603004",5341,141,260,2,1073,133,155,2,7107
"24027604001",5709,0,45,8,271,3,256,3,6295
"24027604002",6740,96,227,2,762,44,254,51,8176
"24027605102",5702,251,523,64,1934,52,467,19,9012
"24027605103",4407,129,102,5,616,1,231,1,5492
"24027605104",3707,57,124,14,1031,0,57,11,5001
"24027605401",2958,204,1144,141,526,70,350,164,5557
"24027605402",3490,178,1721,288,1240,90,635,32,7674
"24027605502",3007,160,1151,120,914,114,179,0,5645
"24027605503",2478,514,2281,351,722,45,306,442,7139
"24027605504",1646,0,227,0,894,0,107,0,2874
"24027605505",3475,128,569,0,1767,47,86,0,6072
"24027605601",3587,103,1477,361,1006,5,258,0,6797
"24027605602",4078,100,1458,27,1246,68,619,0,7596
"24027606601",1812,4,693,12,457,0,271,0,3249
"24027606603",3345,112,2404,523,1293,191,754,201,8823
"24027606604",2339,27,1393,35,487,0,294,0,4575
"24027606606",1692,125,1717,134,751,79,202,17,4717
"24027606607",2460,13,1035,48,1075,86,653,86,5456
"24027606701",2326,8,153,2,321,0,63,0,2873
"24027606704",3127,348,2069,202,1695,285,623,232,8581
"24027606705",1315,248,375,9,307,0,155,177,2586
"24027606706",2435,20,1116,0,1254,111,240,0,5176
"24027606707",1742,26,1143,458,585,43,246,0,4243
"24027606803",3393,148,1522,99,567,20,329,54,6132
"24027606804",2289,20,579,22,474,0,101,0,3485
"24027606805",2741,74,318,32,1012,8,187,2,4374
"24027606806",4136,118,774,14,1546,21,224,0,6833
"24027606901",2504,88,1714,93,1223,0,500,0,6122
"24027606904",1449,151,1618,15,866,228,152,313,4792
"24027606905",3203,57,1502,175,1436,39,500,20,6932
"24027606906",3051,104,1609,46,981,10,234,10,6045
"24027606907",1710,15,2224,20,828,15,280,0,5092
"24029950100",3421,236,290,2,74,36,373,91,4523
"24029950200",3564,434,712,33,106,73,33,73,5028
"24029950300",2346,597,540,593,112,52,142,94,4476
"24029950400",2047,123,481,60,57,69,3,0,2840
"24029950500",2256,103,174,45,23,0,40,0,2641
"24029990000",0,0,0,0,0,0,0,0,0
"24031700101",3248,104,339,0,786,0,485,0,4962
"24031700103",4103,36,400,141,1062,13,396,0,6151
"24031700104",2686,70,1294,0,1202,177,1060,189,6678
"24031700105",3284,68,1644,0,1676,0,1009,35,7716
"24031700204",1789,70,13,0,174,0,194,0,2240
"24031700205",4968,38,522,0,1114,107,608,12,7369
"24031700206",4672,40,232,87,577,0,442,0,6050
"24031700207",3767,285,534,245,403,252,643,177,6306
"24031700208",1805,0,11,1,108,12,87,0,2024
"24031700304",3020,51,1410,562,2684,39,954,58,8778
"24031700306",3584,12,955,82,2237,98,1155,0,8123
"24031700308",3072,99,1081,178,1067,140,913,20,6570
"24031700309",2598,124,1373,379,887,122,867,188,6538
"24031700310",3346,51,1267,90,1072,36,867,36,6765
"24031700311",3552,32,1096,0,3176,62,971,0,8889
"24031700312",2909,72,652,0,1634,69,375,0,5711
"24031700400",1819,111,96,1,139,13,50,0,2229
"24031700500",5120,88,611,27,391,19,498,0,6754
"24031700604",5207,134,272,0,1347,54,253,0,7267
"24031700606",2835,28,17,2,1616,1,164,10,4673
"24031700607",2955,59,271,135,4271,45,147,26,7909
"24031700608",3329,237,281,7,1948,26,359,51,6238
"24031700610",1445,55,146,17,386,14,206,21,2290
"24031700611",2290,70,594,0,3627,63,834,26,7504
"24031700613",2712,128,617,203,2496,38,440,0,6634
"24031700614",2447,223,942,76,1276,20,875,84,5943
"24031700615",2375,13,125,0,364,0,128,0,3005
"24031700616",2722,70,477,0,1174,9,141,0,4593
"24031700704",1355,119,139,31,1111,114,826,74,3769
"24031700706",1319,137,856,60,1396,87,1093,41,4989
"24031700710",3173,125,822,96,1834,151,1780,150,8131
"24031700711",3171,108,519,198,1572,257,988,23,6836
"24031700713",2056,87,1224,129,1773,326,1980,249,7824
"24031700715",2237,135,1439,160,2272,0,1812,0,8055
"24031700716",3543,90,993,104,2789,127,1511,63,9220
"24031700717",2842,135,941,36,1558,232,2008,119,7871
"24031700718",2560,110,429,37,1046,63,207,19,4471
"24031700719",1891,397,1749,337,3032,1453,2263,1591,12713
"24031700720",1892,8,372,50,1344,9,1355,0,5030
"24031700721",1334,30,682,69,383,30,573,0,3101
"24031700722",1914,54,775,157,1095,80,795,0,4870
"24031700723",1888,440,452,79,343,62,111,275,3650
"24031700724",642,383,838,48,795,532,868,258,4364
"24031700810",2336,394,1437,91,812,74,551,342,6037
"24031700811",2324,155,1002,63,1423,30,1762,81,6840
"24031700812",2626,89,345,111,912,60,1151,35,5329
"24031700813",2989,323,1057,326,1291,325,1464,430,8205
"24031700815",4016,174,1446,219,1930,337,2455,196,10773
"24031700816",3332,171,1013,306,3153,123,2316,18,10432
"24031700817",2406,262,641,48,1723,65,303,0,5448
"24031700818",2420,142,1905,407,1598,154,1698,163,8487
"24031700819",4013,47,1438,99,1248,121,1524,133,8623
"24031700820",1255,188,730,195,467,75,698,114,3722
"24031700822",602,131,147,50,550,298,305,365,2448
"24031700823",2005,106,135,23,1044,0,484,44,3841
"24031700824",2175,97,344,0,384,0,189,51,3240
"24031700826",4353,80,359,0,929,0,419,0,6140
"24031700828",1764,14,33,0,539,50,149,0,2549
"24031700829",1880,93,125,0,905,24,423,0,3450
"24031700830",823,73,822,24,864,88,809,48,3551
"24031700832",986,58,650,18,1126,133,1088,14,4073
"24031700833",1636,222,784,31,1449,313,1105,9,5549
"24031700834",2112,136,1140,198,1361,39,1143,82,6211
"24031700835",2111,111,790,1,1619,0,526,13,5171
"24031700901",1928,173,562,0,989,364,336,47,4399
"24031700902",2076,46,649,167,882,28,1143,2,4993
"24031700903",741,61,285,173,598,45,362,49,2314
"24031700904",971,36,185,20,1433,107,566,35,3353
"24031700905",2180,61,184,0,1587,22,173,0,4207
"24031701001",3457,324,500,24,1332,36,561,105,6339
"24031701002",2772,27,48,0,773,13,229,0,3862
"24031701004",3521,117,318,101,967,157,350,26,5557
"24031701005",2597,42,122,82,711,0,450,12,4016
"24031701006",3399,163,94,1,1440,0,393,37,5527
"24031701007",1792,21,479,12,847,7,77,2,3237
"24031701101",2925,96,155,140,991,145,992,181,5625
"24031701102",3792,325,357,91,1527,43,1677,198,8010
"24031701201",3641,292,336,1,1234,0,1228,127,6859
"24031701202",2399,84,71,10,137,8,365,0,3074
"24031701205",5411,126,71,64,914,25,299,0,6910
"24031701206",4860,111,218,0,1440,42,844,38,7553
"24031701210",3309,12,36,0,653,18,228,12,4268
"24031701211",3334,180,638,164,1818,54,559,4,6751
"24031701212",1781,2,398,1,514,1,208,0,2905
"24031701213",4680,193,244,37,929,0,511,69,6663
"24031701214",2014,267,137,14,583,0,324,33,3372
"24031701215",3189,92,295,16,654,0,427,0,4673
"24031701216",2491,133,304,31,1367,50,294,0,4670
"24031701218",1356,72,173,17,675,45,518,0,2856
"24031701219",1153,110,307,117,1438,293,805,232,4455
"24031701220",2339,41,315,27,1278,212,219,29,4460
"24031701221",2272,157,337,0,1486,87,67,39,4445
"24031701303",2845,78,429,0,450,0,117,15,3934
"24031701304",4119,53,719,0,864,79,565,0,6399
"24031701306",2685,32,61,1,265,0,105,0,3149
"24031701307",2037,9,487,1,1099,271,360,1,4265
"24031701308",2057,46,290,20,576,76,88,0,3153
"24031701312",4555,141,457,100,934,33,279,0,6499
"24031701313",2142,8,766,0,659,115,346,115,4151
"24031701314",1668,51,491,1,687,0,357,1,3256
"24031701315",3308,0,653,67,651,0,574,0,5253
"24031701316",4054,113,898,113,560,152,358,0,6248
"24031701317",3060,9,442,9,723,0,153,0,4396
"24031701407",2838,14,1657,12,1123,60,380,59,6143
"24031701408",4099,61,1194,57,1598,219,486,277,7991
"24031701409",2193,34,842,37,1367,17,419,0,4909
"24031701410",1449,140,3249,133,2007,103,622,50,7753
"24031701414",1792,18,3037,376,1545,234,550,21,7573
"24031701415",2541,2,2277,288,2719,1,1161,1,8990
"24031701417",1596,95,2321,657,804,0,553,0,6026
"24031701418",1131,9,1401,80,936,55,447,0,4059
"24031701420",3318,127,1557,234,1424,141,564,129,7494
"24031701421",151,47,1339,47,205,0,227,39,2055
"24031701422",204,12,2096,437,200,172,105,85,3311
"24031701423",637,48,1911,379,1553,151,752,42,5473
"24031701503",3044,40,1988,7,1715,20,1315,0,8129
"24031701505",2964,142,2202,555,577,176,1062,239,7917
"24031701506",2329,212,1377,152,1240,34,640,6,5990
"24031701507",2371,85,862,47,1236,100,170,7,4878
"24031701508",183,40,2257,242,722,300,333,283,4360
"24031701509",892,93,2436,289,1311,355,1099,294,6769
"24031701601",127,7,799,87,1128,138,939,31,3256
"24031701602",892,158,1469,184,3480,466,3214,650,10513
"24031701701",2124,55,557,44,320,32,269,43,3444
"24031701702",952,100,621,206,203,96,480,65,2723
"24031701703",1452,51,1302,126,593,1,601,9,4135
"24031701704",1603,2,633,137,363,0,581,0,3319
"24031701800",2318,73,1977,375,356,27,211,11,5348
"24031701900",1302,184,591,35,645,213,906,166,4042
"24031702000",993,168,910,65,2020,1420,2275,1288,9139
"24031702101",840,88,1546,193,2473,497,1974,397,8008
"24031702102",2417,54,70,2,255,11,105,0,2914
"24031702200",2845,124,428,0,1179,21,1157,16,5770
"24031702301",1372,187,961,121,1006,531,1472,646,6296
"24031702302",2163,66,876,31,1125,53,1234,44,5592
"24031702401",1477,73,560,5,417,0,376,0,2908
"24031702402",1964,111,1183,471,603,35,400,27,4794
"24031702500",1899,206,2252,263,997,249,391,0,6257
"24031702601",1890,204,1622,80,539,70,380,52,4837
"24031702602",2097,442,1094,392,602,88,506,59,5280
"24031702700",3207,404,1157,230,1654,123,1045,361,8181
"24031702800",2813,105,1096,91,601,0,487,10,5203
"24031702900",3998,37,749,77,629,1,325,23,5839
"24031703000",1253,25,363,5,247,22,274,0,2189
"24031703100",2780,81,392,0,754,38,1011,24,5080
"24031703201",4018,99,695,121,2249,24,1663,33,8902
"24031703202",4308,186,355,26,1070,22,802,22,6791
"24031703206",1846,92,561,260,1291,30,945,42,5067
"24031703207",1437,135,1022,258,2721,431,2596,479,9079
"24031703208",3581,152,679,7,557,22,380,0,5378
"24031703209",2111,249,1164,2,1474,749,773,677,7199
"24031703210",1685,98,531,65,837,272,579,263,4330
"24031703212",2326,106,2986,200,2634,30,1843,64,10189
"24031703213",1039,328,2087,411,2054,206,2011,435,8571
"24031703214",1143,153,2592,657,1832,637,1720,522,9256
"24031703215",1143,59,592,99,1375,47,1116,0,4431
"24031703216",1855,75,997,20,763,63,714,0,4487
"24031703218",1539,94,114,0,38,11,41,0,1837
"24031703219",2537,211,362,12,142,86,45,21,3416
"24031703220",1869,129,1668,117,806,310,793,51,5743
"24031703221",2011,143,1293,248,1169,110,434,130,5538
"24031703301",2106,137,199,0,2057,183,2033,121,6836
"24031703302",1430,75,572,38,2115,101,2041,91,6463
"24031703401",1712,226,498,164,2424,180,2098,241,7543
"24031703402",1072,17,330,2,1990,69,1671,85,5236
"24031703403",966,209,630,122,1451,348,1408,273,5407
"24031703404",745,60,428,21,1444,191,1599,198,4686
"24031703501",1825,171,1820,500,1971,602,2083,546,9518
"24031703502",1744,261,144,69,678,243,466,409,4014
"24031703601",2427,85,366,183,1452,56,1211,112,5892
"24031703602",2470,10,85,33,477,0,688,0,3763
"24031703701",1181,128,247,11,1981,157,1944,222,5871
"24031703702",1520,34,550,14,2006,12,1655,12,5803
"24031703800",965,86,520,178,1161,188,723,199,4020
"24031703901",1667,69,317,42,889,16,513,40,3553
"24031703902",3026,297,1562,2,1505,597,1425,579,8993
"24031704000",2713,220,1382,204,1957,108,1349,157,8090
"24031704100",4022,67,123,0,251,0,81,0,4544
"24031704200",1489,17,95,12,215,35,81,0,1944
"24031704300",3332,32,70,0,335,0,321,0,4090
"24031704401",2239,201,208,38,429,5,232,135,3487
"24031704403",1127,35,131,9,218,0,140,0,1660
"24031704404",3845,108,238,13,589,1,217,35,5046
"24031704501",2648,112,66,0,497,34,351,67,3775
"24031704502",2154,17,14,0,375,0,70,0,2630
"24031704503",3502,24,37,18,445,11,478,11,4526
"24031704600",4320,93,54,32,678,56,330,0,5563
"24031704700",3649,7,56,2,347,55,232,0,4348
"24031704803",2370,136,126,9,745,126,502,13,4027
"24031704804",1173,57,62,0,379,0,82,16,1769
"24031704805",1102,104,72,61,287,52,45,24,1747
"24031704806",2356,69,138,2,602,35,187,16,3405
"24031705000",3227,182,173,17,283,17,313,5,4217
"24031705100",4465,81,244,2,417,7,299,0,5515
"24031705200",3165,53,21,0,163,5,293,36,3736
"24031705300",1839,34,0,0,79,3,41,10,2006
"24031705400",2608,23,9,10,212,0,137,0,2999
"24031705501",2052,119,21,0,142,171,228,190,2923
"24031705502",3523,118,39,0,228,0,171,47,4126
"24031705601",2303,28,100,0,285,14,247,0,2977
"24031705602",3707,94,133,0,798,17,472,0,5221
"24031705701",3675,105,66,5,359,44,183,6,4443
"24031705702",4210,104,0,0,122,12,327,2,4777
"24031705800",5474,162,130,0,520,0,155,21,6462
"24031705901",3203,18,83,0,533,9,263,9,4118
"24031705902",3550,26,119,11,606,0,245,0,4557
"24031705903",3520,65,0,0,814,9,366,11,4785
"24031706005",3298,168,280,1,925,0,276,32,4980
"24031706007",4997,103,316,0,1634,0,398,0,7448
"24031706008",3961,32,51,0,1175,0,286,0,5505
"24031706009",4431,82,223,5,775,54,300,1,5871
"24031706010",1801,119,422,0,452,18,125,0,2937
"24031706011",3796,189,187,22,1043,6,297,18,5558
"24031706012",1729,181,276,99,787,123,432,14,3641
"24031706013",2321,67,106,0,400,20,400,0,3314
"24033800102",1307,34,862,69,525,174,571,193,3735
"24033800103",960,167,559,67,412,23,478,33,2699
"24033800105",919,38,1753,106,786,0,478,30,4110
"24033800106",679,19,1587,60,423,0,396,0,3164
"24033800108",558,34,2180,122,233,16,215,0,3358
"24033800109",603,35,1460,106,1470,315,1099,287,5375
"24033800203",3321,22,644,3,326,273,493,273,5355
"24033800206",1105,23,2210,190,437,22,206,0,4193
"24033800208",2023,39,3773,67,1333,43,903,39,8220
"24033800209",569,10,2131,370,376,33,440,0,3929
"24033800210",284,0,2289,306,445,33,322,11,3690
"24033800211",536,8,1549,298,259,6,161,0,2817
"24033800212",1024,35,2221,78,633,280,356,61,4688
"24033800213",734,367,2081,101,679,31,418,155,4566
"24033800214",559,16,1410,337,239,0,213,0,2774
"24033800215",284,12,1742,47,461,7,485,7,3045
"24033800401",1745,30,661,1,526,19,513,0,3495
"24033800402",3343,23,1063,58,536,0,216,0,5239
"24033800403",2258,65,1282,143,249,9,210,21,4237
"24033800408",1178,21,4480,397,350,53,469,65,7013
"24033800409",2442,41,3145,112,653,13,575,12,6993
"24033800410",1435,76,2567,22,1213,42,194,25,5574
"24033800411",1109,54,2016,227,426,0,310,0,4142
"24033800412",543,38,1883,316,328,0,170,37,3315
"24033800413",246,1,2884,533,232,0,76,0,3972
"24033800504",3230,34,960,2,697,72,541,72,5608
"24033800505",1638,150,725,26,96,0,51,8,2694
"24033800507",1013,11,1542,51,215,14,255,0,3101
"24033800509",337,0,8013,318,466,79,83,101,9397
"24033800511",1688,8,2999,99,399,0,451,0,5644
"24033800513",2872,78,2159,104,418,8,248,0,5887
"24033800514",775,33,3441,63,606,0,139,0,5057
"24033800515",1243,60,2056,144,579,0,366,27,4475
"24033800516",1207,65,2122,112,119,0,64,0,3689
"24033800517",362,22,4366,109,193,0,57,0,5109
"24033800518",501,0,2490,52,199,0,113,0,3355
"24033800519",968,58,2209,108,353,0,100,56,3852
"24033800520",88,0,1720,46,52,0,6,0,1912
"24033800601",264,18,1561,153,26,0,152,0,2174
"24033800604",84,3,1417,17,13,0,46,0,1580
"24033800605",583,81,3209,0,100,14,84,14,4085
"24033800606",221,0,4526,120,169,0,0,0,5036
"24033800607",750,10,4743,78,705,32,807,25,7150
"24033800608",266,0,3509,68,124,0,77,0,4044
"24033800701",602,37,3949,123,433,12,147,9,5312
"24033800704",645,3,4027,87,195,0,67,0,5024
"24033800705",631,3,3163,272,155,0,24,0,4248
"24033800706",336,10,3146,49,197,0,0,0,3738
"24033800707",397,0,1992,140,181,0,14,0,2724
"24033800800",2034,28,1081,14,114,17,172,12,3472
"24033800900",688,46,841,25,23,1,17,1,1642
"24033801003",1649,66,2799,14,244,22,321,0,5115
"24033801004",998,43,3075,22,253,0,241,0,4632
"24033801005",566,0,3041,81,407,0,68,10,4173
"24033801006",430,99,2819,133,300,1,144,0,3926
"24033801104",2213,212,315,53,552,32,339,15,3731
"24033801207",579,60,3370,73,173,0,118,41,4414
"24033801208",236,1,3143,59,162,0,122,0,3723
"24033801209",262,1,3437,244,478,0,377,0,4799
"24033801210",491,0,3259,275,474,0,270,0,4769
"24033801211",349,94,2253,0,240,16,121,0,3073
"24033801212",294,48,2726,29,255,0,128,0,3480
"24033801213",311,92,2640,99,197,0,48,92,3479
"24033801214",928,59,2300,246,252,0,331,0,4116
"24033801215",181,6,2129,0,154,0,13,6,2489
"24033801216",488,14,2616,25,164,159,145,49,3660
"24033801217",264,2,2952,86,269,1,154,15,3743
"24033801302",1122,25,1181,20,134,0,70,0,2552
"24033801305",376,12,4486,195,767,45,614,45,6540
"24033801307",363,0,2813,39,483,16,55,12,3781
"24033801308",301,16,2702,108,458,84,216,0,3885
"24033801309",885,15,2472,61,388,1,276,0,4098
"24033801310",864,49,4620,41,582,0,220,0,6376
"24033801311",770,145,4886,492,392,1,541,1,7228
"24033801312",386,42,2067,371,496,0,309,0,3671
"24033801313",468,117,2325,39,259,28,58,0,3294
"24033801404",628,18,2980,427,748,0,227,0,5028
"24033801405",963,32,2094,366,1727,155,1738,99,7174
"24033801406",61,0,1895,278,350,0,233,0,2817
"24033801407",370,169,4950,348,303,57,400,0,6597
"24033801408",129,0,2949,189,194,10,70,3,3544
"24033801409",317,0,1885,40,533,56,325,0,3156
"24033801410",496,11,2421,45,518,11,118,4,3624
"24033801411",519,0,1688,139,1102,8,536,0,3992
"24033801500",155,14,2004,177,250,5,51,12,2668
"24033801600",78,6,1784,235,108,26,143,32,2412
"24033801701",127,13,3377,721,41,98,37,98,4512
"24033801702",99,118,3008,443,69,0,50,53,3840
"24033801704",223,0,4500,578,511,16,601,16,6445
"24033801706",103,137,1053,74,108,0,68,137,1680
"24033801707",274,21,4654,395,820,304,988,308,7764
"24033801708",222,53,2875,227,209,0,169,19,3774
"24033801801",22,64,1492,199,166,12,147,64,2166
"24033801802",35,7,3051,171,0,51,0,0,3315
"24033801804",108,17,1664,255,7,0,48,0,2099
"24033801805",14,50,1903,173,51,78,6,0,2275
"24033801807",101,3,3916,371,60,0,143,0,4594
"24033801808",231,8,3085,221,49,0,108,0,3702
"24033801901",712,57,3593,77,382,0,424,0,5245
"24033801904",547,22,2283,20,179,166,427,133,3777
"24033801905",652,16,4386,72,210,1,55,1,5393
"24033801906",498,32,981,146,182,12,202,0,2053
"24033801907",170,58,2703,159,133,10,118,0,3351
"24033801908",106,0,2930,548,38,0,0,0,3622
"24033802001",311,0,4214,871,234,30,549,14,6223
"24033802002",108,3,3070,324,36,31,178,0,3750
"24033802103",490,19,2284,107,207,68,227,19,3421
"24033802104",83,0,1607,176,9,0,46,0,1921
"24033802106",155,0,3337,241,105,0,239,0,4077
"24033802107",60,0,3176,418,49,0,66,0,3769
"24033802201",434,13,1002,88,88,61,16,0,1702
"24033802203",450,18,3251,238,141,0,331,0,4429
"24033802204",79,34,5337,356,199,0,105,13,6123
"24033802301",241,24,3152,124,96,0,76,0,3713
"24033802404",28,14,3363,521,16,58,31,11,4042
"24033802405",101,24,3572,301,60,65,88,65,4276
"24033802406",140,33,1584,267,66,81,60,1,2232
"24033802407",272,23,2868,737,156,0,114,0,4170
"24033802408",206,35,925,91,62,0,159,0,1478
"24033802501",107,0,2472,209,6,0,46,0,2840
"24033802502",232,32,2116,185,51,0,195,21,2832
"24033802600",139,0,2703,255,114,0,140,0,3351
"24033802700",77,11,1645,381,63,15,69,0,2261
"24033802803",178,111,3716,639,26,7,179,110,4966
"24033802804",25,1,4647,540,134,18,97,1,5463
"24033802805",120,89,4187,689,72,10,211,90,5468
"24033802901",314,35,2622,697,68,13,236,48,4033
"24033803001",312,52,2080,322,179,20,315,51,3331
"24033803002",11,15,2560,132,18,0,109,0,2845
"24033803100",232,7,1995,214,19,0,170,0,2637
"24033803200",33,0,2474,284,87,0,114,0,2992
"24033803300",277,12,3125,674,292,60,587,38,5065
"24033803401",185,16,853,168,154,82,302,82,1842
"24033803402",151,0,3652,921,126,10,212,0,5072
"24033803508",299,0,2751,1259,317,57,446,8,5137
"24033803509",133,33,2174,417,153,188,248,216,3562
"24033803512",253,0,5286,353,316,2,103,0,6313
"24033803513",215,37,3582,427,232,44,189,0,4726
"24033803514",135,1,3528,475,139,0,13,0,4291
"24033803516",384,12,3845,189,416,0,332,0,5178
"24033803519",146,0,3537,87,133,5,148,5,4061
"24033803520",471,30,3244,26,89,0,27,0,3887
"24033803521",339,24,3932,86,346,18,66,18,4829
"24033803522",117,1,2749,325,284,0,212,0,3688
"24033803523",119,0,3325,39,304,24,16,0,3827
"24033803524",60,0,3312,130,213,0,191,0,3906
"24033803525",12,0,1668,366,527,48,66,0,2687
"24033803526",205,0,2574,186,107,0,39,0,3111
"24033803527",203,16,2830,138,115,36,144,0,3482
"24033803601",377,2,3179,105,123,0,336,0,4122
"24033803602",113,0,1315,249,176,25,234,25,2137
"24033803605",2133,75,3289,459,868,55,1716,112,8707
"24033803606",1275,73,2607,59,925,154,1223,191,6507
"24033803607",741,7,2209,89,374,0,618,0,4038
"24033803608",1024,275,3225,40,1037,35,1627,300,7563
"24033803610",741,153,1498,111,483,0,836,141,3963
"24033803612",531,0,2056,184,277,16,581,16,3661
"24033803613",581,216,3333,406,408,54,764,166,5928
"24033803700",958,25,909,114,332,30,957,25,3350
"24033803801",1098,17,994,81,365,55,1136,72,3818
"24033803803",1109,38,3067,320,735,102,1410,100,6881
"24033803900",1765,330,1110,16,681,195,2245,507,6849
"24033804001",297,171,3585,613,355,105,624,242,5992
"24033804002",695,13,1564,411,1230,277,1604,286,6080
"24033804101",360,120,2161,272,288,11,250,75,3537
"24033804102",917,327,3438,560,676,8,1137,287,7350
"24033804200",1543,38,1079,10,215,35,377,0,3297
"24033804300",707,54,1904,374,223,26,805,8,4101
"24033804400",864,76,839,229,434,63,892,132,3529
"24033804600",880,321,897,63,696,42,1116,331,4346
"24033804700",1400,44,1348,95,418,162,981,116,4564
"24033804801",193,26,1305,457,170,214,277,71,2713
"24033804802",529,95,1200,337,670,138,1158,206,4333
"24033804900",220,46,2233,452,503,150,492,184,4280
"24033805000",239,107,3108,240,1667,145,1724,210,7440
"24033805101",552,191,965,118,1767,412,2149,581,6735
"24033805201",151,313,1838,208,1370,288,1679,447,6294
"24033805202",532,2,2230,428,392,37,763,37,4421
"24033805500",899,18,858,141,1979,349,2496,336,7076
"24033805601",897,307,287,67,4070,1070,4804,1345,12847
"24033805602",1008,180,222,87,3529,791,4271,919,11007
"24033805700",791,149,1182,134,3265,643,3681,575,10420
"24033805801",417,207,1171,171,2125,496,2374,638,7599
"24033805802",634,204,1087,64,1611,793,2055,940,7388
"24033805904",596,176,555,217,1420,161,1297,94,4516
"24033805906",552,264,742,144,958,196,1142,395,4393
"24033805907",445,65,1747,351,1180,382,1260,382,5812
"24033805908",111,45,1629,129,392,104,271,3,2684
"24033805909",961,97,2003,436,965,150,1037,128,5777
"24033806000",1007,202,1414,265,1980,650,2225,606,8349
"24033806100",1331,90,1428,49,976,55,1011,103,5043
"24033806200",2123,66,1333,147,181,0,837,10,4697
"24033806300",813,99,575,78,356,32,669,105,2727
"24033806400",2562,216,211,53,487,57,265,47,3898
"24033806501",2648,870,1161,224,395,152,2304,829,8583
"24033806601",2342,501,881,75,459,121,2256,654,7289
"24033806602",1732,194,1921,167,279,197,1378,98,5966
"24033806706",813,60,1453,65,729,92,305,60,3577
"24033806708",1839,311,1126,353,566,70,293,0,4558
"24033806710",855,69,3570,249,1086,14,346,0,6189
"24033806711",580,17,2977,234,707,32,551,0,5098
"24033806712",465,9,2468,55,331,0,122,0,3450
"24033806713",804,136,1540,404,448,331,754,278,4695
"24033806714",690,76,1571,291,616,24,1026,180,4474
"24033806800",2242,169,642,49,763,111,842,15,4833
"24033806900",2178,120,576,41,988,59,1127,0,5089
"24033807000",2515,734,566,630,827,485,940,46,6743
"24033807102",1727,222,246,33,225,97,246,10,2806
"24033807200",752,2405,56,74,124,317,42,79,3849
"24033807301",978,272,847,127,716,460,200,82,3682
"24033807304",775,60,425,25,631,12,767,22,2717
"24033807305",833,103,1452,63,1332,122,1244,156,5305
"24033807404",2284,97,1161,94,902,158,1017,79,5792
"24033807405",2997,187,1203,195,898,229,1043,10,6762
"24033807407",1717,53,2112,46,2211,150,1204,131,7624
"24033807408",2642,89,1391,28,1305,0,354,0,5809
"24033807409",574,100,1299,279,1142,501,892,351,5138
"24033807410",746,27,2026,200,794,443,735,415,5386
"24035810100",2304,325,194,68,168,68,161,195,3483
"24035810200",2043,180,35,0,78,14,63,38,2451
"24035810300",3322,396,606,221,40,11,15,24,4635
"24035810400",5389,131,400,75,80,0,27,0,6102
"24035810500",3706,228,183,240,55,30,36,78,4556
"24035810600",3999,357,129,0,197,9,92,54,4837
"24035810700",2710,355,707,94,189,11,88,31,4185
"24035810800",5434,51,47,0,39,0,43,0,5614
"24035810901",4785,143,15,0,51,162,24,176,5356
"24035810902",2884,154,16,0,53,0,37,0,3144
"24035811000",3347,375,225,119,413,36,275,70,4860
"24035990000",0,0,0,0,0,0,0,0,0
"24035990100",0,0,0,0,0,0,0,0,0
"24035990200",0,0,0,0,0,0,0,0,0
"24037875000",5632,249,288,13,259,0,240,0,6681
"24037875100",3766,210,209,64,258,2,118,0,4627
"24037875201",4674,191,219,0,68,1,37,0,5190
"24037875202",5427,46,415,64,130,7,95,0,6184
"24037875300",2265,218,691,121,91,0,86,1,3473
"24037875400",5633,256,626,292,199,10,8,0,7024
"24037875500",6929,196,708,42,607,66,279,31,8858
"24037875600",6976,290,857,97,572,0,59,0,8851
"24037875700",6122,279,303,30,462,0,174,0,7370
"24037875801",744,9,79,52,102,4,103,4,1097
"24037875802",3525,67,128,0,195,0,181,0,4096
"24037875901",3770,327,962,580,1239,54,494,0,7426
"24037875902",3974,601,1898,622,986,103,609,261,9054
"24037876001",2419,113,1433,864,308,51,350,12,5550
"24037876002",4966,278,1819,340,850,26,578,125,8982
"24037876100",6321,372,462,115,134,9,248,55,7716
"24037876200",5516,93,138,119,284,1,79,0,6230
"24037990000",0,0,0,0,0,0,0,0,0
"24039930101",1525,441,1809,937,0,66,52,78,4908
"24039930102",2094,251,633,226,439,77,297,62,4079
"24039930200",1108,262,104,98,5,22,0,0,1599
"24039930300",1782,214,337,30,53,0,37,0,2453
"24039930500",2582,412,557,112,63,81,50,0,3857
"24039930600",1319,659,329,543,53,76,0,39,3018
"24039980400",11,15,9,3,0,10,3,10,61
"24039990100",0,0,0,0,0,0,0,0,0
"24041960100",3510,402,419,34,24,0,73,0,4462
"24041960201",3518,60,317,110,128,13,37,4,4187
"24041960300",1966,338,888,122,82,41,214,193,3844
"24041960400",3378,302,881,111,234,49,1009,9,5973
"24041960501",3690,282,223,0,395,41,238,11,4880
"24041960502",3207,191,556,109,117,57,159,0,4396
"24041960600",1334,104,284,23,49,14,11,0,1819
"24041960700",3023,190,240,46,49,18,22,0,3588
"24041960800",1803,81,105,0,20,15,0,0,2024
"24041960900",3153,372,487,96,92,0,59,44,4303
"24041990000",0,0,0,0,0,0,0,0,0
"24043000100",2732,188,137,26,257,0,31,0,3371
"24043000200",2749,203,211,76,230,0,48,0,3517
"24043000301",2212,349,173,37,195,6,82,11,3065
"24043000302",1467,689,514,360,66,313,29,7,3445
"24043000400",454,363,531,506,65,51,36,25,2031
"24043000500",2701,662,982,392,487,395,419,119,6157
"24043000601",1392,169,559,92,209,72,137,60,2690
"24043000602",2465,165,243,75,21,18,12,34,3033
"24043000700",1466,750,204,144,146,93,0,75,2878
"24043000800",2456,472,318,232,99,19,207,5,3808
"24043000900",1730,830,290,296,69,107,13,173,3508
"24043001001",3018,762,434,326,435,43,188,108,5314
"24043001002",3408,397,88,60,94,6,172,30,4255
"24043010100",1117,34,0,1,0,36,40,0,1228
"24043010200",4176,443,0,1,49,6,0,68,4743
"24043010300",6139,408,644,15,297,0,201,0,7704
"24043010400",6084,505,488,0,513,27,288,0,7905
"24043010500",5392,248,106,64,131,28,36,0,6005
"24043010600",4623,237,81,0,117,28,100,3,5189
"24043010700",3120,378,31,9,42,18,12,3,3613
"24043010801",4129,162,83,8,95,0,45,0,4522
"24043010802",1883,355,12,0,91,23,7,0,2371
"24043010900",7572,105,197,144,189,32,447,24,8710
"24043011000",0,0,0,0,0,0,0,0,0
"24043011100",4610,991,160,205,118,0,198,232,6514
"24043011201",6333,713,763,123,733,66,206,0,8937
"24043011202",3388,559,169,66,254,25,235,212,4908
"24043011301",4484,237,79,58,200,0,254,0,5312
"24043011302",3557,124,44,28,165,0,90,0,4008
"24043011400",4780,301,68,5,152,2,163,0,5471
"24043011500",7061,637,96,38,200,0,71,30,8133
"24043011600",2649,191,11,11,115,5,21,4,3007
"24045000100",2227,724,1891,813,190,190,546,531,7112
"24045000200",1223,215,611,136,70,14,89,0,2358
"24045000300",53,35,698,602,92,22,109,23,1634
"24045000400",2291,733,625,349,161,89,177,0,4425
"24045000500",1011,181,740,269,110,183,87,0,2581
"24045010101",4027,440,841,125,203,54,67,0,5757
"24045010102",2063,235,394,25,78,15,67,7,2884
"24045010200",743,270,3722,1089,386,126,443,292,7071
"24045010300",5188,182,996,200,1292,394,375,271,8898
"24045010400",3680,662,610,51,97,32,159,0,5291
"24045010501",2714,219,641,399,577,117,228,0,4895
"24045010502",3515,1811,1152,759,580,188,132,52,8189
"24045010603",4842,504,1087,240,457,53,207,0,7390
"24045010604",3871,669,266,10,320,3,237,0,5376
"24045010605",3606,172,451,0,123,0,82,0,4434
"24045010606",3440,446,93,1,71,0,54,21,4126
"24045010701",2716,265,695,91,93,64,46,0,3970
"24045010702",5287,712,1239,500,407,7,195,28,8375
"24045010800",4240,453,686,113,72,0,39,0,5603
"24047950000",1714,67,6,14,11,0,0,5,1817
"24047950100",2086,255,28,10,12,0,194,0,2585
"24047950300",2666,88,0,0,23,111,0,150,3038
"24047950400",2274,446,41,87,140,0,106,330,3424
"24047950600",2714,148,22,0,17,0,170,0,3071
"24047950700",1880,106,0,0,104,0,39,0,2129
"24047950800",4335,443,705,126,69,0,104,0,5782
"24047950900",1125,186,304,21,109,0,55,0,1800
"24047951000",2150,147,1203,306,151,19,250,80,4306
"24047951100",5351,170,147,0,40,6,56,0,5770
"24047951200",2854,282,229,68,0,0,7,0,3440
"24047951300",1386,327,829,184,38,0,16,0,2780
"24047951400",2780,215,312,184,110,0,33,0,3634
"24047951500",2043,496,1661,559,374,72,4,0,5209
"24047951700",2997,370,112,37,22,0,0,4,3542
"24047980000",0,0,0,0,0,0,0,0,0
"24047990000",0,0,0,0,0,0,0,0,0
"24510010100",2566,374,34,11,43,0,81,39,3148
"24510010200",2724,212,528,225,138,63,676,98,4664
"24510010300",2048,124,8,0,169,10,109,0,2468
"24510010400",1868,111,22,2,180,1,77,1,2262
"24510010500",1653,117,81,33,15,10,119,5,2033
"24510020100",1487,281,56,85,173,64,183,214,2543
"24510020200",1222,335,263,10,273,30,625,157,2915
"24510020300",2509,306,14,0,361,351,304,167,4012
"24510030100",328,194,680,1322,64,105,66,230,2989
"24510030200",1086,118,488,358,305,7,83,16,2461
"24510040100",1550,604,482,69,466,254,161,40,3626
"24510040200",130,184,70,107,47,113,7,4,662
"24510060100",1041,237,794,612,229,16,407,142,3478
"24510060200",1155,153,888,799,243,199,377,270,4084
"24510060300",725,117,486,394,24,22,48,56,1872
"24510060400",195,89,519,365,165,38,0,15,1386
"24510070100",223,2,1940,953,107,0,192,0,3417
"24510070200",14,29,2073,1315,240,0,192,0,3863
"24510070300",31,2,400,530,30,0,0,0,993
"24510070400",4,3,513,440,0,10,0,0,970
"24510080101",864,0,2185,440,166,0,76,0,3731
"24510080102",53,16,1841,391,30,0,0,2,2333
"24510080200",0,0,985,274,25,0,0,0,1284
"24510080301",16,15,1129,490,30,5,9,0,1694
"24510080302",0,40,1875,766,47,0,12,15,2755
"24510080400",0,47,846,393,34,10,0,10,1340
"24510080500",52,0,1270,363,22,0,22,0,1729
"24510080600",5,19,1792,497,0,14,0,0,2327
"24510080700",0,46,521,294,0,0,0,0,861
"24510080800",0,0,572,350,0,67,0,0,989
"24510090100",452,150,2948,674,31,30,0,9,4294
"24510090200",535,29,2689,367,32,0,57,0,3709
"24510090300",816,134,2392,434,180,198,16,13,4183
"24510090400",28,5,921,420,22,10,0,0,1406
"24510090500",252,65,1050,407,32,118,0,0,1924
"24510090600",0,18,2391,608,37,18,37,18,3127
"24510090700",28,10,2594,762,18,16,0,0,3428
"24510090800",126,118,1919,1038,19,116,81,16,3433
"24510090900",20,1,1513,825,0,57,149,46,2611
"24510100100",50,32,1482,571,32,1,0,1,2169
"24510100200",0,7,1283,1667,16,4,0,4,2981
"24510100300",0,0,0,0,0,0,0,0,0
"24510110100",1426,690,611,222,295,214,116,0,3574
"24510110200",2171,735,907,419,486,216,170,103,5207
"24510120100",2859,280,149,188,1005,337,113,29,4960
"24510120201",1152,331,189,123,204,219,76,58,2352
"24510120202",1096,594,172,125,674,557,122,60,3400
"24510120300",904,182,1157,490,178,55,79,16,3061
"24510120400",169,44,728,412,93,0,77,9,1532
"24510120500",437,147,840,424,124,62,71,0,2105
"24510120600",756,198,568,717,108,134,90,42,2613
"24510120700",1242,208,341,302,143,269,0,16,2521
"24510130100",173,23,1715,791,166,12,8,2,2890
"24510130200",405,25,1458,1335,103,184,0,71,3581
"24510130300",65,2,1217,502,9,7,12,10,1824
"24510130400",34,1,1606,575,11,4,1,1,2233
"24510130600",3307,249,29,124,152,37,72,5,3975
"24510130700",3604,362,214,76,556,0,123,0,4935
"24510130803",1655,91,188,11,447,15,167,11,2585
"24510130804",1416,156,34,58,156,35,109,15,1979
"24510130805",157,5,690,84,51,0,24,0,1011
"24510130806",935,140,211,9,79,0,0,0,1374
"24510140100",1810,180,1045,491,432,378,0,0,4336
"24510140200",39,90,790,1873,0,0,5,28,2825
"24510140300",55,53,1310,852,63,22,0,24,2379
"24510150100",0,5,2115,1366,17,0,0,0,3503
"24510150200",0,0,2048,685,8,19,0,0,2760
"24510150300",0,0,1854,362,0,127,0,0,2343
"24510150400",0,0,2471,595,0,14,9,0,3089
"24510150500",0,0,1409,598,0,100,0,0,2107
"24510150600",0,39,1455,769,26,0,0,0,2289
"24510150701",0,5,1279,172,7,12,0,0,1475
"24510150702",9,0,1683,317,29,0,29,0,2067
"24510150800",31,23,2533,1140,92,8,61,0,3888
"24510150900",63,20,1946,675,14,0,14,10,2742
"24510151000",121,66,3446,826,224,119,3,0,4805
"24510151100",220,87,4985,1211,467,0,39,0,7009
"24510151200",44,73,3006,2156,33,66,39,39,5456
"24510151300",23,72,2720,1996,35,90,29,54,5019
"24510160100",5,1,1084,1162,23,95,62,1,2433
"24510160200",0,7,1821,742,19,0,0,0,2589
"24510160300",28,15,1046,392,0,7,0,0,1488
"24510160400",1,1,2088,1109,18,0,0,0,3217
"24510160500",0,0,2651,1020,0,0,124,0,3795
"24510160600",0,0,1388,737,0,78,64,94,2361
"24510160700",46,1,2657,1484,40,36,0,0,4264
"24510160801",12,1,2351,1059,38,0,58,0,3519
"24510160802",8,153,2082,734,23,0,0,0,3000
"24510170100",311,78,623,377,121,36,48,0,1594
"24510170200",63,22,1492,1742,33,82,0,34,3468
"24510170300",13,0,1352,605,30,8,0,0,2008
"24510180100",37,31,963,992,0,32,25,16,2096
"24510180200",26,46,531,421,15,0,0,0,1039
"24510180300",411,285,573,385,118,11,35,0,1818
"24510190100",120,2,1281,580,4,28,111,11,2137
"24510190200",517,111,678,446,56,59,50,59,1976
"24510190300",262,186,883,377,179,10,163,28,2088
"24510200100",20,13,850,541,33,0,0,7,1464
"24510200200",49,0,1209,778,43,0,0,0,2079
"24510200300",162,120,627,603,0,98,0,0,1610
"24510200400",55,12,926,744,6,33,0,8,1784
"24510200500",717,362,644,708,123,185,184,59,2982
"24510200600",585,628,1130,352,79,94,0,11,2879
"24510200701",78,46,3119,911,116,0,67,27,4364
"24510200702",8,0,979,417,7,0,0,0,1411
"24510200800",241,20,1361,608,17,0,44,0,2291
"24510210100",654,184,666,388,91,16,34,28,2061
"24510210200",926,272,1132,532,308,81,35,8,3294
"24510220100",2688,611,192,144,246,93,39,0,4013
"24510230100",900,90,445,339,235,0,29,22,2060
"24510230200",1777,79,141,13,78,0,112,0,2200
"24510230300",900,81,16,13,3,15,41,0,1069
"24510240100",2522,151,0,3,67,7,124,0,2874
"24510240200",2193,144,163,9,210,0,66,0,2785
"24510240300",1691,158,44,45,53,72,39,2,2104
"24510240400",2351,88,58,11,340,37,171,29,3085
"24510250101",185,0,2819,632,67,8,50,8,3769
"24510250102",185,44,2089,290,107,14,0,0,2729
"24510250103",2554,304,504,99,195,10,256,8,3930
"24510250203",33,0,1469,407,57,47,46,0,2059
"24510250204",0,34,1516,2888,263,19,9,46,4775
"24510250205",1286,543,2006,528,203,0,617,195,5378
"24510250206",1529,483,194,34,136,48,47,8,2479
"24510250207",96,21,1789,342,157,75,132,8,2620
"24510250301",126,75,1714,494,12,38,54,0,2513
"24510250303",1120,538,238,21,96,60,145,16,2234
"24510250401",1907,591,489,252,80,34,78,65,3496
"24510250402",1250,517,1587,1259,459,254,516,100,5942
"24510250500",2236,841,1315,610,611,312,243,235,6403
"24510250600",0,0,0,0,0,0,0,0,0
"24510260101",1111,324,2404,432,334,157,195,142,5099
"24510260102",461,104,3739,592,122,1,147,0,5166
"24510260201",706,102,2203,858,445,69,289,69,4741
"24510260202",506,197,3024,1244,368,351,38,0,5728
"24510260203",146,39,1870,408,25,89,6,0,2583
"24510260301",231,23,3136,991,47,0,38,0,4466
"24510260302",452,63,4479,1295,0,11,56,0,6356
"24510260303",183,56,338,157,10,0,29,0,773
"24510260401",1897,447,51,195,595,189,612,302,4288
"24510260402",19,5,1931,263,103,0,0,0,2321
"24510260403",32,45,1733,331,11,21,0,0,2173
"24510260404",547,107,1117,12,430,116,807,166,3302
"24510260501",3351,638,350,8,266,143,1018,151,5925
"24510260604",273,56,292,627,117,50,123,28,1566
"24510260605",2990,469,452,176,370,278,542,348,5625
"24510260700",1502,582,0,41,376,143,627,355,3626
"24510260800",1446,151,281,886,272,105,850,214,4205
"24510260900",1999,177,55,2,139,17,236,18,2643
"24510261000",830,192,869,475,252,218,570,333,3739
"24510261100",1639,132,100,68,36,0,50,68,2093
"24510270101",698,40,645,298,26,0,55,0,1762
"24510270102",983,125,2712,138,145,25,67,0,4195
"24510270200",981,71,542,10,109,1,10,7,1731
"24510270301",872,93,1327,195,314,0,70,0,2871
"24510270302",706,13,553,121,145,12,17,0,1567
"24510270401",1133,43,3911,329,43,0,60,76,5595
"24510270402",1299,43,1504,145,103,6,21,1,3122
"24510270501",2745,87,1594,113,98,0,154,0,4791
"24510270502",1404,98,2739,177,281,49,23,0,4771
"24510270600",1878,69,1744,514,340,0,77,0,4622
"24510270701",63,54,2154,631,43,90,88,93,3216
"24510270702",359,78,1423,218,108,60,63,60,2369
"24510270703",1642,138,956,215,226,17,44,0,3238
"24510270801",422,11,3218,666,257,35,219,35,4863
"24510270802",199,16,3687,1526,91,29,18,136,5702
"24510270803",303,65,4030,1121,165,51,0,1,5736
"24510270804",1165,182,800,451,63,6,49,14,2730
"24510270805",278,24,3757,683,244,0,147,0,5133
"24510270901",30,0,3625,472,75,0,0,0,4202
"24510270902",64,5,3515,194,41,10,0,0,3829
"24510270903",220,0,2367,415,134,14,18,14,3182
"24510271001",73,11,1667,539,38,21,0,0,2349
"24510271002",269,32,2994,815,73,0,91,0,4274
"24510271101",704,135,427,289,74,26,97,60,1812
"24510271102",1139,10,104,60,5,0,27,0,1345
"24510271200",4384,281,483,125,543,176,183,0,6175
"24510271300",2290,157,194,0,244,0,22,0,2907
"24510271400",2861,158,122,27,196,90,116,0,3570
"24510271501",3091,302,372,50,252,38,87,15,4207
"24510271503",698,27,58,0,44,0,0,0,827
"24510271600",13,41,3086,1707,103,0,84,5,5039
"24510271700",18,27,3597,947,16,0,0,0,4605
"24510271801",35,6,2230,751,265,106,0,106,3499
"24510271802",8,7,2121,978,0,34,73,0,3221
"24510271900",748,183,2546,359,30,76,0,108,4050
"24510272003",3696,86,1077,434,171,44,28,17,5553
"24510272004",2880,607,380,227,403,17,67,0,4581
"24510272005",2305,212,606,19,198,0,0,0,3340
"24510272006",1186,545,1646,308,126,118,51,86,4066
"24510272007",1473,208,1730,639,389,208,265,160,5072
"24510280101",144,110,2586,594,161,55,48,55,3753
"24510280102",94,55,4047,1163,106,0,18,0,5483
"24510280200",123,50,3824,905,90,43,30,0,5065
"24510280301",245,142,2505,900,73,74,29,56,4024
"24510280302",87,0,1509,470,26,0,0,0,2092
"24510280401",411,21,2416,357,153,0,33,0,3391
"24510280402",6,0,1652,139,30,0,6,0,1833
"24510280403",1179,55,3113,315,162,337,53,156,5370
"24510280404",26,15,1567,250,110,0,0,0,1968
"24510280500",38,90,655,1494,24,23,0,10,2334
"25001010100",2286,266,126,19,130,78,84,38,3027
"25001010206",2518,311,24,16,78,54,0,3,3004
"25001010208",1519,189,0,0,23,0,25,0,1756
"25001010304",1817,94,7,0,71,5,11,0,2005
"25001010306",2643,229,0,5,67,0,62,16,3022
"25001010400",2901,79,0,0,54,0,75,9,3118
"25001010500",2661,111,0,0,16,9,0,0,2797
"25001010600",2805,138,208,103,14,10,0,0,3278
"25001010700",2419,209,10,4,80,0,12,10,2744
"25001010800",4498,318,23,0,38,16,0,36,4929
"25001010900",4087,351,59,0,29,0,63,0,4589
"25001011002",3433,360,71,0,152,147,57,138,4358
"25001011100",4159,221,0,0,194,0,125,0,4699
"25001011200",2853,234,32,2,176,9,7,33,3346
"25001011300",2570,129,0,0,28,10,63,47,2847
"25001011400",2675,286,0,102,29,0,0,35,3127
"25001011500",2639,298,57,277,176,0,33,0,3480
"25001011600",2050,795,0,0,88,45,17,9,3004
"25001011700",1333,431,7,6,54,0,69,7,1907
"25001011801",2147,130,17,0,129,0,32,0,2455
"25001011802",3631,223,46,0,106,0,75,16,4097
"25001012001",5161,484,26,36,62,0,50,0,5819
"25001012002",2205,421,133,6,184,62,40,71,3122
"25001012101",4527,389,284,4,162,13,83,2,5464
"25001012102",2780,125,0,23,66,9,146,16,3165
"25001012200",3608,714,0,0,112,0,89,0,4523
"25001012502",2215,272,13,0,184,19,98,13,2814
"25001012601",2470,380,92,0,103,119,85,0,3249
"25001012602",2696,796,216,404,481,82,448,93,5216
"25001012700",4169,225,27,0,22,0,89,0,4532
"25001012800",3799,304,0,0,179,0,36,0,4318
"25001012900",3836,83,30,0,113,22,65,1,4150
"25001013002",3023,213,32,27,95,0,46,0,3436
"25001013100",5018,297,42,0,169,0,58,0,5584
"25001013200",4523,139,91,0,60,26,123,0,4962
"25001013300",2715,126,0,0,147,0,74,0,3062
"25001013400",3748,113,0,0,228,0,189,0,4278
"25001013500",5947,270,64,0,98,24,9,0,6412
"25001013600",6126,461,0,4,125,0,146,0,6862
"25001013700",2962,297,78,2,94,8,133,1,3575
"25001013800",4149,763,0,0,46,0,42,32,5032
"25001013900",4359,668,72,86,35,70,0,0,5290
"25001014002",3573,343,71,47,209,14,150,0,4407
"25001014100",605,33,11,0,305,0,137,0,1091
"25001014300",3755,255,15,5,93,53,37,92,4305
"25001014402",5676,429,56,0,305,1,126,1,6594
"25001014500",4607,305,423,73,420,0,294,0,6122
"25001014600",3224,133,25,26,400,147,24,2,3981
"25001014700",3050,192,142,0,199,41,29,0,3653
"25001014800",2447,320,115,21,274,139,42,0,3358
"25001014900",3444,181,0,8,96,5,29,8,3771
"25001015001",3890,86,41,0,321,94,42,0,4474
"25001015002",2533,465,92,4,210,8,35,0,3347
"25001015100",3372,296,185,0,122,0,190,0,4165
"25001015200",2108,45,0,0,21,0,8,0,2182
"25001015300",1316,612,421,32,210,425,54,93,3163
"25001990000",0,0,0,0,0,0,0,0,0
"25003900100",1777,983,149,209,186,158,301,145,3908
"25003900200",2314,616,311,149,344,161,245,153,4293
"25003900300",2095,262,109,0,37,32,93,45,2673
"25003900400",3455,866,50,117,103,93,101,235,5020
"25003900500",2851,105,27,0,130,1,57,1,3172
"25003900600",2059,952,398,276,216,215,242,104,4462
"25003900700",2280,381,61,9,84,21,26,0,2862
"25003900800",4947,272,154,12,0,14,13,0,5412
"25003900900",3776,595,96,0,266,69,255,66,5123
"25003901100",3249,85,14,0,86,13,31,0,3478
"25003911100",2861,56,0,0,123,13,0,0,3053
"25003912100",5845,741,16,15,24,0,155,0,6796
"25003913100",3854,632,0,0,175,67,44,61,4833
"25003914100",5150,471,0,9,122,73,98,73,5996
"25003920101",3194,166,7,4,147,4,43,0,3565
"25003920102",1807,150,0,26,104,19,5,37,2148
"25003921300",2657,798,10,171,108,196,95,33,4068
"25003921400",1548,243,0,0,55,49,62,6,1963
"25003921500",2533,438,12,0,89,0,81,74,3227
"25003922100",2061,403,8,0,49,44,26,0,2591
"25003922200",3400,236,15,1,49,15,90,2,3808
"25003922300",1833,244,9,7,28,2,49,0,2172
"25003923100",2831,351,0,17,0,9,6,13,3227
"25003924100",1607,157,54,9,99,8,60,8,2002
"25003925100",4738,534,128,0,715,19,655,82,6871
"25003926100",2785,324,8,2,106,19,24,0,3268
"25003931100",1555,102,4,0,5,1,6,0,1673
"25003931300",1256,69,63,1,40,17,23,0,1469
"25003931400",1610,128,8,0,46,0,2,7,1801
"25003932200",2061,180,8,0,44,34,12,8,2347
"25003932300",2176,85,16,0,23,17,0,6,2323
"25003933200",946,121,0,12,8,12,16,0,1115
"25003933300",1306,134,4,0,62,0,19,0,1525
"25003933400",2005,150,0,4,143,0,37,5,2344
"25003934200",1213,61,18,0,80,0,10,0,1382
"25003934300",1582,83,6,3,21,5,4,2,1706
"25003935100",2309,50,4,1,34,17,19,4,2438
"25003935200",4246,732,54,0,78,48,7,48,5213
"25003935300",2896,515,4,2,183,12,29,54,3695
"25005600100",3339,165,131,0,76,1,72,0,3784
"25005600202",3816,192,199,19,548,4,170,13,4961
"25005600203",5294,62,60,1,189,0,306,0,5912
"25005600204",3428,132,233,8,54,38,117,10,4020
"25005610100",4583,262,30,0,480,47,144,0,5546
"25005610202",5131,136,39,10,231,22,105,45,5719
"25005610203",5942,165,311,0,273,26,137,0,6854
"25005610204",4658,224,98,18,523,26,234,26,5807
"25005611101",3887,140,130,0,254,0,9,0,4420
"25005611102",2892,297,12,36,140,5,44,30,3456
"25005611201",2894,73,0,0,120,0,0,7,3094
"25005611202",5824,248,29,37,193,41,30,0,6402
"25005612100",3816,229,5,0,268,10,51,1,4380
"25005612200",7154,502,442,46,699,103,191,27,9164
"25005613100",5963,448,66,0,43,0,44,0,6564
"25005613300",6875,206,368,57,144,49,335,2,8036
"25005613400",3489,243,110,20,85,39,92,51,4129
"25005613600",2456,560,254,30,95,341,107,235,4078
"25005613700",2903,573,160,50,39,24,32,93,3874
"25005613800",3064,775,107,24,193,165,566,246,5140
"25005613901",1890,312,103,49,160,160,0,147,2821
"25005613902",3847,231,80,1,221,76,141,83,4680
"25005614000",2544,1041,244,103,384,173,372,261,5122
"25005614101",4633,832,473,139,418,19,0,72,6586
"25005614102",6324,289,366,0,93,62,284,47,7465
"25005615100",6579,280,0,0,175,17,285,4,7340
"25005616100",5899,383,38,0,125,0,306,0,6751
"25005617101",4512,280,9,7,77,33,8,0,4926
"25005617102",3588,155,16,0,140,0,66,0,3965
"25005630101",2373,280,154,9,131,5,35,0,2987
"25005630102",3579,313,5,0,166,0,8,0,4071
"25005630200",7735,124,68,1,240,0,85,0,8253
"25005630300",7223,345,309,11,673,24,201,69,8855
"25005630400",4538,107,52,0,122,1,69,1,4890
"25005631100",6677,657,363,97,512,84,436,246,9072
"25005631200",5776,438,118,0,530,41,19,61,6983
"25005631300",4808,242,104,0,144,0,77,0,5375
"25005631400",1314,388,172,7,288,220,325,9,2723
"25005631500",2206,236,7,0,176,2,162,12,2801
"25005631600",3102,550,85,0,460,68,490,234,4989
"25005631700",4908,165,644,0,467,82,303,13,6582
"25005631800",5732,563,325,2,361,29,205,29,7246
"25005632100",5952,252,93,24,203,0,78,0,6602
"25005632200",6760,338,39,1,199,0,143,0,7480
"25005633100",4980,129,0,0,78,0,67,0,5254
"25005633200",6063,248,0,14,61,0,20,0,6406
"25005640100",3466,838,66,35,217,65,288,315,5290
"25005640200",3538,1368,0,283,340,156,335,186,6206
"25005640300",2763,459,45,252,259,252,434,190,4654
"25005640400",2007,481,20,7,42,6,110,0,2673
"25005640500",3165,846,0,14,518,131,210,112,4996
"25005640600",3267,954,151,1,283,198,219,149,5222
"25005640700",2592,246,85,0,127,11,24,0,3085
"25005640800",2708,499,102,0,230,252,186,367,4344
"25005640901",2799,1492,62,28,366,288,101,352,5488
"25005641000",1259,748,20,30,61,66,0,91,2275
"25005641101",621,959,76,36,124,211,0,741,2768
"25005641200",1710,837,212,32,221,449,62,183,3706
"25005641300",2190,1466,291,234,400,230,211,312,5334
"25005641400",1650,442,8,53,59,180,55,67,2514
"25005641500",1478,305,39,0,110,120,64,68,2184
"25005641600",1903,333,13,46,46,8,33,0,2382
"25005641700",4535,541,138,19,249,86,143,49,5760
"25005641800",1718,202,65,21,28,37,5,28,2104
"25005641900",1353,402,152,25,264,35,43,0,2274
"25005642000",1629,599,218,12,215,163,49,184,3069
"25005642100",2897,747,160,1,138,51,36,129,4159
"25005642200",2426,521,22,43,229,277,184,345,4047
"25005642300",2103,49,0,0,71,0,73,0,2296
"25005642400",2536,398,0,14,39,24,43,12,3066
"25005642500",4035,183,30,0,47,0,69,0,4364
"25005644101",5240,321,151,0,171,0,0,0,5883
"25005644102",4680,175,0,1,157,24,24,42,5103
"25005644200",6217,673,0,0,120,0,73,0,7083
"25005645101",4123,433,7,0,160,103,39,9,4874
"25005645102",4796,248,0,0,92,0,31,0,5167
"25005645103",5347,308,31,0,88,0,0,43,5817
"25005646101",7045,166,61,1,150,15,16,0,7454
"25005646103",5353,269,0,0,58,28,0,0,5708
"25005646104",2331,44,0,0,9,0,0,0,2384
"25005650101",5154,294,20,1,140,106,133,24,5872
"25005650102",3645,395,146,11,360,82,832,274,5745
"25005650201",2863,129,36,16,59,29,79,13,3224
"25005650202",1453,380,26,78,77,0,94,126,2234
"25005650300",2671,350,262,11,176,0,194,60,3724
"25005650400",2385,341,274,34,290,152,103,135,3714
"25005650500",2190,553,167,29,269,41,295,143,3687
"25005650600",1542,675,315,38,57,229,71,443,3370
"25005650700",970,394,93,85,375,245,498,247,2907
"25005650800",1788,569,195,162,350,314,595,293,4266
"25005650900",1045,580,122,86,190,659,400,1030,4112
"25005651001",2157,190,43,21,202,118,102,36,2869
"25005651002",2565,471,130,24,320,123,179,21,3833
"25005651100",1498,787,149,304,666,464,219,635,4722
"25005651200",775,509,134,43,255,544,349,574,3183
"25005651300",983,420,136,79,345,153,378,96,2590
"25005651400",1709,478,261,124,420,70,273,61,3396
"25005651500",1554,410,261,38,663,247,512,218,3903
"25005651600",2032,433,588,125,901,258,544,133,5014
"25005651700",597,589,57,242,327,207,79,397,2495
"25005651800",694,372,82,203,70,274,100,159,1954
"25005651900",454,415,192,132,422,376,271,295,2557
"25005652000",1346,380,195,26,284,81,551,135,2998
"25005652100",1731,340,61,0,406,73,237,72,2920
"25005652200",2342,224,103,0,303,19,107,0,3098
"25005652300",1803,518,119,57,429,145,325,75,3471
"25005652400",1448,361,8,11,412,125,296,128,2789
"25005652500",1228,466,114,12,216,275,278,376,2965
"25005652600",969,695,269,5,415,387,604,476,3820
"25005652700",1885,956,154,59,413,167,610,412,4656
"25005652800",3030,124,125,11,49,0,78,0,3417
"25005653101",5636,500,80,11,154,47,83,111,6622
"25005653102",4109,153,0,0,62,0,24,0,4348
"25005653203",4413,173,47,26,254,57,41,2,5013
"25005653204",2826,235,13,0,183,7,70,0,3334
"25005653301",4685,308,26,0,505,22,28,0,5574
"25005653304",3271,151,11,0,96,0,0,0,3529
"25005654100",6329,157,0,0,356,0,245,16,7103
"25005654200",3105,224,0,2,22,0,0,0,3353
"25005655100",3512,233,0,0,45,32,9,0,3831
"25005655200",3256,720,15,0,324,55,101,1,4472
"25005655300",2818,381,0,1,228,10,57,0,3495
"25005655400",3736,163,0,0,55,25,0,0,3979
"25005985500",1279,86,0,0,33,0,19,11,1428
"25005985600",2858,41,117,7,90,0,160,0,3273
"25005990000",0,0,0,0,0,0,0,0,0
"25007200100",3161,611,57,0,120,31,0,0,3980
"25007200200",3559,315,319,35,279,0,0,0,4507
"25007200300",3654,302,60,0,78,0,9,0,4103
"25007200400",3364,342,34,0,240,37,50,18,4085
"25007990000",0,0,0,0,0,0,0,0,0
"25009201100",3108,99,69,0,105,0,154,0,3535
"25009202101",1862,21,4,0,121,2,9,0,2019
"25009202102",5228,409,53,0,111,0,286,0,6087
"25009202200",5374,189,48,1,243,38,216,0,6109
"25009203100",6214,227,116,0,35,43,107,85,6827
"25009203200",4317,242,30,0,92,0,41,0,4722
"25009203301",3667,338,15,0,134,0,64,0,4218
"25009203302",4042,205,21,0,66,19,115,19,4487
"25009204101",3050,602,43,80,303,103,281,225,4687
"25009204102",3464,133,336,11,362,25,473,27,4831
"25009204200",3003,1374,35,204,408,149,640,701,6514
"25009204300",1950,423,155,256,677,134,1325,312,5232
"25009204400",2607,165,0,10,245,37,236,46,3346
"25009204500",2793,178,84,0,146,0,121,0,3322
"25009204600",3926,323,273,23,122,11,266,34,4978
"25009204701",3938,650,318,268,621,270,754,426,7245
"25009204702",4440,381,241,34,385,385,221,433,6520
"25009205100",3965,245,324,0,757,0,637,50,5978
"25009205200",3443,331,730,0,624,177,629,284,6218
"25009205300",3747,183,229,38,252,54,294,8,4805
"25009205400",4614,36,165,0,297,0,224,0,5336
"25009205500",1872,248,639,13,1510,467,1718,418,6885
"25009205600",2044,555,313,452,301,344,422,419,4850
"25009205700",3041,407,461,78,620,152,780,220,5759
"25009205800",888,253,233,109,1159,583,850,438,4513
"25009205900",1603,399,685,23,1055,445,1047,553,5810
"25009206000",932,263,267,147,1112,665,1205,671,5262
"25009206100",1068,343,561,138,1216,776,1488,502,6092
"25009206200",1626,601,375,35,1763,828,1973,805,8006
"25009206300",1711,304,528,194,915,212,1218,386,5468
"25009206400",2823,511,645,182,751,277,1106,528,6823
"25009206500",1005,406,507,336,789,299,806,463,4611
"25009206600",2416,368,344,95,984,96,913,217,5433
"25009206700",1843,794,341,148,608,404,820,830,5788
"25009206800",687,611,309,154,940,427,640,598,4366
"25009206900",1821,571,572,85,757,266,1194,214,5480
"25009207000",625,350,250,87,411,343,451,408,2925
"25009207100",1159,489,341,99,943,281,1428,536,5276
"25009207200",644,505,329,193,799,439,819,424,4152
"25009208101",4537,187,46,0,229,15,306,0,5320
"25009208102",2786,217,63,0,240,48,281,147,3782
"25009208200",4891,283,42,8,109,0,91,14,5438
"25009208300",6499,564,108,0,290,5,609,5,8080
"25009208400",5260,14,116,0,330,0,147,0,5867
"25009209100",5762,92,68,0,373,0,330,0,6625
"25009209200",5236,51,0,0,180,50,20,0,5537
"25009210100",5623,222,14,204,451,26,314,218,7072
"25009210200",4686,264,154,0,111,0,12,0,5227
"25009210300",7531,332,149,0,473,46,222,0,8753
"25009210400",6318,245,267,0,62,0,242,0,7134
"25009210500",6235,199,2,2,75,78,105,0,6696
"25009210600",3102,210,86,0,806,73,736,72,5085
"25009210700",2920,341,65,11,1038,118,1042,182,5717
"25009210800",3455,392,62,138,720,10,534,37,5348
"25009210900",3168,199,40,0,262,88,209,67,4033
"25009211100",3247,156,1,1,151,103,158,15,3832
"25009211200",5865,313,116,0,125,1,75,1,6496
"25009211300",6571,197,15,0,56,11,45,9,6904
"25009211401",2628,225,30,60,412,121,206,45,3727
"25009211402",5477,233,84,0,134,0,121,0,6049
"25009212100",6595,247,110,0,443,36,129,0,7560
"25009213100",7573,70,0,0,397,0,115,0,8155
"25009214100",5354,370,0,0,368,4,0,4,6100
"25009215101",4227,106,233,0,145,41,87,0,4839
"25009215102",2707,40,0,0,165,1,66,1,2980
"25009216100",3377,130,0,0,43,4,0,0,3554
"25009217100",6023,510,149,17,464,30,169,16,7378
"25009217201",3925,299,60,84,36,17,75,22,4518
"25009217202",3452,82,0,0,34,0,0,0,3568
"25009217300",3128,640,122,26,238,15,165,1,4335
"25009217400",4457,546,11,0,166,124,186,207,5697
"25009217500",5103,597,30,0,293,0,294,0,6317
"25009217600",6123,196,0,0,85,2,0,2,6408
"25009218100",4734,287,0,0,124,14,126,0,5285
"25009220101",3877,164,0,0,10,13,61,2,4127
"25009220102",2549,130,118,0,110,0,36,0,2943
"25009221100",4229,289,0,12,77,8,26,43,4684
"25009221300",4432,323,0,6,0,2,143,2,4908
"25009221400",2650,275,88,0,192,40,17,72,3334
"25009221500",2147,586,0,0,56,6,48,68,2911
"25009221600",1974,233,5,44,38,163,42,204,2703
"25009221700",1902,191,0,0,62,0,64,0,2219
"25009221800",1495,34,0,0,82,2,23,2,1638
"25009221901",2980,186,0,0,34,0,19,0,3219
"25009221902",3274,531,52,0,105,0,18,0,3980
"25009222100",3288,124,9,0,125,0,44,0,3590
"25009223100",3590,264,7,8,45,33,95,13,4055
"25009223200",3187,289,9,0,129,0,26,0,3640
"25009223300",5553,80,30,0,37,0,35,0,5735
"25009250100",553,238,70,44,846,583,1047,757,4138
"25009250200",1584,370,332,23,2353,670,3036,812,9180
"25009250300",450,261,91,143,1057,434,1476,813,4725
"25009250400",347,581,121,50,1391,1079,1760,1660,6989
"25009250500",362,238,44,99,2052,1305,2268,1584,7952
"25009250600",1761,516,283,93,2255,903,3492,1249,10552
"25009250700",1375,289,372,52,1994,1016,2961,1232,9291
"25009250800",2653,419,184,57,2872,609,3717,906,11417
"25009250900",512,304,86,98,746,602,1232,957,4537
"25009251000",281,147,141,0,632,250,953,358,2762
"25009251100",493,428,100,29,745,962,1038,1223,5018
"25009251200",459,203,61,15,507,284,851,409,2789
"25009251300",507,239,210,0,1018,919,1576,1094,5563
"25009251400",1493,241,372,140,1559,1199,2573,1335,8912
"25009251500",1734,453,228,146,2798,747,3344,1121,10571
"25009251600",1455,450,204,203,2130,1460,2507,1626,10035
"25009251700",1794,441,426,2,1766,795,2274,924,8422
"25009251800",3600,531,605,216,1738,574,2045,853,10162
"25009252101",2467,189,189,57,518,113,555,184,4272
"25009252102",3549,52,0,0,412,117,178,121,4429
"25009252201",2982,161,47,6,290,0,320,14,3820
"25009252202",3206,46,0,0,114,10,98,0,3474
"25009252300",3756,540,215,37,1512,117,1661,209,8047
"25009252400",1049,322,406,96,1928,323,2125,453,6702
"25009252501",2528,181,174,21,708,164,635,198,4609
"25009252502",3767,210,10,0,300,77,416,41,4821
"25009252601",5261,502,176,0,656,276,238,338,7447
"25009252602",3741,275,42,0,283,28,139,39,4547
"25009252603",2738,102,87,0,187,0,306,0,3420
"25009253100",4236,295,80,0,620,80,350,148,5809
"25009253201",2166,208,0,0,243,73,52,96,2838
"25009253202",4510,152,191,0,603,280,522,90,6348
"25009253203",3897,40,0,0,177,0,104,11,4229
"25009253204",4488,78,35,0,573,83,36,0,5293
"25009253205",3932,89,103,0,190,121,22,15,4472
"25009254100",5483,230,24,0,534,64,431,96,6862
"25009254200",3549,314,18,0,343,90,226,103,4643
"25009254301",3188,16,43,0,543,8,12,8,3818
"25009254302",3633,98,44,10,725,23,65,6,4604
"25009254401",2682,12,103,0,539,0,108,0,3444
"25009254402",4885,183,65,1,1304,21,90,5,6554
"25009254403",3219,333,16,0,518,1,139,0,4226
"25009260100",2599,747,167,30,1195,707,1319,800,7564
"25009260200",1983,591,69,8,174,89,259,197,3370
"25009260301",3844,353,6,0,9,21,38,63,4334
"25009260302",2346,154,36,0,165,0,10,0,2711
"25009260401",3443,103,32,11,278,0,284,24,4175
"25009260402",5188,75,13,17,390,35,399,16,6133
"25009260500",3356,225,49,0,223,0,113,86,4052
"25009260600",1958,469,101,0,953,134,1156,351,5122
"25009260700",3320,261,116,49,480,197,546,229,5198
"25009260800",2753,805,267,24,1114,339,1575,734,7611
"25009260900",3888,464,46,0,339,113,872,164,5886
"25009261000",2960,341,29,0,325,80,178,57,3970
"25009261101",3899,120,113,190,115,0,212,181,4830
"25009261102",3991,301,244,28,418,93,386,93,5554
"25009262100",6214,184,19,0,0,0,67,0,6484
"25009263100",4046,257,0,2,0,0,0,169,4474
"25009264100",6402,94,8,0,119,52,100,0,6775
"25009265101",3594,56,0,0,145,0,17,0,3812
"25009265102",4205,135,21,0,97,0,48,0,4506
"25009266100",3754,143,0,0,96,0,91,0,4084
"25009266200",4900,276,5,0,109,14,9,7,5320
"25009266300",2979,286,7,0,277,0,97,0,3646
"25009266400",3133,163,13,10,12,0,0,7,3338
"25009267101",3280,339,23,0,146,76,20,0,3884
"25009267102",4183,253,22,0,23,0,31,12,4524
"25009268100",2522,79,0,0,22,4,53,4,2684
"25009268200",5174,377,57,0,116,82,116,82,6004
"25009268300",3536,440,12,2,202,14,288,15,4509
"25009268400",4147,445,50,0,17,3,108,32,4802
"25009269100",6265,312,41,20,70,0,31,0,6739
"25009270100",5156,588,59,1,26,0,51,0,5881
"25009990100",0,0,0,0,0,0,0,0,0
"25011040100",3897,509,11,6,189,21,58,9,4700
"25011040200",4067,191,8,0,91,56,165,52,4630
"25011040300",2778,134,1,1,83,0,90,0,3087
"25011040400",2851,330,56,0,105,34,89,11,3476
"25011040501",3644,518,41,4,67,43,54,0,4371
"25011040502",2834,405,10,0,91,0,56,17,3413
"25011040600",4052,302,38,53,156,35,75,47,4758
"25011040701",2917,1012,6,31,171,93,241,98,4569
"25011040702",3266,464,43,10,211,37,0,18,4049
"25011040800",3827,780,21,9,320,50,87,32,5126
"25011040900",4501,215,24,0,286,17,113,0,5156
"25011041000",2389,331,42,0,125,61,71,0,3019
"25011041100",3220,307,0,7,59,52,72,5,3722
"25011041200",2487,529,0,0,117,3,116,58,3310
"25011041300",3736,792,45,20,213,49,185,114,5154
"25011041400",1738,338,45,3,164,127,127,147,2689
"25011041501",3021,195,8,7,113,19,23,0,3386
"25011041502",3461,322,17,0,75,6,13,0,3894
"25013800101",1846,595,390,214,277,603,519,794,5238
"25013800102",1962,1092,424,277,253,669,997,1384,7058
"25013800201",3774,545,598,118,808,384,1752,276,8255
"25013800202",1048,78,48,1,160,0,425,18,1778
"25013800300",1914,433,508,97,1037,493,1613,655,6750
"25013800400",2680,709,1025,0,1175,451,2074,911,9025
"25013800500",1610,169,250,52,842,455,1558,592,5528
"25013800600",433,515,177,214,557,963,913,1441,5213
"25013800700",799,564,221,345,924,865,1737,1489,6944
"25013800800",485,332,155,38,436,548,908,815,3717
"25013800900",514,1659,197,247,811,955,1165,2364,7912
"25013801101",656,484,98,215,135,474,574,912,3548
"25013801102",357,179,101,56,318,226,236,344,1817
"25013801200",324,339,350,365,420,803,655,1076,4332
"25013801300",854,377,1341,462,729,830,904,950,6447
"25013801401",153,323,1155,592,934,521,918,827,5423
"25013801402",649,86,668,46,534,72,537,93,2685
"25013801501",2331,409,1826,161,921,453,1924,640,8665
"25013801502",934,401,694,409,572,295,812,532,4649
"25013801503",1949,309,890,219,469,344,779,360,5319
"25013801601",2062,515,822,102,393,37,509,112,4552
"25013801602",2897,258,766,424,196,170,586,388,5685
"25013801603",2738,320,378,222,402,165,431,313,4969
"25013801604",3010,131,294,10,151,63,287,9,3955
"25013801605",2434,457,733,386,391,104,632,317,5454
"25013801700",433,457,2368,856,481,906,869,925,7295
"25013801800",337,154,1069,895,719,754,951,846,5725
"25013801901",940,437,441,221,910,830,1274,965,6018
"25013801902",578,544,538,426,339,910,570,1459,5364
"25013802000",425,321,213,308,549,1083,647,1343,4889
"25013802100",2940,605,562,302,718,677,1375,919,8098
"25013802200",735,671,435,159,541,526,669,912,4648
"25013802300",2072,663,1281,638,1366,691,1754,898,9363
"25013802400",2659,176,399,32,122,0,555,99,4042
"25013802500",5339,198,392,46,467,0,644,61,7147
"25013802601",3302,595,1290,271,996,402,2012,591,9459
"25013802602",1510,136,28,7,155,6,20,0,1862
"25013810100",5823,511,0,1,15,17,91,0,6458
"25013810200",2350,297,10,0,48,0,0,0,2705
"25013810300",2427,394,44,0,59,13,90,0,3027
"25013810403",3415,494,23,10,272,8,135,0,4357
"25013810404",3795,76,0,1,106,1,195,1,4175
"25013810412",5314,182,0,0,77,0,52,0,5625
"25013810414",6066,233,51,0,31,20,34,0,6435
"25013810601",3538,345,69,1,350,19,340,120,4782
"25013810602",2361,99,0,0,61,0,32,15,2568
"25013810700",5086,605,261,71,425,231,437,464,7580
"25013810800",2912,248,0,59,259,335,421,270,4504
"25013810901",992,248,135,199,91,150,256,363,2434
"25013810902",2975,483,6,44,312,185,476,426,4907
"25013811000",3820,322,13,0,172,0,295,0,4622
"25013811101",3348,655,66,55,329,342,729,544,6068
"25013811102",3891,529,82,50,934,346,1250,383,7465
"25013811200",4421,175,143,84,617,0,713,1,6154
"25013811301",4346,502,201,0,196,135,299,306,5985
"25013811302",4518,557,95,273,242,98,41,203,6027
"25013811400",918,1043,13,28,236,316,990,1295,4839
"25013811500",429,1088,0,70,110,487,481,1534,4199
"25013811600",1243,1542,74,159,110,289,1291,1596,6304
"25013811700",1060,1123,103,92,87,206,721,1167,4559
"25013811800",2813,1179,136,1,270,41,1637,977,7054
"25013811900",3258,196,45,16,125,18,385,18,4061
"25013812001",1455,998,102,84,163,212,432,921,4367
"25013812002",2973,535,51,172,484,287,1362,572,6436
"25013812101",4273,146,0,0,362,0,520,0,5301
"25013812103",1257,880,320,0,599,193,951,745,4945
"25013812104",2944,785,77,18,653,94,1187,496,6254
"25013812201",3596,240,169,227,716,60,542,109,5659
"25013812202",2413,394,188,6,748,80,251,229,4309
"25013812300",3707,1322,237,26,319,140,325,336,6412
"25013812401",5768,145,185,0,132,0,226,0,6456
"25013812403",2907,277,32,12,232,0,123,45,3628
"25013812404",3213,379,0,15,145,152,29,133,4066
"25013812500",6355,785,135,0,350,118,467,191,8401
"25013812600",6022,218,11,0,149,0,61,0,6461
"25013812701",3093,492,307,37,227,43,117,126,4442
"25013812702",3327,478,20,7,972,185,679,93,5761
"25013812800",5987,464,0,0,382,71,732,181,7817
"25013812901",2763,86,0,0,82,237,52,1,3221
"25013812902",4148,319,21,0,141,111,129,226,5095
"25013812903",50,7,0,0,0,0,0,0,57
"25013813000",6785,371,18,7,138,10,166,3,7498
"25013813101",5384,159,0,4,258,0,135,2,5942
"25013813102",3298,268,0,2,133,0,124,3,3828
"25013813204",2946,133,35,15,75,0,90,15,3309
"25013813205",5969,483,64,0,230,77,241,91,7155
"25013813206",3501,300,13,1,64,0,44,7,3930
"25013813207",4037,913,206,0,181,34,247,117,5735
"25013813208",2674,144,79,0,271,0,49,37,3254
"25013813209",4538,376,30,0,250,304,121,274,5893
"25013813301",6640,227,11,0,232,0,145,0,7255
"25013813303",3281,203,27,0,505,51,157,0,4224
"25013813304",3452,77,29,0,288,165,304,0,4315
"25013813401",4310,203,59,13,132,23,84,36,4860
"25013813403",3738,256,59,0,41,44,41,1,4180
"25013813404",5924,110,354,26,170,0,183,0,6767
"25013813500",4734,231,28,0,80,0,20,0,5093
"25013813601",6907,439,170,65,169,15,257,0,8022
"25013813602",5934,141,0,11,183,0,42,33,6344
"25013813701",3176,487,0,0,81,0,33,0,3777
"25013813702",4216,298,0,30,94,76,68,0,4782
"25013813801",3853,287,31,23,78,0,50,6,4328
"25013813802",3403,222,0,0,0,0,12,0,3637
"25015820101",5855,394,12,2,68,0,33,0,6364
"25015820102",2490,904,0,0,46,22,91,118,3671
"25015820202",1195,64,21,23,34,4,98,24,1463
"25015820203",7458,598,77,36,258,212,168,207,9014
"25015820204",5175,373,145,1,228,0,0,26,5948
"25015820300",3048,2358,249,0,874,496,335,55,7415
"25015820400",107,59,0,0,6,42,22,22,258
"25015820500",3081,1493,43,123,279,113,198,33,5363
"25015820600",43,0,0,0,3,0,0,0,46
"25015820700",2479,1097,70,24,767,135,251,289,5112
"25015820801",3038,754,283,112,444,517,480,18,5646
"25015820802",0,0,0,0,0,0,0,0,0
"25015820900",5973,234,0,0,45,3,218,0,6473
"25015821000",3691,288,34,0,253,6,135,115,4522
"25015821100",6133,353,189,7,18,1,135,1,6837
"25015821200",127,0,0,0,26,0,0,0,153
"25015821300",3501,427,78,0,83,41,27,72,4229
"25015821400",4463,332,51,71,118,0,164,0,5199
"25015821500",2873,340,35,3,29,3,19,31,3333
"25015821601",2019,225,8,218,585,418,293,246,4012
"25015821602",3036,621,48,41,213,77,316,64,4416
"25015821700",2926,295,18,24,156,28,87,95,3629
"25015821901",2281,155,0,0,200,26,55,11,2728
"25015821903",2057,638,107,63,212,49,176,90,3392
"25015821904",1881,269,40,0,58,0,103,6,2357
"25015822000",71,25,2,3,5,0,8,25,139
"25015822200",5021,345,27,0,435,24,247,79,6178
"25015822300",4722,297,0,1,488,28,92,82,5710
"25015822401",4901,219,0,2,367,0,326,2,5817
"25015822402",3987,402,152,19,277,161,138,11,5147
"25015822500",5506,212,18,16,106,0,197,11,6066
"25015822601",1730,160,20,0,91,27,5,27,2060
"25015822603",1484,67,0,0,8,2,56,14,1631
"25015822605",1081,67,0,0,12,2,13,0,1175
"25015822606",3465,222,14,0,56,0,116,4,3877
"25015822700",2834,173,21,0,91,15,20,11,3165
"25017300100",2907,163,16,0,17,11,47,0,3161
"25017301101",3565,236,0,0,61,0,23,0,3885
"25017301102",4741,208,0,0,175,22,78,31,5255
"25017310100",2378,528,329,26,638,583,567,688,5737
"25017310200",4065,340,220,37,1267,235,863,91,7118
"25017310300",3181,1018,450,98,835,359,839,427,7207
"25017310400",1614,534,171,58,385,416,555,310,4043
"25017310500",1937,188,126,69,388,365,153,154,3380
"25017310601",3136,313,299,0,1393,267,437,177,6022
"25017310602",4102,276,34,5,1022,472,426,468,6805
"25017310700",1364,544,310,41,1838,565,567,393,5622
"25017311100",793,323,34,10,853,405,646,340,3404
"25017311200",637,163,262,161,1382,252,341,97,3295
"25017311300",1821,309,316,2,996,195,283,36,3958
"25017311400",2117,473,856,84,2113,407,406,200,6656
"25017311500",1004,136,198,0,1408,612,223,199,3780
"25017311600",2747,456,339,0,1514,102,310,217,5685
"25017311700",1640,278,54,141,2289,465,552,127,5546
"25017311800",933,143,129,75,1852,449,313,130,4024
"25017311900",957,486,135,101,242,356,245,362,2884
"25017312000",1279,372,106,62,842,399,387,214,3661
"25017312100",1135,249,209,15,950,311,611,214,3694
"25017312200",1829,375,654,15,1574,233,578,163,5421
"25017312300",3004,417,28,21,1543,2,328,87,5430
"25017312400",1008,332,155,13,643,192,643,324,3310
"25017312501",3326,150,77,83,508,150,472,110,4876
"25017312502",3037,123,167,9,279,76,174,0,3865
"25017313101",5065,85,0,30,393,0,130,0,5703
"25017313102",5299,339,36,0,142,237,130,42,6225
"25017314101",4979,262,41,0,498,0,57,0,5837
"25017314102",6479,126,141,13,489,19,172,36,7475
"25017314200",4876,307,191,5,34,0,144,0,5557
"25017314301",7172,245,350,0,511,156,663,0,9097
"25017314302",2550,94,74,0,196,61,131,136,3242
"25017315100",5557,89,109,18,221,0,183,23,6200
"25017315200",6282,60,324,0,498,0,57,0,7221
"25017315401",3072,268,0,8,313,19,83,12,3775
"25017315402",2673,102,33,0,42,0,65,0,2915
"25017315403",1476,62,6,0,71,0,33,0,1648
"25017315500",7231,246,0,0,224,26,67,0,7794
"25017316101",4647,85,30,0,258,10,231,0,5261
"25017316102",5557,791,0,13,116,0,75,0,6552
"25017316201",3831,165,31,0,70,11,0,0,4108
"25017316202",3744,146,0,34,446,0,53,0,4423
"25017316300",6143,576,184,16,823,0,14,0,7756
"25017316400",4957,216,152,0,375,30,254,30,6014
"25017316500",5269,411,172,0,604,21,200,215,6892
"25017317101",4968,139,0,0,424,80,290,53,5954
"25017317102",3377,130,0,0,646,53,126,0,4332
"25017317103",4448,50,18,0,284,91,97,0,4988
"25017317201",2566,51,52,0,165,0,48,0,2882
"25017317202",3246,40,52,0,255,0,64,0,3657
"25017317203",3400,111,11,0,450,26,42,0,4040
"25017317301",2485,25,0,0,378,4,163,0,3055
"25017317302",4831,180,47,0,496,481,43,481,6559
"25017318100",5318,52,21,0,1414,0,77,52,6934
"25017318200",3120,178,27,0,457,48,117,41,3988
"25017318300",6544,39,16,0,1073,12,141,0,7825
"25017318400",3159,82,96,0,693,0,70,0,4100
"25017320102",4620,116,9,0,488,10,95,0,5338
"25017320103",2363,126,0,0,258,0,13,0,2760
"25017320104",6800,64,23,2,296,3,139,3,7330
"25017321100",5364,355,147,21,1156,61,362,121,7587
"25017321200",5063,455,80,0,726,67,538,99,7028
"25017321300",5337,493,155,1,1544,271,1584,391,9776
"25017321400",2538,68,66,1,395,13,154,3,3238
"25017321500",4923,169,77,33,1421,127,520,121,7391
"25017321600",5586,390,204,25,912,235,310,49,7711
"25017322100",4451,125,10,0,157,39,99,8,4889
"25017322200",3183,145,22,17,415,33,51,0,3866
"25017322300",4878,489,31,3,498,41,139,129,6208
"25017322400",3963,343,51,9,270,10,226,9,4881
"25017323100",6083,184,23,0,437,0,180,18,6925
"25017324101",4098,210,25,0,243,0,10,0,4586
"25017324102",3931,85,0,0,338,0,73,0,4427
"25017325100",5943,801,222,19,422,84,138,161,7790
"25017326101",3567,137,30,0,141,0,35,1,3911
"25017326102",6370,189,84,0,176,77,120,0,7016
"25017327101",3683,89,0,0,60,0,50,0,3882
"25017327102",3842,275,53,2,78,6,81,6,4343
"25017327103",3171,211,0,0,164,0,42,0,3588
"25017328100",3031,40,0,0,184,0,10,0,3265
"25017330100",7460,179,20,0,444,0,105,0,8208
"25017330200",5814,536,77,6,414,0,175,0,7022
"25017331101",2980,66,0,0,246,0,47,0,3339
"25017331102",6218,124,74,0,503,0,147,0,7066
"25017331200",4441,264,18,0,416,0,30,3,5172
"25017331300",6476,53,123,23,334,0,121,0,7130
"25017332100",5002,51,24,0,813,0,63,0,5953
"25017332200",6205,543,358,4,1264,21,210,13,8618
"25017332300",4842,168,287,0,1396,86,34,0,6813
"25017332400",2771,155,111,0,637,74,44,0,3792
"25017333100",6475,195,349,0,776,0,367,0,8162
"25017333200",4493,373,68,8,151,0,264,40,5397
"25017333300",3369,123,150,0,312,6,157,16,4133
"25017333400",4940,403,82,48,649,77,272,13,6484
"25017333501",4378,211,50,2,336,155,123,28,5283
"25017333502",2681,227,218,10,125,21,166,41,3489
"25017333600",5046,181,342,201,933,153,174,0,7030
"25017334100",6245,87,46,0,418,100,312,0,7208
"25017334200",3571,65,0,0,305,0,218,0,4159
"25017334300",7379,86,108,0,159,0,67,0,7799
"25017334400",5609,84,92,0,447,8,80,0,6320
"25017335100",5028,199,0,3,166,16,51,16,5479
"25017335200",5479,255,0,0,269,0,68,0,6071
"25017335301",3412,163,47,0,145,240,39,0,4046
"25017335302",4505,88,39,0,323,2,140,2,5099
"25017335400",4589,58,0,0,151,1,126,0,4925
"25017336100",4866,220,329,0,236,38,142,0,5831
"25017336200",5968,52,13,0,54,3,116,0,6206
"25017336300",5885,183,50,0,436,0,268,0,6822
"25017336401",3403,221,83,60,256,23,218,0,4264
"25017336402",3795,244,225,63,207,3,77,20,4634
"25017337101",2775,199,60,1,109,80,59,11,3294
"25017337102",4671,38,77,0,256,0,112,16,5170
"25017337201",2744,76,5,0,79,141,0,49,3094
"25017337202",4697,36,27,0,33,0,131,12,4936
"25017337300",4275,191,18,0,487,165,159,128,5423
"25017338100",2101,17,40,0,803,0,18,0,2979
"25017338200",2528,76,67,0,867,105,62,0,3705
"25017338300",2932,10,25,0,203,2,105,1,3278
"25017338400",4884,267,44,0,706,0,10,0,5911
"25017338500",5171,169,23,1,302,72,190,13,5941
"25017339100",4979,354,137,61,225,82,59,0,5897
"25017339200",4901,203,0,0,260,0,120,0,5484
"25017339300",1582,94,755,18,273,17,53,0,2792
"25017339400",2386,550,35,35,82,9,120,216,3433
"25017339500",2943,433,391,0,281,20,56,0,4124
"25017339600",3657,687,784,26,404,57,132,0,5747
"25017339700",2810,361,317,148,438,155,177,44,4450
"25017339801",3024,315,284,0,1034,149,369,17,5192
"25017339802",2418,390,289,109,910,83,197,95,4491
"25017339900",3838,562,273,4,423,1,381,74,5556
"25017340000",1988,75,155,30,308,65,93,0,2714
"25017340100",5209,232,404,0,651,0,369,0,6865
"25017341101",1675,134,160,36,1181,286,246,6,3724
"25017341102",2677,164,187,125,1010,476,197,49,4885
"25017341200",2744,650,829,104,2129,773,426,302,7957
"25017341300",1834,532,339,134,2197,713,213,79,6041
"25017341400",3143,282,1026,147,1138,119,526,0,6381
"25017341500",1908,206,1481,89,1381,208,637,77,5987
"25017341600",3768,337,442,408,1490,364,311,0,7120
"25017341700",3041,209,440,0,1084,291,262,59,5386
"25017341800",3012,848,512,384,1084,442,1241,184,7707
"25017341901",1076,190,64,0,89,0,209,0,1628
"25017341902",4137,464,1216,412,1610,1,828,80,8748
"25017342101",2448,556,615,17,643,230,674,307,5490
"25017342102",2601,319,373,225,312,111,596,286,4823
"25017342201",2946,283,610,148,648,206,860,229,5930
"25017342202",2466,146,327,155,508,9,554,60,4225
"25017342300",3813,593,764,152,1064,269,1228,117,8000
"25017342400",3465,651,961,77,953,186,1380,130,7803
"25017342500",5268,559,959,0,666,30,1702,90,9274
"25017342600",2367,323,667,29,864,258,830,253,5591
"25017350103",953,101,222,0,24,15,0,0,1315
"25017350104",3647,611,703,855,1030,386,1147,307,8686
"25017350200",4794,316,302,30,563,118,411,2,6536
"25017350300",1835,112,96,23,357,39,135,20,2617
"25017350400",4242,513,101,4,145,35,188,47,5275
"25017350500",1342,78,24,13,97,10,12,3,1579
"25017350600",1447,421,19,9,237,109,57,0,2299
"25017350700",4189,481,528,447,526,482,221,370,7244
"25017350800",1467,129,118,0,289,43,126,22,2194
"25017350900",2788,178,55,0,206,54,48,24,3353
"25017351000",4785,1286,134,66,888,125,200,179,7663
"25017351100",4240,317,69,35,800,250,348,34,6093
"25017351203",2687,425,62,1,901,166,316,93,4651
"25017351204",2814,463,168,21,762,163,84,201,4676
"25017351300",3217,233,60,34,557,118,244,18,4481
"25017351403",2054,507,378,247,527,59,689,406,4867
"25017351404",2351,366,127,124,971,125,955,114,5133
"25017351500",1517,197,174,20,560,29,347,107,2951
"25017352101",642,246,141,15,610,208,132,167,2161
"25017352102",1720,125,161,22,526,48,54,36,2692
"25017352200",937,227,310,69,349,96,83,51,2122
"25017352300",1632,330,120,9,955,135,128,156,3465
"25017352400",693,179,460,259,252,175,217,58,2293
"25017352500",1692,278,311,211,485,0,222,69,3268
"25017352600",1235,190,248,300,306,310,130,144,2863
"25017352700",1144,268,339,83,361,48,217,75,2535
"25017352800",1578,189,107,5,460,5,151,0,2495
"25017352900",2193,209,29,20,305,171,121,31,3079
"25017353000",2010,337,297,138,538,265,158,101,3844
"25017353101",1079,203,136,41,339,168,215,35,2216
"25017353102",280,79,0,0,138,125,42,0,664
"25017353200",2254,171,434,62,365,124,148,55,3613
"25017353300",2617,193,228,40,559,100,210,104,4051
"25017353400",1199,183,654,86,971,51,343,48,3535
"25017353500",1308,169,175,544,356,57,88,6,2703
"25017353600",1847,174,136,14,461,135,218,58,3043
"25017353700",1995,298,16,119,367,137,141,102,3175
"25017353800",3082,397,97,92,644,168,305,14,4799
"25017353900",1354,390,64,36,798,109,103,185,3039
"25017354000",2075,233,7,0,473,167,112,46,3113
"25017354100",2075,82,37,19,296,25,147,12,2693
"25017354200",2827,159,40,29,231,0,85,0,3371
"25017354300",2186,264,242,87,714,165,104,136,3898
"25017354400",1485,66,65,0,130,22,27,22,1817
"25017354500",1533,176,152,14,243,38,78,0,2234
"25017354600",2450,206,970,453,642,7,61,53,4842
"25017354700",1830,92,168,45,300,2,128,0,2565
"25017354800",1715,90,47,1,157,8,117,1,2136
"25017354900",2932,165,1264,597,1021,314,393,75,6761
"25017355000",2077,128,251,30,205,111,271,59,3132
"25017356100",2590,121,0,0,433,9,121,0,3274
"25017356300",3775,85,348,0,681,52,423,28,5392
"25017356400",5840,214,99,0,746,26,156,0,7081
"25017356500",6011,129,16,8,694,1,89,13,6961
"25017356601",3696,40,53,0,645,19,169,0,4622
"25017356602",3491,149,16,15,428,25,98,8,4230
"25017356701",4671,416,124,0,870,66,118,48,6313
"25017356702",5472,198,181,39,587,54,112,17,6660
"25017357100",3466,94,52,1,755,34,153,0,4555
"25017357200",2614,87,10,10,429,26,237,0,3413
"25017357300",2441,56,11,12,466,110,57,0,3153
"25017357400",1907,76,26,0,179,0,18,0,2206
"25017357500",1698,6,53,1,374,186,47,0,2365
"25017357600",1911,72,47,2,211,85,110,2,2440
"25017357700",2411,216,144,9,537,87,92,25,3521
"25017357800",3185,210,58,0,329,0,133,35,3950
"25017358100",3715,51,97,10,973,0,88,0,4934
"25017358300",3980,155,39,0,1370,94,71,0,5709
"25017358400",3563,188,29,0,1059,40,172,0,5051
"25017358500",3111,265,86,0,1351,96,16,1,4926
"25017358600",4032,88,0,28,2001,96,327,0,6572
"25017358700",3723,116,16,1,1108,0,8,0,4972
"25017359100",4858,139,18,0,917,58,417,34,6441
"25017359300",5642,247,211,0,902,94,96,0,7192
"25017360100",1216,85,197,0,128,0,279,0,1905
"25017360200",4122,35,127,1,432,106,113,16,4952
"25017361100",4985,283,6,1,503,7,92,0,5877
"25017361200",4504,152,27,0,490,53,92,20,5338
"25017361300",5080,233,50,3,230,2,77,1,5676
"25017362100",4135,229,50,12,458,34,106,0,5024
"25017363102",3683,202,173,0,1510,0,54,0,5622
"25017363103",2559,75,99,0,779,0,72,0,3584
"25017363104",4801,57,0,4,1219,32,307,19,6439
"25017363201",2597,65,0,0,664,20,0,1,3347
"25017363202",2914,79,0,0,642,1,52,0,3688
"25017364101",4558,195,0,0,272,65,239,0,5329
"25017364102",3976,234,34,251,522,52,190,52,5311
"25017365100",7004,77,0,0,647,0,76,12,7816
"25017365201",5041,85,0,0,449,0,146,0,5721
"25017365202",3728,104,0,0,580,0,127,15,4554
"25017366100",3546,128,113,0,687,121,85,0,4680
"25017366201",3093,55,0,0,379,0,38,13,3578
"25017366202",4172,166,1,2,613,14,82,3,5053
"25017367100",3261,114,10,19,472,3,129,0,4008
"25017367200",5719,97,142,11,973,14,247,0,7203
"25017368101",4944,236,36,0,556,80,210,0,6062
"25017368102",2676,45,199,8,825,8,332,7,4100
"25017368200",3177,300,181,1,508,73,191,133,4564
"25017368300",3559,446,284,59,905,175,1330,183,6941
"25017368400",3994,246,207,292,655,351,510,14,6269
"25017368500",1721,361,188,30,483,104,566,107,3560
"25017368600",3811,259,90,16,795,292,984,244,6491
"25017368700",1509,329,102,200,246,68,590,159,3203
"25017368800",2934,258,184,28,875,75,924,141,5419
"25017368901",3626,274,166,182,590,19,103,102,5062
"25017368902",1806,164,191,40,943,185,253,112,3694
"25017369000",901,45,140,14,196,51,25,5,1377
"25017369100",4176,89,50,1,346,75,329,14,5080
"25017370101",5511,328,187,0,507,29,492,44,7098
"25017370102",5216,350,161,0,821,119,627,90,7384
"25017370201",3062,80,81,2,422,113,151,2,3913
"25017370202",3649,72,70,0,378,51,218,16,4454
"25017370300",3768,474,248,0,880,0,297,39,5706
"25017370400",3989,301,219,37,597,7,241,7,5398
"25017373100",3241,293,150,82,725,27,140,17,4675
"25017373200",3096,375,32,55,565,82,313,235,4753
"25017373300",1956,116,213,19,253,48,31,0,2636
"25017373400",2581,76,7,0,459,100,158,0,3381
"25017373500",4216,209,133,0,593,14,131,15,5311
"25017373600",2194,296,11,0,150,5,115,5,2776
"25017373700",3371,58,45,2,414,18,81,0,3989
"25017373800",4327,244,35,11,801,22,151,1,5592
"25017373900",5451,324,0,0,993,0,324,0,7092
"25017374000",3287,91,18,141,912,24,74,0,4547
"25017374100",2711,146,73,125,693,351,96,11,4206
"25017374200",3186,147,115,15,929,28,191,70,4681
"25017374300",2986,74,54,1,335,1,70,0,3521
"25017374400",4780,137,189,1,745,0,196,0,6048
"25017374500",3485,61,255,0,820,26,183,26,4856
"25017374600",3897,211,26,0,619,118,412,12,5295
"25017374700",3540,229,93,28,1051,0,239,9,5189
"25017374800",2591,65,8,0,592,8,70,0,3334
"25017382100",4228,140,10,0,505,0,85,15,4983
"25017382200",4466,88,123,19,486,0,237,0,5419
"25017382300",4664,427,77,8,443,19,84,0,5722
"25017382400",4070,208,16,0,235,23,137,0,4689
"25017382500",3854,118,158,42,337,0,166,0,4675
"25017382601",3224,191,19,1,641,83,161,0,4320
"25017382602",3543,41,96,1,637,30,242,0,4590
"25017383101",1228,468,219,146,593,297,390,333,3674
"25017383102",1906,820,466,169,961,497,1840,930,7589
"25017383200",3383,401,498,326,1284,151,1155,372,7570
"25017383300",2079,218,16,9,317,99,185,77,3000
"25017383400",3358,313,574,140,893,0,549,184,6011
"25017383501",2260,468,420,45,1422,137,398,203,5353
"25017383502",1672,117,123,0,253,41,161,38,2405
"25017383600",3716,207,264,616,884,30,501,211,6429
"25017383700",4625,139,17,0,361,18,336,0,5496
"25017383800",4651,27,136,21,453,0,492,0,5780
"25017383901",6250,182,359,108,642,34,228,1,7804
"25017383902",4238,120,462,1,539,68,104,68,5600
"25017384001",1162,32,22,0,220,1,48,0,1485
"25017384002",3317,716,402,170,1816,0,433,76,6930
"25017385100",5462,133,173,0,519,5,109,0,6401
"25017385201",2110,339,57,0,43,21,117,37,2724
"25017385202",6400,308,228,1,938,2,225,0,8102
"25017386100",3780,66,0,0,277,46,25,0,4194
"25017387100",3733,143,13,3,166,6,68,3,4135
"25017387201",5347,153,108,1,236,104,57,0,6006
"25017387202",3612,92,0,0,40,21,115,0,3880
"25017388100",4033,96,22,0,858,39,44,0,5092
"25017388200",4204,685,39,98,570,54,245,84,5979
"25017388300",1097,781,138,162,1087,1207,826,1237,6535
"25017980000",0,0,0,0,0,0,0,0,0
"25019950100",1238,126,67,16,147,6,0,0,1600
"25019950200",3241,547,379,83,120,53,199,272,4894
"25019950307",326,9,0,0,3,2,0,0,340
"25019950400",2128,21,0,0,253,0,456,0,2858
"25019950500",1109,158,15,10,4,17,29,17,1359
"25019990000",0,0,0,0,0,0,0,0,0
"25021400100",2880,682,42,14,760,133,74,138,4723
"25021400200",3265,673,72,32,1202,277,197,71,5789
"25021400300",3126,363,85,15,734,105,164,2,4594
"25021400400",3853,794,111,0,824,123,225,87,6017
"25021400500",3722,485,88,15,856,91,192,33,5482
"25021400600",3530,461,32,0,1013,17,271,15,5339
"25021400700",2720,82,33,0,546,84,88,0,3553
"25021400800",3448,435,94,0,964,449,175,257,5822
"25021400900",2548,216,266,20,621,184,440,23,4318
"25021401000",2218,290,89,13,284,200,139,32,3265
"25021401100",3763,91,46,4,531,21,197,0,4653
"25021401200",4510,122,116,0,1702,82,15,0,6547
"25021402101",3029,219,369,0,209,18,116,0,3960
"25021402102",2823,234,249,27,285,205,360,211,4394
"25021402200",1803,35,240,0,67,0,86,0,2231
"25021402300",3949,25,72,0,281,0,229,0,4556
"25021402400",5170,132,207,5,455,38,453,11,6471
"25021402500",3452,76,62,1,147,14,69,1,3822
"25021403100",6020,212,47,0,487,1,300,0,7067
"25021403300",3809,54,0,0,209,0,60,0,4132
"25021403400",4770,214,148,52,861,68,126,75,6314
"25021403500",4609,125,0,39,892,19,170,4,5858
"25021404100",3253,62,59,0,603,87,210,43,4317
"25021404201",3474,51,0,0,186,0,51,0,3762
"25021404202",2679,80,0,0,272,8,18,0,3057
"25021404301",4636,142,17,0,481,45,27,46,5394
"25021404302",2879,104,0,0,490,0,165,7,3645
"25021404400",3789,59,45,17,260,78,290,9,4547
"25021405100",5031,18,75,0,553,0,127,0,5804
"25021406101",5022,276,0,0,267,0,108,0,5673
"25021406102",5514,240,0,0,754,0,567,0,7075
"25021407100",7061,475,0,0,351,15,243,28,8173
"25021408101",7215,255,0,0,530,26,365,15,8406
"25021408102",4255,105,44,0,316,9,88,0,4817
"25021409101",3794,276,0,1,63,0,15,0,4149
"25021409102",4757,214,24,0,40,14,81,7,5137
"25021410100",5738,226,62,0,127,0,33,32,6218
"25021410300",4245,51,52,0,331,0,63,0,4742
"25021410400",5194,389,186,17,334,0,196,15,6331
"25021411100",7327,389,86,74,273,0,115,0,8264
"25021411200",6123,138,0,0,605,0,115,0,6981
"25021411301",4710,165,101,0,98,0,21,17,5112
"25021411302",3234,74,2,0,173,0,22,0,3505
"25021412100",5578,189,0,0,456,0,134,0,6357
"25021412200",3365,35,11,0,165,0,50,0,3626
"25021412300",4219,100,41,0,525,1,89,0,4975
"25021413100",5140,164,99,0,329,0,115,63,5910
"25021413200",4874,383,72,52,365,0,142,0,5888
"25021413300",4465,210,60,0,325,34,81,109,5284
"25021413401",2661,210,110,40,81,0,176,0,3278
"25021413402",2523,210,165,65,1215,68,111,0,4357
"25021413500",2524,206,499,0,504,584,225,584,5126
"25021414100",3602,65,299,0,1123,28,184,0,5301
"25021414200",5510,160,475,4,1407,4,158,4,7722
"25021414300",4019,300,149,1,525,13,103,13,5123
"25021415101",3780,199,100,38,280,133,130,0,4660
"25021415102",6613,263,279,260,726,14,318,0,8473
"25021415200",4035,270,421,56,245,0,153,0,5180
"25021415300",3581,32,27,0,97,0,37,0,3774
"25021416101",4440,270,188,43,495,0,114,26,5576
"25021416102",1826,76,59,0,351,0,29,4,2345
"25021416200",3611,288,2048,136,513,32,121,100,6849
"25021416300",3462,223,828,121,268,15,356,14,5287
"25021416400",5664,39,63,0,334,0,377,0,6477
"25021417100",2950,140,83,0,1090,176,59,0,4498
"25021417200",3912,449,112,158,3148,484,56,37,8356
"25021417300",1947,143,155,0,414,26,83,0,2768
"25021417400",2334,87,0,0,119,0,58,0,2598
"25021417501",2877,323,36,0,1612,182,56,37,5123
"25021417502",1793,241,224,32,1725,366,141,39,4561
"25021417601",3197,85,155,0,1520,67,74,0,5098
"25021417602",3106,477,35,0,917,453,5,1,4994
"25021417701",3000,307,277,0,1176,140,188,0,5088
"25021417702",1895,175,469,34,220,10,57,10,2870
"25021417801",4507,138,67,0,172,0,136,0,5020
"25021417802",1005,453,158,46,1016,532,1,48,3259
"25021417901",3742,844,684,3,705,84,183,63,6308
"25021417902",2298,291,39,57,715,63,97,19,3579
"25021418002",4217,135,310,27,1914,125,185,0,6913
"25021418003",1462,287,213,0,786,0,245,0,2993
"25021418004",2462,544,141,67,931,165,46,42,4398
"25021418101",2791,201,347,51,1149,29,74,11,4653
"25021418102",2686,107,191,29,467,56,452,8,3996
"25021418200",4531,577,521,129,1192,31,243,94,7318
"25021419100",4988,130,293,0,348,68,128,0,5955
"25021419200",4158,136,203,32,516,17,190,26,5278
"25021419300",2432,364,304,86,596,35,69,11,3897
"25021419400",2529,87,0,0,249,25,6,0,2896
"25021419500",2383,49,2,1,309,7,90,0,2841
"25021419600",5868,259,385,0,687,139,159,0,7497
"25021419700",3029,188,0,0,420,0,32,0,3669
"25021419800",3738,177,27,0,249,5,123,5,4324
"25021420100",3120,245,1879,391,1475,490,242,67,7909
"25021420201",1050,138,872,417,877,62,134,9,3559
"25021420202",1827,90,2823,480,1147,0,252,28,6647
"25021420301",2706,167,2916,344,767,30,396,50,7376
"25021420302",2433,210,3936,283,1125,170,239,199,8595
"25021421100",4127,489,519,58,239,38,720,19,6209
"25021421200",4449,201,367,7,198,18,264,0,5504
"25021422100",5054,279,234,28,540,51,106,16,6308
"25021422200",6185,260,70,0,361,61,56,0,6993
"25021422301",2842,10,0,0,127,75,30,0,3084
"25021422302",5085,140,408,47,438,0,56,20,6194
"25021422400",5587,696,475,27,442,90,341,0,7658
"25021422501",3354,433,404,0,338,147,134,47,4857
"25021422502",3681,688,216,171,563,66,89,171,5645
"25021422600",5678,403,100,1,615,0,188,89,7074
"25021422700",3147,135,15,0,133,84,23,0,3537
"25021422800",3543,140,6,0,164,44,0,7,3904
"25021423100",7401,350,12,0,112,0,42,0,7917
"25021440100",7440,452,0,13,524,0,143,0,8572
"25021441202",2698,40,11,0,70,0,57,0,2876
"25021441203",3309,327,5,0,28,0,0,0,3669
"25021441204",4138,208,0,0,30,0,8,12,4396
"25021442101",4600,103,43,0,77,2,0,0,4825
"25021442102",6879,165,71,0,396,16,155,0,7682
"25021442103",6299,18,30,0,611,0,120,0,7078
"25021442201",3564,146,72,0,220,0,37,0,4039
"25021442202",6632,867,10,0,246,13,329,15,8112
"25021443101",7038,36,244,0,581,0,229,0,8128
"25021443102",7798,304,72,0,321,39,74,50,8658
"25021456101",3069,81,494,0,162,32,28,0,3866
"25021456102",3742,293,673,0,234,73,68,86,5169
"25021456200",2132,99,794,39,218,5,8,5,3300
"25021456301",993,568,87,0,75,0,28,0,1751
"25021456302",3869,365,632,17,118,18,0,55,5074
"25021456401",2144,115,140,100,220,18,112,0,2849
"25021456402",4753,38,268,197,255,0,108,0,5619
"25021457100",3652,50,468,0,230,0,151,0,4551
"25021457200",5137,128,48,0,307,66,85,0,5771
"25023500101",3212,310,62,0,254,0,237,0,4075
"25023500103",2070,114,0,0,75,0,0,0,2259
"25023500104",3849,162,25,0,164,22,77,0,4299
"25023501101",3324,178,0,0,46,16,42,0,3606
"25023501102",7065,193,67,3,413,9,0,0,7750
"25023501201",3421,73,0,0,117,5,90,8,3714
"25023501202",6927,101,19,0,105,8,62,0,7222
"25023502101",5277,175,99,4,274,20,23,0,5872
"25023502102",5024,214,310,0,160,0,85,0,5793
"25023502200",5024,547,146,0,72,24,111,15,5939
"25023503101",6818,370,0,0,20,0,93,0,7301
"25023503102",6122,123,66,0,392,0,4,8,6715
"25023504101",5000,153,0,0,193,0,58,0,5404
"25023504102",4858,88,0,0,34,32,12,15,5039
"25023505101",6124,76,15,0,140,0,79,0,6434
"25023505102",4801,166,0,2,99,0,41,0,5109
"25023505200",6024,172,0,47,285,68,65,0,6661
"25023506101",6238,311,0,6,104,4,145,7,6815
"25023506102",5440,146,0,0,374,0,85,22,6067
"25023506202",2466,159,0,0,20,13,9,13,2680
"25023506203",4706,99,15,0,167,0,116,0,5103
"25023506204",4639,245,30,0,59,43,17,0,5033
"25023507101",5042,119,109,0,139,0,156,0,5565
"25023507103",4064,141,0,2,21,0,0,0,4228
"25023507104",5083,165,13,4,112,0,23,0,5400
"25023508101",6097,207,43,0,236,92,175,42,6892
"25023508102",4752,180,50,0,135,11,84,12,5224
"25023508200",5721,181,41,15,110,0,45,0,6113
"25023509101",5377,507,0,15,533,0,142,0,6574
"25023509102",5824,79,0,0,119,0,153,0,6175
"25023510100",3332,83,596,80,290,70,237,0,4688
"25023510200",3671,784,1657,247,604,5,1143,87,8198
"25023510300",614,266,1766,527,615,172,467,103,4530
"25023510400",776,151,1770,266,331,49,305,85,3733
"25023510501",1271,184,1126,228,296,54,78,27,3264
"25023510502",2046,171,2097,192,777,82,478,11,5854
"25023510503",1536,290,1332,341,260,56,97,57,3969
"25023510600",1704,67,356,243,248,37,92,0,2747
"25023510700",2687,399,1198,297,638,351,246,201,6017
"25023510800",914,397,2238,1351,328,239,327,57,5851
"25023510900",164,908,300,791,160,62,29,534,2948
"25023511000",734,450,1222,109,241,360,303,332,3751
"25023511100",2772,179,1295,94,651,110,293,0,5394
"25023511200",2175,540,1936,107,394,166,226,228,5772
"25023511301",2123,214,1812,391,926,162,439,7,6074
"25023511302",1962,314,756,439,241,113,219,74,4118
"25023511400",927,232,1815,238,597,36,343,22,4210
"25023511500",954,131,1841,357,907,165,354,249,4958
"25023511600",2223,655,1971,718,696,281,544,258,7346
"25023511701",2920,162,751,153,458,15,178,0,4637
"25023511702",1963,198,497,26,247,4,154,28,3117
"25023520100",5993,156,14,0,139,2,113,2,6419
"25023520201",3195,227,65,0,160,7,26,0,3680
"25023520202",5030,159,497,0,263,0,227,0,6176
"25023521101",3750,287,42,12,210,13,84,13,4411
"25023521102",3052,57,0,0,102,60,37,46,3354
"25023521201",2375,405,0,17,87,75,9,4,2972
"25023521202",3699,192,67,9,47,0,34,17,4065
"25023522101",4296,160,178,4,60,9,95,0,4802
"25023522102",5189,143,0,0,184,6,54,0,5576
"25023523100",2795,114,17,0,262,19,65,19,3291
"25023523201",2669,58,0,0,121,0,14,0,2862
"25023523202",7305,242,18,0,86,23,99,0,7773
"25023524101",2279,46,176,0,132,0,63,0,2696
"25023524102",3585,156,134,15,152,45,82,0,4169
"25023525101",5523,442,414,45,288,0,12,11,6735
"25023525104",5063,373,23,20,123,68,25,201,5896
"25023525203",4938,429,96,0,38,15,47,0,5563
"25023525204",3176,44,214,0,69,0,12,0,3515
"25023525300",0,0,0,0,0,0,0,0,0
"25023526100",6917,330,0,0,192,0,134,14,7587
"25023530100",3313,176,0,0,175,0,158,0,3822
"25023530200",3072,374,69,8,183,9,73,58,3846
"25023530300",3320,334,57,5,138,0,44,0,3898
"25023530400",5222,107,21,1,116,0,128,0,5595
"25023530500",4439,376,57,35,71,48,0,0,5026
"25023530600",4308,393,252,0,286,0,17,0,5256
"25023530700",4189,229,0,0,76,0,25,0,4519
"25023530801",5087,287,32,0,194,11,207,11,5829
"25023530802",4804,418,29,2,44,8,79,2,5386
"25023530901",6959,436,68,0,373,0,83,32,7951
"25023530902",4056,411,53,0,124,0,8,0,4652
"25023540101",3732,243,40,0,11,0,0,65,4091
"25023540102",2344,130,0,12,15,0,113,12,2626
"25023540103",3844,128,68,0,42,73,41,32,4228
"25023541100",4755,216,27,0,247,54,69,1,5369
"25023542101",6696,424,121,0,135,0,140,0,7516
"25023542102",1965,114,59,38,65,0,25,0,2266
"25023542200",5633,165,177,0,175,0,0,0,6150
"25023542300",5679,853,50,17,188,170,175,54,7186
"25023543100",2639,111,0,0,84,0,81,0,2915
"25023544100",5001,505,57,0,79,11,20,11,5684
"25023544200",5255,192,126,0,234,10,134,0,5951
"25023545100",6282,190,80,12,494,19,201,21,7299
"25023545200",4256,620,150,4,315,0,77,0,5422
"25023545300",2979,340,78,1,196,89,8,1,3692
"25023545400",4232,876,131,20,418,56,0,20,5753
"25023560100",5812,183,27,0,64,0,0,0,6086
"25023561100",4251,120,0,32,359,24,79,0,4865
"25023561200",214,87,0,0,18,0,0,0,319
"25023990003",0,0,0,0,0,0,0,0,0
"25025000100",2187,275,125,16,582,56,565,28,3834
"25025000201",2293,261,61,82,318,105,259,175,3554
"25025000202",2039,490,237,204,392,99,216,232,3909
"25025000301",1735,255,25,8,214,79,15,91,2422
"25025000302",1649,288,97,2,494,115,0,0,2645
"25025000401",3311,683,82,26,677,421,336,195,5731
"25025000402",2118,544,7,41,607,83,99,47,3546
"25025000502",1450,579,22,1,322,122,105,71,2672
"25025000503",1260,346,38,0,140,108,56,29,1977
"25025000504",2507,970,176,9,461,272,170,101,4666
"25025000601",1724,541,19,17,505,143,141,113,3203
"25025000602",1655,867,242,93,685,193,258,356,4349
"25025000701",1932,523,120,79,443,288,183,68,3636
"25025000703",822,1073,46,211,240,199,61,72,2724
"25025000704",2135,699,210,95,337,283,250,269,4278
"25025000802",2865,1739,196,370,1664,424,1200,466,8924
"25025000803",405,333,182,36,408,229,124,202,1919
"25025010103",212,171,15,10,99,197,29,51,784
"25025010104",1600,488,28,34,263,300,119,118,2950
"25025010203",2522,1253,87,109,407,227,220,245,5070
"25025010204",786,544,13,0,269,283,19,40,1954
"25025010300",206,73,4,8,80,26,91,4,492
"25025010403",939,752,182,68,528,424,272,112,3277
"25025010404",643,1761,74,31,245,257,77,129,3217
"25025010405",564,367,253,140,160,225,163,32,1904
"25025010408",889,237,40,0,165,140,82,18,1571
"25025010500",1320,537,68,92,266,283,67,89,2722
"25025010600",2125,233,82,62,170,66,94,53,2885
"25025010701",1963,212,0,16,400,21,118,25,2755
"25025010702",1892,131,27,15,67,35,41,95,2303
"25025010801",2510,95,0,1,230,8,141,29,3014
"25025010802",2376,174,3,40,260,30,64,42,2989
"25025020101",3425,210,66,0,306,0,1,17,4025
"25025020200",2866,538,58,16,356,85,125,32,4076
"25025020301",1456,134,40,0,429,122,25,2,2208
"25025020302",994,125,0,15,36,35,9,0,1214
"25025020303",1455,334,90,52,554,58,1,18,2562
"25025030100",1565,383,0,0,27,49,33,0,2057
"25025030200",1218,236,12,26,118,37,45,8,1700
"25025030300",3646,570,154,183,383,89,239,141,5405
"25025030400",2044,199,10,5,148,0,44,0,2450
"25025030500",2258,162,0,8,160,8,58,1,2655
"25025040100",2103,46,0,0,119,0,24,8,2300
"25025040200",900,109,109,166,136,343,280,154,2197
"25025040300",3123,236,14,347,145,188,67,126,4246
"25025040401",1888,250,86,0,287,60,28,60,2659
"25025040600",2410,230,80,3,121,1,61,0,2906
"25025040801",1596,175,335,655,528,478,408,121,4296
"25025050101",2421,799,192,34,1915,507,2594,1006,9468
"25025050200",2919,373,202,9,1621,326,3128,596,9174
"25025050300",646,381,294,117,422,337,504,416,3117
"25025050400",1561,144,56,17,480,63,1131,141,3593
"25025050500",1436,195,21,1,222,86,916,160,3037
"25025050600",1215,187,6,22,885,143,1664,233,4355
"25025050700",2298,473,40,86,1682,244,2804,601,8228
"25025050901",2193,722,137,1,1573,282,2651,808,8367
"25025051000",2732,493,46,71,1012,9,1264,240,5867
"25025051101",3968,470,371,143,1140,126,2324,527,9069
"25025051200",1400,187,56,48,437,208,698,256,3290
"25025060101",3175,346,0,0,50,24,53,24,3672
"25025060200",1770,248,0,1,62,32,11,12,2136
"25025060301",2854,203,0,2,38,3,34,0,3134
"25025060400",4159,405,62,0,29,30,55,57,4797
"25025060501",3155,210,57,12,172,102,71,80,3859
"25025060600",2049,93,2,4,312,1,7,0,2468
"25025060700",451,165,589,246,505,398,488,361,3203
"25025060800",3645,385,0,0,317,90,48,0,4485
"25025061000",1232,799,100,316,405,493,221,593,4159
"25025061101",306,412,94,414,461,409,359,392,2847
"25025061200",2749,224,97,7,95,71,155,11,3409
"25025070101",2422,458,51,93,1156,555,226,70,5031
"25025070200",316,186,90,10,1694,1376,15,77,3764
"25025070300",3253,517,84,0,430,110,125,235,4754
"25025070402",52,57,155,67,560,731,37,71,1730
"25025070500",3303,472,199,145,1064,553,661,387,6784
"25025070600",1716,100,49,3,426,13,124,14,2445
"25025070700",1300,170,843,102,320,77,115,53,2980
"25025070800",2161,537,532,84,500,172,276,243,4505
"25025070900",1639,334,341,219,495,308,505,208,4049
"25025071101",1354,317,470,322,850,660,293,259,4525
"25025071201",982,398,368,304,742,322,228,464,3808
"25025080100",156,68,667,352,325,95,119,120,1902
"25025080300",168,152,633,397,380,113,429,226,2498
"25025080401",404,84,769,599,337,335,625,451,3604
"25025080500",354,279,759,437,721,618,1005,926,5099
"25025080601",306,367,432,441,369,238,299,277,2729
"25025080801",244,221,421,591,585,480,528,490,3560
"25025080900",1365,920,353,21,324,432,152,33,3600
"25025081001",1380,1011,429,434,962,571,371,339,5497
"25025081100",1696,843,508,70,607,352,349,224,4649
"25025081200",499,319,606,974,769,254,909,536,4866
"25025081300",665,527,1817,691,971,633,1310,802,7416
"25025081400",608,372,1129,398,302,131,176,191,3307
"25025081500",187,116,985,403,302,87,361,135,2576
"25025081700",41,77,1511,873,287,488,111,421,3809
"25025081800",142,90,1614,797,389,201,628,287,4148
"25025081900",287,157,1591,779,306,92,673,326,4211
"25025082000",18,158,1793,689,82,97,59,242,3138
"25025082100",336,72,1961,1308,592,655,923,812,6659
"25025090100",275,49,2770,864,587,403,577,499,6024
"25025090200",77,19,726,486,640,287,533,274,3042
"25025090300",34,251,1489,377,598,619,571,574,4513
"25025090400",179,430,1749,553,538,120,594,545,4708
"25025090600",95,35,1078,303,427,115,191,101,2345
"25025090700",2323,210,270,186,847,872,274,398,5380
"25025090901",673,689,445,319,779,999,637,443,4984
"25025091001",1559,142,246,148,720,155,6,62,3038
"25025091100",2666,340,219,87,1506,714,202,117,5851
"25025091200",1088,205,439,305,747,279,209,379,3651
"25025091300",180,152,794,219,938,220,290,245,3038
"25025091400",264,111,818,240,496,413,263,421,3026
"25025091500",242,95,1395,573,1993,457,487,200,5442
"25025091600",339,186,1278,364,893,298,292,240,3890
"25025091700",232,143,1551,295,848,351,729,429,4578
"25025091800",232,328,1279,473,817,408,499,461,4497
"25025091900",216,177,2642,443,363,291,416,362,4910
"25025092000",326,164,2769,955,646,342,674,547,6423
"25025092101",1541,494,679,399,2665,700,571,203,7252
"25025092200",716,85,1081,189,724,189,288,215,3487
"25025092300",84,20,2129,711,411,63,289,94,3801
"25025092400",391,31,3366,918,358,504,755,665,6988
"25025100100",251,451,3094,1485,721,283,1078,587,7950
"25025100200",139,0,1779,377,226,148,264,75,3008
"25025100300",239,107,2270,430,102,25,307,137,3617
"25025100400",572,68,2848,659,404,409,494,0,5454
"25025100500",942,122,3695,865,787,418,634,236,7699
"25025100601",2198,93,1093,238,1277,258,292,21,5470
"25025100603",1159,59,153,19,339,4,20,2,1755
"25025100700",3816,234,190,19,121,18,147,0,4545
"25025100800",2919,163,2284,162,704,141,49,21,6443
"25025100900",1190,157,1759,157,524,321,401,94,4603
"25025101001",182,64,4429,1048,112,56,458,74,6423
"25025101002",122,122,3287,658,394,237,782,424,6026
"25025101101",177,103,2866,417,52,8,529,157,4309
"25025101102",69,399,3305,1211,188,58,142,532,5904
"25025110103",2620,274,666,431,1268,557,902,478,7196
"25025110201",599,97,851,182,434,55,586,110,2914
"25025110301",1051,160,574,3,685,0,844,74,3391
"25025110401",1554,251,1204,58,661,242,980,486,5436
"25025110403",1988,146,1485,445,872,41,1234,244,6455
"25025110501",2353,317,508,39,381,11,516,60,4185
"25025110502",2645,180,521,0,391,53,640,63,4493
"25025110601",2254,75,59,33,70,1,56,1,2549
"25025110607",4070,397,55,5,299,80,317,97,5320
"25025120103",1250,75,82,12,132,33,73,18,1675
"25025120104",1325,215,181,74,168,187,150,375,2675
"25025120105",1567,189,72,11,232,24,52,40,2187
"25025120201",2200,301,509,76,428,293,683,443,4933
"25025120301",2212,188,748,228,1185,207,1127,398,6293
"25025120400",4165,749,314,189,765,143,724,151,7200
"25025120500",1291,148,178,164,471,144,851,203,3450
"25025120600",1894,149,149,12,409,14,413,26,3066
"25025120700",1314,150,70,22,316,48,110,63,2093
"25025130100",4898,144,90,0,689,39,251,0,6111
"25025130200",4013,122,121,0,635,16,358,8,5273
"25025130300",3907,17,126,4,582,0,386,0,5022
"25025130402",4173,301,118,2,309,1,347,155,5406
"25025130404",2215,89,17,3,534,33,497,13,3401
"25025130406",1683,226,1472,592,513,71,747,317,5621
"25025140102",1866,47,1544,253,647,118,696,117,5288
"25025140105",1451,61,1662,29,579,26,912,0,4720
"25025140106",646,115,585,129,314,172,347,276,2584
"25025140107",860,71,1188,74,360,48,575,125,3301
"25025140201",1472,96,421,11,310,80,486,76,2952
"25025140202",2328,248,1809,123,1164,154,1513,202,7541
"25025140300",1462,208,2879,542,941,194,1060,306,7592
"25025140400",953,152,5893,431,763,205,1000,412,9809
"25025160101",2596,681,352,114,3363,1990,5093,2237,16426
"25025160200",1007,341,173,46,1781,712,2441,918,7419
"25025160300",1434,180,145,0,358,72,376,79,2644
"25025160400",925,334,160,80,920,126,1359,385,4289
"25025160501",1735,478,270,151,1762,623,2647,914,8580
"25025160502",2281,416,152,77,1185,233,1950,507,6801
"25025160601",1670,394,186,102,910,402,934,464,5062
"25025160602",2186,580,146,87,1551,249,1894,430,7123
"25025170100",4988,1025,192,0,1440,161,1593,195,9594
"25025170200",2880,486,348,1,883,125,943,74,5740
"25025170300",6795,359,437,8,1086,28,1179,0,9892
"25025170400",3409,726,170,2,913,185,1335,218,6958
"25025170501",2324,353,86,57,639,529,891,403,5282
"25025170502",2247,155,17,13,428,97,247,0,3204
"25025170601",3437,830,65,20,1091,31,1316,336,7126
"25025170701",1112,567,60,58,232,0,511,27,2567
"25025170702",2618,719,369,149,1576,641,1897,758,8727
"25025170800",3156,689,245,1,959,43,1230,107,6430
"25025180101",4006,315,113,0,175,42,432,16,5099
"25025180200",3417,316,9,35,81,125,286,35,4304
"25025180301",2935,114,0,11,196,0,6,34,3296
"25025180400",1704,72,19,0,61,8,62,8,1934
"25025180500",3134,516,103,26,133,49,218,43,4222
"25025980101",32,180,7,94,17,22,17,31,400
"25025980300",12,69,14,107,0,40,0,46,288
"25025980700",4,0,0,0,0,0,0,0,4
"25025981000",0,0,0,0,0,0,0,0,0
"25025981100",32,9,31,138,0,0,0,0,210
"25025981201",0,0,0,0,0,0,0,0,0
"25025981202",0,0,0,0,0,0,0,0,0
"25025981300",296,12,36,0,147,0,169,0,660
"25025981501",0,0,0,0,0,0,0,0,0
"25025981502",0,0,0,0,0,0,0,0,0
"25025981600",0,0,0,0,0,0,0,0,0
"25025981700",0,0,0,0,0,0,0,0,0
"25025981800",21,0,0,0,0,0,0,0,21
"25025990101",0,0,0,0,0,0,0,0,0
"25027700100",5366,375,27,23,203,24,155,24,6197
"25027701100",6856,841,58,24,509,94,161,88,8631
"25027702200",2643,245,7,0,155,5,29,20,3104
"25027703100",3189,1098,11,0,119,71,125,296,4909
"25027703200",2809,434,6,7,78,46,212,35,3627
"25027703300",3151,116,10,0,245,35,154,0,3711
"25027704200",2710,151,5,2,71,4,70,5,3018
"25027705100",6761,981,0,0,99,0,56,0,7897
"25027706100",4067,261,0,0,62,8,0,0,4398
"25027707100",3139,769,87,0,124,38,85,79,4321
"25027707200",1157,272,55,0,249,44,217,55,2049
"25027707300",2933,880,9,8,108,14,162,26,4140
"25027707400",3887,275,37,1,140,72,150,24,4586
"25027707500",3926,377,0,4,512,0,526,10,5355
"25027708100",6738,308,47,0,143,13,82,0,7331
"25027709100",2992,335,40,0,425,145,320,60,4317
"25027709201",5704,698,82,0,360,78,276,232,7430
"25027709202",4972,427,400,95,1220,36,1223,125,8498
"25027709400",2732,483,97,21,463,319,602,366,5083
"25027709501",1774,12,117,0,95,15,78,1,2092
"25027709502",4614,302,337,48,505,2,431,20,6259
"25027709600",1734,370,356,31,293,23,484,57,3348
"25027709701",3583,339,519,2,749,161,671,241,6265
"25027709702",1743,257,56,32,268,8,277,13,2654
"25027710100",2480,351,178,5,789,106,816,228,4953
"25027710200",5328,524,179,210,300,593,344,591,8069
"25027710300",2601,478,67,7,209,24,329,184,3899
"25027710400",1547,236,5,9,279,13,261,56,2406
"25027710500",1621,507,80,0,543,211,673,272,3907
"25027710600",4066,1098,184,196,995,451,1470,926,9386
"25027710700",551,404,0,24,144,168,273,290,1854
"25027710800",2084,517,120,25,351,624,598,592,4911
"25027711000",1482,598,94,73,492,90,605,193,3627
"25027711100",3213,260,117,44,259,18,80,57,4048
"25027712101",5360,636,58,1,213,99,132,26,6525
"25027712102",3802,111,65,0,126,15,142,22,4283
"25027713100",5436,780,68,0,205,0,120,22,6631
"25027715100",4545,122,0,10,271,6,124,31,5109
"25027716100",6492,296,111,0,552,35,314,145,7945
"25027716200",1726,360,164,9,300,177,214,177,3127
"25027716300",2595,366,1,7,346,30,462,51,3858
"25027717100",2693,68,25,3,97,0,75,0,2961
"25027718100",3904,102,38,1,313,3,100,14,4475
"25027719100",7101,390,82,0,182,2,140,0,7897
"25027720100",3055,157,9,5,198,0,155,5,3584
"25027721101",1736,84,0,0,9,0,12,0,1841
"25027721102",7507,165,14,90,186,88,182,9,8241
"25027722100",4998,251,0,0,107,0,76,0,5432
"25027723100",3309,431,8,0,124,44,54,64,4034
"25027724100",3041,263,116,0,137,0,16,0,3573
"25027725100",4141,308,67,0,175,0,37,0,4728
"25027726100",5308,346,40,0,173,135,140,118,6260
"25027726200",4741,693,15,28,242,1,300,2,6022
"25027727100",3648,126,51,98,382,0,437,2,4744
"25027728100",3873,161,13,0,78,0,29,0,4154
"25027728200",3381,61,10,1,241,13,101,13,3821
"25027728300",4321,56,55,2,93,10,109,0,4646
"25027728400",4481,188,41,2,303,6,37,6,5064
"25027729100",3250,186,26,0,25,6,35,23,3551
"25027729200",2315,66,32,6,22,29,10,2,2482
"25027730100",3754,304,1506,109,477,52,242,185,6629
"25027730200",4245,419,715,50,165,0,341,0,5935
"25027730300",3850,358,184,0,208,8,451,49,5108
"25027730401",2848,636,389,127,942,114,1238,509,6803
"25027730402",1088,50,318,65,123,0,294,0,1938
"25027730500",2001,484,426,49,164,202,544,304,4174
"25027730600",5795,299,697,0,528,52,435,52,7858
"25027730700",5144,301,984,52,518,33,686,14,7732
"25027730801",3000,116,105,8,343,0,103,0,3675
"25027730802",1517,99,54,0,251,20,12,20,1973
"25027730901",2829,289,248,4,217,40,274,8,3909
"25027730902",2362,359,137,4,101,0,206,0,3169
"25027731001",1834,45,98,12,225,32,305,0,2551
"25027731002",3454,772,1027,73,637,221,438,346,6968
"25027731101",2016,629,255,72,405,103,395,432,4307
"25027731102",1857,182,362,0,272,49,247,130,3099
"25027731202",0,0,0,0,0,0,0,0,0
"25027731203",1222,2001,426,137,843,608,646,1115,6998
"25027731204",969,507,157,5,302,174,714,455,3283
"25027731300",927,896,297,175,873,367,936,866,5337
"25027731400",1477,1245,300,322,383,439,817,1154,6137
"25027731500",1684,1276,546,481,332,524,1194,1190,7227
"25027731600",1806,1234,276,137,387,450,153,122,4565
"25027731700",820,687,339,66,91,94,204,183,2484
"25027731800",2673,1205,727,178,854,776,1155,917,8485
"25027731900",2193,1144,934,163,575,462,1028,780,7279
"25027732001",954,1096,163,336,257,704,864,1550,5924
"25027732002",2264,402,453,33,488,109,311,116,4176
"25027732201",2099,250,231,45,100,91,312,17,3145
"25027732202",2240,420,312,6,168,20,25,168,3359
"25027732203",1287,343,217,8,466,32,196,213,2762
"25027732301",3131,138,298,0,399,27,128,0,4121
"25027732302",2249,449,371,83,771,77,408,234,4642
"25027732400",2978,1762,673,330,637,190,1034,1486,9090
"25027732500",905,560,122,9,105,94,440,285,2520
"25027732600",2275,833,569,225,663,319,1290,403,6577
"25027732700",1963,485,375,454,361,352,383,593,4966
"25027732801",3803,246,362,103,369,0,27,134,5044
"25027732802",2714,363,533,41,611,71,308,293,4934
"25027732901",4421,1018,739,236,557,194,936,340,8441
"25027732902",20,15,0,0,0,0,0,0,35
"25027733000",1730,842,357,14,635,321,913,565,5377
"25027733101",1627,68,93,27,191,0,100,14,2120
"25027733102",1685,110,145,24,129,14,353,65,2525
"25027735100",5861,301,13,3,142,36,283,0,6639
"25027735200",3808,151,76,0,174,28,354,28,4619
"25027736100",2635,59,22,0,18,28,22,0,2784
"25027736200",3058,144,144,0,62,1,40,15,3464
"25027736300",2298,112,16,0,70,10,114,19,2639
"25027736400",2840,134,26,7,26,0,81,0,3114
"25027736500",4257,107,0,2,50,0,228,0,4644
"25027737100",5173,151,0,65,71,56,81,118,5715
"25027737200",1483,60,14,0,30,11,55,11,1664
"25027737300",5350,336,93,0,203,17,257,1,6257
"25027738100",3025,258,129,5,1149,23,186,100,4875
"25027738201",3870,72,22,0,221,0,29,0,4214
"25027738202",4527,531,18,13,557,58,96,0,5800
"25027739100",6350,364,269,43,2178,217,151,99,9671
"25027739200",4267,363,197,0,1404,231,142,0,6604
"25027739300",3136,156,16,22,448,5,24,0,3807
"25027739400",6556,309,140,0,1477,36,467,22,9007
"25027739500",6274,94,151,0,989,54,289,54,7905
"25027740101",4530,94,1,2,673,0,141,1,5442
"25027740102",4984,329,46,5,745,0,359,0,6468
"25027740200",2378,97,190,1,319,5,97,5,3092
"25027741101",3466,160,94,24,628,0,75,0,4447
"25027741102",4348,75,13,26,880,10,102,10,5464
"25027742300",3415,90,15,0,568,0,38,0,4126
"25027742401",4467,50,55,0,589,0,60,0,5221
"25027742402",1423,28,244,0,1498,109,25,79,3406
"25027743100",6641,475,14,0,382,1,58,0,7571
"25027744101",6286,416,23,23,816,0,510,33,8107
"25027744102",4497,219,76,73,249,108,169,75,5466
"25027744200",6071,212,65,14,227,199,509,0,7297
"25027744300",2414,459,338,0,467,426,378,419,4901
"25027744400",3026,652,39,0,385,113,324,380,4919
"25027745100",5456,116,9,0,286,0,219,0,6086
"25027746100",5611,84,26,1,107,10,223,0,6062
"25027747101",4771,146,0,0,400,0,270,0,5587
"25027747102",3242,220,70,20,61,41,75,0,3729
"25027748100",2757,257,10,47,122,0,58,0,3251
"25027749100",7055,280,49,0,131,90,41,0,7646
"25027749200",5405,353,0,0,14,0,62,0,5834
"25027750100",5539,447,29,0,237,65,187,0,6504
"25027750200",6084,275,35,1,251,0,120,0,6766
"25027750300",2522,17,0,0,22,1,42,0,2604
"25027751101",5913,285,1,0,0,0,0,0,6199
"25027751102",2716,15,0,1,88,1,0,0,2821
"25027752100",8010,361,39,0,91,0,93,0,8594
"25027753100",5982,520,0,31,236,134,237,96,7236
"25027753200",6266,194,26,1,81,0,115,1,6684
"25027754100",5443,300,118,15,158,135,36,147,6352
"25027754200",2741,432,56,27,276,156,157,91,3936
"25027754300",1873,572,127,225,178,84,217,11,3287
"25027754400",2581,510,38,0,341,0,99,0,3569
"25027755100",2406,421,75,33,173,17,55,33,3213
"25027755200",6840,334,38,1,192,31,143,0,7579
"25027756101",4055,317,77,0,19,4,10,32,4514
"25027756102",7913,198,0,0,262,34,237,2,8646
"25027757100",3061,424,157,9,367,237,1010,307,5572
"25027757200",1216,260,0,9,429,209,973,245,3341
"25027757300",1451,662,23,16,567,277,708,641,4345
"25027757400",2058,56,68,0,340,252,620,203,3597
"25027757500",3433,319,24,0,459,98,434,203,4970
"25027758101",1640,100,0,0,18,0,34,0,1792
"25027758102",6581,608,24,5,197,48,138,118,7719
"25027759100",2019,119,22,0,93,0,33,0,2286
"25027760100",3131,183,0,0,55,7,2,0,3378
"25027761100",4368,704,0,1,20,30,40,30,5193
"25027761200",3650,179,66,16,1290,241,686,213,6341
"25027761300",2811,122,0,40,243,60,72,86,3434
"25027761400",4784,210,9,147,355,1,168,12,5686
"26001000100",1512,166,0,0,8,4,5,0,1695
"26001970100",2045,334,0,2,36,6,29,8,2460
"26001970400",2261,515,1,0,33,15,29,0,2854
"26001970500",1694,347,0,2,42,8,46,0,2139
"26001970600",1363,189,5,1,30,23,5,10,1626
"26001990000",0,0,0,0,0,0,0,0,0
"26003000100",2814,569,0,0,218,62,4,14,3681
"26003000200",2204,365,0,0,193,30,67,8,2867
"26003000300",1733,219,0,0,67,12,0,0,2031
"26003990000",0,0,0,0,0,0,0,0,0
"26005030200",3291,101,2,0,20,0,158,0,3572
"26005030300",6395,579,10,0,330,3,134,7,7458
"26005030401",6569,416,194,0,130,141,165,8,7623
"26005030402",4148,514,0,0,138,13,0,0,4813
"26005030500",6120,748,17,0,215,93,87,59,7339
"26005030600",4335,682,0,1,159,2,57,5,5241
"26005030702",4343,383,0,0,128,10,95,12,4971
"26005030703",1526,584,66,11,123,50,541,237,3138
"26005030704",3665,660,64,2,181,75,439,288,5374
"26005030800",4173,556,10,5,111,0,200,39,5094
"26005030901",2024,617,28,36,64,73,214,83,3139
"26005030902",1828,316,16,5,281,97,325,160,3028
"26005031000",3430,1435,139,113,442,204,769,333,6865
"26005031100",5272,694,87,11,142,7,139,17,6369
"26005031200",4304,784,72,12,55,54,23,26,5330
"26005031300",4039,663,5,0,103,107,269,147,5333
"26005031800",3888,601,0,0,147,11,68,12,4727
"26005031900",4036,547,30,0,78,26,116,0,4833
"26005032000",4261,681,0,0,32,37,38,37,5086
"26005032100",4104,324,85,0,244,1,241,1,5000
"26005032200",3462,648,16,181,539,124,712,72,5754
"26005032401",1025,310,56,13,132,62,578,284,2460
"26005032402",3261,345,3,12,59,98,171,90,4039
"26005032600",1257,15,4,0,72,40,40,9,1437
"26005990000",0,0,0,0,0,0,0,0,0
"26007000100",3811,728,0,6,98,40,37,12,4732
"26007000200",3531,463,15,2,95,0,46,15,4167
"26007000300",2464,524,2,5,53,3,5,0,3056
"26007000400",2149,861,46,0,83,7,6,0,3152
"26007000500",1438,418,8,0,33,79,51,21,2048
"26007000600",2329,421,0,14,50,23,0,11,2848
"26007000700",2422,520,14,11,0,15,8,33,3023
"26007000800",2731,533,0,0,7,22,5,19,3317
"26007000900",2451,288,3,4,94,12,59,3,2914
"26007990000",0,0,0,0,0,0,0,0,0
"26009960100",2137,236,0,0,93,7,89,0,2562
"26009960200",2852,426,4,2,32,13,49,13,3391
"26009960300",2387,311,0,0,82,3,6,13,2802
"26009960400",2695,334,1,6,123,51,55,8,3273
"26009960500",2870,308,21,0,139,25,59,24,3446
"26009960600",2626,378,0,0,86,43,49,14,3196
"26009960700",3445,1369,0,14,64,44,24,19,4979
"26009990000",0,0,0,0,0,0,0,0,0
"26011970100",2022,484,0,0,26,3,59,11,2605
"26011970200",2607,407,0,2,54,0,27,0,3097
"26011970300",2292,362,2,4,60,6,33,6,2765
"26011970400",2090,583,2,0,22,29,18,3,2747
"26011970500",3200,809,0,3,86,63,33,24,4218
"26011990000",0,0,0,0,0,0,0,0,0
"26011990100",0,0,0,0,0,0,0,0,0
"26013000100",3232,320,8,2,275,89,7,17,3950
"26013000200",1972,316,4,4,350,156,38,4,2844
"26013990100",0,0,0,0,0,0,0,0,0
"26015010100",4530,1024,18,0,197,12,278,10,6069
"26015010200",5218,273,9,0,122,27,102,0,5751
"26015010300",7186,462,45,14,160,1,30,14,7912
"26015010401",2636,648,0,0,28,0,141,10,3463
"26015010402",3725,230,0,1,92,0,53,1,4102
"26015010500",2866,238,0,2,66,1,203,6,3382
"26015010600",5442,1111,0,3,42,9,134,1,6742
"26015010700",4444,397,34,0,190,3,67,3,5138
"26015010800",2537,293,0,0,169,5,37,0,3041
"26015011300",6379,1245,13,16,158,0,146,19,7976
"26015011400",5127,805,59,0,183,0,118,32,6324
"26017280300",766,426,22,64,48,68,53,227,1674
"26017280400",1822,557,26,149,135,50,218,88,3045
"26017280500",3015,290,0,0,93,0,180,0,3578
"26017280600",1739,695,37,104,104,81,127,184,3071
"26017280700",2088,994,61,29,57,84,222,23,3558
"26017280800",3087,381,29,0,134,11,126,39,3807
"26017280900",1960,704,0,12,247,254,150,186,3513
"26017281000",3258,622,50,0,145,66,280,50,4471
"26017281300",2294,496,42,73,40,47,62,117,3171
"26017285100",3086,201,66,0,88,0,107,0,3548
"26017285201",4435,946,112,15,63,70,165,188,5994
"26017285202",2810,726,0,19,64,112,73,30,3834
"26017285300",4129,389,0,0,38,0,262,12,4830
"26017285400",3113,272,36,19,88,9,37,0,3574
"26017285500",6101,414,0,0,67,0,77,0,6659
"26017285600",6362,463,0,0,318,30,147,66,7386
"26017285700",3343,271,0,0,261,62,88,28,4053
"26017285800",5203,881,17,18,110,252,120,115,6716
"26017285900",3811,605,57,13,259,0,119,52,4916
"26017286000",2923,183,0,0,90,0,129,0,3325
"26017286100",6886,511,0,5,147,28,65,52,7694
"26017286200",4471,525,0,3,55,44,99,0,5197
"26017286300",2894,517,4,17,84,26,98,33,3673
"26017286400",2251,217,0,8,34,41,33,45,2629
"26017286500",834,496,28,56,102,39,132,46,1733
"26017286600",3991,719,103,0,266,138,372,22,5611
"26017990000",0,0,0,0,0,0,0,0,0
"26019000100",6182,785,16,10,123,53,59,9,7237
"26019000200",2781,319,0,17,92,28,63,29,3329
"26019000300",1380,176,0,16,7,54,0,0,1633
"26019000400",1709,372,0,1,24,20,53,15,2194
"26019000500",2517,398,0,0,129,48,42,63,3197
"26019990000",0,0,0,0,0,0,0,0,0
"26021000300",73,4,962,971,111,0,8,0,2129
"26021000400",63,41,725,1183,0,96,0,74,2182
"26021000500",101,44,1189,704,0,68,0,0,2106
"26021000600",213,109,1687,946,97,92,0,5,3149
"26021000700",1958,138,777,259,44,0,10,0,3186
"26021000800",4145,620,201,0,169,17,0,0,5152
"26021000900",1547,43,52,0,104,9,0,9,1764
"26021001000",1622,83,0,4,20,0,17,0,1746
"26021001100",3685,0,68,0,244,7,7,0,4011
"26021001300",1773,36,21,0,90,30,31,0,1981
"26021001400",3767,289,68,32,207,0,63,0,4426
"26021001500",2768,234,79,51,203,14,90,13,3452
"26021001600",2422,39,0,0,16,0,13,0,2490
"26021001700",3848,130,27,4,400,0,125,2,4536
"26021001800",4021,165,112,32,317,11,64,26,4748
"26021001900",1544,150,173,4,206,92,231,104,2504
"26021002000",958,135,1511,687,121,36,62,0,3510
"26021002100",670,555,305,653,253,203,193,140,2972
"26021002200",286,59,1018,1504,51,0,66,0,2984
"26021002300",607,175,337,808,165,122,104,122,2440
"26021002400",1412,182,106,15,126,4,140,110,2095
"26021002500",1271,131,297,215,51,19,9,0,1993
"26021010100",2867,403,148,21,73,144,104,130,3890
"26021010200",5582,634,63,8,216,70,19,16,6608
"26021010300",3638,855,3,3,328,116,313,75,5331
"26021010400",2283,117,8,42,77,253,205,281,3266
"26021010500",1781,306,43,11,102,41,76,134,2494
"26021010600",3485,573,152,56,480,156,351,144,5397
"26021011000",2362,247,0,22,124,3,111,13,2882
"26021011100",4237,534,18,54,99,21,7,3,4973
"26021011200",2841,151,75,0,34,0,43,0,3144
"26021011300",3346,443,13,111,144,9,169,9,4244
"26021011400",2036,316,22,0,119,29,50,12,2584
"26021011500",1185,170,0,0,35,8,1,8,1407
"26021011600",1578,134,0,1,127,7,101,3,1951
"26021020100",2083,266,6,111,29,54,2,0,2551
"26021020200",4214,716,340,59,86,0,113,0,5528
"26021020300",2366,198,6,0,68,11,76,0,2725
"26021020400",3004,324,89,0,272,127,221,149,4186
"26021020500",1590,898,348,194,95,54,414,262,3855
"26021020600",2564,517,0,153,62,56,77,4,3433
"26021020700",1486,407,378,212,169,18,109,130,2909
"26021020900",2558,664,125,104,133,101,152,28,3865
"26021021000",3862,663,93,85,165,183,16,68,5135
"26021021100",1490,199,6,113,127,0,101,0,2036
"26021021200",1095,298,34,9,22,10,11,0,1479
"26021021300",1121,136,618,401,775,150,129,14,3344
"26021021400",2474,532,300,95,210,201,252,267,4331
"26021990000",0,0,0,0,0,0,0,0,0
"26023950100",3449,594,12,0,27,10,11,10,4113
"26023950200",2942,526,0,0,66,10,7,5,3556
"26023950300",3237,597,0,0,69,30,50,29,4012
"26023950800",3323,1258,1,5,39,4,10,52,4692
"26023950900",1868,371,0,0,8,0,6,0,2253
"26023951000",1916,220,2,0,18,0,59,5,2220
"26023951100",2323,483,6,85,62,35,47,26,3067
"26023951200",2818,1236,26,6,233,35,246,237,4837
"26023951300",3077,219,0,0,81,0,7,0,3384
"26023951400",3589,581,53,98,121,22,275,241,4980
"26023951500",2026,738,0,2,44,9,90,172,3081
"26023951600",2411,649,0,2,115,10,38,122,3347
"26025000200",1799,885,571,444,195,10,154,42,4100
"26025000300",244,231,797,521,62,20,10,60,1945
"26025000500",1989,660,457,199,110,32,439,179,4065
"26025000600",855,868,297,259,163,384,94,416,3336
"26025000700",1275,818,160,291,57,95,233,262,3191
"26025000800",1828,559,315,94,428,50,119,0,3393
"26025000900",2410,154,338,192,279,88,7,13,3481
"26025001000",923,254,1816,366,157,39,119,6,3680
"26025001100",2822,716,394,244,60,156,71,0,4463
"26025001200",1741,616,144,26,12,0,20,64,2623
"26025001300",2368,752,171,86,414,167,28,130,4116
"26025001400",2927,617,83,11,63,44,225,58,4028
"26025001500",4435,96,343,14,619,0,137,0,5644
"26025001600",1921,197,0,53,346,24,97,0,2638
"26025001700",3244,459,130,55,332,0,146,0,4366
"26025001800",4200,334,764,112,412,0,140,0,5962
"26025001900",3431,244,27,75,237,0,45,0,4059
"26025002000",4165,365,57,0,82,23,82,0,4774
"26025002100",720,251,0,6,14,188,34,0,1213
"26025002200",3033,273,80,14,56,68,56,2,3582
"26025002300",3078,479,118,51,197,55,191,42,4211
"26025002400",2217,191,234,55,0,63,6,0,2766
"26025002500",3025,340,67,6,163,0,115,0,3716
"26025002600",1038,268,121,119,189,106,16,0,1857
"26025002700",5674,366,2,3,165,18,25,0,6253
"26025002800",3983,354,9,3,202,4,10,0,4565
"26025002900",2295,458,0,0,74,0,21,0,2848
"26025003000",1864,232,27,0,28,28,13,15,2207
"26025003100",2314,589,0,5,23,6,51,11,2999
"26025003200",1787,388,30,2,64,5,18,0,2294
"26025003300",698,252,441,446,11,0,27,9,1884
"26025003400",807,358,33,101,65,0,30,5,1399
"26025003500",1645,483,243,169,46,0,274,0,2860
"26025003600",587,436,502,633,114,96,123,50,2541
"26025003700",3880,682,23,0,85,35,82,55,4842
"26025003800",4007,154,0,2,64,0,242,13,4482
"26025003900",3817,311,8,48,101,16,51,13,4365
"26025004000",3541,370,19,57,134,17,266,83,4487
"26025004100",863,429,509,226,151,211,450,260,3099
"26027001000",2862,641,97,0,164,17,11,17,3809
"26027001100",2402,464,0,4,50,14,26,0,2960
"26027001200",2536,107,18,0,172,65,12,0,2910
"26027001500",3386,218,97,0,134,36,190,25,4086
"26027001600",2509,586,342,108,230,49,60,24,3908
"26027001700",4074,654,64,34,144,58,73,10,5111
"26027001800",7132,828,94,8,332,127,182,109,8812
"26027001900",3376,541,41,39,385,73,239,102,4796
"26027002000",3740,713,152,38,110,25,0,1,4779
"26027002100",3388,765,447,226,389,153,106,128,5602
"26027002200",4339,568,722,116,259,228,50,179,6461
"26029000100",1471,191,8,0,76,2,19,27,1794
"26029000200",1110,153,0,0,13,3,0,0,1279
"26029000300",1994,197,0,6,8,0,11,0,2216
"26029000400",2470,187,0,0,148,0,46,0,2851
"26029000500",546,28,0,0,9,3,1,0,587
"26029000800",2648,224,4,1,98,12,9,2,2998
"26029000900",1556,79,2,0,170,40,134,16,1997
"26029001000",1801,366,0,1,86,30,13,3,2300
"26029001100",1397,305,14,4,41,5,8,5,1779
"26029001200",2291,655,14,0,167,0,47,0,3174
"26029001300",1199,97,0,0,49,0,6,0,1351
"26029001400",1002,240,0,0,49,13,16,0,1320
"26029001500",1808,522,19,0,37,55,0,0,2441
"26029990000",0,0,0,0,0,0,0,0,0
"26031960100",2471,366,28,21,136,26,32,2,3082
"26031960200",1659,892,0,0,59,101,71,13,2795
"26031960300",2780,772,0,0,332,175,0,0,4059
"26031960400",3060,345,0,0,157,11,18,0,3591
"26031960500",2396,236,14,3,112,3,3,0,2767
"26031960600",1981,210,0,0,67,51,30,0,2339
"26031960700",2446,526,13,5,129,18,20,23,3180
"26031960800",3047,762,13,0,128,45,16,0,4011
"26031990000",0,0,0,0,0,0,0,0,0
"26033970100",2089,100,0,9,827,100,33,10,3168
"26033970200",1893,340,0,12,764,212,29,2,3252
"26033970300",1661,634,26,10,324,503,3,13,3174
"26033970400",1544,426,2,2,404,144,26,0,2548
"26033970500",2646,711,0,16,582,82,31,3,4071
"26033970600",2544,252,22,1,1696,180,24,0,4719
"26033970700",878,131,0,0,81,11,12,0,1113
"26033970800",3165,487,6,0,603,31,10,0,4302
"26033970900",1258,647,0,17,829,474,30,24,3279
"26033971000",2409,331,12,0,287,47,10,0,3096
"26033971100",1174,113,0,0,213,2,0,0,1502
"26033980100",0,0,0,0,0,0,0,0,0
"26033980200",0,0,0,0,0,0,0,0,0
"26033980300",0,0,0,0,0,0,0,0,0
"26033990000",0,0,0,0,0,0,0,0,0
"26033990100",0,0,0,0,0,0,0,0,0
"26035000100",1178,312,0,2,60,31,0,0,1583
"26035000200",1135,295,0,0,12,0,4,0,1446
"26035000300",1726,619,4,0,89,0,13,0,2451
"26035000400",2657,560,0,0,40,49,101,14,3421
"26035000500",850,348,0,0,21,4,0,0,1223
"26035000600",2260,1351,3,3,55,108,0,7,3787
"26035000700",2582,502,2,0,53,31,18,15,3203
"26035000800",3450,848,4,5,42,6,112,6,4473
"26035000900",1267,601,1,6,31,14,13,16,1949
"26035001000",1937,1071,0,3,24,6,25,27,3093
"26035001300",2646,1220,15,0,109,18,60,5,4073
"26037010104",2682,77,335,0,291,10,121,0,3516
"26037010105",3094,319,0,0,11,3,64,0,3491
"26037010107",3414,55,70,24,71,4,130,0,3768
"26037010108",3696,213,0,0,244,16,246,119,4534
"26037010201",1805,77,49,0,86,1,79,0,2097
"26037010203",955,472,0,0,26,43,88,45,1629
"26037010204",1500,142,186,0,107,0,125,0,2060
"26037010300",4419,311,64,4,104,10,149,11,5072
"26037010400",4874,159,0,0,44,1,179,0,5257
"26037010500",3264,214,0,0,102,0,57,6,3643
"26037010600",2369,120,0,0,29,28,56,9,2611
"26037010701",1977,180,21,1,93,3,48,18,2341
"26037010702",1922,190,0,10,67,0,54,2,2245
"26037010801",3458,460,60,19,106,0,125,58,4286
"26037010802",2783,630,0,0,105,4,57,15,3594
"26037010901",2030,454,0,0,112,18,46,15,2675
"26037010902",4193,107,53,0,113,11,82,13,4572
"26037011001",3064,594,9,0,56,3,171,28,3925
"26037011002",3160,144,0,0,174,1,29,0,3508
"26037011101",3613,101,27,2,204,11,166,41,4165
"26037011104",4296,352,145,26,246,285,106,240,5696
"26037011200",456,1857,21,264,113,251,64,125,3151
"26039960100",1838,246,0,0,69,14,9,0,2176
"26039960200",2527,593,0,0,42,31,16,0,3209
"26039960300",2941,698,0,0,35,19,39,22,3754
"26039960400",1950,267,0,0,6,13,4,0,2240
"26039960500",1861,308,0,0,14,89,35,73,2380
"26041970100",1200,202,1,0,127,19,3,0,1552
"26041970200",2121,269,0,0,130,58,18,1,2597
"26041970300",1989,274,4,0,75,37,21,11,2411
"26041970400",4985,613,0,0,26,47,30,7,5708
"26041970500",3570,425,2,0,139,0,7,0,4143
"26041970600",3177,354,0,0,271,37,28,22,3889
"26041970700",3363,331,0,1,111,36,51,16,3909
"26041970800",2823,896,0,12,134,116,7,4,3992
"26041970900",1641,509,0,9,31,96,27,59,2372
"26041971000",1497,855,0,7,55,126,5,19,2564
"26041971100",2760,484,0,0,162,129,6,0,3541
"26041990000",0,0,0,0,0,0,0,0,0
"26041990100",0,0,0,0,0,0,0,0,0
"26043950100",1440,319,0,3,16,22,6,1,1807
"26043950200",3569,316,2,0,123,1,14,0,4025
"26043950300",4053,526,7,0,71,15,33,0,4705
"26043950400",3695,431,9,0,51,65,123,0,4374
"26043950500",2407,480,0,0,142,34,56,8,3127
"26043950600",3298,743,31,12,62,42,11,13,4212
"26043950700",3378,263,7,0,76,0,34,0,3758
"26045020101",2385,67,391,29,43,7,35,0,2957
"26045020102",2128,84,486,23,355,35,228,8,3347
"26045020103",2888,304,443,175,413,97,232,94,4646
"26045020104",2452,242,527,222,624,0,453,31,4551
"26045020201",1866,95,451,45,141,174,83,140,2995
"26045020202",1797,353,1044,692,253,189,545,214,5087
"26045020302",5455,161,47,0,460,17,359,0,6499
"26045020303",2514,316,100,9,174,0,81,56,3250
"26045020304",3425,209,394,33,583,70,409,58,5181
"26045020402",2547,167,0,41,45,0,23,0,2823
"26045020403",2313,289,0,0,75,57,8,44,2786
"26045020404",3954,255,0,0,57,0,146,24,4436
"26045020500",3386,317,1,1,40,0,103,12,3860
"26045020601",2901,397,55,37,167,0,125,27,3709
"26045020602",3179,205,47,2,53,31,88,10,3615
"26045020700",3515,357,0,2,42,3,70,39,4028
"26045020800",4341,355,36,0,298,9,105,8,5152
"26045020901",2635,714,0,5,163,2,137,97,3753
"26045020902",3251,683,0,0,73,68,12,0,4087
"26045021001",3472,313,0,0,91,32,47,29,3984
"26045021002",3567,404,8,17,108,5,176,4,4289
"26045021100",4148,442,29,2,138,22,179,6,4966
"26045021201",2859,100,26,0,29,0,104,0,3118
"26045021202",2696,497,22,0,243,0,59,0,3517
"26045021301",2468,390,0,0,92,39,80,0,3069
"26045021302",2085,909,45,0,46,39,62,0,3186
"26045021401",2411,184,473,199,253,63,208,63,3854
"26045021402",4064,160,178,7,209,0,89,8,4715
"26047970100",1843,198,10,1,132,23,22,0,2229
"26047970200",4364,635,4,1,288,110,62,13,5477
"26047970300",3633,459,10,0,229,22,42,9,4404
"26047970400",2187,140,17,1,113,34,12,8,2512
"26047970500",3906,396,4,0,241,3,27,2,4579
"26047970600",5187,231,12,0,418,10,91,0,5949
"26047970700",2953,449,26,19,59,31,4,0,3541
"26047970800",2800,651,9,18,252,95,131,12,3968
"26047990000",0,0,0,0,0,0,0,0,0
"26049000100",6,0,1560,1115,30,30,30,0,2771
"26049000200",51,85,785,580,89,137,70,6,1803
"26049000300",13,49,1627,1479,34,10,0,0,3212
"26049000400",47,6,810,720,12,0,0,0,1595
"26049000500",38,6,1162,701,0,0,21,30,1958
"26049000600",46,18,929,853,20,70,20,36,1992
"26049000700",166,204,1621,1014,24,0,0,0,3029
"26049000800",18,94,583,480,30,0,0,2,1207
"26049000900",245,75,2134,1237,45,22,13,102,3873
"26049001000",29,37,1323,608,57,163,0,96,2313
"26049001100",42,42,1046,1180,81,0,19,0,2410
"26049001200",164,82,1462,1199,25,356,10,73,3371
"26049001300",397,62,1403,1159,164,58,0,0,3243
"26049001400",145,109,432,551,108,26,53,0,1424
"26049001500",206,286,442,460,52,21,28,26,1521
"26049001600",1959,570,1093,769,258,233,39,93,5014
"26049001700",40,27,636,771,0,0,0,18,1492
"26049001800",188,289,387,834,0,58,0,14,1770
"26049001900",1143,505,249,713,29,189,125,23,2976
"26049002000",22,11,675,372,15,0,0,0,1095
"26049002200",700,1125,57,154,66,197,81,131,2511
"26049002300",928,1117,228,162,193,84,225,218,3155
"26049002400",1332,631,283,239,175,48,125,0,2833
"26049002600",1351,899,137,306,119,35,249,39,3135
"26049002700",2303,360,155,301,172,13,222,57,3583
"26049002800",417,338,540,419,86,2,75,8,1885
"26049002900",478,222,638,506,53,19,85,0,2001
"26049003000",1847,598,595,156,189,1,240,40,3666
"26049003100",132,37,1275,630,16,95,12,13,2210
"26049003200",123,242,849,1072,18,118,12,0,2434
"26049003300",547,59,913,258,67,101,101,5,2051
"26049003400",235,263,257,1282,40,113,31,104,2325
"26049003500",2231,533,190,174,23,16,49,35,3251
"26049003600",2991,885,480,485,94,133,198,66,5332
"26049003700",898,757,240,77,60,87,16,160,2295
"26049003800",470,513,149,204,19,180,59,151,1745
"26049004000",1691,983,131,390,76,110,11,12,3404
"26049010110",2123,426,0,1,44,13,37,0,2644
"26049010111",837,192,1,7,61,7,17,9,1131
"26049010112",2239,63,0,0,121,0,73,6,2502
"26049010113",1686,651,159,20,82,43,32,39,2712
"26049010114",2303,140,14,0,46,23,52,3,2581
"26049010115",700,100,0,36,57,0,26,0,919
"26049010201",1653,36,0,0,16,0,16,4,1725
"26049010202",1545,48,26,0,50,11,15,11,1706
"26049010304",783,265,1061,1097,200,105,97,34,3642
"26049010305",569,130,2339,1730,120,427,52,317,5684
"26049010501",719,541,461,247,140,78,167,93,2446
"26049010502",2178,285,333,503,99,7,80,21,3506
"26049010503",1727,401,179,0,41,1,42,2,2393
"26049010504",2725,542,979,176,79,14,107,10,4632
"26049010603",4503,525,136,1,100,2,65,56,5388
"26049010604",2527,309,0,0,34,0,112,0,2982
"26049010610",4560,445,218,47,149,0,213,2,5634
"26049010700",4400,428,12,9,202,22,101,3,5177
"26049010810",3265,287,1264,72,421,29,130,0,5468
"26049010811",514,189,784,359,213,0,48,0,2107
"26049010812",1351,356,632,733,143,52,38,26,3331
"26049010813",2889,293,824,17,630,23,165,0,4841
"26049010910",2499,318,579,97,34,54,56,70,3707
"26049010911",616,796,1375,478,87,52,79,1,3484
"26049010912",2335,526,167,93,64,5,23,0,3213
"26049011010",3447,714,280,114,324,230,83,0,5192
"26049011101",7513,334,438,75,479,53,204,16,9112
"26049011102",3892,434,377,46,327,44,131,8,5259
"26049011209",4634,383,475,318,337,23,79,0,6249
"26049011210",1471,252,152,114,12,83,43,4,2131
"26049011211",3726,316,948,43,230,8,142,0,5413
"26049011212",3940,597,572,367,204,19,150,19,5868
"26049011213",4743,375,241,69,517,0,221,0,6166
"26049011214",3863,321,576,213,397,282,84,0,5736
"26049011301",2263,1529,251,301,163,139,25,27,4698
"26049011302",2384,995,1,0,164,151,29,15,3739
"26049011401",2531,369,168,57,59,8,29,5,3226
"26049011402",3360,197,153,0,222,0,112,24,4068
"26049011502",2751,510,139,0,102,0,107,9,3618
"26049011503",4306,591,0,16,256,0,152,62,5383
"26049011505",1959,348,210,1,48,0,36,72,2674
"26049011508",2187,559,77,8,0,49,34,57,2971
"26049011601",2719,126,280,0,17,1,215,3,3361
"26049011610",5275,440,302,207,474,69,172,10,6949
"26049011710",2267,325,0,0,29,24,0,18,2663
"26049011711",2007,411,5,0,23,10,45,10,2511
"26049011712",2514,203,0,0,102,1,67,0,2887
"26049011713",2568,458,195,109,67,33,18,9,3457
"26049011714",2937,98,12,38,51,0,193,0,3329
"26049011800",3120,67,18,1,89,0,32,0,3327
"26049011901",1807,275,79,0,184,103,27,103,2578
"26049011902",2380,341,0,1,147,0,27,0,2896
"26049012003",1698,677,129,33,11,16,68,31,2663
"26049012006",2007,281,108,25,78,90,47,102,2738
"26049012007",1130,233,30,0,89,41,33,0,1556
"26049012008",2714,185,35,22,27,0,29,0,3012
"26049012009",2248,216,0,0,81,10,69,0,2624
"26049012100",2210,558,104,21,60,8,39,65,3065
"26049012201",1661,615,99,47,141,0,34,11,2608
"26049012202",232,150,635,409,42,0,6,0,1474
"26049012310",1604,750,150,349,130,76,58,0,3117
"26049012311",1445,269,135,87,8,73,23,128,2168
"26049012401",1705,114,7,0,79,19,39,7,1970
"26049012402",2389,280,0,0,0,0,22,0,2691
"26049012501",1562,218,52,0,0,0,28,0,1860
"26049012503",2238,460,253,0,29,67,121,36,3204
"26049012504",1792,199,10,15,17,0,34,40,2107
"26049012601",2331,718,20,23,48,30,141,26,3337
"26049012602",1230,320,3,28,52,15,15,2,1665
"26049012603",2607,223,9,0,70,6,97,53,3065
"26049012702",4241,926,105,310,85,0,135,7,5809
"26049012703",2530,505,39,0,147,61,155,0,3437
"26049012704",3736,93,121,97,159,0,99,57,4362
"26049012801",4102,423,0,1,21,0,109,0,4656
"26049012802",1974,122,9,24,49,0,68,0,2246
"26049012904",5486,331,186,5,321,76,93,62,6560
"26049012905",2862,147,376,77,190,186,186,0,4024
"26049012906",2166,112,27,0,91,0,9,3,2408
"26049012907",1969,215,0,1,82,5,27,5,2304
"26049013001",2519,38,0,0,42,0,0,0,2599
"26049013002",3316,780,0,0,33,0,48,11,4188
"26049013110",1839,310,0,0,5,0,16,0,2170
"26049013111",2635,331,0,0,228,0,15,0,3209
"26049013112",3864,301,17,0,183,10,82,15,4472
"26049013113",3620,98,0,0,55,99,14,43,3929
"26049013202",4546,938,45,1,184,17,189,24,5944
"26049013204",4706,766,0,0,147,61,262,41,5983
"26049013301",5100,388,0,1,128,31,58,0,5706
"26049013401",5803,240,41,6,57,0,155,0,6302
"26049013402",1565,158,1,0,16,0,33,0,1773
"26049013500",2137,1126,1643,920,72,117,105,117,6237
"26049013600",32,80,558,547,7,42,6,33,1305
"26049980000",0,0,0,0,0,0,0,0,0
"26049980100",0,0,0,0,0,0,0,0,0
"26051000100",2433,474,0,0,35,0,19,0,2961
"26051000200",987,225,2,3,24,1,10,0,1252
"26051000300",1450,274,0,1,24,8,7,0,1764
"26051000400",2485,842,0,26,56,15,29,9,3462
"26051000500",3060,730,5,5,29,15,54,4,3902
"26051000600",1389,375,0,0,0,9,8,36,1817
"26051000700",3261,1160,0,0,141,25,25,0,4612
"26051000800",2899,854,8,0,41,44,40,67,3953
"26051000900",1526,326,0,4,35,9,6,0,1906
"26053950100",1045,60,1,2,243,84,10,0,1445
"26053950200",1959,370,21,0,38,57,5,2,2452
"26053950300",1866,544,4,20,35,38,6,0,2513
"26053950400",777,119,0,0,15,15,3,0,929
"26053950500",1676,542,0,0,51,15,0,0,2284
"26053950600",2013,780,0,0,32,78,34,42,2979
"26053950700",1913,235,1,1,32,20,0,13,2215
"26053990000",0,0,0,0,0,0,0,0,0
"26055550101",4890,225,0,4,9,0,5,19,5152
"26055550102",3357,183,19,10,25,23,17,0,3634
"26055550200",3686,313,8,3,36,57,41,0,4144
"26055550300",4991,1008,0,0,117,84,27,116,6343
"26055550400",5639,647,23,132,419,45,249,94,7248
"26055550500",4015,496,2,0,162,68,59,89,4891
"26055550600",8357,754,34,15,370,58,269,0,9857
"26055550700",7687,1157,0,18,357,102,193,0,9514
"26055550800",5214,295,14,0,185,0,62,11,5781
"26055550900",4554,286,0,0,0,0,0,0,4840
"26055551000",3231,381,0,45,90,32,46,6,3831
"26055551100",2745,577,0,0,250,25,42,0,3639
"26055551200",2613,650,27,37,46,0,8,61,3442
"26055551300",5185,1591,0,0,363,98,291,33,7561
"26055551400",3837,285,0,0,139,5,114,0,4380
"26055551500",2490,307,60,0,240,3,45,1,3146
"26055990000",0,0,0,0,0,0,0,0,0
"26057000100",3015,905,29,8,24,11,109,15,4116
"26057000200",4103,551,27,30,176,16,214,21,5138
"26057000300",3447,1140,11,14,52,48,195,218,5125
"26057000400",13,0,0,0,0,0,0,0,13
"26057000500",3073,1240,7,0,36,130,258,181,4925
"26057000600",2232,1000,0,0,126,47,161,77,3643
"26057000700",2706,467,16,5,101,0,174,53,3522
"26057000800",3698,509,0,0,16,17,132,34,4406
"26057000900",2911,348,0,0,82,33,63,44,3481
"26057001000",3349,322,11,84,43,11,17,21,3858
"26059050100",4082,390,0,1,30,1,58,1,4563
"26059050200",2692,620,5,5,48,17,59,0,3446
"26059050300",1836,342,5,0,31,6,50,0,2270
"26059050400",3603,1042,35,7,95,22,14,40,4858
"26059050500",3336,538,0,3,102,43,91,0,4113
"26059050600",3400,250,15,0,53,7,65,14,3804
"26059050700",2639,1589,14,4,80,19,129,12,4486
"26059050800",1397,344,0,15,25,18,19,16,1834
"26059050900",3752,788,0,9,73,20,84,14,4740
"26059051000",3580,435,38,2,72,0,54,16,4197
"26059051100",2619,962,5,0,73,36,26,18,3739
"26059051200",2409,1354,2,3,27,5,5,46,3851
"26061000100",2052,508,0,4,76,12,0,4,2656
"26061000200",2334,523,0,0,20,34,7,29,2947
"26061000300",1792,486,0,6,88,4,42,29,2447
"26061000400",2688,803,0,0,21,5,4,0,3521
"26061000500",3081,299,1,12,33,21,32,0,3479
"26061000600",2359,897,3,2,85,49,28,35,3458
"26061000700",2735,415,3,0,15,17,0,10,3195
"26061000800",2012,1868,19,57,226,395,45,40,4662
"26061000900",3669,886,35,61,269,202,14,29,5165
"26061001000",2593,256,7,0,72,31,4,29,2992
"26061990000",0,0,0,0,0,0,0,0,0
"26061990100",0,0,0,0,0,0,0,0,0
"26063950100",1096,289,2,1,18,1,15,1,1423
"26063950200",1938,270,0,4,60,12,45,43,2372
"26063950300",1939,361,0,0,11,28,19,6,2364
"26063950400",886,133,0,0,6,0,12,0,1037
"26063950500",2113,272,0,0,15,18,90,10,2518
"26063950600",2291,436,0,0,21,19,17,14,2798
"26063950700",2773,505,0,5,23,3,26,21,3356
"26063950800",2963,316,0,0,55,76,33,76,3519
"26063950900",3162,498,10,7,59,23,46,0,3805
"26063951000",2608,950,35,0,88,3,57,26,3767
"26063951100",1850,166,19,1,68,10,3,0,2117
"26063951200",3046,662,0,2,83,35,45,50,3923
"26063990000",0,0,0,0,0,0,0,0,0
"26065000100",1190,385,236,14,220,25,480,93,2643
"26065000400",1471,278,212,195,149,197,202,73,2777
"26065000600",529,339,125,127,279,139,95,73,1706
"26065000700",878,559,163,92,257,308,314,247,2818
"26065000800",1178,479,185,180,589,175,468,285,3539
"26065001000",1269,364,52,115,147,56,50,42,2095
"26065001200",864,367,626,251,248,65,110,86,2617
"26065001703",2185,287,1022,123,404,118,418,154,4711
"26065002000",1337,680,340,650,345,262,157,135,3906
"26065002101",725,234,278,338,135,225,113,165,2213
"26065002200",1162,170,100,0,118,0,64,13,1627
"26065002300",2756,130,138,46,251,51,205,96,3673
"26065002600",1049,382,29,131,195,127,95,247,2255
"26065002700",1601,621,444,166,256,83,196,72,3439
"26065002800",1622,282,178,18,238,68,187,44,2637
"26065002901",1416,349,647,303,520,133,211,0,3579
"26065002902",1172,1248,377,347,591,495,218,139,4587
"26065003103",4559,588,580,101,459,75,332,54,6748
"26065003200",1109,397,115,277,147,141,121,115,2422
"26065003301",1713,286,373,540,259,158,235,152,3716
"26065003302",1569,133,331,2,140,37,107,8,2327
"26065003400",1709,65,111,211,231,0,424,20,2771
"26065003500",1353,390,321,109,339,181,471,219,3383
"26065003601",977,198,1270,348,375,596,145,98,4007
"26065003602",977,377,946,166,292,317,352,240,3667
"26065003700",2203,828,967,341,445,294,504,338,5920
"26065003801",2692,318,547,264,531,218,80,23,4673
"26065003802",2377,937,101,187,204,220,48,23,4097
"26065003901",1645,93,75,36,111,29,175,0,2164
"26065003902",2353,1178,56,111,216,95,57,69,4135
"26065004000",2235,1146,128,0,356,36,84,32,4017
"26065004100",683,2648,14,44,8,57,10,28,3492
"26065004301",2401,2522,21,3,254,99,136,13,5449
"26065004302",186,1415,22,69,79,294,0,57,2122
"26065004402",176,135,60,127,444,352,82,24,1400
"26065004403",379,249,40,32,280,107,8,8,1103
"26065004490",0,20,0,0,0,0,0,0,20
"26065004491",0,0,0,0,0,0,0,0,0
"26065004492",0,0,0,0,0,0,0,0,0
"26065004493",0,0,0,0,0,0,0,0,0
"26065004494",0,0,0,0,0,0,0,0,0
"26065004500",2368,534,332,37,268,311,152,17,4019
"26065004600",3695,189,164,0,361,8,147,0,4564
"26065004700",2307,275,38,1,83,131,93,1,2929
"26065004801",2976,796,83,0,474,53,313,25,4720
"26065004802",2767,313,81,0,128,0,96,52,3437
"26065004901",4476,525,131,91,958,141,100,10,6432
"26065004902",1996,748,186,21,559,80,10,0,3600
"26065005001",4334,346,214,0,1488,100,242,40,6764
"26065005002",2938,119,99,30,329,10,99,10,3634
"26065005100",1157,775,851,359,260,452,199,308,4361
"26065005201",2405,682,767,626,730,260,550,40,6060
"26065005202",2583,211,120,0,354,74,143,149,3634
"26065005302",5097,562,363,143,959,98,392,65,7679
"26065005303",2180,841,354,216,534,258,494,142,5019
"26065005304",1295,392,520,790,399,129,195,129,3849
"26065005401",3042,185,8,8,153,5,157,0,3558
"26065005402",3134,280,108,20,148,1,175,33,3899
"26065005501",4260,257,341,19,296,243,117,81,5614
"26065005502",4035,597,152,90,237,151,273,0,5535
"26065005600",2604,139,42,0,79,27,134,6,3031
"26065005700",4822,179,45,14,146,7,47,8,5268
"26065005800",4310,736,44,1,199,5,76,156,5527
"26065005900",4371,594,0,45,42,147,115,63,5377
"26065006001",2980,334,0,0,64,18,109,10,3515
"26065006002",3212,455,3,2,96,4,116,57,3945
"26065006100",3753,376,22,17,84,12,156,20,4440
"26065006200",4845,308,0,2,65,0,248,14,5482
"26065006301",3500,461,0,0,69,112,149,45,4336
"26065006302",3744,216,31,3,108,9,15,18,4144
"26065006401",3570,69,50,1,80,0,187,0,3957
"26065006402",2644,319,0,0,34,21,62,5,3085
"26065006500",1680,1021,169,248,605,132,461,12,4328
"26065006600",1181,616,200,287,188,396,192,476,3536
"26065006700",1033,779,712,845,477,94,174,143,4257
"26065006800",1397,695,468,424,465,244,832,233,4758
"26065007000",3700,400,678,96,449,77,237,66,5703
"26065980000",0,10,0,16,0,0,0,0,26
"26065980100",90,0,0,0,4,0,0,0,94
"26065980200",0,0,0,0,0,0,0,0,0
"26065980300",0,0,0,0,0,0,0,0,0
"26067030100",5311,941,50,22,83,16,100,13,6536
"26067030200",2022,523,12,2,83,13,76,9,2740
"26067030300",1965,740,0,0,152,76,165,21,3119
"26067030400",5221,1172,24,0,267,200,227,254,7365
"26067031200",3828,782,68,1,204,0,282,7,5172
"26067031300",6643,817,17,0,284,279,54,33,8127
"26067031400",4355,260,20,5,59,4,84,16,4803
"26067031500",4830,520,2,2,132,38,236,40,5800
"26067031600",4434,888,0,3,172,38,212,30,5777
"26067031700",2702,871,18,7,176,149,335,116,4374
"26067031900",5235,453,27,0,276,34,217,6,6248
"26067032100",1130,432,0,0,5,57,2,8,1634
"26067982200",0,0,0,0,0,0,0,0,0
"26069000100",1788,473,0,6,19,63,20,0,2369
"26069000200",3359,546,26,9,108,31,38,0,4117
"26069000300",2215,585,31,10,43,55,50,0,2989
"26069000400",2650,607,0,0,115,14,88,0,3474
"26069000500",2772,364,11,0,54,9,91,7,3308
"26069000600",2537,310,0,0,89,8,96,0,3040
"26069000700",1924,929,6,0,39,16,13,19,2946
"26069000800",1026,213,0,0,45,0,12,0,1296
"26069000900",1563,542,0,0,42,5,3,0,2155
"26069990000",0,0,0,0,0,0,0,0,0
"26071000100",2071,251,10,13,42,7,28,18,2440
"26071000200",1384,99,0,0,40,10,0,5,1538
"26071000300",1915,555,0,0,25,0,32,0,2527
"26071000400",2221,373,0,21,31,41,25,35,2747
"26071000500",1937,213,1,0,33,18,34,0,2236
"26073000100",2532,815,0,4,87,41,75,24,3578
"26073000200",3755,923,10,20,46,24,97,39,4914
"26073000300",4324,637,26,0,160,41,80,16,5284
"26073000400",1958,1560,36,53,207,275,39,0,4128
"26073000500",673,2156,0,93,92,99,10,16,3139
"26073000600",1887,1325,49,239,582,103,160,39,4384
"26073000700",878,3652,125,177,100,323,60,174,5489
"26073000800",1255,1664,55,104,239,175,181,79,3752
"26073000900",3490,432,22,0,208,18,74,21,4265
"26073940100",3624,484,20,2,196,92,45,10,4473
"26073940200",3431,948,15,28,852,322,244,25,5865
"26073940300",3773,738,77,42,360,155,116,132,5393
"26073940400",2539,884,44,4,232,133,108,58,4002
"26073940500",1403,976,4,33,97,117,47,94,2771
"26073940600",4278,266,8,12,273,54,118,1,5010
"26075000100",1834,456,38,0,47,4,95,65,2539
"26075000200",1255,582,131,419,83,54,88,66,2678
"26075000400",2811,1009,273,120,96,118,194,94,4715
"26075000500",1260,440,159,50,143,41,72,0,2165
"26075000600",711,386,12,214,8,80,0,0,1411
"26075000800",3402,337,293,217,105,25,102,13,4494
"26075000900",1651,577,114,305,142,62,60,0,2911
"26075001000",656,715,267,454,94,156,109,50,2501
"26075001100",55,268,686,875,33,81,0,78,2076
"26075001200",776,947,106,540,48,160,176,166,2919
"26075001300",693,421,1178,457,93,72,56,136,3106
"26075005000",1405,441,218,77,221,8,31,37,2438
"26075005100",3441,948,12,67,12,19,30,80,4609
"26075005200",5592,156,231,1,290,0,172,0,6442
"26075005301",3539,453,577,188,294,0,181,70,5302
"26075005302",2977,125,66,0,440,0,131,0,3739
"26075005400",4579,851,24,6,39,0,171,19,5689
"26075005500",3538,565,375,140,80,41,53,63,4855
"26075005600",6273,852,230,177,174,101,159,36,8002
"26075005700",2834,339,26,25,152,5,0,0,3381
"26075005800",0,0,0,0,0,0,0,0,0
"26075005900",1819,824,46,50,93,19,57,79,2987
"26075006000",5542,927,0,2,185,128,162,73,7019
"26075006100",4931,1088,9,0,110,35,71,27,6271
"26075006200",6129,469,0,7,77,7,68,0,6757
"26075006301",2721,183,7,11,8,9,6,9,2954
"26075006303",4119,299,1,1,126,29,60,3,4638
"26075006304",2315,513,0,2,14,0,40,2,2886
"26075006401",2540,251,0,0,45,22,76,9,2943
"26075006402",6338,611,6,4,91,21,53,4,7128
"26075006500",5855,377,55,19,289,6,52,13,6666
"26075006600",4073,636,13,7,157,0,104,5,4995
"26075006701",4552,500,89,4,67,31,76,25,5344
"26075006702",3481,775,7,12,60,49,0,0,4384
"26075006801",2769,205,26,0,37,0,21,15,3073
"26075006803",2261,270,45,49,95,7,32,0,2759
"26075006804",5154,341,72,1,70,3,38,102,5781
"26075006900",1564,548,464,174,179,39,212,5,3185
"26077000100",346,332,759,961,241,138,153,58,2988
"26077000201",759,412,86,185,23,88,22,48,1623
"26077000202",34,15,539,409,56,61,0,8,1122
"26077000300",118,264,1861,1344,250,129,121,41,4128
"26077000500",1519,866,560,464,222,84,198,36,3949
"26077000600",1997,1494,84,250,275,107,54,101,4362
"26077000900",438,628,7,128,6,50,33,293,1583
"26077001000",1989,1396,730,1161,373,70,561,304,6584
"26077001100",1326,413,112,222,29,9,338,57,2506
"26077001200",2653,130,222,2,155,0,61,7,3230
"26077001300",1452,113,74,92,95,69,44,16,1955
"26077001501",2847,444,610,27,70,185,52,0,4235
"26077001502",2932,749,471,140,151,0,47,0,4490
"26077001503",3316,396,431,134,129,14,107,75,4602
"26077001504",117,167,27,213,73,143,11,82,833
"26077001506",3328,2151,247,80,366,473,58,27,6730
"26077001507",1880,2745,447,589,203,548,247,533,7192
"26077001601",2145,149,75,49,135,64,72,12,2701
"26077001603",811,328,68,44,183,0,22,0,1456
"26077001604",1276,397,31,116,134,0,24,0,1978
"26077001701",2173,296,347,159,252,20,149,0,3396
"26077001702",2292,862,322,235,187,60,289,258,4505
"26077001801",2371,283,395,42,184,0,155,0,3430
"26077001802",3360,519,209,107,330,141,152,94,4912
"26077001803",1085,425,117,108,136,105,135,70,2181
"26077001905",3918,688,208,357,300,57,164,13,5705
"26077001906",3198,639,109,3,394,44,21,0,4408
"26077001907",2976,291,336,170,365,63,75,95,4371
"26077002002",2801,360,54,2,212,3,147,6,3585
"26077002003",4271,344,453,26,427,22,151,0,5694
"26077002004",3258,185,65,9,438,1,102,0,4058
"26077002005",3018,432,124,265,296,49,84,72,4340
"26077002101",6619,448,484,0,447,79,115,123,8315
"26077002102",2560,96,44,0,101,8,94,0,2903
"26077002201",1569,436,77,0,184,14,207,1,2488
"26077002202",5481,1063,755,178,458,171,229,36,8371
"26077002601",4192,215,46,1,224,0,65,3,4746
"26077002700",6759,343,268,77,174,28,297,0,7946
"26077002801",3860,235,0,1,133,0,42,0,4271
"26077002802",4658,733,245,13,250,9,0,0,5908
"26077002901",3271,284,0,29,22,79,153,13,3851
"26077002903",1981,1115,670,455,79,216,234,68,4818
"26077002904",6826,1519,679,68,432,172,242,20,9958
"26077002905",4663,1021,770,177,403,331,104,244,7713
"26077003002",2272,140,12,11,22,0,45,0,2502
"26077003003",6679,115,118,263,273,0,59,0,7507
"26077003004",6317,265,171,0,758,126,269,0,7906
"26077003302",5131,843,35,13,154,0,183,0,6359
"26077003400",3334,249,21,0,65,0,31,0,3700
"26077003500",3369,485,157,287,143,49,49,0,4539
"26077005501",2591,254,487,148,355,55,394,2,4286
"26077005502",3309,701,1106,650,396,18,342,20,6542
"26077006102",3322,464,7,19,23,0,31,0,3866
"26077006103",3632,593,15,11,179,22,14,0,4466
"26077006601",3631,508,42,17,45,13,106,19,4381
"26077006701",2045,399,18,0,150,24,44,12,2692
"26077006702",4985,429,21,71,110,37,49,18,5720
"26079950200",3563,998,25,12,85,25,44,8,4760
"26079950300",3775,639,10,1,90,47,51,9,4622
"26079950400",2980,550,7,0,86,13,40,0,3676
"26079950601",1803,212,4,0,44,2,16,2,2083
"26079950602",1461,223,0,0,50,5,4,41,1784
"26081000100",1864,218,100,25,84,46,72,0,2409
"26081000200",1350,115,16,5,58,0,135,0,1679
"26081000300",4016,161,146,0,298,0,83,0,4704
"26081000400",2863,218,98,29,63,0,0,0,3271
"26081000500",3432,164,42,35,129,0,184,0,3986
"26081000600",3106,171,51,13,131,34,65,0,3571
"26081000700",2458,376,0,12,379,9,436,156,3826
"26081000800",1503,757,104,363,58,367,181,189,3522
"26081000900",1808,669,35,340,225,74,399,87,3637
"26081001000",2542,594,429,219,325,77,395,173,4754
"26081001101",2639,816,1236,491,307,154,192,470,6305
"26081001102",2228,330,461,725,177,24,30,76,4051
"26081001200",1920,474,318,251,223,67,195,131,3579
"26081001300",1277,791,393,630,299,309,397,272,4368
"26081001400",1230,528,171,226,152,15,251,102,2675
"26081001500",1567,1098,150,532,271,324,546,795,5283
"26081001600",3304,1124,54,341,543,217,995,429,7007
"26081001700",3508,387,25,15,213,127,29,86,4390
"26081001800",5247,747,46,0,55,71,75,440,6681
"26081001900",2933,672,155,135,610,117,757,128,5507
"26081002000",748,575,192,401,57,67,64,55,2159
"26081002100",1476,620,104,264,71,57,119,101,2812
"26081002200",2703,752,484,516,134,108,25,115,4837
"26081002300",3084,366,74,60,279,35,262,8,4168
"26081002400",2017,618,65,22,9,43,212,36,3022
"26081002500",2352,1290,346,84,93,87,70,531,4853
"26081002600",1083,1022,249,323,216,376,1104,1205,5578
"26081002700",1769,832,107,298,185,125,589,329,4234
"26081002800",123,241,305,445,84,278,151,363,1990
"26081002900",787,339,227,173,31,19,93,118,1787
"26081003000",642,194,357,322,40,57,70,55,1737
"26081003100",499,103,1018,1069,332,114,694,89,3918
"26081003200",409,369,1829,1632,356,160,309,205,5269
"26081003300",1870,367,811,393,91,27,266,96,3921
"26081003400",2913,394,911,596,412,208,133,217,5784
"26081003500",1259,404,2139,1079,395,74,430,182,5962
"26081003600",333,397,757,561,68,133,360,327,2936
"26081003700",958,709,1516,1104,263,278,911,512,6251
"26081003800",1078,1627,85,444,552,301,1201,1701,6989
"26081003900",1118,897,375,193,421,390,1199,1178,5771
"26081004000",1474,978,285,74,694,54,1783,741,6083
"26081004100",2931,412,538,309,319,184,366,319,5378
"26081004200",2708,135,461,175,186,30,306,30,4031
"26081004300",2925,221,402,2,203,25,196,0,3974
"26081004400",4305,479,461,18,45,127,66,0,5501
"26081004500",3939,354,944,616,1043,121,383,0,7400
"26081004600",2281,363,1776,616,737,165,208,394,6540
"26081010101",4705,617,0,3,226,7,215,12,5785
"26081010102",1980,436,0,0,16,0,133,13,2578
"26081010200",3267,708,13,13,98,35,113,0,4247
"26081010301",4043,427,47,43,285,44,362,96,5347
"26081010302",4616,405,101,0,472,48,174,0,5816
"26081010401",4097,605,48,74,75,67,103,74,5143
"26081010402",3457,459,64,9,138,0,146,0,4273
"26081010600",9623,824,0,0,151,16,157,0,10771
"26081010700",4145,807,0,9,201,91,75,77,5405
"26081010801",7193,241,0,4,302,30,77,30,7877
"26081010802",5051,597,0,0,137,0,143,89,6017
"26081010902",3478,211,27,0,37,12,51,12,3828
"26081010903",6006,341,82,0,200,0,189,0,6818
"26081010904",6275,300,81,6,158,0,190,0,7010
"26081011001",3728,137,0,0,102,1,56,35,4059
"26081011002",3408,201,0,0,43,0,76,0,3728
"26081011101",3879,164,34,0,86,5,58,0,4226
"26081011102",4433,142,45,6,332,8,70,0,5036
"26081011200",3517,382,22,10,88,13,152,42,4226
"26081011301",3886,400,18,11,321,58,276,0,4970
"26081011302",4830,608,259,151,151,19,257,43,6318
"26081011401",1961,65,0,84,35,86,47,86,2364
"26081011403",1936,250,98,2,135,7,113,2,2543
"26081011405",2541,100,29,0,233,150,140,132,3325
"26081011406",2650,1035,367,519,726,355,1082,720,7454
"26081011500",5301,591,230,311,385,109,215,0,7142
"26081011600",6941,626,67,0,262,45,332,60,8333
"26081011701",4482,458,0,0,238,84,63,92,5417
"26081011702",3528,436,72,58,108,67,41,74,4384
"26081011801",5926,28,114,28,608,12,168,0,6884
"26081011803",3328,223,79,0,144,25,0,0,3799
"26081011804",4217,161,88,13,227,15,136,0,4857
"26081011901",5895,72,62,1,88,0,248,0,6366
"26081011902",6575,180,0,14,373,93,73,16,7324
"26081012002",5433,580,145,0,89,40,229,0,6516
"26081012003",5619,461,0,0,72,39,27,0,6218
"26081012004",3996,484,10,0,40,33,163,12,4738
"26081012201",6304,88,48,0,211,0,114,0,6765
"26081012202",6725,156,0,0,30,0,0,0,6911
"26081012203",3499,153,7,0,186,15,173,11,4044
"26081012300",3103,167,30,2,37,21,19,0,3379
"26081012400",3538,72,3,7,68,10,0,0,3698
"26081012500",4324,66,27,0,204,39,53,0,4713
"26081012604",4134,110,610,37,842,22,232,24,6011
"26081012605",2112,354,178,56,293,63,96,0,3152
"26081012606",2162,534,663,801,601,335,237,331,5664
"26081012607",2953,694,1122,309,535,427,321,683,7044
"26081012608",2315,221,143,25,411,0,41,22,3178
"26081012701",3628,263,920,668,779,360,697,72,7387
"26081012702",2915,201,672,68,573,14,156,0,4599
"26081012703",3175,184,684,492,475,25,231,41,5307
"26081012800",3333,154,450,6,295,28,384,11,4661
"26081012901",2514,568,162,193,600,371,555,305,5268
"26081012902",2959,448,339,113,672,36,332,131,5030
"26081013000",2700,257,74,1,260,62,225,74,3653
"26081013100",4225,547,135,61,177,77,383,16,5621
"26081013200",6023,314,41,67,239,137,127,35,6983
"26081013300",2406,1177,384,188,550,156,1150,711,6722
"26081013400",4424,419,48,29,255,210,392,202,5979
"26081013500",2230,842,177,393,805,156,794,587,5984
"26081013600",1044,317,226,153,281,63,435,166,2685
"26081013700",4546,943,179,321,518,40,632,763,7942
"26081013801",1101,170,66,20,161,24,119,24,1685
"26081013802",4187,736,284,400,595,454,1434,516,8606
"26081013900",5217,844,156,139,348,174,850,138,7866
"26081014000",5035,805,184,25,843,79,842,345,8158
"26081014100",1443,196,10,13,151,68,258,88,2227
"26081014200",2398,479,241,52,449,167,720,284,4790
"26081014300",2179,313,124,86,184,61,193,0,3140
"26081014501",9018,614,119,4,698,148,639,222,11462
"26081014502",6464,471,57,21,656,136,791,261,8857
"26081014601",6996,170,105,11,345,16,80,16,7739
"26081014602",8248,563,0,9,390,42,57,51,9360
"26081014701",1852,860,245,198,343,186,52,365,4101
"26081014703",2234,550,443,244,255,119,108,260,4213
"26081014704",2378,329,76,52,154,81,116,12,3198
"26081014803",2671,260,3,6,46,7,0,2,2995
"26081014804",5612,438,1145,469,574,139,141,53,8571
"26081014805",6045,204,263,1,383,0,269,0,7165
"26081014806",5120,274,0,7,116,0,54,12,5583
"26081014807",6256,211,32,5,302,11,362,11,7190
"26083000100",1775,313,3,13,4,11,5,0,2124
"26083980100",12,0,1,1,0,0,0,0,14
"26083990100",0,0,0,0,0,0,0,0,0
"26085960100",1515,388,0,8,77,9,11,2,2010
"26085961100",1998,810,401,159,74,61,33,4,3540
"26085961200",1693,504,121,174,65,119,115,19,2810
"26085961300",2037,850,0,9,39,13,16,42,3006
"26087330000",3109,307,0,8,107,12,70,2,3615
"26087330500",2659,399,11,11,100,26,113,10,3329
"26087331000",1491,275,0,3,44,20,61,43,1937
"26087331500",2308,248,0,0,101,8,48,9,2722
"26087332000",5038,576,0,0,79,0,118,0,5811
"26087332500",3090,490,0,0,74,0,89,22,3765
"26087333000",2745,325,19,3,21,0,109,0,3222
"26087333500",5006,521,0,0,115,27,40,0,5709
"26087334000",1706,280,0,1,214,0,200,7,2408
"26087334500",1987,70,0,0,129,0,77,0,2263
"26087336000",4690,332,68,39,20,0,50,0,5199
"26087336500",0,0,0,0,0,0,0,0,0
"26087337000",2555,890,0,5,13,27,1,7,3498
"26087337500",2941,934,0,6,137,39,199,76,4332
"26087338000",4576,345,0,0,135,0,144,0,5200
"26087338500",4068,500,70,0,56,57,181,46,4978
"26087339000",2668,311,0,2,117,23,518,92,3731
"26087339500",2553,688,0,0,297,48,827,75,4488
"26087340000",3687,160,0,0,11,0,0,0,3858
"26087340500",2321,198,0,0,161,6,67,11,2764
"26087341000",4346,389,0,0,36,11,30,4,4816
"26087341500",3811,339,0,0,86,0,28,23,4287
"26087342000",4061,433,0,0,52,0,96,0,4642
"26087342100",3297,164,19,0,108,0,158,0,3746
"26089970100",1788,136,7,5,13,14,31,0,1994
"26089970200",3888,582,19,39,432,354,172,267,5753
"26089970300",2304,254,0,0,119,87,56,52,2872
"26089970400",1588,135,0,8,3,0,26,36,1796
"26089970500",4057,474,0,12,153,18,36,0,4750
"26089970600",4646,298,0,0,82,0,118,15,5159
"26089990000",0,0,0,0,0,0,0,0,0
"26091060100",3142,215,21,0,114,0,67,3,3562
"26091060301",4597,402,0,0,92,0,69,0,5160
"26091060302",3148,411,0,0,94,0,70,9,3732
"26091060401",2954,434,0,0,74,2,70,3,3537
"26091060402",2689,476,0,0,66,23,6,33,3293
"26091060500",2865,323,16,0,91,55,201,68,3619
"26091060600",4694,230,70,0,86,5,250,51,5386
"26091060700",6086,674,5,38,432,33,330,207,7805
"26091060800",2751,531,90,0,25,79,109,104,3689
"26091061200",1558,145,0,0,53,17,102,11,1886
"26091061301",2359,1169,34,38,76,172,767,343,4958
"26091061302",1354,928,10,101,197,190,184,458,3422
"26091061400",2401,505,66,10,240,78,299,95,3694
"26091061500",3945,598,116,0,97,14,412,82,5264
"26091061600",2316,1276,178,38,341,218,499,644,5510
"26091061700",5801,892,10,48,305,114,366,141,7677
"26091061800",3176,624,13,7,88,0,194,35,4137
"26091061900",3720,540,0,9,113,17,101,45,4545
"26091062000",2406,277,15,0,71,98,163,35,3065
"26091062100",3882,344,0,0,151,3,205,14,4599
"26091062200",2009,428,0,0,112,25,39,25,2638
"26091062300",5073,133,15,0,126,0,104,0,5451
"26091062400",4332,352,13,6,123,3,239,0,5068
"26093710100",2387,47,20,0,0,0,28,0,2482
"26093710300",3372,347,0,0,187,12,65,20,4003
"26093710500",1550,95,0,0,224,0,11,0,1880
"26093710700",1732,58,0,0,12,18,5,0,1825
"26093711000",3672,318,4,0,175,18,28,0,4215
"26093712101",2746,7,0,1,78,0,19,0,2851
"26093712102",2308,128,0,0,112,0,93,0,2641
"26093712601",3144,144,29,0,123,0,0,0,3440
"26093712602",2835,84,34,0,114,3,133,0,3203
"26093713100",4154,126,0,0,61,15,47,0,4403
"26093713300",1301,74,26,2,22,0,5,0,1430
"26093713500",3780,234,0,0,94,0,126,0,4234
"26093713700",4664,72,0,0,94,8,98,0,4936
"26093720100",3046,391,11,0,116,0,102,0,3666
"26093721100",2956,307,21,0,70,1,1,2,3358
"26093722100",2513,353,0,0,0,6,62,0,2934
"26093722300",2505,381,0,0,6,17,239,1,3149
"26093722500",1909,255,11,0,63,0,0,95,2333
"26093724001",1671,283,0,0,16,0,23,91,2084
"26093724002",2365,80,0,0,109,0,14,0,2568
"26093724003",2049,63,1,0,4,16,61,0,2194
"26093725000",4219,604,0,0,262,0,78,0,5163
"26093725100",2971,765,22,19,109,102,93,62,4143
"26093730101",2635,92,0,0,83,0,177,36,3023
"26093730102",3318,253,1,1,41,0,39,0,3653
"26093730600",3317,140,50,0,87,0,0,0,3594
"26093731100",3605,138,6,2,66,7,69,12,3905
"26093732100",2884,353,67,0,94,0,54,3,3455
"26093733100",1699,133,13,8,13,6,0,34,1906
"26093733601",2403,136,0,0,47,0,41,0,2627
"26093733602",3506,275,0,0,19,48,19,0,3867
"26093740200",3369,98,0,22,148,5,143,0,3785
"26093740300",1720,101,12,0,8,0,0,0,1841
"26093740500",2027,77,0,0,63,0,0,5,2172
"26093740600",2882,160,0,0,40,0,17,0,3099
"26093740700",2391,62,27,0,75,4,22,0,2581
"26093740800",2458,166,0,0,163,5,25,0,2817
"26093740900",1601,48,21,0,125,9,18,9,1831
"26093741100",1858,368,13,0,31,0,105,14,2389
"26093741601",1647,74,0,27,6,0,6,0,1760
"26093741602",3142,153,0,1,109,0,23,11,3439
"26093742201",2857,69,0,0,70,0,112,0,3108
"26093742202",1888,170,51,0,11,0,64,1,2185
"26093742401",699,160,13,2,44,44,58,29,1049
"26093742402",3709,195,103,0,56,0,29,9,4101
"26093742500",2312,119,0,0,0,0,0,0,2431
"26093742700",3566,21,12,0,123,3,120,0,3845
"26093742900",3541,113,0,0,19,1,174,1,3849
"26093743300",2330,114,0,0,26,21,51,0,2542
"26093743400",3794,30,0,0,91,0,46,10,3971
"26093743500",1849,123,0,0,23,6,22,0,2023
"26093743600",2702,25,10,0,74,112,71,0,2994
"26093743700",2369,136,0,0,13,47,7,5,2577
"26093743800",3434,145,0,0,186,0,0,0,3765
"26093743900",3579,49,10,0,43,0,72,0,3753
"26093744200",3274,130,0,12,57,18,29,18,3538
"26093744400",2097,110,5,0,53,8,10,0,2283
"26093744600",1715,128,0,0,79,0,45,0,1967
"26093744700",2693,245,0,0,62,0,59,0,3059
"26093744800",3939,140,0,0,173,50,72,50,4424
"26093744900",2317,186,36,0,48,0,0,0,2587
"26095960100",2186,667,19,6,321,69,32,13,3313
"26095960200",1892,233,6,2,50,48,44,12,2287
"26095980000",0,0,0,0,0,0,0,0,0
"26095990000",0,0,0,0,0,0,0,0,0
"26097950100",1384,111,1,2,106,44,0,0,1648
"26097950200",1608,393,0,2,409,55,6,0,2473
"26097950300",1198,244,0,0,131,36,19,20,1648
"26097950400",1511,110,72,29,731,259,10,0,2722
"26097950500",1517,245,3,1,576,143,18,4,2507
"26097990000",0,0,0,0,0,0,0,0,0
"26099206700",2471,321,162,51,371,8,127,3,3514
"26099210000",3879,371,30,0,25,35,9,8,4357
"26099211000",4344,715,55,186,306,85,234,298,6223
"26099212000",5024,245,8,3,55,0,54,8,5397
"26099214000",2194,338,0,1,78,32,94,61,2798
"26099214500",4225,146,109,4,90,0,122,0,4696
"26099215000",4328,241,0,0,209,0,34,22,4834
"26099215200",6500,574,26,6,109,60,145,60,7480
"26099215300",3713,134,110,155,162,15,94,0,4383
"26099215500",6293,213,41,4,523,17,970,0,8061
"26099216000",3612,142,18,0,31,27,233,6,4069
"26099217000",2478,259,0,6,10,8,9,0,2770
"26099218000",4731,532,687,90,325,52,65,22,6504
"26099220001",6746,342,156,3,195,0,194,0,7636
"26099220002",4068,394,0,61,68,0,36,2,4629
"26099221100",5895,372,326,21,126,60,205,15,7020
"26099221200",5298,381,121,0,177,0,218,0,6195
"26099221500",902,63,0,0,63,0,28,0,1056
"26099221800",4361,34,237,0,294,1,74,0,5001
"26099222101",3606,1033,432,16,63,184,32,218,5584
"26099222102",6638,493,711,163,229,242,205,240,8921
"26099222500",3308,127,14,0,69,0,5,0,3523
"26099222800",2696,233,129,11,51,0,76,0,3196
"26099223400",8044,209,411,55,319,31,173,0,9242
"26099223500",957,136,24,1,53,2,4,2,1179
"26099223800",12375,517,244,0,724,0,127,0,13987
"26099223900",6883,251,450,0,440,0,136,0,8160
"26099224000",10619,503,445,0,482,14,120,0,12183
"26099224100",7669,170,300,0,779,0,327,0,9245
"26099224200",6316,588,327,37,343,18,0,0,7629
"26099224300",4584,261,82,0,137,0,0,0,5064
"26099224400",4679,137,5,0,282,39,53,0,5195
"26099224500",3254,196,113,0,434,0,0,0,3997
"26099224600",4246,830,279,48,132,35,267,492,6329
"26099225100",2312,297,108,72,36,20,71,0,2916
"26099225200",5044,230,28,2,271,0,11,0,5586
"26099225300",3660,472,74,15,167,45,65,1,4499
"26099225400",6637,590,101,0,146,42,108,0,7624
"26099225500",4697,617,23,0,26,50,10,98,5521
"26099225600",3439,530,242,0,235,25,205,14,4690
"26099225701",3014,966,684,189,677,81,196,42,5849
"26099225702",1165,160,16,0,89,0,12,25,1467
"26099225800",5049,404,18,6,404,20,105,80,6086
"26099225900",4390,257,10,0,325,0,30,14,5026
"26099226100",6705,638,220,6,291,0,73,0,7933
"26099226400",2206,138,0,1,59,0,86,1,2491
"26099226700",4071,312,0,8,119,0,84,0,4594
"26099227000",5888,490,85,2,459,0,152,0,7076
"26099227300",3631,220,169,198,60,40,26,0,4344
"26099228000",2767,276,72,38,102,30,101,0,3386
"26099228100",1200,141,0,13,79,5,157,1,1596
"26099230000",3299,280,380,109,251,52,65,0,4436
"26099230200",4448,175,30,0,140,0,144,12,4949
"26099230300",3048,1305,22,43,80,24,43,0,4565
"26099230400",3166,154,209,9,0,4,120,0,3662
"26099230500",2580,1151,81,32,43,24,337,67,4315
"26099230601",5733,105,242,0,1172,0,31,0,7283
"26099230602",4665,704,0,0,640,0,32,0,6041
"26099230700",3929,314,35,0,817,249,72,0,5416
"26099230800",3500,648,0,0,330,56,95,42,4671
"26099230900",6198,885,410,146,148,49,345,0,8181
"26099231000",3238,397,228,13,139,57,92,34,4198
"26099231100",2249,213,350,58,395,64,52,1,3382
"26099231200",3051,100,191,135,300,0,22,0,3799
"26099231400",4168,927,142,56,727,56,7,0,6083
"26099231500",3776,843,138,0,582,33,115,0,5487
"26099231600",2286,702,429,163,561,185,42,0,4368
"26099231700",4570,388,430,62,778,77,84,0,6389
"26099231800",3172,380,66,0,203,39,63,0,3923
"26099231900",4336,466,284,1,395,16,67,0,5565
"26099232000",1693,28,35,0,169,17,22,0,1964
"26099232100",4655,473,737,0,557,159,72,0,6653
"26099232200",3233,491,351,5,546,31,51,0,4708
"26099232300",2571,1425,264,24,460,150,67,13,4974
"26099232400",3737,1539,237,0,811,10,0,0,6334
"26099232500",3809,142,259,0,161,85,101,0,4557
"26099233000",5316,152,74,104,112,0,11,0,5769
"26099240000",1861,600,600,532,84,0,41,268,3986
"26099240300",3452,269,66,53,150,26,73,44,4133
"26099240400",4808,260,1,0,170,30,14,0,5283
"26099240500",1726,171,175,0,296,16,340,69,2793
"26099240600",5578,448,491,52,193,0,191,0,6953
"26099240700",3556,174,201,2,158,12,77,23,4203
"26099240800",4398,726,952,285,218,21,135,0,6735
"26099240900",1604,107,28,4,52,1,47,0,1843
"26099241000",2877,329,732,328,105,32,64,8,4475
"26099241200",3335,519,444,211,153,0,0,0,4662
"26099241300",1451,175,569,227,244,18,140,18,2842
"26099241400",2749,367,67,29,189,0,161,0,3562
"26099241500",2744,130,312,23,317,0,54,0,3580
"26099241600",1436,249,411,231,169,12,34,12,2554
"26099241700",2785,494,424,1,368,133,92,9,4306
"26099241800",2826,315,1497,580,154,29,0,0,5401
"26099241900",3618,299,911,191,164,13,0,0,5196
"26099242000",3885,558,639,314,298,78,39,0,5811
"26099242100",1633,157,534,160,65,31,133,0,2713
"26099242500",4963,374,320,27,65,19,25,0,5793
"26099243000",3996,336,422,0,175,30,18,0,4977
"26099243500",3757,399,457,68,205,20,73,0,4979
"26099244000",1871,168,24,0,98,0,2,0,2163
"26099245000",1119,284,1212,833,88,83,5,18,3642
"26099245100",2234,568,436,180,319,54,124,8,3923
"26099245200",1027,439,155,53,25,3,0,0,1702
"26099245300",3496,248,393,197,0,0,0,0,4334
"26099245400",463,126,492,156,89,0,57,49,1432
"26099247100",364,593,13,0,84,46,75,259,1434
"26099247200",5945,170,757,31,79,0,36,0,7018
"26099247300",5712,283,120,0,28,34,64,0,6241
"26099247400",2220,262,0,2,14,1,49,1,2549
"26099247500",1268,340,66,26,43,9,0,20,1772
"26099247601",759,87,349,276,91,37,0,27,1626
"26099247602",2977,481,476,304,236,1,245,139,4859
"26099250000",1928,355,36,3,28,0,82,0,2432
"26099250100",1833,176,76,0,14,36,40,0,2175
"26099250200",2217,296,0,0,130,0,0,0,2643
"26099250300",2676,86,129,151,32,8,15,32,3129
"26099250400",1243,87,0,35,66,0,4,0,1435
"26099250500",1744,234,19,1,13,42,0,1,2054
"26099250600",2313,371,12,0,13,0,150,0,2859
"26099250700",2364,171,122,1,46,16,21,13,2754
"26099250800",2572,196,182,0,51,0,107,0,3108
"26099250900",2360,234,11,47,90,0,104,0,2846
"26099251000",1292,375,5,0,3,33,24,0,1732
"26099251100",1848,66,0,0,58,0,62,0,2034
"26099251200",3045,107,29,0,39,0,26,0,3246
"26099251300",2194,117,12,0,121,0,116,1,2561
"26099251400",2477,204,0,24,131,21,34,0,2891
"26099251500",1516,85,104,13,98,0,49,0,1865
"26099251600",2410,342,170,44,180,0,61,7,3214
"26099251700",2417,349,170,62,79,60,0,71,3208
"26099251800",2654,334,356,221,172,160,47,0,3944
"26099251900",2287,323,36,0,139,67,87,53,2992
"26099252000",2240,171,160,0,72,0,69,0,2712
"26099252100",1905,113,157,18,79,0,29,0,2301
"26099252200",2264,250,237,0,60,0,4,0,2815
"26099254000",1480,186,0,6,41,6,87,0,1806
"26099254100",3512,163,134,99,66,1,36,9,4020
"26099254200",3576,359,189,37,316,4,22,6,4509
"26099254500",3523,481,148,44,22,8,40,35,4301
"26099255000",2975,492,652,104,181,70,21,52,4547
"26099255100",2463,235,96,7,183,12,96,0,3092
"26099255200",2172,194,394,670,260,141,96,0,3927
"26099255300",2819,177,527,213,78,38,87,1,3940
"26099255400",2359,186,26,0,43,94,68,88,2864
"26099255500",1321,156,95,36,108,4,7,5,1732
"26099255600",2812,375,45,69,193,0,106,0,3600
"26099255700",1189,155,264,0,85,5,0,1,1699
"26099255800",1703,385,132,0,63,13,61,0,2357
"26099255900",1211,225,122,117,129,154,8,7,1973
"26099256000",1468,261,209,0,122,73,20,9,2162
"26099256100",1815,404,281,209,67,49,29,1,2855
"26099256200",1352,293,212,65,0,1,28,0,1951
"26099256300",1128,156,473,76,45,58,38,70,2044
"26099256400",972,250,5,99,32,0,0,8,1366
"26099256500",1153,218,90,4,39,41,0,56,1601
"26099256600",1841,230,359,307,115,6,71,0,2929
"26099256700",1365,96,117,145,57,0,7,32,1819
"26099256800",1263,213,0,54,71,40,0,8,1649
"26099258000",1686,113,751,219,76,0,100,0,2945
"26099258100",2403,364,639,238,150,24,133,0,3951
"26099258200",1497,312,505,274,104,0,0,0,2692
"26099258300",1534,296,417,289,27,186,38,185,2972
"26099258400",2905,397,739,776,117,92,57,0,5083
"26099258500",705,42,609,247,97,101,17,4,1822
"26099258600",1926,253,1231,1024,74,114,101,113,4836
"26099258700",1232,208,619,198,364,29,87,10,2747
"26099258800",1060,78,1684,611,199,1,108,0,3741
"26099258900",1275,70,456,600,0,184,58,0,2643
"26099260000",2643,107,135,0,142,67,27,68,3189
"26099260100",2209,199,357,83,18,55,0,29,2950
"26099260200",2123,107,130,0,33,0,15,0,2408
"26099260300",2368,363,87,2,45,25,54,0,2944
"26099260400",3384,197,200,3,455,0,76,0,4315
"26099260600",2051,425,62,0,100,0,0,0,2638
"26099260700",2500,218,19,31,427,150,37,0,3382
"26099260800",2046,247,19,0,509,0,27,0,2848
"26099260900",3313,377,134,80,678,141,7,0,4730
"26099261000",2284,326,371,0,246,86,104,0,3417
"26099261100",2701,869,457,190,91,41,1,0,4350
"26099261200",2488,148,36,48,54,0,68,0,2842
"26099261300",2339,390,87,25,111,0,56,0,3008
"26099261400",2331,208,0,0,290,11,253,0,3093
"26099261500",2315,361,336,128,81,204,33,1,3459
"26099261600",1026,92,51,59,33,25,0,0,1286
"26099261700",1098,154,465,150,21,7,43,0,1938
"26099261800",2034,248,222,1,307,0,40,31,2883
"26099261900",2100,566,156,36,217,0,52,0,3127
"26099262000",2529,284,126,79,208,25,0,11,3262
"26099262100",699,303,174,91,22,45,13,13,1360
"26099262200",3760,197,197,2,142,114,120,1,4533
"26099262300",1959,477,417,79,582,284,0,9,3807
"26099262400",1703,383,447,51,391,335,0,28,3338
"26099262500",3681,485,549,48,353,143,42,1,5302
"26099262600",1957,163,131,41,91,0,8,0,2391
"26099262700",3168,207,745,149,674,26,28,26,5023
"26099262800",1584,331,185,112,267,0,13,7,2499
"26099262900",2505,753,207,56,117,123,6,0,3767
"26099263200",1803,460,368,393,146,78,58,0,3306
"26099263400",2575,457,86,45,297,144,17,33,3654
"26099263500",3238,605,244,68,348,128,30,170,4831
"26099263600",1584,805,1577,458,425,346,65,61,5321
"26099263700",2793,478,672,455,197,153,21,7,4776
"26099263800",927,683,444,408,167,122,146,5,2902
"26099263900",1251,684,527,610,33,132,17,26,3280
"26099264000",565,179,458,466,35,100,18,8,1829
"26099264200",1852,581,465,667,99,50,98,202,4014
"26099267600",1179,54,78,0,144,8,13,0,1476
"26099268000",3676,756,499,202,62,162,70,19,5446
"26099268100",1671,328,293,239,151,32,8,0,2722
"26099268200",3675,320,39,39,20,36,0,0,4129
"26099268300",1280,236,557,796,10,95,12,0,2986
"26099268400",2178,261,177,295,41,66,25,0,3043
"26099982000",4,0,0,0,0,0,0,0,4
"26099982100",0,0,0,0,0,0,0,0,0
"26099982200",0,13,0,7,0,0,0,0,20
"26099982300",51,6,0,0,0,0,0,0,57
"26099990100",0,0,0,0,0,0,0,0,0
"26101000100",2593,745,0,0,45,11,51,6,3451
"26101000200",1691,254,6,1,39,2,49,12,2054
"26101000300",1679,242,3,14,126,2,87,30,2183
"26101000400",1707,339,2,5,118,51,33,3,2258
"26101000500",1980,390,0,45,153,5,19,16,2608
"26101000600",1178,413,0,0,30,0,2,0,1623
"26101000700",3373,419,2,2,240,64,39,3,4142
"26101000800",2595,558,3,64,126,25,38,76,3485
"26101000900",1655,281,0,1,74,10,134,0,2155
"26101990000",0,0,0,0,0,0,0,0,0
"26103000100",1419,714,0,9,29,4,39,22,2236
"26103000200",1600,505,9,10,17,6,0,1,2148
"26103000300",1322,348,7,0,62,26,20,17,1802
"26103000400",1596,462,0,4,33,39,8,0,2142
"26103000500",53,93,0,9,0,12,0,5,172
"26103000600",984,843,18,39,151,196,0,1,2232
"26103000700",2727,553,0,61,27,0,54,0,3422
"26103001100",1383,63,15,0,45,12,13,0,1531
"26103001200",4686,408,14,2,317,81,46,3,5557
"26103001300",3398,428,39,0,63,21,60,0,4009
"26103001500",2760,136,0,0,82,15,0,0,2993
"26103001600",2117,83,9,0,98,0,42,0,2349
"26103001700",1692,327,0,0,59,42,34,0,2154
"26103001800",2292,165,0,0,115,15,62,0,2649
"26103001900",1301,278,0,1,2,8,0,0,1590
"26103002000",1775,637,0,1,94,47,0,0,2554
"26103002100",2738,214,0,0,49,0,31,0,3032
"26103002200",2954,265,0,0,45,3,27,0,3294
"26103002300",1689,413,0,0,16,5,28,7,2158
"26103002400",1878,734,11,30,142,127,33,85,3040
"26103002500",2128,223,0,0,92,24,14,0,2481
"26103002600",1762,207,0,19,54,27,0,0,2069
"26103002800",3250,617,0,0,299,12,0,0,4178
"26103002900",3322,297,28,0,388,19,51,13,4118
"26103990000",0,0,0,0,0,0,0,0,0
"26105950100",2128,370,9,4,104,24,190,14,2843
"26105950200",3006,450,6,0,27,21,6,2,3518
"26105950300",2919,192,0,0,52,2,62,18,3245
"26105950400",3460,727,4,26,232,58,52,75,4634
"26105950500",2524,672,0,1,28,88,73,260,3646
"26105950600",3917,826,22,45,127,103,85,67,5192
"26105950700",2355,652,19,3,69,22,30,11,3161
"26105950800",2596,248,18,0,75,46,110,51,3144
"26105990000",0,0,0,0,0,0,0,0,0
"26107960100",1985,488,0,8,60,18,75,17,2651
"26107960200",2144,348,43,10,135,8,19,0,2707
"26107960300",2339,288,2,0,64,16,10,2,2721
"26107960400",3646,511,31,75,149,33,34,7,4486
"26107960500",2277,1037,35,76,148,3,35,16,3627
"26107960600",1790,1588,37,280,20,181,21,111,4028
"26107960700",4111,1293,0,0,100,116,74,0,5694
"26107960800",3598,1276,20,2,78,26,87,3,5090
"26107960900",2579,478,118,79,79,42,3,4,3382
"26107961000",4827,703,29,0,52,54,104,43,5812
"26107981300",0,8,0,0,0,0,0,0,8
"26109960100",2689,470,11,6,48,26,32,1,3283
"26109960200",2926,407,4,4,321,173,53,30,3918
"26109960300",2138,272,3,0,20,5,47,10,2495
"26109960400",3241,221,0,1,141,41,17,0,3662
"26109960500",2514,326,0,10,43,15,0,1,2909
"26109960600",3144,603,8,0,88,68,0,0,3911
"26109960700",2869,545,0,0,69,0,121,0,3604
"26109990000",0,0,0,0,0,0,0,0,0
"26111290100",2599,753,26,15,132,16,50,61,3652
"26111290200",2737,756,0,0,140,0,62,25,3720
"26111290300",3441,189,18,6,101,0,52,11,3818
"26111290400",1364,238,0,0,33,0,49,0,1684
"26111290500",1792,119,0,9,53,13,12,0,1998
"26111290600",1700,482,0,0,160,0,108,0,2450
"26111290700",2251,719,166,45,543,165,56,56,4001
"26111290800",4177,757,103,0,263,29,42,0,5371
"26111290900",6330,466,148,0,425,0,211,0,7580
"26111291000",4975,632,173,28,338,114,27,124,6411
"26111291101",3047,412,38,1,67,10,36,0,3611
"26111291102",8041,604,180,27,174,95,107,20,9248
"26111291200",4343,470,0,0,271,10,60,0,5154
"26111291300",3867,342,0,7,59,66,51,2,4394
"26111291400",3536,562,0,0,101,8,83,27,4317
"26111291500",3426,735,0,4,65,23,25,34,4312
"26111291601",2120,391,0,0,38,0,7,0,2556
"26111291602",3849,796,0,0,149,2,40,165,5001
"26111291700",3541,795,0,0,88,78,31,74,4607
"26113960100",3052,623,0,0,60,12,36,15,3798
"26113960200",2588,504,0,2,72,57,14,70,3307
"26113960300",4111,622,23,0,93,17,67,16,4949
"26113960400",2498,362,1,5,30,23,107,3,3029
"26115830100",3107,344,0,0,69,7,135,0,3662
"26115830200",4874,494,49,0,248,0,327,3,5995
"26115830300",3207,507,27,1,39,1,37,19,3838
"26115830400",3473,336,59,6,96,9,13,3,3995
"26115830500",3430,297,64,26,84,2,17,13,3933
"26115830600",2352,241,289,44,93,0,39,0,3058
"26115830700",3101,272,38,1,33,0,135,0,3580
"26115830800",5632,892,0,0,184,1,46,5,6760
"26115830900",2468,58,0,0,23,174,81,174,2978
"26115831000",2607,352,45,0,35,28,21,59,3147
"26115831100",1849,360,0,0,0,14,74,112,2409
"26115831200",5321,967,95,0,82,70,66,18,6619
"26115831300",4226,339,22,7,82,107,78,29,4890
"26115831400",4906,1605,217,16,190,225,84,274,7517
"26115831500",2627,262,0,15,83,11,33,0,3031
"26115831600",2546,373,62,68,142,26,154,8,3379
"26115831700",3126,577,42,294,96,30,35,153,4353
"26115831800",791,156,217,232,73,86,281,17,1853
"26115831900",921,240,36,93,126,0,107,12,1535
"26115832000",1408,270,3,131,24,9,15,0,1860
"26115832100",2040,749,18,22,77,48,131,37,3122
"26115832200",1647,155,33,12,39,0,23,12,1921
"26115832300",2956,1178,216,0,123,0,194,0,4667
"26115832400",3614,323,12,23,146,0,74,0,4192
"26115832500",3767,498,201,80,166,36,143,0,4891
"26115832600",2030,278,19,0,45,0,61,78,2511
"26115832700",2044,384,0,0,67,0,26,11,2532
"26115832800",4585,235,16,2,80,2,67,5,4992
"26115832900",4023,366,73,0,111,0,63,3,4639
"26115833000",4165,231,151,15,10,11,10,36,4629
"26115833100",5109,231,18,0,77,0,122,0,5557
"26115833200",3589,505,0,0,98,0,0,0,4192
"26115833300",6265,201,0,0,94,0,178,1,6739
"26115833500",3982,527,56,8,72,11,95,0,4751
"26115833600",2747,388,7,0,156,0,265,19,3582
"26115833700",2056,356,0,37,130,18,94,17,2708
"26115833800",4353,460,0,2,196,0,148,0,5159
"26115833900",4659,259,26,10,102,0,117,0,5173
"26115990000",0,0,0,0,0,0,0,0,0
"26117970100",3693,590,26,0,123,15,49,104,4600
"26117970200",2571,534,94,32,80,21,84,3,3419
"26117970300",2449,618,24,0,118,0,114,10,3333
"26117970400",2190,854,9,72,103,11,79,0,3318
"26117970500",6308,1109,144,0,180,103,70,124,8038
"26117970600",4284,751,27,4,84,25,221,6,5402
"26117970700",3953,760,22,2,23,49,85,42,4936
"26117970800",3485,866,19,65,43,17,54,40,4589
"26117970900",2811,467,0,0,8,3,83,5,3377
"26117971000",4071,719,6,0,127,36,101,35,5095
"26117971100",3991,936,6,0,202,44,189,18,5386
"26117971200",3855,1206,0,2,92,149,132,49,5485
"26117971300",3766,1152,0,14,173,0,144,0,5249
"26119910100",1921,491,0,0,40,14,5,0,2471
"26119910200",1380,357,7,0,34,0,54,0,1832
"26119910300",1507,237,0,0,35,0,29,0,1808
"26119910400",1732,240,4,0,66,11,0,11,2064
"26119910500",979,356,0,0,5,0,4,0,1344
"26121000100",1700,354,688,772,308,1,96,13,3932
"26121000300",572,692,625,1076,238,115,208,60,3586
"26121000401",1498,638,1439,319,469,130,280,74,4847
"26121000402",127,202,163,161,136,30,0,0,819
"26121000500",1224,1028,1132,886,356,282,420,167,5495
"26121000601",562,384,324,529,86,101,182,11,2179
"26121000800",1691,569,111,293,192,57,210,184,3307
"26121000900",2245,686,175,265,107,33,31,0,3542
"26121001000",1054,133,20,0,53,0,41,0,1301
"26121001200",93,234,1258,658,78,14,4,22,2361
"26121001300",60,52,992,1307,51,100,0,15,2577
"26121001402",722,215,1385,1297,105,87,27,44,3882
"26121001500",3333,209,15,0,174,8,56,17,3812
"26121001600",2541,109,24,0,102,0,97,0,2873
"26121001700",4252,237,88,22,74,46,126,10,4855
"26121001800",3399,928,129,3,58,16,50,10,4593
"26121001901",2522,701,151,111,219,237,94,67,4102
"26121001902",3782,775,68,234,120,126,269,73,5447
"26121002000",2853,610,9,3,48,0,141,91,3755
"26121002100",2047,653,130,29,64,52,107,56,3138
"26121002200",2920,311,96,228,146,39,178,52,3970
"26121002300",4666,557,62,0,265,84,439,25,6098
"26121002400",2791,141,134,14,74,96,120,0,3370
"26121002500",7102,313,31,4,413,27,173,0,8063
"26121002601",2187,424,35,2,148,22,91,63,2972
"26121002602",3406,355,224,45,210,41,134,0,4415
"26121002700",6438,782,19,2,137,93,134,102,7707
"26121002800",5326,284,39,6,358,34,125,16,6188
"26121002900",4456,279,20,0,96,158,243,162,5414
"26121003000",3672,540,0,23,145,46,264,78,4768
"26121003100",3110,944,0,22,119,62,206,67,4530
"26121003200",4153,860,59,0,304,41,362,18,5797
"26121003300",3772,1198,0,0,76,37,126,39,5248
"26121003400",3210,500,53,61,31,71,118,41,4085
"26121003500",3206,589,9,35,164,13,17,209,4242
"26121003600",5695,873,45,62,117,105,176,15,7088
"26121003700",4574,537,23,17,97,26,277,6,5557
"26121003800",2805,406,27,2,87,24,175,0,3526
"26121003900",1615,250,1,0,22,26,75,46,2035
"26121004000",1762,131,0,6,44,1,34,2,1980
"26121004200",1133,496,782,462,69,189,155,77,3363
"26121004300",168,33,833,904,16,116,10,7,2087
"26121990000",0,0,0,0,0,0,0,0,0
"26123970100",3269,985,146,35,124,35,47,56,4697
"26123970300",2864,659,34,0,240,25,129,74,4025
"26123970400",4602,687,27,3,130,42,154,197,5842
"26123970500",3449,835,31,5,57,79,59,115,4630
"26123970600",2715,584,0,0,143,5,127,18,3592
"26123970700",2812,1006,49,27,95,58,44,7,4098
"26123970800",2639,518,0,17,63,4,46,7,3294
"26123970900",3766,436,2,5,149,23,73,13,4467
"26123971000",3828,553,14,4,177,44,169,38,4827
"26123971100",3158,696,18,21,302,235,386,330,5146
"26123971200",3445,1130,22,26,125,33,264,267,5312
"26125120000",2694,279,109,0,55,0,25,92,3254
"26125120300",2875,256,56,0,67,0,111,7,3372
"26125121000",2079,418,0,0,44,12,100,59,2712
"26125121400",3919,73,95,0,22,4,67,4,4184
"26125121500",3013,421,30,0,0,0,114,0,3578
"26125121700",5134,178,18,2,197,0,114,0,5643
"26125121800",4400,388,0,39,99,0,164,34,5124
"26125122200",3297,130,0,0,132,15,148,0,3722
"26125122400",5996,778,0,0,106,26,34,112,7052
"26125122700",2614,214,0,0,36,0,26,40,2930
"26125122900",1430,248,12,17,64,35,51,44,1901
"26125123000",1802,467,131,0,60,4,0,89,2553
"26125123100",2922,76,13,0,47,0,0,0,3058
"26125124000",4858,197,82,10,108,10,184,10,5459
"26125124500",4914,825,99,14,210,0,392,17,6471
"26125125000",3055,321,96,0,96,0,16,10,3594
"26125125600",2641,52,0,0,12,1,84,0,2790
"26125126200",2449,86,8,0,9,0,144,36,2732
"26125126300",4164,449,13,15,50,0,110,9,4810
"26125126400",3571,23,13,0,47,21,46,16,3737
"26125126500",3003,92,0,0,29,0,66,0,3190
"26125127000",5187,412,0,3,156,4,102,21,5885
"26125127100",4895,148,14,0,174,0,109,0,5340
"26125127200",1508,97,0,0,17,5,14,29,1670
"26125127300",3987,368,147,53,181,50,55,2,4843
"26125127400",1574,79,14,1,4,1,82,0,1755
"26125127500",5693,169,178,0,368,68,171,0,6647
"26125127600",3297,69,175,0,237,0,52,0,3830
"26125127700",5282,677,108,2,259,62,352,0,6742
"26125128000",3016,196,8,0,27,0,45,0,3292
"26125128100",2680,120,21,2,24,0,109,0,2956
"26125128200",3000,81,10,0,168,0,154,0,3413
"26125128300",3499,221,36,0,290,39,67,0,4152
"26125128400",2664,514,90,48,322,105,194,109,4046
"26125128500",2709,171,221,1,205,100,232,18,3657
"26125128600",2861,217,11,0,253,0,64,60,3466
"26125128700",1928,131,39,0,152,11,204,0,2465
"26125128800",1168,161,49,1,101,0,40,7,1527
"26125128900",3853,368,259,0,467,0,250,80,5277
"26125129000",2598,254,0,0,27,9,51,26,2965
"26125130000",2612,534,89,240,125,13,40,0,3653
"26125130100",1978,170,4,3,159,0,100,0,2414
"26125130200",4566,267,160,0,65,12,50,1,5121
"26125130300",3090,774,38,0,21,32,54,176,4185
"26125130400",2887,29,9,0,78,21,84,21,3129
"26125130500",2812,77,0,0,45,14,53,8,3009
"26125130600",2850,126,26,1,100,14,37,14,3168
"26125130700",5543,26,284,0,185,46,131,0,6215
"26125131100",2063,80,0,8,99,8,10,10,2278
"26125131300",3978,138,248,0,48,4,0,0,4416
"26125131400",2018,127,0,0,16,0,48,0,2209
"26125131500",3356,383,20,0,7,17,169,7,3959
"26125131600",2284,208,5,0,83,17,33,0,2630
"26125131800",3271,692,1,0,53,0,12,0,4029
"26125132100",4979,341,0,1,271,9,137,0,5738
"26125132500",2844,409,0,17,36,50,48,0,3404
"26125132600",3724,106,30,0,98,1,66,11,4036
"26125132700",2767,65,0,11,55,0,76,0,2974
"26125133001",2481,8,0,0,116,0,64,0,2669
"26125133002",3088,326,12,0,115,0,142,13,3696
"26125133003",2561,192,109,74,87,59,60,0,3142
"26125133100",1828,539,819,431,390,335,172,473,4987
"26125134000",4320,299,34,0,193,0,57,0,4903
"26125134300",4350,294,64,0,50,1,67,1,4827
"26125134400",3961,374,0,0,171,13,36,0,4555
"26125134500",2532,180,0,0,395,0,56,0,3163
"26125134600",3830,187,0,0,63,0,161,0,4241
"26125134700",2630,262,76,10,198,26,194,151,3547
"26125134800",2858,103,87,0,81,7,291,0,3427
"26125134900",2980,592,22,0,199,47,167,0,4007
"26125135000",2157,357,53,1,307,79,84,0,3038
"26125135100",4752,348,48,0,136,37,42,33,5396
"26125135200",2509,98,128,16,259,0,72,0,3082
"26125135300",4421,68,91,2,144,0,107,0,4833
"26125136000",1822,99,325,13,536,12,56,12,2875
"26125136101",3089,336,56,0,982,116,254,0,4833
"26125136102",2533,529,326,172,450,31,39,0,4080
"26125136300",3200,50,567,8,772,186,88,54,4925
"26125136500",3906,152,393,22,831,33,100,1,5438
"26125136600",4586,184,40,112,2811,104,81,0,7918
"26125136700",4141,153,199,0,1043,0,127,1,5664
"26125136800",2838,166,303,22,690,0,63,0,4082
"26125137100",5952,291,403,38,1957,144,186,13,8984
"26125137400",5293,24,223,0,909,0,86,0,6535
"26125137700",1472,138,53,0,112,0,38,0,1813
"26125137800",2891,108,36,0,227,9,254,0,3525
"26125138100",4141,155,18,1,165,113,179,25,4797
"26125138301",2921,206,61,18,57,27,142,20,3452
"26125138302",4520,121,109,0,242,14,55,0,5061
"26125138600",1913,61,13,0,68,0,45,9,2109
"26125139200",5936,453,69,0,213,12,240,0,6923
"26125139400",4501,153,122,0,135,8,183,0,5102
"26125140100",1109,42,40,0,88,9,145,9,1442
"26125140301",2021,694,585,269,410,106,439,442,4966
"26125140302",2173,372,351,0,380,49,239,62,3626
"26125140500",1515,197,202,27,182,0,139,0,2262
"26125140600",1479,113,634,85,153,0,32,25,2521
"26125140700",1788,143,318,150,175,181,298,205,3258
"26125140800",2464,177,633,121,1151,0,309,0,4855
"26125140900",769,564,990,410,156,72,165,372,3498
"26125141000",2220,293,1673,990,660,49,645,30,6560
"26125141100",1492,323,463,442,278,49,376,121,3544
"26125141200",776,713,798,579,303,178,424,330,4101
"26125141300",2109,890,442,146,119,91,636,494,4927
"26125141400",1364,669,770,392,491,420,803,535,5444
"26125141500",517,620,2600,1675,330,107,332,319,6500
"26125141600",881,687,1472,593,330,451,382,304,5100
"26125141700",1242,958,360,487,65,239,429,787,4567
"26125142000",414,599,782,382,114,115,164,505,3075
"26125142100",420,413,217,205,148,5,58,166,1632
"26125142200",148,256,1179,1380,8,364,43,121,3499
"26125142300",213,113,1002,802,51,252,26,0,2459
"26125142400",80,187,1645,953,35,231,0,166,3297
"26125142500",185,136,1086,201,11,17,0,91,1727
"26125142600",1441,406,979,193,201,130,286,127,3763
"26125142700",42,15,2580,815,151,52,39,52,3746
"26125143500",5335,400,86,41,65,16,177,118,6238
"26125144100",3590,317,227,1,174,107,162,139,4717
"26125144200",3907,293,0,0,186,0,243,0,4629
"26125144300",3148,279,13,3,48,0,31,6,3528
"26125144400",3820,422,76,0,280,8,262,0,4868
"26125144500",2722,209,81,3,77,18,117,35,3262
"26125144600",3344,177,76,23,271,0,151,2,4044
"26125144701",1748,1177,322,141,99,68,189,525,4269
"26125144800",1582,656,145,45,201,121,35,340,3125
"26125144900",2941,382,225,228,200,38,135,0,4149
"26125145100",1983,124,35,6,99,0,21,0,2268
"26125145200",2822,435,135,11,81,0,82,0,3566
"26125145300",3701,591,25,71,194,18,276,231,5107
"26125145400",2825,609,303,119,426,59,386,95,4822
"26125145501",3075,214,148,0,90,0,103,58,3688
"26125145502",3040,391,190,83,78,84,302,133,4301
"26125145600",3601,445,127,42,95,73,170,83,4636
"26125145700",2025,162,77,43,71,3,32,34,2447
"26125145900",1861,406,151,218,112,26,50,36,2860
"26125150000",3521,213,644,298,831,12,114,0,5633
"26125150100",2384,180,724,57,253,83,8,0,3689
"26125150200",1953,162,116,0,293,37,28,0,2589
"26125150300",3242,166,506,88,510,14,42,7,4575
"26125150400",2412,15,19,7,277,0,125,0,2855
"26125150500",2468,231,24,3,72,3,0,0,2801
"26125150600",1862,34,211,33,475,0,96,0,2711
"26125150700",3374,270,122,0,411,62,47,0,4286
"26125150800",3279,153,169,17,425,0,23,9,4075
"26125150900",2672,249,489,1,358,0,39,0,3808
"26125151000",4266,134,0,2,569,0,38,0,5009
"26125152000",3205,107,29,0,377,15,72,0,3805
"26125152600",3451,75,102,0,150,0,22,0,3800
"26125152700",2858,88,38,0,75,0,20,8,3087
"26125152900",3252,81,363,0,196,24,93,8,4017
"26125153000",1647,142,39,0,109,6,72,30,2045
"26125153100",1896,173,53,0,83,5,83,0,2293
"26125153200",1606,66,34,0,105,0,9,0,1820
"26125153300",3187,44,136,0,103,0,91,0,3561
"26125154000",1542,51,59,0,16,0,32,0,1700
"26125154100",2121,145,144,2,84,0,42,12,2550
"26125154200",1886,656,110,64,260,0,145,352,3473
"26125154500",1888,69,81,0,152,0,48,0,2238
"26125154600",2068,54,347,82,529,0,12,0,3092
"26125156000",1772,98,152,0,162,38,12,37,2271
"26125156100",3334,172,308,35,552,0,106,8,4515
"26125156200",5819,97,394,54,375,0,109,6,6854
"26125156300",3285,69,294,0,413,0,180,0,4241
"26125156400",3171,91,482,32,375,31,58,20,4260
"26125156500",3159,126,553,0,588,0,95,0,4521
"26125156900",1862,96,392,5,566,0,114,0,3035
"26125157000",1998,69,217,0,160,5,31,0,2480
"26125157100",1257,167,223,0,311,21,0,0,1979
"26125157200",2348,469,626,111,167,6,42,0,3769
"26125157300",1718,123,674,26,440,3,36,0,3020
"26125157400",1707,199,241,6,342,0,6,0,2501
"26125157500",1634,104,653,118,244,0,58,0,2811
"26125157600",2630,616,812,20,814,36,24,0,4952
"26125157700",1706,30,273,1,483,14,0,0,2507
"26125157800",2049,70,765,11,413,0,7,0,3315
"26125157900",1900,59,398,27,509,35,43,0,2971
"26125158000",3365,25,131,0,258,0,84,0,3863
"26125158100",2495,90,417,9,55,25,45,28,3164
"26125158200",3003,55,98,8,144,48,52,8,3416
"26125159000",3511,197,297,4,278,11,43,6,4347
"26125160000",1447,53,2212,181,146,0,18,0,4057
"26125160300",443,184,1170,680,82,74,104,23,2760
"26125160400",338,56,1956,356,124,0,10,0,2840
"26125160500",1563,489,1419,278,257,0,15,0,4021
"26125160600",1357,187,2495,264,270,0,142,16,4731
"26125160700",474,1,842,90,50,3,0,0,1460
"26125160800",979,116,2413,287,86,95,72,1,4049
"26125160900",575,64,2482,479,371,0,160,0,4131
"26125161000",258,47,1295,380,79,0,20,0,2079
"26125161100",641,559,1949,257,76,174,0,0,3656
"26125161200",854,200,3097,100,198,27,16,0,4492
"26125161300",992,284,1910,287,419,0,151,0,4043
"26125161400",1190,325,1407,394,36,11,8,1,3372
"26125161500",247,28,1158,313,85,67,23,16,1937
"26125161600",190,44,1429,269,105,0,0,0,2037
"26125161700",574,75,1893,130,105,0,39,0,2816
"26125161800",505,23,2801,489,115,2,51,5,3991
"26125161900",486,55,1410,82,52,0,0,19,2104
"26125162000",457,121,3120,119,63,6,29,0,3915
"26125162100",48,19,2184,751,59,23,35,0,3119
"26125162200",44,0,850,110,121,0,0,0,1125
"26125162300",327,34,2792,431,214,0,74,0,3872
"26125162400",359,35,1216,444,57,11,51,1,2174
"26125162500",880,213,1749,608,43,129,26,10,3658
"26125165000",2509,146,24,100,224,0,9,0,3012
"26125165100",2899,152,446,16,172,32,18,7,3742
"26125165200",1526,128,346,104,1437,92,110,0,3743
"26125166000",1520,254,404,57,125,20,42,36,2458
"26125166100",1737,202,1058,13,105,13,78,0,3206
"26125166200",2320,38,41,2,221,37,46,1,2706
"26125166400",2483,204,222,0,493,0,56,0,3458
"26125166500",1936,40,281,1,430,77,74,0,2839
"26125166600",1584,289,695,327,504,104,94,0,3597
"26125166700",1270,86,727,21,283,12,25,0,2424
"26125166800",2236,127,817,12,224,29,67,0,3512
"26125166900",2461,228,483,0,409,0,112,9,3702
"26125167000",3562,156,532,0,832,0,54,0,5136
"26125167300",2026,401,481,35,392,36,103,36,3510
"26125167400",2795,653,1126,237,595,11,177,1,5595
"26125167500",3245,417,1079,0,686,39,111,0,5577
"26125167800",3013,413,667,60,680,0,249,0,5082
"26125167900",2119,56,367,88,255,7,12,0,2904
"26125168100",1676,127,227,0,276,0,115,0,2421
"26125168400",2336,57,315,26,653,0,53,0,3440
"26125168500",1406,203,485,26,384,27,113,0,2644
"26125168600",4689,104,1037,34,385,0,144,0,6393
"26125168700",2225,175,493,0,864,9,55,9,3830
"26125168800",1844,15,295,2,97,0,37,0,2290
"26125168900",1557,219,1279,12,1567,89,109,0,4832
"26125170000",2460,35,0,0,40,19,66,0,2620
"26125170100",2279,198,138,15,82,0,30,0,2742
"26125170200",2714,265,47,0,305,0,46,0,3377
"26125170300",2354,126,9,0,22,45,20,0,2576
"26125170400",3499,216,19,20,114,42,90,27,4027
"26125171000",2665,907,922,68,238,0,0,0,4800
"26125171100",1067,143,1374,329,343,0,40,0,3296
"26125171200",916,111,946,207,189,13,27,3,2412
"26125171300",363,214,1933,282,226,50,0,8,3076
"26125171400",1586,225,3653,649,238,135,57,5,6548
"26125171500",370,0,3919,1056,123,22,65,0,5555
"26125171600",563,232,597,306,342,143,99,15,2297
"26125172400",304,332,882,288,46,4,14,0,1870
"26125172500",52,14,1651,709,131,109,7,0,2673
"26125173000",2987,668,330,317,58,109,235,42,4746
"26125173100",1105,182,115,0,62,19,31,0,1514
"26125173200",2339,122,61,14,160,0,56,0,2752
"26125173300",1197,39,233,31,187,6,47,20,1760
"26125173400",3792,751,419,285,277,15,183,0,5722
"26125173500",2285,233,73,10,101,76,48,9,2835
"26125173600",1100,131,91,8,37,8,30,0,1405
"26125175000",2093,685,59,27,46,54,30,0,2994
"26125175100",3238,713,93,367,208,155,0,0,4774
"26125175200",2807,1183,242,0,422,12,80,26,4772
"26125175300",2052,822,555,362,139,123,0,0,4053
"26125180000",2157,185,0,0,316,109,87,35,2889
"26125180100",2384,213,26,0,107,0,28,0,2758
"26125180200",3283,169,7,0,97,6,93,10,3665
"26125180300",2432,187,39,0,73,20,43,0,2794
"26125181000",1373,1274,571,272,866,106,102,0,4564
"26125181100",2630,162,55,99,76,0,90,0,3112
"26125181200",4778,863,110,0,520,53,0,24,6348
"26125181300",3715,725,307,128,336,140,112,0,5463
"26125181400",2216,561,39,50,104,16,9,0,2995
"26125181500",1867,235,21,0,311,25,50,0,2509
"26125181600",3909,764,16,36,257,51,17,0,5050
"26125183000",2479,323,121,69,285,47,63,15,3402
"26125183100",4113,177,110,12,81,32,154,0,4679
"26125183200",2529,216,48,14,91,17,10,0,2925
"26125183300",2792,78,68,0,126,32,34,0,3130
"26125183400",2078,160,118,103,203,7,68,0,2737
"26125183500",1455,170,304,34,224,15,24,9,2235
"26125183600",3960,149,60,5,156,0,100,47,4477
"26125183700",5017,281,6,7,197,8,152,21,5689
"26125183800",3696,210,187,0,66,0,30,0,4189
"26125183900",2267,112,26,0,71,87,33,0,2596
"26125184000",2803,177,0,1,68,19,122,10,3200
"26125184100",2240,296,95,0,62,0,57,0,2750
"26125184200",3292,296,14,12,400,0,91,69,4174
"26125184300",2724,93,0,31,99,0,124,0,3071
"26125184400",2285,262,104,0,39,21,23,20,2754
"26125184500",2139,118,52,0,67,12,69,7,2464
"26125184600",2400,223,60,0,154,0,46,0,2883
"26125184700",1422,57,120,4,75,4,18,0,1700
"26125187000",2205,88,39,0,193,8,20,16,2569
"26125188000",3593,53,124,0,125,5,18,0,3918
"26125188100",2273,52,5,2,48,0,12,0,2392
"26125190200",2977,66,0,4,186,0,9,0,3242
"26125190400",2729,194,43,3,116,0,47,0,3132
"26125190500",2338,120,92,0,78,0,176,0,2804
"26125190700",4011,41,203,1,652,0,133,0,5041
"26125190800",2659,78,164,0,222,0,119,0,3242
"26125191000",1393,200,23,18,18,0,11,26,1689
"26125191100",1815,166,72,18,144,14,25,0,2254
"26125191200",3979,129,473,1,312,0,155,0,5049
"26125191300",3401,146,101,0,359,0,200,12,4219
"26125192000",4616,272,468,28,331,37,202,0,5954
"26125192200",4984,52,288,7,483,0,61,9,5884
"26125192400",4541,112,109,0,277,35,154,0,5228
"26125192500",2555,41,65,0,317,0,72,0,3050
"26125192700",2378,129,190,0,400,0,22,39,3158
"26125192800",383,53,230,0,68,18,11,29,792
"26125193000",2555,80,248,1,206,19,148,0,3257
"26125193100",2898,178,74,43,221,0,99,21,3534
"26125193300",2979,348,456,47,436,93,151,28,4538
"26125193400",3351,186,36,0,664,24,54,0,4315
"26125193500",2105,409,87,0,70,0,346,116,3133
"26125193600",1595,248,68,0,251,128,182,0,2472
"26125193700",3371,209,40,9,790,132,253,0,4804
"26125194000",2490,207,438,130,1588,136,67,0,5056
"26125194100",2091,103,156,0,489,1,71,1,2912
"26125194200",1685,36,133,1,112,0,0,0,1967
"26125194300",2515,216,305,20,452,12,120,0,3640
"26125194400",3019,658,22,0,237,0,150,0,4086
"26125194500",924,81,5,5,3,0,0,0,1018
"26125194600",3278,158,177,0,738,13,58,0,4422
"26125196000",4277,206,95,0,1214,141,90,9,6032
"26125196100",4107,290,354,45,960,21,0,0,5777
"26125196200",3008,79,225,0,691,79,30,0,4112
"26125196300",2619,172,23,0,587,13,17,2,3433
"26125196400",2895,50,140,2,776,1,83,1,3948
"26125196500",4221,34,0,2,1360,90,83,0,5790
"26125196600",1626,16,23,1,509,26,25,0,2226
"26125196700",2599,34,11,1,179,0,4,0,2828
"26125196800",2858,94,36,0,1394,34,70,0,4486
"26125196900",2074,285,114,0,838,31,61,26,3429
"26125197000",3025,250,104,7,1133,82,68,0,4669
"26125197100",1652,58,58,0,404,53,10,5,2240
"26125197200",2604,47,24,0,837,117,59,0,3688
"26125197300",4051,474,172,8,215,69,180,0,5169
"26125197400",1256,378,47,59,188,66,120,0,2114
"26125197500",2307,298,330,73,1114,290,198,0,4610
"26125197600",1236,78,89,21,539,9,16,21,2009
"26125197701",2251,107,212,70,1670,98,106,29,4543
"26125197702",670,97,58,0,1070,58,15,0,1968
"26125197900",2624,128,221,2,719,24,62,0,3780
"26125198000",2298,224,98,0,841,0,112,0,3573
"26125198100",1203,667,87,34,521,148,63,34,2757
"26125981000",0,0,0,0,0,0,0,0,0
"26127010300",5324,1166,24,0,310,150,993,345,8312
"26127010400",2802,1052,7,0,148,103,405,419,4936
"26127010500",2449,805,2,6,135,62,478,527,4464
"26127010600",4209,862,0,6,201,19,121,15,5433
"26127010800",2143,411,0,42,49,30,85,41,2801
"26127010900",1703,261,3,0,40,30,65,78,2180
"26127011000",1354,195,0,0,23,0,32,0,1604
"26127990000",0,0,0,0,0,0,0,0,0
"26129950100",1812,499,1,0,18,14,22,0,2366
"26129950200",2705,350,1,0,42,0,29,8,3135
"26129950300",1597,263,0,0,38,8,23,8,1937
"26129950400",2461,610,0,1,66,12,47,0,3197
"26129950500",3303,738,1,4,65,34,88,35,4268
"26129950600",1951,566,0,0,16,70,18,3,2624
"26129950900",2442,1322,7,0,128,79,40,13,4031
"26131970100",1438,297,0,0,26,6,16,0,1783
"26131970200",2305,327,5,5,81,27,0,3,2753
"26131970300",1692,228,8,0,21,2,44,2,1997
"26131990100",0,0,0,0,0,0,0,0,0
"26133970100",3185,839,0,5,73,35,68,6,4211
"26133970200",3309,528,0,1,94,4,13,9,3958
"26133970300",2549,425,2,4,73,22,3,0,3078
"26133970400",2062,864,7,0,46,24,71,16,3090
"26133970500",3506,743,53,6,61,38,45,15,4467
"26133970600",2938,1341,4,10,26,86,83,4,4492
"26135970201",1190,266,0,0,51,4,9,2,1522
"26135970202",1287,298,0,0,62,3,6,0,1656
"26135970300",1165,556,2,0,38,8,37,0,1806
"26135970400",1700,341,0,1,1,18,3,4,2068
"26135970500",1231,228,0,0,66,0,26,0,1551
"26137950100",2440,347,0,0,37,15,9,15,2863
"26137950200",5116,702,0,0,61,50,94,54,6077
"26137950300",3634,1013,0,0,169,279,47,0,5142
"26137950400",1747,176,0,0,12,2,0,0,1937
"26137950500",2865,315,0,2,87,35,0,21,3325
"26137950600",4179,251,22,0,70,1,76,0,4599
"26139020100",4489,314,5,17,168,70,138,85,5286
"26139020200",3617,537,1,1,27,97,209,46,4535
"26139020400",3372,526,38,0,82,0,68,0,4086
"26139020501",2603,349,0,1,18,133,0,20,3124
"26139020503",3433,213,0,0,112,9,0,0,3767
"26139020504",1700,550,0,0,47,0,38,124,2459
"26139020600",2977,221,50,0,61,7,142,7,3465
"26139020900",3895,413,0,0,58,52,0,0,4418
"26139021000",4553,516,0,27,43,22,54,2,5217
"26139021100",4303,353,11,11,131,1,64,23,4897
"26139021201",4037,557,0,0,200,11,100,0,4905
"26139021202",5128,476,0,0,512,318,205,341,6980
"26139021301",2702,325,6,0,43,3,14,3,3096
"26139021303",2387,148,0,0,83,93,70,108,2889
"26139021304",4396,308,28,0,171,9,125,86,5123
"26139021400",7015,393,18,0,135,25,87,25,7698
"26139021500",6852,245,139,30,224,66,295,66,7917
"26139021603",4184,287,31,10,30,46,43,8,4639
"26139021604",6941,114,48,0,206,54,134,54,7551
"26139021605",3784,110,48,0,123,0,43,0,4108
"26139021606",4312,401,11,0,75,26,11,26,4862
"26139021700",3229,347,38,0,131,19,121,0,3885
"26139021801",3753,535,0,0,87,101,37,0,4513
"26139021802",3534,305,51,0,349,4,125,4,4372
"26139021901",3788,150,14,0,188,1,88,0,4229
"26139021902",6610,515,88,0,531,367,333,342,8786
"26139022001",3645,207,0,28,505,247,450,299,5381
"26139022002",3502,291,109,0,222,15,165,118,4422
"26139022103",1318,87,0,0,16,0,86,8,1515
"26139022105",3968,337,57,82,611,41,531,217,5844
"26139022106",3547,61,0,0,58,19,278,19,3982
"26139022107",1067,167,0,0,133,75,19,145,1606
"26139022108",5644,273,78,0,336,0,335,0,6666
"26139022203",5188,1173,416,224,1902,644,1988,1234,12769
"26139022206",3398,209,87,0,415,62,242,0,4413
"26139022600",1762,43,25,0,190,0,298,7,2325
"26139022900",4837,737,74,7,364,98,106,86,6309
"26139023001",4939,258,1,0,88,0,235,0,5521
"26139023002",5702,250,0,0,282,69,286,0,6589
"26139023100",6450,749,63,0,2793,466,2453,486,13460
"26139023200",2206,113,21,18,33,102,17,88,2598
"26139023500",4577,18,44,0,82,6,32,0,4759
"26139023600",2376,46,0,0,41,0,29,0,2492
"26139024300",4098,551,0,6,104,0,238,0,4997
"26139024400",6536,1652,89,97,522,122,249,123,9390
"26139024500",756,2952,92,116,105,112,181,194,4508
"26139024600",4478,119,0,0,377,0,200,0,5174
"26139024900",2670,1067,208,31,322,395,1115,564,6372
"26139025100",4829,371,194,58,1043,183,1288,74,8040
"26139025200",2989,465,140,145,932,325,575,468,6039
"26139025500",3577,265,46,22,128,0,100,40,4178
"26139025700",4065,601,102,10,467,63,439,265,6012
"26139025800",3802,794,124,37,963,389,2328,623,9060
"26139990000",0,0,0,0,0,0,0,0,0
"26141950100",1724,129,0,0,23,11,14,0,1901
"26141950200",2370,218,0,4,11,0,0,0,2603
"26141950300",1750,294,0,0,35,28,36,19,2162
"26141950400",1823,474,0,29,40,10,12,10,2398
"26141950500",2162,353,5,0,60,37,5,16,2638
"26141950600",1339,90,0,0,15,0,0,0,1444
"26141990000",0,0,0,0,0,0,0,0,0
"26143970100",1373,333,0,0,17,0,1,0,1724
"26143970200",1355,469,0,0,0,37,0,38,1899
"26143970300",1770,674,0,0,20,39,14,36,2553
"26143970400",1508,235,0,0,189,54,4,5,1995
"26143970500",790,203,0,4,4,37,2,43,1083
"26143970600",1703,495,0,0,27,7,36,26,2294
"26143970700",2357,374,0,9,4,0,25,0,2769
"26143971000",3360,1016,23,0,31,45,37,0,4512
"26143971100",2332,801,0,0,17,35,24,3,3212
"26143971200",1721,438,0,3,52,0,8,0,2222
"26145000100",56,198,416,682,30,13,30,6,1431
"26145000200",6,85,679,370,44,183,20,73,1460
"26145000400",79,86,520,678,52,15,42,5,1477
"26145000600",415,102,816,564,97,148,270,139,2551
"26145000700",183,143,856,435,79,67,138,97,1998
"26145000800",150,105,1146,1087,36,65,111,93,2793
"26145000900",281,123,1311,1518,84,65,19,0,3401
"26145001000",535,277,1756,1228,200,82,427,98,4603
"26145001100",466,427,799,1433,194,119,580,191,4209
"26145001200",1245,536,532,276,371,125,542,241,3868
"26145001300",797,454,336,278,198,92,227,46,2428
"26145001400",1641,211,109,105,57,0,158,74,2355
"26145001500",2048,920,330,119,215,36,233,329,4230
"26145001600",1845,936,398,323,242,210,491,534,4979
"26145001700",917,403,180,415,53,47,152,93,2260
"26145001800",592,500,672,120,12,33,17,250,2196
"26145001900",928,565,118,262,32,0,172,171,2248
"26145002000",1885,554,387,145,443,28,350,95,3887
"26145002100",2373,616,726,95,336,0,343,199,4688
"26145010100",7373,540,48,1,375,24,191,0,8552
"26145010200",2627,692,23,43,215,88,136,97,3921
"26145010302",5977,391,402,153,562,0,237,1,7723
"26145010303",2863,145,222,67,138,21,203,0,3659
"26145010304",2879,699,366,194,573,110,173,14,5008
"26145010401",1957,261,131,28,8,21,53,21,2480
"26145010402",4556,536,338,115,110,16,248,116,6035
"26145010403",4410,334,602,77,198,85,238,269,6213
"26145010501",2140,90,78,0,88,9,178,9,2592
"26145010502",3933,431,244,372,386,33,273,42,5714
"26145010600",1352,415,403,190,287,154,240,167,3208
"26145010700",4353,718,151,575,200,67,750,85,6899
"26145010800",1879,289,263,216,44,12,233,32,2968
"26145011000",594,326,2388,1898,411,29,344,87,6077
"26145011100",1322,348,395,0,8,6,56,51,2186
"26145011200",1730,125,0,7,5,1,32,0,1900
"26145011300",6260,442,7,24,172,18,203,5,7131
"26145011500",1238,431,442,283,111,396,293,264,3458
"26145011600",1545,258,1012,261,272,0,280,18,3646
"26145011701",1224,67,266,0,59,45,140,103,1904
"26145011702",1974,402,24,1,21,0,141,0,2563
"26145011800",1569,144,253,5,130,2,218,54,2375
"26145011901",1720,112,9,0,25,0,39,20,1925
"26145011902",2033,108,11,0,35,8,87,0,2282
"26145012001",3265,131,23,19,85,8,200,0,3731
"26145012002",3572,69,45,8,100,0,130,0,3924
"26145012003",4012,261,11,0,118,17,39,17,4475
"26145012100",3771,215,27,8,80,0,100,0,4201
"26145012200",1396,170,2,1,14,26,66,28,1703
"26145012300",2615,346,0,0,95,27,124,31,3238
"26145012400",1742,186,7,1,14,25,22,3,2000
"26145012500",3270,634,1,1,100,43,136,57,4242
"26145012600",3028,391,0,4,49,8,49,4,3533
"26145012700",3815,415,13,0,182,71,218,12,4726
"26145012900",4030,552,14,7,51,14,119,62,4849
"26145013000",3944,417,4,8,32,65,118,0,4588
"26145013100",5303,420,33,1,199,16,314,6,6292
"26147620000",1911,939,625,211,104,182,135,75,4182
"26147621000",2162,1052,314,23,31,99,39,70,3790
"26147622000",2365,712,119,302,242,178,135,26,4079
"26147623000",1725,709,236,103,97,64,26,6,2966
"26147624000",641,658,84,93,0,69,11,19,1575
"26147625000",696,567,2,144,10,192,14,66,1691
"26147626000",1559,509,0,47,63,24,120,22,2344
"26147627000",2241,314,81,4,97,19,44,105,2905
"26147628000",2740,460,247,0,314,40,112,85,3998
"26147629000",2118,647,0,19,122,48,123,9,3086
"26147630100",1139,105,0,20,30,27,19,36,1376
"26147630400",4809,556,76,207,80,23,237,0,5988
"26147631100",1473,58,3,0,60,0,5,0,1599
"26147631600",2093,199,0,0,31,0,65,7,2395
"26147632000",3525,284,0,16,72,63,16,5,3981
"26147633100",2459,130,0,6,149,0,96,1,2841
"26147633200",2632,82,0,0,32,20,100,0,2866
"26147634100",3053,405,49,0,127,17,29,4,3684
"26147634600",4659,715,86,0,159,0,180,0,5799
"26147635000",4997,901,105,0,62,211,150,0,6426
"26147636000",2315,1086,81,181,112,198,146,190,4309
"26147637100",3328,262,0,0,59,0,53,16,3718
"26147637200",3439,271,16,0,62,6,42,0,3836
"26147637300",2002,373,0,0,38,0,25,8,2446
"26147640100",1812,129,0,0,125,0,93,0,2159
"26147640200",2111,121,0,3,16,0,24,0,2275
"26147640600",2109,281,0,0,71,0,9,0,2470
"26147641000",3234,166,0,0,53,67,8,51,3579
"26147642000",4834,497,0,0,95,21,37,6,5490
"26147643000",3160,280,111,0,24,11,0,0,3586
"26147644000",3580,587,15,0,79,76,18,9,4364
"26147645000",2725,641,0,0,34,19,73,54,3546
"26147646000",4107,417,0,0,56,0,56,0,4636
"26147647000",2875,298,0,0,14,0,10,0,3197
"26147648000",1134,61,0,0,0,9,0,16,1220
"26147649000",3323,540,0,5,131,36,68,41,4144
"26147650100",3125,570,0,1,29,6,0,1,3732
"26147650200",1240,107,0,23,14,0,2,0,1386
"26147651100",1566,120,0,0,0,0,0,0,1686
"26147651200",2000,381,0,0,14,0,45,100,2540
"26147651600",3765,134,0,0,127,0,26,0,4052
"26147652100",2228,162,0,0,12,2,0,0,2404
"26147652600",2861,216,19,7,112,6,99,8,3328
"26147655100",3955,882,8,0,149,41,188,46,5269
"26147655600",2943,434,0,0,59,2,28,13,3479
"26147657100",1292,274,7,0,266,57,385,74,2355
"26147657200",4564,537,0,0,195,132,288,123,5839
"26147658100",2187,380,7,0,43,14,31,0,2662
"26147658500",3255,346,7,0,48,0,0,13,3669
"26147990000",0,0,0,0,0,0,0,0,0
"26149040100",3370,191,190,0,200,0,9,0,3960
"26149040200",773,524,119,140,43,32,121,125,1877
"26149040300",2046,492,104,60,179,70,38,93,3082
"26149040400",1132,359,194,213,6,103,22,75,2104
"26149040500",2179,462,45,0,216,87,241,168,3398
"26149040600",1602,540,10,63,148,106,200,152,2821
"26149040700",2354,904,0,10,94,18,647,485,4512
"26149040800",2401,704,11,2,77,45,479,243,3962
"26149040900",3445,441,180,3,122,47,73,0,4311
"26149041000",2751,496,13,9,44,4,55,1,3373
"26149041101",3320,731,67,25,87,48,163,6,4447
"26149041102",2788,142,0,0,17,3,0,3,2953
"26149041200",2661,197,67,20,123,9,47,8,3132
"26149041300",5378,995,5,8,43,55,4,59,6547
"26149041400",4070,1086,6,8,76,11,61,121,5439
"26149041500",3604,534,14,0,94,0,107,18,4371
"26149041600",2986,606,9,0,99,2,147,143,3992
"26151970100",1516,173,0,4,6,11,7,2,1719
"26151970200",2207,283,0,0,61,3,36,9,2599
"26151970300",3021,608,14,3,17,14,37,1,3715
"26151970400",3106,841,37,20,70,52,104,76,4306
"26151970500",1903,347,0,1,79,20,44,7,2401
"26151970600",1665,177,0,0,43,0,20,0,1905
"26151970700",1148,347,0,0,69,0,14,0,1578
"26151970800",5099,698,0,19,88,53,286,81,6324
"26151970900",3846,963,16,17,85,37,212,30,5206
"26151971000",3484,777,0,40,81,15,139,10,4546
"26151971100",2804,636,0,0,80,22,48,18,3608
"26151971200",4414,811,6,0,106,69,84,200,5690
"26151990000",0,0,0,0,0,0,0,0,0
"26153000100",1881,345,1,14,253,104,25,11,2634
"26153000200",1858,437,0,0,196,16,20,0,2527
"26153000300",1996,658,6,0,334,134,9,4,3141
"26153990000",0,0,0,0,0,0,0,0,0
"26155030100",5317,450,5,21,80,10,94,5,5982
"26155030200",3226,284,0,0,49,0,149,55,3763
"26155030300",3986,694,65,0,114,19,75,66,5019
"26155030400",2316,439,0,0,4,7,153,0,2919
"26155030500",2764,671,0,0,101,18,16,38,3608
"26155030600",1352,498,0,2,63,17,92,42,2066
"26155030700",2203,732,0,0,10,49,30,12,3036
"26155030800",2221,849,0,0,65,60,225,41,3461
"26155031301",3876,480,1,2,141,7,105,26,4638
"26155031302",3599,483,0,1,144,10,48,20,4305
"26155031401",5633,442,0,3,98,22,132,12,6342
"26155031402",3187,316,23,5,186,11,29,29,3786
"26155031500",4667,1007,54,26,111,39,31,0,5935
"26155031600",2825,821,10,13,0,0,30,0,3699
"26155031700",3577,462,0,32,19,7,0,62,4159
"26155031800",3203,1001,12,0,60,27,25,27,4355
"26155031900",2984,479,0,0,33,11,25,0,3532
"26157000100",3429,614,5,5,96,14,155,57,4375
"26157000200",2713,351,0,5,37,31,73,29,3239
"26157000300",2644,714,5,0,41,0,140,106,3650
"26157000400",2729,368,5,2,105,42,78,76,3405
"26157000500",4601,893,0,0,103,0,130,19,5746
"26157000600",2944,804,0,14,100,70,108,127,4167
"26157000700",2903,531,9,18,71,34,121,25,3712
"26157000800",3694,389,0,3,64,20,89,3,4262
"26157000900",3632,763,53,63,69,48,14,11,4653
"26157001000",4379,908,30,18,208,13,54,2,5612
"26157001100",2501,601,66,25,43,29,14,8,3287
"26157001200",3932,540,9,1,69,0,46,0,4597
"26157001300",4182,511,18,12,51,4,14,0,4792
"26157990000",0,0,0,0,0,0,0,0,0
"26159010100",5774,796,75,27,97,58,122,39,6988
"26159010200",3934,1160,184,43,267,343,469,821,7221
"26159010300",1457,260,56,29,41,1,19,10,1873
"26159010400",1681,463,331,233,156,0,86,0,2950
"26159010500",2651,336,124,128,178,53,221,46,3737
"26159010600",1023,428,313,412,518,169,688,298,3849
"26159010900",6431,732,103,0,116,66,230,75,7753
"26159011002",6011,622,40,48,362,16,285,43,7427
"26159011300",2825,1230,26,37,351,105,378,151,5103
"26159011400",2758,796,54,15,587,326,643,382,5561
"26159011500",2867,658,16,0,109,144,642,340,4776
"26159011600",4487,971,189,48,165,143,177,41,6221
"26159011800",4726,1501,43,0,231,342,114,221,7178
"26159011900",4311,287,45,2,180,6,166,5,5002
"26159012000",3850,1132,206,102,457,230,679,398,7054
"26159990000",0,0,0,0,0,0,0,0,0
"26161400100",434,553,42,14,210,246,10,14,1523
"26161400200",75,20,0,0,0,3,0,5,103
"26161400300",1198,2871,87,98,444,710,42,144,5594
"26161400400",2114,711,66,1,200,44,172,19,3327
"26161400500",1314,3354,170,32,346,694,64,200,6174
"26161400600",3022,594,22,44,381,128,19,30,4240
"26161400700",1525,445,189,52,157,44,49,79,2540
"26161400800",822,943,28,7,143,264,70,43,2320
"26161402100",1281,428,47,76,555,171,92,5,2655
"26161402200",541,763,25,109,345,262,81,25,2151
"26161402300",1620,51,32,0,460,93,20,6,2282
"26161402500",1104,244,18,0,787,52,17,34,2256
"26161402600",678,214,80,85,713,348,83,70,2271
"26161402700",3393,194,109,138,1375,98,211,0,5518
"26161403100",1293,7,51,0,187,31,10,0,1579
"26161403200",2451,147,311,0,253,0,32,13,3207
"26161403300",2870,313,465,2,313,66,109,29,4167
"26161403400",2465,102,249,0,319,12,240,0,3387
"26161403500",1942,257,141,54,118,26,69,0,2607
"26161403600",1684,619,319,17,1413,673,121,0,4846
"26161403800",1725,228,486,229,457,112,33,2,3272
"26161404100",2682,124,286,23,102,10,116,47,3390
"26161404200",1033,232,252,243,344,44,115,0,2263
"26161404300",2555,33,30,1,157,9,129,0,2914
"26161404400",1854,63,88,0,177,73,41,0,2296
"26161404500",2381,525,299,36,1281,226,660,9,5417
"26161404600",2607,312,407,317,425,191,91,75,4425
"26161405100",1261,249,533,52,194,19,206,105,2619
"26161405200",3934,401,256,71,510,14,24,15,5225
"26161405300",3874,106,161,14,835,83,151,0,5224
"26161405400",1714,54,42,22,144,186,155,3,2320
"26161405500",1458,172,274,20,405,110,80,0,2519
"26161405600",2095,573,919,105,821,218,259,185,5175
"26161406000",2231,182,60,17,755,55,84,5,3389
"26161407000",3930,80,125,0,804,29,120,0,5088
"26161407400",1947,312,1523,629,610,272,143,255,5691
"26161407600",1151,21,1325,0,240,0,22,0,2759
"26161410100",606,353,942,516,368,125,193,108,3211
"26161410200",1359,284,175,181,131,76,58,10,2274
"26161410300",2416,344,595,200,229,119,202,39,4144
"26161410400",2285,310,666,254,269,18,412,0,4214
"26161410500",655,253,553,367,238,205,105,237,2613
"26161410600",293,426,736,570,12,194,43,33,2307
"26161410700",628,165,288,154,92,34,1,0,1362
"26161410800",581,177,271,450,154,22,4,9,1668
"26161410900",1105,67,17,14,40,66,0,0,1309
"26161411000",1257,552,175,94,79,126,70,56,2409
"26161411100",60,28,26,16,21,19,8,0,178
"26161411200",360,333,674,476,164,178,82,9,2276
"26161411700",1619,91,335,69,119,1,146,0,2380
"26161411900",2018,385,679,533,131,172,99,34,4051
"26161412000",2274,607,500,202,207,201,35,136,4162
"26161412100",1611,454,561,530,233,67,110,129,3695
"26161412300",679,1,1396,563,154,95,23,0,2911
"26161412600",1289,332,705,154,164,66,70,51,2831
"26161412700",2663,258,778,650,217,388,104,123,5181
"26161413000",1581,180,1086,643,88,18,116,0,3712
"26161413200",2528,582,584,142,251,64,163,92,4406
"26161413401",2499,136,895,311,543,0,244,0,4628
"26161413402",3362,98,1135,69,533,0,113,21,5331
"26161413403",1243,36,479,16,14,5,0,0,1793
"26161414000",967,656,850,95,300,209,113,91,3281
"26161414200",1626,269,322,55,536,87,177,40,3112
"26161414300",1317,475,330,30,754,48,236,22,3212
"26161414500",1413,12,499,59,781,184,64,0,3012
"26161414700",920,124,71,0,411,9,34,39,1608
"26161414900",2163,12,115,0,1426,88,181,0,3985
"26161415200",1072,169,327,101,124,7,86,25,1911
"26161415400",1303,118,185,15,259,41,77,73,2071
"26161415600",1575,8,34,1,346,25,127,29,2145
"26161415800",2759,75,174,0,567,12,69,0,3656
"26161416000",1811,144,389,58,578,160,192,66,3398
"26161416200",3521,122,286,5,78,41,180,0,4233
"26161420000",2824,176,157,21,156,121,57,13,3525
"26161420200",2663,265,186,3,187,0,7,0,3311
"26161421100",3406,130,0,0,100,145,163,0,3944
"26161421900",11,0,0,0,0,3,0,0,14
"26161422200",6748,118,52,0,324,8,253,0,7503
"26161422900",18,40,0,43,0,4,0,9,114
"26161423400",6007,283,49,0,214,0,180,4,6737
"26161423600",2041,52,0,0,175,0,61,0,2329
"26161425000",3784,75,82,0,283,8,28,42,4302
"26161426000",3256,167,11,0,260,17,92,10,3813
"26161431000",4038,356,10,15,66,119,67,1,4672
"26161432000",4527,315,14,27,90,6,80,41,5100
"26161444000",5628,291,2,0,12,0,69,2,6004
"26161445000",2195,92,0,14,179,0,77,0,2557
"26161446200",1898,15,0,1,73,0,8,0,1995
"26161446400",2361,408,0,0,102,0,67,0,2938
"26161447000",2595,178,11,1,48,1,15,0,2849
"26161448000",3175,138,35,0,205,0,180,0,3733
"26161453000",4467,57,78,0,502,14,79,30,5227
"26161454000",4516,174,0,0,199,11,197,59,5156
"26161455000",2984,358,231,103,758,19,201,0,4654
"26161456000",3920,168,116,509,631,335,190,190,6059
"26161461000",6219,199,0,0,433,0,77,0,6928
"26161464000",5048,353,78,0,221,0,98,40,5838
"26161465000",4671,464,0,1,399,148,165,43,5891
"26161466000",2414,21,3,0,115,0,48,0,2601
"26161984000",54,4,0,0,0,0,0,0,58
"26163500100",277,11,1794,1152,13,0,0,0,3247
"26163500200",107,0,1585,845,142,49,0,0,2728
"26163500300",166,110,1134,1004,9,56,0,4,2483
"26163500400",35,52,348,544,31,3,0,19,1032
"26163500500",12,0,1223,448,0,0,0,6,1689
"26163500600",201,12,884,2048,16,200,0,0,3361
"26163500700",247,70,2571,1519,46,0,71,0,4524
"26163500800",183,12,1223,1053,68,20,0,0,2559
"26163500900",54,0,2658,1345,0,0,8,0,4065
"26163501000",56,51,1436,1616,232,165,12,114,3682
"26163501100",71,4,1397,1757,54,0,8,0,3291
"26163501200",64,11,1228,504,7,0,0,0,1814
"26163501300",63,3,2160,1895,0,0,6,0,4127
"26163501400",284,24,2719,639,27,0,17,0,3710
"26163501500",534,71,2185,1223,203,67,52,0,4335
"26163501600",363,50,928,321,105,58,0,49,1874
"26163501700",180,166,636,1142,135,30,0,17,2306
"26163501800",868,52,3061,793,166,81,52,0,5073
"26163501900",210,1,1405,1244,22,31,0,0,2913
"26163502000",38,51,1317,991,0,0,0,0,2397
"26163503100",197,134,1922,700,27,80,0,0,3060
"26163503200",74,74,1542,1638,9,119,9,0,3465
"26163503300",129,32,2508,1506,152,30,79,0,4436
"26163503400",0,14,824,302,87,5,0,0,1232
"26163503500",73,0,1398,1725,174,26,174,0,3570
"26163503600",34,45,783,364,68,41,0,1,1336
"26163503900",1,12,1834,736,36,33,0,43,2695
"26163504000",7,3,999,540,0,0,0,0,1549
"26163504100",0,0,580,1084,5,0,0,0,1669
"26163504200",0,2,1275,866,0,42,0,0,2185
"26163504300",53,33,1538,760,21,0,0,3,2408
"26163504400",6,0,1078,613,0,0,0,0,1697
"26163504700",48,5,917,1362,12,0,0,0,2344
"26163504800",33,5,567,594,15,27,0,0,1241
"26163504900",95,18,1996,1180,18,2,0,0,3309
"26163505000",13,0,711,429,13,5,0,0,1171
"26163505100",140,8,1482,966,36,20,13,12,2677
"26163505200",208,89,1910,1351,142,0,10,29,3739
"26163505400",33,20,1134,1501,22,2,0,0,2712
"26163505500",22,164,814,572,0,7,0,3,1582
"26163506100",51,67,864,697,66,0,0,34,1779
"26163506200",36,46,930,1218,0,18,15,10,2273
"26163506300",5,16,1514,806,9,59,63,0,2472
"26163506400",40,89,756,386,0,38,0,0,1309
"26163506500",0,21,1195,1259,0,17,0,0,2492
"26163506600",26,117,1551,1136,6,27,0,26,2889
"26163506700",61,11,787,737,0,21,0,0,1617
"26163506800",56,49,2835,1196,50,26,54,21,4287
"26163506900",98,39,2528,1419,49,1,37,24,4195
"26163507000",10,0,1602,1096,22,0,0,0,2730
"26163507100",1,0,1288,1011,6,27,0,0,2333
"26163507200",33,5,605,576,21,34,33,20,1327
"26163507300",7,2,1708,613,36,0,0,0,2366
"26163507400",14,14,1917,598,17,12,18,7,2597
"26163507500",86,32,1230,1118,0,15,0,10,2491
"26163507800",64,1,472,395,16,0,0,0,948
"26163507900",99,116,927,834,31,0,17,37,2061
"26163508000",38,271,542,432,0,32,0,0,1315
"26163508100",60,99,720,1018,54,22,0,0,1973
"26163510400",4,10,566,324,0,47,0,0,951
"26163510500",294,110,319,920,1112,2511,0,0,5266
"26163510600",836,547,404,261,177,2046,0,0,4271
"26163510700",180,772,167,176,319,166,0,0,1780
"26163511000",32,12,1155,780,24,35,0,6,2044
"26163511200",0,0,774,451,7,19,0,0,1251
"26163511300",242,219,757,567,92,84,0,0,1961
"26163511400",24,15,1733,736,11,49,0,0,2568
"26163511900",27,27,633,1012,18,4,0,0,1721
"26163512100",21,18,1774,1291,0,0,0,0,3104
"26163512200",22,43,181,927,0,0,0,37,1210
"26163512300",47,144,439,843,12,43,0,91,1619
"26163512400",32,6,690,779,26,0,0,0,1533
"26163512600",6,9,843,778,14,16,0,0,1666
"26163512900",61,12,386,945,25,81,0,0,1510
"26163513200",215,20,1003,382,66,55,0,44,1785
"26163513300",217,86,1217,833,35,40,0,24,2452
"26163513600",30,25,700,719,112,11,85,43,1725
"26163513700",121,2,2057,1200,23,0,30,0,3433
"26163513900",1,10,1208,902,21,0,38,0,2180
"26163514100",29,22,1163,1805,0,67,7,49,3142
"26163514200",0,6,1675,1202,0,44,0,0,2927
"26163514300",0,7,1722,1713,0,6,0,0,3448
"26163514500",0,0,679,844,0,0,0,0,1523
"26163515200",24,42,893,491,1,21,11,0,1483
"26163515300",149,76,1127,1236,97,10,31,12,2738
"26163515400",549,24,574,474,40,0,51,0,1712
"26163515600",4,13,836,640,0,4,0,0,1497
"26163515700",250,62,2620,633,139,0,41,0,3745
"26163515900",23,1,521,623,0,0,0,0,1168
"26163516000",9,43,1574,765,12,11,0,11,2425
"26163516100",0,2,218,306,28,0,0,0,554
"26163516200",4,14,373,289,2,0,0,0,682
"26163516300",5,0,339,369,0,6,0,0,719
"26163516400",95,45,664,271,14,13,0,1,1103
"26163516500",237,86,622,254,39,47,19,0,1304
"26163516600",1,18,990,1076,0,0,0,0,2085
"26163516700",27,4,1512,1285,129,29,0,0,2986
"26163516800",5,16,366,596,0,27,0,0,1010
"26163516900",33,0,1719,645,10,9,0,0,2416
"26163517000",497,157,1168,553,83,20,9,9,2496
"26163517100",82,50,718,361,3,0,13,0,1227
"26163517200",319,76,385,99,74,4,56,0,1013
"26163517300",246,83,784,642,58,30,18,0,1861
"26163517500",184,66,890,908,82,10,12,0,2152
"26163518000",184,101,904,362,132,8,20,0,1711
"26163518400",45,38,256,145,0,4,0,0,488
"26163518500",80,63,546,375,0,84,0,0,1148
"26163518600",8,1,163,321,0,0,0,0,493
"26163518800",74,2,350,314,10,9,0,0,759
"26163518900",89,5,534,1033,4,72,0,0,1737
"26163520200",363,257,71,132,453,257,0,5,1538
"26163520300",330,274,218,278,232,223,65,17,1637
"26163520400",259,284,596,588,49,25,4,5,1810
"26163520700",645,285,841,582,20,69,60,8,2510
"26163520800",271,54,603,126,104,39,92,0,1289
"26163521100",878,553,54,225,238,76,928,317,3269
"26163521300",60,10,395,372,116,52,69,40,1114
"26163521400",456,327,407,92,55,32,99,300,1768
"26163521500",109,118,880,539,18,29,62,19,1774
"26163521800",7,0,647,497,8,0,8,0,1167
"26163521900",780,264,564,1231,127,33,91,4,3094
"26163522000",21,114,830,1054,0,5,31,16,2071
"26163522100",0,97,335,249,0,0,0,0,681
"26163522200",132,25,231,207,0,0,71,0,666
"26163522300",44,12,491,775,19,11,0,3,1355
"26163522400",70,2,404,559,0,25,0,0,1060
"26163522500",147,199,360,651,3,36,7,25,1428
"26163523100",533,304,111,177,274,209,538,327,2473
"26163523200",1320,529,204,35,964,887,1963,1192,7094
"26163523300",1750,1080,42,86,350,380,1919,1136,6743
"26163523400",900,383,306,445,665,100,1312,248,4359
"26163523800",1641,1310,258,5,869,698,2092,1483,8356
"26163524000",1456,1008,77,66,448,405,1404,1072,5936
"26163524100",1465,526,155,134,979,647,1947,895,6748
"26163524200",2276,859,31,256,1166,309,2559,631,8087
"26163524300",1036,696,197,16,485,363,1140,796,4729
"26163524500",263,375,121,24,214,26,287,328,1638
"26163524700",0,74,2806,1059,0,62,0,75,4076
"26163524800",10,99,1307,1229,20,11,10,68,2754
"26163524900",519,341,180,49,159,298,423,356,2325
"26163525000",373,228,119,134,40,133,175,157,1359
"26163525400",378,329,604,504,531,188,824,497,3855
"26163525500",128,45,694,239,70,263,164,157,1760
"26163525600",443,720,57,27,322,383,604,1058,3614
"26163525700",2233,1038,30,71,1256,725,2721,1231,9305
"26163525800",403,420,94,121,203,520,456,827,3044
"26163526000",1110,1010,29,200,358,529,532,744,4512
"26163526100",790,724,323,81,227,492,330,349,3316
"26163526200",827,618,264,319,496,519,771,689,4503
"26163526300",780,648,181,268,990,790,1501,1139,6297
"26163526400",247,386,195,485,412,68,688,459,2940
"26163526500",207,31,978,730,124,118,231,146,2565
"26163527200",0,53,480,304,0,1,0,51,889
"26163527300",0,2,568,816,3,70,0,0,1459
"26163530100",57,0,1657,758,16,50,0,0,2538
"26163530200",117,185,1934,1238,73,51,34,1,3633
"26163530300",0,16,1209,1220,19,0,0,15,2479
"26163530400",28,0,976,528,5,0,0,0,1537
"26163530500",12,26,1578,1057,24,71,0,0,2768
"26163530800",27,4,1195,999,12,10,0,9,2256
"26163530900",10,3,1175,1341,31,12,0,0,2572
"26163531100",0,17,424,578,0,52,0,17,1088
"26163531200",67,24,2591,618,75,0,0,0,3375
"26163531300",2,13,813,385,0,4,0,0,1217
"26163531400",18,6,1196,443,0,8,17,8,1696
"26163531500",0,16,1308,993,0,117,0,14,2448
"26163531600",0,26,867,502,29,32,0,0,1456
"26163531700",0,28,652,1035,1,0,0,0,1716
"26163531800",38,19,1184,954,13,0,0,0,2208
"26163531900",0,114,442,372,29,0,11,0,968
"26163532200",27,29,908,387,0,12,0,0,1363
"26163532300",98,37,602,50,70,0,0,0,857
"26163532400",11,86,1068,478,0,27,0,24,1694
"26163532600",46,40,737,1088,98,87,47,24,2167
"26163532700",0,13,587,211,0,52,0,0,863
"26163533000",14,41,678,665,4,139,0,16,1557
"26163533100",0,8,729,1579,0,0,0,0,2316
"26163533200",0,10,1140,624,0,0,0,0,1774
"26163533300",0,14,973,678,0,0,0,0,1665
"26163533400",0,53,1294,1504,30,21,0,0,2902
"26163533500",0,0,443,586,28,0,0,0,1057
"26163533600",24,0,1416,629,0,0,83,0,2152
"26163533700",0,30,391,597,0,0,0,0,1018
"26163533900",128,119,1313,1069,27,0,0,0,2656
"26163534100",2,1,1037,914,0,47,0,0,2001
"26163534200",8,18,2288,1564,26,86,0,0,3990
"26163534300",0,0,751,526,0,9,0,0,1286
"26163534400",6,9,943,955,10,14,0,0,1937
"26163534500",10,0,229,658,33,0,0,0,930
"26163534600",35,13,917,685,38,8,55,0,1751
"26163534700",14,0,1833,1340,20,0,1,0,3208
"26163535000",124,24,1656,1174,66,128,0,0,3172
"26163535100",51,9,1479,407,21,0,0,0,1967
"26163535200",8,13,884,1623,0,50,49,0,2627
"26163535300",38,2,2434,1400,42,12,29,26,3983
"26163535400",19,0,608,928,0,0,0,0,1555
"26163535500",120,135,1493,1000,0,0,33,0,2781
"26163535600",64,0,3016,508,17,23,0,0,3628
"26163535700",0,0,1041,604,70,0,29,41,1785
"26163536100",2,7,1985,1044,43,97,17,63,3258
"26163536200",0,0,1238,667,22,5,0,0,1932
"26163536300",18,35,1812,1409,0,0,0,0,3274
"26163536400",33,0,1388,1112,89,0,0,0,2622
"26163536500",40,21,1201,642,53,48,0,21,2026
"26163536600",1,0,1698,838,51,0,12,0,2600
"26163536700",1,0,620,750,0,40,0,0,1411
"26163536800",0,3,1134,332,54,1,0,0,1524
"26163536900",62,20,1921,903,0,26,105,0,3037
"26163537000",59,11,2114,1124,46,0,0,0,3354
"26163537100",4,0,1516,497,21,0,0,0,2038
"26163537200",14,7,413,485,63,9,8,0,999
"26163537300",0,1,1335,1184,40,0,0,26,2586
"26163537500",42,0,1554,1114,0,0,0,0,2710
"26163537600",131,0,2109,1016,33,65,12,65,3431
"26163537700",14,0,2412,1123,0,2,14,0,3565
"26163537800",30,19,1044,803,25,0,0,0,1921
"26163538100",260,52,1589,344,268,0,5,0,2518
"26163538200",210,0,1513,181,45,0,9,0,1958
"26163538300",13,2,1198,423,0,13,0,13,1662
"26163538400",327,1,2693,221,118,16,0,0,3376
"26163538500",0,11,3833,845,139,46,0,0,4874
"26163538600",38,2,4244,820,163,8,44,0,5319
"26163538700",33,18,2210,1460,0,21,6,0,3748
"26163538800",12,0,1105,474,23,16,4,0,1634
"26163538900",48,0,3068,401,37,0,7,0,3561
"26163539000",16,5,2128,1189,51,19,0,34,3442
"26163539100",0,125,1263,556,6,43,0,0,1993
"26163539200",12,7,3267,1372,122,0,0,4,4784
"26163539300",30,10,3162,1223,74,0,27,0,4526
"26163539400",21,17,2177,1064,88,20,0,4,3391
"26163539500",30,0,2265,539,107,0,0,0,2941
"26163539600",53,67,2051,1270,18,10,9,10,3488
"26163539700",21,1,1265,741,8,15,0,0,2051
"26163540100",48,0,2150,1234,48,32,8,0,3520
"26163540200",24,2,1804,1733,23,0,0,0,3586
"26163540300",12,0,2814,1541,36,0,36,0,4439
"26163540400",1,1,1574,981,10,0,8,0,2575
"26163540500",61,1,2059,907,0,0,0,0,3028
"26163540600",48,17,2408,753,20,0,7,0,3253
"26163540700",55,10,2598,996,17,23,8,35,3742
"26163540800",14,21,1690,482,26,2,12,0,2247
"26163540900",92,11,2658,813,35,0,0,0,3609
"26163541000",42,39,2042,1579,32,61,5,0,3800
"26163541100",64,405,1540,1133,123,0,12,0,3277
"26163541200",81,119,910,793,13,42,1,51,2010
"26163541300",448,169,1150,600,92,13,11,66,2549
"26163541400",285,145,1329,425,19,0,0,0,2203
"26163541500",67,16,2547,1065,91,34,11,9,3840
"26163541700",49,38,1200,597,7,0,0,0,1891
"26163541800",244,55,1368,446,52,0,0,0,2165
"26163542100",47,15,2450,1286,65,37,46,0,3946
"26163542200",11,1,2422,1023,114,171,46,171,3959
"26163542300",30,0,1184,879,7,11,0,0,2111
"26163542400",0,1,1913,627,9,0,0,0,2550
"26163542500",65,0,2448,463,37,0,0,0,3013
"26163542600",0,0,2160,918,29,38,0,14,3159
"26163542700",8,29,533,460,5,4,4,0,1043
"26163542800",169,7,1999,392,71,13,0,0,2651
"26163542900",185,17,2710,223,180,0,0,0,3315
"26163543000",143,52,1966,382,99,0,16,39,2697
"26163543100",292,27,1952,231,49,0,0,0,2551
"26163543200",64,40,1963,737,174,55,26,81,3140
"26163543400",14,4,1992,1060,30,0,0,80,3180
"26163543500",46,11,502,900,18,23,6,9,1515
"26163543600",158,45,351,777,15,97,5,86,1534
"26163543700",179,36,1047,890,104,58,0,58,2372
"26163543800",63,362,155,360,19,100,12,63,1134
"26163543900",98,75,302,161,7,15,0,0,658
"26163544000",143,14,1667,640,0,1,0,0,2465
"26163544100",155,7,966,253,14,0,0,0,1395
"26163544200",280,251,686,1101,78,2,2,98,2498
"26163544300",410,213,1125,1203,47,26,34,10,3068
"26163545100",15,8,894,466,0,0,32,0,1415
"26163545200",53,14,1612,1647,9,0,12,0,3347
"26163545300",29,0,981,797,0,0,22,0,1829
"26163545400",37,9,235,403,0,0,0,28,712
"26163545500",524,700,1213,1603,248,90,152,88,4618
"26163545600",643,1842,1090,591,120,112,320,181,4899
"26163545700",706,488,396,220,245,113,334,205,2707
"26163545800",985,454,1213,1365,225,433,160,394,5229
"26163545900",250,331,1605,1177,53,65,75,50,3606
"26163546000",144,19,1838,1405,55,1,0,31,3493
"26163546100",255,315,2105,1995,18,70,10,23,4791
"26163546200",701,92,1872,268,65,41,71,41,3151
"26163546300",198,113,1327,218,36,0,0,0,1892
"26163546400",40,15,739,341,0,0,0,0,1135
"26163546500",35,0,1098,815,78,4,4,10,2044
"26163546600",108,17,1351,717,45,0,26,0,2264
"26163546700",90,41,1761,621,0,70,0,1,2584
"26163546800",142,59,1444,1748,10,55,0,46,3504
"26163546900",29,15,987,101,0,14,0,0,1146
"26163550100",3505,86,473,64,22,0,57,10,4217
"26163550200",2946,408,379,106,204,0,192,15,4250
"26163550300",3122,45,40,0,75,0,46,0,3328
"26163550400",1213,82,31,0,216,6,71,0,1619
"26163550500",3562,83,8,0,184,0,85,0,3922
"26163550600",2376,47,0,0,54,8,76,0,2561
"26163550700",5120,308,84,0,80,0,103,0,5695
"26163550800",1171,38,0,0,76,0,32,0,1317
"26163550900",2584,69,36,0,204,14,23,0,2930
"26163551100",4300,131,94,24,68,1,52,18,4688
"26163551200",3383,115,385,0,138,6,54,0,4081
"26163551300",2117,153,1043,223,54,10,16,10,3626
"26163551400",1773,191,1559,303,145,73,133,0,4177
"26163551500",1129,138,1218,49,22,37,125,0,2718
"26163551600",1434,128,983,998,162,0,44,0,3749
"26163551700",3283,69,41,0,86,4,26,0,3509
"26163551800",3048,352,323,29,92,9,40,0,3893
"26163552000",813,658,54,54,999,211,22,36,2847
"26163552100",1620,820,438,517,831,408,6,0,4640
"26163552200",1825,621,181,84,592,434,71,0,3808
"26163552300",1224,1203,62,170,713,459,41,27,3899
"26163552400",412,664,282,77,423,458,3,4,2323
"26163552800",1291,1673,85,437,305,364,0,9,4164
"26163553000",4,9,628,454,6,0,0,0,1101
"26163553100",153,22,755,538,30,50,0,0,1548
"26163553200",0,77,298,504,0,0,0,0,879
"26163553300",1,1,336,434,95,7,32,0,906
"26163553400",0,1,674,1833,0,0,0,0,2508
"26163553600",148,75,1497,866,29,0,0,5,2620
"26163553800",20,27,722,726,5,10,8,0,1518
"26163554100",2293,478,905,302,94,0,81,33,4186
"26163554200",1892,260,465,125,100,0,59,23,2924
"26163554300",3956,92,595,141,261,57,105,9,5216
"26163554400",1691,246,922,238,0,21,7,21,3146
"26163554500",2064,200,361,94,234,0,141,9,3103
"26163554600",2912,208,99,122,144,18,185,17,3705
"26163554700",1775,216,196,56,53,125,151,123,2695
"26163554800",1319,446,1599,263,95,0,92,0,3814
"26163554900",1611,207,1115,39,115,8,37,0,3132
"26163555100",3033,288,659,236,92,237,74,126,4745
"26163555300",1666,208,1461,255,137,1,87,0,3815
"26163555400",427,181,1674,343,11,1,85,16,2738
"26163555500",1494,242,877,267,46,109,24,0,3059
"26163555600",1714,44,808,2,116,0,16,0,2700
"26163556100",2614,275,28,95,226,108,84,0,3430
"26163556200",1900,339,204,73,182,23,44,0,2765
"26163556300",2468,217,107,10,315,27,64,0,3208
"26163556400",3796,127,49,0,343,17,169,0,4501
"26163556500",1759,98,63,56,180,0,0,0,2156
"26163556600",2968,198,32,1,162,0,19,0,3380
"26163556700",2139,149,79,0,124,0,72,26,2589
"26163556800",1766,64,0,18,24,11,85,0,1968
"26163556900",3376,24,20,1,403,0,175,0,3999
"26163557000",1983,570,265,33,43,0,162,0,3056
"26163557100",1921,120,153,9,162,33,62,0,2460
"26163557200",1593,76,0,26,108,0,69,4,1876
"26163557300",2097,42,20,11,33,6,37,0,2246
"26163557400",3228,180,0,0,85,0,78,0,3571
"26163557500",3570,128,1,4,62,12,83,12,3872
"26163557600",2979,73,20,3,98,0,18,0,3191
"26163557700",4291,74,25,7,129,0,28,0,4554
"26163557900",4209,170,126,13,164,13,53,16,4764
"26163558000",3653,145,90,3,225,1,133,0,4250
"26163558100",3276,151,0,13,49,78,7,0,3574
"26163558200",3463,370,186,46,101,103,82,1,4352
"26163558300",1361,95,70,15,98,0,66,0,1705
"26163558400",3458,181,320,48,184,0,92,0,4283
"26163558500",3839,170,1,3,132,54,50,38,4287
"26163558600",1926,94,20,24,49,0,80,0,2193
"26163558700",2647,81,17,19,35,0,62,0,2861
"26163558800",2435,138,5,0,219,0,114,51,2962
"26163558900",1671,54,4,2,133,18,50,10,1942
"26163559000",2148,46,179,0,136,0,33,0,2542
"26163559100",2200,34,63,2,301,0,265,13,2878
"26163559200",1817,252,26,3,59,3,66,0,2226
"26163560100",2367,112,33,1,116,61,15,0,2705
"26163560200",3627,248,207,24,817,0,127,15,5065
"26163560300",2520,110,213,0,464,0,61,0,3368
"26163560400",5407,183,96,0,156,0,161,0,6003
"26163561200",3760,116,281,0,1931,0,88,18,6194
"26163561300",6471,205,196,7,1075,0,370,56,8380
"26163561600",3437,201,78,1,80,14,26,59,3896
"26163561700",1661,173,102,2,103,29,105,29,2204
"26163561900",6332,142,59,0,720,0,74,0,7327
"26163562300",1616,62,48,0,176,25,24,0,1951
"26163562400",4964,119,100,19,339,1,74,0,5616
"26163562500",1534,152,62,56,129,0,52,46,2031
"26163562600",3372,130,0,41,61,13,17,0,3634
"26163562700",3116,109,9,4,87,8,102,14,3449
"26163562800",2850,39,109,2,165,0,28,0,3193
"26163562900",2996,263,77,18,155,11,45,0,3565
"26163563200",1582,199,698,37,348,63,16,157,3100
"26163563300",2215,39,454,127,304,37,67,7,3250
"26163563400",4377,136,115,63,281,28,98,0,5098
"26163563500",5037,128,249,2,762,42,150,0,6370
"26163563600",1710,27,61,0,319,9,46,9,2181
"26163563700",1321,19,129,0,123,0,24,0,1616
"26163563800",2414,133,131,21,316,0,48,0,3063
"26163563900",1653,83,216,7,453,0,26,0,2438
"26163564000",990,61,120,35,243,19,94,0,1562
"26163564100",2545,191,294,72,828,32,168,0,4130
"26163564200",2611,280,340,168,360,75,83,0,3917
"26163564300",1949,21,159,9,382,40,60,0,2620
"26163564401",4044,160,0,0,873,78,165,0,5320
"26163564402",2495,6,335,0,1535,28,56,0,4455
"26163564501",3446,283,554,0,638,0,103,0,5024
"26163564502",2164,91,285,0,1037,0,13,0,3590
"26163564503",1974,23,735,7,634,0,137,0,3510
"26163564504",3850,426,683,54,1027,59,53,151,6303
"26163564600",5003,78,323,1,1509,0,155,0,7069
"26163564700",2731,168,466,244,1105,140,82,0,4936
"26163564800",3414,103,455,26,681,52,25,9,4765
"26163564900",1288,521,181,105,122,77,177,5,2476
"26163565000",2880,155,143,19,1261,234,70,0,4762
"26163565100",1742,142,623,389,378,10,89,10,3383
"26163565200",2824,210,796,173,901,0,53,0,4957
"26163565300",2013,284,2008,443,497,107,0,113,5465
"26163565600",1869,103,293,38,36,0,6,15,2360
"26163565700",2429,321,509,6,215,96,20,0,3596
"26163565800",3056,322,122,111,150,0,39,0,3800
"26163565900",1805,602,176,67,90,18,71,8,2837
"26163566400",610,102,211,134,4,0,34,0,1095
"26163566500",1582,493,104,73,13,177,11,10,2463
"26163566600",1428,52,342,98,166,9,21,0,2116
"26163566700",2877,678,11,33,178,20,191,53,4041
"26163566800",2371,188,133,5,144,57,38,20,2956
"26163566900",3246,417,573,439,195,26,30,13,4939
"26163567000",1259,348,1297,206,276,0,42,40,3468
"26163567100",2747,590,248,138,56,0,88,62,3929
"26163567201",2602,285,58,2,423,28,181,28,3607
"26163567202",1994,86,286,460,16,133,42,31,3048
"26163567300",3396,763,312,91,133,84,146,0,4925
"26163567400",2600,147,38,15,139,0,23,0,2962
"26163567800",3552,343,590,94,216,0,108,12,4915
"26163567900",2321,85,255,15,125,8,65,0,2874
"26163568000",1807,177,57,29,132,10,71,0,2283
"26163568200",3158,161,323,7,226,112,46,0,4033
"26163568300",2794,461,265,213,154,18,65,67,4037
"26163568400",2644,314,337,106,174,28,154,0,3757
"26163568500",1744,1655,371,292,257,148,117,31,4615
"26163568700",2800,136,437,251,62,0,58,0,3744
"26163568800",1289,327,590,634,245,49,139,10,3283
"26163568900",2027,301,91,15,187,15,13,13,2662
"26163569100",2369,121,0,0,13,0,125,0,2628
"26163569200",2343,243,118,3,66,26,22,8,2829
"26163569300",3075,274,17,0,200,11,90,18,3685
"26163569400",2392,255,117,20,130,1,119,23,3057
"26163569500",2541,188,13,2,13,0,103,0,2860
"26163569600",3135,290,15,1,95,0,100,0,3636
"26163569700",3457,434,112,19,78,17,143,63,4323
"26163569800",1974,235,40,2,154,7,0,18,2430
"26163569900",2160,408,117,20,71,0,43,0,2819
"26163570100",1230,193,1637,365,196,0,159,0,3780
"26163570200",785,175,925,412,153,8,63,8,2529
"26163570400",465,274,1905,2077,25,69,0,87,4902
"26163570500",229,380,1944,1120,58,0,62,12,3805
"26163570600",38,38,1000,822,17,56,17,14,2002
"26163570800",28,11,1633,906,298,132,199,0,3207
"26163570900",79,18,1503,1182,58,14,0,0,2854
"26163571000",155,87,1070,1138,33,70,30,7,2590
"26163571500",2843,998,526,54,220,49,106,49,4845
"26163571600",1022,249,54,56,110,76,39,0,1606
"26163571700",916,672,323,304,83,90,15,38,2441
"26163571800",2439,410,228,39,145,0,127,33,3421
"26163571900",2005,228,327,59,206,0,43,10,2878
"26163572000",1480,173,70,0,167,0,6,0,1896
"26163572100",5014,1131,0,42,416,120,261,0,6984
"26163572200",3938,1050,374,42,298,88,175,0,5965
"26163572400",709,328,60,83,127,76,83,16,1482
"26163572500",1096,302,43,140,56,0,128,55,1820
"26163572600",3052,580,231,370,622,0,130,31,5016
"26163572700",3620,215,65,8,309,0,367,7,4591
"26163572800",4120,828,124,17,287,41,208,167,5792
"26163572900",1656,483,248,22,101,0,163,0,2673
"26163573000",2478,511,17,9,60,11,85,0,3171
"26163573100",2854,603,396,182,386,5,49,0,4475
"26163573300",2686,2110,20,0,60,74,32,0,4982
"26163573400",2197,1494,122,86,32,64,33,6,4034
"26163573500",2258,1899,20,18,341,99,7,16,4658
"26163573600",2362,3603,31,205,232,176,78,26,6713
"26163573701",1348,657,0,1,0,0,116,0,2122
"26163573702",2652,3028,60,0,187,32,82,0,6041
"26163573800",2578,2039,85,55,197,209,82,0,5245
"26163573900",2805,1947,17,69,264,237,0,0,5339
"26163574000",2876,1816,11,3,212,131,187,0,5236
"26163574100",2084,1775,85,16,249,46,36,202,4493
"26163574202",1830,142,515,9,325,0,107,9,2937
"26163574300",1670,884,288,110,329,103,251,17,3652
"26163574600",4555,225,119,9,132,8,231,8,5287
"26163574700",3839,336,10,26,255,0,225,31,4722
"26163574800",3803,36,0,0,235,14,90,0,4178
"26163574900",1337,105,108,28,24,0,40,0,1642
"26163575000",3584,372,22,0,109,20,195,23,4325
"26163575100",1863,361,75,0,333,17,322,17,2988
"26163575200",3220,144,322,32,166,0,259,27,4170
"26163575300",2999,424,0,0,141,0,262,37,3863
"26163575400",2911,189,42,1,169,0,164,0,3476
"26163575500",3458,300,56,19,116,8,309,0,4266
"26163575600",1187,73,32,0,106,0,86,0,1484
"26163576000",1582,98,123,8,41,75,153,104,2184
"26163576100",5084,496,98,50,168,82,734,85,6797
"26163576200",2198,225,0,0,19,0,186,0,2628
"26163576300",2087,192,17,2,47,9,134,19,2507
"26163576400",3229,189,39,0,22,0,197,0,3676
"26163576500",3293,213,29,2,53,0,224,73,3887
"26163576600",3911,221,45,68,199,14,281,68,4807
"26163576700",2963,232,173,0,159,0,108,0,3635
"26163577000",2344,646,439,365,853,36,1104,114,5901
"26163577100",1703,393,88,42,91,267,122,357,3063
"26163577200",2400,620,129,28,232,103,369,149,4030
"26163577300",2436,319,50,0,176,73,289,43,3386
"26163577400",2434,463,0,16,339,48,496,94,3890
"26163577500",2213,451,175,17,252,0,277,132,3517
"26163577600",2971,584,62,0,114,40,411,12,4194
"26163577700",2095,204,9,7,43,0,153,6,2517
"26163577800",3824,1005,27,103,134,45,626,130,5894
"26163577900",2794,287,180,23,87,189,153,170,3883
"26163578000",1828,398,75,121,162,0,472,0,3056
"26163578500",3025,543,591,40,692,236,956,197,6280
"26163578600",3156,1154,410,185,312,263,544,177,6201
"26163579100",758,265,549,234,52,12,175,79,2124
"26163579200",1480,478,345,567,196,131,470,65,3732
"26163579300",1,1,1436,1322,12,11,12,32,2827
"26163579500",583,512,208,174,129,187,167,119,2079
"26163579600",86,0,2113,984,50,24,8,0,3265
"26163579700",1431,473,324,151,547,115,707,189,3937
"26163579800",610,312,174,40,57,63,20,100,1376
"26163579900",3206,645,247,33,291,49,133,0,4604
"26163580100",1675,107,48,28,15,32,210,0,2115
"26163580200",2224,270,20,7,132,0,132,0,2785
"26163580300",2740,155,0,18,16,57,182,6,3174
"26163580400",2245,115,0,0,158,0,192,0,2710
"26163580500",2945,199,1,2,69,29,50,31,3326
"26163580600",2491,484,0,69,48,144,178,160,3574
"26163580700",2953,786,14,8,69,1,282,0,4113
"26163580800",1375,167,61,22,43,0,23,0,1691
"26163580900",3125,292,11,0,97,0,90,0,3615
"26163581100",2847,267,396,145,152,25,262,38,4132
"26163581200",2944,234,164,36,200,0,173,16,3767
"26163581500",1860,199,14,11,46,27,96,0,2253
"26163581600",4366,452,214,107,594,207,246,43,6229
"26163581800",2241,290,0,0,93,0,165,7,2796
"26163581900",4389,250,36,2,36,68,284,68,5133
"26163582000",1877,301,351,174,57,4,86,33,2883
"26163582100",3453,311,15,1,124,0,172,0,4076
"26163583000",1716,452,253,109,95,97,88,0,2810
"26163583100",2655,804,197,170,178,30,204,17,4255
"26163583200",1847,591,0,2,65,0,220,0,2725
"26163583300",1985,333,17,234,154,11,69,30,2833
"26163583400",3925,351,59,122,272,71,332,23,5155
"26163583500",2233,222,120,0,115,0,95,0,2785
"26163583600",2087,296,73,1,52,0,0,0,2509
"26163583700",3394,428,189,75,52,17,316,37,4508
"26163583800",3616,357,327,15,188,2,237,0,4742
"26163583900",2328,504,614,314,98,116,138,46,4158
"26163584000",2611,216,696,648,59,9,131,48,4418
"26163584100",1397,155,39,5,38,20,67,0,1721
"26163584200",1805,143,451,526,35,153,7,0,3120
"26163584300",1245,200,347,73,21,41,75,0,2002
"26163584400",1880,144,460,233,176,0,209,0,3102
"26163584500",1842,313,306,40,293,6,246,45,3091
"26163584600",1094,211,286,130,84,195,42,0,2042
"26163584700",2294,154,17,6,260,18,218,51,3018
"26163584800",1071,663,829,2731,190,314,119,239,6156
"26163585500",804,400,180,153,166,7,151,3,1864
"26163585600",293,260,1932,588,218,102,80,0,3473
"26163585700",649,155,1011,146,134,43,168,0,2306
"26163585800",1511,516,1997,457,211,50,115,0,4857
"26163585900",1285,395,506,200,199,35,68,0,2688
"26163586200",2723,330,2307,526,788,333,42,0,7049
"26163586300",1533,318,19,46,68,0,12,7,2003
"26163587000",2860,526,291,37,118,0,191,26,4049
"26163587900",3088,668,2088,204,643,82,86,35,6894
"26163588000",3320,531,1558,223,123,117,61,0,5933
"26163588100",1509,621,160,0,152,7,67,0,2516
"26163588200",1268,281,1051,322,129,20,19,87,3177
"26163588300",3903,287,804,19,230,0,49,15,5307
"26163588400",3215,39,1315,99,268,0,113,0,5049
"26163589300",2787,617,334,5,103,14,169,80,4109
"26163589400",4158,826,382,95,0,84,108,210,5863
"26163590400",5623,586,216,28,101,90,238,34,6916
"26163590500",5009,748,70,162,368,70,96,17,6540
"26163590600",2340,136,18,11,42,20,21,20,2608
"26163591501",2015,164,147,56,477,1,90,1,2951
"26163591502",1614,183,374,94,497,78,20,0,2860
"26163591600",1640,95,117,2,263,0,250,18,2385
"26163591700",5294,324,306,19,526,0,496,0,6965
"26163591800",4442,579,191,182,683,200,324,51,6652
"26163591900",4315,379,326,1,214,0,357,0,5592
"26163592000",3830,93,287,0,320,0,263,0,4793
"26163593000",4199,343,163,232,302,48,197,24,5508
"26163593200",3454,214,131,0,104,0,72,0,3975
"26163593300",2838,327,57,0,141,0,152,0,3515
"26163594000",1816,459,13,22,84,43,128,175,2740
"26163594100",3882,131,16,1,38,0,26,0,4094
"26163594200",2653,19,0,0,66,0,86,0,2824
"26163594300",2809,180,35,6,58,0,177,0,3265
"26163594400",2149,479,76,42,103,20,173,13,3055
"26163594500",2734,203,80,182,43,21,105,0,3368
"26163595000",3100,562,3,2,194,0,183,83,4127
"26163595100",4301,603,109,54,88,16,386,75,5632
"26163595200",2513,104,50,72,82,28,65,9,2923
"26163596100",3331,109,2,1,28,4,0,0,3475
"26163596200",3716,110,0,3,240,0,187,0,4256
"26163596300",2478,147,1,4,118,0,68,0,2816
"26163597000",3899,451,85,60,59,0,67,0,4621
"26163598000",2844,255,0,9,148,10,71,0,3337
"26163599000",3934,522,454,198,204,0,292,129,5733
"26163599100",3637,474,44,135,76,148,206,45,4765
"26163985000",0,0,65,0,0,0,0,0,65
"26163985100",8,7,56,49,0,4,0,5,129
"26163985200",0,0,0,0,0,0,0,0,0
"26163985300",0,0,0,0,0,0,0,0,0
"26163985400",0,0,0,0,0,0,0,0,0
"26163985500",0,0,0,0,0,0,0,0,0
"26163985600",0,0,0,0,0,0,0,0,0
"26163985700",0,0,0,0,0,0,0,0,0
"26163985900",0,0,0,0,0,0,0,0,0
"26163990100",0,0,0,0,0,0,0,0,0
"26163990200",0,0,0,0,0,0,0,0,0
"26165380100",3934,963,19,0,143,8,143,9,5219
"26165380200",3683,737,0,7,94,41,25,19,4606
"26165380300",2058,618,0,10,50,20,34,11,2801
"26165380400",3837,505,0,17,79,34,22,8,4502
"26165380500",5074,1122,26,0,36,35,51,87,6431
"26165380600",2529,679,5,1,103,77,0,4,3398
"26165380700",1730,604,29,0,25,78,0,68,2534
"26165380800",2633,414,0,10,150,0,17,10,3234
"27001770100",2025,166,2,1,76,17,4,0,2291
"27001770200",1666,239,1,2,85,27,11,11,2042
"27001770300",2914,516,13,0,21,43,12,0,3519
"27001770400",2313,405,6,0,206,108,89,9,3136
"27001790501",1623,225,3,0,14,3,3,1,1872
"27001790502",2874,155,15,1,24,6,6,0,3081
"27003050107",2439,419,13,6,43,0,11,0,2931
"27003050108",4061,376,7,0,171,66,10,0,4691
"27003050109",4718,278,10,0,115,32,17,12,5182
"27003050110",2345,285,0,0,137,56,29,0,2852
"27003050111",3209,218,0,0,150,1,12,17,3607
"27003050114",2526,35,21,0,98,0,0,0,2680
"27003050115",4441,199,72,2,651,18,692,11,6086
"27003050116",3877,362,21,1,44,123,46,214,4688
"27003050208",2998,130,35,0,147,0,28,0,3338
"27003050210",3713,174,0,0,14,38,14,0,3953
"27003050215",3794,33,29,0,196,0,56,0,4108
"27003050216",5253,113,0,1,265,1,300,0,5933
"27003050217",2552,100,0,0,217,0,39,8,2916
"27003050218",3108,76,0,0,97,0,51,0,3332
"27003050219",2780,144,0,0,88,37,42,35,3126
"27003050220",5570,471,205,0,288,13,205,27,6779
"27003050221",6060,208,67,0,214,42,48,0,6639
"27003050222",4733,72,94,18,399,0,197,0,5513
"27003050223",2472,67,0,0,66,0,8,0,2613
"27003050224",2522,129,0,0,99,0,0,0,2750
"27003050225",5624,120,263,0,275,73,94,0,6449
"27003050226",2585,97,40,0,212,18,54,0,3006
"27003050227",3651,204,67,0,252,0,44,0,4218
"27003050228",4061,114,308,0,537,0,246,20,5286
"27003050229",3567,77,7,0,282,69,147,9,4158
"27003050230",2284,10,0,0,133,4,90,0,2521
"27003050232",3552,64,0,0,181,13,29,13,3852
"27003050233",2761,2,24,0,69,0,0,0,2856
"27003050234",2625,204,34,0,74,0,116,1,3054
"27003050235",2587,111,0,0,57,26,199,26,3006
"27003050236",3781,169,56,0,269,79,42,79,4475
"27003050237",4652,280,19,49,300,15,0,0,5315
"27003050401",2227,271,195,30,289,11,94,0,3117
"27003050402",2655,398,181,18,126,31,0,0,3409
"27003050501",2137,349,0,1,216,24,91,0,2818
"27003050504",2225,90,64,0,161,48,83,55,2726
"27003050505",3766,513,77,151,219,45,269,5,5045
"27003050602",1786,277,251,20,157,15,59,54,2619
"27003050605",4244,425,112,98,433,116,372,74,5874
"27003050606",1412,239,107,152,77,122,0,16,2125
"27003050607",3718,556,104,118,196,103,18,8,4821
"27003050608",3333,287,283,48,510,13,309,9,4792
"27003050609",3140,82,5,38,88,56,38,0,3447
"27003050610",5862,220,169,0,357,71,228,57,6964
"27003050702",2658,93,105,0,164,8,57,0,3085
"27003050704",4079,235,166,37,348,77,161,0,5103
"27003050706",2632,504,118,84,333,106,68,57,3902
"27003050707",4997,356,224,0,474,0,16,0,6067
"27003050709",1917,87,67,0,148,0,74,0,2293
"27003050710",2774,163,151,23,348,0,100,23,3582
"27003050711",3906,69,150,14,292,0,136,0,4567
"27003050712",3395,250,66,53,284,59,0,0,4107
"27003050805",5482,230,303,0,389,249,1,94,6748
"27003050806",4914,223,422,0,627,29,182,0,6397
"27003050807",2449,249,194,10,325,34,4,8,3273
"27003050808",1775,123,43,27,126,54,31,0,2179
"27003050809",4678,151,60,1,1271,39,393,0,6593
"27003050810",3071,368,95,1,339,95,123,0,4092
"27003050811",2008,102,8,77,398,0,299,0,2892
"27003050813",4916,300,331,18,785,175,179,9,6713
"27003050816",3908,37,346,29,350,16,0,0,4686
"27003050818",3920,41,0,0,471,0,99,0,4531
"27003050819",2534,23,230,0,670,30,0,0,3487
"27003050820",2596,155,40,19,332,26,28,0,3196
"27003050821",3805,87,103,14,850,28,11,0,4898
"27003050901",1601,314,10,0,94,41,11,0,2071
"27003050902",4213,213,164,0,316,0,0,0,4906
"27003051001",2036,166,121,0,203,107,24,60,2717
"27003051002",2801,162,92,0,403,115,194,131,3898
"27003051101",3474,277,187,60,504,65,58,0,4625
"27003051102",2902,225,120,118,922,184,679,249,5399
"27003051103",2160,98,364,233,532,137,235,92,3851
"27003051201",2217,223,465,340,466,104,465,24,4304
"27003051202",2324,251,298,160,217,17,270,13,3550
"27003051203",3820,380,470,0,421,21,73,21,5206
"27003051206",1292,136,302,66,585,55,55,0,2491
"27003051302",1897,548,233,270,527,83,137,285,3980
"27003051304",1702,178,143,86,324,60,463,17,2973
"27003051305",1477,294,143,145,805,160,338,178,3540
"27003051400",3134,419,630,295,602,19,342,40,5481
"27003051501",1822,100,587,477,199,1,109,0,3295
"27003051502",1964,221,335,34,192,28,188,6,2968
"27003051600",4842,275,0,0,53,0,101,0,5271
"27005450100",2471,272,2,1,59,12,10,4,2831
"27005450200",2002,273,0,7,52,11,24,4,2373
"27005450300",4065,389,11,26,283,109,68,31,4982
"27005450400",2049,76,3,7,148,62,40,0,2385
"27005450500",2879,573,6,0,231,130,113,30,3962
"27005450600",2809,531,0,0,159,4,0,0,3503
"27005450700",2907,216,0,0,143,33,20,0,3319
"27005450800",1949,175,0,3,115,76,8,5,2331
"27005450900",2695,220,0,0,80,23,8,18,3044
"27005940000",1703,188,30,2,1262,733,46,27,3991
"27007450100",4605,609,18,5,523,176,42,76,6054
"27007450200",5484,835,52,47,334,173,11,63,6999
"27007450300",3885,314,7,0,202,84,50,15,4557
"27007450400",2093,439,28,0,117,30,27,29,2763
"27007450500",1294,227,0,1,31,0,2,0,1555
"27007450600",1972,1047,63,0,452,238,21,42,3835
"27007450701",3498,570,2,2,403,179,0,0,4654
"27007450702",3171,505,13,0,461,879,66,26,5121
"27007940001",215,43,14,51,3019,2532,50,141,6065
"27007940002",1011,67,0,0,608,336,21,27,2070
"27009020100",5040,518,23,5,72,36,29,16,5739
"27009020202",2532,251,0,0,62,0,17,0,2862
"27009020203",2211,55,16,0,32,21,31,0,2366
"27009020205",2947,145,0,0,10,1,45,0,3148
"27009020206",1963,298,13,0,78,5,54,0,2411
"27009020300",3071,54,4,0,91,0,65,0,3285
"27009021101",6470,1040,109,22,189,182,26,0,8038
"27009021102",3536,427,0,29,82,152,171,3,4400
"27009021200",3884,1710,187,359,39,209,50,179,6617
"27011950100",1308,117,0,0,0,18,18,8,1469
"27011950200",1348,233,0,0,13,8,9,6,1617
"27011950300",1753,240,1,0,25,14,11,0,2044
"27013170100",4119,296,183,65,73,5,97,21,4859
"27013170200",4404,420,58,55,185,0,91,0,5213
"27013170300",2370,604,6,19,39,38,43,3,3122
"27013170400",3057,383,55,106,88,12,103,5,3809
"27013170500",3648,479,163,127,306,182,83,0,4988
"27013170600",1304,314,10,14,73,2,9,9,1735
"27013170700",1583,1101,14,0,71,80,98,144,3091
"27013170800",4136,297,10,66,136,28,77,14,4764
"27013170900",2730,255,22,0,95,57,78,64,3301
"27013171000",3227,149,0,13,39,26,9,24,3487
"27013171101",1745,2091,9,194,118,208,10,11,4386
"27013171202",3142,1957,18,249,238,219,11,181,6015
"27013171300",3223,202,2,0,80,9,138,16,3670
"27013171400",3299,280,5,0,98,15,78,7,3782
"27013171500",2570,230,0,3,18,16,48,24,2909
"27013171600",2420,742,140,110,99,31,80,37,3659
"27015960101",1766,190,15,0,39,0,16,0,2026
"27015960102",1048,150,0,0,42,0,60,0,1300
"27015960200",3409,225,0,4,24,3,14,0,3679
"27015960300",2597,388,0,0,22,0,12,72,3091
"27015960400",3960,273,0,0,19,1,16,11,4280
"27015960500",3052,360,11,2,183,44,411,186,4249
"27015960600",2780,304,17,13,29,28,26,35,3232
"27015960700",3128,306,1,1,27,4,10,1,3478
"27017070100",4372,436,168,0,377,97,178,0,5628
"27017070200",3161,469,46,0,90,34,60,0,3860
"27017070300",4865,112,16,0,134,28,51,0,5206
"27017070400",6567,642,10,8,301,115,41,18,7702
"27017070500",4868,978,9,60,106,173,39,45,6278
"27017070600",2740,368,0,0,68,24,20,14,3234
"27017940000",1247,189,0,8,894,559,15,1,2913
"27019090100",4729,602,47,0,192,19,141,0,5730
"27019090200",3752,85,11,0,83,64,51,38,4084
"27019090301",5925,320,0,0,217,2,230,0,6694
"27019090302",5125,86,17,0,137,12,135,0,5512
"27019090401",4137,150,0,0,89,0,10,56,4442
"27019090402",5278,140,0,0,197,0,78,48,5741
"27019090501",2483,28,0,0,28,0,0,0,2539
"27019090502",2404,41,12,0,402,0,101,0,2960
"27019090503",2623,60,44,0,92,0,28,0,2847
"27019090601",3429,112,0,0,372,0,228,0,4141
"27019090602",2599,117,0,0,166,0,0,0,2882
"27019090701",5469,217,20,54,550,0,0,0,6310
"27019090702",2102,0,0,0,115,0,80,0,2297
"27019090800",7100,322,150,4,584,3,303,124,8590
"27019090900",5150,134,44,0,160,0,65,0,5553
"27019091000",7694,890,327,0,715,241,1385,34,11286
"27019091100",5085,154,96,2,558,0,38,32,5965
"27019091201",4067,155,37,10,128,424,65,354,5240
"27019091202",2528,70,0,5,75,37,47,0,2762
"27021940001",2509,425,0,0,395,464,31,55,3879
"27021940002",743,142,15,0,1297,785,48,66,3096
"27021960100",1495,291,0,16,121,21,27,11,1982
"27021960200",1730,224,0,0,230,221,27,0,2432
"27021960301",898,34,0,0,25,0,2,0,959
"27021960302",1033,68,0,0,36,0,6,0,1143
"27021960600",2441,517,13,1,90,73,14,4,3153
"27021960700",3167,566,1,1,43,6,18,0,3802
"27021960801",3333,249,0,0,39,6,14,0,3641
"27021960802",3761,493,9,0,96,0,57,9,4425
"27023950300",1575,148,3,0,161,2,77,0,1966
"27023950400",1887,216,0,0,16,2,57,12,2190
"27023950500",2010,109,12,0,125,67,46,14,2383
"27023950600",4848,554,3,34,133,149,261,151,6133
"27025110100",3483,281,12,0,80,4,42,0,3902
"27025110200",4936,596,13,16,139,16,35,0,5751
"27025110301",3245,506,0,0,130,0,71,0,3952
"27025110302",5366,267,134,5,239,55,139,54,6259
"27025110401",8017,536,9,12,443,47,214,0,9278
"27025110402",4001,367,0,0,152,8,38,2,4568
"27025110501",3512,337,0,3,114,52,38,0,4056
"27025110502",6065,285,0,6,8,0,91,0,6455
"27025110600",4529,159,40,0,43,15,50,2,4838
"27025110700",3515,305,10,0,48,17,14,3,3912
"27027020100",4454,485,5,24,215,20,337,162,5702
"27027020202",1886,139,10,11,120,21,216,20,2423
"27027020300",1735,738,0,0,99,145,87,59,2863
"27027020400",1037,796,147,13,131,89,67,40,2320
"27027020500",4770,421,4,0,151,17,59,0,5422
"27027020600",3530,454,8,10,126,42,48,13,4231
"27027030102",4322,771,9,96,123,44,144,112,5621
"27027030103",5144,751,221,61,728,386,263,47,7601
"27027030104",6594,452,14,0,196,78,136,136,7606
"27027030106",1676,210,64,0,57,1,26,4,2038
"27027030107",1662,75,0,0,1,0,0,3,1741
"27027030201",4941,331,16,0,152,17,34,12,5503
"27027030202",4234,144,31,0,104,1,29,0,4543
"27029000100",1945,347,7,0,149,116,28,21,2613
"27029000200",1884,178,3,0,406,314,23,30,2838
"27029000300",2663,439,0,0,108,25,28,0,3263
"27031480100",2551,178,24,0,380,118,25,16,3292
"27031480200",1663,91,0,3,99,37,1,0,1894
"27031990000",0,0,0,0,0,0,0,0,0
"27033270100",2239,280,0,0,439,86,221,36,3301
"27033270200",1919,257,0,8,54,2,126,46,2412
"27033270300",2804,181,0,4,72,39,11,0,3111
"27033270400",2154,653,23,26,73,19,107,0,3055
"27035950100",1799,150,0,0,29,23,0,11,2012
"27035950204",1568,120,1,0,30,0,0,2,1721
"27035950400",4640,567,21,25,53,0,37,11,5354
"27035950501",2726,78,0,0,83,0,20,0,2907
"27035950502",2367,153,0,0,34,0,23,0,2577
"27035950700",4394,957,3,26,138,60,66,74,5718
"27035950800",4030,501,25,19,80,34,23,8,4720
"27035950900",4721,309,0,0,213,12,22,0,5277
"27035951000",3537,556,50,0,50,0,23,0,4216
"27035951100",2801,1401,23,97,70,59,42,48,4541
"27035951200",1808,535,0,58,11,45,39,52,2548
"27035951301",4294,204,0,0,35,0,0,0,4533
"27035951302",4790,959,57,0,9,144,0,102,6061
"27035951400",4562,421,0,6,114,53,50,10,5216
"27035951600",2191,251,0,0,117,30,9,0,2598
"27035951700",2463,162,0,0,15,3,3,11,2657
"27037060101",2849,157,103,6,538,91,688,92,4524
"27037060102",2229,62,108,14,267,20,332,34,3066
"27037060103",2321,38,52,0,115,0,115,0,2641
"27037060104",3821,324,625,35,186,519,371,599,6480
"27037060105",3029,471,117,306,689,297,1340,352,6601
"27037060201",2249,62,41,30,367,1,242,0,2992
"27037060202",2829,337,214,55,112,14,109,79,3749
"27037060301",2906,512,104,178,219,180,414,243,4756
"27037060302",2781,683,26,0,192,32,171,349,4234
"27037060401",2156,47,57,0,170,1,297,0,2728
"27037060402",2639,175,131,160,288,0,181,0,3574
"27037060502",3327,447,94,3,449,85,532,307,5244
"27037060503",3865,306,195,16,473,83,533,63,5534
"27037060505",3838,559,191,62,326,276,613,236,6101
"27037060506",4663,105,148,0,712,51,570,48,6297
"27037060507",2718,328,47,71,157,18,103,18,3460
"27037060508",4970,130,37,0,397,45,229,0,5808
"27037060509",4656,52,149,0,461,85,345,0,5748
"27037060603",3888,143,64,1,246,1,251,0,4594
"27037060604",3189,52,0,0,102,8,42,0,3393
"27037060605",1290,43,75,0,150,0,28,0,1586
"27037060606",2420,158,4,0,159,16,242,16,3015
"27037060709",4200,153,549,25,791,10,491,0,6219
"27037060710",2455,239,226,270,439,49,414,115,4207
"27037060711",2698,225,462,353,199,98,141,55,4231
"27037060713",2646,193,172,46,212,0,229,0,3498
"27037060714",3539,233,199,9,323,59,60,0,4422
"27037060716",2894,313,51,43,502,96,123,84,4106
"27037060717",1862,88,18,12,340,0,95,0,2415
"27037060721",1868,144,92,32,351,19,239,8,2753
"27037060725",2201,213,412,144,618,161,520,138,4407
"27037060726",1748,237,329,22,305,29,155,0,2825
"27037060727",1929,240,92,44,458,84,49,49,2945
"27037060728",3283,102,368,44,698,72,167,25,4759
"27037060729",3487,35,100,0,499,0,134,0,4255
"27037060730",5770,143,0,0,354,162,115,120,6664
"27037060731",4052,143,35,0,302,27,89,0,4648
"27037060732",4804,101,191,25,472,64,97,0,5754
"27037060733",3004,159,72,194,357,10,95,0,3891
"27037060734",3741,59,27,0,622,0,128,0,4577
"27037060735",3334,134,262,178,649,172,255,22,5006
"27037060737",3116,156,569,64,775,0,251,60,4991
"27037060738",2076,123,189,9,523,303,233,293,3749
"27037060739",3681,759,176,81,677,136,480,376,6366
"27037060741",5141,537,275,121,485,205,317,108,7189
"27037060742",3325,112,112,0,142,0,110,0,3801
"27037060743",905,103,210,91,108,31,57,0,1505
"27037060744",1198,15,93,0,241,0,77,0,1624
"27037060745",2862,247,337,429,261,332,153,340,4961
"27037060746",2542,366,69,165,238,39,117,272,3808
"27037060747",2405,130,820,281,340,0,204,0,4180
"27037060748",2742,64,345,106,326,0,130,0,3713
"27037060749",1164,34,51,0,245,39,233,0,1766
"27037060750",2550,146,421,31,324,198,52,198,3920
"27037060805",1946,427,188,25,380,244,431,262,3903
"27037060806",4892,119,112,0,367,67,14,66,5637
"27037060811",3886,207,138,92,430,144,10,0,4907
"27037060812",5046,88,494,336,395,45,58,0,6462
"27037060813",3855,179,66,0,379,202,320,165,5166
"27037060814",5393,143,62,0,371,401,297,19,6686
"27037060815",4197,149,47,0,349,14,70,0,4826
"27037060816",5366,148,41,16,276,0,87,0,5934
"27037060817",6246,231,200,281,526,36,141,62,7723
"27037060818",5962,405,57,0,890,66,67,0,7447
"27037060819",5720,464,20,0,557,0,80,86,6927
"27037060820",7083,148,0,0,395,0,74,0,7700
"27037060821",4817,390,164,4,165,198,254,27,6019
"27037060822",1222,7,43,11,9,0,0,0,1292
"27037060823",3407,2,165,0,378,0,43,0,3995
"27037060824",2894,222,133,3,273,6,48,0,3579
"27037060825",5959,147,124,102,603,56,52,0,7043
"27037060826",5197,347,315,143,726,10,150,18,6906
"27037060828",2596,136,283,26,733,86,126,72,4058
"27037060829",2416,49,172,7,263,26,106,26,3065
"27037060902",4448,33,220,0,84,1,21,0,4807
"27037060904",2682,325,14,13,104,35,54,97,3324
"27037060905",4091,321,235,50,318,17,225,0,5257
"27037060906",3233,8,124,9,201,25,65,9,3674
"27037060907",6235,20,0,1,458,0,322,0,7036
"27037061001",3186,100,2,0,112,14,16,0,3430
"27037061003",1034,86,7,1,22,12,41,0,1203
"27037061004",5529,118,22,0,579,13,151,0,6412
"27037061005",1818,200,18,0,174,0,155,10,2375
"27037061007",3984,144,466,0,177,0,41,90,4902
"27037061008",1257,560,403,73,278,0,556,0,3127
"27037061009",3969,31,261,0,823,25,107,0,5216
"27037061102",3840,268,130,36,145,22,142,0,4583
"27037061105",2142,195,34,0,113,9,66,0,2559
"27037061106",2455,239,9,29,129,17,69,15,2962
"27037061107",5450,365,0,0,373,0,399,0,6587
"27037061108",5426,478,14,16,242,10,131,28,6345
"27037061401",2938,132,8,3,51,0,26,0,3158
"27037061402",3362,282,0,3,60,64,38,50,3859
"27037061501",2287,78,0,0,34,0,17,0,2416
"27037061502",2648,79,7,0,46,0,20,0,2800
"27039950100",4273,143,21,1,68,5,77,20,4608
"27039950200",3362,435,0,0,215,25,310,171,4518
"27039950300",1978,315,21,0,104,21,116,64,2619
"27039950400",3095,197,27,80,5,14,35,0,3453
"27039950500",5375,230,4,0,0,14,138,0,5761
"27041450100",2804,226,1,2,17,0,15,0,3065
"27041450200",3262,270,0,0,69,2,66,11,3680
"27041450500",4239,237,14,3,47,17,7,0,4564
"27041450600",5044,832,14,25,113,19,20,19,6086
"27041450701",3435,1089,30,0,99,49,28,23,4753
"27041450702",2314,226,0,0,39,12,0,0,2591
"27041450800",3033,511,24,0,68,8,54,26,3724
"27041450900",3095,152,0,0,20,2,34,0,3303
"27041451000",3904,168,16,0,20,5,87,0,4200
"27043460100",1727,135,0,0,19,0,18,8,1907
"27043460200",1867,231,0,0,30,1,87,0,2216
"27043460300",1678,201,1,2,23,4,63,7,1979
"27043460400",2450,564,8,0,63,40,144,171,3440
"27043460500",2075,196,1,0,22,42,74,13,2423
"27043460600",2208,373,0,0,45,0,201,10,2837
"27045960100",3111,301,1,0,23,8,29,9,3482
"27045960200",3953,313,0,0,58,37,38,62,4461
"27045960300",3103,383,22,7,63,40,9,0,3627
"27045960400",2474,437,0,0,1,5,8,2,2927
"27045960500",2500,536,1,0,12,0,15,0,3064
"27045960600",2593,364,2,0,29,29,26,11,3054
"27047180100",2623,148,4,0,52,7,102,13,2949
"27047180200",2303,173,2,0,43,0,30,2,2553
"27047180300",3097,241,0,0,78,26,136,13,3591
"27047180400",2941,109,51,0,38,28,173,28,3368
"27047180500",3584,442,1,0,105,19,298,84,4533
"27047180600",3027,862,24,78,162,46,803,207,5209
"27047180700",2195,156,1,0,38,1,74,5,2470
"27047180800",1952,267,60,0,103,84,287,33,2786
"27047180900",2416,389,0,27,217,95,273,63,3480
"27047181000",2120,171,0,0,73,3,125,0,2492
"27049080101",3324,579,0,43,48,48,0,0,4042
"27049080102",4798,359,0,148,117,9,98,0,5529
"27049080200",5627,800,6,57,478,126,432,45,7571
"27049080300",3468,256,0,2,45,50,20,7,3848
"27049080400",3483,206,4,0,134,0,95,72,3994
"27049080500",3252,144,8,0,66,7,65,0,3542
"27049080600",4041,247,12,57,138,0,34,0,4529
"27049080700",3093,324,6,8,56,5,212,106,3810
"27049080800",3577,343,35,0,86,12,63,11,4127
"27049080900",4851,546,0,56,116,38,93,9,5709
"27051070100",2884,226,7,5,39,4,35,9,3209
"27051070200",2325,334,0,0,40,28,30,25,2782
"27053000101",1517,96,460,99,1049,330,106,1,3658
"27053000102",1900,161,690,423,1192,40,172,0,4578
"27053000300",2409,108,315,213,212,1,112,7,3377
"27053000601",3721,456,46,166,450,99,381,120,5439
"27053000603",2418,116,0,0,119,11,5,0,2669
"27053001100",1518,175,29,8,270,179,306,165,2650
"27053001700",1300,230,288,447,230,4,207,75,2781
"27053002200",135,19,335,123,306,563,111,205,1797
"27053002400",1470,185,187,178,163,56,58,0,2297
"27053002700",341,145,960,907,411,85,88,111,3048
"27053003200",335,12,552,499,108,56,103,0,1665
"27053003300",155,4,829,520,557,467,95,17,2644
"27053003800",1397,1528,204,17,394,184,7,52,3783
"27053005901",891,382,611,720,112,114,26,63,2919
"27053005902",902,652,382,732,204,179,424,443,3918
"27053006800",2601,745,356,40,364,137,549,42,4834
"27053007700",1529,194,245,670,227,196,188,97,3346
"27053007801",454,255,352,127,166,244,236,237,2071
"27053008100",2930,286,19,139,192,29,28,11,3634
"27053008200",1739,1142,201,690,276,220,566,494,5328
"27053008300",954,221,83,253,476,225,755,153,3120
"27053008400",1282,138,363,184,346,161,763,41,3278
"27053008500",2000,817,219,129,797,186,987,624,5759
"27053009500",1568,419,355,212,392,154,535,360,3995
"27053009600",2344,279,190,334,222,221,337,333,4260
"27053010600",2563,83,204,0,177,0,106,8,3141
"27053010700",2032,121,0,12,149,30,70,0,2414
"27053011000",2958,119,119,138,121,53,143,81,3732
"27053011703",3232,162,228,0,330,40,92,19,4103
"27053011704",2747,215,137,0,293,37,275,19,3723
"27053011800",4107,245,242,0,247,0,467,11,5319
"27053011998",3449,113,51,0,296,63,248,0,4220
"27053012001",4797,300,174,6,472,0,282,10,6041
"27053012003",3547,384,786,38,820,197,1039,102,6913
"27053012101",1633,273,109,449,487,158,575,206,3890
"27053012102",1999,152,238,52,367,34,240,0,3082
"27053020101",2886,50,35,2,74,0,70,0,3117
"27053020102",1822,120,45,0,160,30,68,0,2245
"27053020200",2463,184,2368,676,1713,749,728,494,9375
"27053020301",1503,428,318,204,216,116,119,199,3103
"27053020302",776,151,630,294,360,47,148,0,2406
"27053020303",1809,89,486,238,905,293,373,0,4193
"27053020304",1084,314,634,234,652,160,52,223,3353
"27053020400",1922,485,1032,318,333,124,41,160,4415
"27053020500",1574,186,519,209,1384,39,555,0,4466
"27053020600",1120,157,124,27,474,9,172,9,2092
"27053020700",2975,216,210,210,522,40,266,31,4470
"27053020801",1202,108,415,47,251,35,169,0,2227
"27053020804",1855,294,333,53,378,71,154,78,3216
"27053020902",1865,161,35,0,120,32,90,98,2401
"27053020903",2734,94,373,23,167,37,363,6,3797
"27053021001",4034,220,539,112,343,0,141,0,5389
"27053021002",1501,33,18,91,76,29,100,0,1848
"27053021100",1271,179,104,291,123,15,39,0,2022
"27053021200",3834,78,371,49,211,40,194,0,4777
"27053021300",2977,330,531,353,230,22,166,9,4618
"27053021400",2300,68,283,90,228,18,56,12,3055
"27053021501",2522,263,549,173,237,27,52,29,3852
"27053021502",1724,368,781,64,159,105,289,112,3602
"27053021503",3089,319,418,56,907,47,631,156,5623
"27053021504",2396,116,453,417,187,75,87,13,3744
"27053021505",3052,201,569,275,313,250,103,8,4771
"27053021601",2928,140,582,98,355,90,105,0,4298
"27053021602",4525,375,260,48,120,299,97,0,5724
"27053021700",4022,111,209,0,404,0,117,0,4863
"27053021800",1628,77,104,10,295,0,23,0,2137
"27053021900",3008,58,119,36,199,25,112,0,3557
"27053022000",1213,105,30,12,128,0,43,0,1531
"27053022101",1841,125,147,121,424,46,99,12,2815
"27053022102",2000,210,90,59,227,9,174,0,2769
"27053022200",4017,94,50,0,419,27,156,0,4763
"27053022301",1791,78,45,6,91,0,8,0,2019
"27053022302",1672,115,391,154,169,91,78,30,2700
"27053022400",2918,85,0,213,460,40,150,15,3881
"27053022700",3122,126,302,55,408,76,364,0,4453
"27053022801",2016,41,27,0,48,0,26,0,2158
"27053022802",2331,217,158,24,288,16,114,8,3156
"27053022901",4204,271,116,9,196,51,203,0,5050
"27053022902",1694,32,37,4,0,0,83,5,1855
"27053023000",3118,114,416,21,390,11,104,0,4174
"27053023100",1618,23,10,0,105,0,57,0,1813
"27053023200",2905,431,456,433,1527,119,282,131,6284
"27053023300",3770,300,432,35,917,178,704,154,6490
"27053023400",3601,549,339,501,443,581,289,288,6591
"27053023501",3097,120,39,0,318,29,124,0,3727
"27053023502",4793,233,233,78,221,30,108,29,5725
"27053023600",3797,141,11,0,90,0,10,13,4062
"27053023700",3774,176,51,85,462,0,28,0,4576
"27053023801",4569,168,13,11,268,0,127,32,5188
"27053023802",2526,115,46,0,144,0,15,0,2846
"27053023901",3323,0,7,0,296,0,95,0,3721
"27053023902",1847,30,50,0,96,6,113,0,2142
"27053023903",2421,49,141,111,408,34,46,0,3210
"27053024003",3025,70,120,24,1578,0,456,13,5286
"27053024004",2964,107,63,14,562,4,16,0,3730
"27053024005",1167,137,89,57,264,0,43,0,1757
"27053024006",1554,51,14,0,252,15,7,1,1894
"27053024100",2405,162,224,169,510,12,428,12,3922
"27053024200",2593,44,85,0,205,28,181,0,3136
"27053024300",2222,499,628,54,833,68,537,245,5086
"27053024400",2609,296,253,87,779,80,334,15,4453
"27053024500",1548,114,80,13,364,171,142,148,2580
"27053024600",2420,207,233,130,392,114,157,82,3735
"27053024700",2193,332,118,272,245,156,215,133,3664
"27053024801",1557,68,173,30,343,26,297,21,2515
"27053024802",1629,366,236,38,660,177,1107,388,4601
"27053024901",728,28,53,4,82,3,116,2,1016
"27053024902",1302,264,114,220,502,426,512,483,3823
"27053024903",971,151,525,92,385,82,486,62,2754
"27053025100",1246,131,472,307,517,73,287,96,3129
"27053025201",2684,295,628,622,717,232,665,404,6247
"27053025205",3754,156,77,20,874,288,721,292,6182
"27053025301",2493,66,35,0,293,16,125,0,3028
"27053025302",2862,281,117,286,429,170,256,0,4401
"27053025401",2164,212,511,272,693,131,348,24,4355
"27053025403",2418,306,289,158,303,30,138,71,3713
"27053025601",1517,249,122,11,342,25,166,0,2432
"27053025603",3032,331,149,16,263,43,104,179,4117
"27053025605",2801,230,166,26,237,0,52,0,3512
"27053025701",5212,251,342,3,964,36,486,0,7294
"27053025702",3017,245,233,84,759,73,492,46,4949
"27053025801",2309,369,124,44,213,3,92,240,3394
"27053025802",2097,44,14,1,94,60,0,59,2369
"27053025803",2383,193,84,15,292,88,200,38,3293
"27053025805",2282,86,129,0,146,24,32,0,2699
"27053025903",5223,257,155,50,380,120,117,74,6376
"27053025905",3099,81,61,0,357,0,50,0,3648
"27053025906",4854,395,220,34,662,0,143,0,6308
"27053025907",3516,26,85,415,543,0,161,0,4746
"27053026005",3316,54,62,71,208,13,108,0,3832
"27053026006",2469,97,86,94,233,4,149,1,3133
"27053026007",3234,222,281,396,701,82,250,13,5179
"27053026013",4126,63,230,1,191,1,16,0,4628
"27053026014",4291,169,56,0,307,81,122,1,5027
"27053026015",4533,220,41,145,514,0,262,0,5715
"27053026016",5835,333,109,83,498,93,278,63,7292
"27053026018",5405,151,156,0,1047,0,262,0,7021
"27053026019",2307,158,300,71,2518,31,230,0,5615
"27053026020",3057,75,555,189,251,28,0,0,4155
"27053026021",3376,210,216,0,623,0,148,0,4573
"27053026022",5819,12,167,0,1068,31,76,0,7173
"27053026101",2816,73,22,38,67,66,19,0,3101
"27053026103",2738,80,0,0,109,0,77,0,3004
"27053026104",2746,59,527,278,457,0,20,0,4087
"27053026201",3074,10,87,0,82,3,61,0,3317
"27053026202",2501,60,9,0,171,11,31,11,2794
"27053026205",2797,94,9,8,211,1,112,10,3242
"27053026206",2740,120,0,0,148,0,0,0,3008
"27053026207",3423,359,67,28,229,92,153,55,4406
"27053026208",2938,56,8,13,160,13,0,0,3188
"27053026301",2886,104,51,0,120,0,61,10,3232
"27053026302",2991,71,0,0,301,26,41,0,3430
"27053026402",4518,300,428,48,499,21,241,94,6149
"27053026403",2399,73,117,8,334,26,33,0,2990
"27053026404",4670,211,45,129,162,7,51,0,5275
"27053026505",3083,165,135,35,289,0,56,1,3764
"27053026507",3448,255,331,190,206,22,191,14,4657
"27053026508",4180,135,189,101,262,20,112,0,4999
"27053026509",3900,31,218,49,188,0,172,0,4558
"27053026510",2749,265,63,0,371,0,80,12,3540
"27053026511",2441,284,275,107,463,35,161,210,3976
"27053026512",4376,282,260,213,379,72,40,28,5650
"27053026514",3460,164,300,2,816,12,67,0,4821
"27053026605",2899,42,54,14,433,0,227,23,3692
"27053026606",4584,77,53,13,264,35,115,31,5172
"27053026609",2713,222,9,0,155,0,0,0,3099
"27053026610",3805,130,101,0,212,39,120,0,4407
"27053026611",3768,158,248,94,347,230,251,0,5096
"27053026612",7180,175,292,11,1516,83,142,0,9399
"27053026613",5156,100,49,0,1317,13,295,0,6930
"27053026702",2015,115,21,6,223,32,21,0,2433
"27053026706",3319,51,0,28,70,5,19,5,3497
"27053026707",4370,47,254,0,198,8,60,0,4937
"27053026708",4849,160,97,204,242,34,104,47,5737
"27053026710",6368,215,365,0,961,41,92,0,8042
"27053026711",2677,102,13,88,140,1,8,1,3030
"27053026712",2742,102,33,94,155,0,138,0,3264
"27053026713",3738,80,7,83,300,0,184,0,4392
"27053026714",7263,357,644,64,880,29,243,0,9480
"27053026715",10774,875,261,133,1383,0,475,0,13901
"27053026716",7548,17,0,2,467,48,0,0,8082
"27053026807",3320,339,756,361,606,5,203,0,5590
"27053026809",943,539,1832,470,902,407,727,654,6474
"27053026810",2037,352,1616,431,1351,469,551,241,7048
"27053026811",2893,101,1546,596,990,12,387,0,6525
"27053026812",2919,134,699,240,1423,98,150,10,5673
"27053026814",3154,340,976,271,1159,12,200,155,6267
"27053026815",2817,29,528,23,1556,161,120,0,5234
"27053026816",2265,228,1944,195,1219,220,227,27,6325
"27053026818",2253,288,937,816,721,13,355,0,5383
"27053026819",919,432,1588,630,642,446,343,260,5260
"27053026820",6972,154,1722,27,2348,314,386,0,11923
"27053026822",3797,65,379,78,669,0,104,0,5092
"27053026823",2899,78,691,0,1002,53,0,0,4723
"27053026903",3740,145,321,2,140,57,50,8,4463
"27053026906",6034,266,625,16,261,0,328,21,7551
"27053026907",5281,68,136,0,169,11,108,8,5781
"27053026908",5502,129,141,1,334,0,166,0,6273
"27053026909",10417,320,230,0,367,1,125,0,11460
"27053026910",3981,488,54,1,175,0,261,177,5137
"27053027001",2778,219,0,0,58,0,10,66,3131
"27053027002",4701,173,23,13,279,54,136,16,5395
"27053027101",5198,148,30,0,159,90,115,78,5818
"27053027102",5152,122,49,0,193,0,220,0,5736
"27053027201",5898,136,109,0,244,66,72,20,6545
"27053027202",1657,161,8,4,66,4,33,0,1933
"27053027203",3179,141,14,30,154,4,12,0,3534
"27053027300",3336,229,98,32,111,8,68,0,3882
"27053027400",3960,48,0,2,116,2,70,0,4198
"27053027501",4010,269,21,0,119,17,86,0,4522
"27053027503",3773,149,21,0,144,13,40,12,4152
"27053027504",3110,85,12,0,58,0,79,0,3344
"27053027601",3131,410,153,32,96,15,166,28,4031
"27053027602",4707,335,0,0,152,60,20,0,5274
"27053027700",8011,503,51,0,379,37,217,37,9235
"27053100200",1879,114,526,284,383,281,358,0,3825
"27053100400",684,239,885,642,476,308,98,51,3383
"27053100500",1325,137,53,236,251,39,60,8,2109
"27053100700",1572,133,619,404,257,0,104,0,3089
"27053100800",903,116,838,606,689,553,0,108,3813
"27053100900",1154,196,791,1290,558,229,186,56,4460
"27053101200",3275,193,108,57,465,4,313,0,4415
"27053101300",354,77,610,204,371,137,295,53,2101
"27053101600",266,170,487,300,488,401,155,109,2376
"27053101800",1655,498,269,639,701,159,560,274,4755
"27053101900",1710,278,266,80,256,66,96,0,2752
"27053102000",469,15,803,341,343,170,58,0,2199
"27053102100",277,31,645,617,410,218,142,0,2340
"27053102300",236,18,475,206,82,78,21,4,1120
"27053102500",1710,568,108,82,178,96,430,321,3493
"27053102600",766,390,53,28,444,94,250,88,2113
"27053102800",285,173,742,570,207,460,37,0,2474
"27053102900",156,64,240,249,443,107,205,24,1488
"27053103000",1031,205,53,13,197,4,111,9,1623
"27053103100",1365,165,175,152,244,65,270,62,2498
"27053103400",244,151,655,937,110,378,166,334,2975
"27053103600",1865,119,67,15,170,11,54,0,2301
"27053103700",1530,611,44,44,547,136,143,34,3089
"27053103900",386,1076,0,84,154,233,6,12,1951
"27053104000",2662,2403,147,605,1236,372,132,133,7690
"27053104100",872,380,861,795,208,158,119,246,3639
"27053104400",1006,323,107,193,324,136,27,19,2135
"27053104800",867,567,1297,1906,142,660,83,175,5697
"27053104900",632,2062,140,347,574,915,0,176,4846
"27053105100",2290,75,95,0,168,18,30,0,2676
"27053105201",1869,507,67,92,214,15,60,19,2843
"27053105204",1072,484,181,451,124,39,54,48,2453
"27053105400",1409,163,316,372,272,62,96,27,2717
"27053105500",3106,271,114,0,240,53,78,53,3915
"27053105600",2288,494,195,170,481,113,327,124,4192
"27053105700",1333,407,360,521,54,111,125,16,2927
"27053106000",557,239,507,871,320,535,271,109,3409
"27053106200",822,626,1104,519,218,202,31,19,3541
"27053106400",926,155,272,392,90,27,12,0,1874
"27053106500",3546,254,99,0,271,32,102,15,4319
"27053106600",2081,177,8,2,205,28,87,0,2588
"27053106700",4166,565,121,43,301,0,358,44,5598
"27053106900",1196,417,298,33,166,121,268,56,2555
"27053107000",1988,565,307,431,615,247,862,404,5419
"27053107400",979,73,144,120,301,7,229,20,1873
"27053107500",1530,154,31,77,153,36,78,18,2077
"27053107600",2826,209,112,1,568,37,221,28,4002
"27053108000",2758,284,0,14,274,62,118,0,3510
"27053108600",1017,243,223,397,559,211,392,234,3276
"27053108700",2109,263,271,43,341,135,133,107,3402
"27053108800",2133,383,405,202,264,148,111,286,3932
"27053108900",1948,72,148,0,100,0,134,0,2402
"27053109000",1402,80,123,1,53,0,25,0,1684
"27053109100",3881,397,99,1,455,17,126,0,4976
"27053109200",2517,388,95,49,286,0,140,0,3475
"27053109300",2607,246,340,85,640,41,481,38,4478
"27053109400",731,219,625,146,511,89,806,269,3396
"27053109700",1439,163,97,64,394,113,256,179,2705
"27053109800",3698,72,198,33,157,10,125,18,4311
"27053109900",3253,194,170,2,308,0,102,0,4029
"27053110000",623,408,318,223,252,18,608,332,2782
"27053110100",1987,70,394,13,242,0,173,0,2879
"27053110200",2340,237,68,25,669,152,160,63,3714
"27053110400",1902,299,217,0,276,145,139,106,3084
"27053110500",3913,489,67,20,293,28,153,341,5304
"27053110800",3670,235,137,36,362,126,178,15,4759
"27053110900",1712,106,692,427,363,101,217,72,3690
"27053111100",2688,113,70,0,196,6,86,0,3159
"27053111200",2766,20,21,0,74,0,63,0,2944
"27053111300",3986,65,122,174,156,22,99,0,4624
"27053111400",3463,129,62,42,231,0,53,0,3980
"27053111500",3788,240,267,169,286,57,165,0,4972
"27053111600",2828,92,175,0,130,1,91,0,3317
"27053122500",2207,158,297,396,369,81,31,0,3539
"27053122600",1892,29,44,67,81,54,33,0,2200
"27053125500",2193,152,226,310,525,87,239,0,3732
"27053125600",1611,205,31,0,198,245,11,0,2301
"27053125700",523,148,646,661,1126,778,120,53,4055
"27053125800",1801,355,816,255,816,583,1489,468,6583
"27053125900",1077,573,564,284,615,1111,905,876,6005
"27053126000",1036,560,1063,1447,484,370,648,405,6013
"27053126100",2881,514,427,285,674,279,138,22,5220
"27053126200",2948,273,104,252,181,54,99,30,3941
"27053980000",158,90,52,5,47,57,74,138,621
"27055020100",5033,572,0,0,96,0,39,0,5740
"27055020200",3134,211,0,0,60,40,14,5,3464
"27055020300",2178,266,3,9,89,0,6,7,2558
"27055020500",2581,487,0,0,45,81,31,0,3225
"27055020900",3367,355,0,12,24,2,26,0,3786
"27057070100",3856,389,15,4,249,108,76,30,4727
"27057070200",2036,147,10,0,71,5,62,8,2339
"27057070300",1552,275,0,0,130,13,10,0,1980
"27057070400",2289,319,11,0,160,19,38,0,2836
"27057070500",2612,368,0,0,61,10,89,0,3140
"27057070600",2489,759,0,17,79,43,0,0,3387
"27057070700",1860,162,2,6,18,10,21,0,2079
"27059130100",3073,379,0,0,81,0,110,0,3643
"27059130200",2546,427,4,41,111,63,15,0,3207
"27059130301",7624,716,34,64,181,43,125,5,8792
"27059130302",2327,172,0,0,63,0,29,0,2591
"27059130400",3415,201,29,0,109,0,92,0,3846
"27059130501",4503,230,0,16,119,8,25,0,4901
"27059130502",6447,465,0,0,223,67,52,0,7254
"27059130600",3586,128,5,0,89,0,154,0,3962
"27061480100",2141,313,4,0,77,15,45,14,2609
"27061480300",3577,398,0,0,323,131,15,33,4477
"27061480400",3031,281,0,9,189,11,61,7,3589
"27061480500",2045,633,0,0,76,99,0,0,2853
"27061480600",2215,187,1,0,18,11,0,11,2443
"27061480700",5090,274,21,0,79,3,36,0,5503
"27061480801",1872,206,4,0,39,0,12,0,2133
"27061480802",4921,920,0,0,205,0,0,0,6046
"27061480900",5559,745,50,0,243,35,3,0,6635
"27061481000",4719,656,10,4,254,95,56,64,5858
"27061940000",1464,252,0,3,552,258,53,41,2623
"27063480100",2121,133,0,0,53,7,11,0,2325
"27063480200",1867,166,0,3,84,40,109,59,2328
"27063480300",2112,241,0,0,46,0,41,2,2442
"27063480400",2482,511,0,0,143,77,53,34,3300
"27065480100",2935,356,19,10,87,23,33,5,3468
"27065480200",3077,620,34,3,70,28,35,55,3922
"27065480300",3085,540,0,0,31,0,5,59,3720
"27065480400",4363,547,6,0,111,34,31,18,5110
"27067770900",1849,547,166,54,124,51,378,325,3494
"27067780100",2348,136,3,0,39,0,23,0,2549
"27067780200",2213,121,1,0,4,1,16,3,2359
"27067780300",4016,180,0,0,57,32,19,35,4339
"27067780400",3479,187,0,3,72,0,123,4,3868
"27067780500",3285,647,73,246,265,216,731,151,5614
"27067780600",4548,261,0,7,206,38,322,60,5442
"27067780700",3412,245,0,0,223,42,416,83,4421
"27067780800",1150,417,56,6,132,154,328,218,2461
"27067781000",3113,1211,22,297,212,61,618,653,6187
"27067781100",2259,271,10,1,84,0,74,0,2699
"27067781200",2458,195,8,1,32,21,32,31,2778
"27069090100",2023,300,1,0,42,12,11,6,2395
"27069090200",1837,116,10,1,54,0,7,0,2025
"27071790100",1612,469,0,6,69,50,0,0,2206
"27071790200",4360,635,5,71,164,104,96,0,5435
"27071790300",2859,109,0,0,104,21,0,0,3093
"27071790500",1909,280,0,0,31,82,7,0,2309
"27073180100",1962,139,2,0,60,36,49,0,2248
"27073180200",1763,148,0,0,9,1,20,0,1941
"27073180300",2613,239,16,0,18,1,39,17,2943
"27075370100",3972,478,0,0,84,28,7,26,4595
"27075370300",1923,282,0,0,62,7,0,0,2274
"27075370400",2994,561,0,8,87,76,66,0,3792
"27075990100",0,0,0,0,0,0,0,0,0
"27077460300",1376,90,4,0,65,14,0,0,1549
"27077460400",2095,206,35,0,69,1,0,0,2406
"27079950100",6503,297,0,0,161,0,153,7,7121
"27079950200",3711,318,38,0,314,39,490,0,4910
"27079950300",3851,475,0,41,117,144,91,99,4818
"27079950400",3166,338,0,0,53,4,85,9,3655
"27079950500",3555,265,8,0,161,113,295,158,4555
"27079950600",3342,328,0,53,50,4,31,0,3808
"27081201001",2676,216,2,0,26,2,12,3,2937
"27081201002",2396,271,0,0,94,4,65,7,2837
"27083360100",3371,177,11,11,31,0,45,25,3671
"27083360200",2840,144,40,13,187,78,149,80,3531
"27083360300",3833,559,174,138,216,32,184,80,5216
"27083360400",3280,774,42,23,201,173,146,227,4866
"27083360500",2400,398,19,47,178,368,345,196,3951
"27083360600",2515,219,12,22,13,26,12,3,2822
"27083360700",1387,265,29,0,251,79,0,5,2016
"27085950100",4673,361,28,0,85,60,10,33,5250
"27085950200",3955,92,0,0,176,9,134,8,4374
"27085950300",5111,380,0,5,60,38,110,14,5718
"27085950400",6570,551,0,41,456,68,239,73,7998
"27085950500",2642,171,0,5,31,17,113,8,2987
"27085950600",3992,319,14,0,150,0,296,0,4771
"27085950700",4521,787,18,81,143,28,496,284,6358
"27087940100",1367,244,9,16,804,453,11,62,2966
"27087940300",918,133,0,7,880,559,25,20,2542
"27089080100",2030,184,1,1,53,3,15,7,2294
"27089080200",2069,181,0,0,33,0,24,3,2310
"27089080300",2006,152,2,6,21,2,180,6,2375
"27089080400",2282,197,7,2,52,7,115,9,2671
"27091790100",2633,173,2,4,44,19,7,16,2898
"27091790200",2270,327,4,0,49,14,53,37,2754
"27091790300",2104,236,3,20,12,2,11,0,2388
"27091790400",1739,111,1,2,29,33,41,21,1977
"27091790500",5823,312,0,0,117,8,54,0,6314
"27091790600",3289,889,25,9,15,26,353,150,4756
"27093560100",4710,343,0,0,56,32,62,10,5213
"27093560200",4386,346,0,0,64,0,77,10,4883
"27093560300",3185,453,19,0,85,0,223,10,3975
"27093560400",2475,594,15,11,0,0,49,157,3301
"27093560500",2862,180,7,0,73,13,55,16,3206
"27093560600",2428,340,22,0,43,4,70,16,2923
"27095170400",4514,526,0,0,112,21,40,1,5214
"27095170500",3517,507,16,0,117,5,77,4,4243
"27095170600",2484,277,9,0,65,7,66,0,2908
"27095170700",4644,548,21,0,89,54,64,30,5450
"27095970100",1657,266,28,0,199,20,33,0,2203
"27095970200",1397,325,25,5,699,539,13,17,3020
"27095970300",2140,342,0,0,70,76,12,22,2662
"27097780100",2533,321,0,0,45,0,73,10,2982
"27097780200",3589,440,0,0,12,48,30,42,4161
"27097780300",5329,423,22,10,69,10,67,17,5947
"27097780400",2328,227,14,0,23,17,1,0,2610
"27097780500",4126,527,0,0,104,7,67,9,4840
"27097780600",4128,883,0,82,156,118,46,0,5413
"27097780700",2096,517,0,0,63,14,0,0,2690
"27097780800",3895,477,4,0,24,3,47,1,4451
"27099000100",1543,395,42,33,64,0,146,177,2400
"27099000200",2410,81,0,16,79,39,95,23,2743
"27099000300",2613,1637,239,48,197,38,127,1039,5938
"27099000410",2749,1135,1,146,508,0,232,98,4869
"27099000600",2631,155,18,84,92,30,407,27,3444
"27099000800",2772,837,0,1,427,0,364,388,4789
"27099000900",3488,371,71,115,189,42,299,229,4804
"27099001000",3332,224,4,3,38,19,102,49,3771
"27099001200",1624,161,4,23,43,21,23,23,1922
"27099001300",3914,362,7,0,74,7,119,8,4491
"27099001400",2988,150,18,30,83,64,15,63,3411
"27101900100",1857,123,0,0,16,4,21,5,2026
"27101900200",2742,300,13,5,158,23,165,5,3411
"27101900300",2759,445,8,0,47,0,18,37,3314
"27103480100",3079,193,5,0,20,0,39,17,3353
"27103480200",5139,104,15,5,124,15,166,0,5568
"27103480300",3328,785,0,17,66,168,286,188,4838
"27103480400",2648,888,11,121,340,33,128,29,4198
"27103480501",5734,376,291,71,101,42,254,18,6887
"27103480502",2864,120,74,0,0,0,17,0,3075
"27103480600",3288,178,40,69,62,31,73,0,3741
"27105105100",2535,214,0,0,31,48,63,42,2933
"27105105200",2772,284,7,3,65,8,28,12,3179
"27105105300",2064,185,8,0,64,5,94,11,2431
"27105105400",2874,504,118,113,678,400,1769,410,6866
"27105105500",1803,645,12,181,546,306,893,689,5075
"27105105600",3583,190,194,123,394,163,863,134,5644
"27107960100",2123,288,16,0,112,77,41,29,2686
"27107960200",1630,137,1,0,58,50,109,5,1990
"27107960300",1722,301,3,0,56,8,63,43,2196
"27109000100",671,152,26,120,187,66,23,9,1254
"27109000200",3024,400,165,301,731,26,296,125,5068
"27109000300",2340,346,111,42,140,86,223,208,3496
"27109000400",2470,258,46,12,223,13,145,0,3167
"27109000500",1780,368,67,233,304,52,66,197,3067
"27109000600",3154,355,175,147,333,0,422,0,4586
"27109000901",4182,375,654,257,214,26,808,194,6710
"27109000902",2514,222,70,290,223,0,118,0,3437
"27109000903",2929,43,0,0,54,23,21,0,3070
"27109001000",3704,253,110,159,382,130,136,8,4882
"27109001100",2875,130,0,9,153,0,56,34,3257
"27109001201",3884,143,86,0,623,27,332,27,5122
"27109001202",3055,99,108,0,428,0,100,0,3790
"27109001203",4260,54,92,0,510,0,153,0,5069
"27109001301",3507,295,48,17,586,97,276,0,4826
"27109001302",3778,150,138,0,453,18,222,0,4759
"27109001401",3264,445,371,146,176,95,0,0,4497
"27109001402",9217,249,93,0,1483,131,282,0,11455
"27109001501",2361,220,126,52,210,0,115,17,3101
"27109001502",1891,92,30,0,100,0,112,0,2225
"27109001503",2088,198,0,0,89,0,56,0,2431
"27109001601",2933,177,311,169,324,0,83,0,3997
"27109001602",2776,57,154,0,91,71,46,0,3195
"27109001603",3233,88,11,0,275,22,31,0,3660
"27109001701",2112,492,649,37,1150,53,112,17,4622
"27109001702",2812,526,413,294,846,84,194,0,5169
"27109001703",4285,227,97,17,385,7,127,0,5145
"27109001800",4708,140,7,0,75,13,0,0,4943
"27109001900",6433,275,56,10,134,12,142,48,7110
"27109002000",6195,395,9,3,112,23,105,26,6868
"27109002100",5525,471,19,0,42,0,84,64,6205
"27109002200",3682,109,77,0,30,0,14,0,3912
"27109002300",4538,244,27,0,471,30,168,0,5478
"27111960102",2410,133,0,0,46,0,22,0,2611
"27111960103",1847,111,8,0,51,0,13,0,2030
"27111960300",2379,361,41,270,287,106,390,170,4004
"27111960400",1835,200,6,1,9,43,7,11,2112
"27111960500",4053,577,15,4,341,14,355,8,5367
"27111960600",3732,549,13,4,92,0,90,12,4492
"27111960700",2151,202,0,0,34,8,29,4,2428
"27111960800",2638,157,11,0,72,20,12,6,2916
"27111960900",4271,954,14,2,15,42,141,13,5452
"27111961000",3806,505,0,0,77,20,56,27,4491
"27111961100",3884,630,27,32,18,0,65,3,4659
"27111961200",2233,117,12,10,25,45,10,0,2452
"27111961300",3331,466,24,1,39,12,19,6,3898
"27111961400",1926,266,2,0,21,29,9,7,2260
"27111961500",2650,364,6,0,25,0,3,3,3051
"27111961600",1938,201,0,0,73,9,54,8,2283
"27111961700",3039,110,9,2,48,0,23,4,3235
"27113090100",2097,251,16,3,62,14,100,13,2556
"27113090200",1666,357,127,0,151,127,0,40,2468
"27113090300",1778,93,4,0,22,0,21,4,1922
"27113090400",2628,322,0,0,65,30,160,10,3215
"27113090500",3416,215,0,71,163,11,31,13,3920
"27115950100",2068,281,6,0,74,21,10,1,2461
"27115950200",2298,351,1,1,19,2,3,4,2679
"27115950300",2496,358,6,26,45,14,5,12,2962
"27115950400",2714,460,58,8,367,134,115,15,3871
"27115950500",3708,791,28,0,238,258,95,24,5142
"27115950600",3479,530,13,22,121,12,17,8,4202
"27115950700",2784,380,0,2,50,31,0,0,3247
"27115950800",2954,403,24,2,69,0,15,0,3467
"27117460100",1431,104,10,0,25,6,71,10,1657
"27117460200",1598,123,0,6,170,61,11,71,2040
"27117460300",1689,267,0,0,48,163,1,154,2322
"27117460400",1464,112,7,0,44,11,8,0,1646
"27117460500",1740,133,0,0,44,5,56,0,1978
"27119020100",3917,437,169,0,287,123,152,110,5195
"27119020200",974,137,6,0,47,30,49,17,1260
"27119020300",2551,66,0,0,17,0,41,0,2675
"27119020400",1988,95,0,0,45,4,79,0,2211
"27119020500",2302,260,6,9,116,8,89,61,2851
"27119020600",3525,903,0,11,285,211,308,88,5331
"27119020700",1658,243,0,9,285,14,343,97,2649
"27119020800",2018,264,0,0,68,8,72,44,2474
"27119020900",3240,480,0,11,72,18,58,28,3907
"27119021000",2868,445,6,5,81,25,59,12,3501
"27121970100",2196,180,0,2,36,6,4,6,2430
"27121970200",2434,186,2,0,39,4,69,7,2741
"27121970300",2201,145,2,0,34,3,6,0,2391
"27121970400",2741,467,40,0,22,0,4,2,3276
"27123030100",2798,334,156,32,587,78,112,12,4109
"27123030201",4640,191,48,47,73,117,86,19,5221
"27123030202",1264,452,181,14,98,68,58,61,2196
"27123030300",4681,189,11,34,232,91,226,0,5464
"27123030400",2405,497,992,422,1097,398,426,233,6470
"27123030500",917,442,597,733,1258,1667,384,312,6310
"27123030601",1512,263,788,455,1921,1128,701,423,7191
"27123030602",2742,114,138,6,696,247,196,0,4139
"27123030702",2976,310,36,237,1125,385,323,74,5466
"27123030703",1844,257,280,41,914,425,219,89,4069
"27123030704",1781,195,475,148,1019,506,561,236,4921
"27123030800",2386,391,605,282,926,351,830,22,5793
"27123030900",1147,218,245,241,939,808,308,104,4010
"27123031000",1375,665,149,181,1135,510,185,537,4737
"27123031100",1890,370,55,172,926,123,50,0,3586
"27123031200",1863,368,250,229,274,17,278,19,3298
"27123031300",567,267,39,668,500,538,83,79,2741
"27123031400",777,372,357,639,396,796,210,291,3838
"27123031500",595,246,272,217,662,179,182,73,2426
"27123031600",1052,562,109,369,1439,1078,482,83,5174
"27123031701",781,183,285,239,745,400,156,27,2816
"27123031702",1631,751,577,865,1651,1278,706,750,8209
"27123031801",1985,377,437,513,1221,331,567,269,5700
"27123031802",2232,390,57,308,468,315,344,98,4212
"27123031900",1042,576,270,69,159,211,0,6,2333
"27123032000",1974,288,359,29,94,22,132,0,2898
"27123032100",1362,229,247,217,213,118,175,58,2619
"27123032200",1656,541,212,28,93,0,60,5,2595
"27123032300",2254,310,205,243,284,74,127,152,3649
"27123032400",860,23,705,390,519,107,233,51,2888
"27123032500",607,52,511,358,1552,1714,179,0,4973
"27123032600",597,214,419,247,1051,472,219,157,3376
"27123032700",370,55,690,590,680,270,165,140,2960
"27123033000",459,285,128,172,248,265,251,115,1923
"27123033100",387,177,178,169,236,290,127,69,1633
"27123033200",1481,213,408,71,187,125,0,20,2505
"27123033300",2408,373,59,123,88,43,78,72,3244
"27123033400",879,320,500,598,199,113,172,79,2860
"27123033500",242,305,1457,821,449,104,138,0,3516
"27123033600",26,34,358,744,143,150,0,29,1484
"27123033700",123,148,177,263,237,445,18,118,1529
"27123033800",842,55,340,552,131,0,80,93,2093
"27123033900",654,14,471,282,87,143,54,16,1721
"27123034000",1033,123,100,93,35,60,15,41,1500
"27123034201",1079,380,41,40,197,37,0,0,1774
"27123034202",2918,623,348,343,430,57,70,33,4822
"27123034400",848,111,41,191,449,406,141,80,2267
"27123034500",1418,357,303,271,1366,494,153,173,4535
"27123034601",1971,325,331,257,966,603,504,109,5066
"27123034602",1537,214,206,340,1265,541,416,31,4550
"27123034701",1591,334,787,179,1116,257,318,146,4728
"27123034702",1874,400,365,166,1003,126,628,258,4820
"27123034900",1775,607,19,3,164,59,27,36,2690
"27123035000",2274,362,43,0,134,0,116,0,2929
"27123035100",1603,197,34,2,171,64,135,0,2206
"27123035200",2930,148,73,10,113,69,165,39,3547
"27123035300",3296,251,112,15,226,54,241,17,4212
"27123035500",1249,280,156,65,50,60,62,27,1949
"27123035700",2380,120,46,0,138,7,205,0,2896
"27123035800",2180,349,54,37,129,29,89,41,2908
"27123035900",515,135,29,0,45,10,39,6,779
"27123036000",1690,201,246,81,138,88,106,26,2576
"27123036100",463,239,91,245,332,329,378,312,2389
"27123036300",2568,203,30,5,95,84,16,10,3011
"27123036400",3114,225,163,9,361,109,122,0,4103
"27123036500",3283,227,130,0,221,36,83,0,3980
"27123036600",3572,200,214,56,279,286,60,339,5006
"27123036700",3579,239,128,14,449,51,432,0,4892
"27123036800",1626,261,89,31,186,34,35,12,2274
"27123036900",1441,216,134,32,87,20,33,20,1983
"27123037000",2198,122,66,76,193,89,293,49,3086
"27123037100",2356,199,312,317,950,503,1105,291,6033
"27123037200",2403,439,1015,404,1202,545,1583,328,7919
"27123037402",2238,154,551,51,739,43,350,37,4163
"27123037403",2793,84,1436,1294,889,439,371,20,7326
"27123037500",3985,170,512,2,353,39,448,40,5549
"27123037601",2770,237,131,20,63,307,160,12,3700
"27123037602",2495,729,1607,512,333,76,340,196,6288
"27123040100",6286,176,0,0,237,11,92,0,6802
"27123040200",1694,62,0,0,21,0,22,0,1799
"27123040301",1703,91,0,0,60,0,20,18,1892
"27123040302",4396,292,116,0,109,179,90,66,5248
"27123040401",2663,121,165,4,300,1,0,8,3262
"27123040402",4225,221,80,182,438,69,28,24,5267
"27123040502",2259,86,0,25,69,0,76,0,2515
"27123040503",3007,201,11,0,175,10,130,0,3534
"27123040504",3398,350,172,0,509,7,121,0,4557
"27123040601",4470,273,0,6,443,0,104,0,5296
"27123040603",4530,285,132,0,460,35,256,35,5733
"27123040604",5466,356,89,46,1093,93,218,22,7383
"27123040703",5853,194,195,0,564,0,0,2,6808
"27123040704",4208,444,77,67,557,0,176,51,5580
"27123040705",3428,180,80,0,437,13,56,0,4194
"27123040706",3999,64,89,17,503,51,66,19,4808
"27123040707",4123,52,0,0,181,0,45,0,4401
"27123040801",2426,139,0,1,380,19,92,19,3076
"27123040802",0,0,0,0,0,0,0,0,0
"27123040803",3967,314,40,1,251,60,20,0,4653
"27123040901",1570,61,104,27,311,50,15,0,2138
"27123040902",3104,239,178,118,232,293,264,18,4446
"27123041001",2667,270,49,1,242,48,155,135,3567
"27123041002",2624,59,99,30,190,21,228,0,3251
"27123041103",1925,359,326,37,324,19,91,8,3089
"27123041104",2230,136,47,5,340,18,14,0,2790
"27123041105",4341,167,134,192,391,40,89,14,5368
"27123041106",2602,73,478,104,224,11,171,0,3663
"27123041107",3555,797,607,237,596,168,16,30,6006
"27123041200",2609,486,230,52,303,50,140,290,4160
"27123041301",2682,197,173,17,672,43,218,35,4037
"27123041302",2346,75,9,0,444,95,143,2,3114
"27123041400",3935,514,513,0,437,5,64,117,5585
"27123041500",3952,129,241,0,117,86,189,0,4714
"27123041601",4801,158,230,0,643,81,309,0,6222
"27123041602",2128,468,186,28,217,836,195,341,4399
"27123041700",2241,73,49,57,92,51,61,10,2634
"27123041800",2789,539,155,0,264,51,139,249,4186
"27123041900",2889,179,34,31,115,5,92,0,3345
"27123042001",767,119,48,16,525,75,48,0,1598
"27123042002",1358,246,57,228,298,129,20,109,2445
"27123042101",3590,555,398,122,714,136,406,0,5921
"27123042102",2765,363,129,108,741,107,26,19,4258
"27123042201",1085,50,46,22,307,0,176,28,1714
"27123042202",3224,357,456,87,844,577,266,66,5877
"27123042301",2176,150,40,10,522,0,54,0,2952
"27123042302",3053,291,167,0,923,150,363,117,5064
"27123042401",4112,380,227,269,691,217,345,49,6290
"27123042402",3698,277,172,68,822,54,0,23,5114
"27123042501",4151,191,74,292,436,116,261,0,5521
"27123042503",2380,35,410,0,447,0,75,0,3347
"27123042504",2518,101,532,24,511,30,100,14,3830
"27123042601",2978,288,255,265,359,24,164,0,4333
"27123042602",1402,182,55,7,288,17,64,9,2024
"27123042700",4154,403,64,84,516,360,337,65,5983
"27123042800",404,117,436,572,373,474,93,37,2506
"27123042900",2803,216,464,96,160,35,117,16,3907
"27123043000",5181,232,52,112,424,15,288,0,6304
"27123980000",0,0,0,0,0,0,0,0,0
"27125010100",1501,270,7,0,43,8,13,43,1885
"27125010200",1904,187,9,9,94,5,51,5,2264
"27127750100",2164,230,0,54,324,89,31,6,2898
"27127750200",2735,266,14,0,215,60,64,10,3364
"27127750300",1631,92,0,0,235,59,129,0,2146
"27127750400",2524,171,0,0,68,0,17,0,2780
"27127750500",2090,220,3,0,329,126,25,12,2805
"27127750600",1651,181,0,5,96,7,49,21,2010
"27129790100",2579,220,0,5,154,30,247,0,3235
"27129790200",1628,173,4,0,13,36,11,36,1901
"27129790300",1773,140,0,0,15,0,41,0,1969
"27129790400",2241,230,1,0,174,49,282,55,3032
"27129790500",2509,441,9,67,18,6,143,106,3299
"27129790600",2178,331,6,0,93,31,96,21,2756
"27131070100",6112,479,12,0,141,0,36,0,6780
"27131070200",4830,147,2,0,89,0,74,9,5151
"27131070300",4129,411,17,0,50,35,89,92,4823
"27131070400",3974,334,0,0,76,9,25,15,4433
"27131070501",1829,117,0,0,132,31,80,14,2203
"27131070503",2869,68,8,0,136,1,39,0,3121
"27131070504",2827,464,17,0,115,37,114,0,3574
"27131070601",2220,265,0,0,951,364,819,0,4619
"27131070602",1777,179,65,0,75,0,102,0,2198
"27131070700",3473,847,60,0,124,34,125,232,4895
"27131070800",6152,574,156,138,317,19,209,158,7723
"27131070901",4248,697,0,193,218,109,849,398,6712
"27131070902",2335,663,12,140,189,176,513,508,4536
"27133570100",2156,161,18,0,24,2,10,1,2372
"27133570200",3233,418,0,0,9,0,32,0,3692
"27133570300",2580,586,16,32,130,34,49,120,3547
"27135970100",3332,274,6,0,432,113,0,0,4157
"27135970200",1925,125,5,0,19,35,9,0,2118
"27135970300",3153,364,20,3,109,9,38,7,3703
"27135970400",3089,425,19,0,51,4,32,8,3628
"27135970500",1635,130,0,0,15,0,33,0,1813
"27137000100",3614,392,43,0,68,14,0,0,4131
"27137000200",3943,188,4,10,120,7,21,0,4293
"27137000300",5187,768,17,100,490,373,108,16,7059
"27137000400",2980,1074,0,0,124,25,21,0,4224
"27137000500",2357,575,0,21,279,37,20,0,3289
"27137000600",4297,218,52,0,143,0,10,0,4720
"27137000700",2694,66,22,0,58,7,26,0,2873
"27137000900",2801,712,45,14,48,207,8,45,3880
"27137001000",1400,525,0,2,24,77,28,54,2110
"27137001100",1225,83,19,0,64,8,0,0,1399
"27137001200",703,510,33,119,70,114,32,0,1581
"27137001300",679,779,5,69,114,122,6,0,1774
"27137001400",1222,663,121,100,39,268,47,15,2475
"27137001600",705,572,97,74,95,83,99,11,1736
"27137001700",593,603,36,85,24,116,11,0,1468
"27137001800",927,668,21,26,50,244,10,47,1993
"27137001900",840,479,49,161,55,185,8,11,1788
"27137002000",1002,197,28,0,72,40,0,25,1364
"27137002200",910,66,0,6,4,5,0,5,996
"27137002300",3667,252,12,4,51,27,0,0,4013
"27137002400",682,135,0,0,71,27,7,10,932
"27137002600",1258,560,22,2,100,46,0,9,1997
"27137002900",1521,117,0,0,21,7,0,0,1666
"27137003000",1039,177,9,1,21,8,28,0,1283
"27137003300",1808,618,68,29,87,86,4,0,2700
"27137003400",828,335,17,0,73,15,0,8,1276
"27137003600",1511,154,0,0,22,14,25,4,1730
"27137003700",1216,467,5,14,105,5,25,1,1838
"27137003800",2554,312,3,0,33,37,15,0,2954
"27137010100",2514,107,13,0,71,0,0,0,2705
"27137010200",1458,146,0,0,40,0,3,0,1647
"27137010300",7614,746,32,0,90,58,23,20,8583
"27137010400",3174,271,28,0,36,5,0,0,3514
"27137010500",3402,241,14,0,76,0,67,0,3800
"27137010600",5894,271,5,3,169,47,76,13,6478
"27137011100",6701,328,6,10,217,28,74,0,7364
"27137011200",2164,415,11,25,377,273,24,0,3289
"27137011300",1777,234,2,0,41,13,0,0,2067
"27137011400",2589,220,0,0,18,15,24,0,2866
"27137012100",4055,415,0,0,41,11,13,107,4642
"27137012200",1303,269,0,25,119,16,56,0,1788
"27137012300",2098,247,0,0,15,0,4,0,2364
"27137012400",3220,1104,0,117,31,57,97,11,4637
"27137012500",2234,479,1,0,46,133,38,0,2931
"27137012600",3951,631,34,0,137,147,111,8,5019
"27137012700",1946,220,14,3,114,9,25,13,2344
"27137012800",2547,324,0,0,27,19,10,5,2932
"27137013000",1533,342,5,0,41,45,0,0,1966
"27137013100",1547,770,27,36,158,167,0,13,2718
"27137013200",2982,511,0,0,46,142,30,0,3711
"27137013300",2867,498,30,4,157,34,24,0,3614
"27137013400",2597,242,0,0,106,8,2,33,2988
"27137013500",1684,145,0,0,0,2,7,0,1838
"27137013600",1710,191,0,0,7,42,16,0,1966
"27137013800",1282,263,1,0,11,0,0,1,1558
"27137013900",2033,266,0,0,14,4,0,1,2318
"27137014000",1876,132,2,0,26,0,0,0,2036
"27137014100",1204,162,0,1,26,0,0,0,1393
"27137015100",2545,211,0,0,71,6,0,2,2835
"27137015200",2910,205,3,1,165,27,37,14,3362
"27137015300",2610,589,0,2,13,0,0,0,3214
"27137015400",2699,270,0,1,80,3,31,1,3085
"27137015500",2536,361,0,0,634,193,62,9,3795
"27137015600",1346,584,83,413,292,381,228,10,3337
"27137015700",1193,510,0,0,42,29,31,2,1807
"27137015800",3228,597,11,0,140,42,25,26,4069
"27137990100",0,0,0,0,0,0,0,0,0
"27139080100",1112,296,67,4,468,41,133,27,2148
"27139080201",1974,22,58,0,318,0,20,0,2392
"27139080202",3632,111,136,7,710,15,37,0,4648
"27139080203",5881,141,210,223,953,45,386,14,7853
"27139080204",2475,115,144,26,192,0,201,71,3224
"27139080205",6736,276,421,0,666,0,127,0,8226
"27139080301",7848,335,282,33,2165,273,834,189,11959
"27139080302",10904,401,295,2,2534,496,700,458,15790
"27139080400",2382,534,164,114,679,177,797,320,5167
"27139080500",1632,220,4,51,254,36,49,38,2284
"27139080600",3477,66,242,2,496,109,97,0,4489
"27139080700",2029,150,139,2,182,78,232,106,2918
"27139080800",7454,434,14,0,218,0,87,75,8282
"27139080903",5933,197,173,2,837,47,164,6,7359
"27139080904",6296,253,62,195,422,154,119,0,7501
"27139080905",4654,69,24,0,193,0,62,0,5002
"27139080906",4114,230,92,0,258,9,63,0,4766
"27139081000",7415,218,135,23,150,0,119,0,8060
"27139081100",9828,364,53,3,248,14,68,20,10598
"27139081200",5739,190,4,0,118,6,161,2,6220
"27139081300",7652,280,4,12,169,96,14,0,8227
"27141030101",10299,826,20,0,24,41,0,102,11312
"27141030102",6555,504,0,0,229,0,39,0,7327
"27141030200",7012,200,0,0,161,0,114,0,7487
"27141030300",5631,234,17,13,63,4,26,11,5999
"27141030402",8383,548,125,27,299,0,619,0,10001
"27141030403",8194,485,236,0,310,0,94,0,9319
"27141030404",7837,374,0,0,185,20,124,0,8540
"27141030502",10245,475,72,16,344,38,78,53,11321
"27141030503",5287,343,40,15,343,30,251,0,6309
"27141030504",4280,282,32,0,356,16,27,61,5054
"27141031500",3241,1467,417,488,25,318,101,94,6151
"27143170198",3666,447,1,1,86,33,79,0,4313
"27143170200",2930,474,16,0,79,26,115,195,3835
"27143170300",2782,264,0,0,107,11,320,90,3574
"27143170400",3398,463,2,2,44,27,183,118,4237
"27145000301",2325,560,42,89,148,33,46,0,3243
"27145000302",2789,2791,403,577,525,379,98,49,7611
"27145000401",3356,647,106,724,289,28,68,0,5218
"27145000402",4858,164,0,0,298,21,37,0,5378
"27145000500",5274,796,457,131,299,99,34,102,7192
"27145000601",2292,471,219,436,187,113,88,82,3888
"27145000602",2497,295,66,100,36,5,45,29,3073
"27145000701",2075,294,67,0,198,111,27,0,2772
"27145000801",2708,486,33,28,59,63,20,26,3423
"27145000901",3461,564,282,91,182,66,0,27,4673
"27145001001",6093,797,198,0,624,166,90,35,8003
"27145010101",7314,134,53,0,80,0,199,0,7780
"27145010102",7486,175,74,0,256,0,110,0,8101
"27145010200",5162,285,0,0,178,0,22,0,5647
"27145010401",3546,251,0,0,34,0,50,2,3883
"27145010402",3447,198,0,0,40,7,13,14,3719
"27145010403",2979,130,0,0,4,0,17,0,3130
"27145010500",3255,343,0,1,20,0,18,0,3637
"27145010600",2973,413,19,58,520,58,752,330,5123
"27145010900",3157,326,0,2,23,9,12,12,3541
"27145011000",3413,238,13,0,33,6,54,20,3777
"27145011100",6529,502,19,0,25,4,45,27,7151
"27145011200",5829,382,19,6,93,8,38,5,6380
"27145011301",4514,1385,17,6,119,102,59,134,6336
"27145011302",6272,516,4,0,42,23,195,97,7149
"27145011304",4218,221,17,0,137,135,167,143,5038
"27145011400",4231,271,48,6,76,42,120,0,4794
"27145011500",5348,525,0,0,201,298,148,400,6920
"27145011600",286,358,6,125,10,41,4,10,840
"27147960100",4027,482,0,6,160,18,197,95,4985
"27147960200",5359,407,0,5,75,20,110,0,5976
"27147960300",5182,312,0,478,392,176,699,210,7449
"27147960400",2930,347,154,120,330,159,550,66,4656
"27147960500",2595,108,5,0,68,1,12,0,2789
"27147960600",2691,427,48,0,155,53,119,21,3514
"27147960700",4778,148,0,0,178,8,122,8,5242
"27147960800",3064,415,0,0,1,26,42,163,3711
"27149480100",2141,113,0,11,7,9,27,15,2323
"27149480200",2827,643,6,0,138,113,54,59,3840
"27149480300",2423,379,0,0,161,135,123,52,3273
"27151960100",2106,271,0,0,45,0,142,57,2621
"27151960200",2764,313,48,0,55,3,118,15,3316
"27151960300",1558,55,10,0,20,0,6,2,1651
"27151960400",1879,223,6,26,32,32,14,10,2222
"27153790100",2372,539,6,4,80,19,48,0,3068
"27153790200",2026,514,4,5,77,12,27,10,2675
"27153790300",2379,575,11,3,67,9,73,28,3145
"27153790400",2732,658,10,12,57,34,23,0,3526
"27153790500",2103,327,0,0,26,5,3,0,2464
"27153790600",2678,486,12,0,550,23,884,169,4802
"27153790700",3592,413,2,2,77,3,5,0,4094
"27153790800",1615,182,0,0,29,0,12,0,1838
"27155460100",1864,122,0,2,37,31,27,14,2097
"27155460200",1115,75,0,0,84,75,8,0,1357
"27157490100",2508,251,42,0,32,33,142,5,3013
"27157490200",2925,187,0,0,16,11,4,0,3143
"27157490300",3772,247,0,0,28,0,169,0,4216
"27157490400",3821,288,7,1,66,18,65,6,4272
"27157490500",3180,316,13,34,107,25,71,0,3746
"27157490600",3019,362,0,1,0,2,0,112,3496
"27159480100",2608,553,2,0,37,39,32,0,3271
"27159480200",4823,572,17,37,132,21,73,5,5680
"27159480300",3477,982,0,0,106,78,47,33,4723
"27161790100",2784,343,50,0,96,0,54,17,3344
"27161790200",1954,200,0,0,31,0,81,0,2266
"27161790300",2506,104,18,0,72,0,67,0,2767
"27161790400",5377,345,5,0,284,0,83,0,6094
"27161790500",2976,578,0,73,8,34,129,310,4108
"27163070103",3670,647,60,23,247,25,75,22,4769
"27163070104",2696,374,0,0,91,17,210,0,3388
"27163070105",3720,93,8,0,51,0,0,0,3872
"27163070106",6320,96,0,0,352,1,356,0,7125
"27163070203",6423,292,211,0,439,159,204,159,7887
"27163070204",5386,326,18,0,188,25,47,28,6018
"27163070205",3602,275,20,0,60,0,69,170,4196
"27163070206",3235,128,6,0,118,0,0,0,3487
"27163070301",1583,73,6,0,40,2,46,0,1750
"27163070303",4570,78,42,0,139,2,43,0,4874
"27163070304",4195,316,14,20,65,83,48,19,4760
"27163070403",3843,50,0,2,69,3,45,0,4012
"27163070404",3190,178,42,0,61,20,17,14,3522
"27163070405",4086,163,0,0,112,37,0,0,4398
"27163070406",3234,281,0,0,149,0,66,105,3835
"27163070501",3422,123,0,2,47,0,88,0,3682
"27163070502",3396,452,0,0,79,13,118,0,4058
"27163070601",5796,139,28,297,256,65,92,48,6721
"27163070602",2331,269,21,13,88,39,75,54,2890
"27163070701",5852,187,42,0,303,0,78,0,6462
"27163070703",2437,193,0,79,212,25,14,0,2960
"27163070704",2720,191,0,3,21,4,5,0,2944
"27163070801",0,0,0,0,0,0,0,0,0
"27163070802",0,0,0,0,0,0,0,0,0
"27163070906",4059,104,232,10,155,127,150,0,4837
"27163070907",4077,351,226,86,319,204,79,0,5342
"27163070909",4355,143,374,17,842,9,84,25,5849
"27163070910",3601,370,231,134,654,134,526,113,5763
"27163070911",3355,208,188,44,463,57,188,9,4512
"27163070912",2014,155,273,111,469,73,59,19,3173
"27163071001",3179,307,218,74,779,0,166,85,4808
"27163071003",2610,339,35,120,316,10,136,16,3582
"27163071006",3115,154,270,188,662,45,245,30,4709
"27163071010",4214,76,284,0,674,8,277,0,5533
"27163071011",2835,58,47,0,106,1,133,10,3190
"27163071012",3870,118,649,78,626,0,321,10,5672
"27163071013",3909,92,104,8,510,12,136,18,4789
"27163071014",3444,49,178,0,587,9,241,0,4508
"27163071015",5258,107,211,0,828,0,339,0,6743
"27163071016",3703,22,94,0,642,0,184,8,4653
"27163071017",4618,175,298,65,1148,22,36,22,6384
"27163071018",11398,371,747,0,1752,50,395,0,14713
"27163071101",3244,194,26,0,75,0,33,16,3588
"27163071102",4199,128,14,1,220,0,214,1,4777
"27163071206",7452,472,409,55,1043,329,504,97,10361
"27163071207",6649,61,148,231,186,0,185,0,7460
"27163071208",3915,208,187,0,452,204,158,0,5124
"27163071209",5455,261,82,0,322,168,34,55,6377
"27163071300",4415,373,120,0,313,61,165,24,5471
"27163071400",5668,143,39,0,950,0,474,0,7274
"27165950100",2952,266,0,3,273,7,571,59,4131
"27165950200",3538,618,72,0,259,70,1273,342,6172
"27165950300",2585,209,6,0,133,19,106,36,3094
"27167950100",2830,207,7,0,53,11,84,23,3215
"27167950200",2811,361,0,9,92,0,34,0,3307
"27169670100",6563,478,14,3,323,34,164,0,7579
"27169670200",2927,324,0,0,38,7,121,34,3451
"27169670300",3746,449,146,46,188,0,0,0,4575
"27169670400",3480,622,0,4,99,2,21,0,4228
"27169670500",1899,2085,0,0,49,69,0,0,4102
"27169670600",2672,610,58,46,199,57,37,0,3679
"27169670700",3103,457,14,92,17,21,0,39,3743
"27169670800",6820,468,49,0,156,0,67,0,7560
"27169670900",3279,253,16,40,51,2,100,23,3764
"27169671000",3627,869,13,0,536,49,345,248,5687
"27171100100",11754,371,243,0,764,19,133,0,13284
"27171100202",1280,58,0,0,29,0,0,0,1367
"27171100203",4768,429,47,0,227,0,73,5,5549
"27171100204",7792,617,34,0,618,0,557,62,9680
"27171100300",4813,385,43,0,37,3,125,0,5406
"27171100400",4326,314,80,49,32,17,28,9,4855
"27171100500",4125,527,0,2,11,4,25,19,4713
"27171100701",4998,829,0,0,208,46,75,130,6286
"27171100702",6830,653,8,96,237,38,222,76,8160
"27171100703",8282,400,2,0,55,0,98,2,8839
"27171100801",10613,276,267,164,1422,0,252,0,12994
"27171100802",13151,294,39,0,339,0,96,0,13919
"27171100900",6421,546,64,31,245,3,134,3,7447
"27171101000",7745,354,0,0,167,4,62,0,8332
"27171101100",6389,536,9,2,660,79,588,78,8341
"27171101200",3455,426,0,0,186,9,185,0,4261
"27171101300",4190,371,16,8,52,175,22,126,4960
"27173970100",2675,216,3,2,314,68,63,19,3360
"27173970200",1902,414,0,0,17,18,6,93,2450
"27173970300",2164,189,5,0,24,40,15,37,2474
"27173970400",1660,175,0,3,81,108,90,61,2178
"28001000100",3365,328,1048,938,21,13,0,0,5713
"28001000200",539,81,2493,1095,0,0,20,34,4262
"28001000300",17,0,1397,889,0,0,0,0,2303
"28001000400",17,238,1310,1914,0,0,0,0,3479
"28001000500",1231,225,1951,606,28,18,27,0,4086
"28001000600",1170,84,502,199,30,0,0,0,1985
"28001000700",832,81,380,322,63,0,2,25,1705
"28001000800",858,186,1620,908,0,79,0,0,3651
"28001000900",2796,308,275,226,76,0,61,0,3742
"28003950100",4613,932,89,90,77,12,18,110,5941
"28003950200",4908,703,989,390,358,38,407,0,7793
"28003950300",2066,889,163,21,164,66,246,49,3664
"28003950400",4572,895,0,0,65,0,0,0,5532
"28003950500",2854,1467,1033,763,99,96,149,21,6482
"28003950600",3327,554,0,0,72,4,0,1,3958
"28003950700",2977,596,408,36,0,0,8,0,4025
"28005950100",2298,330,793,771,7,3,9,3,4214
"28005950200",2177,469,875,621,8,0,0,0,4150
"28005950300",1680,474,1761,660,50,3,36,0,4664
"28007060100",1897,285,406,337,0,0,0,0,2925
"28007060200",1499,257,274,281,0,0,7,0,2318
"28007060300",1217,114,1124,638,126,0,126,25,3370
"28007060400",1909,303,893,287,12,0,74,0,3478
"28007060500",1380,384,1143,621,133,32,80,14,3787
"28007060600",963,360,810,1322,0,62,16,0,3533
"28009950100",2575,334,1693,975,233,77,125,0,6012
"28009950200",1811,520,213,170,5,0,36,0,2755
"28011950100",556,67,1304,1694,1,45,0,45,3712
"28011950200",294,71,1438,1173,13,10,7,0,3006
"28011950300",331,43,1966,944,0,74,0,50,3408
"28011950400",837,186,1636,1574,3,72,0,72,4380
"28011950500",2195,218,1351,996,89,344,25,319,5537
"28011950600",4537,454,169,0,157,37,91,0,5445
"28011950701",285,53,2258,1812,47,0,59,0,4514
"28011950702",196,106,1547,1105,0,16,0,0,2970
"28013950100",3013,606,507,246,80,0,45,105,4602
"28013950200",635,95,465,276,0,0,0,0,1471
"28013950300",1815,294,702,127,0,0,8,2,2948
"28013950400",1838,759,358,166,111,18,264,199,3713
"28013950500",1015,332,667,561,0,0,123,60,2758
"28015950100",2613,657,487,375,108,13,0,32,4285
"28015950200",3110,358,1314,1057,75,26,0,0,5940
"28017950100",1218,345,1548,951,41,6,100,13,4222
"28017950200",2084,428,1040,273,0,55,52,0,3932
"28017950300",1858,441,885,640,135,75,284,101,4419
"28017950400",2896,213,1020,887,29,0,86,0,5131
"28019950100",1675,520,231,106,0,0,0,0,2532
"28019950200",2197,208,867,615,31,14,28,0,3960
"28019950300",893,144,409,400,6,0,0,0,1852
"28021950100",585,38,1869,723,122,0,10,0,3347
"28021950200",130,18,877,765,3,19,0,15,1827
"28021950300",363,59,2126,1386,0,0,26,30,3990
"28023950100",3249,458,651,213,19,0,12,0,4602
"28023950200",3291,876,981,435,0,0,7,67,5657
"28023950300",1010,135,1375,1143,25,0,21,0,3709
"28023950400",1367,199,648,398,23,0,3,0,2638
"28025950100",2209,187,1903,741,53,0,33,0,5126
"28025950200",904,104,896,587,6,9,0,0,2506
"28025950300",760,113,1545,1364,13,0,13,0,3808
"28025950400",1711,230,1494,1226,30,47,48,17,4803
"28025950500",1806,25,1432,642,150,84,13,0,4152
"28027950100",660,65,1589,1429,5,5,14,0,3767
"28027950200",1291,155,597,208,6,10,33,0,2300
"28027950300",910,91,1233,1131,30,5,30,0,3430
"28027950400",1391,93,1563,1037,68,0,54,0,4206
"28027950500",827,117,2098,2044,27,16,0,0,5129
"28027950600",22,0,661,563,0,23,0,0,1269
"28027950700",18,30,2631,2605,0,34,0,0,5318
"28029950100",2065,365,2268,1049,196,196,167,224,6530
"28029950200",2267,470,1267,672,19,36,0,167,4898
"28029950300",1756,79,1525,721,47,0,0,0,4128
"28029950400",654,198,2113,1659,45,9,11,97,4786
"28029950500",3417,466,964,602,215,0,28,72,5764
"28029950600",1175,169,910,760,0,0,25,0,3039
"28031950100",1851,281,1347,1673,0,26,59,0,5237
"28031950200",708,34,736,408,7,16,0,0,1909
"28031950300",2305,504,1191,1043,122,34,68,32,5299
"28031950400",4827,1471,352,251,0,0,52,0,6953
"28033070101",1867,102,495,287,45,194,175,172,3337
"28033070102",2795,106,788,57,375,0,28,18,4167
"28033070210",3050,714,1710,113,532,44,228,273,6664
"28033070221",2386,178,864,100,208,29,0,45,3810
"28033070222",2678,199,1013,129,146,0,297,0,4462
"28033070310",2259,319,923,7,233,42,166,170,4119
"28033070322",2167,340,827,133,218,48,75,0,3808
"28033070323",2249,165,2617,476,345,51,763,8,6674
"28033070324",2398,471,1617,296,379,83,309,91,5644
"28033070325",1774,512,369,30,127,161,149,261,3383
"28033070411",1267,50,292,167,53,0,3,0,1832
"28033070412",2346,325,945,501,221,197,213,40,4788
"28033070421",1954,118,126,0,295,108,25,121,2747
"28033070422",1870,174,123,228,154,0,86,0,2635
"28033070520",6820,268,2279,91,406,58,372,0,10294
"28033070521",1921,547,141,81,431,158,308,152,3739
"28033070522",2768,306,766,0,185,7,94,199,4325
"28033070610",1205,235,984,274,435,0,19,10,3162
"28033070620",5458,173,930,555,309,0,82,0,7507
"28033070630",7739,265,1116,195,566,18,120,0,10019
"28033070710",4299,273,1363,331,121,12,99,0,6498
"28033070721",2927,212,796,169,55,0,22,0,4181
"28033070722",4073,126,225,0,175,0,118,0,4717
"28033070811",2950,205,1372,316,553,15,247,9,5667
"28033070812",3961,252,1091,154,174,74,667,89,6462
"28033070821",3860,357,447,16,404,16,80,31,5211
"28033070822",3002,151,900,92,387,0,478,0,5010
"28033070830",4102,126,932,21,438,17,609,17,6262
"28033070900",2990,87,785,141,118,10,43,0,4174
"28033071000",7823,277,370,0,279,0,62,0,8811
"28033071110",6077,423,61,12,225,64,87,83,7032
"28033071120",4255,351,801,558,35,0,49,185,6234
"28033071200",2392,447,333,87,82,16,14,16,3387
"28035000200",1188,278,479,180,12,2,9,0,2148
"28035000300",919,218,1642,676,22,44,170,59,3750
"28035000500",373,241,545,407,16,32,107,267,1988
"28035000600",60,147,3406,2971,11,17,0,29,6641
"28035000700",1937,418,528,198,39,15,21,147,3303
"28035000800",3197,787,696,549,15,11,23,21,5299
"28035000900",296,386,178,483,79,69,7,10,1508
"28035001000",1129,1174,1024,1030,169,187,166,54,4933
"28035001100",620,252,1485,1030,209,21,10,124,3751
"28035010101",4340,481,566,67,151,0,165,43,5813
"28035010102",5295,535,368,1,85,0,0,0,6284
"28035010200",2930,733,2214,729,109,26,98,0,6839
"28035010300",2609,372,337,67,420,74,337,94,4310
"28035010400",2389,581,326,91,396,121,275,129,4308
"28035010500",972,172,1256,789,35,0,48,0,3272
"28035010600",5827,2038,45,178,33,37,51,0,8209
"28035010700",59,165,838,778,96,0,65,0,2001
"28037950100",3171,680,779,644,24,0,9,0,5307
"28037950200",1027,183,1056,316,41,0,0,0,2623
"28039950101",4875,669,60,22,88,259,16,283,6272
"28039950102",3299,808,278,35,163,0,154,10,4747
"28039950200",1395,166,209,357,34,64,0,0,2225
"28039950301",4761,1414,249,53,33,31,6,0,6547
"28039950302",2256,194,228,37,17,0,0,0,2732
"28041950100",3364,905,404,94,18,7,25,7,4824
"28041950200",4138,919,1138,106,180,23,0,0,6504
"28043950100",2757,438,2149,313,64,0,4,0,5725
"28043950200",3627,483,970,312,34,0,0,0,5426
"28043950300",616,44,1096,1236,37,0,0,0,3029
"28043950400",228,206,1196,573,0,8,0,0,2211
"28043950500",3260,368,605,627,62,69,0,0,4991
"28045030100",3766,553,311,264,110,24,0,3,5031
"28045030200",3590,1033,686,164,163,28,169,1,5834
"28045030300",5823,1990,737,55,296,139,252,26,9318
"28045030400",1095,256,663,185,14,12,61,12,2298
"28045030500",7590,715,16,3,409,0,273,178,9184
"28045030601",5557,1529,0,6,204,0,120,0,7416
"28045030602",4274,1073,154,18,428,208,422,0,6577
"28045990000",0,0,0,0,0,0,0,0,0
"28047000100",151,54,0,22,40,74,0,0,341
"28047000300",330,167,592,624,167,124,183,136,2323
"28047000600",1083,212,61,18,13,56,13,0,1456
"28047000900",314,87,73,0,10,34,0,0,518
"28047001201",2727,567,416,151,481,207,180,170,4899
"28047001202",3773,548,678,818,423,17,327,159,6743
"28047001300",1769,250,562,220,248,17,348,8,3422
"28047001400",996,222,104,181,5,22,88,0,1618
"28047001501",2546,306,525,242,59,0,195,0,3873
"28047001502",2797,476,375,245,483,169,365,126,5036
"28047001600",2919,142,39,0,81,0,96,0,3277
"28047001700",2938,794,1156,388,173,113,302,98,5962
"28047001800",292,128,1246,1248,9,0,112,29,3064
"28047001900",1418,440,426,356,0,0,37,251,2928
"28047002000",1183,605,984,490,15,27,132,70,3506
"28047002300",362,405,1083,535,7,57,20,0,2469
"28047002400",484,258,1586,1671,16,87,133,22,4257
"28047002500",1008,226,86,0,35,0,182,44,1581
"28047002600",648,61,1347,858,17,32,19,0,2982
"28047002700",4590,355,191,270,194,116,123,50,5889
"28047002800",1782,349,18,0,67,24,60,85,2385
"28047002900",1082,20,35,30,22,16,52,9,1266
"28047003000",1670,210,845,385,332,32,0,0,3474
"28047003101",4940,677,657,739,341,0,122,113,7589
"28047003102",5263,773,730,111,250,51,285,0,7463
"28047003204",1636,419,910,309,131,35,342,119,3901
"28047003205",4218,334,1918,109,84,0,205,0,6868
"28047003206",5600,609,987,642,525,42,160,127,8692
"28047003207",2394,494,1270,929,217,120,62,58,5544
"28047003208",1307,332,1034,709,157,157,212,210,4118
"28047003301",5064,1048,1056,160,1018,62,640,45,9093
"28047003303",3293,375,1142,192,395,362,191,101,6051
"28047003304",3147,176,727,57,306,100,256,0,4769
"28047003402",8621,931,818,85,1145,453,207,0,12260
"28047003403",1948,160,0,0,42,0,46,33,2229
"28047003404",3892,792,65,174,179,26,25,0,5153
"28047003501",6751,1055,380,116,301,153,136,0,8892
"28047003502",4186,906,114,54,230,25,113,0,5628
"28047003504",4365,843,660,255,268,0,98,0,6489
"28047003505",3940,785,1271,278,374,32,266,13,6959
"28047003600",248,169,239,108,161,144,80,90,1239
"28047003700",1678,470,277,401,140,114,162,129,3371
"28047003800",681,148,65,90,37,0,138,80,1239
"28047003900",1606,500,460,402,242,194,200,181,3785
"28047980000",0,0,0,0,0,0,0,0,0
"28047990000",0,0,0,0,0,0,0,0,0
"28049000100",3049,130,1370,186,165,0,39,0,4939
"28049000200",3676,260,566,560,65,0,48,0,5175
"28049000301",78,70,1299,1437,0,0,0,0,2884
"28049000302",184,257,2404,735,34,25,0,137,3776
"28049000400",1030,249,1642,459,78,17,11,12,3498
"28049000500",0,15,3996,1863,17,23,0,0,5914
"28049000600",0,0,1982,1556,0,0,0,0,3538
"28049000700",323,57,3664,1831,38,30,0,0,5943
"28049000800",0,27,2108,1789,0,0,4,0,3928
"28049000900",1,1,1054,727,4,0,0,0,1787
"28049001000",0,0,934,769,29,0,47,0,1779
"28049001100",50,0,1020,709,0,0,0,0,1779
"28049001200",1,9,1162,701,0,0,0,9,1882
"28049001300",2092,331,639,491,0,13,66,0,3632
"28049001400",2355,169,8,69,23,0,46,0,2670
"28049001500",2479,359,258,29,124,11,73,0,3333
"28049001600",799,235,1614,505,34,67,20,13,3287
"28049001900",59,0,978,830,8,0,0,0,1875
"28049002000",5,2,509,437,0,0,0,0,953
"28049002100",38,7,1691,1724,0,0,0,0,3460
"28049002200",52,50,1163,724,0,9,0,0,1998
"28049002300",108,13,1127,1150,0,0,0,0,2398
"28049002400",8,0,2910,1168,32,0,0,0,4118
"28049002500",43,9,1679,734,24,1,0,3,2493
"28049002700",190,83,387,241,5,2,0,2,910
"28049003000",195,102,687,743,0,5,40,13,1785
"28049003200",11,3,539,624,0,0,0,0,1177
"28049003300",425,90,3468,2608,48,90,24,25,6778
"28049003400",156,230,1742,1498,0,11,0,94,3731
"28049003500",193,82,1637,2354,22,56,0,17,4361
"28049003600",442,0,2497,1468,116,0,25,0,4548
"28049003700",417,211,1929,845,13,0,0,0,3415
"28049003800",552,150,1450,1084,47,22,106,0,3411
"28049010101",1993,90,3399,584,480,144,581,125,7396
"28049010102",1306,224,2290,1038,45,370,26,596,5895
"28049010201",23,20,1944,799,66,0,66,0,2918
"28049010202",236,2,5041,964,67,0,99,0,6409
"28049010203",70,29,1839,899,9,0,0,0,2846
"28049010301",0,4,2321,846,0,0,0,0,3171
"28049010304",2878,207,2454,219,465,0,153,0,6376
"28049010305",1494,221,1327,315,136,12,82,0,3587
"28049010400",2078,378,790,370,14,141,0,65,3836
"28049010500",2889,544,3054,1094,69,33,0,0,7683
"28049010600",893,167,3367,958,55,20,71,0,5531
"28049010700",3386,332,1223,502,26,0,0,0,5469
"28049010801",68,18,706,751,95,20,80,33,1771
"28049010804",440,230,478,43,129,169,106,30,1625
"28049010805",2278,46,863,164,179,75,63,6,3674
"28049010806",2222,164,561,41,351,53,77,9,3478
"28049010807",2923,62,828,0,68,0,9,9,3899
"28049010808",348,0,3356,815,72,12,0,0,4603
"28049010809",263,37,2301,167,0,0,0,0,2768
"28049010901",128,37,1738,675,0,0,0,0,2578
"28049010902",77,21,1133,340,37,20,37,20,1685
"28049011001",638,272,3019,1938,0,0,30,0,5897
"28049011002",428,54,2730,1048,9,0,0,0,4269
"28049011101",344,113,1805,327,68,0,68,0,2725
"28049011102",3102,140,6108,827,204,0,23,0,10404
"28049011103",2143,207,3211,372,0,0,0,0,5933
"28049011201",1919,0,439,337,18,0,0,0,2713
"28049011202",4024,653,3033,175,137,17,14,11,8064
"28049011300",1671,89,1773,692,34,24,71,24,4378
"28049011400",0,19,775,413,0,2,0,44,1253
"28049011500",0,0,706,748,0,0,0,0,1454
"28051950100",722,160,1676,1450,6,38,0,0,4052
"28051950200",499,161,1769,1488,137,4,0,0,4058
"28051950300",114,35,1076,1542,0,6,0,0,2773
"28051950400",473,94,904,780,0,0,0,0,2251
"28051950500",378,69,2575,2134,0,0,0,19,5175
"28053950100",483,45,850,1537,98,0,99,0,3112
"28053950200",781,119,505,380,18,6,5,10,1824
"28053950300",563,57,1687,1935,30,0,75,25,4372
"28055950100",308,31,435,326,0,1,0,1,1102
"28057950100",3594,767,121,53,56,36,26,0,4653
"28057950200",5644,650,183,6,44,0,182,0,6709
"28057950300",1841,375,132,102,11,0,29,0,2490
"28057950400",4229,576,34,18,43,44,5,27,4976
"28057950500",2622,686,330,194,13,0,39,0,3884
"28059040101",5853,470,536,7,34,7,11,7,6925
"28059040102",6018,773,37,3,115,0,0,0,6946
"28059040201",7461,602,182,103,206,20,124,0,8698
"28059040203",3444,410,43,121,328,54,22,15,4437
"28059040204",5282,1204,459,0,300,183,0,169,7597
"28059040300",4389,822,970,298,1019,140,129,99,7866
"28059040400",5927,774,1016,207,415,85,214,154,8792
"28059040500",2912,358,105,36,200,19,83,0,3713
"28059040600",4731,168,590,55,183,0,359,0,6086
"28059040700",6437,985,694,42,329,0,510,0,8997
"28059040800",3526,631,877,658,345,57,433,57,6584
"28059040900",8676,635,646,563,662,135,567,129,12013
"28059041000",2711,278,1102,463,520,0,615,33,5722
"28059041100",3776,696,1594,837,164,0,397,356,7820
"28059041300",3993,714,843,298,71,206,51,150,6326
"28059041400",1517,82,1371,140,70,0,41,0,3221
"28059041500",345,29,682,234,15,0,15,0,1320
"28059041600",233,64,1653,748,15,0,0,0,2713
"28059041700",15,23,1782,399,0,13,0,1,2233
"28059041800",67,68,2013,445,0,0,0,0,2593
"28059041900",1293,217,456,316,50,0,31,8,2371
"28059042000",1721,353,1687,731,408,9,644,0,5553
"28059042100",1149,587,617,718,112,18,279,126,3606
"28059042200",1703,711,548,710,232,108,150,210,4372
"28059042500",1659,100,114,174,20,5,218,5,2295
"28059042600",2461,15,230,168,38,43,97,43,3095
"28059042700",689,211,14,76,0,0,0,0,990
"28059042900",1333,146,407,228,41,0,155,35,2345
"28059990000",0,0,0,0,0,0,0,0,0
"28061950100",2091,308,1542,541,6,5,24,11,4528
"28061950200",560,132,896,733,49,3,0,0,2373
"28061950300",2968,511,1162,224,0,2,0,1,4868
"28061950400",1029,214,2688,903,44,112,17,135,5142
"28063950100",886,18,2630,2152,0,2,0,0,5688
"28063950200",0,0,780,695,4,0,0,0,1479
"28065950100",1463,304,2498,1007,31,0,23,0,5326
"28065950201",1025,256,1393,633,11,0,25,0,3343
"28065950202",1453,185,910,739,0,121,0,0,3408
"28067950100",4191,576,1070,563,69,20,87,0,6576
"28067950200",3951,141,935,633,53,0,0,0,5713
"28067950301",3347,691,516,238,57,0,0,0,4849
"28067950302",3007,265,0,0,0,0,218,0,3490
"28067950401",2521,211,273,20,0,61,0,0,3086
"28067950402",1716,579,1748,570,41,0,25,103,4782
"28067950500",1929,312,877,1055,718,199,1243,225,6558
"28067950600",1275,501,2392,2493,133,107,192,129,7222
"28067950700",904,141,1410,781,0,0,0,0,3236
"28067950800",4033,639,188,270,391,33,25,175,5754
"28067950900",5261,2157,307,146,33,25,135,256,8320
"28067951000",1457,392,781,524,6,16,0,0,3176
"28067951100",5225,647,492,299,0,2,246,0,6911
"28067980000",0,0,0,0,0,0,0,0,0
"28069030100",1342,331,1628,1907,9,0,24,0,5241
"28069030200",1595,151,1633,479,158,310,173,0,4499
"28071950100",2679,73,1250,757,119,0,49,0,4927
"28071950201",2152,435,452,457,19,0,0,0,3515
"28071950202",1859,1432,636,188,29,14,0,0,4158
"28071950301",240,636,98,456,62,122,81,118,1813
"28071950302",1750,526,427,415,355,55,232,7,3767
"28071950401",4029,795,1802,510,53,30,84,32,7335
"28071950402",1821,775,1033,305,17,3,21,22,3997
"28071950501",5236,182,357,12,192,0,40,0,6019
"28071950502",1523,269,366,8,18,6,0,0,2190
"28071950503",2546,1693,1248,353,131,656,35,260,6922
"28073020100",5773,577,437,100,110,119,48,119,7283
"28073020201",5371,486,348,470,110,314,69,262,7430
"28073020202",6983,245,540,55,167,0,77,0,8067
"28073020301",4475,806,2275,273,230,40,231,10,8340
"28073020302",3275,1791,2213,1850,432,34,29,109,9733
"28073020400",4893,426,470,201,118,36,130,51,6325
"28073020500",5317,847,269,23,61,27,92,0,6636
"28073020600",1678,270,809,772,24,29,49,0,3631
"28075000200",281,95,1672,984,63,114,146,34,3389
"28075000300",492,86,1038,778,4,13,6,0,2417
"28075000400",124,260,1831,3166,136,424,0,2,5943
"28075000600",53,24,993,980,31,9,2,1,2093
"28075000700",530,388,1611,1203,17,43,6,7,3805
"28075000800",155,174,803,476,0,0,0,1,1609
"28075000900",1119,307,2593,1142,0,73,8,0,5242
"28075001000",2179,260,1008,450,27,6,218,5,4153
"28075001101",2156,120,443,448,13,1,40,1,3222
"28075001102",2311,331,1420,82,163,9,39,0,4355
"28075010201",2954,314,1522,1004,120,0,59,0,5973
"28075010202",4023,416,1384,499,133,5,203,0,6663
"28075010301",4373,583,859,0,30,0,0,13,5858
"28075010302",4573,687,612,172,189,33,143,33,6442
"28075010400",1145,208,129,77,106,8,64,0,1737
"28075010500",4746,621,337,64,43,0,63,0,5874
"28075010600",5369,516,1002,277,219,23,220,0,7626
"28075010700",225,85,468,317,0,0,0,0,1095
"28075980000",58,6,0,6,0,0,28,0,98
"28077960100",2007,393,1322,575,43,0,68,0,4408
"28077960200",2709,181,1173,839,54,0,23,11,4990
"28077960300",2723,345,189,32,27,0,0,0,3316
"28079040100",2461,284,731,158,166,0,180,20,4000
"28079040400",3534,227,929,823,587,213,0,14,6327
"28079040500",2119,263,671,166,6,0,137,0,3362
"28079040600",1859,515,972,1655,317,220,308,343,6189
"28079040700",668,106,1125,1537,0,4,0,0,3440
"28081950101",3737,331,410,88,117,45,2,0,4730
"28081950102",2500,298,929,223,8,0,0,36,3994
"28081950201",6170,637,669,13,76,0,84,38,7687
"28081950202",5668,426,92,38,60,73,87,0,6444
"28081950301",4045,716,20,71,47,52,161,0,5112
"28081950302",2176,391,485,186,73,0,0,0,3311
"28081950401",1526,237,1166,1321,0,53,0,0,4303
"28081950402",4841,126,408,88,171,80,11,0,5725
"28081950500",3135,349,915,680,49,0,42,0,5170
"28081950601",2539,294,693,313,39,95,6,53,4032
"28081950602",1752,257,1158,218,274,0,235,0,3894
"28081950700",1243,236,1189,831,26,84,26,224,3859
"28081950800",1395,143,716,841,154,0,125,144,3518
"28081950901",1713,77,381,600,0,35,47,0,2853
"28081950902",2046,441,1840,862,357,0,217,301,6064
"28081951001",2100,398,838,400,0,7,72,0,3815
"28081951002",802,430,1624,1125,46,99,23,96,4245
"28081951100",3921,536,1089,285,130,8,0,5,5974
"28081980000",0,0,0,0,0,0,0,0,0
"28083950100",400,50,419,297,0,0,0,0,1166
"28083950200",750,100,941,1211,9,7,0,0,3018
"28083950300",674,36,1960,1737,152,0,0,0,4559
"28083950400",791,133,2271,1907,54,0,47,110,5313
"28083950600",3810,292,334,545,76,103,217,44,5421
"28083950700",287,162,1120,687,0,131,0,131,2518
"28083950800",169,0,1847,2022,20,73,147,13,4291
"28083950900",32,48,1914,2649,0,7,0,0,4650
"28085950100",2217,249,1244,370,0,0,43,0,4123
"28085950200",4103,443,476,427,0,0,63,0,5512
"28085950300",4725,1058,687,199,108,0,17,33,6827
"28085950400",5520,951,903,144,84,0,19,116,7737
"28085950500",1010,444,1200,1789,12,0,49,0,4504
"28085950600",2669,180,1213,1799,45,0,33,0,5939
"28087000101",5032,657,553,98,26,1,61,1,6429
"28087000102",1242,258,701,327,133,47,0,59,2767
"28087000200",967,19,127,0,142,73,41,54,1423
"28087000300",5463,593,1728,289,116,12,66,89,8356
"28087000401",4059,481,1110,1085,12,0,42,0,6789
"28087000403",1985,151,1558,508,7,0,7,0,4216
"28087000404",3293,292,368,239,0,0,131,0,4323
"28087000500",978,309,1876,670,33,74,51,74,4065
"28087000600",519,180,1325,1451,0,0,0,0,3475
"28087000700",1032,260,979,1995,12,5,49,0,4332
"28087000800",82,146,1231,1859,8,0,45,120,3491
"28087000900",1501,383,1835,1189,261,55,45,3,5272
"28087001000",1309,130,607,289,27,1,8,3,2374
"28087001100",218,12,928,639,27,6,0,0,1830
"28089030101",5879,303,688,140,164,24,40,0,7238
"28089030104",1815,141,476,13,227,8,0,0,2680
"28089030105",1307,154,728,252,143,0,272,34,2890
"28089030106",1785,299,2100,425,188,208,72,173,5250
"28089030107",2006,174,288,23,26,62,3,0,2582
"28089030108",1427,185,2932,221,671,67,614,0,6117
"28089030201",6243,297,1232,87,60,0,39,0,7958
"28089030202",3941,50,556,45,263,0,19,0,4874
"28089030203",2370,133,282,0,120,0,7,0,2912
"28089030204",3056,99,417,156,297,66,88,0,4179
"28089030205",1699,84,422,10,83,11,0,0,2309
"28089030206",1486,37,219,42,112,7,19,0,1922
"28089030301",4412,66,540,0,246,9,0,0,5273
"28089030302",2968,177,1859,1120,79,0,49,7,6259
"28089030400",8362,177,3754,292,347,23,382,0,13337
"28089030500",4,170,3246,2869,134,413,101,507,7444
"28089030600",315,51,1672,1161,73,0,73,0,3345
"28089030700",224,77,334,260,148,24,140,29,1236
"28089030800",722,53,926,161,44,34,20,0,1960
"28089030900",1794,135,3770,740,30,0,42,0,6511
"28089031000",230,81,1500,268,0,0,6,0,2085
"28091950100",3660,1218,597,511,79,59,0,0,6124
"28091950200",1601,427,773,388,0,0,9,11,3209
"28091950300",966,603,1025,663,8,0,54,0,3319
"28091950400",2137,572,376,404,31,0,38,0,3558
"28091950500",1801,472,1768,975,27,77,0,236,5356
"28091950600",3177,597,414,278,22,7,0,0,4495
"28093950100",3615,624,2082,352,47,10,0,32,6762
"28093950200",4407,901,2069,855,241,47,372,17,8909
"28093950300",2956,263,2220,728,53,303,53,303,6879
"28093950401",337,17,1426,1287,18,25,0,25,3135
"28093950402",480,24,1876,654,0,9,0,3,3046
"28093950500",3088,903,2049,491,101,246,30,315,7223
"28095950100",5210,350,137,24,33,2,100,0,5856
"28095950200",4339,488,1124,966,52,23,55,0,7047
"28095950300",2501,590,179,203,10,0,13,0,3496
"28095950400",1431,128,992,859,4,12,0,10,3436
"28095950501",2696,431,157,119,7,20,0,20,3450
"28095950502",2810,359,266,57,29,0,0,30,3551
"28095950600",1717,102,1251,669,0,73,82,0,3894
"28095950700",802,131,907,677,5,9,0,28,2559
"28095950800",454,124,1213,1396,10,0,22,0,3219
"28097950100",1434,155,537,721,0,0,0,0,2847
"28097950200",1448,275,590,334,0,0,0,0,2647
"28097950300",1886,401,1422,1420,0,0,0,0,5129
"28099010100",3673,626,725,136,463,112,63,0,5798
"28099010200",1997,456,317,160,79,0,93,132,3234
"28099010400",1050,117,1550,931,99,116,45,24,3932
"28099010500",1420,105,431,677,39,18,0,0,2690
"28099010600",3351,732,28,114,628,161,0,60,5074
"28099010700",2712,783,551,377,101,197,20,0,4741
"28099940100",278,181,140,0,2410,993,60,15,4077
"28101050100",2666,200,221,0,0,0,0,0,3087
"28101050200",2599,338,440,433,22,23,28,0,3883
"28101050300",2823,288,798,516,659,456,77,0,5617
"28101050400",2798,388,1404,442,43,0,84,2,5161
"28101050500",1005,247,1481,577,108,0,116,0,3534
"28103950100",1372,202,2444,1665,33,0,9,49,5774
"28103950200",959,38,1371,1182,0,0,5,0,3555
"28103950300",363,50,757,720,4,0,16,0,1910
"28105950100",2576,1858,1578,1279,79,416,14,51,7851
"28105950200",3225,1241,1099,959,371,0,0,0,6895
"28105950300",832,77,1503,916,134,0,33,0,3495
"28105950400",1641,1683,697,676,328,76,25,25,5151
"28105950500",1618,720,881,465,71,24,28,13,3820
"28105950601",2148,639,177,216,64,115,29,90,3478
"28105950602",2146,666,1495,783,221,0,230,0,5541
"28105950700",3578,705,2559,1302,75,0,117,14,8350
"28107950100",1879,209,4207,1595,68,26,57,0,8041
"28107950200",622,70,970,934,9,5,0,0,2610
"28107950300",2752,278,953,1225,0,0,0,0,5208
"28107950400",3534,504,948,443,97,0,77,0,5603
"28107950500",3087,405,1777,888,24,9,4,9,6203
"28107950600",2926,412,1792,1682,0,0,24,0,6836
"28109950100",4245,1538,115,0,72,30,115,61,6176
"28109950200",3744,854,615,451,71,40,119,39,5933
"28109950300",1607,239,210,302,182,71,24,15,2650
"28109950401",4647,1351,419,221,160,0,92,109,6999
"28109950402",3895,1534,91,417,0,0,43,0,5980
"28109950501",6268,964,285,2,93,72,376,0,8060
"28109950502",6271,637,422,44,231,96,321,0,8022
"28109950600",2900,472,436,118,160,40,66,40,4232
"28109950700",3476,1532,1530,1028,198,0,76,157,7997
"28111950101",3097,420,458,195,22,0,0,0,4192
"28111950102",2505,645,538,190,72,16,0,0,3966
"28111950200",2318,379,524,689,18,0,0,0,3928
"28113950101",3172,425,960,330,77,16,13,0,4993
"28113950102",3222,587,171,383,31,7,0,0,4401
"28113950200",1894,477,1590,1037,6,61,80,14,5159
"28113950300",188,62,2501,1999,149,78,67,94,5138
"28113950400",1405,215,753,410,160,0,0,0,2943
"28113950500",1810,281,3749,839,89,2,22,176,6968
"28113950600",1726,582,1961,1952,16,4,0,15,6256
"28113950700",1629,481,1178,580,3,2,28,1,3902
"28115950101",2784,467,1211,225,39,0,20,0,4746
"28115950102",4073,496,429,53,243,31,175,28,5528
"28115950200",4200,472,157,30,345,53,410,133,5800
"28115950300",2722,380,548,318,943,269,796,240,6216
"28115950400",3184,501,708,6,33,0,0,0,4432
"28115950500",3778,678,305,192,24,0,7,11,4995
"28117950100",4624,1028,83,0,12,60,0,38,5845
"28117950200",4572,1119,232,64,160,4,122,50,6323
"28117950300",2800,1376,905,470,32,134,0,32,5749
"28117950400",3667,562,32,209,12,0,70,0,4552
"28117950500",835,120,339,708,99,24,0,10,2135
"28119950100",352,30,1069,1016,0,7,42,14,2530
"28119950200",384,40,742,539,2,0,0,0,1707
"28119950300",1116,388,938,1108,0,37,0,0,3587
"28121020101",2781,273,773,584,66,112,53,112,4754
"28121020102",8524,171,1453,1010,320,3,44,3,11528
"28121020206",6975,704,1109,132,323,0,179,124,9546
"28121020207",4002,360,942,299,19,0,190,157,5969
"28121020208",5243,272,364,12,74,0,80,0,6045
"28121020209",3996,124,632,18,11,10,12,0,4803
"28121020210",3853,76,389,223,187,0,58,0,4786
"28121020211",6818,433,1158,46,566,0,335,0,9356
"28121020212",2348,33,302,0,34,0,42,0,2759
"28121020213",1007,0,232,59,80,0,0,0,1378
"28121020301",2538,220,0,58,0,121,37,0,2974
"28121020302",5260,522,896,172,440,20,305,135,7750
"28121020401",2488,676,508,331,159,39,121,7,4329
"28121020402",4133,372,1311,368,109,0,21,17,6331
"28121020500",85,139,24,90,0,0,0,0,338
"28121020600",4495,440,2742,148,382,353,433,206,9199
"28121020701",777,118,189,20,97,0,148,4,1353
"28121020703",1255,290,29,38,34,21,17,25,1709
"28121020704",4120,460,808,153,145,42,211,55,5994
"28121020801",1523,217,288,13,7,0,13,0,2061
"28121020802",7027,883,2305,599,380,0,12,308,11514
"28121020803",1308,525,142,0,12,25,22,36,2070
"28121020900",4952,853,924,320,0,0,19,6,7074
"28121021001",4571,610,348,113,57,77,33,44,5853
"28121021002",5070,447,1164,397,107,0,93,0,7278
"28121021003",3835,519,486,139,53,47,0,0,5079
"28121980000",99,9,28,5,0,3,0,0,144
"28123020100",3151,969,1686,647,231,81,280,239,7284
"28123020200",1378,444,2440,1075,45,0,59,35,5476
"28123020300",3512,376,635,92,0,0,315,0,4930
"28123020400",1186,353,656,501,129,114,610,195,3744
"28123020500",1972,685,963,750,166,67,580,588,5771
"28123020600",2081,296,763,374,0,70,34,61,3679
"28125950100",810,51,1075,813,0,0,12,0,2761
"28125950200",450,35,935,588,6,0,35,0,2049
"28127950100",2352,734,1628,375,13,0,14,0,5116
"28127950200",1912,428,648,448,12,71,0,62,3581
"28127950300",3888,639,944,693,59,0,0,0,6223
"28127950400",4119,555,1780,898,181,29,26,0,7588
"28127950500",1685,634,1464,552,71,0,259,40,4705
"28129950100",3123,922,692,287,18,0,5,81,5128
"28129950200",3893,712,581,905,119,8,81,0,6299
"28129950300",3314,286,710,727,16,0,45,0,5098
"28131020100",2470,297,158,717,35,0,50,24,3751
"28131020201",5471,684,546,313,83,100,14,13,7224
"28131020202",4119,495,849,447,151,2,149,2,6214
"28133950100",1089,227,1039,1283,3,0,30,47,3718
"28133950200",1047,221,2171,1077,14,0,23,6,4559
"28133950300",892,59,604,810,65,46,38,52,2566
"28133950401",1540,132,1065,632,0,43,37,9,3458
"28133950402",57,0,3308,2341,7,89,0,97,5899
"28133950500",263,13,852,1172,33,0,0,0,2333
"28133950600",493,100,1040,566,38,0,10,7,2254
"28135950100",2265,313,690,287,9,0,54,15,3633
"28135950200",523,10,949,1324,34,5,15,0,2860
"28135950300",770,196,1328,985,3,1,0,5,3288
"28135950400",980,76,770,415,21,0,0,0,2262
"28137950100",3370,393,1354,641,61,29,102,0,5950
"28137950200",4499,586,733,243,0,10,21,0,6092
"28137950301",1952,163,1120,1102,35,0,43,0,4415
"28137950302",4043,640,838,99,17,225,20,225,6107
"28137950400",2524,298,1297,546,118,18,225,14,5040
"28139950100",3010,1124,349,109,153,61,177,61,5044
"28139950200",3910,1988,513,251,281,100,232,320,7595
"28139950300",1312,196,564,376,272,46,32,0,2798
"28139950400",5205,807,522,440,70,24,95,110,7273
"28141950100",2657,309,0,0,24,0,17,0,3007
"28141950200",1580,562,111,14,55,23,0,19,2364
"28141950300",5202,987,0,4,77,23,0,18,6311
"28141950400",5762,1205,173,176,248,80,314,170,8128
"28143950100",943,351,2833,1385,124,47,50,73,5806
"28143950200",1047,95,2299,1216,18,71,57,63,4866
"28143980000",0,0,0,0,0,0,0,0,0
"28145950100",3258,977,285,2,77,56,88,94,4837
"28145950200",3487,959,294,101,91,53,38,40,5063
"28145950300",2609,429,403,572,139,115,144,55,4466
"28145950400",2160,560,676,419,96,238,49,440,4638
"28145950500",3821,1150,272,98,33,0,7,228,5609
"28145950600",2512,312,378,285,23,6,0,39,3555
"28147950100",2386,811,2427,1065,20,47,50,0,6806
"28147950200",821,143,349,334,37,0,28,0,1712
"28147950300",3301,379,1769,962,52,38,25,139,6665
"28149950100",2743,62,751,519,0,103,59,16,4253
"28149950200",524,88,1755,1666,173,18,0,0,4224
"28149950300",306,51,1190,1472,0,0,5,0,3024
"28149950400",718,20,924,1152,15,0,36,0,2865
"28149950500",1047,124,607,257,33,71,19,104,2262
"28149950600",2897,255,1457,1113,239,33,149,22,6165
"28149950700",475,87,1207,311,28,0,0,0,2108
"28149950800",1389,190,1809,516,77,0,24,42,4047
"28149950901",3261,363,1044,239,14,0,52,0,4973
"28149950902",2567,760,547,401,68,9,6,171,4529
"28149951101",3242,278,1471,452,11,12,5,12,5483
"28149951102",2339,312,1041,698,95,21,197,0,4703
"28151000100",804,45,429,245,36,0,25,0,1584
"28151000200",303,76,880,519,0,0,4,0,1782
"28151000300",118,17,1581,1707,71,8,0,0,3502
"28151000400",0,0,1495,1806,0,9,0,0,3310
"28151000600",3,23,1381,1155,0,5,8,5,2580
"28151000701",1047,363,1504,534,51,0,12,0,3511
"28151000702",2201,66,1195,12,483,93,244,113,4407
"28151000800",1513,228,1137,525,18,7,5,9,3442
"28151000900",723,106,848,1209,4,23,0,0,2913
"28151001000",9,7,704,386,2,79,7,0,1194
"28151001100",18,0,836,881,0,4,0,0,1739
"28151001200",1,0,1217,813,20,0,0,0,2051
"28151001300",85,16,929,1370,27,0,13,0,2440
"28151001400",801,251,1732,1013,0,6,0,11,3814
"28151001500",2308,723,429,806,34,0,94,0,4394
"28151001600",495,144,571,734,46,3,34,0,2027
"28151001700",563,32,1162,1199,4,6,4,0,2970
"28151002000",224,39,628,509,0,0,0,0,1400
"28151002100",85,1,455,747,0,2,0,0,1290
"28153950100",2141,221,1631,1354,64,0,0,0,5411
"28153950200",1066,545,1182,1339,53,0,53,0,4238
"28153950300",3514,646,767,452,77,0,67,29,5552
"28153950400",3413,649,690,579,16,20,96,13,5476
"28155950100",3208,753,223,314,31,23,47,2,4601
"28155950200",2464,401,517,292,16,0,14,0,3704
"28155950300",799,274,138,409,88,11,52,0,1771
"28157950100",1412,28,1112,1346,0,0,0,0,3898
"28157950200",904,186,2821,845,0,0,0,0,4756
"28159950100",1663,328,752,107,31,0,0,4,2885
"28159950200",1617,278,1324,989,0,6,22,0,4236
"28159950300",1003,240,1278,1228,96,0,3,0,3848
"28159950400",1460,336,840,1117,16,0,3,29,3801
"28159950500",2449,372,407,521,46,0,103,10,3908
"28161950100",2026,209,998,231,28,9,24,20,3545
"28161950200",1777,398,818,922,35,2,18,42,4012
"28161950300",2669,347,1242,603,33,23,0,0,4917
"28163950100",1799,342,764,565,51,0,9,0,3530
"28163950200",1007,41,1012,1142,0,0,0,0,3202
"28163950300",353,16,1975,2966,0,61,0,22,5393
"28163950400",1421,199,277,7,84,0,130,0,2118
"28163950500",327,69,1823,2017,0,68,0,0,4304
"28163950600",3556,772,1365,477,77,0,28,0,6275
"29001950100",3025,566,2,0,38,20,2,0,3653
"29001950200",2593,338,42,0,202,0,7,0,3182
"29001950300",1704,1040,35,7,0,58,94,67,3005
"29001950400",3272,350,29,0,131,24,26,0,3832
"29001950500",4837,1486,52,88,53,255,115,63,6949
"29001950900",996,978,10,0,36,48,36,86,2190
"29001951000",14,24,9,9,0,0,0,0,56
"29003010100",5484,347,45,0,151,0,180,29,6236
"29003010200",5756,517,44,0,78,22,81,0,6498
"29003010300",1488,186,22,0,29,0,24,0,1749
"29003010400",2356,307,0,0,46,0,16,0,2725
"29005950100",2600,422,7,4,58,3,18,2,3114
"29005950200",2126,195,0,0,9,3,24,5,2362
"29007950100",1939,467,280,37,87,53,20,4,2887
"29007950200",4129,474,16,9,12,0,6,2,4648
"29007950300",2668,950,0,0,56,0,0,0,3674
"29007950400",2102,331,19,112,54,122,104,0,2844
"29007950500",2399,251,8,0,234,46,280,0,3218
"29007950600",2363,275,467,16,39,0,0,0,3160
"29007950700",2493,709,257,32,152,165,147,66,4021
"29009960100",4447,857,0,0,43,0,0,0,5347
"29009960200",5108,937,9,0,546,363,449,150,7562
"29009960300",3530,1225,0,2,822,382,878,713,7552
"29009960401",3085,804,0,0,154,76,37,55,4211
"29009960402",2418,638,0,0,219,121,231,47,3674
"29009960500",5371,745,0,0,67,145,137,77,6542
"29009960600",2450,391,0,0,88,9,0,2,2940
"29011960100",2440,472,0,5,74,136,42,145,3314
"29011960200",3119,507,0,0,76,53,13,41,3809
"29011960300",4117,923,1,0,136,198,16,0,5391
"29013070100",4508,587,0,0,240,10,120,0,5465
"29013070200",3208,660,16,0,113,47,107,37,4188
"29013070300",3049,1152,0,103,27,0,14,25,4370
"29013070400",2194,498,32,7,19,3,6,0,2759
"29015460100",2708,819,0,0,13,0,44,19,3603
"29015460200",1733,674,0,0,4,8,0,68,2487
"29015460300",3251,677,7,0,49,21,84,0,4089
"29015460400",1570,306,0,0,99,0,0,0,1975
"29015460700",2498,341,7,7,82,0,0,0,2935
"29015460800",2849,750,0,0,94,154,92,0,3939
"29017950100",3741,857,0,0,22,9,0,0,4629
"29017950200",3417,1044,0,0,152,0,17,81,4711
"29017950300",2496,524,0,0,20,13,9,0,3062
"29019000200",913,375,18,12,61,69,42,6,1496
"29019000300",719,1622,0,45,163,74,3,63,2689
"29019000500",280,1070,64,17,268,300,19,33,2051
"29019000600",4190,147,31,0,247,0,110,0,4725
"29019000700",2429,631,497,205,315,356,496,314,5243
"29019000900",695,304,159,165,113,71,54,11,1572
"29019001001",2299,1322,74,135,351,91,206,27,4505
"29019001002",4186,779,192,404,449,118,101,0,6229
"29019001101",2883,3212,673,571,444,702,203,69,8757
"29019001103",4887,921,310,28,316,87,102,0,6651
"29019001104",7210,1564,606,209,610,66,143,33,10441
"29019001201",4817,212,428,101,600,87,127,0,6372
"29019001202",4421,418,0,11,476,42,67,0,5435
"29019001300",1747,661,266,413,545,179,70,0,3881
"29019001400",8244,627,588,539,938,148,524,0,11608
"29019001502",3380,805,639,268,616,235,167,92,6202
"29019001503",1767,601,482,284,154,130,96,21,3535
"29019001504",5137,1450,1244,620,782,91,297,27,9648
"29019001601",5436,702,594,230,323,278,168,23,7754
"29019001602",2916,127,61,67,85,0,93,0,3349
"29019001701",6470,794,13,8,146,0,12,0,7443
"29019001702",4028,402,53,20,223,2,132,0,4860
"29019001803",3486,471,142,85,423,0,228,35,4870
"29019001805",7084,383,522,357,583,73,72,0,9074
"29019001901",4448,334,34,0,78,9,22,0,4925
"29019001902",7400,495,54,6,266,18,170,24,8433
"29019002000",4244,588,95,2,95,0,32,0,5056
"29019002100",866,653,561,467,163,354,31,67,3162
"29019002200",162,503,7,47,107,118,31,4,979
"29021000100",4939,405,37,50,336,79,206,0,6052
"29021000200",3947,176,73,11,45,69,66,69,4456
"29021000300",2596,471,0,0,71,84,52,0,3274
"29021000400",1191,425,40,9,95,0,17,0,1777
"29021000500",1951,285,53,11,92,9,151,44,2596
"29021000600",2577,210,45,85,81,115,111,114,3338
"29021000701",2948,163,0,192,47,0,64,0,3414
"29021000702",3007,670,226,205,145,103,126,107,4589
"29021000900",4091,219,104,19,123,7,152,23,4738
"29021001000",874,1000,429,143,182,262,141,89,3120
"29021001100",1892,805,158,26,119,27,213,288,3528
"29021001200",1018,331,43,58,20,160,9,102,1741
"29021001500",4171,742,119,0,208,178,66,0,5484
"29021001600",1751,195,426,48,199,0,136,0,2755
"29021001700",3345,673,51,11,191,48,337,58,4714
"29021001800",2259,862,6,11,68,61,50,0,3317
"29021002100",2096,411,160,62,131,59,264,99,3282
"29021002200",1784,78,0,0,42,0,24,0,1928
"29021002300",2293,202,0,0,35,0,138,0,2668
"29021002400",1395,219,8,16,131,134,192,92,2187
"29021002500",1425,526,45,17,69,30,185,160,2457
"29021002700",2949,203,12,29,75,278,86,0,3632
"29021002800",4660,384,44,0,68,0,172,0,5328
"29021002900",2498,348,0,0,14,0,50,0,2910
"29021003000",4120,1356,123,172,347,277,403,110,6908
"29023950100",4543,725,42,0,113,100,97,39,5659
"29023950201",4005,245,80,0,185,0,55,0,4570
"29023950202",4825,538,1,0,123,0,0,0,5487
"29023950300",5116,941,190,6,140,123,82,123,6721
"29023950400",1253,905,683,114,20,388,14,52,3429
"29023950500",1400,1022,73,69,37,14,15,0,2630
"29023950600",3434,740,29,0,49,17,6,3,4278
"29023950700",1441,1216,130,39,33,163,8,11,3041
"29023950800",1767,576,78,125,52,90,45,144,2877
"29023950900",2778,530,216,107,62,37,8,0,3738
"29025950100",2234,478,10,0,47,15,17,0,2801
"29025950200",5289,760,29,9,139,30,116,23,6395
"29027070100",3984,534,26,7,109,31,99,0,4790
"29027070200",3009,406,0,0,87,22,69,0,3593
"29027070300",3829,853,233,57,82,158,70,65,5347
"29027070400",3154,604,403,18,216,24,127,0,4546
"29027070500",4059,452,89,19,175,0,56,0,4850
"29027070600",5178,1074,75,16,183,10,102,34,6672
"29027070700",6059,327,92,0,179,47,55,0,6759
"29027070800",3967,577,10,48,147,7,0,0,4756
"29029950100",3578,499,0,0,32,0,16,49,4174
"29029950200",4453,1152,11,0,65,297,19,472,6469
"29029950300",1957,233,0,0,0,0,0,0,2190
"29029950400",3239,375,2,8,34,47,124,51,3880
"29029950500",2498,767,3,3,59,87,57,40,3514
"29029950600",3935,610,0,0,110,21,27,21,4724
"29029950700",2644,633,20,44,40,105,0,48,3534
"29029950800",5999,1168,0,6,53,73,12,42,7353
"29029950900",3172,361,0,0,0,0,2,19,3554
"29029951100",2358,197,0,0,24,12,24,12,2627
"29029951200",2020,266,34,16,101,0,12,0,2449
"29031880100",4791,477,0,1,43,0,69,0,5381
"29031880200",3745,236,0,0,10,0,45,0,4036
"29031880300",4165,276,34,0,19,14,6,0,4514
"29031880400",5465,530,66,158,110,0,113,0,6442
"29031880500",8840,838,81,73,164,78,106,1,10181
"29031880600",4658,872,66,75,186,59,8,37,5961
"29031880700",3895,417,46,33,109,0,54,0,4554
"29031880800",1054,542,0,139,80,62,56,27,1960
"29031880900",1349,172,355,303,151,109,78,29,2546
"29031881000",718,528,365,353,58,80,13,7,2122
"29031881100",2788,367,107,11,53,80,53,39,3498
"29031881200",5145,498,125,287,63,0,104,0,6222
"29031881300",3675,632,603,332,165,42,249,0,5698
"29031881400",1464,303,325,826,2,16,0,11,2947
"29031881500",3819,577,0,1,215,72,36,192,4912
"29031881600",1755,729,215,180,41,137,71,154,3282
"29033960100",2008,330,3,0,45,0,24,4,2414
"29033960200",2469,187,16,0,116,14,15,4,2821
"29033960300",3066,622,31,24,53,52,35,33,3916
"29035960100",2492,963,0,0,109,24,14,17,3619
"29035960200",2194,292,0,23,22,47,0,1,2579
"29037060001",3559,504,56,0,69,73,198,299,4758
"29037060003",2476,358,294,188,102,0,282,45,3745
"29037060004",4236,830,111,0,321,0,228,301,6027
"29037060100",1090,149,137,33,58,0,44,0,1511
"29037060202",3902,208,31,44,497,25,253,39,4999
"29037060301",7247,227,1175,88,300,32,181,45,9295
"29037060302",6575,178,68,14,168,17,229,32,7281
"29037060305",3735,149,261,0,234,0,109,0,4488
"29037060400",4249,96,62,0,172,0,247,0,4826
"29037060500",2636,129,0,0,51,12,43,0,2871
"29037060600",6257,775,0,22,587,0,262,0,7903
"29037060700",3305,305,0,0,102,30,45,6,3793
"29037060800",5456,431,39,0,96,0,205,0,6227
"29037060904",2693,279,0,39,25,17,0,0,3053
"29037061001",4518,190,99,0,133,6,47,0,4993
"29037061002",5818,449,63,2,102,193,183,17,6827
"29037061100",3795,284,0,0,124,51,79,3,4336
"29037061200",3386,424,6,0,67,12,62,23,3980
"29037061300",3959,923,609,40,271,74,89,0,5965
"29037061400",4304,830,1,25,45,20,320,48,5593
"29039870100",4690,817,0,1,91,0,32,1,5632
"29039870200",3099,1445,1,0,153,0,0,2,4700
"29039870300",2276,793,4,0,55,86,22,0,3236
"29041470100",1808,359,0,1,13,2,2,1,2186
"29041470200",2009,399,65,40,25,9,20,6,2573
"29041470300",2288,367,6,52,37,6,21,0,2777
"29043020101",2500,275,69,0,103,40,16,18,3021
"29043020102",4628,480,0,0,133,35,38,13,5327
"29043020201",4087,151,0,0,0,0,0,0,4238
"29043020202",5295,522,0,0,188,12,319,12,6348
"29043020203",5251,692,0,0,377,84,64,64,6532
"29043020204",3374,465,36,2,133,0,124,47,4181
"29043020205",5501,913,43,0,142,56,359,0,7014
"29043020302",4825,523,0,0,399,54,405,0,6206
"29043020303",4594,501,53,0,9,7,124,7,5295
"29043020304",1979,744,29,2,28,135,39,73,3029
"29043020305",5576,303,31,102,58,117,72,2,6261
"29043020306",6657,617,40,2,97,72,168,20,7673
"29043020400",6870,593,0,0,121,9,26,0,7619
"29043020500",6140,670,0,0,186,51,21,2,7070
"29045950100",1709,279,0,0,45,15,0,15,2063
"29045950200",1793,410,0,9,11,10,0,6,2239
"29045950300",2142,466,0,0,13,32,0,19,2672
"29047020201",2773,429,411,96,759,208,219,35,4930
"29047020202",3137,183,38,1,326,0,363,0,4048
"29047020300",4203,527,342,219,537,248,349,170,6595
"29047020400",1660,102,237,30,417,7,270,32,2755
"29047020500",3904,824,64,315,384,134,482,107,6214
"29047020602",2861,527,330,327,162,99,295,141,4742
"29047020603",2704,636,180,0,82,28,273,136,4039
"29047020604",3420,358,218,83,727,64,436,124,5430
"29047020801",5195,720,55,1,455,95,303,103,6927
"29047020901",4489,156,206,74,514,9,207,0,5655
"29047020902",2091,114,139,7,130,22,322,8,2833
"29047021001",2673,399,141,169,77,202,203,250,4114
"29047021003",3129,369,107,0,156,26,132,22,3941
"29047021004",2654,154,156,0,74,4,52,40,3134
"29047021101",3600,390,148,27,173,117,95,173,4723
"29047021102",5629,527,339,26,267,0,442,25,7255
"29047021103",3126,158,95,48,128,25,129,10,3719
"29047021204",3162,744,387,40,295,258,152,326,5364
"29047021205",5321,218,355,99,718,61,424,0,7196
"29047021206",6245,114,258,46,509,0,436,0,7608
"29047021207",2216,183,213,119,243,138,268,65,3445
"29047021208",3662,563,911,44,638,0,751,167,6736
"29047021303",2442,361,112,19,84,23,42,0,3083
"29047021305",5801,303,461,48,785,0,363,0,7761
"29047021306",6413,80,286,0,273,0,464,0,7516
"29047021307",4304,126,446,171,475,307,351,231,6411
"29047021309",4065,64,116,0,280,0,139,0,4664
"29047021310",5943,251,252,0,366,0,480,0,7292
"29047021401",2812,585,237,11,77,0,0,0,3722
"29047021403",2309,277,119,2,119,39,198,1,3064
"29047021404",3919,380,251,0,69,102,57,51,4829
"29047021600",7019,432,104,311,387,28,170,34,8485
"29047021701",4533,115,112,26,276,37,210,0,5309
"29047021702",4696,1100,238,115,75,3,56,7,6290
"29047021803",6756,37,155,15,351,0,269,0,7583
"29047021804",6462,74,0,0,116,0,1,6,6659
"29047021805",7898,173,13,0,509,58,210,0,8861
"29047021806",3245,280,0,0,135,5,18,0,3683
"29047021900",5436,164,32,0,157,0,155,0,5944
"29047022000",4037,433,15,0,221,20,293,2,5021
"29047022100",3264,543,52,0,492,27,414,56,4848
"29047022200",3363,164,194,138,168,16,246,0,4289
"29047022301",2264,334,93,0,88,8,17,81,2885
"29047022302",5214,324,95,0,173,9,351,48,6214
"29049960100",3904,894,0,0,111,68,15,5,4997
"29049960200",6182,356,37,0,73,39,93,41,6821
"29049960300",3578,290,222,30,149,0,103,0,4372
"29049960400",3736,370,9,0,38,6,24,7,4190
"29051010300",3709,446,193,884,174,91,0,49,5546
"29051010400",5403,536,160,378,198,0,43,0,6718
"29051010500",1929,606,572,490,128,88,48,124,3985
"29051010600",1841,649,312,381,409,154,126,0,3872
"29051010701",4145,283,307,0,542,0,312,0,5589
"29051010702",4648,289,500,59,158,26,9,0,5689
"29051010800",7311,464,795,0,147,196,229,205,9347
"29051010900",5471,267,167,65,114,33,32,0,6149
"29051020198",3701,146,0,1,48,0,16,0,3912
"29051020200",3677,176,0,0,40,7,4,0,3904
"29051020300",3218,340,30,0,54,6,0,0,3648
"29051020400",4254,340,610,95,469,10,316,92,6186
"29051020500",2052,523,0,0,73,5,17,0,2670
"29051020600",3483,412,14,157,197,0,144,21,4428
"29051020700",776,433,384,431,77,127,12,32,2272
"29053950100",2571,547,1,2,57,4,1,1,3184
"29053950200",1138,259,136,134,45,81,58,4,1855
"29053950300",3120,695,46,33,116,6,62,0,4078
"29053950400",1698,224,33,15,118,150,23,9,2270
"29053950500",3827,664,23,4,165,14,8,4,4709
"29055450101",1584,330,0,1,25,1,11,28,1980
"29055450102",5038,1261,11,16,28,0,60,0,6414
"29055450200",3145,703,9,3,258,2,0,52,4172
"29055450301",2091,614,0,0,0,19,102,0,2826
"29055450302",3032,977,0,0,15,24,40,52,4140
"29055450400",3849,1143,7,0,81,20,20,25,5145
"29057480100",3379,822,3,0,102,31,31,64,4432
"29057480200",2401,681,12,7,144,23,21,4,3293
"29059480100",3279,1037,2,4,77,165,28,20,4612
"29059480200",4062,881,0,0,268,39,113,4,5367
"29059480300",4973,1576,0,0,91,56,103,12,6811
"29061470100",2608,361,2,0,47,4,33,1,3056
"29061470200",4232,811,5,0,86,30,43,17,5224
"29063080100",4486,650,2,23,204,19,40,4,5428
"29063080200",3639,205,8,21,24,4,14,3,3918
"29065960100",3979,583,0,0,153,5,15,0,4735
"29065960200",3917,1062,0,0,223,45,53,49,5349
"29065960300",1185,841,0,0,4,0,0,10,2040
"29065960400",2608,604,0,0,38,65,45,0,3360
"29067950100",2639,691,0,0,17,0,0,32,3379
"29067950200",4461,1265,0,0,69,0,12,13,5820
"29067950500",3082,1048,0,9,94,15,57,9,4314
"29069360100",1054,303,816,324,93,22,0,0,2612
"29069360200",2005,283,132,204,23,41,103,27,2818
"29069360300",2821,1225,0,33,15,27,35,33,4189
"29069360400",3064,767,33,103,24,142,173,166,4472
"29069360500",1893,517,478,168,0,50,27,221,3354
"29069360600",2669,1206,199,171,48,65,139,87,4584
"29069360700",2407,634,282,105,91,0,66,0,3585
"29069360800",1479,549,5,0,24,135,300,209,2701
"29069360900",1818,314,75,0,40,4,69,26,2346
"29069361000",1450,548,0,0,46,20,52,53,2169
"29071800100",7612,1031,45,0,63,0,43,0,8794
"29071800201",4376,439,39,121,97,149,0,149,5370
"29071800202",5406,137,0,0,238,0,65,0,5846
"29071800300",6537,620,77,37,88,0,103,56,7518
"29071800401",4571,306,15,3,166,0,267,4,5332
"29071800402",6142,562,0,20,0,0,50,0,6774
"29071800500",6338,679,0,0,51,0,65,46,7179
"29071800601",6131,968,0,0,108,0,56,156,7419
"29071800602",7311,541,83,0,129,0,139,64,8267
"29071800701",5248,989,409,122,99,0,64,0,6931
"29071800702",2951,105,39,6,40,0,9,0,3150
"29071800800",6460,906,83,0,108,4,14,9,7584
"29071800901",2485,418,0,0,133,0,28,0,3064
"29071800902",4700,1512,67,3,225,67,36,0,6610
"29071801000",2991,700,0,0,79,39,16,0,3825
"29071801101",3075,1200,26,0,11,8,0,0,4320
"29071801102",2956,803,0,0,4,0,0,30,3793
"29073960100",2204,297,18,0,56,0,6,0,2581
"29073960200",1710,188,0,0,6,0,0,0,1904
"29073960300",2593,352,0,0,36,47,2,0,3030
"29073960400",2279,673,0,8,53,0,18,0,3031
"29073960500",3500,591,7,0,26,19,28,115,4286
"29075960100",2586,452,11,23,41,2,6,0,3121
"29075960200",2754,644,0,0,37,5,18,11,3469
"29077000100",509,429,37,94,10,18,9,25,1131
"29077000200",292,717,19,7,81,137,34,123,1410
"29077000300",2316,599,6,0,112,90,107,26,3256
"29077000400",1955,1711,82,282,302,168,11,75,4586
"29077000501",1161,478,146,56,238,65,14,14,2172
"29077000502",1251,1053,79,228,101,277,19,38,3046
"29077000600",1478,832,16,65,30,35,48,66,2570
"29077000700",1519,971,109,161,48,0,56,41,2905
"29077000800",1261,482,61,77,90,63,39,29,2102
"29077000900",2690,1160,77,105,147,323,14,59,4575
"29077001000",2076,113,6,0,49,19,29,0,2292
"29077001100",2251,471,77,18,160,58,123,7,3165
"29077001200",2873,628,141,9,150,85,69,179,4134
"29077001301",1654,493,6,0,12,3,81,32,2281
"29077001302",1369,477,3,84,234,9,296,42,2514
"29077001400",2907,918,109,65,255,70,164,105,4593
"29077001500",3097,486,221,0,392,199,209,34,4638
"29077001700",1696,660,223,33,110,81,18,15,2836
"29077001800",1965,687,37,5,47,46,17,20,2824
"29077001900",1653,1273,61,31,193,54,27,55,3347
"29077002200",3105,915,114,17,348,400,221,384,5504
"29077002300",3554,1793,8,39,117,223,31,119,5884
"29077002402",3322,320,60,66,219,35,65,35,4122
"29077002502",3584,1123,96,93,118,208,47,42,5311
"29077002600",4165,340,0,0,105,0,10,41,4661
"29077002700",1675,366,18,0,275,23,71,0,2428
"29077002800",1402,131,11,6,172,0,106,57,1885
"29077002900",3586,295,68,16,180,0,99,16,4260
"29077003002",3049,989,307,38,368,58,40,67,4916
"29077003100",1681,671,66,0,19,31,10,58,2536
"29077003200",2904,848,96,150,168,120,173,55,4514
"29077003300",1803,1694,101,180,164,47,12,68,4069
"29077003600",1514,1200,21,65,113,172,50,355,3490
"29077003700",6303,418,78,0,307,0,158,0,7264
"29077003800",6201,263,30,0,404,0,90,0,6988
"29077003900",2303,260,54,60,43,0,8,0,2728
"29077004001",3848,603,70,0,224,31,146,40,4962
"29077004002",3031,151,85,0,306,0,45,0,3618
"29077004003",4162,303,26,0,194,29,88,0,4802
"29077004101",7472,526,37,0,305,12,27,0,8379
"29077004102",6309,367,42,0,305,0,144,0,7167
"29077004103",5695,658,13,0,657,0,31,0,7054
"29077004201",3980,528,83,0,187,6,24,6,4814
"29077004202",4823,596,132,0,264,306,190,148,6459
"29077004301",6103,443,224,53,221,187,280,0,7511
"29077004302",3036,518,92,0,254,112,70,68,4150
"29077004400",4732,1574,314,28,144,17,151,0,6960
"29077004500",2392,135,27,0,78,34,0,0,2666
"29077004600",6191,767,64,8,207,5,169,11,7422
"29077004700",4306,642,0,0,157,0,0,0,5105
"29077004801",5313,952,0,0,257,0,166,18,6706
"29077004802",6777,314,40,0,374,38,211,0,7754
"29077004803",3498,896,9,0,87,86,21,0,4597
"29077004900",5798,408,0,0,114,0,0,0,6320
"29077005001",2891,412,7,0,153,24,120,28,3635
"29077005002",5645,595,118,2,112,60,328,35,6895
"29077005100",2743,307,0,0,69,0,80,0,3199
"29077005200",5242,814,20,0,148,47,8,43,6322
"29077005500",2388,868,227,118,146,8,113,54,3922
"29077005600",2540,880,41,11,133,91,102,32,3830
"29077005700",2646,851,30,14,225,68,82,137,4053
"29077005800",2600,1493,70,78,102,66,161,18,4588
"29079960100",1827,224,2,0,19,15,5,6,2098
"29079960200",1758,305,3,0,47,8,44,0,2165
"29079960300",1876,326,27,0,125,0,0,0,2354
"29079960400",2680,678,24,4,14,13,4,37,3454
"29081950100",2914,606,0,0,67,19,19,13,3638
"29081950200",1737,339,33,2,22,0,18,0,2151
"29081950300",2475,441,0,0,7,7,80,19,3029
"29083950100",2322,433,83,0,5,0,0,0,2843
"29083950200",2954,733,0,0,87,28,106,0,3908
"29083950300",2999,435,0,0,39,20,18,56,3567
"29083950400",2202,429,5,4,43,2,48,0,2733
"29083950500",2489,872,56,0,92,26,37,16,3588
"29083950600",4136,814,78,34,32,71,117,0,5282
"29085470100",2395,691,0,1,48,6,26,0,3167
"29085470300",2160,223,0,0,24,10,40,0,2457
"29085470500",2613,1044,0,0,115,55,41,3,3871
"29087960100",1078,196,0,1,5,8,3,1,1292
"29087960200",1421,189,0,0,50,3,4,2,1669
"29087960300",1478,167,5,0,28,8,2,0,1688
"29089960100",2290,390,101,21,6,50,15,38,2911
"29089960200",2723,490,51,4,26,129,47,0,3470
"29089960300",2257,625,240,13,70,3,29,0,3237
"29091090100",4481,1152,0,20,114,12,81,0,5860
"29091090200",3104,961,0,0,48,46,50,17,4226
"29091090300",3415,941,36,0,109,41,12,31,4585
"29091090400",3544,789,0,0,218,22,65,0,4638
"29091090500",4111,758,16,8,85,21,49,0,5048
"29091090600",3798,1151,0,0,22,28,45,0,5044
"29091090700",2603,1994,0,0,164,256,0,170,5187
"29091090800",4283,1191,19,0,168,74,14,182,5931
"29093950100",2248,381,0,0,58,6,69,25,2787
"29093950200",1655,455,25,1,70,3,30,0,2239
"29093950300",1921,990,19,12,9,40,13,0,3004
"29093950400",1600,361,10,83,11,31,0,0,2096
"29095000300",532,111,107,369,201,424,52,128,1924
"29095000600",1347,1268,15,98,633,702,1160,1293,6516
"29095000700",1042,679,222,172,736,683,744,925,5203
"29095000800",1604,310,315,53,1066,328,1426,368,5470
"29095000900",1251,239,49,323,775,441,589,568,4235
"29095001000",712,99,481,656,808,185,691,100,3732
"29095001100",901,196,260,70,80,67,100,46,1720
"29095001800",504,322,293,392,503,188,261,267,2730
"29095001900",888,623,529,333,599,315,1019,477,4783
"29095002000",583,230,14,84,707,709,580,776,3683
"29095002100",939,1131,229,579,720,314,1074,973,5959
"29095002200",446,465,363,453,799,185,733,529,3973
"29095002300",272,288,963,214,194,106,330,293,2660
"29095003400",255,256,691,874,488,83,473,133,3253
"29095003700",1,9,466,433,60,47,46,25,1087
"29095003800",10,30,961,719,4,46,37,41,1848
"29095004300",1168,253,208,463,117,20,239,8,2476
"29095004400",674,65,40,23,49,63,37,0,951
"29095004600",1796,392,85,47,284,28,514,26,3172
"29095005100",763,118,229,125,41,243,88,280,1887
"29095005200",149,54,375,494,7,62,94,30,1265
"29095005300",224,22,520,285,79,5,16,0,1151
"29095005400",4,11,426,422,0,0,0,0,863
"29095005500",0,30,378,351,0,16,17,8,800
"29095005601",68,0,1085,570,10,185,6,133,2057
"29095005602",4,2,1071,581,9,20,9,12,1708
"29095005700",131,0,1513,502,91,45,0,0,2282
"29095005801",22,39,1028,464,102,73,50,83,1861
"29095006000",55,58,585,419,71,71,11,60,1330
"29095006100",137,99,1086,982,347,50,23,24,2748
"29095006300",19,50,904,554,0,0,65,23,1615
"29095006500",1000,168,257,168,57,7,40,0,1697
"29095006600",1082,205,92,0,121,42,103,12,1657
"29095006700",665,279,107,239,247,73,225,82,1917
"29095006900",768,161,32,0,72,5,46,0,1084
"29095007100",1844,422,183,0,205,77,126,11,2868
"29095007200",1751,206,16,0,149,0,89,0,2211
"29095007300",2111,397,168,0,203,117,40,28,3064
"29095007400",2205,452,65,41,221,182,34,80,3280
"29095007500",492,382,711,298,162,0,8,7,2060
"29095007600",63,202,1257,654,135,85,0,0,2396
"29095007700",7,15,979,693,9,5,0,0,1708
"29095007802",72,13,1579,305,244,21,202,0,2436
"29095007900",75,52,2527,782,178,0,107,0,3721
"29095008000",46,29,1864,747,61,109,51,69,2976
"29095008100",265,76,1272,370,103,43,92,26,2247
"29095008200",2380,233,149,9,233,48,86,7,3145
"29095008300",2287,30,28,0,30,0,55,0,2430
"29095008400",2773,0,0,0,104,0,33,0,2910
"29095008500",3151,109,50,0,88,0,42,0,3440
"29095008600",4540,194,200,0,173,0,190,0,5297
"29095008700",214,54,1284,516,94,0,16,11,2189
"29095008800",155,54,2087,762,100,10,91,24,3283
"29095008900",36,4,1123,756,5,5,17,0,1946
"29095009000",588,53,2987,726,410,0,157,9,4930
"29095009100",3155,222,376,33,139,0,221,0,4146
"29095009200",2315,169,195,41,66,9,192,39,3026
"29095009300",2009,126,11,1,183,0,130,8,2468
"29095009400",2281,533,756,415,326,64,89,68,4532
"29095009500",672,356,1145,612,69,90,8,90,3042
"29095009600",196,114,758,940,115,86,0,79,2288
"29095009700",284,44,478,387,58,22,26,22,1321
"29095009800",2217,116,876,139,129,0,75,0,3552
"29095009900",1563,111,433,31,70,114,60,80,2462
"29095010001",1351,49,321,36,57,0,34,0,1848
"29095010002",1315,550,1428,91,331,164,80,34,3993
"29095010103",1159,75,974,209,198,0,66,0,2681
"29095010105",2732,70,228,0,114,180,106,0,3430
"29095010201",490,248,546,725,41,12,21,14,2097
"29095010203",2576,156,1555,139,278,3,162,0,4869
"29095010204",2187,743,550,316,1118,381,606,563,6464
"29095010500",1526,324,1367,830,348,183,400,231,5209
"29095010600",2028,212,606,0,150,22,278,0,3296
"29095010702",1308,142,964,739,30,24,51,47,3305
"29095011000",2880,1312,238,50,46,73,139,89,4827
"29095011100",2438,534,9,0,151,0,87,0,3219
"29095011200",2480,400,16,4,88,88,93,35,3204
"29095011300",2985,819,146,186,377,176,140,132,4961
"29095011401",6106,1312,231,137,574,21,657,563,9601
"29095011405",1228,1350,63,210,80,366,109,211,3617
"29095011406",4181,506,104,61,817,59,681,63,6472
"29095011500",3438,1096,62,314,561,124,494,177,6266
"29095011600",2711,946,315,44,201,13,194,103,4527
"29095011700",2722,647,469,31,68,57,229,51,4274
"29095011800",3280,944,223,489,174,539,328,489,6466
"29095011900",2172,461,50,51,504,204,508,110,4060
"29095012000",1963,450,172,44,280,28,235,12,3184
"29095012100",3093,1270,742,142,646,199,531,319,6942
"29095012200",4364,324,369,77,276,119,138,40,5707
"29095012300",3190,250,142,1,10,7,9,0,3609
"29095012400",2982,245,268,87,343,11,359,0,4295
"29095012501",1898,382,867,69,83,114,164,88,3665
"29095012502",2006,119,377,20,160,36,234,8,2960
"29095012600",3204,373,958,112,324,0,267,0,5238
"29095012701",3981,436,1474,172,191,12,247,12,6525
"29095012802",2103,116,936,26,78,5,224,2,3490
"29095012803",1512,70,141,9,101,4,19,0,1856
"29095012804",3292,358,1747,751,224,221,106,64,6763
"29095012903",1123,202,1722,386,197,35,282,4,3951
"29095012904",1061,155,1107,82,185,0,34,0,2624
"29095012906",1351,171,2106,404,313,43,37,13,4438
"29095013003",1272,189,2709,1040,215,154,422,63,6064
"29095013100",647,202,1327,228,267,223,89,159,3142
"29095013203",992,322,1583,912,200,199,350,67,4625
"29095013208",315,210,1478,608,72,13,124,0,2820
"29095013210",786,36,1295,431,4,15,378,0,2945
"29095013301",2305,337,460,32,285,238,94,228,3979
"29095013307",539,130,1463,250,530,0,447,37,3396
"29095013309",1088,129,2655,322,193,47,178,0,4612
"29095013313",3000,291,1019,239,552,44,240,72,5457
"29095013401",871,516,747,91,326,182,562,367,3662
"29095013405",1133,407,183,470,62,16,161,149,2581
"29095013407",2114,78,120,0,81,0,56,0,2449
"29095013408",3316,223,902,144,552,0,353,0,5490
"29095013410",1811,606,422,280,150,24,180,10,3483
"29095013416",992,62,948,99,140,0,105,0,2346
"29095013502",4820,310,134,12,291,0,127,0,5694
"29095013504",2694,212,273,0,142,0,268,89,3678
"29095013606",1357,22,43,0,0,0,0,0,1422
"29095013608",4684,241,233,221,140,0,110,14,5643
"29095013612",4730,156,496,68,1044,0,409,0,6903
"29095013703",3124,859,347,451,198,73,72,0,5124
"29095013704",5126,414,295,0,257,0,212,0,6304
"29095013801",3645,828,282,0,367,33,99,0,5254
"29095013802",7175,192,590,78,819,0,572,0,9426
"29095013901",6151,205,0,0,122,0,114,0,6592
"29095013902",1059,120,28,2,55,0,27,0,1291
"29095013904",5434,242,427,0,360,25,222,0,6710
"29095013916",4574,82,429,0,311,20,173,0,5589
"29095014002",1638,105,0,0,39,0,40,0,1822
"29095014004",2004,602,19,1,69,1,216,12,2924
"29095014005",4986,236,29,0,30,0,534,0,5815
"29095014006",5442,15,322,1,566,0,399,0,6745
"29095014007",4424,864,0,42,150,10,190,0,5680
"29095014101",5049,698,540,36,156,178,48,45,6750
"29095014105",6684,388,424,0,325,0,331,51,8203
"29095014108",4591,634,389,72,545,61,415,94,6801
"29095014111",2527,99,73,0,230,93,45,0,3067
"29095014112",739,4,0,0,10,0,25,0,778
"29095014114",5893,608,389,98,207,290,26,140,7651
"29095014120",2486,267,71,0,68,37,97,209,3235
"29095014203",3219,27,497,0,273,16,282,0,4314
"29095014204",6160,277,917,292,372,12,193,34,8257
"29095014300",3546,268,998,151,195,18,20,69,5265
"29095014400",1553,89,880,72,98,0,25,0,2717
"29095014501",3037,195,437,37,126,24,146,5,4007
"29095014502",4064,93,104,0,235,0,161,13,4670
"29095014601",4122,424,233,56,277,6,280,0,5398
"29095014603",2877,476,53,0,105,13,124,13,3661
"29095014604",3116,498,284,32,656,114,839,0,5539
"29095014701",2735,286,355,178,89,0,93,0,3736
"29095014702",4313,165,207,44,336,11,401,0,5477
"29095014804",2464,143,28,0,159,0,148,0,2942
"29095014806",3596,85,143,0,319,8,158,20,4329
"29095014902",1682,341,0,0,27,3,23,22,2098
"29095014903",4284,206,1,0,73,10,231,0,4805
"29095014904",5252,180,195,0,351,56,231,0,6265
"29095014905",4297,126,54,0,110,0,47,0,4634
"29095015000",3296,304,40,6,117,5,102,41,3911
"29095015100",4499,779,170,2,272,12,183,115,6032
"29095015200",1143,153,229,43,156,29,81,0,1834
"29095015300",815,291,263,386,986,788,1270,935,5734
"29095015400",212,311,846,1622,14,414,26,223,3668
"29095015500",676,273,0,28,52,195,42,288,1554
"29095015600",970,591,0,127,161,63,215,102,2229
"29095015700",1444,206,164,66,97,40,34,11,2062
"29095015800",1046,49,33,46,14,0,127,11,1326
"29095015900",498,119,57,99,125,43,58,18,1017
"29095016000",115,96,475,475,227,223,208,196,2015
"29095016100",12,18,1308,513,19,0,0,0,1870
"29095016200",115,92,502,257,135,7,82,0,1190
"29095016300",360,454,659,494,236,344,213,325,3085
"29095016400",222,239,885,297,70,256,189,271,2429
"29095016500",62,24,1172,286,80,19,116,23,1782
"29095016600",67,137,911,396,83,35,90,29,1748
"29095016700",1933,298,301,78,315,48,256,29,3258
"29095016800",2458,578,161,211,192,56,389,50,4095
"29095016900",49,0,1303,515,54,22,12,49,2004
"29095017000",926,405,427,126,70,38,38,102,2132
"29095017100",158,30,3135,566,44,80,41,0,4054
"29095017200",1646,171,1877,260,92,107,153,73,4379
"29095017300",2700,141,464,19,146,49,62,8,3589
"29095017400",383,288,1235,254,122,158,85,94,2619
"29095017500",805,88,484,279,34,17,28,0,1735
"29095017600",3199,138,1388,143,251,0,216,9,5344
"29095017700",4630,218,115,0,299,15,407,5,5689
"29095017800",769,327,243,709,207,176,215,180,2826
"29095017900",3443,178,434,12,468,33,293,0,4861
"29095018000",2503,582,235,7,110,19,142,128,3726
"29095018100",5176,122,673,34,551,0,63,34,6653
"29095018200",2391,44,308,6,297,26,133,5,3210
"29095018500",2684,132,185,9,393,0,86,0,3489
"29095018600",2772,11,60,0,105,0,0,0,2948
"29095019300",4507,270,742,0,297,114,140,0,6070
"29095980101",0,0,0,0,0,0,0,0,0
"29095980802",0,0,0,0,0,0,0,0,0
"29095988300",27,0,0,0,0,0,0,0,27
"29095989100",8,0,5,0,0,0,0,0,13
"29095989200",0,0,0,0,0,0,0,0,0
"29097010100",1819,516,147,118,420,54,34,53,3161
"29097010200",3511,677,60,0,270,26,148,29,4721
"29097010300",4578,1085,84,177,440,54,456,0,6874
"29097010400",3897,367,13,32,298,28,71,5,4711
"29097010500",4380,424,54,69,364,154,366,17,5828
"29097010600",3455,692,0,132,127,236,482,123,5247
"29097010700",2241,316,0,0,149,288,127,138,3259
"29097010800",2220,673,35,40,470,179,194,131,3942
"29097010900",5301,831,31,0,333,59,0,0,6555
"29097011000",2096,1461,154,339,177,46,106,26,4405
"29097011100",1938,244,13,0,69,24,86,4,2378
"29097011200",5076,683,0,2,419,0,147,0,6327
"29097011300",6749,1361,58,0,241,81,142,0,8632
"29097011400",4264,771,0,54,170,58,17,14,5348
"29097011500",7848,1245,19,4,194,79,269,163,9821
"29097011600",2434,1936,20,3,585,328,850,1644,7800
"29097011700",5040,1290,116,17,56,123,543,356,7541
"29097011800",3044,868,41,19,353,24,567,215,5131
"29097011900",3016,503,0,51,292,46,40,25,3973
"29097012000",3619,586,12,0,75,34,2,19,4347
"29097012100",3046,386,16,0,194,60,223,19,3944
"29097012200",6381,901,39,0,272,39,207,22,7861
"29099700107",2583,130,118,0,72,0,70,0,2973
"29099700109",11529,815,0,18,114,0,88,18,12582
"29099700110",6796,509,0,0,195,0,165,0,7665
"29099700111",3600,471,0,8,89,27,11,0,4206
"29099700113",2935,323,0,0,41,16,23,9,3347
"29099700114",3791,832,23,0,88,14,66,147,4961
"29099700115",4132,191,0,0,109,0,291,0,4723
"29099700116",3085,154,9,0,101,11,21,0,3381
"29099700117",6020,368,0,0,258,45,58,133,6882
"29099700118",5376,486,11,0,293,66,124,0,6356
"29099700119",1857,246,58,0,30,0,24,9,2224
"29099700203",4975,628,0,0,325,61,143,0,6132
"29099700206",4066,1138,0,41,74,70,135,39,5563
"29099700207",3246,359,41,0,93,0,60,0,3799
"29099700208",4368,1322,67,0,312,12,132,0,6213
"29099700209",3173,85,14,6,60,0,117,0,3455
"29099700210",3265,397,13,0,260,22,116,22,4095
"29099700211",4360,408,0,0,35,77,15,23,4918
"29099700302",4836,448,0,0,82,0,20,0,5386
"29099700303",4382,316,45,0,88,45,65,10,4951
"29099700304",5995,791,0,0,152,27,53,0,7018
"29099700401",3781,436,0,0,65,0,0,0,4282
"29099700402",5145,505,0,2,234,0,175,2,6063
"29099700502",4869,554,0,0,150,9,87,1,5670
"29099700503",3413,498,0,0,20,0,0,0,3931
"29099700504",4138,711,0,0,45,8,30,0,4932
"29099700601",4927,998,166,0,172,55,71,0,6389
"29099700603",5359,670,33,37,39,0,134,28,6300
"29099700604",5499,512,0,15,81,29,27,14,6177
"29099700605",5451,675,0,2,26,0,70,62,6286
"29099700700",3951,334,78,0,176,79,98,0,4716
"29099700801",4814,595,57,128,147,0,195,0,5936
"29099700802",3205,358,0,195,219,176,0,0,4153
"29099700900",4087,521,154,3,124,0,0,0,4889
"29099701000",7398,802,0,0,165,32,192,0,8589
"29099701101",3440,364,22,0,21,0,38,0,3885
"29099701102",4255,830,2,0,71,31,47,0,5236
"29099701200",4379,1218,72,0,68,32,12,21,5802
"29099701300",2664,581,34,0,19,30,7,0,3335
"29099701401",3406,253,17,0,31,0,0,0,3707
"29099701403",3470,584,0,0,78,0,12,16,4160
"29099701404",4983,675,74,0,54,0,7,0,5793
"29101960100",7419,716,122,50,143,0,56,0,8506
"29101960200",4156,713,30,23,153,54,48,100,5277
"29101960300",7123,826,264,18,421,9,382,9,9052
"29101960400",1845,1388,89,148,205,136,128,61,4000
"29101960500",5059,1140,198,91,556,160,95,21,7320
"29101960600",2055,965,160,194,23,47,39,57,3540
"29101960700",3854,863,388,190,522,35,331,46,6229
"29101960900",4013,761,8,1,73,43,35,4,4938
"29101980000",1310,83,155,0,218,0,120,0,1886
"29103960100",1349,424,1,21,49,5,2,0,1851
"29103960200",1546,593,4,10,23,6,11,0,2193
"29105960100",7061,1450,10,0,319,34,271,46,9191
"29105960298",4668,688,0,0,78,7,33,62,5536
"29105960300",5948,863,0,0,97,0,28,0,6936
"29105960400",2582,965,0,0,104,100,112,23,3886
"29105960500",4077,987,32,66,175,44,36,89,5506
"29105960600",2789,1625,14,0,141,72,19,15,4675
"29107090100",4420,423,314,17,65,72,12,72,5395
"29107090200",4614,505,341,35,33,191,55,86,5860
"29107090300",1131,229,0,1,56,0,27,32,1476
"29107090400",5683,765,73,3,64,6,148,65,6807
"29107090500",3360,238,19,0,252,1,62,20,3952
"29107090601",5234,347,0,0,129,1,128,34,5873
"29107090602",3543,201,19,0,4,34,21,0,3822
"29109470100",3310,407,0,0,38,0,99,0,3854
"29109470200",6113,1163,0,1,41,0,200,134,7652
"29109470300",4231,1013,0,2,170,56,230,98,5800
"29109470400",5620,1030,21,84,152,358,434,392,8091
"29109470500",4711,1289,0,21,204,102,0,45,6372
"29109470601",3652,666,0,0,200,35,441,0,4994
"29109470602",2006,652,0,1,191,145,329,97,3421
"29111970100",2346,356,11,0,19,33,2,0,2767
"29111970200",1743,570,9,24,21,0,8,0,2375
"29111970300",2321,129,0,2,62,0,150,0,2664
"29111970400",1357,180,90,46,59,79,3,0,1814
"29113810100",3077,695,20,120,25,30,52,28,4047
"29113810201",5451,970,1,5,239,46,153,96,6961
"29113810202",5545,416,0,0,74,0,30,0,6065
"29113810301",6449,1319,430,0,230,115,224,155,8922
"29113810303",7446,803,281,3,221,0,141,0,8895
"29113810304",7987,1516,170,13,90,161,20,0,9957
"29113810400",7124,773,11,0,350,119,53,120,8550
"29115490100",1322,351,0,0,4,3,6,0,1686
"29115490200",1895,402,1,0,44,13,29,12,2396
"29115490300",2638,145,12,0,105,7,53,7,2967
"29115490400",2024,574,16,10,134,46,38,9,2851
"29115490500",2339,289,2,0,13,31,20,31,2725
"29117480100",2345,396,4,7,18,38,16,0,2824
"29117480200",2899,438,0,7,47,5,3,0,3399
"29117480300",2527,389,0,21,0,0,14,9,2960
"29117480400",2075,489,0,0,86,27,32,0,2709
"29117480500",1222,596,12,0,40,28,0,102,2000
"29119070100",4578,764,0,0,449,75,147,0,6013
"29119070200",3495,928,0,5,267,185,36,36,4952
"29119070300",3381,1475,135,101,534,73,1238,740,7677
"29119070400",4427,1230,18,3,447,109,288,86,6608
"29121960100",1795,429,0,2,14,8,4,0,2252
"29121960200",2338,468,5,0,20,3,1,0,2835
"29121960300",3063,492,69,14,35,68,31,8,3780
"29121960400",3152,379,22,11,57,18,26,20,3685
"29121960500",1843,440,264,108,34,10,62,14,2775
"29123960100",2510,733,0,0,150,28,25,8,3454
"29123960200",3964,1292,0,2,66,27,200,0,5551
"29123960300",2776,509,0,0,29,0,0,0,3314
"29125880100",2023,786,0,37,0,16,4,32,2898
"29125880298",2257,124,6,0,66,0,0,0,2453
"29125880300",3039,502,0,17,75,15,54,0,3702
"29127960100",3909,354,61,0,14,0,0,0,4338
"29127960200",2804,200,4,1,69,0,4,4,3086
"29127960300",2928,477,0,15,51,32,6,0,3509
"29127960400",3040,559,180,67,41,94,44,51,4076
"29127960500",1847,816,265,15,87,0,9,0,3039
"29127960600",2555,335,186,1,112,0,24,0,3213
"29127960800",2251,476,186,83,135,15,204,29,3379
"29127960900",1895,611,204,274,39,0,10,0,3033
"29129470100",1195,353,6,4,29,0,0,0,1587
"29129470200",1677,389,4,1,25,0,8,31,2135
"29131962500",5232,718,0,0,202,100,18,0,6270
"29131962600",3012,355,0,0,62,0,42,31,3502
"29131962700",3338,823,0,0,12,30,0,39,4242
"29131962800",4361,1139,0,0,177,83,56,73,5889
"29131962900",2918,1811,0,2,43,59,47,70,4950
"29133950100",1623,306,56,32,6,22,0,0,2045
"29133950200",1980,531,1485,1118,34,0,93,0,5241
"29133950300",1316,399,52,7,6,0,3,0,1783
"29133950400",2818,1024,123,63,40,7,36,62,4173
"29135385100",3694,342,0,0,149,1,51,31,4268
"29135385200",3588,326,23,0,50,77,322,49,4435
"29135385300",2842,418,7,0,46,1,66,2,3382
"29135385400",2153,422,6,5,55,23,87,25,2776
"29137960100",2786,350,63,150,86,10,0,4,3449
"29137960200",1934,310,28,30,38,2,6,31,2379
"29137960300",2393,413,0,0,52,3,6,1,2868
"29139970100",1976,321,4,6,38,18,15,0,2378
"29139970200",2813,670,9,13,19,20,50,23,3617
"29139970300",2598,458,29,0,80,30,0,0,3195
"29139970400",2030,375,0,5,27,119,70,4,2630
"29141470100",4774,1328,0,0,237,3,24,2,6368
"29141470200",2921,634,0,0,22,6,62,51,3696
"29141470300",1723,603,78,17,11,116,49,0,2597
"29141470400",1887,793,0,0,16,0,62,27,2785
"29141470500",3627,1084,0,12,53,80,54,31,4941
"29143960100",3663,525,349,104,153,16,121,14,4945
"29143960200",1209,340,245,304,24,25,31,11,2189
"29143960300",2121,387,528,280,40,99,0,0,3455
"29143960400",1461,402,275,145,41,14,11,0,2349
"29143960500",1802,480,0,3,34,0,25,17,2361
"29143960600",2065,430,261,422,36,0,14,0,3228
"29145020100",2976,735,0,128,427,74,339,219,4898
"29145020200",3205,529,27,21,672,221,223,129,5027
"29145020300",3054,264,3,4,142,12,400,53,3932
"29145020400",5740,866,10,0,344,15,224,9,7208
"29145020501",3349,303,16,9,164,0,58,0,3899
"29145020502",4076,1029,15,0,221,73,166,0,5580
"29145020601",4477,372,6,11,427,28,121,62,5504
"29145020602",3733,498,86,0,353,0,11,0,4681
"29145020700",2772,703,33,0,654,104,17,6,4289
"29145020800",4645,1138,15,0,228,116,169,24,6335
"29145020900",3423,721,17,0,194,45,18,0,4418
"29145021000",3024,568,10,0,279,53,292,125,4351
"29147470100",1892,275,3,0,50,21,25,1,2267
"29147470200",2188,307,3,8,56,1,6,0,2569
"29147470300",3891,2049,14,15,97,29,30,76,6201
"29147470400",2556,1875,0,130,53,21,38,52,4725
"29147470500",3692,1014,3,5,26,8,40,18,4806
"29149480100",2321,1251,0,0,165,36,64,0,3837
"29149480200",3438,949,0,7,135,69,30,25,4653
"29149480300",1724,671,0,0,17,0,28,0,2440
"29151490100",3410,178,0,0,2,11,2,11,3614
"29151490200",3807,475,23,1,8,0,2,0,4316
"29151490300",3125,203,0,20,22,0,30,40,3440
"29151490400",1982,299,68,2,2,0,0,3,2356
"29153470100",3898,839,0,0,82,37,69,11,4936
"29153470200",3579,1033,0,0,104,10,58,0,4784
"29155470100",1682,383,119,33,40,13,39,2,2311
"29155470200",1305,250,923,897,15,17,41,2,3450
"29155470300",1580,434,516,643,19,33,19,11,3255
"29155470400",1360,397,387,719,15,13,23,121,3035
"29155470500",2434,507,109,28,77,22,78,0,3255
"29155470600",1916,490,117,365,38,0,40,4,2970
"29157470100",2272,205,0,0,6,106,0,70,2659
"29157470200",4126,638,0,0,31,0,0,0,4795
"29157470300",3067,631,0,0,141,43,209,48,4139
"29157470400",2861,457,0,0,31,16,6,10,3381
"29157470500",3814,127,30,0,0,0,9,0,3980
"29159480100",3169,407,2,0,58,109,19,6,3770
"29159480200",4716,447,40,0,470,130,536,135,6474
"29159480300",3116,751,13,0,185,23,80,134,4302
"29159480400",3248,584,31,0,90,0,74,59,4086
"29159480500",2526,301,0,0,50,15,0,18,2910
"29159480600",963,624,227,189,147,128,30,461,2769
"29159480700",2226,751,73,19,203,53,96,22,3443
"29159480800",1812,710,105,44,34,43,45,98,2891
"29159480900",1974,630,37,29,175,26,228,8,3107
"29159481000",3880,659,60,14,399,73,321,37,5443
"29159481100",3356,824,158,11,220,0,607,169,5345
"29161890100",3807,442,0,0,27,90,37,9,4412
"29161890200",3746,538,8,0,244,0,54,0,4590
"29161890300",4322,1625,0,136,481,184,19,254,7021
"29161890400",1350,1161,83,98,433,590,93,55,3863
"29161890500",3315,505,26,0,102,6,9,33,3996
"29161890600",2502,427,4,0,49,0,5,0,2987
"29161890700",2900,520,52,1,120,0,42,0,3635
"29161890800",1910,361,124,0,159,5,0,0,2559
"29161890900",3221,420,112,83,275,0,275,0,4386
"29161891000",4871,366,8,0,14,0,59,0,5318
"29163460100",2449,466,42,7,222,59,72,59,3376
"29163460200",2411,359,30,0,29,0,12,0,2841
"29163460300",3188,261,2,2,22,0,0,0,3475
"29163460400",3343,859,340,21,58,0,57,26,4704
"29163460500",1533,399,111,17,29,5,17,3,2114
"29165030001",5609,325,972,442,490,100,502,0,8440
"29165030002",1568,350,365,51,183,206,10,133,2866
"29165030101",2790,196,75,1,246,0,127,3,3438
"29165030102",2058,99,316,2,347,169,188,38,3217
"29165030103",4676,244,217,16,149,103,422,93,5920
"29165030201",1663,83,132,28,24,0,41,0,1971
"29165030205",5289,246,556,96,579,39,285,0,7090
"29165030207",4628,387,87,0,223,0,382,14,5721
"29165030208",2625,67,0,4,102,0,55,0,2853
"29165030209",6101,359,462,0,490,106,425,43,7986
"29165030210",1538,19,159,164,196,5,47,0,2128
"29165030211",2025,103,226,75,329,0,378,0,3136
"29165030305",6956,610,172,0,488,127,391,18,8762
"29165030306",3448,19,72,0,138,13,17,13,3720
"29165030307",0,0,0,0,0,0,0,0,0
"29165030308",3593,312,215,51,509,21,497,21,5219
"29165030401",4936,60,45,0,163,0,194,9,5407
"29165030500",4643,665,296,85,146,0,71,50,5956
"29165030600",6355,370,68,17,217,20,210,10,7267
"29165030700",3220,217,0,3,90,8,19,5,3562
"29167960100",4141,1303,8,10,159,120,94,39,5874
"29167960200",5220,1636,18,5,94,0,122,0,7095
"29167960300",6329,2052,0,0,152,124,72,0,8729
"29167960400",6528,1639,3,31,144,123,26,251,8745
"29169470101",3719,422,2,0,201,4,190,0,4538
"29169470102",2108,801,36,0,138,31,80,31,3225
"29169470286",2417,332,418,79,242,70,84,0,3642
"29169470287",5110,440,648,224,985,419,882,21,8729
"29169470389",1257,124,287,7,304,0,389,5,2373
"29169470390",996,55,533,32,212,19,345,0,2192
"29169470400",7612,692,1108,449,1044,111,750,50,11816
"29169470500",4298,748,257,64,147,55,233,39,5841
"29169470600",2413,198,752,31,396,96,429,5,4320
"29171960100",2361,341,0,0,5,0,4,0,2711
"29171960200",1514,540,15,1,36,30,29,9,2174
"29173470100",2822,452,10,0,24,3,0,0,3311
"29173470200",3153,200,14,0,106,38,22,0,3533
"29173470300",2831,270,1,1,54,23,44,45,3269
"29175490100",3058,509,9,22,56,26,62,9,3751
"29175490200",2874,371,10,106,54,11,79,0,3505
"29175490300",2458,1257,368,39,100,122,39,182,4565
"29175490400",2656,288,232,0,0,15,35,0,3226
"29175490500",3083,666,82,199,108,95,0,6,4239
"29175490600",3266,705,16,6,43,10,3,0,4049
"29177080000",6562,527,0,0,285,1,130,21,7526
"29177080100",3244,233,10,6,39,40,63,0,3635
"29177080200",4564,1167,121,7,34,104,12,74,6083
"29177080300",5118,502,24,39,177,30,51,7,5948
"29179380100",2050,851,19,9,37,24,14,72,3076
"29179380200",2760,676,5,2,42,24,21,2,3532
"29181870100",3353,675,0,0,157,0,19,4,4208
"29181870200",2036,673,0,0,34,47,55,9,2854
"29181870300",3047,1493,0,8,33,61,19,20,4681
"29181870400",1840,406,9,0,15,79,26,0,2375
"29183310100",2056,335,0,0,31,1,6,0,2429
"29183310201",3007,29,123,0,32,0,23,0,3214
"29183310202",3087,486,41,14,44,0,35,0,3707
"29183310301",4062,161,66,1,14,0,107,0,4411
"29183310302",2463,306,126,259,101,4,30,0,3289
"29183310400",1783,304,60,42,70,17,56,16,2348
"29183310501",2270,1097,118,169,377,257,544,761,5593
"29183310502",1953,295,203,62,35,29,26,15,2618
"29183310601",1166,322,10,196,34,37,56,36,1857
"29183310602",4778,82,319,43,134,47,90,27,5520
"29183310700",3560,476,185,123,129,0,45,36,4554
"29183310801",1875,98,71,0,156,19,50,6,2275
"29183310802",5014,197,165,31,283,56,319,0,6065
"29183310901",1408,166,465,0,46,91,20,0,2196
"29183310902",4374,516,59,310,46,0,167,0,5472
"29183310903",3524,305,121,6,68,88,23,46,4181
"29183311001",3477,101,247,0,373,0,190,0,4388
"29183311003",1887,224,247,28,482,68,263,132,3331
"29183311004",4037,338,130,0,398,0,23,0,4926
"29183311103",6059,209,86,0,93,13,46,0,6506
"29183311114",4330,55,195,0,85,0,53,0,4718
"29183311122",5069,353,297,270,753,15,257,0,7014
"29183311124",5708,93,111,0,538,31,172,0,6653
"29183311132",3270,10,88,0,25,0,22,0,3415
"29183311145",4408,21,118,0,237,0,32,0,4816
"29183311146",3479,31,177,9,429,12,103,0,4240
"29183311147",3720,189,108,0,34,0,0,189,4240
"29183311148",3993,65,20,10,265,0,218,0,4571
"29183311149",3149,160,88,0,358,68,186,0,4009
"29183311150",4106,83,229,0,185,0,74,16,4693
"29183311151",4404,95,262,148,716,0,0,0,5625
"29183311152",4447,198,206,0,128,0,85,12,5076
"29183311153",5892,77,194,0,358,17,7,0,6545
"29183311154",4412,94,73,0,355,0,167,0,5101
"29183311203",5098,135,244,18,382,18,188,0,6083
"29183311211",3659,155,408,42,172,0,117,24,4577
"29183311212",3350,114,96,0,176,0,52,24,3812
"29183311221",3160,271,65,0,73,23,157,17,3766
"29183311294",3505,137,187,1,141,0,174,128,4273
"29183311296",4109,102,0,0,166,12,65,0,4454
"29183311311",4884,80,255,0,186,65,184,0,5654
"29183311312",5494,232,116,0,115,13,111,0,6081
"29183311322",5191,138,274,0,208,0,38,0,5849
"29183311331",3970,148,267,0,207,15,150,15,4772
"29183311391",4376,31,215,6,131,0,224,0,4983
"29183311422",5293,134,243,0,102,36,109,13,5930
"29183311500",1654,321,44,33,89,24,13,45,2223
"29183311601",4908,392,153,0,182,0,0,95,5730
"29183311602",4675,226,121,0,325,26,237,26,5636
"29183311712",3885,126,161,0,210,0,244,0,4626
"29183311721",3100,97,142,28,249,0,68,0,3684
"29183311722",6106,514,255,48,128,0,160,0,7211
"29183311732",6511,158,492,1,245,0,213,0,7620
"29183311733",2315,41,64,0,140,0,137,0,2697
"29183311734",2882,225,108,108,246,59,37,89,3754
"29183311735",5669,38,218,1,208,0,79,0,6213
"29183311736",5379,18,506,0,593,0,170,0,6666
"29183311801",4876,187,426,0,121,0,145,0,5755
"29183311802",4684,573,193,47,110,27,37,0,5671
"29183311903",4950,339,80,15,154,0,47,0,5585
"29183311904",4680,567,226,66,600,0,329,14,6482
"29183311907",5335,465,296,0,341,0,0,0,6437
"29183311908",2467,166,252,0,127,0,122,0,3134
"29183311909",4210,131,214,0,164,0,92,0,4811
"29183312001",2449,72,0,0,10,0,10,1,2542
"29183312094",3257,114,375,65,129,58,78,30,4106
"29183312095",3694,183,61,46,202,0,144,0,4330
"29183312096",5882,137,155,0,146,0,55,0,6375
"29183312097",6716,122,122,0,175,4,250,0,7389
"29183312192",3228,162,8,11,57,24,40,0,3530
"29183312193",6353,51,107,17,113,0,75,0,6716
"29183312194",2550,250,135,2,0,0,84,0,3021
"29183312195",2348,297,163,278,100,0,0,0,3186
"29183312204",4890,137,0,0,66,0,0,0,5093
"29183312205",5085,813,326,60,200,53,185,53,6775
"29183312206",3577,154,77,0,437,0,41,0,4286
"29183312300",3037,60,0,3,29,0,0,0,3129
"29183312400",4012,454,188,27,269,33,58,0,5041
"29183980000",0,0,0,0,0,0,0,0,0
"29185480100",2432,857,0,14,90,39,86,26,3544
"29185480200",2383,501,0,0,56,8,43,0,2991
"29185480300",2279,613,0,1,118,21,22,0,3054
"29186960100",5477,674,4,0,12,0,55,0,6222
"29186960200",3699,798,102,0,218,0,7,44,4868
"29186960300",3853,266,10,0,16,0,0,0,4145
"29186960400",2188,360,8,0,0,0,3,45,2604
"29187950101",3320,1031,0,0,79,0,45,0,4475
"29187950102",3953,714,6,0,84,18,28,17,4820
"29187950300",3219,774,7,24,20,39,16,8,4107
"29187950400",5149,1351,0,14,71,75,42,70,6772
"29187950600",2400,821,0,0,45,24,41,4,3335
"29187950700",6186,1266,0,0,4,0,91,0,7547
"29187950800",5045,832,5,16,111,67,108,13,6197
"29187950901",1818,381,5,0,26,0,0,0,2230
"29187950902",3615,466,26,6,82,0,30,0,4225
"29187951000",4901,1818,30,5,42,0,42,8,6846
"29187951100",5980,1294,33,21,19,81,9,14,7451
"29189210100",2195,104,2230,1564,67,286,34,115,6595
"29189210200",793,37,3718,1751,0,132,16,0,6447
"29189210300",803,159,1593,898,47,39,59,66,3664
"29189210400",384,19,3341,773,40,45,22,0,4624
"29189210501",242,0,2025,1298,130,88,0,0,3783
"29189210502",108,18,2475,896,25,64,0,0,3586
"29189210600",1445,277,3466,1002,77,136,21,0,6424
"29189210702",1040,116,3744,1046,206,90,32,0,6274
"29189210703",521,108,2526,502,140,0,0,0,3797
"29189210704",393,80,1947,1382,111,60,28,33,4034
"29189210803",1580,29,2615,119,126,15,0,0,4484
"29189210804",1108,91,6721,672,451,44,38,0,9125
"29189210805",647,154,4447,611,30,24,29,1,5943
"29189210806",559,97,3979,1117,97,68,16,0,5933
"29189210912",2776,250,3762,85,320,0,57,87,7337
"29189210921",1831,72,1634,338,120,0,19,0,4014
"29189210923",3298,207,1661,377,261,28,37,23,5892
"29189210924",1541,44,2358,151,357,71,97,3,4622
"29189210925",2573,424,1981,62,153,0,22,0,5215
"29189210926",1637,148,857,87,87,4,11,0,2831
"29189210927",2285,18,2144,136,106,0,217,0,4906
"29189210928",1685,0,2062,97,291,79,112,0,4326
"29189211000",3413,548,2393,190,616,0,11,0,7171
"29189211101",4124,349,1659,204,186,34,55,18,6629
"29189211102",1500,176,1971,405,182,0,54,0,4288
"29189211201",2569,394,1787,272,62,81,51,49,5265
"29189211202",2763,346,165,1,49,8,0,0,3332
"29189211301",4426,159,531,414,515,8,111,35,6199
"29189211331",4467,299,905,243,155,59,47,0,6175
"29189211332",5082,219,513,106,225,280,98,186,6709
"29189211333",2946,216,1764,67,168,76,25,12,5274
"29189211334",3203,162,355,17,144,46,119,0,4046
"29189211401",3035,510,1006,172,363,0,91,344,5521
"29189211402",994,79,896,80,110,6,0,17,2182
"29189211500",145,8,2465,788,43,104,48,104,3705
"29189211600",2234,137,2532,857,286,362,138,2,6548
"29189211700",2018,226,1622,355,35,14,91,0,4361
"29189211801",645,45,2678,748,96,180,1,0,4393
"29189211802",455,29,1771,767,24,85,27,0,3158
"29189211900",481,27,2311,2031,267,92,35,0,5244
"29189212001",538,35,5138,1872,0,0,0,0,7583
"29189212002",136,13,2100,467,26,70,0,13,2825
"29189212101",314,61,2296,1407,73,3,37,29,4220
"29189212102",152,13,2418,814,46,5,0,0,3448
"29189212200",118,16,4088,1930,35,0,10,23,6220
"29189212300",567,100,3000,1081,177,12,4,6,4947
"29189212400",151,79,1540,701,16,100,0,36,2623
"29189212500",1080,34,2522,1199,0,145,58,0,5038
"29189212600",2103,272,1275,852,258,171,64,18,5013
"29189212700",1072,149,3438,855,39,28,0,1,5582
"29189213101",3029,416,545,136,188,0,308,24,4646
"29189213102",241,66,34,12,38,0,33,0,424
"29189213202",4227,402,572,11,1167,11,260,208,6858
"29189213203",3420,202,469,281,247,24,27,0,4670
"29189213204",1641,236,456,268,675,253,499,212,4240
"29189213300",3814,530,1792,595,767,146,335,62,8041
"29189213400",3349,869,1491,742,712,82,262,122,7629
"29189213500",2695,465,1114,221,146,10,204,53,4908
"29189213600",522,219,2180,1176,107,135,12,51,4402
"29189213700",1100,190,2834,528,168,121,7,36,4984
"29189213800",115,3,3575,1537,75,78,31,10,5424
"29189213900",5,17,1047,1072,5,4,5,0,2155
"29189214100",0,0,1055,366,63,0,0,0,1484
"29189214200",166,58,2200,931,28,6,0,0,3389
"29189214300",894,212,1518,628,137,136,72,102,3699
"29189214400",2900,485,1005,487,171,0,324,29,5401
"29189214500",2320,245,349,139,115,47,65,13,3293
"29189214601",2961,465,372,116,147,37,90,2,4190
"29189214602",2758,401,628,71,118,9,112,126,4223
"29189214700",3584,847,1150,462,580,131,418,158,7330
"29189214800",3801,579,556,80,306,89,101,180,5692
"29189214900",4134,398,1009,529,392,38,608,157,7265
"29189215001",1341,38,157,85,737,165,170,0,2693
"29189215003",3836,180,169,101,194,0,65,0,4545
"29189215004",1823,350,496,12,217,23,22,23,2966
"29189215005",3698,506,680,19,769,144,110,0,5926
"29189215102",3476,255,320,0,739,38,479,38,5345
"29189215103",1659,47,278,0,328,0,92,0,2404
"29189215105",1847,96,87,32,379,7,118,0,2566
"29189215141",3402,43,344,11,517,0,25,14,4356
"29189215142",4157,463,1027,159,1206,121,498,59,7690
"29189215143",2565,138,116,27,17,18,0,0,2881
"29189215144",4409,261,587,17,738,0,327,0,6339
"29189215201",3803,357,596,26,1008,161,228,16,6195
"29189215202",4695,319,453,7,869,15,75,0,6433
"29189215231",3690,325,163,0,368,8,155,0,4709
"29189215232",5995,104,90,30,1574,0,70,0,7863
"29189215301",3494,247,139,26,567,0,18,15,4506
"29189215302",2884,24,94,0,131,2,57,0,3192
"29189215400",4678,54,32,0,250,0,72,0,5086
"29189215500",3665,108,437,0,554,36,55,36,4891
"29189215600",2009,219,1558,371,678,88,358,153,5434
"29189215700",1005,171,3167,515,197,670,292,267,6284
"29189215800",5449,362,1177,124,426,189,336,56,8119
"29189215900",1721,179,3892,837,121,0,97,0,6847
"29189216000",111,27,1542,213,18,0,8,0,1919
"29189216100",2355,912,618,607,385,337,75,107,5396
"29189216200",5819,506,655,14,386,284,167,14,7845
"29189216300",2353,278,34,0,226,118,64,0,3073
"29189216400",4608,199,305,32,675,125,65,0,6009
"29189216500",2952,182,0,18,366,24,111,18,3671
"29189216600",1586,113,49,0,83,0,33,0,1864
"29189216700",2451,99,666,90,143,31,52,1,3533
"29189216800",2626,232,72,0,119,99,157,25,3330
"29189216900",1374,222,412,106,38,58,95,59,2364
"29189217000",2614,533,184,300,159,73,23,0,3886
"29189217200",1294,153,146,76,195,72,36,0,1972
"29189217300",2604,118,126,15,316,118,177,0,3474
"29189217400",3839,141,59,19,303,0,114,0,4475
"29189217500",4876,88,83,0,240,0,138,0,5425
"29189217600",6638,241,74,0,260,0,93,4,7310
"29189217701",4298,207,54,0,490,77,125,0,5251
"29189217702",5559,227,151,46,640,55,62,0,6740
"29189217802",5945,29,60,2,700,0,259,0,6995
"29189217806",5100,335,124,3,108,154,135,0,5959
"29189217807",5465,126,257,9,199,15,41,0,6112
"29189217841",4595,115,124,0,574,129,368,0,5905
"29189217842",5796,74,254,20,479,137,174,16,6950
"29189217851",2862,20,150,0,127,0,27,0,3186
"29189217852",5491,29,67,0,379,8,64,0,6038
"29189217921",4285,74,10,0,305,0,112,0,4786
"29189217923",5946,382,285,1,659,15,201,13,7502
"29189217931",5579,201,95,18,496,0,255,6,6650
"29189217932",3544,100,52,0,757,21,43,0,4517
"29189217941",4658,266,165,310,330,0,179,0,5908
"29189217942",4490,206,71,0,410,33,15,0,5225
"29189217943",3173,32,34,8,430,0,101,0,3778
"29189217944",5068,85,66,0,557,0,59,0,5835
"29189218003",6341,263,137,0,678,0,262,0,7681
"29189218011",4865,534,250,172,973,122,402,96,7414
"29189218012",4080,102,20,26,92,0,27,0,4347
"29189218102",2565,217,17,260,388,0,0,0,3447
"29189218103",3865,634,79,0,499,91,95,26,5289
"29189218201",2787,108,40,0,67,0,15,0,3017
"29189218300",3193,153,228,9,174,21,56,0,3834
"29189218401",3780,62,0,9,17,36,20,0,3924
"29189218402",4060,199,133,0,178,0,110,0,4680
"29189218500",4483,180,41,1,37,42,108,0,4892
"29189218600",1900,81,453,167,56,19,30,0,2706
"29189218800",5430,240,13,0,212,18,81,0,5994
"29189218900",3749,364,1644,186,415,0,214,0,6572
"29189219100",3549,193,62,9,69,0,53,0,3935
"29189219200",2042,119,77,10,99,0,17,7,2371
"29189219300",1611,96,155,38,59,30,47,0,2036
"29189219400",5605,358,96,0,96,89,197,0,6441
"29189219500",5708,176,0,278,146,20,231,0,6559
"29189219600",5199,521,189,25,440,9,126,48,6557
"29189219700",5092,465,191,19,209,106,97,31,6210
"29189219800",5864,592,236,78,584,68,106,122,7650
"29189219900",5032,444,7,0,599,0,90,0,6172
"29189220001",4485,194,48,0,36,0,131,0,4894
"29189220002",2759,152,36,8,206,0,28,0,3189
"29189220100",5731,1093,154,12,402,183,69,0,7644
"29189220200",4764,360,51,6,79,0,108,19,5387
"29189220300",1175,433,76,35,36,60,15,4,1834
"29189220431",6933,531,117,16,321,110,543,34,8605
"29189220432",7449,214,77,24,270,0,103,0,8137
"29189220441",5725,148,0,1,184,0,163,0,6221
"29189220442",3975,242,9,0,124,1,72,0,4423
"29189220443",3474,269,43,73,194,0,77,0,4130
"29189220444",7337,150,83,0,160,154,15,0,7899
"29189220445",4635,67,0,1,55,0,41,9,4808
"29189220446",4365,109,143,0,36,7,128,0,4788
"29189220501",4957,858,109,73,116,27,101,0,6241
"29189220502",5002,730,172,157,199,186,124,0,6570
"29189220601",5360,297,21,99,354,11,86,8,6236
"29189220602",4725,629,88,0,266,0,107,0,5815
"29189220701",2354,319,61,0,25,2,58,53,2872
"29189220702",3280,133,0,0,95,0,12,0,3520
"29189220703",2374,52,0,0,60,0,48,0,2534
"29189220801",4385,617,49,0,96,94,89,309,5639
"29189220802",4101,135,37,126,311,27,29,0,4766
"29189220803",4323,98,14,35,224,0,111,0,4805
"29189221000",2026,101,455,123,122,26,157,6,3016
"29189221100",1750,56,2,3,68,13,8,9,1909
"29189221201",2993,398,28,0,105,0,0,0,3524
"29189221202",5605,324,0,0,78,0,0,0,6007
"29189221301",7009,524,31,0,125,0,38,0,7727
"29189221302",5863,223,164,0,244,12,123,0,6629
"29189221332",4443,55,6,0,203,0,45,0,4752
"29189221335",5316,18,128,0,190,0,115,0,5767
"29189221421",6255,154,22,0,214,0,150,0,6795
"29189221422",7802,557,15,1,218,98,173,0,8864
"29189221423",3564,294,79,0,52,0,4,0,3993
"29189221424",4512,210,8,0,138,9,30,0,4907
"29189221502",5359,85,19,1,214,1,126,0,5805
"29189221503",5087,210,54,1,176,52,134,0,5714
"29189221506",4631,21,20,0,267,0,84,0,5023
"29189221621",3870,125,26,0,49,131,16,0,4217
"29189221624",3095,126,41,0,221,0,18,0,3501
"29189221625",5681,694,89,44,246,25,227,0,7006
"29189221626",5868,181,149,9,321,0,185,0,6713
"29189221627",5696,93,201,0,349,0,193,10,6542
"29189221628",4947,441,185,0,784,66,280,0,6703
"29189221629",4593,142,10,7,549,0,120,44,5465
"29189221800",268,32,2149,608,0,76,124,0,3257
"29189221900",2841,135,87,1,250,0,144,11,3469
"29189222000",3374,63,40,0,29,17,58,19,3600
"29189222100",4741,45,139,0,113,0,107,0,5145
"29195090100",1806,412,148,34,123,3,120,11,2657
"29195090200",2103,142,13,0,34,23,0,0,2315
"29195090300",1767,644,279,0,374,155,307,185,3711
"29195090400",1671,400,241,74,225,0,342,0,2953
"29195090500",2417,484,42,9,239,113,257,31,3592
"29195090600",1691,408,92,25,199,315,174,371,3275
"29195090700",1950,364,78,0,52,4,4,2,2454
"29195090800",2154,420,13,2,51,26,36,123,2825
"29197470100",1435,518,14,5,24,0,7,1,2004
"29197470200",1793,501,2,16,19,0,0,0,2331
"29199480100",2406,421,0,0,6,1,57,2,2893
"29199480200",1441,434,0,0,7,0,16,0,1898
"29201780100",2381,672,24,1,130,67,94,0,3369
"29201780200",3212,874,0,0,89,0,48,0,4223
"29201780300",2209,398,0,25,36,23,44,8,2743
"29201780400",4215,956,122,79,156,38,46,56,5668
"29201780600",3123,404,409,8,72,8,5,5,4034
"29201780700",1179,181,1054,357,35,0,56,37,2899
"29201781000",3153,603,1,7,7,0,3,67,3841
"29201781100",2819,537,0,0,11,0,9,0,3376
"29201781200",3201,816,1096,642,148,127,127,110,6267
"29201781300",2093,293,233,243,46,0,15,0,2923
"29203470100",2725,463,5,0,21,211,0,0,3425
"29203470200",3417,1396,0,7,33,15,65,84,5017
"29205450100",1681,208,0,41,17,3,10,3,1963
"29205450200",1934,493,0,8,2,7,0,0,2444
"29205450300",1320,355,0,0,13,3,20,13,1724
"29207470100",3041,650,2,13,14,19,17,0,3756
"29207470200",3599,717,18,25,3,2,88,6,4458
"29207470300",3459,568,0,21,51,0,65,0,4164
"29207470400",2739,270,51,26,28,21,17,17,3169
"29207470500",2427,866,0,0,29,0,59,14,3395
"29207470600",4349,376,90,0,47,26,33,0,4921
"29207470700",1898,520,4,163,139,0,0,0,2724
"29207470800",2821,84,11,0,6,0,77,0,2999
"29209090100",5793,1025,0,0,314,149,48,54,7383
"29209090200",3635,899,0,0,462,138,85,35,5254
"29209090400",4274,752,0,0,252,26,2,26,5332
"29209090500",4529,674,2,2,280,22,54,5,5568
"29209090601",2624,149,2,0,303,10,36,0,3124
"29209090602",3230,1202,0,9,367,308,117,112,5345
"29211480100",1863,217,0,0,39,16,39,10,2184
"29211480200",1057,240,6,0,64,6,33,10,1416
"29211480300",2101,570,74,11,187,42,766,336,4087
"29213480105",4599,724,43,0,369,46,216,31,6028
"29213480106",1510,513,100,0,24,150,327,152,2776
"29213480201",7352,1310,95,9,320,200,32,228,9546
"29213480202",5136,1886,3,5,216,281,270,259,8056
"29213480301",4359,379,49,7,288,7,305,47,5441
"29213480302",3417,581,0,0,67,0,11,16,4092
"29213480401",3626,1091,27,0,139,143,93,21,5140
"29213480402",2170,632,3,16,42,60,0,8,2931
"29213480501",1750,207,0,0,37,45,0,0,2039
"29213480502",5041,1098,0,0,361,155,496,80,7231
"29215480100",4994,710,65,0,282,181,191,24,6447
"29215480200",3523,1526,0,0,150,17,9,0,5225
"29215480300",5136,1232,4,1,63,31,0,81,6548
"29215480400",4530,1406,43,0,160,54,110,7,6310
"29217950100",2030,716,0,0,95,68,0,11,2920
"29217950200",1838,529,0,0,49,0,0,0,2416
"29217950300",4164,1114,17,16,95,27,0,222,5655
"29217950400",2155,1053,15,0,72,12,0,6,3313
"29217950500",2776,177,1,0,71,1,10,0,3036
"29217950600",2433,505,4,0,30,0,69,2,3043
"29219820101",5556,1082,35,42,123,32,58,271,7199
"29219820102",6119,1184,127,31,208,152,51,66,7938
"29219820103",6271,844,168,50,285,60,104,0,7782
"29219820201",2103,259,0,0,49,124,20,124,2679
"29219820202",6628,444,82,17,280,3,275,9,7738
"29221460100",4462,1908,19,1,76,85,0,0,6551
"29221460200",4296,995,0,0,63,4,84,52,5494
"29221460300",2508,775,48,28,95,29,113,0,3596
"29221460400",3357,1075,0,0,17,0,0,0,4449
"29221460500",3194,646,0,0,135,40,0,0,4015
"29223690100",2493,425,0,0,8,0,0,21,2947
"29223690200",2570,845,0,4,111,1,0,0,3531
"29223690300",3251,981,32,0,91,58,24,78,4515
"29223690400",1751,571,17,0,32,12,32,0,2415
"29225470101",4146,339,0,0,18,52,112,49,4716
"29225470102",4749,520,82,0,136,132,85,0,5704
"29225470201",4089,498,21,0,122,112,86,75,5003
"29225470202",2686,1003,0,9,151,16,102,0,3967
"29225470301",4337,938,2,75,109,6,50,0,5517
"29225470302",3377,1665,11,3,19,11,0,0,5086
"29225470401",2714,787,0,6,48,40,42,0,3637
"29225470402",1844,490,2,0,59,4,3,0,2402
"29227960100",1782,261,0,0,9,12,10,0,2074
"29229490100",2572,947,0,0,48,41,0,8,3616
"29229490200",2952,1100,38,0,0,0,19,5,4114
"29229490300",3451,1417,8,6,177,51,14,3,5127
"29229490400",4047,1242,2,1,27,258,22,199,5798
"29510101100",2065,149,115,0,152,75,135,75,2766
"29510101200",2356,345,131,13,135,7,97,9,3093
"29510101300",3161,389,199,47,383,45,101,0,4325
"29510101400",1395,293,414,46,304,33,77,15,2577
"29510101500",1756,420,419,527,157,63,285,4,3631
"29510101800",1710,600,189,317,253,77,413,119,3678
"29510102100",2217,296,87,73,160,0,165,0,2998
"29510102200",6206,239,119,11,64,47,498,21,7205
"29510102300",1640,208,15,0,13,0,16,0,1892
"29510102400",1921,314,113,52,102,12,70,16,2600
"29510102500",1612,163,55,12,73,112,64,12,2103
"29510103100",2570,194,280,23,101,25,42,9,3244
"29510103400",1520,225,23,16,14,1,38,0,1837
"29510103600",1011,161,53,70,182,0,22,0,1499
"29510103700",1826,277,98,0,227,22,121,16,2587
"29510103800",3272,122,146,7,166,0,139,0,3852
"29510104200",2765,227,302,102,171,185,185,21,3958
"29510104500",1164,98,145,20,69,31,33,0,1560
"29510105198",1959,683,300,177,277,176,78,10,3660
"29510105200",980,167,1194,286,194,106,22,35,2984
"29510105300",115,19,1301,932,32,0,40,0,2439
"29510105400",236,138,1229,718,71,47,190,106,2735
"29510105500",283,0,1826,517,170,0,0,0,2796
"29510106100",1,0,968,936,6,23,0,1,1935
"29510106200",43,0,742,900,0,5,0,0,1690
"29510106300",0,0,676,635,0,5,0,5,1321
"29510106400",9,0,1682,790,12,0,12,0,2505
"29510106500",0,11,1817,677,0,0,0,0,2505
"29510106600",0,0,1003,1135,4,0,0,0,2142
"29510106700",23,11,1823,1127,10,83,0,24,3101
"29510107200",4,0,662,194,10,0,0,0,870
"29510107300",36,0,3309,1409,27,0,17,5,4803
"29510107400",11,8,1700,1007,0,17,0,0,2743
"29510107500",0,0,1970,484,16,6,0,0,2476
"29510107600",36,3,1496,1106,0,0,0,0,2641
"29510108100",129,17,2290,673,1,0,51,0,3161
"29510108200",53,4,1505,579,24,33,21,0,2219
"29510108300",93,18,1416,691,11,7,0,7,2243
"29510109600",27,0,2485,1094,71,22,22,0,3721
"29510109700",55,142,1149,1360,9,14,0,32,2761
"29510110100",0,1,2027,852,8,0,0,0,2888
"29510110200",20,2,1393,1031,6,0,15,0,2467
"29510110300",0,0,1825,721,0,0,0,0,2546
"29510110400",0,2,1671,424,43,0,0,0,2140
"29510110500",55,0,1019,493,10,0,0,0,1577
"29510111100",34,33,945,643,11,0,0,0,1666
"29510111200",5,11,603,581,3,10,0,0,1213
"29510111300",0,0,814,490,0,0,0,0,1304
"29510111400",1,3,811,482,0,12,0,0,1309
"29510111500",2,1,495,433,0,0,0,0,931
"29510112100",2363,311,953,308,364,0,35,0,4334
"29510112200",76,5,1133,556,25,0,43,0,1838
"29510112300",9,0,1289,1074,0,0,0,0,2372
"29510112400",2036,664,504,204,176,133,80,29,3826
"29510113500",1967,180,0,4,18,0,0,0,2169
"29510114101",2604,462,748,238,281,135,102,19,4589
"29510114102",3731,295,61,41,0,0,184,0,4312
"29510114200",3514,310,332,311,114,8,101,0,4690
"29510114300",4091,412,398,66,510,25,454,1,5957
"29510115100",2651,485,365,70,154,100,187,27,4039
"29510115200",1103,354,492,605,290,185,98,146,3273
"29510115300",2199,609,895,500,541,294,166,431,5635
"29510115400",1730,537,330,165,235,116,105,103,3321
"29510115500",2133,1340,1587,761,129,120,344,0,6414
"29510115600",1569,551,703,1719,291,92,170,163,5258
"29510115700",903,200,1148,996,116,174,90,119,3746
"29510116100",1520,367,830,609,441,95,170,145,4177
"29510116200",2503,153,768,327,465,18,245,0,4479
"29510116301",1867,184,516,220,233,170,130,35,3355
"29510116302",380,107,665,317,851,260,191,117,2888
"29510116400",703,473,2131,1122,349,130,465,57,5430
"29510116500",1748,371,1054,483,517,102,153,127,4555
"29510117100",1008,53,194,5,93,66,40,0,1459
"29510117200",2411,411,1024,1338,187,208,57,16,5652
"29510117400",1697,342,1274,271,638,96,88,8,4414
"29510118100",210,68,503,315,30,0,31,0,1157
"29510118400",138,104,175,148,0,0,5,9,579
"29510118600",1012,350,708,482,128,161,94,35,2970
"29510119101",957,299,520,454,237,207,41,39,2754
"29510119102",1552,386,213,200,308,221,17,28,2925
"29510119200",604,62,589,142,148,15,21,0,1581
"29510119300",308,744,620,316,81,298,39,32,2438
"29510120200",218,0,428,713,0,0,11,0,1370
"29510121100",92,106,921,541,9,17,0,0,1686
"29510121200",0,6,789,1269,5,3,30,0,2102
"29510123100",774,112,1924,504,237,23,96,11,3681
"29510123200",1165,116,393,481,78,17,6,0,2256
"29510123300",1695,157,398,311,86,7,26,21,2701
"29510124100",889,421,1888,1551,209,165,67,182,5372
"29510124200",826,129,1000,962,224,277,141,261,3820
"29510124300",1611,328,632,244,78,0,141,0,3034
"29510124600",555,132,367,637,100,94,7,80,1972
"29510125500",1467,335,527,134,141,37,75,0,2716
"29510125600",1875,164,1059,346,151,47,34,58,3734
"29510125700",20,21,1267,2206,9,0,0,0,3523
"29510126600",354,236,1429,1138,48,5,90,0,3300
"29510126700",199,254,438,483,12,0,0,0,1386
"29510126800",2559,355,437,13,375,39,128,37,3943
"29510126900",17,91,3113,1619,57,17,23,10,4947
"29510127000",181,53,527,413,13,9,0,8,1204
"29510127100",30,10,1086,823,7,0,4,5,1965
"29510127200",2705,400,260,139,227,40,69,0,3840
"29510127300",950,262,1400,753,86,12,65,87,3615
"29510127400",1013,44,1293,2479,30,0,51,0,4910
"29510127500",329,19,1093,734,170,18,0,0,2363
"29510127600",2239,347,463,174,57,0,52,11,3343
"30001000100",1205,189,2,1,13,0,37,35,1482
"30001000200",2965,267,0,0,125,5,95,0,3457
"30001000300",2923,824,0,0,195,30,90,30,4092
"30003000100",2651,272,0,0,1277,451,310,78,5039
"30003940400",177,32,0,0,860,629,42,0,1740
"30003940500",301,83,0,0,522,174,25,2,1107
"30003940600",475,13,0,0,1908,1014,84,16,3510
"30003940700",206,42,0,0,1082,528,12,0,1870
"30005000100",767,190,0,0,331,145,17,1,1451
"30005000200",1726,385,11,0,87,48,56,16,2329
"30005940100",0,2,0,0,831,581,20,6,1440
"30005940200",40,1,0,0,800,509,2,0,1352
"30007000100",1693,346,0,0,47,42,38,8,2174
"30007000200",3135,178,0,26,151,0,0,0,3490
"30009000100",2169,161,9,0,63,6,40,0,2448
"30009000200",1836,242,0,0,77,8,63,18,2244
"30009000300",1916,383,0,0,42,23,0,49,2413
"30009000400",1563,153,0,0,39,0,29,0,1784
"30009000500",1164,125,0,0,27,10,16,0,1342
"30011000300",1032,159,0,0,10,7,12,0,1220
"30013000100",1951,458,0,65,121,33,16,119,2763
"30013000200",3266,137,55,0,648,18,93,0,4217
"30013000300",2183,283,0,0,183,352,3,0,3004
"30013000400",1371,289,4,0,92,227,87,8,2078
"30013000700",1140,306,71,50,127,244,13,17,1968
"30013000800",1401,177,13,0,172,0,57,0,1820
"30013000900",2110,419,0,0,295,217,177,22,3240
"30013001000",2573,236,36,0,131,22,9,0,3007
"30013001100",3134,870,40,0,129,241,87,39,4540
"30013001200",2447,211,210,63,357,6,263,159,3716
"30013001600",2734,1644,7,16,261,147,99,162,5070
"30013001700",1880,138,0,0,243,1,56,0,2318
"30013001800",2833,215,61,0,383,105,86,39,3722
"30013001900",5166,87,0,0,328,0,97,0,5678
"30013002100",3129,601,13,0,221,73,199,0,4236
"30013002200",5034,623,49,0,464,60,159,18,6407
"30013002300",6784,219,50,0,128,63,147,0,7391
"30013010100",2898,544,0,0,286,20,97,0,3845
"30013010400",1551,124,0,0,23,19,0,0,1717
"30013010600",3330,376,13,0,124,75,48,9,3975
"30013010700",3332,485,14,0,227,37,87,0,4182
"30013010800",1724,838,82,0,78,467,150,178,3517
"30015010200",1727,170,0,0,29,0,14,0,1940
"30015010300",2102,323,0,0,609,745,36,53,3868
"30017961300",1699,225,11,0,26,7,32,11,2011
"30017961500",1301,307,0,0,125,16,22,16,1787
"30017961600",1676,268,0,4,74,0,33,0,2055
"30017961800",1358,79,0,0,73,6,28,0,1544
"30017961900",1821,171,0,0,38,0,26,0,2056
"30017962000",1684,328,0,11,0,91,91,26,2231
"30019020300",1537,129,0,0,32,47,32,0,1777
"30021000100",1207,223,0,0,20,0,10,0,1460
"30021000200",2242,450,0,0,24,0,28,11,2755
"30021000300",3620,694,10,0,116,15,135,0,4590
"30023000300",1937,701,98,11,56,59,23,59,2944
"30023000400",2695,311,21,0,24,56,62,21,3190
"30023000500",2075,624,0,2,185,60,24,42,3012
"30025000100",2767,179,0,0,78,0,14,0,3038
"30027030100",3795,957,0,0,133,52,16,38,4991
"30027030200",5535,531,0,0,199,12,98,37,6412
"30029000100",2197,732,0,19,238,0,58,34,3278
"30029000201",3347,847,0,0,40,92,108,0,4434
"30029000202",2151,209,0,0,393,0,219,0,2972
"30029000203",3202,840,0,0,270,45,0,170,4527
"30029000300",3990,304,18,0,77,0,97,0,4486
"30029000401",4247,750,0,0,62,56,65,17,5197
"30029000402",2248,268,0,0,19,25,73,0,2633
"30029000601",3204,364,0,0,188,50,42,25,3873
"30029000602",3652,240,37,0,55,4,68,19,4075
"30029000700",4511,660,0,0,82,77,72,0,5402
"30029000800",6012,704,0,0,72,67,0,0,6855
"30029000900",5719,1185,0,0,406,191,327,31,7859
"30029001000",1247,370,0,0,91,0,8,0,1716
"30029001100",4254,892,0,0,207,52,3,52,5460
"30029001200",6210,735,37,0,275,13,173,13,7456
"30029001301",3203,218,0,0,37,0,71,0,3529
"30029001302",4043,795,0,0,142,30,155,5,5170
"30029001400",4418,803,74,0,136,35,69,19,5554
"30029001700",6662,1108,0,6,198,29,154,60,8217
"30031000101",4629,262,0,0,90,0,58,10,5049
"30031000102",1662,155,10,0,51,0,35,0,1913
"30031000103",6014,1083,0,0,142,92,145,100,7576
"30031000200",8226,972,0,0,228,1,298,173,9898
"30031000300",2590,347,0,0,60,25,46,11,3079
"30031000400",4291,275,25,0,64,8,27,47,4737
"30031000501",1823,65,0,0,11,2,27,1,1929
"30031000502",4903,293,13,0,154,0,56,0,5419
"30031000503",8000,1100,0,0,391,249,131,47,9918
"30031000504",1680,132,0,0,6,15,15,21,1869
"30031000600",1557,613,0,0,113,106,187,34,2610
"30031000701",2496,430,0,14,25,61,41,30,3097
"30031000702",4578,783,70,0,213,142,188,28,6002
"30031000800",1638,328,0,2,18,88,16,40,2130
"30031000900",2049,1449,0,21,173,86,66,71,3915
"30031001001",2896,425,37,0,61,19,8,0,3446
"30031001002",3515,348,9,0,150,73,143,88,4326
"30031001101",436,845,7,21,278,246,0,22,1855
"30031001102",1380,351,0,0,103,45,21,0,1900
"30031001200",4298,299,0,0,110,52,51,31,4841
"30031001500",1776,222,50,0,26,25,47,104,2250
"30031001600",2126,159,0,0,5,4,39,7,2340
"30033000100",1008,112,0,0,11,8,4,0,1143
"30035940200",129,70,8,0,2529,2710,20,0,5466
"30035940400",910,288,0,0,2296,791,101,32,4418
"30035976000",2589,251,0,0,310,348,14,39,3551
"30035980000",25,20,0,0,2,0,0,0,47
"30037000100",553,145,0,0,9,2,0,3,712
"30039961700",2520,443,0,4,62,14,36,15,3094
"30041040100",999,179,0,0,21,0,0,0,1199
"30041040200",1734,237,0,0,134,1,72,2,2180
"30041040300",1928,758,0,10,376,381,37,54,3544
"30041040400",3218,477,14,0,428,213,48,39,4437
"30041040500",1889,47,0,0,222,8,87,0,2253
"30041940300",113,20,0,0,1816,671,40,24,2684
"30043962201",3670,34,2,0,135,0,56,0,3897
"30043962202",3338,503,20,0,164,27,106,0,4158
"30043962300",2889,272,0,0,102,34,58,13,3368
"30045000100",1766,253,0,0,23,1,37,0,2080
"30047000100",1215,243,10,0,12,1,29,54,1564
"30047000200",1326,166,0,0,52,11,44,18,1617
"30047940301",2833,760,0,0,696,483,93,77,4942
"30047940303",4008,877,0,0,721,397,107,49,6159
"30047940400",1680,482,0,0,1053,662,123,114,4114
"30047940500",2437,466,18,0,1250,673,211,57,5112
"30047940600",1943,370,0,0,1521,229,33,10,4106
"30047940700",837,221,0,19,502,306,29,37,1951
"30049000100",1394,237,0,0,43,23,26,29,1752
"30049000200",4265,204,0,11,398,14,58,61,5011
"30049000300",2255,148,0,0,87,0,55,0,2545
"30049000400",4467,1158,0,0,158,131,125,58,6097
"30049000501",3132,319,42,0,424,14,39,0,3970
"30049000502",5149,808,86,16,160,112,95,0,6426
"30049000600",2333,77,0,0,72,5,16,0,2503
"30049000700",6022,668,0,0,384,0,117,33,7224
"30049000800",2559,531,0,18,108,75,35,24,3350
"30049000900",2871,366,44,0,185,155,109,84,3814
"30049001000",3407,332,24,0,211,0,140,0,4114
"30049001100",4425,466,0,0,62,49,0,59,5061
"30049001201",5746,392,4,0,544,28,280,0,6994
"30049001202",4668,128,24,0,260,0,149,0,5229
"30051050100",1785,422,0,19,51,48,0,14,2339
"30053000100",2753,541,0,0,77,35,80,0,3486
"30053000200",1661,577,0,0,73,39,16,19,2385
"30053000300",2821,756,20,0,214,28,168,12,4019
"30053000400",5193,890,0,7,158,11,66,29,6354
"30053000500",2796,579,0,0,102,0,62,15,3554
"30055954000",1577,131,0,0,59,0,20,0,1787
"30057000100",2936,215,0,25,64,17,101,17,3375
"30057000200",2162,185,3,4,31,7,61,4,2457
"30057000300",1686,209,8,0,76,0,23,0,2002
"30059000100",1578,247,0,0,36,6,8,21,1896
"30061964500",1643,248,0,27,11,9,8,9,1955
"30061964600",1666,471,0,0,26,1,0,57,2221
"30063000100",5001,842,53,0,358,147,172,0,6573
"30063000201",4998,1780,0,113,302,285,291,70,7839
"30063000202",9240,1102,0,0,568,77,181,11,11179
"30063000300",1028,839,0,1,147,91,9,0,2115
"30063000400",2299,482,0,0,154,19,25,0,2979
"30063000500",3368,1200,0,36,487,240,200,32,5563
"30063000700",1559,774,18,0,87,26,21,0,2485
"30063000800",4084,1567,0,0,391,126,230,243,6641
"30063000901",4955,428,28,0,202,251,102,64,6030
"30063000902",2078,116,0,0,40,6,25,0,2265
"30063001000",3472,980,0,0,174,43,160,0,4829
"30063001100",2468,761,0,0,254,56,91,0,3630
"30063001200",3653,1051,33,0,296,148,113,109,5403
"30063001302",5131,665,0,133,93,108,17,9,6156
"30063001303",4248,688,0,0,120,0,12,33,5101
"30063001304",5865,377,0,0,587,33,392,0,7254
"30063001400",5595,569,19,0,315,58,117,12,6685
"30063001500",5669,472,0,0,282,0,37,0,6460
"30063001600",6755,466,0,0,105,120,30,13,7489
"30063001800",2992,516,9,0,430,46,118,28,4139
"30065000100",2249,201,19,0,148,17,17,19,2670
"30065000200",1577,385,8,0,52,3,43,3,2071
"30067000100",1580,152,0,0,57,8,0,0,1797
"30067000200",3118,341,0,0,76,14,11,0,3560
"30067000300",2651,449,0,10,104,108,53,22,3397
"30067000400",4460,496,0,11,68,53,99,47,5234
"30067000500",1386,236,0,0,41,2,57,57,1779
"30067980600",23,23,0,0,0,0,0,0,46
"30069000100",462,45,5,14,7,0,9,5,547
"30071060200",3174,425,0,0,390,155,23,0,4167
"30073977000",3332,316,0,0,101,66,57,25,3897
"30073977200",973,408,36,0,588,278,14,0,2297
"30075000100",1443,141,0,0,45,9,34,0,1672
"30077000100",1302,264,6,0,43,6,20,0,1641
"30077000200",3255,532,0,0,57,40,44,33,3961
"30079000100",895,237,0,0,17,13,2,5,1169
"30081000100",3301,402,0,0,113,16,14,0,3846
"30081000201",2872,903,0,4,37,141,34,69,4060
"30081000202",5918,589,55,0,353,16,71,0,7002
"30081000300",2455,434,0,0,22,4,43,75,3033
"30081000401",2020,397,0,0,43,0,66,78,2604
"30081000402",4064,934,0,0,141,90,104,180,5513
"30081000500",4019,1186,46,0,197,5,19,24,5496
"30081000600",5099,1018,0,0,173,48,206,96,6640
"30081000700",1465,308,0,0,76,16,10,9,1884
"30081000800",892,224,0,0,12,18,37,93,1276
"30083070100",966,275,12,20,60,12,31,17,1393
"30083070200",1306,320,0,0,214,4,90,55,1989
"30083070300",3356,628,0,0,75,11,70,23,4163
"30083070400",2704,189,0,0,118,0,91,0,3102
"30085080100",1263,70,0,0,235,27,85,0,1680
"30085940001",1707,112,0,5,1813,883,50,11,4581
"30085940002",604,62,0,0,2061,1628,18,12,4385
"30087000100",2125,140,0,0,154,0,12,14,2445
"30087000200",1137,144,0,0,121,14,71,42,1529
"30087000300",1788,46,18,0,335,73,88,0,2348
"30087940400",229,30,12,0,1671,1137,51,71,3201
"30089000100",2512,702,0,0,59,19,103,0,3395
"30089000200",4620,1062,5,0,99,22,31,53,5892
"30089940300",1044,380,3,4,395,276,16,39,2157
"30091090200",1925,204,0,0,48,77,34,0,2288
"30091090400",974,113,0,1,43,4,18,0,1153
"30093000100",2444,1454,0,0,299,150,76,79,4502
"30093000200",3203,1257,47,0,87,170,75,474,5313
"30093000300",1998,496,0,0,81,20,110,9,2714
"30093000400",3355,451,9,0,49,3,160,13,4040
"30093000500",3522,426,0,0,112,36,39,4,4139
"30093000600",3861,773,0,12,58,33,52,13,4802
"30093000700",3103,218,0,0,73,21,58,21,3494
"30093000800",4559,751,0,0,111,114,33,60,5628
"30095966400",3506,264,0,3,41,15,91,0,3920
"30095966500",1819,178,2,0,54,20,117,5,2195
"30095966600",2789,230,16,0,155,0,26,0,3216
"30097967000",2977,488,0,0,142,0,61,0,3668
"30099000100",1702,227,0,0,48,31,6,0,2014
"30099000200",1442,181,0,0,43,19,26,27,1738
"30099000300",1740,411,0,0,90,30,23,0,2294
"30101000100",1083,176,0,0,20,0,0,0,1279
"30101000200",2396,509,0,0,248,43,21,21,3238
"30101980000",0,0,0,0,0,0,0,0,0
"30103963500",569,53,0,0,62,27,22,29,762
"30105100100",1293,113,0,0,16,0,4,19,1445
"30105100500",2237,390,0,0,136,93,6,18,2880
"30105940600",2113,234,6,0,448,147,52,7,3007
"30107000100",1816,224,0,0,57,13,18,0,2128
"30109000100",782,120,0,0,0,0,18,0,920
"30111000200",2156,526,6,15,242,339,69,49,3402
"30111000300",1968,884,49,20,644,417,550,171,4703
"30111000401",2345,455,24,27,163,44,58,91,3207
"30111000402",1962,403,44,4,359,244,137,63,3216
"30111000500",3524,701,0,0,130,57,95,0,4507
"30111000600",1952,220,28,0,53,3,12,0,2268
"30111000701",3803,532,0,0,285,259,155,0,5034
"30111000702",6011,369,0,0,680,207,388,0,7655
"30111000704",3242,323,63,0,473,125,254,83,4563
"30111000705",3163,335,21,0,257,90,180,0,4046
"30111000706",2582,1062,0,0,70,97,128,53,3992
"30111000800",3743,426,0,0,227,25,99,11,4531
"30111000901",2519,254,0,0,137,267,48,142,3367
"30111000902",3063,561,55,0,644,564,372,157,5416
"30111001000",3632,441,7,0,450,115,490,43,5178
"30111001100",4851,284,81,0,390,36,168,0,5810
"30111001200",1933,436,35,6,169,166,67,185,2997
"30111001300",5934,440,0,0,73,122,128,181,6878
"30111001401",8623,457,60,0,658,119,279,44,10240
"30111001402",4831,304,5,0,361,91,146,85,5823
"30111001501",4076,545,0,13,281,27,212,14,5168
"30111001502",3337,262,3,0,135,7,52,46,3842
"30111001702",3868,242,48,25,74,89,133,0,4479
"30111001703",4231,955,0,0,120,3,50,8,5367
"30111001704",3233,677,98,0,218,109,80,0,4415
"30111001801",4693,83,0,0,532,5,112,0,5425
"30111001802",4975,521,0,0,211,17,325,0,6049
"30111001803",1767,110,11,0,87,0,123,0,2098
"30111001804",2461,248,0,28,108,6,98,37,2986
"30111001901",4642,83,0,0,81,9,179,0,4994
"30111001902",3247,268,0,0,102,75,54,8,3754
"30111940000",6452,549,6,0,630,199,256,5,8097
"31001965400",3823,214,0,30,28,4,36,8,4143
"31001965500",3323,422,12,11,148,20,198,46,4180
"31001965600",4015,417,15,0,113,26,197,13,4796
"31001965700",766,320,0,0,10,123,132,153,1504
"31001965800",2037,323,0,0,346,73,461,16,3256
"31001965900",3794,283,0,0,125,0,111,0,4313
"31001966000",3297,909,54,26,383,60,569,197,5495
"31001966100",1277,431,0,0,0,16,195,119,2038
"31001966200",2277,84,21,0,32,4,16,4,2438
"31003979600",1998,214,0,0,19,9,0,28,2268
"31003979700",1413,220,0,0,22,0,45,55,1755
"31003979800",2318,256,1,0,19,13,45,15,2667
"31005958300",470,35,0,0,2,0,0,0,507
"31007954000",657,126,10,0,23,0,32,13,861
"31009972400",475,97,0,0,7,7,0,0,586
"31011960100",3148,302,4,0,4,1,40,8,3507
"31011960200",1646,203,0,0,8,9,10,11,1887
"31013951100",1812,208,2,0,7,15,13,0,2057
"31013951200",3767,552,0,2,155,391,123,380,5370
"31013951300",2545,1053,7,0,151,429,195,497,4877
"31015975800",1769,211,21,0,20,1,8,6,2036
"31017975000",2570,484,0,0,43,0,55,7,3159
"31019968900",2992,296,0,0,102,0,72,34,3496
"31019969000",3934,236,0,3,49,5,49,0,4276
"31019969100",3807,366,16,0,402,8,715,132,5446
"31019969202",2801,805,0,30,183,13,195,64,4091
"31019969203",4847,395,0,8,84,0,121,50,5505
"31019969204",4380,300,63,0,130,24,131,31,5059
"31019969300",1407,292,0,0,432,132,362,110,2735
"31019969400",3352,401,15,5,146,70,316,115,4420
"31019969500",1714,189,50,12,46,3,161,17,2192
"31019969600",2370,1449,6,18,84,152,83,110,4272
"31019969700",4507,701,38,5,339,128,420,39,6177
"31021963200",2008,155,23,12,55,7,0,9,2269
"31021963300",2080,189,22,22,53,10,31,0,2407
"31021963400",1661,231,0,0,105,16,32,8,2053
"31023967600",3036,263,3,0,42,20,62,17,3443
"31023967700",2420,332,43,0,66,2,129,0,2992
"31023967800",1802,154,6,0,5,1,0,4,1972
"31025965600",3199,322,32,0,30,0,95,0,3678
"31025965700",4315,193,0,0,69,7,71,0,4655
"31025965800",2838,123,0,13,53,16,5,12,3060
"31025965900",4559,418,0,0,96,0,102,0,5175
"31025966000",3689,144,95,0,189,27,201,14,4359
"31025966100",3962,326,21,0,160,0,127,20,4616
"31027977100",3808,548,2,3,19,13,69,0,4462
"31027977200",3902,283,0,0,24,24,47,5,4285
"31029961900",3337,439,0,0,58,60,328,138,4360
"31031955800",3258,358,0,0,354,212,0,81,4263
"31031955900",1213,147,0,6,19,0,0,0,1385
"31033954800",2445,302,17,0,121,8,58,30,2981
"31033954900",3494,678,0,1,60,24,204,237,4698
"31033955000",2274,332,0,0,81,35,76,0,2798
"31035962100",3232,231,52,5,12,56,290,107,3985
"31035962200",2425,266,0,0,48,10,102,15,2866
"31037964600",2090,212,10,0,30,5,19,3,2369
"31037964700",1485,135,1,0,26,12,31,4,1694
"31037964800",4410,1041,123,47,538,141,3295,960,10555
"31039972700",2290,238,0,0,79,0,61,7,2675
"31039972800",3447,594,50,0,151,44,456,217,4959
"31039972900",1804,144,2,0,75,15,28,14,2082
"31041971700",2444,294,8,0,44,18,22,9,2839
"31041971800",2464,175,0,0,52,8,28,6,2733
"31041971900",3365,332,45,0,0,19,94,19,3874
"31041972000",1192,174,3,0,40,0,21,6,1436
"31043010100",2619,652,286,408,1362,801,1790,912,8830
"31043010200",4061,461,90,48,2001,266,2650,619,10196
"31043010300",3165,337,18,0,409,247,874,355,5405
"31043010400",2975,254,0,0,149,21,194,31,3624
"31045950600",2055,452,31,4,67,12,20,2,2643
"31045950700",3899,906,0,69,440,110,151,71,5646
"31047968000",2322,197,22,0,163,74,373,52,3203
"31047968100",1373,138,0,0,116,0,121,23,1771
"31047968200",3308,288,1,0,0,39,96,14,3746
"31047968300",2999,542,98,24,108,39,383,40,4233
"31047968400",3177,612,124,160,1028,163,2909,682,8855
"31047968500",2954,804,389,39,715,273,2195,829,8198
"31047968600",1356,85,0,0,33,44,15,19,1552
"31049955400",1651,259,2,0,16,2,39,58,2027
"31051977600",2312,157,0,0,39,2,61,6,2577
"31051977800",2713,458,5,12,113,23,367,216,3907
"31053963600",4311,321,9,0,166,15,125,8,4955
"31053963700",2632,130,0,0,26,0,73,0,2861
"31053963800",4448,509,0,0,94,0,462,29,5542
"31053963900",3127,875,30,0,15,51,531,360,4989
"31053964000",2689,280,0,0,180,25,312,54,3540
"31053964100",3918,236,0,0,67,0,169,141,4531
"31053964200",3206,238,4,6,125,59,409,106,4153
"31053964300",4300,302,0,0,137,9,90,0,4838
"31053964400",2097,670,0,16,206,59,637,252,3937
"31055000200",1816,332,739,172,297,56,192,30,3634
"31055000300",609,208,1012,504,117,98,279,98,2925
"31055000400",1013,561,52,18,293,297,434,351,3019
"31055000500",460,264,190,82,42,187,25,154,1404
"31055000600",256,30,470,323,142,157,91,3,1472
"31055000700",26,10,579,502,102,7,6,0,1232
"31055000800",161,237,786,783,176,204,176,111,2634
"31055001100",253,277,1059,1006,179,127,153,167,3221
"31055001200",164,213,1193,917,149,93,255,87,3071
"31055001600",68,65,17,0,26,55,0,0,231
"31055001800",1747,484,93,60,119,11,37,53,2604
"31055001900",448,233,304,104,96,61,34,18,1298
"31055002000",2205,601,0,27,1088,225,2272,619,7037
"31055002100",1212,543,73,74,324,88,597,237,3148
"31055002200",591,184,0,0,198,33,178,29,1213
"31055002300",1589,323,0,0,285,6,414,39,2656
"31055002400",2073,728,0,3,252,400,1281,823,5560
"31055002500",1589,284,74,0,508,140,1007,311,3913
"31055002600",1447,172,6,30,942,350,1844,433,5224
"31055002700",911,365,0,2,873,224,1175,470,4020
"31055002800",1451,523,28,32,844,178,1446,474,4976
"31055002900",2312,765,413,1215,387,250,1962,727,8031
"31055003000",3389,1456,198,17,1733,772,2233,2042,11840
"31055003100",2355,339,87,169,536,138,1070,163,4857
"31055003200",1070,312,23,94,879,156,1504,319,4357
"31055003300",1240,463,61,7,214,392,726,570,3673
"31055003401",2264,700,110,23,763,77,800,200,4937
"31055003402",2320,227,32,0,79,0,337,105,3100
"31055003500",3304,365,134,0,402,236,625,177,5243
"31055003600",3626,215,130,0,79,78,83,0,4211
"31055003700",2274,137,46,9,166,0,107,0,2739
"31055003800",1828,569,203,437,188,330,521,254,4330
"31055003900",1213,607,45,45,715,583,1008,923,5139
"31055004000",1332,847,85,224,126,165,454,598,3831
"31055004200",637,489,71,47,312,75,248,303,2182
"31055004300",1482,606,87,26,441,30,80,105,2857
"31055004400",1090,76,1,2,90,4,108,6,1377
"31055004500",2689,192,80,0,86,9,53,0,3109
"31055004600",1962,322,0,0,189,52,69,41,2635
"31055004700",1995,52,14,0,42,0,38,0,2141
"31055004800",3241,759,266,63,194,205,461,0,5189
"31055004900",2583,399,562,355,376,410,288,192,5165
"31055005000",2309,851,514,80,397,170,472,418,5211
"31055005100",969,541,447,214,164,101,112,289,2837
"31055005200",109,143,412,330,265,269,30,56,1614
"31055005300",345,101,972,642,84,115,77,131,2467
"31055005400",948,311,993,407,222,267,192,380,3720
"31055005500",4455,427,83,31,186,0,148,190,5520
"31055005600",2795,353,663,64,584,27,235,48,4769
"31055005700",2268,474,712,206,228,203,106,184,4381
"31055005800",2026,140,850,134,196,395,130,15,3886
"31055005901",433,158,897,372,258,14,12,0,2144
"31055005902",132,121,771,843,88,130,69,0,2154
"31055006000",779,334,1411,1010,241,160,232,253,4420
"31055006101",337,96,1174,378,69,274,25,27,2380
"31055006102",800,669,1226,801,266,158,86,414,4420
"31055006202",2187,211,861,491,361,80,155,22,4368
"31055006301",923,135,1029,147,88,121,123,66,2632
"31055006302",941,341,2038,214,389,514,179,215,4831
"31055006303",1301,77,653,268,146,245,99,32,2821
"31055006400",3560,730,36,152,127,120,99,69,4893
"31055006503",2326,56,151,41,161,12,112,0,2859
"31055006504",2430,188,327,73,152,8,74,4,3256
"31055006505",985,119,561,121,117,0,118,0,2021
"31055006506",1198,282,1197,134,375,275,214,0,3675
"31055006602",4407,779,386,28,252,53,268,0,6173
"31055006603",1488,311,460,416,163,64,128,26,3056
"31055006604",2966,264,144,101,363,47,160,0,4045
"31055006701",3092,261,101,0,320,97,82,59,4012
"31055006703",2498,151,160,0,305,84,92,0,3290
"31055006704",1359,119,0,0,44,0,10,0,1532
"31055006803",1807,78,64,0,65,0,6,0,2020
"31055006804",1341,72,0,0,104,0,30,0,1547
"31055006805",2915,184,0,2,82,8,53,8,3252
"31055006806",1404,386,140,155,145,242,11,30,2513
"31055006903",2228,141,1,62,95,0,125,7,2659
"31055006904",3643,140,0,0,102,27,106,0,4018
"31055006905",1501,78,21,6,174,58,2,85,1925
"31055006906",2781,236,6,41,48,0,133,25,3270
"31055007001",1955,693,231,75,307,48,429,174,3912
"31055007002",2561,234,183,113,151,29,293,0,3564
"31055007003",2097,230,6,14,102,7,668,64,3188
"31055007101",2458,240,42,0,213,154,582,154,3843
"31055007102",2905,104,0,0,583,0,1256,0,4848
"31055007303",2482,178,80,22,66,0,110,0,2938
"31055007304",1208,34,109,5,71,0,28,0,1455
"31055007309",2638,310,448,60,318,52,59,19,3904
"31055007310",2117,107,281,9,199,0,120,25,2858
"31055007311",2218,199,371,368,176,48,92,0,3472
"31055007312",1279,150,149,155,139,0,46,14,1932
"31055007313",4649,256,1738,361,563,0,100,44,7711
"31055007314",2850,19,38,0,139,0,40,0,3086
"31055007315",2832,182,156,0,80,0,14,0,3264
"31055007316",2500,0,87,41,326,0,148,0,3102
"31055007317",3329,467,282,0,90,6,52,0,4226
"31055007318",3608,67,111,0,190,30,16,30,4052
"31055007405",1397,205,21,0,87,3,54,3,1770
"31055007406",4019,470,53,0,194,0,155,0,4891
"31055007407",2350,176,74,225,271,0,170,47,3313
"31055007408",3552,315,70,7,188,174,165,126,4597
"31055007409",1948,197,30,0,61,0,62,22,2320
"31055007424",2382,329,65,98,157,0,183,68,3282
"31055007429",3523,29,8,0,112,0,112,0,3784
"31055007431",3792,276,173,26,125,0,70,0,4462
"31055007432",2610,209,276,60,207,0,185,58,3605
"31055007433",3446,209,295,72,130,27,180,28,4387
"31055007434",2016,387,483,103,249,124,249,58,3669
"31055007435",2746,294,72,51,315,148,206,30,3862
"31055007436",3193,202,389,468,304,71,147,0,4774
"31055007438",1613,124,11,0,25,0,105,7,1885
"31055007439",4118,222,229,0,157,20,250,100,5096
"31055007440",1102,264,301,210,167,0,73,19,2136
"31055007441",2209,34,76,0,177,0,84,0,2580
"31055007442",4466,181,0,8,82,17,113,0,4867
"31055007443",2697,194,221,78,181,0,113,0,3484
"31055007444",2749,385,337,50,656,0,135,16,4328
"31055007445",1620,121,201,115,184,88,26,0,2355
"31055007446",3701,48,11,0,116,0,61,0,3937
"31055007447",2503,221,0,0,44,89,102,11,2970
"31055007448",2413,93,13,0,63,0,47,29,2658
"31055007449",3067,27,0,0,104,0,48,0,3246
"31055007450",3077,119,147,0,75,0,51,0,3469
"31055007451",4497,395,0,30,231,0,151,0,5304
"31055007452",4926,72,27,0,162,13,215,0,5415
"31055007453",3074,72,23,0,73,159,17,0,3418
"31055007454",3934,178,8,0,62,22,244,0,4448
"31055007455",1246,168,0,0,9,57,58,113,1651
"31055007456",2004,88,46,20,208,0,224,0,2590
"31055007457",2276,125,66,0,231,72,200,17,2987
"31055007458",1935,189,71,15,184,9,99,24,2526
"31055007459",2796,152,0,0,64,29,501,0,3542
"31055007460",3905,0,0,0,268,0,94,0,4267
"31055007461",5294,92,19,0,634,62,252,62,6415
"31055007462",3854,373,44,0,219,66,233,145,4934
"31055007463",3692,265,217,0,228,30,162,0,4594
"31055007464",2364,76,35,210,58,9,20,0,2772
"31055007465",3595,120,62,22,516,50,278,0,4643
"31055007466",4063,750,85,0,522,112,358,504,6394
"31055007467",3928,347,226,0,498,58,436,90,5583
"31055007468",2322,109,23,0,118,46,618,50,3286
"31055007469",3132,59,0,0,358,0,197,14,3760
"31055007470",4640,109,305,0,554,99,514,0,6221
"31055007471",2806,68,76,110,538,0,125,0,3723
"31055007472",3896,34,132,0,288,48,139,48,4585
"31055007504",2577,280,26,18,34,0,8,0,2943
"31055007505",2726,124,0,0,105,5,54,0,3014
"31055007506",1972,214,45,0,133,0,155,85,2604
"31055007508",2431,130,0,2,11,3,20,2,2599
"31055007509",3613,53,0,0,27,0,12,0,3705
"31055007511",3950,338,177,0,410,49,109,0,5033
"31055007512",5237,407,0,8,139,56,66,7,5920
"31055007513",4213,41,31,0,217,42,14,42,4600
"31055007514",3213,43,19,0,135,0,129,0,3539
"31055007515",3136,0,140,0,339,0,41,0,3656
"31055007516",2909,30,55,0,249,0,13,0,3256
"31055007517",4177,281,13,0,179,0,40,0,4690
"31057962300",1759,158,1,0,26,0,113,5,2062
"31059091600",1966,176,0,0,18,3,50,7,2220
"31059091700",2996,294,15,0,32,13,42,15,3407
"31061964600",1120,88,0,1,1,14,10,0,1234
"31061964700",1551,284,0,6,20,7,16,14,1898
"31063961100",2104,275,0,0,16,13,17,7,2432
"31065963900",3972,743,0,0,80,39,82,57,4973
"31067964600",2292,210,0,0,16,0,7,12,2537
"31067964700",3535,160,1,0,58,0,49,27,3830
"31067964800",2857,636,0,0,88,37,24,15,3657
"31067964900",3339,500,5,0,55,0,20,0,3919
"31067965000",2974,194,0,0,56,0,6,3,3233
"31067965100",1392,392,0,0,138,36,84,38,2080
"31067965200",2250,337,6,2,58,29,84,0,2766
"31069952100",1677,179,0,0,56,0,83,11,2006
"31071973200",1644,234,0,13,8,0,6,0,1905
"31073967600",1751,155,0,0,54,2,45,4,2011
"31075956300",481,111,0,0,0,0,2,7,601
"31077970900",2159,294,7,0,3,4,29,19,2515
"31079000100",2217,173,20,0,50,9,45,55,2569
"31079000200",3890,1072,0,19,331,133,2449,1007,8901
"31079000300",5018,895,28,19,205,28,1860,393,8446
"31079000400",4271,719,0,0,201,0,843,215,6249
"31079000500",4125,120,0,0,157,0,167,43,4612
"31079000600",4037,383,64,0,248,41,551,218,5542
"31079000700",3177,447,216,50,108,7,741,13,4759
"31079000800",2617,254,0,0,86,0,325,0,3282
"31079000900",4268,911,69,195,149,54,1409,534,7589
"31079001000",2775,604,98,125,480,224,789,603,5698
"31079001100",2933,841,48,152,409,18,890,541,5832
"31079001200",3417,103,41,5,41,28,152,5,3792
"31079001300",2595,192,23,6,75,30,84,65,3070
"31079001400",1716,150,33,0,22,0,153,34,2108
"31081969100",1750,114,0,0,36,9,53,0,1962
"31081969200",2219,260,0,0,20,2,22,23,2546
"31081969300",3881,517,30,0,85,0,92,9,4614
"31083964200",2924,382,4,0,42,25,45,16,3438
"31085961500",1065,67,3,0,7,0,41,10,1193
"31087962700",2330,428,4,0,41,6,41,0,2850
"31089974000",1366,148,0,0,0,0,17,3,1534
"31089974100",2255,341,0,0,12,5,13,7,2633
"31089974200",1690,158,2,0,12,0,0,0,1862
"31089974300",3609,346,0,0,274,46,235,64,4574
"31091956700",578,86,0,0,9,0,6,0,679
"31093970500",1663,114,0,0,26,0,71,0,1874
"31093970600",3858,510,0,0,74,22,39,18,4521
"31095963600",2887,249,0,0,76,3,46,0,3261
"31095963700",2432,496,0,0,31,14,96,65,3134
"31095963800",963,243,0,0,15,0,0,17,1238
"31097967500",1784,137,0,0,39,10,20,4,1994
"31097967600",1548,403,15,0,208,20,177,63,2434
"31099966600",3384,135,0,0,39,0,189,0,3747
"31099966700",2581,174,0,0,49,0,84,0,2888
"31101000100",1134,200,0,0,30,15,15,38,1432
"31101000200",2643,435,0,0,115,0,181,18,3392
"31101000300",3214,214,2,0,49,47,151,61,3738
"31103975400",577,104,0,1,11,3,0,0,696
"31105954500",3079,481,17,0,132,3,157,89,3958
"31107976200",2505,320,10,0,31,21,8,20,2915
"31107976300",1986,288,0,1,47,25,18,9,2374
"31107976400",2146,167,0,6,443,343,87,35,3227
"31109000100",2789,656,41,21,104,137,87,53,3888
"31109000201",3852,240,25,0,116,51,72,0,4356
"31109000202",1939,1011,64,16,193,71,187,75,3556
"31109000300",1855,979,25,33,284,76,226,187,3665
"31109000400",2342,1292,221,396,619,361,473,312,6016
"31109000500",820,686,11,27,33,66,49,41,1733
"31109000600",10,150,0,0,0,11,0,7,178
"31109000700",656,385,203,444,625,413,69,11,2806
"31109000800",1985,628,194,88,311,261,235,348,4050
"31109000900",2093,658,23,39,262,204,59,67,3405
"31109001001",1956,349,71,0,154,59,67,55,2711
"31109001002",1063,349,11,16,34,19,8,0,1500
"31109001003",2490,494,114,64,296,9,239,48,3754
"31109001101",4122,161,36,0,177,0,171,0,4667
"31109001102",2858,391,39,0,136,0,31,56,3511
"31109001200",5172,475,98,0,268,1,64,10,6088
"31109001301",2996,160,27,0,132,10,54,19,3398
"31109001302",2692,84,12,0,144,0,105,0,3037
"31109001400",3040,554,102,54,354,0,163,0,4267
"31109001500",3433,351,90,0,61,69,47,0,4051
"31109001600",4439,579,59,49,258,81,176,47,5688
"31109001700",2244,1391,225,516,581,614,476,589,6636
"31109001800",792,379,41,39,218,109,168,105,1851
"31109001900",228,154,54,0,29,17,0,3,485
"31109002001",923,1088,218,117,311,32,120,316,3125
"31109002002",1177,773,168,190,104,162,336,165,3075
"31109002100",1136,514,24,8,200,98,325,109,2414
"31109002200",3085,1039,218,56,267,366,271,373,5675
"31109002300",4501,781,75,0,440,128,230,52,6207
"31109002400",2713,210,14,0,54,0,32,0,3023
"31109002500",5058,318,15,91,164,35,213,24,5918
"31109002701",2155,287,111,0,281,20,177,0,3031
"31109002702",4308,382,45,0,299,91,230,29,5384
"31109002800",4727,321,126,75,185,0,114,46,5594
"31109002900",3529,752,336,143,506,193,186,43,5688
"31109003001",4820,880,48,0,823,318,250,107,7246
"31109003002",2444,469,204,109,152,42,202,20,3642
"31109003003",2511,1045,129,225,238,327,42,407,4924
"31109003102",4978,492,203,27,118,82,98,60,6058
"31109003103",1075,911,17,89,556,76,460,212,3396
"31109003104",4103,967,112,113,441,209,550,295,6790
"31109003202",2152,436,159,70,128,30,461,129,3565
"31109003301",2322,1487,26,437,179,71,75,101,4698
"31109003302",3200,303,100,0,348,6,390,62,4409
"31109003401",4054,539,0,0,327,15,291,143,5369
"31109003402",3667,498,473,735,684,159,346,396,6958
"31109003500",8,28,0,3,0,0,0,0,39
"31109003601",0,0,0,0,0,0,0,0,0
"31109003604",2621,60,27,0,110,2,0,0,2820
"31109003605",2751,172,42,0,278,133,201,0,3577
"31109003607",3475,123,47,0,284,0,8,0,3937
"31109003608",996,37,0,0,103,0,28,0,1164
"31109003609",2067,26,0,8,71,0,34,0,2206
"31109003704",4202,648,136,0,410,29,349,0,5774
"31109003706",5257,219,57,1,296,11,174,0,6015
"31109003707",6829,320,34,19,214,48,78,1,7543
"31109003708",3956,127,9,0,363,0,113,0,4568
"31109003709",4360,305,62,0,193,135,188,113,5356
"31109003713",2152,6,62,0,59,0,35,0,2314
"31109003714",2219,34,0,0,37,0,220,0,2510
"31109003715",2345,11,8,0,141,0,12,0,2517
"31109003716",4463,102,0,0,365,0,105,0,5035
"31109003717",2537,471,35,24,49,26,3,0,3145
"31109003718",1824,43,28,0,150,0,34,3,2082
"31109003719",3438,104,112,0,112,46,46,0,3858
"31109003720",1322,0,0,0,60,0,0,0,1382
"31109003801",4206,181,81,32,141,52,1,18,4712
"31109003802",2480,231,6,0,44,1,131,0,2893
"31109010100",5601,175,0,0,152,2,136,0,6066
"31109010201",2910,713,163,0,393,10,330,0,4519
"31109010202",4060,261,30,0,36,0,12,0,4399
"31109010300",3640,123,36,8,68,0,6,0,3881
"31109010400",7832,356,21,7,199,12,278,29,8734
"31109983200",0,0,0,0,0,0,0,0,0
"31111959700",3199,272,0,0,32,9,21,3,3536
"31111959800",2786,183,0,4,119,61,174,17,3344
"31111959900",3874,762,0,33,417,47,719,98,5950
"31111960200",3723,850,25,30,90,79,242,213,5252
"31111960300",3675,490,57,10,264,9,381,91,4977
"31111960400",4864,473,0,0,188,29,221,0,5775
"31111960500",4132,357,41,26,83,0,166,26,4831
"31111960600",3541,254,6,0,122,22,187,35,4167
"31113957500",664,85,2,0,2,7,1,19,780
"31115972800",421,122,0,0,10,28,0,25,606
"31117957900",330,52,0,0,0,0,0,0,382
"31119960600",4050,398,0,88,190,0,96,50,4872
"31119960700",2087,731,0,29,296,78,390,123,3734
"31119960801",3971,236,0,0,91,0,188,43,4529
"31119960802",2848,306,24,0,49,24,21,126,3398
"31119960900",3101,879,50,41,331,316,415,517,5650
"31119961000",2445,708,66,0,74,16,395,190,3894
"31119961100",1642,212,60,0,73,0,381,55,2423
"31119961200",3070,254,4,0,24,7,72,56,3487
"31119961300",4122,486,59,0,320,0,1290,223,6500
"31121966600",1720,164,21,0,23,2,12,20,1962
"31121966700",2171,294,0,0,15,0,92,3,2575
"31121966800",2504,492,0,0,153,0,40,79,3268
"31123952500",4004,649,0,3,155,15,597,89,5512
"31125966100",3143,427,0,0,24,28,59,23,3704
"31127968100",2857,298,6,0,29,18,19,12,3239
"31127968200",3052,368,24,0,50,13,0,54,3561
"31129960000",2143,259,0,0,29,9,77,21,2538
"31129960100",1705,194,0,0,7,23,0,0,1929
"31131966600",2048,84,1,0,16,13,31,0,2193
"31131966700",2695,274,0,0,33,36,21,7,3066
"31131966800",2630,118,12,0,34,2,10,0,2806
"31131966900",3744,624,0,0,158,86,345,157,5114
"31131967000",2315,375,6,1,71,0,226,139,3133
"31133967800",2090,568,0,0,41,15,45,0,2759
"31135959300",2701,166,0,0,16,0,66,28,2977
"31137967000",2185,360,0,0,53,7,113,0,2718
"31137967100",2883,224,0,0,54,0,145,0,3306
"31137967200",2906,202,2,1,26,14,113,32,3296
"31139979100",3619,107,0,0,72,5,45,0,3848
"31139979200",2926,278,4,0,31,3,34,5,3281
"31141965100",3698,216,0,0,3,7,19,15,3958
"31141965298",2949,260,1,0,43,19,38,2,3312
"31141965300",5653,764,6,0,73,0,343,0,6839
"31141965400",3520,658,0,29,87,124,577,747,5742
"31141965500",5083,298,0,0,223,21,828,21,6474
"31141965600",3804,549,0,7,462,159,1074,411,6466
"31141965700",2654,266,0,0,191,22,440,146,3719
"31143960000",1830,142,0,0,54,2,2,6,2036
"31143960100",2767,277,5,0,101,10,118,39,3317
"31145963100",2369,296,0,0,52,0,30,3,2750
"31145963200",4490,248,10,0,0,0,356,4,5108
"31145963300",2279,717,6,0,89,87,26,27,3231
"31147964500",1533,144,2,0,92,12,6,3,1792
"31147968500",1499,286,5,0,63,6,13,8,1880
"31147968600",3333,808,0,0,180,136,19,68,4544
"31149974600",1214,129,0,0,34,10,0,0,1387
"31151960600",4540,1560,0,82,403,156,1695,875,9311
"31151960700",1998,42,0,0,33,0,55,0,2128
"31151960800",1446,114,7,0,32,0,45,0,1644
"31151960900",2473,242,0,0,94,32,228,84,3153
"31153010103",3783,265,239,0,297,0,196,0,4780
"31153010104",1353,164,92,0,233,28,177,128,2175
"31153010105",2138,283,36,0,179,66,95,57,2854
"31153010106",3249,775,129,165,96,108,144,141,4807
"31153010107",2452,348,131,0,298,155,726,384,4494
"31153010108",2422,133,241,272,326,60,356,76,3886
"31153010203",3933,85,189,23,299,0,203,13,4745
"31153010204",2850,295,140,0,133,11,110,11,3550
"31153010205",4752,11,212,0,585,41,369,0,5970
"31153010206",3541,94,255,0,497,38,687,74,5186
"31153010207",1758,56,207,6,265,0,181,0,2473
"31153010208",2181,180,176,13,79,8,162,0,2799
"31153010302",427,42,143,0,114,0,23,0,749
"31153010305",1232,96,69,7,133,0,158,12,1707
"31153010306",1787,105,55,0,175,0,120,14,2256
"31153010401",2348,251,158,24,253,66,819,28,3947
"31153010402",3453,633,551,140,127,27,149,2,5082
"31153010501",4547,412,274,45,966,80,1486,171,7981
"31153010502",3596,410,84,5,222,50,629,0,4996
"31153010503",2966,219,171,0,89,48,381,139,4013
"31153010614",3768,377,317,204,463,135,427,65,5756
"31153010615",1595,160,39,0,140,0,141,43,2118
"31153010616",3369,11,112,0,212,0,318,0,4022
"31153010617",5176,83,190,1,314,0,310,38,6112
"31153010618",4908,129,62,28,699,0,426,55,6307
"31153010619",3470,588,54,96,350,89,155,0,4802
"31153010620",2984,153,73,0,259,0,126,0,3595
"31153010621",5433,187,95,253,103,0,131,256,6458
"31153010622",2567,61,33,0,270,0,38,14,2983
"31153010623",4097,126,23,0,134,0,36,0,4416
"31153010624",5209,306,31,2,293,0,202,0,6043
"31153010625",4183,190,302,0,218,56,118,0,5067
"31153010626",4427,322,0,0,385,0,8,0,5142
"31153010627",2603,21,0,0,105,0,193,0,2922
"31153010628",4353,35,106,0,44,2,101,0,4641
"31153010629",1733,43,50,0,84,0,59,0,1969
"31153010630",2301,6,10,0,77,0,60,0,2454
"31153010631",4216,175,0,69,30,0,103,0,4593
"31153010632",3787,84,0,0,119,0,151,0,4141
"31153010633",2370,88,18,0,139,0,28,0,2643
"31153010634",2401,43,16,0,162,13,33,13,2681
"31153010701",2209,32,0,0,15,0,0,23,2279
"31153010702",3165,166,3,0,80,1,44,0,3459
"31155968100",3180,91,0,0,3,0,24,0,3298
"31155968200",4715,532,5,43,78,27,97,0,5497
"31155968300",3983,453,0,3,108,9,125,0,4681
"31155968400",4031,225,62,0,53,7,98,0,4476
"31155968500",2540,258,0,0,98,0,55,19,2970
"31157952900",2683,176,0,0,51,16,270,23,3219
"31157953000",2646,324,0,0,157,106,460,66,3759
"31157953100",1622,491,2,3,88,52,233,272,2763
"31157953200",1326,118,0,0,5,4,92,31,1576
"31157953300",2961,260,33,6,218,149,395,67,4089
"31157953400",2264,68,32,0,137,0,243,5,2749
"31157953500",2025,872,31,51,151,45,507,437,4119
"31157953600",2486,110,0,8,167,0,378,0,3149
"31157953700",2796,781,0,2,458,298,1861,628,6824
"31157953800",3817,468,9,25,112,13,944,42,5430
"31157953900",4584,460,0,2,116,26,731,158,6077
"31159960100",3891,291,22,0,71,14,7,5,4301
"31159960200",1939,271,22,0,34,0,21,0,2287
"31159960300",3632,295,3,0,102,58,99,0,4189
"31159960400",4271,359,6,1,80,70,42,80,4909
"31161951600",1495,321,0,5,194,149,71,55,2290
"31161951700",2410,298,5,0,323,72,46,10,3164
"31163970100",2647,391,0,24,10,0,7,22,3101
"31165950100",1084,111,0,0,26,3,51,3,1278
"31167962100",1529,145,0,0,31,0,31,0,1736
"31167962200",3899,351,13,0,119,22,216,49,4669
"31169963100",2303,256,0,5,7,15,21,0,2607
"31169963200",2038,371,0,0,27,29,60,12,2537
"31171957100",644,53,6,0,25,3,0,0,731
"31173940100",1931,153,5,11,1113,994,91,94,4392
"31173940200",592,48,0,0,1329,624,42,12,2647
"31175971300",1656,263,0,0,9,6,15,3,1952
"31175971400",1893,310,0,0,0,58,10,41,2312
"31177050101",2792,118,0,0,55,0,48,0,3013
"31177050102",4235,750,9,38,167,63,28,43,5333
"31177050201",3718,133,0,0,17,2,38,2,3910
"31177050202",3059,77,15,0,5,0,110,0,3266
"31177050300",4033,333,0,0,61,3,101,0,4531
"31179978600",3147,255,85,0,66,31,60,65,3709
"31179978700",3518,949,132,0,38,0,245,21,4903
"31181965000",1631,175,0,0,28,43,19,26,1922
"31181965100",1377,328,0,0,21,14,94,5,1839
"31183973600",716,134,0,0,14,5,16,0,885
"31185969600",2578,131,0,0,34,4,54,0,2801
"31185969700",3151,242,0,0,231,61,116,100,3901
"31185969800",3465,516,0,4,81,0,135,0,4201
"31185969900",2108,174,12,3,18,2,74,0,2391
"32001950100",2399,273,6,33,190,11,448,39,3399
"32001950301",2042,1011,84,0,636,254,342,143,4512
"32001950302",3253,535,161,114,749,35,388,48,5283
"32001950400",618,4,14,0,91,0,136,0,863
"32001950500",847,129,0,0,287,206,41,64,1574
"32001950600",3852,185,0,0,407,138,670,229,5481
"32001950700",4152,668,15,0,709,23,492,36,6095
"32003000101",2947,493,525,372,1700,261,2989,528,9815
"32003000103",2746,463,502,46,1218,497,2642,750,8864
"32003000105",1803,734,74,88,886,22,1519,429,5555
"32003000106",2302,524,462,15,699,208,945,401,5556
"32003000107",2178,312,399,26,779,18,1495,15,5222
"32003000108",1647,363,141,0,861,627,1796,831,6266
"32003000109",2044,291,120,114,804,86,1267,86,4812
"32003000201",1128,703,1080,537,580,336,1157,894,6415
"32003000203",1642,579,398,236,831,251,1131,538,5606
"32003000204",675,121,62,0,214,34,149,50,1305
"32003000301",226,320,842,490,217,127,357,199,2778
"32003000302",343,582,1153,1917,349,419,589,743,6095
"32003000401",465,509,118,319,328,175,205,207,2326
"32003000402",700,1107,125,277,832,446,957,1293,5737
"32003000403",835,300,217,313,302,226,557,316,3066
"32003000510",2572,790,247,67,1030,287,3220,998,9211
"32003000513",1982,596,49,233,674,252,1623,722,6131
"32003000514",1907,812,730,233,993,1110,1868,1750,9403
"32003000515",2183,752,421,49,1401,276,2430,955,8467
"32003000516",2028,781,11,129,806,642,1929,1182,7508
"32003000517",3031,496,185,211,1109,434,3224,721,9411
"32003000518",2770,756,194,293,1017,260,2657,763,8710
"32003000519",1891,1093,93,139,1341,403,2482,1288,8730
"32003000520",1052,295,0,0,401,141,1189,364,3442
"32003000521",1338,1008,189,86,445,400,1580,899,5945
"32003000522",1129,951,23,222,528,357,1324,1065,5599
"32003000523",619,690,406,269,196,76,615,656,3527
"32003000524",534,542,73,47,454,383,783,779,3595
"32003000525",1202,419,268,53,565,226,1525,589,4847
"32003000526",1431,557,21,78,1023,84,1960,616,5770
"32003000527",1738,971,85,104,1053,305,2214,1276,7746
"32003000528",1124,463,131,142,494,282,1364,661,4661
"32003000600",1035,710,253,326,336,368,767,507,4302
"32003000700",763,286,68,126,93,28,53,36,1453
"32003000800",888,520,72,184,172,194,403,295,2728
"32003000900",454,205,122,70,157,20,77,0,1105
"32003001003",2294,301,419,109,531,125,1221,204,5204
"32003001004",3784,932,366,51,942,308,1777,763,8923
"32003001005",1107,138,229,5,96,30,89,46,1740
"32003001006",3070,261,208,68,469,33,710,20,4839
"32003001100",899,571,176,224,425,308,704,537,3844
"32003001200",2147,392,189,146,622,195,1002,375,5068
"32003001300",3097,585,37,64,515,28,2207,557,7090
"32003001401",1285,1031,81,17,452,32,981,615,4494
"32003001402",2460,818,0,10,687,53,2358,641,7027
"32003001501",1841,852,94,192,462,139,1065,660,5305
"32003001502",2335,403,131,18,464,9,1186,185,4731
"32003001607",2136,987,214,227,549,279,755,359,5506
"32003001608",1052,262,47,0,91,80,331,291,2154
"32003001609",2431,1334,189,75,1120,139,2143,1172,8603
"32003001610",1129,677,178,25,264,115,536,528,3452
"32003001611",2243,684,9,254,883,129,1999,529,6730
"32003001612",3295,780,750,476,850,744,2076,1091,10062
"32003001613",1611,715,280,126,881,130,1131,608,5482
"32003001706",1612,359,179,18,616,56,186,6,3032
"32003001707",1154,167,105,8,109,15,93,29,1680
"32003001708",1633,99,183,194,411,185,538,157,3400
"32003001709",912,118,222,53,164,25,335,86,1915
"32003001710",2386,427,202,78,924,192,1384,287,5880
"32003001711",2462,304,256,10,540,42,1078,223,4915
"32003001712",2233,304,658,69,285,190,839,258,4836
"32003001713",2170,101,98,74,523,36,998,57,4057
"32003001714",2061,345,166,0,651,26,1120,243,4612
"32003001715",1555,231,78,32,580,358,1038,338,4210
"32003001716",1352,153,136,55,372,0,874,108,3050
"32003001717",1065,54,0,0,161,7,190,6,1483
"32003001718",1454,609,72,256,248,159,941,635,4374
"32003001801",3807,900,234,332,1176,114,2480,682,9725
"32003001803",1742,281,69,0,545,45,1296,89,4067
"32003001804",1544,579,269,122,728,321,1538,599,5700
"32003001901",2388,1083,180,151,1320,404,2412,1205,9143
"32003001902",1982,719,115,156,515,67,1293,479,5326
"32003002000",1733,409,294,90,447,470,406,188,4037
"32003002201",1851,778,161,226,331,454,433,766,5000
"32003002203",2108,1065,188,100,1615,270,2646,1050,9042
"32003002204",2221,1032,296,75,465,354,2026,1215,7684
"32003002206",1494,618,204,190,866,442,1526,868,6208
"32003002207",1441,931,40,48,833,1371,1981,1993,8638
"32003002302",496,97,10,123,228,0,40,0,994
"32003002303",365,6,5,0,35,6,0,0,417
"32003002403",1321,653,786,259,510,227,549,603,4908
"32003002404",1607,725,620,490,536,291,1512,612,6393
"32003002405",2577,939,189,213,509,62,1730,689,6908
"32003002406",1009,425,178,239,326,95,197,247,2716
"32003002501",3618,1357,470,39,1037,242,2538,752,10053
"32003002504",1903,268,305,99,343,128,925,14,3985
"32003002505",824,127,171,30,110,275,478,214,2229
"32003002506",1811,732,409,94,364,92,1260,611,5373
"32003002603",1271,525,222,275,257,175,365,240,3330
"32003002604",1101,345,169,33,281,45,472,201,2647
"32003002605",294,249,84,0,67,0,55,20,769
"32003002706",2235,310,336,87,297,190,1360,307,5122
"32003002707",1881,353,237,110,612,34,1030,255,4512
"32003002708",1157,317,319,498,261,33,826,282,3693
"32003002808",1642,92,62,33,254,12,233,15,2343
"32003002810",1746,537,175,34,494,136,733,57,3912
"32003002811",2761,221,304,1,619,13,543,10,4472
"32003002814",3055,195,390,102,1169,320,662,261,6154
"32003002821",2896,539,137,110,923,215,1006,140,5966
"32003002822",1946,410,255,147,958,178,1753,451,6098
"32003002823",1872,271,418,26,667,104,698,101,4157
"32003002824",1371,86,6,0,317,71,135,53,2039
"32003002825",1902,309,84,37,663,82,1003,141,4221
"32003002826",2028,245,59,0,348,0,887,8,3575
"32003002827",1365,226,148,35,694,123,959,110,3660
"32003002828",2304,287,91,71,397,143,434,131,3858
"32003002829",3492,102,72,3,746,44,934,66,5459
"32003002830",4012,196,319,0,1164,66,1074,34,6865
"32003002831",2622,232,298,113,645,316,1315,121,5662
"32003002832",3619,257,547,45,1414,305,1368,163,7718
"32003002833",3408,516,201,8,1477,30,915,197,6752
"32003002834",4204,427,1038,0,1143,88,1370,0,8270
"32003002835",1457,274,40,24,1155,77,671,105,3803
"32003002836",2170,119,192,0,1103,71,1389,48,5092
"32003002837",4580,555,95,3,896,61,1654,246,8090
"32003002838",3835,337,318,0,990,175,933,120,6708
"32003002841",1811,25,115,10,426,66,235,25,2713
"32003002842",3264,87,321,30,2287,140,1607,63,7799
"32003002843",4347,394,593,2,2402,346,2108,101,10293
"32003002844",4313,125,676,25,1419,184,570,0,7312
"32003002845",2952,690,630,61,629,59,1164,456,6641
"32003002846",3989,200,720,18,1935,254,1522,65,8703
"32003002847",2519,376,190,138,596,55,941,15,4830
"32003002848",2065,248,192,39,600,39,603,117,3903
"32003002905",2299,825,182,182,695,342,516,323,5364
"32003002915",3394,160,469,81,561,253,789,24,5731
"32003002916",2179,150,250,1,198,36,511,74,3399
"32003002919",2323,285,458,112,712,7,640,78,4615
"32003002935",1055,36,88,5,317,185,418,186,2290
"32003002936",1773,91,376,199,781,124,768,15,4127
"32003002937",2457,299,417,99,1097,408,1440,404,6621
"32003002938",782,247,132,49,337,61,107,37,1752
"32003002939",1220,79,123,0,303,19,230,12,1986
"32003002940",1634,279,108,52,1197,230,520,33,4053
"32003002941",2761,741,63,114,1491,55,1720,641,7586
"32003002942",2426,266,289,72,859,86,526,108,4632
"32003002944",1847,405,170,32,994,25,212,357,4042
"32003002946",1322,348,113,7,578,31,375,222,2996
"32003002947",2003,202,29,0,565,0,451,172,3422
"32003002948",2174,254,0,30,847,93,1692,225,5315
"32003002949",2319,247,161,0,786,0,825,68,4406
"32003002950",2284,392,247,156,1446,160,822,156,5663
"32003002951",3792,357,563,33,2347,565,823,79,8559
"32003002952",1533,235,207,19,260,67,298,96,2715
"32003002953",2903,262,118,0,992,19,813,109,5216
"32003002954",2350,598,408,104,565,41,866,428,5360
"32003002956",1023,150,559,111,487,105,334,123,2892
"32003002957",1818,24,29,0,156,0,158,0,2185
"32003002958",2734,402,619,23,1730,202,957,354,7021
"32003002961",1538,129,98,0,450,8,126,66,2415
"32003002962",777,196,29,29,163,17,91,60,1362
"32003002964",2006,722,883,201,618,121,772,327,5650
"32003002965",2770,559,289,31,361,216,1138,589,5953
"32003002966",2223,424,918,254,549,416,1162,319,6265
"32003002967",1327,612,858,120,790,213,314,274,4508
"32003002968",1111,383,150,142,824,57,338,335,3340
"32003002969",698,9,240,33,278,133,236,14,1641
"32003002970",1703,171,328,0,969,253,587,233,4244
"32003002974",2689,220,294,129,1060,23,718,72,5205
"32003002975",2897,333,242,146,1979,164,1314,215,7290
"32003002976",2358,67,249,214,1054,192,689,10,4833
"32003002977",2024,102,171,15,1082,101,566,17,4078
"32003002978",1630,119,60,106,938,63,602,41,3559
"32003002979",1440,10,377,107,335,32,388,0,2689
"32003002980",2544,21,539,30,3160,139,619,19,7071
"32003002981",2034,100,316,14,1781,19,972,35,5271
"32003002982",2797,176,386,77,3286,413,1083,17,8235
"32003002983",1015,45,598,77,580,44,167,23,2549
"32003002984",1729,70,167,0,1775,94,596,13,4444
"32003002985",1867,147,546,0,1718,68,598,145,5089
"32003002995",1431,339,86,92,548,404,937,431,4268
"32003002996",2031,672,147,69,1338,285,1584,632,6758
"32003003001",2478,117,62,66,887,62,1447,33,5152
"32003003003",3696,129,311,0,1260,336,1406,255,7393
"32003003004",1214,257,156,73,193,46,494,77,2510
"32003003005",2945,45,95,125,516,45,1075,11,4857
"32003003006",2578,350,102,28,421,44,968,221,4712
"32003003102",2642,874,411,122,1117,494,1725,1025,8410
"32003003103",1718,192,201,181,838,13,1228,134,4505
"32003003104",1629,816,391,173,647,80,1123,338,5197
"32003003204",4755,145,466,57,522,27,717,46,6735
"32003003208",2043,68,119,1,653,0,297,26,3207
"32003003210",2177,177,63,0,165,13,44,10,2649
"32003003211",2809,108,56,0,120,0,126,0,3219
"32003003213",1667,57,62,0,197,41,18,0,2042
"32003003214",1313,31,71,6,42,0,16,0,1479
"32003003215",3036,442,476,33,600,114,588,122,5411
"32003003218",4463,89,264,0,937,0,547,0,6300
"32003003219",4265,288,964,29,1068,143,1288,161,8206
"32003003220",3101,779,450,235,1683,71,1698,510,8527
"32003003222",3222,191,531,11,992,49,545,12,5553
"32003003223",2180,255,166,0,491,33,99,95,3319
"32003003226",2024,68,0,0,453,40,193,12,2790
"32003003227",2507,177,219,67,363,49,171,0,3553
"32003003228",2897,1024,619,49,599,27,424,450,6089
"32003003229",1960,163,191,31,540,77,607,34,3603
"32003003230",4160,329,470,0,971,107,1034,134,7205
"32003003231",3444,405,423,0,1141,143,777,0,6333
"32003003232",4775,251,39,0,628,99,722,81,6595
"32003003233",2139,46,467,13,941,0,596,0,4202
"32003003234",2284,266,472,17,652,54,695,24,4464
"32003003235",1608,144,1104,71,493,52,275,45,3792
"32003003236",1559,21,84,0,278,0,145,16,2103
"32003003237",2623,179,294,208,925,87,789,22,5127
"32003003238",4119,458,825,113,952,354,1444,252,8517
"32003003239",2567,73,133,0,604,0,294,0,3671
"32003003240",2763,204,76,7,545,120,548,0,4263
"32003003241",2799,191,225,2,407,51,771,73,4519
"32003003242",1457,82,174,0,271,0,370,12,2366
"32003003243",2774,101,264,31,1031,19,881,15,5116
"32003003244",2134,88,199,0,699,11,549,11,3691
"32003003245",3208,215,286,22,905,24,886,0,5546
"32003003246",2376,135,254,29,1076,3,540,0,4413
"32003003247",2974,62,198,105,499,0,598,8,4444
"32003003248",2260,143,327,267,402,65,606,29,4099
"32003003249",2465,127,125,113,521,202,642,14,4209
"32003003250",3498,133,280,8,1079,1043,538,15,6594
"32003003251",2226,22,52,0,142,169,278,0,2889
"32003003252",3233,185,425,65,966,56,395,71,5396
"32003003253",2421,113,120,2,903,377,800,102,4838
"32003003254",2524,220,431,2,615,8,637,63,4500
"32003003260",2401,259,189,20,574,95,608,85,4231
"32003003261",2396,155,63,55,251,61,690,55,3726
"32003003262",2433,168,43,0,223,0,32,9,2908
"32003003303",2529,191,452,196,1103,194,983,76,5724
"32003003305",2951,461,407,51,616,13,607,12,5118
"32003003306",2825,322,292,72,250,0,332,0,4093
"32003003307",3886,88,781,156,1624,23,1116,152,7826
"32003003308",1546,134,357,7,520,35,477,0,3076
"32003003309",3723,6,29,72,313,0,361,0,4504
"32003003310",3401,170,223,0,508,42,644,0,4988
"32003003311",2455,198,396,388,561,61,934,28,5021
"32003003312",2709,85,213,0,482,23,638,36,4186
"32003003313",2257,91,564,0,265,123,391,39,3730
"32003003314",6040,301,374,25,827,0,2111,41,9719
"32003003315",2865,207,189,21,534,93,580,137,4626
"32003003316",4266,202,239,224,583,62,932,62,6570
"32003003317",2066,84,141,0,159,29,466,54,2999
"32003003318",3252,244,475,182,333,99,350,127,5062
"32003003319",4135,228,912,228,1091,11,1906,0,8511
"32003003320",3638,169,279,0,482,0,977,12,5557
"32003003321",1689,125,148,0,423,0,207,9,2601
"32003003408",3235,447,612,0,757,203,906,129,6289
"32003003409",2749,815,492,268,632,192,1043,368,6559
"32003003410",3105,170,220,280,374,42,631,31,4853
"32003003411",1968,568,366,64,837,29,720,134,4686
"32003003412",2153,380,529,60,659,219,759,139,4898
"32003003413",2504,233,736,125,1334,184,1574,108,6798
"32003003414",1548,74,101,2,290,59,212,62,2348
"32003003415",3065,842,722,451,1555,536,1656,987,9814
"32003003416",1953,68,105,0,757,66,899,37,3885
"32003003418",1820,921,597,290,569,130,1060,529,5916
"32003003419",2561,938,1023,158,1015,612,1494,855,8656
"32003003420",2254,582,232,92,611,654,1237,1012,6674
"32003003421",1885,307,340,88,326,350,355,518,4169
"32003003422",2795,823,293,111,628,206,1130,685,6671
"32003003423",2520,970,818,141,1956,79,2206,434,9124
"32003003426",1446,446,625,16,923,117,761,290,4624
"32003003427",1667,247,432,181,465,313,790,279,4374
"32003003428",765,218,282,30,126,187,450,269,2327
"32003003429",2269,673,304,397,980,269,1840,614,7346
"32003003430",608,306,901,405,406,55,621,180,3482
"32003003431",1135,815,280,265,1005,396,1441,1144,6481
"32003003500",458,92,1264,515,257,450,451,483,3970
"32003003607",4247,465,970,29,2143,73,2694,284,10905
"32003003609",2898,272,518,291,793,136,1274,93,6275
"32003003610",3218,144,718,21,1671,145,2454,150,8521
"32003003612",2905,112,1496,358,1990,145,2113,143,9262
"32003003613",2177,412,1090,247,2472,250,2379,440,9467
"32003003615",1556,166,345,8,570,178,800,175,3798
"32003003616",1198,149,1400,548,1970,181,2636,306,8388
"32003003617",418,35,516,85,450,103,350,81,2038
"32003003618",4660,513,1167,58,1086,144,1158,311,9097
"32003003619",1538,47,204,0,1211,0,731,27,3758
"32003003620",2320,80,799,336,1121,0,586,37,5279
"32003003621",2328,85,201,13,218,35,15,26,2921
"32003003622",3121,163,896,23,1482,66,615,76,6442
"32003003623",2214,250,1079,64,915,166,1080,295,6063
"32003003624",3027,158,1478,368,2067,129,2393,13,9633
"32003003625",3141,630,1587,276,1168,53,1196,406,8457
"32003003626",2496,360,647,34,369,176,785,56,4923
"32003003627",1738,70,884,41,1454,108,1294,143,5732
"32003003628",3684,224,880,445,3060,244,2909,430,11876
"32003003629",2967,302,789,187,1459,41,1814,35,7594
"32003003630",3437,341,1191,49,882,169,1261,131,7461
"32003003631",1949,410,773,50,616,240,981,304,5323
"32003003632",1733,252,500,16,640,0,864,248,4253
"32003003633",2273,292,438,258,405,77,1111,322,5176
"32003003634",2278,56,1112,68,691,149,1267,122,5743
"32003003635",2672,101,554,37,1944,24,1556,53,6941
"32003003636",1739,67,461,18,360,152,244,16,3057
"32003003637",2118,413,709,9,875,80,1109,331,5644
"32003003638",1151,127,427,368,1062,132,739,147,4153
"32003003639",1502,135,477,193,917,98,1057,107,4486
"32003003640",2192,169,763,506,873,0,1546,57,6106
"32003003641",1765,184,2037,268,1035,249,1100,255,6893
"32003003642",1578,142,885,36,1290,178,1631,257,5997
"32003003643",2454,199,795,185,1783,419,2839,472,9146
"32003003644",912,42,1217,507,1312,18,1196,0,5204
"32003003700",406,160,1457,469,505,230,768,343,4338
"32003003800",1434,769,195,379,422,593,1384,1057,6233
"32003004000",1486,578,74,24,621,644,1785,1163,6375
"32003004100",2305,941,92,0,1342,919,3136,1714,10449
"32003004200",1777,1124,239,39,1106,246,2419,1278,8228
"32003004301",202,658,9,52,254,331,433,908,2847
"32003004302",798,1407,217,98,742,614,1460,1887,7223
"32003004401",1085,505,73,62,485,418,1343,861,4832
"32003004402",1204,691,429,169,717,664,1730,1280,6884
"32003004500",1829,849,286,231,1168,480,2670,1094,8607
"32003004601",1187,660,196,400,996,303,1911,907,6560
"32003004602",1152,780,569,40,393,98,1280,839,5151
"32003004703",1817,1275,714,625,634,165,1397,1328,7955
"32003004707",1214,534,18,109,571,379,1339,783,4947
"32003004709",1808,1161,374,371,1689,1060,3016,1963,11442
"32003004710",2637,1497,315,630,988,512,2782,1780,11141
"32003004712",2327,1596,850,858,736,312,1163,997,8839
"32003004713",1404,746,656,604,713,216,1394,635,6368
"32003004714",2281,604,969,166,955,384,2096,875,8330
"32003004715",2374,313,806,365,624,685,1350,858,7375
"32003004716",1158,410,592,91,580,179,1277,464,4751
"32003004717",880,408,158,20,984,146,1353,490,4439
"32003004907",2478,120,201,40,988,37,1191,76,5131
"32003004910",1099,119,164,38,1185,199,1502,159,4465
"32003004911",1653,393,126,170,1305,186,1416,399,5648
"32003004912",2648,716,357,199,1268,211,2492,566,8457
"32003004914",1584,182,84,14,612,116,1179,175,3946
"32003004915",2043,380,71,8,835,282,1253,417,5289
"32003004916",1330,394,321,7,453,127,936,389,3957
"32003004917",1531,68,294,25,893,10,1327,27,4175
"32003004918",2622,417,492,15,722,22,1551,169,6010
"32003004919",3138,178,340,3,731,141,1602,132,6265
"32003004920",1946,1116,400,315,1320,178,2000,670,7945
"32003004921",3189,1079,277,210,702,313,2337,1305,9412
"32003004923",1956,7,316,278,1123,63,1376,15,5134
"32003004924",1929,207,163,301,831,164,1623,320,5538
"32003004925",2735,189,652,0,1807,198,2320,113,8014
"32003004926",2038,64,126,0,1500,57,1552,49,5386
"32003005005",2310,738,93,400,219,81,334,208,4383
"32003005006",2438,473,475,0,848,58,969,137,5398
"32003005007",1374,203,88,34,557,11,214,45,2526
"32003005010",2595,616,164,203,1484,75,1598,493,7228
"32003005011",2267,282,69,0,403,259,1445,470,5195
"32003005012",1629,369,440,35,667,36,897,288,4361
"32003005013",1781,50,94,157,1216,182,1539,10,5029
"32003005014",1832,494,733,115,1606,418,778,407,6383
"32003005015",2244,42,397,0,1403,127,1036,11,5260
"32003005016",3688,113,365,0,1463,30,2424,32,8115
"32003005017",1938,482,437,154,1399,71,1235,413,6129
"32003005101",5268,232,141,103,1038,186,1017,13,7998
"32003005102",3481,382,79,80,596,122,923,6,5669
"32003005103",3403,506,318,156,393,216,883,79,5954
"32003005104",2172,262,185,0,642,60,460,0,3781
"32003005105",4332,953,441,327,1020,152,1435,400,9060
"32003005106",1889,66,367,29,676,35,616,7,3685
"32003005107",3404,265,125,0,769,16,854,147,5580
"32003005108",2416,148,335,0,337,59,470,35,3800
"32003005109",4156,484,468,121,1842,228,855,90,8244
"32003005200",2290,681,42,19,180,17,343,136,3708
"32003005311",1777,243,103,24,492,13,653,24,3329
"32003005312",1689,317,210,0,342,4,193,198,2953
"32003005313",4556,146,288,0,1012,52,905,58,7017
"32003005314",2116,52,101,0,233,0,227,12,2741
"32003005315",3932,142,274,26,696,19,638,0,5727
"32003005316",3124,280,391,181,730,0,790,262,5758
"32003005317",3997,267,80,117,950,49,591,11,6062
"32003005318",2234,160,93,0,553,42,304,0,3386
"32003005319",1987,141,84,3,427,5,434,73,3154
"32003005320",2095,174,143,0,282,24,394,16,3128
"32003005321",2934,241,198,2,560,9,643,51,4638
"32003005322",916,43,0,29,250,31,119,32,1420
"32003005333",2083,107,45,0,150,60,102,29,2576
"32003005335",4018,210,59,43,389,46,527,12,5304
"32003005336",2566,482,229,19,385,8,309,15,4013
"32003005337",2277,173,51,0,236,0,70,0,2807
"32003005338",1866,78,53,0,64,17,228,9,2315
"32003005341",1582,150,71,0,148,44,244,30,2269
"32003005342",3026,111,40,0,340,35,452,50,4054
"32003005343",3589,631,19,0,374,1,403,0,5017
"32003005346",3144,178,469,82,986,122,692,32,5705
"32003005347",3773,212,78,14,874,57,304,0,5312
"32003005348",3431,176,72,0,917,115,400,0,5111
"32003005349",2664,338,100,17,893,42,601,19,4674
"32003005350",2483,399,26,0,365,0,188,0,3461
"32003005351",2732,527,65,73,944,156,322,291,5110
"32003005352",2312,252,78,0,343,46,296,173,3500
"32003005353",2769,119,80,12,525,26,499,0,4030
"32003005354",3032,424,444,0,888,38,648,207,5681
"32003005355",3555,253,163,30,726,15,259,51,5052
"32003005356",1971,5,45,17,357,74,260,0,2729
"32003005357",4015,428,488,87,967,242,511,58,6796
"32003005358",2228,145,25,0,341,48,251,12,3050
"32003005359",5574,328,643,108,488,78,949,0,8168
"32003005360",3857,378,108,0,447,0,517,10,5317
"32003005421",1532,513,216,570,315,75,383,215,3819
"32003005422",2571,566,176,150,487,233,900,440,5523
"32003005423",2560,338,231,614,459,178,703,111,5194
"32003005432",4059,95,455,0,672,11,723,0,6015
"32003005433",3889,281,156,1,456,72,431,68,5354
"32003005434",3701,635,24,13,433,26,408,391,5631
"32003005435",2823,477,58,17,91,158,146,127,3897
"32003005436",5249,315,325,413,1065,56,1016,15,8454
"32003005437",2254,206,95,0,106,0,155,0,2816
"32003005438",1372,106,127,241,178,147,184,85,2440
"32003005439",2063,440,218,143,523,272,881,420,4960
"32003005501",3603,362,0,0,200,15,155,15,4350
"32003005502",3650,248,0,2,129,2,272,32,4335
"32003005503",2504,249,0,0,107,163,100,103,3226
"32003005504",2860,459,0,12,227,54,224,228,4064
"32003005607",2738,244,55,9,329,225,1268,284,5152
"32003005612",1483,111,20,18,110,7,334,0,2083
"32003005613",3700,464,192,0,123,9,391,138,5017
"32003005614",950,424,11,4,411,257,700,427,3184
"32003005615",1420,131,0,0,109,65,381,73,2179
"32003005702",1898,860,77,33,134,182,137,247,3568
"32003005703",537,219,96,11,204,25,117,8,1217
"32003005704",1541,540,109,0,84,51,418,50,2793
"32003005705",2039,249,11,0,182,0,176,24,2681
"32003005711",3573,34,25,0,874,155,537,7,5205
"32003005712",6303,262,258,122,1062,58,962,0,9027
"32003005713",4716,149,101,19,1015,134,326,17,6477
"32003005714",5098,137,148,0,509,39,330,0,6261
"32003005715",3424,143,156,0,742,62,72,15,4614
"32003005716",2556,118,197,10,666,41,72,0,3660
"32003005803",2928,428,149,68,578,226,536,17,4930
"32003005804",3225,117,281,0,578,143,514,0,4858
"32003005805",2732,95,153,70,324,44,350,0,3768
"32003005806",2539,374,183,46,293,220,577,227,4459
"32003005807",2772,194,205,0,644,73,353,14,4255
"32003005808",2015,90,205,21,568,63,263,0,3225
"32003005809",2570,530,313,12,437,258,879,326,5325
"32003005811",4589,332,751,24,2064,186,1283,199,9428
"32003005813",2340,74,589,161,1085,12,1085,70,5416
"32003005818",726,166,35,0,73,0,211,0,1211
"32003005822",4179,203,76,0,1118,482,223,19,6300
"32003005823",2501,38,378,0,1084,0,213,8,4222
"32003005824",2427,214,51,0,489,133,335,284,3933
"32003005825",3220,312,334,48,1073,528,1146,249,6910
"32003005826",1280,310,515,120,1714,227,343,177,4686
"32003005827",4138,235,178,42,1397,205,387,22,6604
"32003005828",3677,144,541,15,2120,52,401,68,7018
"32003005829",3350,289,335,0,1802,143,787,161,6867
"32003005830",1526,43,574,0,1363,95,618,0,4219
"32003005831",2193,67,176,165,772,37,459,0,3869
"32003005832",1639,209,65,0,1458,67,751,0,4189
"32003005833",3504,261,515,195,2321,162,1082,116,8156
"32003005834",2291,164,98,71,367,46,867,52,3956
"32003005835",2613,63,600,25,1064,25,894,0,5284
"32003005836",2925,91,64,0,1019,0,570,0,4669
"32003005837",2374,241,312,0,875,46,785,54,4687
"32003005838",3230,111,390,0,2061,223,639,13,6667
"32003005839",2724,56,58,0,1046,25,427,0,4336
"32003005840",5270,246,667,73,3162,74,2131,58,11681
"32003005841",3350,74,310,0,728,0,179,0,4641
"32003005842",1507,46,188,165,154,106,35,6,2207
"32003005843",1885,82,102,0,584,0,82,20,2755
"32003005844",5805,125,146,0,418,82,649,50,7275
"32003005845",2921,262,328,0,681,0,608,0,4800
"32003005846",3529,174,150,0,822,87,462,13,5237
"32003005847",1016,61,120,28,544,66,111,0,1946
"32003005848",2299,216,530,174,935,390,473,222,5239
"32003005849",2322,151,527,9,767,7,907,0,4690
"32003005850",2446,81,322,69,1596,189,552,39,5294
"32003005851",3376,556,219,34,1937,100,1267,216,7705
"32003005852",2813,157,237,27,995,53,561,0,4843
"32003005853",5267,797,548,105,1210,300,2074,265,10566
"32003005854",4921,544,624,236,1688,325,1346,0,9684
"32003005855",2579,297,463,28,2045,18,594,32,6056
"32003005856",2178,48,74,0,1466,197,171,35,4169
"32003005902",806,32,0,1,387,165,269,64,1724
"32003005903",2252,238,6,0,68,0,303,14,2881
"32003005904",1535,79,0,0,46,0,60,5,1725
"32003005905",1628,259,0,0,173,7,190,9,2266
"32003006001",1999,83,865,296,397,431,700,261,5032
"32003006103",1667,186,232,111,403,250,811,425,4085
"32003006104",1942,456,264,84,553,67,878,394,4638
"32003006201",1251,1355,676,18,647,232,890,943,6012
"32003006202",2154,797,203,0,565,56,1413,668,5856
"32003006203",1766,508,140,113,328,161,741,290,4047
"32003006204",1967,557,199,430,1148,104,1484,281,6170
"32003006700",636,118,32,0,107,53,177,72,1195
"32003006800",1902,468,466,232,511,211,1121,332,5243
"32003006900",1249,136,59,22,111,6,158,0,1741
"32003007100",1387,832,128,45,424,252,1193,768,5029
"32003007200",1934,255,187,475,810,284,1350,261,5556
"32003007500",984,55,0,0,64,72,106,4,1285
"32003007600",3093,421,0,0,651,23,1246,253,5687
"32003007800",753,580,52,195,179,30,222,68,2079
"32005001000",2427,263,21,0,176,0,236,28,3151
"32005001100",3590,785,43,0,711,272,471,360,6232
"32005001200",2445,468,0,0,21,32,69,83,3118
"32005001300",1537,17,0,0,26,0,80,0,1660
"32005001400",2742,173,0,0,233,55,194,3,3400
"32005001500",4118,394,96,28,682,194,877,194,6583
"32005001600",914,56,6,0,30,0,19,5,1030
"32005001700",1299,129,0,0,231,63,460,75,2257
"32005001800",1698,136,0,0,131,26,249,0,2240
"32005001900",1156,18,0,0,285,0,207,4,1670
"32005002000",2650,668,0,0,276,29,332,156,4111
"32005002100",1479,192,11,0,148,0,94,87,2011
"32005002200",6401,54,0,0,194,0,508,0,7157
"32005002300",3280,239,0,2,176,5,133,0,3835
"32005002400",746,84,8,2,268,166,132,22,1428
"32005002500",1497,165,6,0,115,42,156,36,2017
"32005990000",0,0,0,0,0,0,0,0,0
"32007950200",1633,105,0,0,89,43,389,47,2306
"32007950701",4518,185,44,45,516,126,1146,13,6593
"32007950702",3855,192,74,0,798,220,656,57,5852
"32007950800",1563,70,10,0,82,30,201,30,1986
"32007950900",1591,147,117,0,299,52,373,46,2625
"32007951000",1225,46,33,0,100,0,468,10,1882
"32007951201",3900,106,0,0,290,2,193,0,4491
"32007951202",2248,337,9,0,201,70,816,218,3899
"32007951300",2157,208,14,0,263,57,1351,80,4130
"32007951401",4238,70,22,12,474,0,1082,12,5910
"32007951402",6165,369,0,0,176,0,361,94,7165
"32007951500",3396,1033,0,0,94,117,1803,716,7159
"32007951600",2371,150,10,0,0,0,251,0,2782
"32007951700",1565,235,0,39,858,263,941,134,4035
"32009950100",729,147,0,0,15,66,111,44,1112
"32011000100",1461,240,0,0,71,8,59,10,1849
"32013010500",4653,552,26,1,525,299,1412,4,7472
"32013010600",2023,147,0,0,196,3,343,0,2712
"32013010701",3382,719,0,0,274,79,1205,330,5989
"32013010702",3029,144,7,0,331,79,680,35,4305
"32015000300",4874,460,0,4,315,70,1322,138,7183
"32017950100",2191,355,0,0,150,93,0,80,2869
"32017950200",1722,332,0,0,36,79,127,69,2365
"32019960101",7989,945,53,57,1043,0,1216,147,11450
"32019960102",6219,605,81,35,848,48,1318,147,9301
"32019960103",844,171,0,7,27,19,433,37,1538
"32019960201",3220,532,7,0,351,23,330,40,4503
"32019960202",1997,911,77,0,248,125,102,189,3649
"32019960301",1116,698,0,0,78,67,235,91,2285
"32019960302",6682,1469,0,0,877,76,1166,323,10593
"32019960303",3308,404,0,0,356,64,272,7,4411
"32019960800",3156,258,46,3,207,5,570,13,4258
"32019960900",3529,915,3,0,897,185,876,191,6596
"32021970700",2204,455,46,29,595,56,287,105,3777
"32021970800",391,184,0,0,390,213,77,15,1270
"32023960100",2133,259,0,1,364,118,273,2,3150
"32023960200",2273,382,0,0,91,47,314,63,3170
"32023960300",1135,713,0,0,292,0,428,167,2735
"32023960401",4349,421,212,14,105,301,441,232,6075
"32023960402",3879,980,77,0,433,78,719,162,6328
"32023960403",3548,1204,116,193,82,0,405,379,5927
"32023960404",5906,1131,133,0,373,283,570,512,8908
"32023960405",2735,1057,93,3,81,6,506,156,4637
"32023960406",5352,802,97,97,901,21,508,127,7905
"32023980500",0,0,0,0,0,0,0,0,0
"32027960100",3544,706,8,3,454,170,637,249,5771
"32029970200",3277,411,2,7,224,15,40,47,4023
"32031000101",1715,675,36,50,171,206,78,201,3132
"32031000102",1020,898,1,171,353,265,207,262,3177
"32031000201",2454,543,5,67,213,82,1349,366,5079
"32031000202",1507,616,6,0,278,91,464,212,3174
"32031000300",2850,422,10,0,311,150,392,98,4233
"32031000400",4279,638,51,6,240,56,98,38,5406
"32031000700",2076,1639,177,0,1267,176,813,638,6786
"32031000900",1958,1340,11,346,391,270,1577,1215,7108
"32031001005",2099,376,0,28,356,75,385,125,3444
"32031001008",1997,1196,130,15,464,428,1336,943,6509
"32031001009",1535,384,0,0,403,34,657,282,3295
"32031001010",2466,226,18,0,168,19,86,5,2988
"32031001011",3542,26,17,17,182,17,100,0,3901
"32031001012",2288,362,82,38,270,70,50,28,3188
"32031001013",6131,83,0,24,629,42,180,42,7131
"32031001014",1884,95,0,0,528,36,224,0,2767
"32031001015",3561,187,33,65,273,11,198,2,4330
"32031001101",2580,164,0,0,86,19,148,14,3011
"32031001103",4318,155,122,0,432,0,38,0,5065
"32031001104",3548,131,0,0,575,2,132,0,4388
"32031001105",3407,164,0,16,195,9,245,28,4064
"32031001201",1656,421,0,24,204,10,99,226,2640
"32031001202",2708,419,222,45,607,249,601,102,4953
"32031001300",2325,607,15,35,482,215,424,231,4334
"32031001400",1421,1002,116,21,406,162,214,190,3532
"32031001501",2840,402,86,0,946,7,1159,158,5598
"32031001502",1842,1069,349,183,438,480,730,557,5648
"32031001701",992,845,81,278,746,642,732,877,5193
"32031001702",2588,720,84,48,1010,359,1097,620,6526
"32031001801",1413,942,67,32,865,248,1443,698,5708
"32031001802",1136,561,84,48,920,193,1159,587,4688
"32031001901",2372,1511,138,108,614,390,1569,1448,8150
"32031001902",2376,866,0,28,1073,184,1476,435,6438
"32031002103",2569,40,0,0,235,0,546,0,3390
"32031002104",2477,283,31,8,130,42,292,186,3449
"32031002105",3290,494,228,0,749,37,1148,143,6089
"32031002106",2409,172,29,0,524,41,849,0,4024
"32031002107",477,383,10,11,485,312,222,401,2301
"32031002204",2525,843,275,0,566,507,1369,922,7007
"32031002205",3664,301,91,42,633,135,1140,297,6303
"32031002206",4566,521,116,0,1059,140,814,113,7329
"32031002207",2826,0,97,0,770,8,185,0,3886
"32031002208",2265,80,31,0,218,76,267,18,2955
"32031002209",3949,172,33,0,1208,114,883,114,6473
"32031002210",2072,46,0,0,88,29,235,0,2470
"32031002211",2306,1250,10,0,393,106,1625,1079,6769
"32031002212",1875,1903,36,363,74,329,1386,2051,8017
"32031002301",4078,118,57,0,518,21,299,0,5091
"32031002302",2317,78,0,0,162,0,91,0,2648
"32031002401",2315,266,2,0,847,58,404,0,3892
"32031002406",3269,855,103,14,554,127,531,373,5826
"32031002407",2625,514,61,13,373,65,362,178,4191
"32031002408",3152,145,9,49,215,58,213,15,3856
"32031002409",3772,285,51,0,347,0,552,0,5007
"32031002410",3123,319,62,0,602,0,765,147,5018
"32031002411",2836,301,192,0,376,64,385,90,4244
"32031002412",1795,8,0,0,594,19,279,0,2695
"32031002500",3272,522,88,38,644,489,471,462,5986
"32031002603",1229,60,0,0,39,13,102,3,1446
"32031002610",4359,216,32,0,902,99,1397,81,7086
"32031002611",3444,1722,222,218,574,554,1230,879,8843
"32031002612",2615,640,79,0,165,8,398,35,3940
"32031002613",4297,215,159,0,546,0,675,0,5892
"32031002614",2526,238,56,0,1186,280,1434,297,6017
"32031002615",2004,284,72,46,765,60,688,225,4144
"32031002616",2566,402,213,0,835,144,1178,177,5515
"32031002617",4197,431,96,20,1192,161,2186,170,8453
"32031002618",5471,249,0,1,629,153,986,152,7641
"32031002619",4315,1088,213,50,249,47,849,566,7377
"32031002703",1295,415,82,64,550,57,822,198,3483
"32031002704",2966,825,122,26,540,209,1216,539,6443
"32031002705",2708,898,38,71,384,31,468,310,4908
"32031002706",2947,816,53,175,653,283,1006,440,6373
"32031002707",2893,684,36,51,609,35,1104,382,5794
"32031002801",2627,632,190,36,933,121,1349,441,6329
"32031002802",2672,858,21,13,1380,96,1306,590,6936
"32031002901",2845,360,0,0,298,0,1006,63,4572
"32031002902",2328,683,257,23,795,250,972,492,5800
"32031003000",4424,682,62,0,1175,97,2037,207,8684
"32031003101",2583,660,99,119,476,132,798,316,5183
"32031003105",1686,208,0,0,232,57,378,20,2581
"32031003106",4558,700,96,0,1249,290,1486,402,8781
"32031003108",2549,97,60,0,421,18,469,12,3626
"32031003109",2285,130,0,0,379,18,135,1,2948
"32031003110",3526,473,215,0,690,133,608,133,5778
"32031003202",5511,320,0,0,263,24,347,24,6489
"32031003203",4267,139,18,6,268,8,184,9,4899
"32031003204",2423,91,45,0,135,0,47,0,2741
"32031003305",1033,100,0,0,160,0,367,0,1660
"32031003306",1194,160,0,0,246,52,517,143,2312
"32031003307",764,200,0,0,0,0,90,0,1054
"32031003308",1845,112,0,0,134,11,120,0,2222
"32031003309",2049,187,0,0,219,0,63,0,2518
"32031003501",2891,164,55,0,621,182,195,26,4134
"32031003503",4221,123,48,0,262,31,1119,1,5805
"32031003504",6827,274,88,0,653,13,735,0,8590
"32031003507",3300,110,59,0,482,79,439,79,4548
"32031003508",2388,95,0,0,663,0,600,0,3746
"32031003509",3888,166,199,63,1025,12,1389,18,6760
"32031003510",2021,306,41,0,487,129,402,334,3720
"32031003511",4527,254,57,0,389,0,392,34,5653
"32031003512",3717,232,68,18,347,0,323,69,4774
"32031003513",1746,69,26,0,357,8,549,0,2755
"32031003514",1968,97,131,0,230,37,158,0,2621
"32031003515",4636,128,61,41,1000,12,943,73,6894
"32031940200",266,80,0,0,843,407,53,66,1715
"32031980000",18,31,0,13,0,0,0,15,77
"32031980100",0,0,0,0,0,0,0,0,0
"32031980200",0,0,0,0,0,0,0,0,0
"32031980300",0,0,0,0,0,0,0,0,0
"32031990000",0,0,0,0,0,0,0,0,0
"32031990100",0,0,0,0,0,0,0,0,0
"32033970100",1531,265,0,0,88,49,48,26,2007
"32033970200",3819,572,30,0,436,90,562,145,5654
"32033970300",1742,162,0,0,276,33,344,45,2602
"32510000100",2580,133,120,0,177,48,148,45,3251
"32510000200",2972,620,48,0,178,9,394,199,4420
"32510000300",3180,52,0,80,322,47,107,7,3795
"32510000400",2861,485,0,0,388,125,701,51,4611
"32510000501",3651,950,115,0,718,75,1412,595,7516
"32510000502",2156,843,0,0,222,210,559,399,4389
"32510000600",3646,744,157,0,584,82,923,93,6229
"32510000701",3411,274,0,0,242,0,518,70,4515
"32510000702",2669,548,40,0,112,167,237,561,4334
"32510000800",2309,191,0,0,229,66,354,0,3149
"32510000900",3274,878,0,0,1059,0,953,73,6237
"32510001001",2250,1036,30,19,757,537,1386,1008,7023
"32510001002",3018,289,85,0,696,49,891,0,5028
"32510990000",0,0,0,0,0,0,0,0,0
"33001965100",2810,307,7,0,116,9,0,0,3249
"33001965200",2536,455,0,0,15,0,0,0,3006
"33001965300",2832,276,25,0,77,0,16,20,3246
"33001965400",2921,45,0,0,0,0,101,0,3067
"33001965598",3030,296,0,0,12,44,40,44,3466
"33001965600",3177,451,0,0,82,21,24,0,3755
"33001965700",4307,145,0,0,141,0,26,0,4619
"33001965800",6201,494,248,40,294,0,272,65,7614
"33001965900",3099,475,0,0,103,72,68,0,3817
"33001966000",3658,827,0,0,187,64,0,0,4736
"33001966100",3813,328,0,0,62,26,0,0,4229
"33001966200",2152,562,0,0,30,16,43,0,2803
"33001966401",1187,135,0,0,39,0,26,0,1387
"33001966402",5301,340,44,0,37,53,15,30,5820
"33001966500",4585,368,74,0,226,0,13,0,5266
"33003955100",3556,314,2,3,49,20,0,15,3959
"33003955300",5136,752,52,0,150,81,11,67,6249
"33003955400",3563,461,0,0,170,1,0,17,4212
"33003955500",2707,115,16,0,7,0,1,0,2846
"33003955600",4316,672,28,0,63,0,8,0,5087
"33003955800",2179,344,10,0,22,11,4,0,2570
"33003955900",3204,840,0,0,68,0,33,0,4145
"33003956000",5199,362,4,0,153,6,131,0,5855
"33003956100",5561,435,0,0,129,0,164,0,6289
"33003956300",3778,146,0,1,109,0,33,16,4083
"33003956400",2177,192,3,0,10,0,0,0,2382
"33005970100",3912,272,14,0,60,6,67,0,4331
"33005970200",3280,211,0,0,193,36,84,12,3816
"33005970400",4766,248,39,0,73,0,55,0,5181
"33005970500",4866,386,0,0,39,39,21,0,5351
"33005970600",3797,674,81,14,111,114,8,32,4831
"33005970700",3118,191,19,0,173,0,32,0,3533
"33005970800",3688,359,38,0,105,5,32,0,4227
"33005970900",6282,605,0,0,128,165,113,77,7370
"33005971000",4578,738,61,0,64,50,46,131,5668
"33005971100",4238,923,0,2,58,58,12,2,5293
"33005971300",2084,659,0,0,210,0,58,0,3011
"33005971401",1666,744,20,0,91,52,36,11,2620
"33005971402",3336,290,0,0,204,6,49,0,3885
"33005971500",4981,243,4,0,202,0,73,40,5543
"33005971600",3562,296,37,0,113,0,55,0,4063
"33005971700",3343,743,0,0,117,40,24,0,4267
"33007950100",1699,300,0,5,33,6,39,6,2088
"33007950200",2530,428,9,0,64,0,24,0,3055
"33007950300",1748,160,4,0,72,6,51,9,2050
"33007950400",2783,582,7,38,55,0,11,0,3476
"33007950500",2852,361,16,17,70,0,0,1,3317
"33007950600",2551,719,0,0,109,62,50,31,3522
"33007950700",2813,222,0,0,40,6,38,0,3119
"33007950800",1873,466,0,12,78,0,0,0,2429
"33007950900",2916,213,0,0,50,0,53,0,3232
"33007951000",1919,281,0,0,67,0,11,9,2287
"33007951100",2587,290,33,0,93,4,45,16,3068
"33009960100",5191,508,30,13,168,0,146,30,6086
"33009960200",3722,359,10,0,79,91,25,0,4286
"33009960300",4148,446,17,0,187,13,64,11,4886
"33009960400",3399,451,13,0,91,0,32,24,4010
"33009960500",2128,200,0,0,27,8,3,4,2370
"33009960600",3503,795,7,0,153,0,20,0,4478
"33009960700",2800,262,13,0,68,6,17,0,3166
"33009960800",4389,463,10,0,148,11,0,0,5021
"33009960900",2911,275,11,0,124,0,38,0,3359
"33009961000",3887,1111,2,0,257,96,168,0,5521
"33009961100",3099,423,19,0,45,0,19,8,3613
"33009961200",3639,408,29,0,95,0,13,0,4184
"33009961300",3085,342,0,0,99,4,38,2,3570
"33009961400",3350,418,0,0,62,13,10,0,3853
"33009961500",4369,90,0,52,40,0,50,0,4601
"33009961601",2526,98,0,0,96,21,14,0,2755
"33009961602",3441,399,0,43,217,241,18,5,4364
"33009961700",5065,913,0,26,943,344,287,72,7650
"33009961800",5106,185,16,27,486,82,211,0,6113
"33011000101",2575,38,12,78,83,71,24,26,2907
"33011000102",3332,136,105,0,240,348,65,0,4226
"33011000202",1714,301,100,0,34,33,13,20,2215
"33011000203",2328,201,20,0,131,0,21,0,2701
"33011000204",3512,454,372,95,521,43,227,0,5224
"33011000300",2342,722,22,0,120,0,55,154,3415
"33011000600",1376,364,47,25,68,53,130,31,2094
"33011000700",2648,172,17,28,101,0,49,0,3015
"33011000800",1958,261,34,66,116,4,429,28,2896
"33011000901",3130,208,91,0,80,131,324,67,4031
"33011000902",4018,274,454,0,611,34,88,34,5513
"33011001000",4580,201,14,0,542,0,90,0,5427
"33011001100",4880,189,63,0,137,69,231,0,5569
"33011001200",1541,193,50,51,46,16,108,129,2134
"33011001300",2119,586,287,61,137,235,683,173,4281
"33011001400",1089,520,89,72,305,189,345,257,2866
"33011001500",950,678,84,456,568,373,367,243,3719
"33011001600",2279,968,231,80,570,108,520,352,5108
"33011001700",1666,152,87,0,56,42,144,35,2182
"33011001800",4170,525,114,12,462,140,582,92,6097
"33011001900",1359,319,107,248,566,15,403,82,3099
"33011002000",1137,606,82,109,288,107,64,129,2522
"33011002100",3160,987,194,31,455,199,371,166,5563
"33011002200",2952,380,21,0,44,21,10,21,3449
"33011002300",3449,140,41,0,169,0,304,1,4104
"33011002400",5645,567,512,154,386,51,322,45,7682
"33011002500",4421,344,1,0,123,97,99,24,5109
"33011002600",5122,217,0,0,219,0,93,0,5651
"33011002701",3730,99,0,0,85,0,225,0,4139
"33011002702",5712,232,176,0,48,0,0,49,6217
"33011002800",4702,281,91,0,55,24,109,24,5286
"33011002901",6183,382,65,21,334,0,68,0,7053
"33011002902",4920,164,303,192,140,0,54,37,5810
"33011002903",8006,33,7,0,109,0,177,0,8332
"33011010100",4698,127,165,0,217,0,193,14,5414
"33011010200",5321,487,67,23,1035,19,294,73,7319
"33011010301",3959,27,0,0,413,0,275,0,4674
"33011010302",3641,180,26,0,294,0,377,9,4527
"33011010400",4451,194,93,0,485,0,320,16,5559
"33011010500",2216,1042,103,16,362,314,562,822,5437
"33011010600",3261,689,350,225,311,330,483,539,6188
"33011010700",742,288,12,0,175,69,211,92,1589
"33011010800",4016,2186,157,49,504,217,1165,762,9056
"33011010900",4455,1084,167,0,833,81,553,163,7336
"33011011000",4109,273,67,0,214,95,154,0,4912
"33011011101",2850,224,59,14,509,8,112,11,3787
"33011011102",2236,164,0,11,733,73,255,6,3478
"33011011200",4744,110,82,0,1222,0,142,0,6300
"33011011300",3814,102,56,74,301,25,44,0,4416
"33011011401",4244,120,21,0,724,0,350,0,5459
"33011011402",4066,180,32,0,930,0,420,23,5651
"33011011500",2221,38,0,0,142,7,98,7,2513
"33011012100",7450,214,84,0,379,0,87,0,8214
"33011012200",6739,472,145,0,117,70,464,48,8055
"33011012300",7811,346,82,0,430,0,253,0,8922
"33011013100",7912,194,45,0,148,0,259,0,8558
"33011014100",4432,409,40,0,268,10,179,0,5338
"33011014201",5632,84,0,26,175,49,305,0,6271
"33011014202",5484,151,0,0,174,0,36,0,5845
"33011014300",7741,326,0,0,350,0,199,1,8617
"33011015100",5015,134,40,0,167,0,164,0,5520
"33011015200",5273,76,0,0,406,113,266,113,6247
"33011016100",2508,90,32,0,224,71,124,0,3049
"33011016201",5504,554,81,13,394,81,29,92,6748
"33011016202",5095,198,0,0,98,0,150,0,5541
"33011017100",7416,102,20,0,139,9,223,0,7909
"33011018000",4767,108,3,0,145,0,77,0,5100
"33011018501",1987,238,0,0,72,0,5,0,2302
"33011018502",1095,220,0,0,21,23,8,0,1367
"33011019000",3397,188,15,2,76,0,27,2,3707
"33011019501",1422,86,4,0,51,4,17,0,1584
"33011019502",2235,187,0,0,31,0,31,0,2484
"33011020000",4999,132,25,0,165,0,15,0,5336
"33011021000",8441,171,16,0,200,0,174,0,9002
"33011021500",4244,277,17,0,111,56,60,0,4765
"33011022000",1256,87,0,0,82,6,21,0,1452
"33011022500",6484,394,0,0,149,2,92,31,7152
"33011023000",5619,237,28,3,245,2,15,2,6151
"33011024000",1634,97,4,3,32,4,29,0,1803
"33011025000",2311,250,19,0,30,18,19,0,2647
"33011025500",5204,772,3,0,174,3,33,3,6192
"33011200100",4218,149,36,0,141,0,22,18,4584
"33011200200",3910,111,0,0,109,12,85,0,4227
"33011200300",3761,261,32,13,143,53,22,0,4285
"33011200400",1828,483,217,8,116,142,181,164,3139
"33011980101",0,0,0,0,0,0,0,0,0
"33013003001",3643,108,43,0,41,4,150,0,3989
"33013003006",3249,107,6,1,0,0,123,0,3486
"33013003100",3874,325,18,0,66,0,75,0,4358
"33013003200",6358,557,0,0,201,13,166,0,7295
"33013030000",2395,209,6,0,155,0,17,0,2782
"33013031001",3765,90,0,0,53,0,53,0,3961
"33013031002",3451,95,0,0,119,0,0,0,3665
"33013032100",3440,63,17,0,118,0,9,5,3652
"33013032200",2463,345,57,45,68,0,102,0,3080
"33013032300",1372,300,0,5,37,27,23,21,1785
"33013032400",2671,385,26,0,51,70,16,10,3229
"33013032500",2891,380,17,22,70,0,10,0,3390
"33013032600",2093,168,33,12,33,6,0,0,2345
"33013032701",1274,143,37,0,153,0,102,0,1709
"33013032706",3406,367,88,13,44,8,239,0,4165
"33013032800",4774,110,0,0,317,0,73,4,5278
"33013032900",2543,532,228,80,251,277,6,13,3930
"33013033000",2330,137,0,0,61,0,15,0,2543
"33013034000",4249,155,0,0,55,0,11,0,4470
"33013035000",3070,753,26,44,163,13,47,0,4116
"33013036000",4794,351,8,0,129,39,8,6,5335
"33013037000",2198,85,3,0,4,0,57,0,2347
"33013038000",2908,443,1,44,0,11,0,17,3424
"33013038500",4165,322,0,0,44,0,42,0,4573
"33013039000",5289,171,16,0,113,0,9,9,5607
"33013040000",3830,254,51,1,28,0,58,0,4222
"33013040500",4879,280,3,1,207,4,42,0,5416
"33013041000",3236,183,9,0,46,45,18,0,3537
"33013041500",3444,302,3,0,85,9,0,7,3850
"33013042500",3380,269,17,0,121,30,43,0,3860
"33013043001",3028,1078,11,0,19,34,34,28,4232
"33013043002",3253,555,63,61,204,17,46,38,4237
"33013044000",3891,535,20,2,79,229,57,0,4813
"33013044100",2541,372,2,33,210,73,147,0,3378
"33013044200",5095,104,0,0,348,0,193,0,5740
"33013044300",3867,268,223,0,135,0,62,0,4555
"33015003301",4208,156,0,0,215,1,162,0,4742
"33015003302",4089,237,82,0,107,6,87,0,4608
"33015003400",4283,720,134,0,136,0,79,0,5352
"33015003500",4906,514,130,79,209,12,286,0,6136
"33015003601",6268,462,188,0,321,0,101,45,7385
"33015003602",5197,213,17,0,95,0,19,0,5541
"33015003701",3076,146,65,0,112,0,92,11,3502
"33015003703",5223,101,11,0,123,0,70,0,5528
"33015003801",3603,111,15,0,166,0,232,0,4127
"33015003802",3855,86,39,0,87,13,140,7,4227
"33015003901",3457,134,13,0,197,0,86,10,3897
"33015003902",3452,76,9,0,0,0,9,0,3546
"33015004000",4680,155,15,0,156,20,71,0,5097
"33015050000",3612,174,0,0,99,0,58,0,3943
"33015051000",4267,268,19,9,113,0,73,33,4782
"33015052000",5544,400,16,0,103,8,32,8,6111
"33015053000",4180,142,0,0,69,0,37,0,4428
"33015054000",4038,96,40,0,90,12,108,12,4396
"33015055001",5520,265,30,1,101,0,170,0,6087
"33015055002",3640,400,26,0,143,0,48,79,4336
"33015056000",4144,145,6,0,7,0,48,0,4350
"33015057000",3780,297,23,0,145,8,68,11,4332
"33015058000",4476,160,54,0,76,0,22,0,4788
"33015059000",6098,272,0,0,112,10,13,0,6505
"33015060000",3688,260,0,13,96,9,54,9,4129
"33015061001",5338,378,0,0,119,0,12,0,5847
"33015062000",2326,95,0,0,61,0,14,0,2496
"33015062500",2754,46,0,0,57,4,42,4,2907
"33015063001",2965,218,8,0,168,80,34,80,3553
"33015063002",4652,502,0,0,101,17,0,0,5272
"33015064000",2120,65,0,0,124,6,0,0,2315
"33015065001",6962,391,97,0,486,61,23,0,8020
"33015065005",2062,89,0,0,19,0,37,0,2207
"33015065006",1452,58,0,0,23,0,0,0,1533
"33015065007",1188,6,0,0,28,0,41,0,1263
"33015065008",1339,502,0,0,27,0,7,0,1875
"33015066000",4121,85,44,0,36,42,40,23,4391
"33015067000",7073,42,0,1,141,0,64,1,7322
"33015067501",5979,586,34,0,448,20,100,0,7167
"33015067502",2678,334,140,26,223,31,46,22,3500
"33015069100",3539,197,14,0,18,17,71,0,3856
"33015069200",2528,243,7,0,110,7,0,0,2895
"33015069300",1871,123,7,12,3,35,32,0,2083
"33015069700",2527,39,0,43,250,5,66,8,2938
"33015071000",5057,210,0,0,12,0,10,0,5289
"33015100100",6299,106,25,0,240,0,131,0,6801
"33015100200",5057,354,0,0,131,0,33,0,5575
"33015100301",4094,164,80,13,199,21,249,13,4833
"33015100302",3618,166,27,0,593,69,523,137,5133
"33015100400",6547,361,86,13,385,34,505,0,7931
"33015101100",7125,413,2,0,50,0,101,0,7691
"33015102100",4292,338,11,7,17,0,175,81,4921
"33015103100",6398,220,0,0,157,0,195,13,6983
"33015104101",4505,241,19,0,106,0,27,19,4917
"33015104102",3444,70,0,0,141,0,21,0,3676
"33015105100",5536,264,0,0,192,0,83,0,6075
"33015106101",6618,226,0,0,468,80,42,0,7434
"33015106102",5909,158,36,0,241,0,39,0,6383
"33015106200",3354,477,0,108,100,75,55,131,4300
"33015106400",3959,151,66,12,14,31,60,0,4293
"33015107100",1906,299,115,8,322,38,257,0,2945
"33015107200",4485,679,263,0,472,2,228,136,6265
"33015107400",1199,81,12,0,102,0,35,0,1429
"33015107500",4044,141,1,0,157,10,62,0,4415
"33015980011",0,0,0,0,0,0,0,0,0
"33015990000",0,0,0,0,0,0,0,0,0
"33017080100",3085,26,11,0,202,0,73,0,3397
"33017080202",1795,801,0,0,211,0,19,1,2827
"33017080203",657,384,0,0,107,45,0,0,1193
"33017080204",515,456,0,0,43,0,0,0,1014
"33017080500",5655,264,9,0,408,0,117,0,6453
"33017081100",5510,356,126,0,476,35,17,0,6520
"33017081200",4117,72,0,0,140,0,68,0,4397
"33017081300",3733,756,0,0,97,31,0,0,4617
"33017081400",1288,226,45,0,205,25,37,0,1826
"33017081500",4642,454,15,78,514,2,157,0,5862
"33017081600",5215,494,47,0,559,14,20,0,6349
"33017082000",2204,218,22,0,76,0,50,39,2609
"33017083001",5165,675,123,0,550,316,324,87,7240
"33017083002",3600,689,213,0,336,60,160,0,5058
"33017084100",4622,166,0,0,163,12,18,0,4981
"33017084200",7363,620,82,0,182,7,40,0,8294
"33017084300",4225,917,0,0,310,16,297,0,5765
"33017084400",3122,682,62,40,112,156,56,135,4365
"33017084500",3069,719,22,23,113,33,28,0,4007
"33017084600",2436,134,0,0,5,0,22,0,2597
"33017085000",8098,449,0,0,72,0,143,0,8762
"33017086000",3779,35,34,0,130,2,178,0,4158
"33017087000",5760,884,0,0,80,55,0,29,6808
"33017088000",4031,487,0,0,48,0,25,16,4607
"33017088500",3855,271,6,0,12,7,14,0,4165
"33019975100",3734,71,16,0,215,7,72,0,4115
"33019975200",4675,143,14,0,94,11,30,0,4967
"33019975300",2879,228,0,0,241,0,105,0,3453
"33019975400",5468,645,0,0,189,35,22,2,6361
"33019975500",2597,301,4,0,60,27,52,0,3041
"33019975600",2697,160,0,0,67,8,43,0,2975
"33019975700",4298,510,84,0,151,10,7,0,5060
"33019975800",4339,698,11,15,206,15,102,24,5410
"33019975901",3409,887,12,0,0,0,0,9,4317
"33019975902",3027,461,0,0,12,0,46,0,3546
"34001000100",1150,158,229,389,393,159,644,111,3233
"34001000200",1535,199,266,0,811,322,461,34,3628
"34001000300",1321,476,269,113,1136,577,941,547,5380
"34001000400",1080,293,519,129,458,275,487,126,3367
"34001000500",776,480,101,161,1187,400,529,637,4271
"34001001100",47,58,1209,429,89,14,35,0,1881
"34001001200",387,208,1491,529,182,181,412,239,3629
"34001001300",78,112,1110,349,346,0,68,116,2179
"34001001400",480,446,1511,1153,0,570,319,947,5426
"34001001500",136,161,354,708,42,139,56,151,1747
"34001001900",577,50,572,161,262,7,573,38,2240
"34001002300",665,612,56,90,886,410,647,335,3701
"34001002400",798,422,319,1062,273,188,452,290,3804
"34001002500",432,244,1755,782,498,230,362,84,4387
"34001010101",2943,200,0,0,22,0,34,21,3220
"34001010102",1536,144,20,0,88,35,78,0,1901
"34001010104",1455,245,0,0,77,0,95,56,1928
"34001010105",1516,226,23,299,575,46,93,366,3144
"34001010200",4750,350,173,20,381,0,530,0,6204
"34001010300",1117,117,402,9,762,182,296,23,2908
"34001010401",4583,227,238,115,281,0,151,22,5617
"34001010403",2759,510,388,55,2208,444,715,314,7393
"34001010501",5729,369,595,2,510,72,909,76,8262
"34001010503",3756,180,1526,587,1217,238,1594,91,9189
"34001010505",2514,93,23,8,92,0,419,0,3149
"34001010506",3428,22,504,0,907,101,377,0,5339
"34001010600",2312,295,632,127,412,410,670,627,5485
"34001010700",4919,422,260,72,394,71,1144,90,7372
"34001010800",2247,224,58,0,271,19,266,99,3184
"34001010900",4745,297,489,20,516,0,660,208,6935
"34001011000",2135,127,31,38,209,25,382,71,3018
"34001011100",2140,304,40,29,440,72,673,245,3943
"34001011201",1432,140,158,7,72,4,100,4,1917
"34001011202",5350,467,454,435,700,152,750,38,8346
"34001011300",2964,273,178,39,1085,56,1566,113,6274
"34001011401",3562,314,56,3,304,10,366,22,4637
"34001011403",2767,211,1071,32,1288,101,1478,68,7016
"34001011404",5674,571,1121,200,1394,431,1387,263,11041
"34001011500",3676,281,1265,356,507,30,507,63,6685
"34001011600",4273,395,69,14,175,4,204,46,5180
"34001011701",4604,270,798,291,2901,293,1546,289,10992
"34001011702",1183,257,745,52,868,488,491,121,4205
"34001011802",11366,571,732,5,3117,111,2247,55,18204
"34001011803",2631,215,478,38,1274,228,1453,67,6384
"34001011804",5232,356,298,0,633,0,169,0,6688
"34001011805",1978,170,18,15,98,48,22,0,2349
"34001011900",1463,1094,2927,901,1032,570,1628,910,10525
"34001012000",1800,365,1313,232,688,309,1351,492,6550
"34001012100",1078,261,688,182,384,236,876,465,4170
"34001012200",1431,263,2080,380,776,148,1623,503,7204
"34001012302",2816,179,13,0,443,10,393,26,3880
"34001012401",2230,192,19,1,141,108,161,142,2994
"34001012402",1950,146,7,9,142,33,159,32,2478
"34001012501",2270,34,19,0,416,0,358,0,3097
"34001012502",1295,81,0,0,116,0,9,0,1501
"34001012602",1261,40,16,3,46,3,32,0,1401
"34001012701",2489,248,259,39,297,82,380,87,3881
"34001012702",1203,105,23,167,136,0,179,2,1815
"34001012801",2393,291,372,441,365,58,316,131,4367
"34001012802",1485,97,174,9,17,47,267,39,2135
"34001013000",3117,525,24,0,12,14,19,14,3725
"34001013101",1395,7,1,1,5,0,16,1,1426
"34001013102",1026,154,69,0,23,0,26,8,1306
"34001013201",1457,570,27,0,829,53,525,96,3557
"34001013202",1511,309,222,0,204,128,286,18,2678
"34001013301",2256,155,39,1,359,0,446,1,3257
"34001013302",1926,164,48,59,259,31,203,66,2756
"34001013500",2556,66,49,2,23,0,126,0,2822
"34001983400",42,3,0,0,3,0,0,0,48
"34001990000",0,0,0,0,0,0,0,0,0
"34003001000",5323,216,63,0,765,48,334,0,6749
"34003002100",1234,77,48,0,501,1,122,25,2008
"34003002200",3271,299,25,0,1202,116,351,38,5302
"34003002300",3543,78,101,0,1713,72,360,13,5880
"34003003100",2345,143,349,118,2040,56,1240,78,6369
"34003003200",1786,136,101,11,1987,503,1134,312,5970
"34003003300",2504,204,481,30,2907,119,1599,118,7962
"34003003401",1946,76,49,2,923,83,526,45,3650
"34003003402",2335,31,47,1,1426,5,737,4,4586
"34003003500",1916,377,270,76,1210,334,1216,326,5725
"34003004001",1987,126,185,2,895,70,1298,0,4563
"34003004002",2711,477,181,27,1531,25,1396,326,6674
"34003005000",4642,191,0,27,1108,187,1041,30,7226
"34003006100",4528,517,113,22,1136,91,1967,139,8513
"34003006201",3280,650,43,0,573,346,1045,332,6269
"34003006202",2947,329,362,0,1050,91,446,94,5319
"34003006300",5250,1145,109,37,1263,180,2215,1028,11227
"34003007001",2566,79,148,0,1149,28,333,28,4331
"34003007002",2716,123,10,0,1511,88,105,20,4573
"34003008000",6354,146,20,0,1828,190,941,0,9479
"34003009100",3476,37,12,0,1301,78,228,0,5132
"34003009200",2826,29,48,0,448,50,53,1,3455
"34003010100",4338,61,51,12,1555,62,700,0,6779
"34003010200",2908,99,29,0,972,218,840,1,5067
"34003010300",5702,108,148,0,1249,88,1347,0,8642
"34003011100",3031,100,296,17,568,135,1133,96,5376
"34003011200",3310,476,144,62,704,81,581,387,5745
"34003011300",3466,326,94,1,772,48,822,237,5766
"34003011400",4682,414,272,5,544,97,792,122,6928
"34003012001",2996,373,126,25,2152,108,1110,82,6972
"34003012002",2279,102,51,2,813,64,442,0,3753
"34003013001",2319,124,459,15,2937,119,659,51,6683
"34003013002",3434,210,80,346,1333,289,685,158,6535
"34003014000",5740,466,175,4,745,69,762,69,8030
"34003015100",2009,10,138,0,269,0,153,0,2579
"34003015200",2076,101,1828,181,1196,584,1348,612,7926
"34003015300",560,20,4140,468,1102,99,805,27,7221
"34003015400",1989,209,1069,859,2154,365,1617,443,8705
"34003015500",3713,198,495,8,1297,0,762,1,6474
"34003016000",2797,240,54,34,2086,101,304,24,5640
"34003017100",5705,293,35,1,1069,0,566,0,7669
"34003017200",4463,194,225,0,1007,44,600,48,6581
"34003017300",4816,212,204,21,999,95,625,116,7088
"34003017400",3750,91,39,7,1028,97,377,37,5426
"34003017500",6061,349,130,45,1456,32,1671,50,9794
"34003018100",3858,973,243,0,1266,587,3083,1120,11130
"34003018200",4671,342,45,27,1731,188,2554,373,9931
"34003019102",1419,243,53,0,872,123,162,13,2885
"34003019103",1550,80,77,35,2002,206,393,0,4343
"34003019104",1773,207,59,0,1817,229,544,118,4747
"34003019202",661,67,71,0,557,68,302,8,1734
"34003019203",1878,192,0,0,664,235,238,35,3242
"34003019204",1932,122,25,39,1106,449,697,15,4385
"34003019303",1849,11,37,0,3144,431,574,0,6046
"34003019304",1804,119,0,0,686,46,455,37,3147
"34003019305",3992,283,178,0,1894,49,411,16,6823
"34003019306",1093,18,261,0,807,104,295,0,2578
"34003020100",3188,85,31,0,747,0,414,0,4465
"34003020200",5787,180,33,0,580,0,264,0,6844
"34003021100",5542,649,173,1,211,50,1256,50,7932
"34003021200",4257,755,190,72,326,58,1341,507,7506
"34003021300",3087,423,156,7,309,98,822,184,5086
"34003021400",3505,432,278,11,290,0,1292,157,5965
"34003021500",3696,378,608,148,175,35,2023,218,7281
"34003021600",3065,778,251,176,329,219,2078,723,7619
"34003022100",3383,34,269,0,464,15,242,0,4407
"34003022200",6405,188,15,2,853,61,446,11,7981
"34003023100",748,403,576,99,746,113,907,416,4008
"34003023200",3099,384,1237,39,1746,339,1336,274,8454
"34003023301",1138,220,986,28,504,62,773,62,3773
"34003023302",2273,263,838,120,1026,179,674,123,5496
"34003023401",1302,99,621,20,1605,177,499,123,4446
"34003023402",1744,165,1269,79,1739,1183,1443,1183,8805
"34003023501",639,252,1442,502,438,80,586,229,4168
"34003023502",1596,313,700,51,1224,508,1525,552,6469
"34003023601",1747,345,368,266,591,41,784,315,4457
"34003023602",1079,126,337,232,1653,514,2094,532,6567
"34003024100",4193,127,229,0,1210,0,156,0,5915
"34003024200",3773,75,0,1,811,44,221,13,4938
"34003025100",4902,356,176,2,349,157,782,71,6795
"34003025200",5207,189,0,5,520,33,766,33,6753
"34003026100",3973,122,18,2,331,206,269,233,5154
"34003026200",4887,203,46,46,400,78,464,154,6278
"34003027000",3515,30,11,0,553,0,115,0,4224
"34003028001",2130,363,130,2,2413,186,732,324,6280
"34003028002",2071,119,104,0,1378,90,504,8,4274
"34003029100",2355,90,192,89,1981,104,911,7,5729
"34003029200",3659,378,95,2,1652,103,1189,304,7382
"34003030100",3216,543,504,199,497,110,1333,473,6875
"34003030200",5529,652,477,146,926,34,2578,219,10561
"34003030300",2614,607,286,25,547,37,1584,452,6152
"34003030400",4289,839,368,105,1597,65,1833,793,9889
"34003031100",3523,337,61,26,953,14,1213,132,6259
"34003031200",4092,169,50,0,348,43,795,17,5514
"34003031300",4764,271,48,45,386,35,778,19,6346
"34003031400",4757,260,47,0,353,259,698,178,6552
"34003032102",4906,207,241,0,599,0,105,0,6058
"34003032103",3977,157,64,0,573,0,103,14,4888
"34003032104",1725,37,89,0,352,21,238,11,2473
"34003032201",4035,64,160,0,907,248,269,34,5717
"34003032202",4096,51,22,2,654,43,255,15,5138
"34003033100",2797,68,67,0,617,57,599,0,4205
"34003033200",2004,238,31,0,224,13,359,105,2974
"34003033300",2111,253,255,19,779,76,588,47,4128
"34003034000",6421,125,46,3,520,47,497,27,7686
"34003035100",6081,399,16,1,1291,122,311,1,8222
"34003035200",4885,140,183,1,473,0,277,0,5959
"34003036100",1673,92,190,6,475,20,567,16,3039
"34003036200",2191,104,0,24,325,67,667,76,3454
"34003037100",3507,349,381,0,1336,160,788,174,6695
"34003037201",2777,140,106,0,986,88,683,33,4813
"34003037202",3689,136,525,19,1979,15,547,35,6945
"34003038100",4357,402,120,0,421,11,665,186,6162
"34003038200",3042,345,28,1,1025,8,869,100,5418
"34003038300",4787,226,42,0,531,146,1211,37,6980
"34003039100",3769,89,0,0,421,0,346,7,4632
"34003039200",5312,135,19,0,218,43,395,2,6124
"34003039300",2462,58,28,0,78,6,111,6,2749
"34003040001",2835,16,12,3,518,0,191,1,3576
"34003040002",3935,0,21,0,488,20,139,0,4603
"34003041100",1932,301,133,14,2816,389,1645,353,7583
"34003041200",1356,206,0,0,2470,327,424,174,4957
"34003041301",1695,494,227,115,2936,195,1093,448,7203
"34003041302",1206,218,0,54,2603,127,511,86,4805
"34003042100",5072,76,125,2,1395,140,611,3,7424
"34003042301",3168,150,41,0,1198,78,332,60,5027
"34003042302",3315,93,0,23,1244,0,223,23,4921
"34003042400",3090,105,15,0,1151,60,229,16,4666
"34003042500",2583,288,115,0,1706,66,348,116,5222
"34003043001",3394,34,28,3,261,0,214,0,3934
"34003043002",4024,96,116,26,462,68,722,68,5582
"34003044100",5423,215,0,0,397,0,165,14,6214
"34003044201",3455,53,20,0,245,0,349,0,4122
"34003044202",3921,131,0,2,708,0,287,6,5055
"34003045100",4585,246,51,1,3527,230,2080,16,10736
"34003045200",1618,131,24,0,699,0,580,39,3091
"34003046100",2609,99,121,44,1145,16,1593,62,5689
"34003046200",2682,31,81,33,1416,77,1645,76,6041
"34003046300",2716,276,259,0,1095,119,1624,154,6243
"34003047100",4133,129,212,0,1239,63,543,34,6353
"34003047200",3697,33,67,12,365,28,105,0,4307
"34003047300",2509,80,24,0,362,31,42,0,3048
"34003047400",3297,123,64,25,1333,258,657,10,5767
"34003047500",5580,98,13,0,1025,116,248,0,7080
"34003048100",2145,95,153,0,1527,45,212,26,4203
"34003048200",6098,20,0,0,1315,0,629,0,8062
"34003049001",3694,72,4,1,680,33,493,0,4977
"34003049002",4246,147,115,0,766,0,175,0,5449
"34003050000",4209,171,46,0,947,0,1358,15,6746
"34003051100",4777,176,183,0,849,203,778,26,6992
"34003051200",2011,12,98,0,447,11,462,17,3058
"34003051300",2746,249,177,31,941,207,628,77,5056
"34003051400",3928,152,207,0,525,60,571,0,5443
"34003052100",6741,489,45,2,438,149,813,0,8677
"34003052200",4785,338,66,1,644,0,879,2,6715
"34003053100",2764,69,38,5,272,0,370,0,3518
"34003053200",6780,226,179,0,1025,31,265,0,8506
"34003054100",2098,11,4280,891,1178,97,992,97,9644
"34003054200",1388,386,1341,215,557,15,600,30,4532
"34003054300",5798,57,432,0,214,0,122,1,6624
"34003054400",3255,105,1177,70,1628,377,1449,118,8179
"34003054500",2818,89,710,0,853,0,754,8,5232
"34003054600",3554,172,1468,267,2959,375,2313,256,11364
"34003055100",5024,157,0,2,1301,126,243,19,6872
"34003055200",4722,138,31,38,2795,159,606,51,8540
"34003056100",4145,73,17,0,402,0,250,0,4887
"34003056200",4336,224,77,0,448,0,254,54,5393
"34003057101",2905,420,261,46,492,17,283,258,4682
"34003057102",3143,213,21,3,322,130,372,0,4204
"34003057200",2889,303,39,0,188,20,379,89,3907
"34003058100",3423,124,22,1,125,0,182,0,3877
"34003058200",4951,91,0,0,415,0,346,0,5803
"34003059100",3835,107,365,3,877,0,851,0,6038
"34003059200",4420,409,223,33,562,68,329,105,6149
"34003060000",6646,362,17,0,1010,85,835,62,9017
"34003061100",4214,33,10,0,438,1,224,0,4920
"34003061200",3048,27,0,0,184,26,45,26,3356
"34003061300",2861,197,5,9,246,0,129,4,3451
"34003061400",4915,42,0,0,300,0,251,0,5508
"34005700102",2196,41,97,0,230,0,121,0,2685
"34005700103",2157,165,240,0,133,78,108,60,2941
"34005700104",1105,192,494,130,130,6,41,12,2110
"34005700200",2561,19,6,0,90,9,56,10,2751
"34005700303",2668,146,174,4,358,0,271,8,3629
"34005700304",2069,197,18,0,45,41,142,0,2512
"34005700305",4439,119,136,18,181,0,246,0,5139
"34005700306",2286,140,25,4,77,8,76,0,2616
"34005700307",2487,22,94,0,175,0,119,0,2897
"34005700401",1915,17,0,0,164,0,81,0,2177
"34005700402",3069,81,0,0,184,0,36,5,3375
"34005700403",3727,401,19,0,91,0,153,33,4424
"34005700405",1257,206,37,0,80,0,16,0,1596
"34005700407",2837,409,901,221,986,82,713,170,6319
"34005700408",973,94,563,1,533,17,255,10,2446
"34005700501",4885,112,226,81,227,30,129,33,5723
"34005700502",2057,87,9,0,91,0,102,0,2346
"34005700503",2753,101,606,74,273,0,95,11,3913
"34005700504",2514,25,227,0,87,0,31,0,2884
"34005700505",4765,87,53,0,1027,10,44,10,5996
"34005700602",4592,166,326,39,1243,38,290,8,6702
"34005700603",3607,546,600,6,835,0,374,76,6044
"34005700605",4374,59,310,0,132,1,127,1,5004
"34005700701",2999,139,114,20,99,0,129,0,3500
"34005700702",1743,130,253,17,53,152,242,98,2688
"34005700703",1547,276,154,18,247,46,249,19,2556
"34005700800",3537,200,510,26,205,0,184,9,4671
"34005700900",1336,133,597,91,307,104,134,108,2810
"34005701001",2737,439,957,143,656,111,576,94,5713
"34005701002",2257,75,995,33,381,84,326,19,4170
"34005701102",3114,129,1072,85,637,8,463,0,5508
"34005701103",3348,28,1709,2,887,36,362,24,6396
"34005701104",2277,176,1341,246,406,9,295,0,4750
"34005701105",2913,44,2310,117,590,380,555,196,7105
"34005701201",1810,48,810,51,437,0,210,44,3410
"34005701203",1108,67,746,9,70,0,101,0,2101
"34005701204",577,69,964,397,401,89,132,49,2678
"34005701205",1309,77,463,61,92,183,147,134,2466
"34005701301",3466,53,563,52,359,19,159,0,4671
"34005701302",2409,101,0,0,259,0,12,0,2781
"34005701303",3372,84,640,58,761,19,507,14,5455
"34005701401",4832,174,792,0,742,0,239,0,6779
"34005701402",1550,0,0,0,421,0,30,0,2001
"34005701502",3071,79,376,0,427,11,307,21,4292
"34005701700",2928,147,403,14,432,1,159,23,4107
"34005702101",1855,114,553,0,398,0,230,5,3155
"34005702203",1539,221,780,116,255,31,377,34,3353
"34005702204",1186,107,512,64,192,297,210,94,2662
"34005702206",1617,84,106,4,164,71,88,36,2170
"34005702207",1937,450,609,55,212,37,331,77,3708
"34005702208",5365,238,1033,166,298,13,729,17,7859
"34005702209",1968,265,451,2,307,14,317,8,3332
"34005702210",2289,383,1132,296,530,215,363,91,5299
"34005702300",1020,49,127,34,84,72,159,71,1616
"34005702400",3130,67,67,2,148,6,209,7,3636
"34005702500",4455,116,727,28,734,18,513,0,6591
"34005702601",2539,239,804,29,340,6,223,0,4180
"34005702603",1389,202,484,43,88,24,133,123,2486
"34005702700",5578,43,1892,90,1029,132,959,13,9736
"34005702801",280,0,1529,31,159,0,36,0,2035
"34005702802",545,65,2612,165,147,78,104,71,3787
"34005702803",617,71,2463,31,403,0,315,12,3912
"34005702804",475,26,1828,93,364,0,334,0,3120
"34005702805",691,44,2343,308,424,17,278,0,4105
"34005702806",526,1,2476,444,453,104,278,130,4412
"34005702807",591,81,1856,191,554,79,429,36,3817
"34005702808",562,26,1805,326,440,17,475,14,3665
"34005702809",252,106,904,34,17,1,51,87,1452
"34005702810",232,6,937,42,40,0,81,3,1341
"34005702811",334,15,1948,105,272,11,117,11,2813
"34005702905",3413,201,127,8,334,0,32,0,4115
"34005702906",1845,3,61,0,176,0,116,0,2201
"34005702907",2639,99,0,0,154,25,48,0,2965
"34005702908",3980,76,162,5,185,0,133,35,4576
"34005702909",4463,64,403,0,939,63,413,0,6345
"34005702910",3946,53,223,3,671,171,327,0,5394
"34005702913",2488,143,767,108,718,11,183,2,4420
"34005702914",3552,141,283,0,421,0,178,0,4575
"34005702915",2769,309,936,46,564,15,259,6,4904
"34005702917",1384,8,169,13,202,0,9,0,1785
"34005702918",1388,49,153,15,325,20,71,0,2021
"34005703000",4651,60,719,6,595,51,230,0,6312
"34005703102",2020,19,392,0,162,10,224,0,2827
"34005703103",2635,159,1139,105,478,182,312,206,5216
"34005703104",3669,155,551,0,504,0,486,70,5435
"34005703201",3207,186,111,47,174,0,229,0,3954
"34005703202",2432,191,27,0,161,0,88,0,2899
"34005703203",3547,190,98,0,53,0,98,0,3986
"34005703600",6572,171,3,0,219,0,436,0,7401
"34005703700",6056,174,17,0,183,0,176,0,6606
"34005703801",6201,314,113,2,351,0,127,0,7108
"34005703802",3710,234,225,9,159,20,526,79,4962
"34005703803",4252,70,24,3,88,0,156,3,4596
"34005703804",6624,19,224,4,331,0,133,2,7337
"34005703900",4017,63,0,0,62,0,22,0,4164
"34005704004",2976,183,63,0,364,0,145,0,3731
"34005704005",3481,45,105,8,259,0,71,0,3969
"34005704006",1649,120,226,30,379,25,10,0,2439
"34005704007",3242,209,24,11,114,12,152,25,3789
"34005704008",4711,156,154,7,199,37,49,0,5313
"34005704009",3855,153,231,0,342,0,243,0,4824
"34005704011",2800,110,8,0,132,0,20,0,3070
"34005704012",5053,181,601,1,343,0,455,19,6653
"34005704013",4625,81,255,18,333,0,166,1,5479
"34005704014",5796,194,450,3,1068,29,182,177,7899
"34005704200",5346,131,833,8,1358,0,442,7,8125
"34005704302",4163,53,164,15,712,19,94,15,5235
"34005704500",4068,362,625,61,302,62,352,99,5931
"34005704600",1308,312,727,45,216,38,239,191,3076
"34005704700",3365,320,0,7,105,0,174,42,4013
"34005704801",2098,211,205,0,241,0,348,60,3163
"34005704802",617,21,101,0,62,0,123,17,941
"34005981802",35,0,12,0,0,0,0,0,47
"34005982111",561,29,5,16,66,25,6,32,740
"34007600200",203,0,732,382,356,422,447,412,2954
"34007600400",176,63,823,1072,743,328,810,460,4475
"34007600700",77,27,268,64,406,327,516,348,2033
"34007600800",244,389,925,679,1095,1363,1416,1667,7778
"34007600900",424,241,562,1136,1351,1221,1556,1768,8259
"34007601000",787,76,904,347,2572,732,3021,877,9316
"34007601101",605,151,396,271,1437,489,1620,612,5581
"34007601102",770,321,1005,410,2421,639,2540,687,8793
"34007601200",772,157,1795,412,2136,956,2731,967,9926
"34007601300",425,331,1239,780,738,1874,1186,1982,8555
"34007601400",63,2,2990,916,224,523,327,495,5540
"34007601500",153,73,2674,1723,442,463,892,570,6990
"34007601600",139,52,1200,675,115,0,203,46,2430
"34007601700",49,50,855,1193,336,464,423,527,3897
"34007601800",72,52,532,363,120,279,77,371,1866
"34007601900",124,96,851,1105,471,364,468,882,4361
"34007602000",550,554,3043,1303,1107,816,1708,1405,10486
"34007602503",387,53,770,180,672,5,769,42,2878
"34007602601",1188,65,493,54,652,19,520,39,3030
"34007602602",756,90,844,0,1712,0,975,55,4432
"34007602901",3212,163,671,68,651,0,681,0,5446
"34007602902",1936,112,463,255,409,257,567,234,4233
"34007603001",2502,39,451,0,508,140,578,148,4366
"34007603002",1969,71,1196,172,1430,104,1773,64,6779
"34007603100",2366,392,326,177,537,13,391,177,4379
"34007603200",5029,80,478,15,780,269,400,71,7122
"34007603301",3440,383,347,1,971,230,141,93,5606
"34007603302",4295,241,516,10,1283,0,713,10,7068
"34007603303",1465,435,206,49,321,10,51,106,2643
"34007603400",5216,164,514,0,1229,86,486,0,7695
"34007603501",4109,134,282,151,1561,37,117,0,6391
"34007603503",3935,28,76,1,522,15,115,0,4692
"34007603504",2014,66,69,1,513,18,148,0,2829
"34007603505",2315,43,245,46,650,39,198,0,3536
"34007603506",4664,18,224,3,1819,14,247,0,6989
"34007603507",5262,72,343,19,1254,110,177,16,7253
"34007603601",3032,61,88,32,195,23,98,9,3538
"34007603602",2181,13,76,1,78,0,0,0,2349
"34007603603",2136,20,0,0,33,0,6,0,2195
"34007603700",2375,131,129,22,772,43,458,42,3972
"34007603800",4544,169,219,2,93,38,60,38,5163
"34007603901",4329,404,39,0,217,15,49,15,5068
"34007603902",2592,46,188,0,95,50,86,50,3107
"34007604100",709,266,443,344,962,242,944,476,4386
"34007604200",2721,209,328,40,346,65,472,148,4329
"34007604300",3237,198,91,14,154,0,129,0,3823
"34007604400",2621,79,103,1,118,55,128,0,3105
"34007604600",1477,106,166,18,118,19,222,24,2150
"34007604700",1909,110,39,0,55,25,46,0,2184
"34007605100",2044,227,19,38,52,39,13,44,2476
"34007605200",2017,260,56,1,341,19,243,8,2945
"34007605300",1346,100,138,11,105,50,103,33,1886
"34007605400",2465,116,0,49,0,2,85,1,2718
"34007605602",2705,82,36,0,133,0,141,34,3131
"34007605700",2893,337,72,17,27,22,17,46,3431
"34007605800",2351,73,257,2,50,1,8,1,2743
"34007605900",2492,35,11,0,12,0,29,0,2579
"34007606000",1993,27,33,1,103,5,140,5,2307
"34007606100",1904,98,0,0,81,5,64,0,2152
"34007606200",3699,204,0,0,140,23,44,0,4110
"34007606300",1863,264,48,0,88,0,79,0,2342
"34007606400",2915,11,31,1,123,26,197,0,3304
"34007606500",60,0,2234,318,283,43,154,39,3131
"34007606600",2032,110,90,0,70,12,87,7,2408
"34007606700",4137,161,106,0,180,28,273,15,4900
"34007606800",3051,172,29,59,345,204,125,31,4016
"34007607000",3704,428,110,1,144,98,358,154,4997
"34007607100",3113,100,99,12,245,0,274,11,3854
"34007607200",3449,346,302,131,507,147,437,64,5383
"34007607300",3042,254,698,95,140,114,199,150,4692
"34007607401",1924,256,490,9,372,0,343,25,3419
"34007607402",1386,94,371,56,219,44,177,61,2408
"34007607502",4124,84,142,106,549,13,76,0,5094
"34007607503",3994,238,428,0,1695,34,176,14,6579
"34007607504",2921,70,218,0,309,0,53,40,3611
"34007607505",3341,55,384,60,967,0,250,6,5063
"34007607506",1518,81,484,0,1014,36,86,11,3230
"34007607507",3114,413,662,31,1059,203,206,0,5688
"34007607600",2019,54,47,9,71,48,36,53,2337
"34007607701",1432,297,1430,441,862,550,1192,638,6842
"34007607702",1829,313,939,250,959,232,786,168,5476
"34007607801",2062,311,1994,108,515,704,665,545,6904
"34007607802",1751,44,229,91,198,15,85,15,2428
"34007607900",1709,85,43,9,100,10,119,10,2085
"34007608001",2262,210,733,13,293,155,108,128,3902
"34007608202",2890,105,845,37,286,5,162,0,4330
"34007608205",3672,225,96,15,80,26,22,26,4162
"34007608206",3435,51,160,51,106,0,72,14,3889
"34007608209",2072,317,694,2,344,6,49,166,3650
"34007608210",1938,330,1126,155,230,60,277,48,4164
"34007608211",2836,496,1352,3,927,39,501,0,6154
"34007608302",3662,285,279,37,218,116,141,87,4825
"34007608303",2211,237,130,23,206,78,176,107,3168
"34007608304",4748,260,401,57,562,19,526,30,6603
"34007608401",3313,45,270,30,205,37,39,0,3939
"34007608402",2596,29,994,10,460,37,266,0,4392
"34007608403",4178,108,1716,39,900,216,706,12,7875
"34007608404",3815,505,1108,39,490,14,213,0,6184
"34007608503",1333,221,1055,125,317,140,163,0,3354
"34007608504",1355,341,664,205,171,125,150,139,3150
"34007608600",3112,669,710,172,287,49,200,127,5326
"34007608700",6460,463,114,125,330,0,132,42,7666
"34007608800",3797,274,522,153,515,69,253,84,5667
"34007608901",4637,759,105,32,392,17,247,100,6289
"34007608903",3092,159,25,15,104,1,67,37,3500
"34007608904",1245,38,32,1,20,0,55,0,1391
"34007609000",495,153,724,49,266,14,254,39,1994
"34007609103",3251,124,615,230,763,11,201,36,5231
"34007609201",2230,185,1256,208,274,30,549,43,4775
"34007609202",1113,101,2780,791,370,16,484,16,5671
"34007609203",4129,62,3946,61,1227,42,502,44,10013
"34007609204",776,32,2238,412,276,198,251,205,4388
"34007609205",4382,214,1192,60,690,38,654,61,7291
"34007610300",357,252,629,482,114,128,201,129,2292
"34007610400",233,528,655,947,415,665,742,1062,5247
"34007610500",1892,231,1960,148,1674,803,1928,835,9471
"34007610600",594,19,194,40,193,64,87,64,1255
"34007610800",1061,219,794,220,693,95,705,50,3837
"34007610900",3246,230,0,3,46,3,28,13,3569
"34007611000",4581,697,240,52,668,62,284,179,6763
"34007611100",2271,241,113,9,297,179,321,136,3567
"34007611200",3443,236,167,45,235,9,94,9,4238
"34007611300",3686,270,160,54,175,0,97,0,4442
"34007611400",3287,211,391,71,151,144,300,138,4693
"34007611500",3554,237,144,82,217,6,333,8,4581
"34007611600",2440,574,641,72,271,65,490,94,4647
"34007611700",2543,413,31,4,40,51,83,23,3188
"34009020101",2708,217,203,65,87,59,161,0,3500
"34009020102",1790,122,45,20,305,58,276,37,2653
"34009020201",1302,26,0,0,0,0,0,0,1328
"34009020203",1995,95,22,15,0,0,0,0,2127
"34009020205",1072,195,0,6,0,0,0,0,1273
"34009020206",866,4,94,0,42,12,73,12,1103
"34009020301",3889,95,16,0,103,12,118,0,4233
"34009020302",4376,221,0,0,119,2,78,2,4798
"34009020400",3013,251,76,0,67,24,110,0,3541
"34009020500",917,435,622,169,137,91,437,194,3002
"34009020600",1993,16,0,25,92,0,33,25,2184
"34009020700",3760,365,1,1,48,12,38,0,4225
"34009020800",1682,131,0,1,23,24,16,0,1877
"34009020901",668,57,8,3,0,0,0,0,736
"34009020902",1794,94,0,1,35,0,32,0,1956
"34009021001",1679,123,28,7,79,0,101,5,2022
"34009021002",3183,109,178,4,113,5,75,12,3679
"34009021100",3900,448,397,1,113,0,214,0,5073
"34009021300",3346,602,23,3,23,0,9,1,4007
"34009021400",2415,918,0,52,116,229,478,730,4938
"34009021500",1407,248,452,24,36,7,252,15,2441
"34009021600",2897,154,0,4,128,71,154,28,3436
"34009021701",2121,180,16,29,110,0,118,0,2574
"34009021702",2215,154,67,0,142,6,56,6,2646
"34009021803",3078,664,9,22,14,24,191,41,4043
"34009021804",4920,329,239,24,130,13,458,0,6113
"34009021805",3795,339,86,0,105,232,183,232,4972
"34009021806",2277,212,38,0,2,45,36,42,2652
"34009021900",1662,121,76,13,72,7,22,0,1973
"34009022000",2479,172,157,27,124,107,155,33,3254
"34009022101",1356,635,0,28,0,10,320,0,2349
"34009022102",3706,201,700,26,806,8,350,8,5805
"34009990100",0,0,0,0,0,0,0,0,0
"34011010101",3306,375,22,9,95,0,115,82,4004
"34011010103",0,0,0,0,0,0,0,0,0
"34011010200",3321,521,457,302,156,371,290,395,5813
"34011010301",2581,166,256,112,130,24,270,50,3589
"34011010302",1067,256,18,2,39,0,64,2,1448
"34011010401",1773,382,2020,274,604,98,371,174,5696
"34011010402",0,0,0,0,0,0,0,0,0
"34011010500",1912,148,37,14,141,95,36,87,2470
"34011010600",3742,259,286,90,558,0,214,12,5161
"34011010700",5753,334,1135,25,307,81,396,115,8146
"34011010800",2016,194,437,3,438,1,526,21,3636
"34011020100",148,157,49,89,162,133,297,258,1293
"34011020200",878,149,503,182,544,340,1198,509,4303
"34011020300",1962,1480,530,803,1494,779,3330,2147,12525
"34011020400",1446,408,483,46,436,123,702,334,3978
"34011020502",0,0,0,0,0,0,0,0,0
"34011020503",487,235,1306,947,247,367,503,516,4608
"34011020600",1619,314,996,187,555,237,948,262,5118
"34011030100",325,152,288,83,11,38,31,104,1032
"34011030200",2149,774,1123,675,771,222,933,564,7211
"34011030300",1900,304,650,381,327,212,490,94,4358
"34011030400",5332,385,1105,144,447,43,618,79,8153
"34011030501",5187,188,554,1,210,0,663,0,6803
"34011030502",2063,596,412,315,691,260,549,693,5579
"34011040300",2238,160,480,144,758,35,1481,110,5406
"34011040400",3071,219,1025,103,1040,25,1951,181,7615
"34011040500",2398,463,1249,118,1599,670,2662,1010,10169
"34011040600",3412,898,686,461,932,475,2083,741,9688
"34011040700",5125,691,822,241,793,228,1592,302,9794
"34011040800",3964,288,321,32,587,18,523,81,5814
"34011040901",1368,158,477,43,375,169,607,192,3389
"34011040902",3806,448,813,0,1018,137,1276,190,7688
"34011041000",6080,614,393,85,509,86,800,153,8720
"34011041100",1652,545,1120,504,2180,1539,3797,2053,13390
"34011990000",0,0,0,0,0,0,0,0,0
"34013000100",2136,650,1216,114,1964,233,3363,710,10386
"34013000200",833,265,310,205,1062,369,1359,554,4957
"34013000300",949,224,443,729,839,178,1484,407,5253
"34013000400",1212,236,182,32,856,150,1637,285,4590
"34013000500",445,243,122,28,1028,213,1178,409,3666
"34013000600",1748,344,643,130,1128,507,2454,617,7571
"34013000700",1033,158,1873,1467,999,287,1902,427,8146
"34013000800",1026,194,683,495,1372,620,2089,942,7421
"34013000900",643,278,845,811,524,372,969,710,5152
"34013001000",338,253,996,351,246,219,458,419,3280
"34013001100",54,50,793,251,89,120,129,157,1643
"34013001300",175,220,1006,412,0,95,119,315,2342
"34013001400",72,189,971,962,154,105,263,265,2981
"34013001500",25,13,949,770,28,193,53,250,2281
"34013001600",110,124,1075,181,286,71,463,196,2506
"34013001700",99,0,1150,821,163,37,241,71,2582
"34013001800",136,25,1095,498,4,5,169,32,1964
"34013001900",0,10,759,945,0,18,29,67,1828
"34013002000",109,58,3640,588,48,0,138,0,4581
"34013002100",126,11,2631,485,133,25,286,2,3699
"34013002201",374,194,4007,484,1723,749,879,527,8937
"34013002202",106,90,2614,463,180,35,14,0,3502
"34013002300",111,2,2880,897,170,106,87,154,4407
"34013002400",59,8,1955,1045,40,19,55,4,3185
"34013002500",48,0,1783,687,162,36,114,26,2856
"34013002600",54,76,901,633,136,117,169,196,2282
"34013002800",150,5,785,403,172,20,298,25,1858
"34013003100",56,0,1019,692,77,41,149,68,2102
"34013003500",24,24,1522,368,28,69,68,58,2161
"34013003700",20,2,1304,476,93,21,61,31,2008
"34013003800",145,56,1059,288,89,0,170,56,1863
"34013003900",0,0,682,587,11,15,0,51,1346
"34013004100",145,0,1711,629,78,0,244,0,2807
"34013004200",2,5,1716,1211,103,132,123,171,3463
"34013004300",0,0,1890,631,73,62,90,25,2771
"34013004400",14,6,1007,469,120,120,120,113,1969
"34013004500",3,3,2730,384,0,0,0,0,3120
"34013004600",0,0,2058,925,44,15,52,0,3094
"34013004700",15,4,4349,493,240,12,95,16,5224
"34013004801",48,4,1529,889,177,57,181,77,2962
"34013004802",268,62,995,1681,167,197,386,269,4025
"34013004900",77,9,2547,773,265,13,243,0,3927
"34013005000",24,56,1713,871,122,81,65,180,3112
"34013005100",12,0,1556,479,65,0,77,53,2242
"34013005200",0,0,920,149,11,17,11,17,1125
"34013005300",0,176,1550,563,38,47,0,178,2552
"34013005400",54,170,1759,991,143,169,192,88,3566
"34013005700",630,290,654,344,410,534,738,734,4334
"34013006200",0,89,791,630,23,283,30,372,2218
"34013006400",131,37,690,133,75,68,59,0,1193
"34013006600",64,1,942,204,115,123,150,55,1654
"34013006700",272,392,705,1093,548,161,523,478,4172
"34013006800",1545,430,711,717,1326,553,1822,572,7676
"34013006900",1953,447,18,64,1639,467,1782,487,6857
"34013007000",2170,375,0,1,1048,309,1246,420,5569
"34013007100",2123,408,54,0,574,178,540,330,4207
"34013007200",2057,375,0,0,1143,169,1258,282,5284
"34013007300",2856,457,63,51,1855,403,1971,564,8220
"34013007400",1372,244,11,72,758,209,721,221,3608
"34013007501",1639,217,204,455,1185,382,1227,420,5729
"34013007502",818,366,300,414,858,331,1026,649,4762
"34013007600",1741,196,101,0,642,349,650,309,3988
"34013007700",1209,243,133,0,804,653,1040,773,4855
"34013007800",1646,135,122,58,951,392,1456,474,5234
"34013007900",1935,441,36,171,1309,359,1614,609,6474
"34013008000",583,138,459,133,442,267,562,290,2874
"34013008100",248,149,1988,738,234,129,328,214,4028
"34013008200",159,81,793,655,171,164,191,89,2303
"34013008700",1303,729,374,112,1481,601,2687,1199,8486
"34013008800",390,167,763,56,309,107,848,225,2865
"34013008900",497,211,327,81,406,424,1040,665,3651
"34013009000",248,155,934,285,211,115,377,231,2556
"34013009100",903,666,193,111,797,648,1696,1258,6272
"34013009200",466,111,784,512,390,208,585,341,3397
"34013009300",1415,447,687,252,1680,485,2839,827,8632
"34013009400",1417,1046,827,422,769,384,1809,1218,7892
"34013009500",2312,510,722,296,2059,103,3740,570,10312
"34013009600",1281,500,663,680,1129,599,2410,1131,8393
"34013009700",2220,673,550,90,1210,501,3339,1055,9638
"34013009900",27,16,1063,266,0,162,0,197,1731
"34013010000",77,36,1717,241,134,0,65,0,2270
"34013010100",150,0,2037,295,139,0,117,0,2738
"34013010200",117,110,3868,427,186,31,204,12,4955
"34013010300",45,22,2876,688,151,129,111,229,4251
"34013010400",218,2,3359,617,499,107,571,107,5480
"34013010500",318,27,2879,846,245,49,466,58,4888
"34013010600",126,76,2191,1126,231,190,339,210,4489
"34013010700",65,17,2805,396,70,23,126,49,3551
"34013010800",19,0,1639,357,138,0,204,6,2363
"34013010900",156,158,1823,752,145,0,205,1,3240
"34013011100",187,116,1977,878,307,197,386,283,4331
"34013011200",66,3,2123,607,91,59,81,208,3238
"34013011300",110,0,2361,692,80,62,166,42,3513
"34013011400",307,27,3789,560,146,64,269,53,5215
"34013011500",116,2,1828,486,186,48,219,16,2901
"34013011600",0,0,1906,749,204,49,100,49,3057
"34013011700",20,11,3504,418,63,41,53,10,4120
"34013011800",0,0,1838,346,54,0,36,46,2320
"34013011900",189,54,1054,310,19,101,197,160,2084
"34013012000",661,240,4403,425,258,145,650,373,7155
"34013012100",262,11,2166,798,414,120,386,120,4277
"34013012200",533,100,3715,859,201,208,552,272,6440
"34013012300",125,13,3829,434,223,17,205,17,4863
"34013012400",150,112,2845,1137,167,29,403,124,4967
"34013012500",158,29,2778,634,136,84,126,32,3977
"34013012600",75,0,2464,707,73,42,83,42,3486
"34013012700",140,22,3553,298,207,82,282,0,4584
"34013012800",176,19,2324,725,259,0,260,0,3763
"34013012900",0,88,1878,1010,154,149,262,215,3756
"34013013000",100,0,1242,193,183,76,71,8,1873
"34013013100",56,0,816,668,73,65,105,101,1884
"34013013200",120,8,1438,795,86,119,102,90,2758
"34013013300",95,47,1983,918,126,40,133,75,3417
"34013013400",3527,123,0,0,333,0,180,0,4163
"34013013500",3388,349,141,0,775,76,484,43,5256
"34013013600",3870,262,268,1,1365,0,823,12,6601
"34013013700",3759,419,241,51,414,14,841,0,5739
"34013013800",3672,263,0,0,262,44,399,91,4731
"34013013900",3633,68,109,3,985,0,741,10,5549
"34013014000",2356,111,106,0,1335,17,763,9,4697
"34013014100",2048,77,289,0,1177,182,937,175,4885
"34013014200",2212,61,95,1,1551,64,1713,96,5793
"34013014300",3510,108,300,26,1787,99,3047,109,8986
"34013014400",1909,205,443,18,1000,9,1432,155,5171
"34013014500",2218,168,250,12,1100,397,1776,455,6376
"34013014600",2167,59,607,22,1260,53,1923,42,6133
"34013014700",2861,347,557,171,2226,276,2357,355,9150
"34013014800",2771,129,44,0,648,12,454,0,4058
"34013014900",3649,132,250,0,549,0,341,0,4921
"34013015000",2479,153,377,7,493,0,510,2,4021
"34013015100",2402,190,848,134,930,58,1116,69,5747
"34013015200",3016,167,515,2,358,57,845,101,5061
"34013015300",1126,189,743,29,586,104,414,206,3397
"34013015400",3138,170,395,44,297,177,575,84,4880
"34013015500",1916,139,787,81,597,44,829,62,4455
"34013015600",1792,247,888,101,1065,33,716,145,4987
"34013015700",761,274,609,91,497,44,820,121,3217
"34013015800",2205,57,616,137,911,120,1453,105,5604
"34013015900",1889,179,1288,159,1780,240,2115,230,7880
"34013016000",6251,199,380,30,698,0,502,0,8060
"34013016100",2845,45,86,0,105,10,157,0,3248
"34013016200",3012,47,107,6,268,9,175,0,3624
"34013016300",3161,92,60,7,227,101,190,52,3890
"34013016400",3117,137,282,7,170,0,221,22,3956
"34013016500",3060,114,713,46,377,11,414,3,4738
"34013016600",1191,115,1140,35,180,25,122,9,2817
"34013016700",1006,204,804,119,164,14,272,55,2638
"34013016800",1494,105,535,165,609,9,386,0,3303
"34013016900",2064,36,700,187,414,1,149,1,3552
"34013017000",1719,13,1259,39,143,28,308,0,3509
"34013017100",259,15,1221,427,204,30,248,72,2476
"34013017200",635,46,1327,50,380,0,119,0,2557
"34013017301",3715,163,707,44,915,35,310,75,5964
"34013017302",3854,125,990,44,969,100,588,3,6673
"34013017400",3266,98,1152,29,838,3,571,3,5960
"34013017500",3825,92,1158,14,631,13,1020,18,6771
"34013017600",1776,261,1534,108,756,531,1457,626,7049
"34013017700",1763,269,1735,332,439,78,1559,310,6485
"34013017800",1495,410,1043,327,543,45,1350,250,5463
"34013017900",2048,122,917,65,194,0,83,9,3438
"34013018000",4199,68,1325,2,362,0,492,0,6448
"34013018100",130,14,1361,354,163,51,166,65,2304
"34013018200",371,132,2443,562,930,156,1247,242,6083
"34013018300",205,32,2536,724,834,239,950,279,5799
"34013018400",32,12,1400,254,145,17,199,10,2069
"34013018600",410,42,1198,487,982,566,1232,585,5502
"34013018700",103,116,3487,980,171,46,208,78,5189
"34013018800",273,22,3040,791,550,0,266,8,4950
"34013018900",524,57,1880,835,104,83,440,115,4038
"34013019000",3360,104,564,10,410,8,178,0,4634
"34013019100",2056,171,1297,130,202,27,161,40,4084
"34013019200",1526,295,724,92,128,0,147,0,2912
"34013019300",1820,216,771,30,369,16,166,0,3388
"34013019400",2692,36,69,0,291,59,205,0,3352
"34013019500",3130,70,393,6,357,16,226,37,4235
"34013019600",2388,153,3527,187,258,0,259,0,6772
"34013019700",1994,52,2823,173,336,35,1053,84,6550
"34013019800",1547,29,422,28,305,5,211,5,2552
"34013019900",2274,94,70,14,160,0,132,73,2817
"34013020000",4742,104,28,0,883,32,176,0,5965
"34013020100",3760,117,67,0,706,0,58,0,4708
"34013020200",3913,10,191,3,933,7,674,8,5739
"34013020300",3397,166,88,11,861,83,307,13,4926
"34013020400",3814,37,0,2,741,18,144,2,4758
"34013020500",5560,46,78,2,2141,32,415,0,8274
"34013020600",3438,85,36,0,1178,8,92,1,4838
"34013020700",3163,73,39,2,973,76,183,45,4554
"34013020800",5568,317,112,2,1627,37,379,0,8042
"34013020901",1926,43,6,0,140,0,48,0,2163
"34013020902",5136,54,111,0,476,36,544,0,6357
"34013021000",4254,85,24,0,425,0,235,0,5023
"34013021100",3929,91,354,6,470,104,453,87,5494
"34013021200",3439,13,29,0,123,0,150,0,3754
"34013021300",4449,133,31,3,731,107,166,0,5620
"34013021400",5430,149,219,2,352,104,462,72,6790
"34013021601",6985,97,224,0,185,0,180,0,7671
"34013021602",5748,166,0,2,391,0,259,77,6643
"34013021701",3012,89,64,9,294,69,396,69,4002
"34013021702",3374,129,163,0,248,0,85,0,3999
"34013021801",2479,65,24,3,82,0,121,10,2784
"34013021802",2625,145,9,26,621,56,215,0,3697
"34013021803",4177,108,0,0,174,0,243,0,4702
"34013022700",144,37,1101,1490,260,309,346,409,4096
"34013022800",45,13,1112,877,309,104,355,106,2921
"34013022900",598,222,1037,871,160,138,383,94,3503
"34013023000",176,20,1054,803,238,406,309,392,3398
"34013023100",220,64,982,785,27,64,249,116,2507
"34013023200",365,100,1664,1511,112,47,347,91,4237
"34013980100",0,0,0,0,0,0,0,0,0
"34013980200",0,14,0,49,35,160,35,160,453
"34015500100",3222,505,29,60,281,162,81,191,4531
"34015500201",2012,191,167,0,152,0,38,22,2582
"34015500202",3843,530,228,45,145,8,56,33,4888
"34015500203",4096,198,245,28,156,19,38,0,4780
"34015500204",4466,164,539,104,478,257,412,179,6599
"34015500205",2889,194,184,9,29,10,54,1,3370
"34015500300",2667,178,49,2,107,0,44,4,3051
"34015500400",2666,589,1118,1136,222,325,219,194,6469
"34015500500",4379,291,94,2,120,9,52,3,4950
"34015500600",7862,340,307,328,714,0,254,0,9805
"34015500701",6463,556,278,176,340,0,341,0,8154
"34015500702",5202,247,157,3,165,0,103,0,5877
"34015500703",1471,22,21,0,19,0,32,0,1565
"34015500800",1989,39,8,1,128,0,51,1,2217
"34015500900",2794,83,54,3,115,0,91,5,3145
"34015501001",1123,132,420,191,183,126,159,178,2512
"34015501002",1861,235,926,326,353,59,242,101,4103
"34015501003",2984,295,323,55,216,0,212,0,4085
"34015501101",2414,462,651,270,197,100,262,264,4620
"34015501102",5190,215,375,300,801,101,661,18,7661
"34015501103",3997,154,347,54,626,41,365,41,5625
"34015501104",2313,184,116,0,234,0,188,0,3035
"34015501105",1983,101,277,28,126,316,87,16,2934
"34015501106",1647,114,1131,425,249,34,21,25,3646
"34015501107",4028,332,0,0,161,0,35,0,4556
"34015501201",5563,114,190,4,318,27,24,0,6240
"34015501202",4588,181,49,1,168,0,232,0,5219
"34015501203",3128,65,7,21,66,0,25,0,3312
"34015501204",3458,89,248,83,146,0,131,0,4155
"34015501205",2558,80,197,0,250,0,139,8,3232
"34015501206",2695,181,184,23,279,5,241,0,3608
"34015501208",3139,287,101,0,282,112,79,62,4062
"34015501209",5314,262,791,266,680,65,844,77,8299
"34015501210",3545,19,79,0,66,0,43,0,3752
"34015501212",2843,74,432,2,261,19,88,76,3795
"34015501213",3874,69,81,0,409,0,221,0,4654
"34015501301",3440,69,40,29,96,0,21,0,3695
"34015501302",2741,124,7,0,146,42,57,42,3159
"34015501303",2045,81,0,22,45,0,0,0,2193
"34015501402",1053,599,1023,183,224,176,277,385,3920
"34015501403",2247,230,570,105,230,11,129,7,3529
"34015501404",598,266,21,22,17,85,45,36,1090
"34015501405",3365,73,344,15,92,0,0,9,3898
"34015501406",3027,491,354,348,234,224,180,228,5086
"34015501500",4914,753,1231,61,1187,50,334,130,8660
"34015501603",5360,320,415,87,406,0,628,33,7249
"34015501604",5949,651,553,47,384,22,317,1,7924
"34015501605",3321,221,639,22,368,101,217,117,5006
"34015501606",4647,264,1217,20,483,45,120,37,6833
"34015501608",3580,439,369,31,433,97,150,10,5109
"34015501609",4142,90,1042,32,279,0,119,11,5715
"34015501701",4458,177,483,52,277,19,263,19,5748
"34015501702",2330,138,47,11,141,0,27,0,2694
"34015501703",3579,261,209,24,335,28,365,28,4829
"34015501704",3064,294,518,0,225,44,50,26,4221
"34015501800",1406,120,48,12,70,3,101,0,1760
"34015501900",3339,270,422,80,116,0,186,49,4462
"34015502001",4536,181,111,0,399,39,125,39,5430
"34015502002",6210,165,424,15,393,0,214,11,7432
"34015502100",2596,75,357,0,143,4,169,43,3387
"34015502200",8334,391,845,74,883,14,374,19,10934
"34015502300",1809,81,444,11,211,65,371,46,3038
"34015502400",4491,283,690,15,442,80,419,14,6434
"34017000100",1810,55,296,109,3952,464,3081,382,10149
"34017000200",1725,570,463,87,2122,581,2334,958,8840
"34017000300",1731,382,186,0,1764,393,2162,490,7108
"34017000400",1099,96,587,84,1644,296,753,248,4807
"34017000500",1155,189,536,21,1914,327,1309,204,5655
"34017000600",1863,201,291,76,2312,270,2030,304,7347
"34017000700",1308,142,143,72,1064,922,1229,674,5554
"34017000800",1441,213,263,34,1872,403,1996,430,6652
"34017000902",1605,790,216,87,2712,538,675,397,7020
"34017001000",921,105,119,0,654,209,614,6,2628
"34017001100",2624,194,262,29,2055,54,2513,150,7881
"34017001201",897,80,65,0,956,116,575,39,2728
"34017001202",326,202,195,31,515,138,173,167,1747
"34017001300",773,44,345,9,1037,616,1056,357,4237
"34017001400",1716,310,419,26,1339,108,1269,363,5550
"34017001701",1706,473,312,657,1166,624,954,350,6242
"34017001800",1015,603,254,452,1468,192,600,421,5005
"34017001900",273,12,20,19,884,319,70,2,1599
"34017002000",965,509,413,52,1500,398,409,154,4400
"34017002200",978,184,84,0,180,12,142,114,1694
"34017002300",1144,44,163,14,550,205,325,197,2642
"34017002400",1947,58,130,8,458,6,328,1,2936
"34017002700",1333,580,764,505,1481,99,876,150,5788
"34017002800",1995,974,1447,320,1288,96,1452,392,7964
"34017002900",1491,233,379,106,1114,340,500,58,4221
"34017003000",982,283,358,214,800,314,835,287,4073
"34017003100",1147,316,575,95,1130,309,790,244,4606
"34017003500",1246,131,107,43,440,100,551,106,2724
"34017004000",911,127,966,108,2309,433,558,265,5677
"34017004101",1901,487,1468,493,1368,838,1455,804,8814
"34017004102",499,155,967,510,686,136,760,201,3914
"34017004200",689,439,1544,836,1122,49,1220,235,6134
"34017004300",243,254,1323,247,105,128,290,305,2895
"34017004400",38,43,1283,949,80,0,240,30,2663
"34017004500",385,61,2451,809,297,82,483,143,4711
"34017004600",678,77,629,60,584,180,1053,272,3533
"34017004700",712,96,833,155,828,88,982,133,3827
"34017004800",894,145,727,111,2229,112,697,0,4915
"34017004900",314,121,1793,334,930,190,619,369,4670
"34017005200",368,129,2420,869,301,185,232,452,4956
"34017005300",241,137,1916,339,62,173,339,214,3421
"34017005400",940,103,2696,255,2946,59,1058,15,8072
"34017005500",157,37,1471,443,142,19,334,115,2718
"34017005600",559,276,1275,261,1274,157,380,168,4350
"34017005801",209,23,3265,1286,435,229,518,439,6404
"34017005802",1076,36,95,0,278,0,71,26,1582
"34017005900",1838,238,1313,490,3141,463,730,282,8495
"34017006000",485,163,2214,617,739,408,744,541,5911
"34017006100",1311,513,1462,975,2338,419,1048,1119,9185
"34017006200",846,412,799,618,861,141,739,397,4813
"34017006300",1337,171,1054,362,1290,187,1762,250,6413
"34017006400",1947,73,206,0,787,48,570,56,3687
"34017006500",971,188,191,96,405,68,370,208,2497
"34017006600",324,54,5,0,882,123,40,0,1428
"34017006700",515,270,883,703,416,176,647,543,4153
"34017006800",97,113,2093,641,175,84,197,147,3547
"34017006900",113,0,10,0,0,5,110,0,238
"34017007000",2010,202,460,9,1152,114,1254,198,5399
"34017007100",1317,167,264,163,1317,152,743,120,4243
"34017007200",1049,21,181,0,708,44,254,0,2257
"34017007300",722,11,27,0,469,24,144,0,1397
"34017007400",2752,15,122,0,1574,13,311,0,4787
"34017007500",2340,362,266,27,1929,290,370,189,5773
"34017007600",2280,48,176,34,3215,106,413,0,6272
"34017007700",2469,12,268,131,5625,1134,635,91,10365
"34017007800",392,205,58,133,328,147,242,229,1734
"34017010100",3174,391,434,183,1175,113,1126,283,6879
"34017010200",2011,293,143,14,423,144,271,133,3432
"34017010300",1852,230,263,95,354,64,650,113,3621
"34017010400",3330,302,617,0,1037,79,683,43,6091
"34017010500",3887,190,157,14,334,85,649,19,5335
"34017010600",4017,928,410,59,852,327,1446,171,8210
"34017010700",2154,663,223,62,521,42,629,237,4531
"34017010800",2190,284,137,88,277,20,616,113,3725
"34017010900",1158,350,63,41,233,70,296,48,2259
"34017011000",1200,196,308,117,639,69,546,230,3305
"34017011100",2788,961,506,3,540,158,936,298,6190
"34017011200",4602,316,232,26,640,234,759,223,7032
"34017011300",1910,320,178,46,264,56,767,82,3623
"34017011400",2822,106,46,26,275,0,710,19,4004
"34017011500",2581,96,247,29,389,18,479,36,3875
"34017011600",2197,364,462,311,714,236,475,164,4923
"34017012300",1294,121,6,0,848,55,1014,79,3417
"34017012400",2447,171,20,2,578,0,684,136,4038
"34017012500",2602,118,157,14,1006,61,943,127,5028
"34017012600",2436,282,0,4,778,26,1182,47,4755
"34017012700",2836,198,122,44,1758,222,1821,157,7158
"34017012800",2223,228,137,0,1620,17,1658,62,5945
"34017012900",2391,293,20,0,1168,211,1681,418,6182
"34017013000",1439,169,23,1,1566,191,1532,201,5122
"34017013100",1241,228,65,12,470,167,617,233,3033
"34017013200",1672,464,91,0,1888,546,2174,585,7420
"34017013300",1625,11,24,0,1441,255,1761,143,5260
"34017013400",1025,86,36,2,864,382,1125,315,3835
"34017013500",1508,623,34,0,1873,652,1457,700,6847
"34017013600",761,52,4,0,1026,385,1002,304,3534
"34017013700",1032,84,23,0,1067,281,1205,140,3832
"34017013800",748,56,5,0,974,152,563,121,2619
"34017013900",1094,28,32,0,1360,160,1210,51,3935
"34017014000",3040,245,234,1,1027,167,3089,274,8077
"34017014101",1561,103,101,11,993,8,582,36,3395
"34017014102",3359,253,263,0,1193,190,2870,144,8272
"34017014200",3822,805,56,32,1275,208,4437,887,11522
"34017014300",3340,737,61,0,1463,301,3775,913,10590
"34017014400",5439,892,207,26,1810,51,5295,771,14491
"34017014501",4098,700,233,1,1113,348,4286,924,11703
"34017014502",2247,715,33,0,142,169,1593,604,5503
"34017014600",2326,335,163,0,1301,43,2985,320,7473
"34017014700",2643,521,191,20,1299,167,3460,535,8836
"34017014800",3250,663,177,2,1246,209,3728,733,10008
"34017014900",1484,318,87,0,830,341,1544,482,5086
"34017015001",1259,34,72,0,710,38,518,0,2631
"34017015002",2563,534,431,70,1485,286,3462,695,9526
"34017015100",1836,79,92,23,1437,218,2768,237,6690
"34017015201",1445,111,14,0,783,0,431,37,2821
"34017015202",3125,226,192,49,1830,684,3607,573,10286
"34017015300",1620,597,114,83,1464,186,2727,690,7481
"34017015500",2465,546,156,23,1760,442,3784,1011,10187
"34017015600",2138,733,116,56,1064,176,2824,862,7969
"34017015700",1741,455,216,22,1155,165,2826,619,7199
"34017015801",1511,63,90,0,1018,75,119,0,2876
"34017015802",2785,1333,249,76,1306,257,3579,1594,11179
"34017015900",2250,647,101,79,1798,793,3970,1352,10990
"34017016000",1734,452,59,0,861,302,2294,734,6436
"34017016100",1318,717,304,0,1162,469,2492,1064,7526
"34017016200",2925,783,50,85,813,265,3350,1026,9297
"34017016300",2849,634,130,77,846,237,3418,939,9130
"34017016400",2228,865,91,1,677,308,2655,1100,7925
"34017016500",2245,532,166,32,796,98,2650,311,6830
"34017016600",1522,953,62,0,647,526,1874,1048,6632
"34017016700",725,98,0,10,439,93,906,201,2472
"34017016800",1676,485,187,22,584,382,1944,803,6083
"34017016900",1960,1149,27,8,433,210,1974,1297,7058
"34017017000",2036,1096,220,43,739,328,2680,1283,8425
"34017017100",3274,370,242,52,1216,341,4056,706,10257
"34017017200",1444,437,145,22,672,198,1858,535,5311
"34017017300",1356,373,24,0,549,100,1188,395,3985
"34017017400",1896,262,13,10,740,99,2384,319,5723
"34017017500",1728,829,401,25,982,77,2672,787,7501
"34017017600",1308,351,108,1,611,404,1757,676,5216
"34017017700",750,403,91,56,439,194,942,526,3401
"34017017800",2766,780,389,39,1648,378,3662,1101,10763
"34017017900",1103,84,54,28,577,1,193,40,2080
"34017018000",2971,268,241,0,757,68,1664,240,6209
"34017018100",1513,212,60,57,437,228,828,432,3767
"34017018200",2652,104,502,0,909,0,1286,56,5509
"34017018301",1304,11,0,30,223,27,65,0,1660
"34017018302",2649,46,24,0,734,33,159,0,3645
"34017018400",4241,715,28,0,259,144,566,455,6408
"34017018500",4799,391,76,0,437,178,584,196,6661
"34017018600",1870,103,0,6,271,53,327,18,2648
"34017018701",1289,27,1,0,87,42,67,1,1514
"34017018702",3398,584,160,0,362,58,593,410,5565
"34017018800",2309,235,0,39,262,14,176,31,3066
"34017018900",3249,155,45,1,382,77,459,138,4506
"34017019000",2868,1172,814,240,295,149,1429,1177,8144
"34017019100",2507,480,45,20,157,7,218,335,3769
"34017019200",3151,50,0,0,621,0,243,13,4078
"34017019300",2159,316,41,15,352,33,573,119,3608
"34017019400",2020,349,34,0,323,16,334,157,3233
"34017019800",3477,403,61,0,1389,145,822,370,6667
"34017019900",3178,91,182,0,1283,114,598,119,5565
"34017020000",2937,426,115,77,1756,55,839,159,6364
"34017020100",371,127,86,0,403,0,65,25,1077
"34017032400",2334,1312,181,39,1885,962,3973,2234,12920
"34017980100",0,0,0,0,0,0,0,0,0
"34019010100",5625,53,95,0,196,0,230,0,6199
"34019010200",7087,242,2,19,196,4,200,11,7761
"34019010300",2399,160,33,0,202,0,78,0,2872
"34019010400",4365,156,54,0,107,67,85,115,4949
"34019010500",4912,121,93,0,119,0,163,0,5408
"34019010600",5803,61,4,6,79,7,268,3,6231
"34019010701",4140,102,66,14,199,42,143,65,4771
"34019010702",3065,46,8,1,37,1,66,1,3225
"34019010801",2369,147,12,1,136,18,217,68,2968
"34019010802",1451,99,0,4,68,6,92,1,1721
"34019010900",3382,23,42,1,185,0,213,1,3847
"34019011001",4276,28,53,0,304,0,107,13,4781
"34019011002",5897,249,16,1,497,0,290,53,7003
"34019011100",4636,491,50,38,141,0,220,33,5609
"34019011201",6649,61,10,0,424,20,249,0,7413
"34019011202",3185,101,37,33,207,0,140,0,3703
"34019011301",5988,206,28,32,381,0,400,7,7042
"34019011302",6046,264,48,0,558,15,372,39,7342
"34019011303",4196,173,1,14,267,46,46,0,4743
"34019011304",3150,63,44,1,341,0,25,1,3625
"34019011400",2649,677,117,14,788,196,721,555,5717
"34019011500",4916,250,24,1,108,0,81,12,5392
"34019011600",4849,79,20,0,116,3,29,0,5096
"34019011700",3605,159,0,1,198,1,138,9,4111
"34019011800",2406,71,19,0,136,12,12,0,2656
"34019011900",3152,168,84,5,471,0,506,0,4386
"34021000100",1456,473,423,166,687,154,1570,466,5395
"34021000200",1625,315,746,342,242,192,1073,429,4964
"34021000300",1780,289,644,115,1532,256,1891,489,6996
"34021000400",2071,848,344,297,1209,217,2649,753,8388
"34021000500",1648,387,502,345,959,166,1873,541,6421
"34021000600",1796,459,817,156,656,167,1127,409,5587
"34021000700",1003,321,475,66,478,219,1011,465,4038
"34021000800",844,407,321,133,462,127,1064,506,3864
"34021000900",661,313,1307,854,397,223,968,476,5199
"34021001000",297,207,895,480,487,245,684,445,3740
"34021001101",59,51,1522,233,77,37,0,13,1992
"34021001102",95,77,2473,930,12,92,0,36,3715
"34021001200",648,12,2232,411,96,57,192,48,3696
"34021001300",457,82,2057,202,222,24,261,36,3341
"34021001401",48,24,2193,1671,94,75,122,79,4306
"34021001402",52,96,1416,609,21,59,40,150,2443
"34021001500",39,136,1796,717,0,43,0,170,2901
"34021001600",125,138,302,316,103,98,218,52,1352
"34021001700",303,103,2475,1055,57,31,214,74,4312
"34021001800",1527,376,609,136,687,158,1197,235,4925
"34021001900",537,420,458,202,104,219,631,598,3169
"34021002000",131,141,470,237,119,7,177,71,1353
"34021002100",666,381,2232,851,1337,430,1899,537,8333
"34021002200",1143,612,2747,676,505,124,1120,664,7591
"34021002400",0,0,0,0,0,0,0,0,0
"34021002500",4254,438,463,64,666,165,1429,28,7507
"34021002601",1874,317,1053,170,625,8,746,149,4942
"34021002602",2424,140,579,111,481,100,843,70,4748
"34021002701",2480,115,710,97,298,105,617,105,4527
"34021002702",4602,924,712,78,627,67,1235,245,8490
"34021002800",1829,502,2569,967,1117,88,1108,523,8703
"34021002902",2609,282,1055,336,477,148,639,307,5853
"34021002903",2451,141,12,36,140,55,348,108,3291
"34021002904",4714,49,268,0,562,0,149,21,5763
"34021003001",5626,220,196,1,362,0,360,0,6765
"34021003002",4988,24,20,0,496,0,188,0,5716
"34021003003",5660,166,75,2,186,0,232,0,6321
"34021003004",5062,16,131,0,238,0,72,0,5519
"34021003006",5369,42,86,1,228,0,259,0,5985
"34021003007",3404,98,0,0,35,0,41,0,3578
"34021003008",4312,87,203,12,245,75,116,10,5060
"34021003009",4553,0,161,0,337,0,120,0,5171
"34021003100",3471,150,390,35,285,112,957,134,5534
"34021003201",3549,169,877,88,490,60,76,0,5309
"34021003202",3613,451,567,57,800,0,306,270,6064
"34021003301",5356,98,622,143,722,0,470,16,7427
"34021003302",3677,227,1211,74,3320,119,411,18,9057
"34021003400",767,19,1293,339,101,202,127,208,3056
"34021003500",2729,720,2806,168,602,68,462,11,7566
"34021003601",1213,200,1295,210,239,22,213,207,3599
"34021003602",1772,255,955,242,173,45,217,0,3659
"34021003703",2512,368,582,23,290,39,106,27,3947
"34021003704",1973,34,53,0,101,8,73,0,2242
"34021003705",3454,230,1093,137,235,7,129,7,5292
"34021003706",2767,147,636,70,232,0,184,35,4071
"34021003800",6118,192,93,0,254,1,110,15,6783
"34021003902",1759,14,32,1,60,0,37,0,1903
"34021003903",2259,197,25,4,61,45,80,43,2714
"34021003904",4580,78,304,0,1366,0,331,0,6659
"34021003905",4349,23,124,0,243,0,85,0,4824
"34021004000",3298,127,336,47,460,83,289,1,4641
"34021004201",4737,208,318,43,747,183,324,121,6681
"34021004203",2550,107,167,11,1020,53,117,0,4025
"34021004204",3955,236,271,0,1203,42,341,98,6146
"34021004301",3033,238,366,2,4639,84,583,59,9004
"34021004304",4504,81,241,3,2791,330,372,0,8322
"34021004306",2721,65,112,0,2288,64,305,0,5555
"34021004307",3326,256,18,70,2254,97,397,14,6432
"34021004309",3390,212,86,1,424,7,93,181,4394
"34021004310",7051,243,311,1,2042,19,431,1,10099
"34021004403",3476,128,239,57,1576,62,2150,126,7814
"34021004404",4529,269,408,23,1533,360,2190,85,9397
"34021004405",3959,174,456,78,3269,364,1143,262,9705
"34021004406",2909,244,230,34,1070,117,891,247,5742
"34021004407",4535,391,424,91,1453,44,883,0,7821
"34021004501",1156,67,28,12,133,8,0,0,1404
"34021004502",849,76,27,0,119,82,11,16,1180
"34023000100",6809,53,42,1,456,0,608,0,7969
"34023000200",4663,181,679,17,797,5,1442,0,7784
"34023000300",5289,78,580,140,904,256,1881,271,9399
"34023000401",2169,84,634,37,743,71,615,2,4355
"34023000403",1712,67,1057,18,2342,21,601,22,5840
"34023000404",2519,149,908,10,1713,246,658,172,6375
"34023000501",1427,203,2467,60,1047,28,1205,203,6640
"34023000502",1858,36,1434,127,3489,391,703,65,8103
"34023000603",1049,29,202,8,988,13,133,0,2422
"34023000606",1754,308,1749,61,3613,134,478,0,8097
"34023000608",455,76,267,12,585,137,107,10,1649
"34023000701",1794,83,253,78,1112,9,497,11,3837
"34023000702",2927,26,1692,21,1082,59,471,45,6323
"34023000801",2675,214,536,41,373,34,755,94,4722
"34023000802",2382,54,142,0,345,10,609,0,3542
"34023000901",2076,16,127,0,239,7,491,14,2970
"34023000902",3411,113,376,39,817,23,680,0,5459
"34023001001",1954,0,309,0,311,0,117,0,2691
"34023001002",2719,118,738,17,2879,219,347,36,7073
"34023001100",2859,216,49,48,1218,178,335,17,4920
"34023001200",3155,282,475,404,1003,50,902,45,6316
"34023001300",3224,345,154,11,364,98,179,79,4454
"34023001409",1415,47,30,0,1972,20,86,1,3571
"34023001410",1225,85,232,3,2754,82,202,12,4595
"34023001411",1273,0,183,0,1932,44,95,0,3527
"34023001412",1524,64,83,0,1423,67,80,0,3241
"34023001413",1284,46,289,71,3839,81,145,0,5755
"34023001414",1456,33,313,0,3800,56,130,0,5788
"34023001415",2780,245,19,0,2282,37,202,25,5590
"34023001416",763,75,135,95,6512,609,320,17,8526
"34023001417",1239,21,0,27,830,0,32,0,2149
"34023001502",3737,120,413,322,1236,11,364,62,6265
"34023001504",1463,89,300,81,3940,134,440,30,6477
"34023001505",170,2,228,10,1485,0,232,0,2127
"34023001506",298,298,86,538,4860,90,53,183,6406
"34023001600",2991,191,163,42,1484,58,1183,46,6158
"34023001701",3235,131,168,0,1334,0,633,0,5501
"34023001702",1921,24,129,0,1138,56,453,0,3721
"34023001803",1845,152,233,1,517,131,262,71,3212
"34023001804",1899,239,138,0,1495,206,462,122,4561
"34023001805",2084,184,448,18,2292,170,551,99,5846
"34023001901",1926,165,463,57,1679,45,627,150,5112
"34023001902",1498,72,120,1,413,0,405,0,2509
"34023001903",2262,154,0,25,515,0,388,64,3408
"34023002000",2593,134,391,63,817,0,269,0,4267
"34023002101",1924,67,9,5,424,14,115,0,2558
"34023002102",3149,52,63,0,500,0,237,0,4001
"34023002200",2408,142,472,0,380,0,318,0,3720
"34023002301",3179,134,198,1,354,9,305,25,4205
"34023002302",3248,57,9,24,288,4,653,10,4293
"34023002401",4063,223,484,0,570,0,594,98,6032
"34023002402",1086,56,0,1,226,0,71,1,1441
"34023002500",2586,53,359,41,4030,380,611,15,8075
"34023002603",1716,128,383,26,2879,143,360,0,5635
"34023002604",3613,87,486,60,1983,320,578,0,7127
"34023002605",1833,81,133,0,560,49,501,23,3180
"34023002701",1915,420,306,34,2875,117,538,118,6323
"34023002703",3795,171,642,13,1142,13,1048,76,6900
"34023002805",2427,12,168,0,272,0,259,6,3144
"34023002901",1886,139,357,11,696,0,464,68,3621
"34023002902",2060,193,155,33,296,29,752,77,3595
"34023003001",3465,222,151,209,422,105,759,186,5519
"34023003002",1693,88,425,0,4153,50,492,66,6967
"34023003101",1550,62,234,11,1028,10,352,36,3283
"34023003102",1979,95,618,104,1704,147,350,150,5147
"34023003201",2232,262,396,0,525,16,468,0,3899
"34023003203",2506,254,26,19,559,66,486,185,4101
"34023003300",2939,305,368,226,1053,272,1961,518,7642
"34023003401",2641,29,607,9,259,9,730,4,4288
"34023003500",2133,181,140,1,795,366,985,55,4656
"34023003600",4345,805,740,385,1250,164,2418,598,10705
"34023003700",1818,155,250,0,1439,44,638,150,4494
"34023003800",3767,664,925,197,1566,185,1733,729,9766
"34023004000",1835,737,790,0,547,143,1862,823,6737
"34023004100",2130,435,151,55,170,31,1517,455,4944
"34023004200",1906,396,460,63,479,29,2153,457,5943
"34023004300",2526,433,354,15,567,218,2484,615,7212
"34023004400",2212,515,82,0,1051,0,2760,504,7124
"34023004500",3057,2321,700,132,869,105,3516,2348,13048
"34023004600",2802,1408,245,83,878,132,3537,1463,10548
"34023004700",2437,451,165,204,347,85,2300,439,6428
"34023004800",3414,1629,178,27,353,236,3410,1802,11049
"34023004900",2917,858,321,52,844,236,3211,910,9349
"34023005000",2807,982,331,123,423,227,2879,1151,8923
"34023005100",1083,1835,124,80,333,363,121,94,4033
"34023005200",1823,2431,373,77,170,909,1119,1156,8058
"34023005300",1776,1254,141,54,113,11,1804,1225,6378
"34023005500",1535,451,1250,167,305,171,1747,611,6237
"34023005601",2085,614,153,115,182,7,1945,548,5649
"34023005602",3853,1412,488,126,884,312,4532,1700,13307
"34023005700",2368,929,962,105,998,266,2885,999,9512
"34023005800",3140,1291,378,256,259,196,3065,1267,9852
"34023006001",1230,20,400,0,388,29,478,13,2558
"34023006002",945,301,598,91,376,186,935,223,3655
"34023006101",2309,234,519,35,1130,65,1766,126,6184
"34023006103",2442,88,826,35,1801,211,1490,120,7013
"34023006104",1883,138,798,168,1127,43,432,61,4650
"34023006203",3382,55,1542,287,4296,184,983,0,10729
"34023006204",657,41,83,0,926,11,36,0,1754
"34023006205",3080,125,1063,47,2289,151,479,56,7290
"34023006206",1456,4,162,0,206,0,89,0,1917
"34023006207",2723,58,1508,79,1585,196,713,43,6905
"34023006300",5804,372,51,73,619,16,333,78,7346
"34023006403",1700,41,166,0,742,78,356,4,3087
"34023006500",5105,129,145,1,1895,27,550,0,7852
"34023006601",1878,15,0,0,445,0,89,0,2427
"34023006604",4021,295,264,20,1995,53,294,135,7077
"34023006605",3067,99,177,0,444,0,128,0,3915
"34023006606",1984,154,8,0,775,29,12,0,2962
"34023006607",2387,70,40,0,448,0,128,0,3073
"34023006608",2100,127,126,20,1032,37,74,0,3516
"34023006701",2923,98,232,48,1106,48,513,14,4982
"34023006703",3244,331,232,43,1983,66,475,33,6407
"34023006800",3294,597,98,1,539,0,865,349,5743
"34023006900",2032,268,373,58,428,193,813,335,4500
"34023007000",5620,398,793,16,1175,152,1051,243,9448
"34023007101",2651,189,262,0,793,45,483,37,4460
"34023007102",3574,216,388,8,625,9,572,0,5392
"34023007103",1357,261,1707,114,1153,205,547,259,5603
"34023007202",3154,48,341,101,1304,44,425,6,5423
"34023007203",2655,115,319,55,1614,14,720,95,5587
"34023007301",2677,141,101,10,257,0,321,124,3631
"34023007303",1518,104,92,2,72,0,233,0,2021
"34023007304",2945,240,536,131,2370,110,697,21,7050
"34023007402",3513,105,408,10,432,37,449,10,4964
"34023007500",2905,193,118,0,150,34,484,141,4025
"34023007600",4404,419,192,4,271,0,660,27,5977
"34023007702",3532,87,399,32,1379,0,565,0,5994
"34023007703",2648,82,84,0,388,0,248,27,3477
"34023007704",2431,39,94,0,137,0,368,18,3087
"34023007801",1862,84,224,39,729,0,193,0,3131
"34023007804",4090,58,211,0,911,15,551,18,5854
"34023007805",4140,27,84,0,476,0,363,0,5090
"34023007806",3321,205,173,1,299,10,529,22,4560
"34023007905",1781,66,136,3,404,4,244,34,2672
"34023007906",954,144,270,91,278,16,320,116,2189
"34023007907",2664,34,64,0,288,0,183,0,3233
"34023007908",1294,87,987,115,1872,245,821,29,5450
"34023007909",3120,79,0,11,635,0,289,11,4145
"34023007910",2131,97,188,0,643,40,406,40,3545
"34023007911",2411,0,121,0,1453,11,445,0,4441
"34023007912",5366,171,75,96,2081,47,629,44,8509
"34023008001",4760,232,577,75,698,61,390,5,6798
"34023008101",3959,89,123,2,242,23,205,11,4654
"34023008102",3386,145,130,10,152,14,262,24,4123
"34023008103",1898,98,13,0,317,14,238,8,2586
"34023008202",7918,391,214,3,2091,58,379,0,11054
"34023008204",3500,121,147,14,142,0,105,0,4029
"34023008205",2799,197,49,0,108,0,29,41,3223
"34023008206",2866,214,248,110,13,0,51,54,3556
"34023008207",2292,66,20,0,0,0,56,0,2434
"34023008208",7840,260,344,46,3628,0,409,2,12529
"34023008209",2908,155,0,2,336,12,41,12,3466
"34023008300",4727,639,256,0,297,0,914,355,7188
"34023008403",3131,88,853,290,2944,42,177,14,7539
"34023008404",2634,26,194,7,824,26,317,7,4035
"34023008405",2411,119,432,3,2103,12,90,37,5207
"34023008406",1279,49,67,0,787,12,162,42,2398
"34023008501",2012,96,579,53,2264,116,86,20,5226
"34023008502",2872,61,108,0,2224,0,310,27,5602
"34023008503",3421,66,880,22,4726,79,396,60,9650
"34023008504",3481,83,90,2,2176,0,122,11,5965
"34023008601",2512,124,81,1,2313,0,526,11,5568
"34023008602",1830,78,144,10,3279,126,87,0,5554
"34023008604",2545,94,225,12,2957,110,401,0,6344
"34023008605",705,35,319,0,1252,0,167,0,2478
"34023008606",1584,97,339,0,2092,113,211,48,4484
"34023008700",2937,50,89,1,526,0,70,0,3673
"34023008800",1333,13,273,0,658,212,191,0,2680
"34023008900",1408,158,498,52,1584,249,843,116,4908
"34023009000",911,202,769,92,573,73,200,1,2821
"34023009100",2456,88,415,71,509,0,507,40,4086
"34023009200",3063,160,274,0,476,2,553,15,4543
"34023009300",1487,1369,660,434,732,282,1026,1143,7133
"34023009400",2841,214,458,21,1378,196,584,69,5761
"34025800100",3880,739,68,0,220,25,352,143,5427
"34025800200",3879,252,40,1,122,73,165,34,4566
"34025800400",3136,214,0,0,67,32,108,48,3605
"34025800500",3989,175,10,1,150,0,404,0,4729
"34025800601",4885,273,42,3,213,10,488,11,5925
"34025800602",3254,188,20,0,183,0,343,17,4005
"34025800701",4243,163,20,0,209,0,192,6,4833
"34025800702",2730,345,10,0,181,81,52,0,3399
"34025800800",6031,186,0,0,115,0,519,17,6868
"34025800900",5579,111,101,0,85,0,385,10,6271
"34025801000",3674,300,10,0,146,0,313,0,4443
"34025801100",3952,93,16,7,249,46,215,30,4608
"34025801200",3628,54,0,0,206,0,97,0,3985
"34025801300",5584,95,91,0,477,0,325,0,6572
"34025801400",3778,7,0,0,240,17,221,0,4263
"34025801500",5628,255,84,3,419,15,238,0,6642
"34025801600",3941,677,165,48,276,99,630,44,5880
"34025801700",2928,558,255,126,512,262,569,237,5447
"34025801800",5508,120,115,166,163,11,740,1,6824
"34025801900",2515,103,193,184,561,7,501,17,4081
"34025802000",3077,105,91,22,334,20,609,31,4289
"34025802100",5470,150,172,25,340,49,538,0,6744
"34025802200",3541,255,0,8,74,0,300,8,4186
"34025802300",3954,137,28,11,202,86,240,10,4668
"34025802400",4865,109,122,0,508,0,405,0,6009
"34025802500",2304,48,238,31,723,3,678,0,4025
"34025802600",2726,157,1178,37,719,66,560,12,5455
"34025802700",3103,151,171,45,356,1,204,21,4052
"34025802800",3170,153,336,0,510,22,319,7,4517
"34025802900",1664,42,10,94,110,0,114,12,2046
"34025803000",4204,71,252,71,415,69,423,0,5505
"34025803100",2591,332,155,3,489,56,228,239,4093
"34025803201",2309,26,45,0,1090,93,115,34,3712
"34025803202",5079,159,70,0,761,98,134,0,6301
"34025803300",5089,124,160,0,1168,0,159,0,6700
"34025803400",1547,619,1316,229,987,402,1581,972,7653
"34025803500",1855,114,113,27,269,109,333,89,2909
"34025803600",3528,212,46,36,641,18,788,70,5339
"34025803700",5643,157,128,1,152,0,161,0,6242
"34025803800",3047,23,0,3,19,47,78,0,3217
"34025803900",3482,322,33,0,89,0,115,0,4041
"34025804100",2929,204,0,0,147,0,193,0,3473
"34025804200",5534,252,0,0,153,0,210,0,6149
"34025804500",4186,112,850,9,393,0,406,0,5956
"34025804600",2487,51,53,0,317,0,107,0,3015
"34025804700",0,0,45,0,0,0,0,0,45
"34025804800",7620,449,635,58,419,97,275,40,9593
"34025805001",2048,386,1136,79,989,118,611,331,5698
"34025805100",3183,216,55,9,470,6,281,44,4264
"34025805300",5150,228,41,0,69,0,43,0,5531
"34025805400",2588,175,343,43,157,127,366,174,3973
"34025805500",1689,265,1146,97,488,25,946,25,4681
"34025805600",313,485,489,319,429,170,419,616,3240
"34025805700",1933,208,186,16,1080,346,1673,511,5953
"34025805800",1897,448,470,112,390,157,882,307,4663
"34025805900",3276,689,673,119,635,86,1226,355,7059
"34025806000",3232,561,304,33,788,1,830,135,5884
"34025806100",3012,259,39,70,38,40,110,0,3568
"34025806201",1915,459,0,0,31,13,44,0,2462
"34025806202",4273,62,0,0,195,0,402,0,4932
"34025806300",2084,220,0,0,238,37,189,6,2774
"34025806400",4186,568,21,2,365,2,129,11,5284
"34025806501",2065,345,508,163,896,183,837,201,5198
"34025806502",2051,130,678,8,548,57,372,25,3869
"34025806503",3444,7,94,0,355,0,176,0,4076
"34025806504",1329,244,698,24,322,69,269,60,3015
"34025806600",4706,283,34,0,281,0,468,37,5809
"34025807003",1738,240,1030,999,540,328,1637,777,7289
"34025807004",1453,417,425,307,458,141,764,424,4389
"34025807100",937,90,681,478,47,224,169,244,2870
"34025807200",271,54,896,691,250,87,249,203,2701
"34025807300",334,268,1437,995,29,141,336,376,3916
"34025807400",2851,125,56,12,95,0,132,0,3271
"34025807500",918,108,1228,36,243,68,591,123,3315
"34025807600",195,17,1455,848,119,46,81,36,2797
"34025807700",717,46,2377,411,386,78,251,78,4344
"34025807800",1588,76,2179,214,647,9,414,20,5147
"34025807900",1984,148,1199,19,210,8,159,55,3782
"34025808001",4029,234,23,0,20,0,90,0,4396
"34025808002",2036,55,226,26,133,2,224,1,2703
"34025808100",2892,155,1004,232,448,0,232,170,5133
"34025808200",3332,307,100,58,192,309,434,260,4992
"34025808300",1724,80,0,1,98,38,72,48,2061
"34025808401",1717,220,109,3,90,25,355,80,2599
"34025808402",2994,309,23,26,230,17,907,69,4575
"34025808500",5449,580,19,3,237,53,196,0,6537
"34025808600",5366,179,541,18,117,0,173,0,6394
"34025808701",4643,253,18,1,169,0,32,0,5116
"34025808702",3901,53,11,0,97,0,149,0,4211
"34025808800",3920,69,0,28,47,14,38,0,4116
"34025808900",4334,239,10,68,18,40,153,0,4862
"34025809000",1075,212,262,19,108,39,191,109,2015
"34025809100",2851,128,21,0,11,0,94,1,3106
"34025809200",1782,54,0,1,15,0,48,8,1908
"34025809301",2744,145,0,55,0,0,8,54,3006
"34025809302",2715,186,12,0,14,0,14,8,2949
"34025809400",4354,113,202,0,113,0,210,0,4992
"34025809501",5339,28,134,13,2799,46,695,7,9061
"34025809502",6450,0,201,0,1965,0,339,0,8955
"34025809600",6025,73,51,0,476,0,217,0,6842
"34025809701",4460,48,129,5,996,4,106,0,5748
"34025809703",4087,48,35,0,413,0,97,0,4680
"34025809704",4596,223,104,0,1231,30,217,0,6401
"34025809901",4743,193,54,0,196,14,155,14,5369
"34025809902",4046,197,23,0,381,0,83,91,4821
"34025809903",129,0,30,0,61,0,59,0,279
"34025810001",4879,190,157,11,496,0,185,0,5918
"34025810002",2920,315,101,0,72,27,147,8,3590
"34025810003",4649,75,32,4,370,9,348,0,5487
"34025810004",3561,115,0,1,195,0,35,0,3907
"34025810101",3751,160,55,0,369,0,58,0,4393
"34025810102",3424,62,70,0,374,185,122,185,4422
"34025810200",9805,133,706,13,1721,60,926,0,13364
"34025810300",1575,32,19,0,208,0,112,0,1946
"34025810401",2697,159,60,5,492,0,249,70,3732
"34025810402",6686,90,242,9,1109,0,434,0,8570
"34025810501",3737,123,254,55,296,32,560,79,5136
"34025810502",6351,236,141,2,947,34,678,69,8458
"34025810503",3448,258,88,17,172,0,129,29,4141
"34025810600",6068,322,131,16,297,50,164,22,7070
"34025810700",1474,90,141,8,177,0,414,41,2345
"34025810800",1834,427,403,213,396,171,1255,473,5172
"34025810900",1948,266,150,22,430,8,768,184,3776
"34025811000",2802,343,275,19,255,146,1674,466,5980
"34025811101",5041,250,0,0,355,0,263,76,5985
"34025811102",5622,222,101,1,350,1,216,15,6528
"34025811200",4670,197,188,21,265,116,445,109,6011
"34025811301",3654,534,399,55,807,168,402,255,6274
"34025811303",4162,61,126,13,247,27,308,0,4944
"34025811304",3007,118,143,0,375,12,464,67,4186
"34025811401",5321,41,81,0,265,205,533,0,6446
"34025811402",3262,318,351,13,210,0,417,270,4841
"34025811501",5527,56,0,0,427,56,386,0,6452
"34025811502",3082,224,65,0,282,38,200,0,3891
"34025811600",1071,85,66,5,87,0,66,8,1388
"34025811900",6148,165,182,0,369,0,185,0,7049
"34025812000",1590,58,83,0,80,0,51,0,1862
"34025812100",1281,75,41,3,61,0,214,11,1686
"34025812200",2435,49,325,28,632,236,554,179,4438
"34025812300",4251,109,213,3,158,15,438,44,5231
"34025812400",2248,103,9,10,61,15,105,12,2563
"34025812501",5102,279,244,12,302,0,165,0,6104
"34025812502",4382,150,247,2,585,0,223,24,5613
"34025990000",0,0,0,0,0,0,0,0,0
"34027040101",3787,4,44,4,395,118,171,11,4534
"34027040102",4712,232,205,42,427,0,179,148,5945
"34027040200",6180,271,58,5,472,76,507,27,7596
"34027040300",8211,133,13,0,112,0,141,0,8610
"34027040400",3572,69,0,0,128,0,247,0,4016
"34027040500",2994,191,10,0,443,81,606,190,4515
"34027040600",3466,43,11,0,320,0,418,0,4258
"34027040701",5787,159,1,0,96,0,322,0,6365
"34027040702",4060,37,0,0,174,0,308,0,4579
"34027040801",4123,321,4,0,419,0,110,10,4987
"34027040803",4900,253,13,0,1988,19,621,40,7834
"34027040804",2708,123,105,0,491,30,53,3,3513
"34027040805",5054,49,0,17,842,49,367,0,6378
"34027040900",3630,180,120,0,277,0,57,0,4264
"34027041000",3656,156,312,4,505,44,470,23,5170
"34027041100",2978,150,85,0,342,64,603,121,4343
"34027041200",3597,47,0,0,537,37,55,29,4302
"34027041300",3785,86,105,4,245,2,195,0,4422
"34027041400",5022,142,234,0,582,1,409,25,6415
"34027041500",5269,52,209,1,828,21,340,0,6720
"34027041601",3957,181,163,6,3029,92,330,60,7818
"34027041602",2142,28,26,0,685,21,161,21,3084
"34027041603",2408,87,181,0,1510,202,330,50,4768
"34027041604",3529,72,27,0,894,17,243,0,4782
"34027041701",3980,122,174,0,1426,152,636,23,6513
"34027041702",2361,51,101,0,1171,89,239,13,4025
"34027041704",2649,123,299,41,1638,13,347,45,5155
"34027041705",937,139,0,0,225,79,98,6,1484
"34027041706",2764,332,322,0,1628,0,957,48,6051
"34027041801",1204,30,162,30,1222,69,123,0,2840
"34027041802",3287,109,108,0,1987,15,419,81,6006
"34027041803",2451,61,84,25,1868,0,213,49,4751
"34027041901",4782,383,61,0,419,197,580,253,6675
"34027041902",4321,91,17,0,882,82,289,22,5704
"34027042000",3561,91,166,0,705,9,88,0,4620
"34027042100",3865,159,0,0,281,0,571,11,4887
"34027042200",3942,181,0,1,865,20,269,20,5298
"34027042301",2257,111,14,33,86,0,157,33,2691
"34027042302",2752,26,76,2,111,0,226,0,3193
"34027042500",3288,13,59,0,146,0,34,0,3540
"34027042600",5362,386,154,16,756,0,643,0,7317
"34027042700",3483,11,0,4,382,16,195,2,4093
"34027042800",4441,115,0,12,485,0,411,0,5464
"34027042900",3029,260,109,26,235,4,94,64,3821
"34027043000",3816,113,35,2,420,10,215,0,4611
"34027043100",3212,70,52,9,281,0,1,12,3637
"34027043200",2518,89,68,0,118,0,154,35,2982
"34027043301",1800,54,644,21,176,0,339,0,3034
"34027043302",2828,77,12,11,250,0,47,0,3225
"34027043303",3283,27,43,0,243,0,240,0,3836
"34027043401",5574,253,256,29,804,0,312,54,7282
"34027043402",4509,201,32,195,430,8,305,27,5707
"34027043500",1805,890,675,149,396,45,1822,778,6560
"34027043600",4371,231,373,14,642,15,839,66,6551
"34027043700",2231,218,193,0,319,12,248,148,3369
"34027043800",3356,521,347,99,1039,0,1632,371,7365
"34027043900",3916,297,123,13,293,0,138,0,4780
"34027044000",5056,98,110,0,562,0,224,0,6050
"34027044101",2602,43,0,1,276,0,95,0,3017
"34027044102",4464,148,89,1,1025,100,969,38,6834
"34027044200",3238,248,8,93,242,8,49,0,3886
"34027044300",5543,150,238,2,538,0,668,48,7187
"34027044401",4084,123,286,0,308,0,202,43,5046
"34027044403",4217,61,0,0,455,0,536,19,5288
"34027044404",3000,21,129,0,846,0,527,4,4527
"34027044501",5149,183,184,16,935,0,741,60,7268
"34027044502",3102,97,71,8,964,28,1065,30,5365
"34027044601",4677,73,0,1,217,38,188,0,5194
"34027044602",5224,276,73,12,68,0,389,0,6042
"34027044701",4522,208,0,0,35,42,456,0,5263
"34027044702",4491,138,278,4,818,0,447,47,6223
"34027044800",3014,220,246,10,3522,150,4971,320,12453
"34027044900",2827,180,229,0,2322,218,3687,324,9787
"34027045000",1844,368,84,24,2252,283,2893,409,8157
"34027045100",3745,251,241,1,2114,214,2576,362,9504
"34027045200",2878,97,158,15,515,0,551,23,4237
"34027045300",3080,140,219,0,517,116,301,116,4489
"34027045401",4668,157,48,3,230,0,240,33,5379
"34027045402",4157,268,97,167,980,0,701,0,6370
"34027045501",4834,37,49,0,248,0,270,34,5472
"34027045502",7415,115,131,23,655,0,418,16,8773
"34027045602",587,58,215,47,547,220,784,220,2678
"34027045603",3227,153,379,0,1419,62,1032,74,6346
"34027045701",5079,248,59,41,675,26,83,22,6233
"34027045703",3288,79,138,0,204,0,134,0,3843
"34027045704",4740,138,56,0,442,0,234,35,5645
"34027045804",4886,338,14,0,633,0,251,0,6122
"34027045901",1344,54,0,0,119,3,140,3,1663
"34027045902",7130,461,25,0,194,33,79,10,7932
"34027046000",2515,442,126,14,65,77,536,211,3986
"34027046103",4551,425,337,0,579,0,566,124,6582
"34027046104",6219,396,291,86,852,0,1597,244,9685
"34027046105",4973,243,583,3,636,52,440,32,6962
"34027046106",6287,394,363,11,880,0,497,40,8472
"34027046201",5220,114,172,28,843,0,741,0,7118
"34027046202",3531,126,14,0,133,0,298,37,4139
"34027046297",3300,52,81,0,53,0,117,0,3603
"34027046298",4307,55,100,0,388,0,305,0,5155
"34027046300",3989,146,233,21,862,108,291,49,5699
"34027046400",4449,58,0,4,194,0,186,0,4891
"34029710100",3929,435,44,0,149,117,126,298,5098
"34029711100",3940,76,18,11,56,67,339,67,4574
"34029711200",3709,323,0,0,2,0,38,0,4072
"34029711300",3631,299,0,0,171,0,207,29,4337
"34029711400",5610,196,0,0,182,0,278,0,6266
"34029712000",1231,119,0,0,40,0,0,0,1390
"34029713000",3783,204,25,2,273,194,113,55,4649
"34029713100",5938,229,36,0,351,3,353,0,6910
"34029713201",2525,63,4,0,0,0,124,10,2726
"34029713202",3799,81,25,0,100,0,381,0,4386
"34029713203",4117,100,357,115,328,0,538,0,5555
"34029713300",3434,387,0,2,141,0,307,0,4271
"34029713401",4238,261,182,96,226,0,653,18,5674
"34029713402",3063,474,176,0,233,50,275,136,4407
"34029713500",2957,134,0,0,12,0,96,0,3199
"34029713600",3611,116,0,1,96,0,259,1,4084
"34029713700",2482,94,0,0,0,0,73,0,2649
"34029713800",3085,142,20,12,41,39,168,11,3518
"34029713900",5019,414,325,1,589,83,553,104,7088
"34029714000",5535,148,0,1,633,0,493,0,6810
"34029714100",2765,178,0,0,67,0,112,11,3133
"34029714200",5723,554,92,82,181,33,426,114,7205
"34029714300",3306,25,0,0,0,0,9,0,3340
"34029714400",546,28,0,0,0,0,6,1,581
"34029715000",5195,1237,565,469,1600,282,2697,1060,13105
"34029715200",7587,3046,152,136,1095,506,2311,1030,15863
"34029715301",5276,2699,506,256,160,64,820,222,10003
"34029715302",2247,3299,29,63,77,39,339,613,6706
"34029715401",3770,1370,342,0,201,6,222,0,5911
"34029715402",2644,2648,0,0,0,0,104,47,5443
"34029715500",7815,3778,39,2,21,15,220,60,11950
"34029715600",2559,1836,542,102,582,284,928,568,7401
"34029715700",5222,2822,287,16,205,36,932,223,9743
"34029715800",3708,1380,298,105,364,42,736,139,6772
"34029715901",1428,66,489,0,317,38,370,46,2754
"34029715902",3247,195,496,230,165,24,536,7,4900
"34029716000",3578,272,85,0,44,0,127,0,4106
"34029717001",2479,34,115,0,121,0,191,0,2940
"34029717002",3508,144,312,36,377,0,443,10,4830
"34029717101",7599,189,143,0,686,0,874,83,9574
"34029717102",4129,135,134,173,197,0,381,42,5191
"34029717200",7357,297,371,103,511,21,456,21,9137
"34029717300",4894,149,324,20,282,35,427,0,6131
"34029717400",4561,221,276,28,295,0,394,0,5775
"34029717501",6427,380,343,87,339,13,791,227,8607
"34029717502",6075,126,336,0,444,0,393,0,7374
"34029718000",7250,624,193,0,315,1,496,77,8956
"34029720001",3692,290,49,0,188,2,154,2,4377
"34029720101",4090,943,351,50,128,0,224,0,5786
"34029720102",2630,337,63,15,76,0,105,0,3226
"34029720103",4174,150,70,10,116,77,168,21,4786
"34029720202",3154,113,347,108,123,39,168,39,4091
"34029720203",3682,141,256,2,111,10,307,22,4531
"34029720204",4548,307,444,0,483,10,397,12,6201
"34029720205",2590,169,21,0,57,0,109,18,2964
"34029720206",5141,277,269,0,462,0,100,0,6249
"34029721000",2111,124,166,18,142,106,582,18,3267
"34029722001",4215,165,51,0,342,32,286,0,5091
"34029722002",6702,451,100,17,649,65,1015,66,9065
"34029722100",5349,64,224,0,1038,0,576,0,7251
"34029722200",1955,243,62,0,19,0,41,0,2320
"34029722300",3571,82,25,0,193,0,85,10,3966
"34029722401",4821,379,11,0,220,0,329,68,5828
"34029722402",3458,112,0,2,143,0,234,0,3949
"34029722500",921,93,0,0,0,0,20,0,1034
"34029722600",2883,122,40,0,12,43,314,26,3440
"34029722701",3939,256,0,0,380,0,260,8,4843
"34029722702",3881,168,25,0,12,0,82,11,4179
"34029722800",3850,305,472,86,489,77,832,130,6241
"34029722900",3717,343,186,139,716,8,684,26,5819
"34029723000",4305,432,87,12,431,12,388,89,5756
"34029723100",3302,71,40,14,85,32,260,34,3838
"34029723200",5607,405,152,0,505,0,382,0,7051
"34029723300",6295,523,9,24,112,127,959,147,8196
"34029723400",2997,97,0,1,0,0,76,0,3171
"34029723500",1995,240,49,0,114,38,119,0,2555
"34029723600",2258,242,23,8,53,46,30,21,2681
"34029724000",1859,341,629,104,342,357,478,346,4456
"34029725001",2206,139,0,0,205,250,72,257,3129
"34029725002",5573,221,95,3,291,0,476,22,6681
"34029725100",1912,83,0,0,67,24,70,15,2171
"34029726000",1468,109,25,3,62,25,36,29,1757
"34029727001",2078,191,0,0,0,0,0,0,2269
"34029727002",1094,95,0,0,6,0,14,0,1209
"34029728000",4132,638,0,18,126,0,694,62,5670
"34029729000",1659,244,49,0,0,0,36,0,1988
"34029730000",2066,67,8,3,41,0,61,0,2246
"34029731001",3072,73,22,0,50,39,185,39,3480
"34029731002",3346,67,0,0,81,35,232,35,3796
"34029731101",2935,312,34,14,75,46,204,12,3632
"34029731102",5163,89,262,34,551,150,853,155,7257
"34029731103",4169,101,14,0,87,0,243,13,4627
"34029731201",3654,213,69,74,73,0,127,0,4210
"34029731202",3720,366,19,0,71,0,110,0,4286
"34029731203",1621,123,11,0,16,0,17,0,1788
"34029731204",3524,199,26,0,13,5,177,0,3944
"34029731205",2534,205,307,99,66,11,145,33,3400
"34029731206",1925,257,13,17,0,24,48,0,2284
"34029732001",6055,116,0,1,54,0,106,0,6332
"34029732002",7854,800,0,4,49,0,170,154,9031
"34029732101",5461,436,0,36,67,0,367,14,6381
"34029732103",2230,59,0,3,99,1,220,2,2614
"34029732104",3773,367,22,0,73,0,126,0,4361
"34029733000",7614,410,0,17,286,80,372,0,8779
"34029734001",6260,366,202,0,378,18,243,18,7485
"34029734002",5726,654,45,1,199,143,633,49,7450
"34029734003",5530,768,515,2,184,128,419,90,7636
"34029735001",6014,299,0,0,44,0,395,51,6803
"34029735002",8559,172,67,0,211,0,365,0,9374
"34029735101",2202,97,15,0,117,104,144,27,2706
"34029735103",3899,216,0,0,51,0,136,13,4315
"34029735104",3579,449,27,0,309,0,776,173,5313
"34029736001",3038,52,11,0,26,98,73,0,3298
"34029736002",1410,43,6,0,41,27,13,0,1540
"34029736101",4278,678,30,16,281,66,244,307,5900
"34029736102",6519,768,107,33,271,5,409,30,8142
"34029736105",3122,341,55,13,72,6,143,12,3764
"34029737000",2953,296,0,3,84,5,133,22,3496
"34029738001",1891,200,0,0,10,0,21,0,2122
"34029738002",1323,50,13,0,0,1,54,0,1441
"34029738100",1609,75,2,0,73,4,33,0,1796
"34029739000",2034,102,10,0,67,11,71,15,2310
"34029739100",1464,192,0,0,295,0,25,0,1976
"34029980000",0,0,0,0,0,0,0,0,0
"34029980100",0,0,0,0,41,0,0,0,41
"34029990000",0,0,0,0,0,0,0,0,0
"34031116500",6590,575,0,4,411,0,729,467,8776
"34031124200",4555,172,275,0,1958,353,1190,154,8657
"34031124311",3542,172,56,0,928,11,761,11,5481
"34031124312",3194,54,283,1,518,67,357,25,4499
"34031124321",4205,173,499,62,836,133,1136,190,7234
"34031124322",3481,28,0,2,954,0,550,2,5017
"34031124323",1624,119,71,197,667,0,495,10,3183
"34031124401",5478,37,217,53,948,43,1001,98,7875
"34031124402",3101,504,357,36,1128,84,1046,18,6274
"34031124500",4636,819,266,102,1127,95,2289,167,9501
"34031124601",3322,271,147,8,577,63,1152,140,5680
"34031124602",3347,198,431,0,805,85,1233,121,6220
"34031124700",3741,505,140,0,1497,236,2612,414,9145
"34031124800",2778,184,154,0,1458,27,1907,79,6587
"34031124900",2641,414,153,0,1993,157,3360,286,9004
"34031125000",3545,946,136,33,1116,263,3765,767,10571
"34031125100",1937,353,253,51,1001,368,2232,559,6754
"34031133701",2960,266,519,7,1551,237,2470,369,8379
"34031133702",2338,103,32,11,160,18,776,89,3527
"34031143200",6012,204,132,1,214,0,368,17,6948
"34031143300",4834,212,0,6,166,0,849,47,6114
"34031143400",5700,760,187,0,440,0,1012,236,8335
"34031154001",4362,192,335,1,508,42,149,81,5670
"34031154002",6270,687,28,1,653,23,1102,86,8850
"34031163500",7330,161,503,0,275,0,847,0,9116
"34031175200",1518,773,85,206,1464,1541,2813,2338,10738
"34031175301",934,439,31,49,1199,858,2017,1283,6810
"34031175302",1348,376,187,240,1604,1060,2874,1488,9177
"34031175401",1702,395,614,136,1749,711,3258,979,9544
"34031175402",658,386,429,494,1314,1068,2065,1444,7858
"34031175500",1585,550,1111,647,1996,1519,3513,2235,13156
"34031175601",2588,26,0,0,180,0,177,0,2971
"34031175602",2872,375,755,288,1439,1071,2707,1299,10806
"34031175701",2762,180,526,487,990,135,2429,265,7774
"34031175703",1954,341,210,194,1818,163,1749,309,6738
"34031175704",3303,244,141,0,522,8,884,129,5231
"34031175801",852,496,199,17,1778,615,1924,950,6831
"34031175802",1746,1854,255,315,1588,1384,3322,3336,13800
"34031175900",889,224,347,135,1195,1078,1993,1311,7172
"34031180100",3552,724,1770,21,1206,604,3558,556,11991
"34031180201",1327,152,580,196,853,133,1313,258,4812
"34031180202",2828,732,432,215,1107,1181,3245,1089,10829
"34031180300",2067,899,1438,665,1187,381,2723,1040,10400
"34031180600",950,484,1382,797,484,332,1151,669,6249
"34031180700",686,121,565,435,207,155,823,180,3172
"34031180800",796,539,437,390,282,176,1177,653,4450
"34031180900",822,564,477,359,573,446,1384,836,5461
"34031181000",1922,665,480,366,1035,402,2904,1058,8832
"34031181100",2534,536,2167,811,1143,551,3387,969,12098
"34031181200",1022,251,1598,955,332,113,1295,360,5926
"34031181300",741,864,1741,1015,288,124,1078,728,6579
"34031181400",188,178,935,1003,52,110,277,280,3023
"34031181500",80,133,804,696,138,0,298,176,2325
"34031181702",706,521,518,323,535,375,1230,938,5146
"34031181800",537,612,78,321,519,501,870,693,4131
"34031181900",2132,283,301,141,1376,365,2144,352,7094
"34031182000",555,468,47,15,234,249,662,694,2924
"34031182100",1751,966,242,73,775,228,2086,531,6652
"34031182200",1052,657,179,579,586,477,1424,1015,5969
"34031182301",473,408,166,117,205,280,670,687,3006
"34031182302",1430,1141,986,469,1129,1046,2688,2124,11013
"34031182400",1948,310,1991,364,707,99,2728,409,8556
"34031182500",2258,433,3760,835,549,182,2898,594,11509
"34031182600",914,534,3184,532,562,0,1475,348,7549
"34031182700",3206,711,1307,92,1673,287,4817,854,12947
"34031182800",1309,244,394,106,1077,315,2374,517,6336
"34031182900",762,473,59,39,258,214,876,691,3372
"34031183000",4924,1141,35,123,898,532,2735,827,11215
"34031183101",2197,164,373,0,730,122,2013,131,5730
"34031183102",2289,596,567,19,706,166,2849,648,7840
"34031183200",683,199,983,634,160,107,925,286,3977
"34031196401",3606,10,31,0,288,17,267,10,4229
"34031196402",5834,499,2,0,808,31,899,387,8460
"34031203600",3581,352,857,358,707,41,2854,298,9048
"34031216701",6103,145,43,8,400,9,170,12,6890
"34031216702",4873,397,22,2,173,16,332,26,5841
"34031223801",2209,164,45,0,474,6,597,6,3501
"34031223802",5913,118,29,49,947,56,1517,56,8685
"34031223900",186,326,10,100,6,0,2,72,702
"34031236601",2852,112,20,2,599,32,602,15,4234
"34031236602",6365,171,58,45,557,3,908,10,8117
"34031246001",3268,279,34,2,876,72,316,50,4897
"34031246002",2761,33,0,0,0,0,147,0,2941
"34031246003",4755,141,137,1,631,0,280,29,5974
"34031246101",5719,261,168,12,757,0,486,59,7462
"34031246102",1677,102,119,53,591,13,326,8,2889
"34031246103",5609,13,0,0,1031,42,730,42,7467
"34031246104",2863,49,0,0,183,139,234,0,3468
"34031246201",5325,81,18,4,423,0,299,1,6151
"34031246202",4960,108,141,0,222,0,452,34,5917
"34031246203",3602,37,0,6,281,2,352,2,4282
"34031246300",3808,316,220,8,344,66,424,66,5252
"34031256801",4614,248,45,3,53,14,318,14,5309
"34031256802",3882,123,6,1,69,0,260,22,4363
"34031256803",4609,134,14,0,74,0,360,13,5204
"34031256804",6556,208,0,0,322,0,551,2,7639
"34031256805",4776,212,0,0,161,27,505,26,5707
"34031264101",4139,350,135,0,350,67,1479,196,6716
"34031264102",5001,285,102,2,1360,89,1033,62,7934
"34031264200",421,744,1307,1250,506,319,749,1116,6412
"34033020100",1670,55,123,30,48,14,47,22,2009
"34033020200",787,53,740,157,313,24,655,24,2753
"34033020300",793,337,895,463,346,149,349,216,3548
"34033020400",1519,558,558,105,24,0,256,276,3296
"34033020500",1916,104,404,37,111,4,72,0,2648
"34033020600",1763,120,220,50,269,3,280,16,2721
"34033020700",3427,274,70,35,76,4,76,4,3966
"34033020800",2573,136,685,49,49,7,150,7,3656
"34033020900",2833,100,30,43,326,106,313,103,3854
"34033021000",1080,112,38,20,66,6,40,1,1363
"34033021101",4218,223,54,11,149,0,190,0,4845
"34033021102",3547,218,555,21,221,0,214,0,4776
"34033021201",3049,161,47,0,38,8,21,31,3355
"34033021202",2055,161,221,44,131,10,54,10,2686
"34033021300",1095,137,270,3,12,17,51,57,1642
"34033021400",2829,198,66,12,242,27,98,21,3493
"34033021500",1578,235,0,0,121,0,60,0,1994
"34033021600",4868,768,89,0,111,0,227,0,6063
"34033021700",1686,391,45,0,24,0,27,105,2278
"34033021900",931,133,462,216,39,104,7,46,1938
"34033022000",105,235,678,864,41,51,55,225,2254
"34033022100",503,113,287,230,39,60,32,40,1304
"34033022201",1467,94,34,60,60,4,7,1,1727
"34033022202",942,28,33,31,0,8,0,12,1054
"34033990000",0,0,0,0,0,0,0,0,0
"34035050100",2396,131,46,67,129,63,511,9,3352
"34035050200",1376,159,294,2,496,0,288,91,2706
"34035050300",3139,71,127,17,704,7,478,2,4545
"34035050400",1212,102,555,160,540,84,788,150,3591
"34035050500",2184,274,112,12,442,271,724,391,4410
"34035050600",2912,53,65,0,592,127,241,127,4117
"34035050701",2883,157,2,1,785,16,291,0,4135
"34035050703",2652,107,51,61,2115,37,538,1,5562
"34035050704",3955,262,77,0,2490,18,381,5,7188
"34035050801",2911,17,6,14,410,5,110,6,3479
"34035050802",3337,54,140,0,671,0,224,0,4426
"34035050901",4136,105,41,0,422,15,147,0,4866
"34035050902",3034,36,116,4,271,0,192,0,3653
"34035050903",4315,76,202,2,880,51,224,0,5750
"34035051000",3939,501,378,131,2184,59,1540,227,8959
"34035051100",2689,183,191,4,711,14,2039,143,5974
"34035051200",2360,386,491,77,836,162,1722,511,6545
"34035051300",1944,53,24,4,307,0,386,0,2718
"34035051400",3750,159,19,11,462,0,819,0,5220
"34035051500",2342,269,0,92,392,0,776,98,3969
"34035051600",2524,156,0,35,128,1,557,1,3402
"34035051700",2214,76,244,98,1896,207,2708,250,7693
"34035051800",1803,59,756,25,1780,435,2411,463,7732
"34035051900",2344,84,889,59,396,140,1039,140,5091
"34035052001",1566,180,1143,36,684,70,750,147,4576
"34035052002",1967,585,793,49,931,333,1556,337,6551
"34035052100",5159,154,80,25,1603,0,525,0,7546
"34035052201",4421,192,76,7,1031,0,553,157,6437
"34035052203",3599,67,2,3,986,0,170,0,4827
"34035052204",4169,36,23,2,770,75,436,75,5586
"34035052300",4563,205,93,0,888,6,80,0,5835
"34035052400",4709,167,33,15,334,86,290,1,5635
"34035052601",6529,159,42,97,2417,181,479,30,9934
"34035052603",3659,80,36,0,237,0,180,0,4192
"34035052700",6699,175,16,0,866,2,1130,79,8967
"34035052800",2305,32,51,28,46,14,268,24,2768
"34035052901",806,63,46,0,122,0,85,17,1139
"34035052903",5020,168,130,1,651,66,306,0,6342
"34035052904",1925,38,16,3,119,0,131,4,2236
"34035053000",3158,350,404,0,653,19,1179,201,5964
"34035053102",1589,36,1322,51,1000,13,311,0,4322
"34035053103",2473,23,1606,138,789,141,578,135,5883
"34035053105",3894,463,627,14,2022,49,509,14,7592
"34035053200",2550,217,3212,241,1032,0,1350,163,8765
"34035053300",1068,95,1910,433,670,9,878,64,5127
"34035053402",3254,20,751,0,2687,122,356,28,7218
"34035053403",1491,22,1303,69,2024,41,317,0,5267
"34035053404",3068,325,3233,284,3948,292,1109,198,12457
"34035053501",2248,87,226,6,425,0,35,0,3027
"34035053602",5258,65,121,0,822,0,307,0,6573
"34035053603",4056,59,128,2,338,42,306,29,4960
"34035053604",3058,53,108,0,416,0,182,0,3817
"34035053703",2646,98,64,1,497,1,80,1,3388
"34035053704",2662,15,57,6,428,0,318,0,3486
"34035053705",4852,519,458,1,1045,43,1091,84,8093
"34035053706",3431,148,237,67,1047,29,368,89,5416
"34035053707",2898,71,153,37,598,0,92,0,3849
"34035053801",384,5,0,5,48,0,8,2,452
"34035053803",6603,35,413,0,1085,0,232,0,8368
"34035053804",3023,80,324,16,938,32,606,21,5040
"34035053805",2721,132,152,0,781,158,359,0,4303
"34035053901",511,20,8,0,4,0,21,0,564
"34035053904",2704,20,0,0,658,0,161,0,3543
"34035053905",3606,16,438,0,2908,62,157,0,7187
"34035054100",5876,67,82,45,1045,97,420,8,7640
"34035054201",4682,444,69,0,2076,0,194,275,7740
"34035054202",3131,135,25,5,1192,0,180,52,4720
"34035054300",5255,307,987,55,2272,47,412,8,9343
"34037371000",3083,505,16,3,172,13,254,32,4078
"34037371100",3811,52,44,7,215,0,70,0,4199
"34037371200",1465,331,31,12,132,17,118,15,2121
"34037371300",3724,101,55,0,24,8,232,54,4198
"34037371400",2773,99,88,0,137,0,304,3,3404
"34037371502",4571,323,76,3,119,3,383,3,5481
"34037371503",2455,48,40,0,120,0,175,15,2853
"34037371600",2526,366,49,7,108,39,426,86,3607
"34037371700",4843,330,122,7,217,23,455,24,6021
"34037371800",6474,373,45,4,230,17,296,3,7442
"34037371900",1795,122,46,0,82,0,65,0,2110
"34037372000",3121,117,0,1,39,0,227,0,3505
"34037372100",1748,54,0,1,64,2,60,2,1931
"34037372200",1889,84,0,0,0,62,71,62,2168
"34037372300",3989,153,39,17,104,0,40,0,4342
"34037372400",2257,89,0,4,67,0,119,0,2536
"34037372500",2646,221,66,0,96,0,127,20,3176
"34037372600",4882,114,7,2,95,0,88,3,5191
"34037372700",2854,217,22,1,148,0,255,73,3570
"34037372800",1399,137,23,1,64,5,106,6,1741
"34037372900",2898,242,11,86,131,0,319,46,3733
"34037373000",2179,81,3,0,60,0,156,0,2479
"34037373100",5541,50,55,9,287,23,483,0,6448
"34037373200",3558,50,24,0,283,14,266,0,4195
"34037373300",2632,60,2,6,204,2,98,2,3006
"34037373400",6065,433,55,1,222,0,151,17,6944
"34037373500",3376,78,20,1,121,0,146,3,3745
"34037373600",2369,61,72,0,168,0,206,37,2913
"34037373700",2139,448,312,388,284,40,437,96,4144
"34037373800",3191,334,184,30,147,19,286,82,4273
"34037373900",3746,118,0,0,165,43,86,11,4169
"34037374000",3052,98,0,36,179,0,35,1,3401
"34037374100",3380,103,0,3,83,0,277,0,3846
"34037374200",2296,41,0,0,157,0,75,0,2569
"34037374300",3271,94,26,0,69,0,94,0,3554
"34037374400",2258,19,0,0,46,0,124,0,2447
"34037374500",1895,55,0,0,56,11,176,0,2193
"34037374600",3046,267,18,25,224,0,215,85,3880
"34037374700",3768,96,101,11,192,9,334,50,4561
"34037374800",3531,221,261,5,372,0,214,0,4604
"34037374900",3787,216,56,0,128,253,510,338,5288
"34039030200",878,149,473,87,821,327,1509,460,4704
"34039030400",1433,281,954,719,1696,665,2850,911,9509
"34039030500",1981,212,640,183,1465,762,2868,986,9097
"34039030600",1396,481,452,403,436,217,1100,611,5096
"34039030701",988,356,0,0,510,37,644,341,2876
"34039030702",4216,665,644,144,2447,450,4750,867,14183
"34039030802",1674,94,259,147,552,162,1630,233,4751
"34039030900",3046,431,363,0,2161,488,4320,811,11620
"34039031000",1011,172,527,239,1387,375,2407,518,6636
"34039031100",2126,470,436,180,1635,416,3155,801,9219
"34039031200",1107,418,1963,278,1491,388,2258,665,8568
"34039031300",2480,195,1040,554,2316,391,3825,519,11320
"34039031400",1107,416,1886,450,1160,172,2074,522,7787
"34039031500",2672,251,618,8,1337,232,2279,379,7776
"34039031601",1213,135,1108,86,773,204,1808,282,5609
"34039031602",2790,713,953,100,1062,412,2888,1004,9922
"34039031700",1677,674,1730,637,797,262,1514,702,7993
"34039031801",3405,461,790,22,285,526,2885,713,9087
"34039031802",1124,219,499,99,421,118,1411,318,4209
"34039031903",2611,719,568,163,1455,204,3179,917,9816
"34039031904",892,673,710,172,815,168,1562,710,5702
"34039032001",3783,1048,150,52,1623,264,4264,792,11976
"34039032002",2216,181,387,94,729,84,2057,179,5927
"34039032100",5399,130,414,0,777,0,2407,44,9171
"34039032200",285,0,4719,1004,105,15,232,0,6360
"34039032300",323,150,1310,196,295,0,277,112,2663
"34039032400",2412,167,2781,815,1232,203,1488,210,9308
"34039032500",2753,296,1697,270,420,51,654,22,6163
"34039032600",1197,209,2463,215,694,110,305,36,5229
"34039032700",2572,388,2894,84,1304,170,884,112,8408
"34039032800",742,43,3535,539,143,28,314,137,5481
"34039032901",1883,121,813,24,1130,158,791,53,4973
"34039032902",3887,106,480,87,1001,92,1192,0,6845
"34039033000",2449,80,424,31,1103,18,1184,18,5307
"34039033100",2866,96,1426,2,1072,24,757,31,6274
"34039033200",2601,47,973,120,870,100,706,135,5552
"34039033300",2513,113,323,36,1084,29,697,0,4795
"34039033400",2506,12,251,0,508,84,544,84,3989
"34039033500",4411,191,964,6,734,205,1445,24,7980
"34039033600",6422,426,372,2,744,11,1231,55,9263
"34039033700",2943,123,306,116,1499,29,1462,91,6569
"34039033800",3246,109,139,0,1621,24,1444,0,6583
"34039033900",1908,90,296,12,579,251,878,251,4265
"34039034000",1518,183,2346,342,1088,355,1433,414,7679
"34039034100",917,121,1754,148,321,194,883,218,4556
"34039034200",797,138,1973,187,668,304,480,340,4887
"34039034300",1042,47,2068,145,699,46,752,0,4799
"34039034400",435,75,2222,494,410,76,526,56,4294
"34039034500",1938,216,1362,195,771,45,1657,205,6389
"34039034600",198,37,2676,558,486,93,592,29,4669
"34039034700",1894,108,1166,211,531,0,805,179,4894
"34039034800",3666,82,453,25,335,0,817,14,5392
"34039034900",4595,247,865,0,841,105,1761,222,8636
"34039035000",1953,33,222,0,511,4,721,4,3448
"34039035100",1463,161,1339,150,800,130,996,211,5250
"34039035200",1434,202,182,5,507,251,1214,280,4075
"34039035300",2369,360,1167,128,418,247,810,187,5686
"34039035400",1896,73,342,12,340,55,695,22,3435
"34039035500",3597,646,1171,166,1217,136,1605,152,8690
"34039035600",2534,235,594,21,358,18,646,0,4406
"34039035700",2673,290,711,35,1271,44,1444,19,6487
"34039035800",1353,0,1518,499,253,80,754,80,4537
"34039035900",1330,142,779,168,530,233,534,276,3992
"34039036000",906,116,2675,184,1052,0,1247,50,6230
"34039036100",1269,96,30,0,96,5,140,0,1636
"34039036200",5988,173,1,0,330,0,573,20,7085
"34039036301",4069,146,30,7,233,84,448,0,5017
"34039036302",3411,162,16,0,81,0,398,2,4070
"34039036400",6791,77,122,20,523,0,624,0,8157
"34039036500",4884,212,56,1,552,0,387,15,6107
"34039036600",2950,77,630,101,256,3,350,47,4414
"34039036700",5306,89,118,0,320,12,229,0,6074
"34039036800",6211,59,39,146,705,10,219,0,7389
"34039036900",3690,107,27,2,413,0,557,23,4819
"34039037000",5712,247,184,10,98,0,308,37,6596
"34039037100",4012,38,0,0,153,0,208,0,4411
"34039037200",2784,123,223,8,218,0,284,36,3676
"34039037300",3838,64,161,20,452,0,146,0,4681
"34039037400",3937,66,103,3,163,1,333,6,4612
"34039037500",4111,76,87,120,927,0,643,122,6086
"34039037601",3973,112,160,0,353,46,203,8,4855
"34039037602",4558,488,404,93,689,52,371,1,6656
"34039037700",3823,128,58,289,458,17,318,2,5093
"34039037800",4217,434,116,0,669,47,536,316,6335
"34039037900",5032,20,179,0,697,44,53,44,6069
"34039038000",3426,593,218,92,1018,40,1476,405,7268
"34039038101",3522,110,2,8,542,57,115,9,4365
"34039038102",6443,392,68,0,906,64,467,214,8554
"34039038201",4916,186,26,19,801,0,221,32,6201
"34039038202",6113,74,0,5,571,34,432,2,7231
"34039038300",5565,355,247,1,364,0,397,0,6929
"34039038400",3732,102,1428,24,799,11,472,36,6604
"34039038500",4232,61,523,21,525,0,203,0,5565
"34039038601",6309,44,821,24,825,0,674,0,8697
"34039038602",3288,108,232,0,365,15,121,0,4129
"34039038700",6351,40,362,0,607,0,534,17,7911
"34039038800",421,88,2658,384,714,157,913,109,5444
"34039038900",578,279,1592,935,1702,830,1780,706,8402
"34039039000",399,149,1109,122,1475,528,1377,491,5650
"34039039100",1325,109,1118,61,458,0,342,14,3427
"34039039200",448,145,2014,448,1325,427,1234,339,6380
"34039039300",498,301,662,602,2759,1418,2897,1144,10281
"34039039400",401,131,1827,434,1770,655,1451,518,7187
"34039039500",543,102,2194,345,2850,916,2746,697,10393
"34039039600",699,166,2129,283,459,318,658,465,5177
"34039039700",777,38,2803,111,721,285,731,225,5691
"34039039800",1489,191,745,212,976,394,1825,481,6313
"34039039900",320,43,210,120,178,35,395,89,1390
"34041030600",2743,491,146,20,196,32,406,52,4086
"34041030700",3149,885,451,159,189,74,614,109,5630
"34041030800",2636,483,9,75,111,13,109,12,3448
"34041030900",1663,252,258,132,399,147,316,121,3288
"34041031101",5564,204,6,12,148,0,222,17,6173
"34041031102",3596,109,47,0,113,5,202,5,4077
"34041031200",6738,390,51,7,520,14,251,64,8035
"34041031301",5074,183,1,3,318,1,367,0,5947
"34041031302",4049,59,15,0,303,0,239,0,4665
"34041031401",3319,142,67,3,593,214,587,247,5172
"34041031402",3480,827,45,0,263,0,374,648,5637
"34041031500",5933,397,305,0,809,57,659,78,8238
"34041031601",4314,210,29,6,98,18,211,0,4886
"34041031602",2356,45,58,24,6,0,120,3,2612
"34041031700",2373,153,27,7,108,0,49,1,2718
"34041031800",2481,88,26,0,38,0,18,0,2651
"34041031900",5492,310,683,10,83,0,215,61,6854
"34041032000",4941,704,275,46,292,201,375,210,7044
"34041032101",2972,56,0,1,115,6,56,1,3207
"34041032102",4670,129,266,5,549,27,171,17,5834
"34041032200",6472,310,409,43,444,45,330,36,8089
"34041032300",2904,217,56,0,130,11,111,6,3435
"34041032400",2090,168,67,42,21,0,182,19,2589
"35001000107",2087,100,34,38,276,80,500,67,3182
"35001000108",2092,221,95,0,240,60,523,76,3307
"35001000109",1800,63,69,0,442,124,541,23,3062
"35001000110",2334,636,141,18,341,330,713,541,5054
"35001000111",2286,319,8,0,453,0,644,42,3752
"35001000112",1600,21,54,1,333,8,333,0,2350
"35001000113",1685,179,267,0,607,324,723,176,3961
"35001000114",2334,143,15,132,594,50,958,183,4409
"35001000115",1879,366,92,206,453,112,822,99,4029
"35001000116",2224,402,91,0,342,8,711,339,4117
"35001000117",1817,125,59,0,200,43,372,114,2730
"35001000118",2232,187,0,9,484,104,858,64,3938
"35001000119",1710,119,54,0,69,16,627,76,2671
"35001000120",2030,142,72,96,379,10,872,60,3661
"35001000121",3824,941,245,0,840,373,1638,862,8723
"35001000122",2959,266,114,13,364,231,966,191,5104
"35001000123",3345,213,73,3,1012,477,1757,477,7357
"35001000124",2010,736,52,257,423,191,581,448,4698
"35001000125",3432,80,69,2,508,10,967,0,5068
"35001000126",1951,515,105,18,370,11,712,219,3901
"35001000127",1920,312,86,3,437,27,987,195,3967
"35001000128",1997,369,90,36,354,156,1058,117,4177
"35001000129",2178,881,176,140,566,366,915,562,5784
"35001000203",1267,112,54,357,291,71,579,161,2892
"35001000204",1803,234,81,25,500,205,936,118,3902
"35001000205",1872,347,98,42,568,77,1199,192,4395
"35001000206",1657,254,185,0,447,276,793,308,3920
"35001000207",2088,367,27,21,549,100,1383,211,4746
"35001000208",1430,306,51,0,623,34,1135,179,3758
"35001000300",3944,567,44,18,900,225,1150,251,7099
"35001000401",3285,548,84,15,459,86,1047,153,5677
"35001000402",2662,199,113,13,378,37,786,121,4309
"35001000501",1260,390,26,43,918,300,980,112,4029
"35001000502",2743,598,65,79,813,228,589,313,5428
"35001000601",2299,180,263,0,691,83,735,80,4331
"35001000603",1498,1101,113,67,1226,980,1994,1776,8755
"35001000604",1191,1080,54,44,851,940,1104,1541,6805
"35001000704",2209,507,27,41,871,12,1248,217,5132
"35001000707",2810,1221,176,65,1654,730,2912,1532,11100
"35001000708",3785,848,98,73,1261,212,1952,641,8870
"35001000710",4807,168,83,0,687,42,1305,59,7151
"35001000711",3310,433,32,0,753,224,850,305,5907
"35001000712",1846,904,206,38,573,354,976,606,5503
"35001000713",2855,1088,349,144,1616,478,2519,859,9908
"35001000714",2930,541,225,24,1118,281,1631,545,7295
"35001000801",2310,410,107,11,289,263,554,133,4077
"35001000901",1764,1485,145,36,1688,1364,2461,2317,11260
"35001000903",2090,1377,189,440,610,1060,737,1299,7802
"35001000904",2080,427,92,76,1042,606,1242,654,6219
"35001001101",3051,355,69,0,1061,162,746,201,5645
"35001001102",1574,452,98,93,586,467,812,525,4607
"35001001200",2265,1651,324,122,1452,1250,1819,1859,10742
"35001001300",1732,759,64,2,1035,910,2694,1593,8789
"35001001400",1389,615,0,14,327,385,1420,824,4974
"35001001500",861,597,128,18,542,355,775,611,3887
"35001001600",1186,509,51,16,339,367,290,226,2984
"35001001700",2516,783,0,61,750,422,709,334,5575
"35001001800",232,113,0,9,73,44,107,40,618
"35001001900",694,211,9,0,172,0,276,31,1393
"35001002000",790,544,110,8,532,322,980,393,3679
"35001002100",502,195,26,0,113,86,92,101,1115
"35001002200",1924,512,36,0,418,207,775,442,4314
"35001002300",3109,800,151,32,2567,1199,4987,1829,14674
"35001002401",2458,407,0,35,1983,321,3822,676,9702
"35001002402",3074,795,111,252,1894,883,4331,1441,12781
"35001002500",1166,560,5,41,372,205,897,695,3941
"35001002600",587,173,0,0,202,60,395,133,1550
"35001002700",1962,590,74,0,638,267,1330,588,5449
"35001002900",1871,571,29,21,803,381,1474,721,5871
"35001003001",2990,436,62,57,876,472,2097,857,7847
"35001003002",2591,526,40,17,738,177,1840,449,6378
"35001003100",2290,185,15,6,388,0,1018,104,4006
"35001003201",1918,326,11,23,486,119,1479,276,4638
"35001003202",3397,503,53,11,1722,762,3700,1026,11174
"35001003400",1252,1140,58,99,956,613,1249,1243,6610
"35001003501",3415,560,48,0,1009,689,2557,903,9181
"35001003502",3948,273,0,0,741,81,1664,49,6756
"35001003600",3942,1058,38,0,1370,27,2840,736,10011
"35001003707",2737,523,32,0,941,78,1306,273,5890
"35001003712",3873,182,350,0,563,0,1178,0,6146
"35001003714",3912,1171,334,77,1502,547,2548,814,10905
"35001003715",3456,99,0,0,286,16,567,34,4458
"35001003717",3654,459,90,0,934,85,1108,158,6488
"35001003718",2118,169,40,51,372,50,909,0,3709
"35001003719",3830,439,38,9,955,137,1839,119,7366
"35001003721",5175,117,77,0,846,47,673,0,6935
"35001003722",5064,185,133,21,1444,9,2520,28,9404
"35001003723",4161,723,450,13,618,81,1294,321,7661
"35001003724",2583,56,208,0,533,10,1040,0,4430
"35001003725",2995,512,61,10,401,122,1095,339,5535
"35001003726",1861,27,7,0,508,42,520,42,3007
"35001003728",3238,297,132,0,599,282,1261,117,5926
"35001003729",1631,29,0,2,149,2,287,0,2100
"35001003730",3971,117,10,0,537,9,804,31,5479
"35001003731",3280,122,0,0,212,48,820,116,4598
"35001003732",5770,432,34,0,1004,62,1545,291,9138
"35001003733",1342,821,80,30,637,539,1033,858,5340
"35001003735",4043,870,24,0,1489,184,2845,448,9903
"35001003736",1163,313,47,0,365,144,874,175,3081
"35001003737",2344,69,0,0,124,73,241,0,2851
"35001003738",4071,270,59,0,475,176,1045,255,6351
"35001003803",2802,162,5,0,223,0,595,33,3820
"35001003804",4955,228,48,0,552,18,1261,26,7088
"35001003805",1770,317,0,0,83,15,664,208,3057
"35001003806",2819,191,19,0,447,21,944,18,4459
"35001003807",3302,559,14,0,398,70,1014,435,5792
"35001004001",2634,1159,23,39,950,299,2888,1159,9151
"35001004300",2228,758,15,0,1511,547,2959,1197,9215
"35001004401",1611,327,0,0,953,642,2336,918,6787
"35001004402",2108,877,13,45,1096,213,2439,916,7707
"35001004501",1594,620,35,0,904,498,2091,1057,6799
"35001004502",1492,406,20,9,1396,971,2563,1270,8127
"35001004602",2325,199,15,0,1476,389,2709,500,7613
"35001004603",2081,285,26,8,1098,236,2395,442,6571
"35001004604",2487,947,0,54,1394,698,3040,1415,10035
"35001004712",3917,669,100,0,2265,53,4879,601,12484
"35001004713",3725,1221,124,0,1601,151,4297,1312,12431
"35001004715",2397,553,77,0,867,1144,2728,1335,9101
"35001004716",1754,113,14,68,509,154,1024,75,3711
"35001004717",6337,258,233,57,1253,318,3419,353,12228
"35001004720",2823,194,37,0,278,287,965,321,4905
"35001004722",3021,323,27,47,1081,145,1537,91,6272
"35001004723",5531,182,169,0,1096,1,2676,138,9793
"35001004724",2356,11,19,0,270,30,1211,28,3925
"35001004725",2399,111,6,0,1181,32,1972,101,5802
"35001004726",1805,91,15,0,411,88,781,120,3311
"35001004727",1354,58,88,5,281,38,794,31,2649
"35001004728",3389,326,218,80,1215,111,2306,144,7789
"35001004729",2743,298,14,74,782,64,1987,256,6218
"35001004733",3377,1240,279,24,1889,752,4478,1894,13933
"35001004734",3081,587,107,0,1838,1045,3869,1160,11687
"35001004735",750,509,36,34,288,204,950,654,3425
"35001004736",571,320,13,0,650,137,952,433,3076
"35001004737",2721,488,310,18,1554,502,3062,930,9585
"35001004738",3222,1034,157,8,1444,462,3705,1394,11426
"35001004739",2759,1123,361,0,1969,496,3933,1423,12064
"35001004740",3223,836,361,76,1844,786,4418,1458,13002
"35001004741",3240,853,191,68,1852,585,3734,1363,11886
"35001004742",3889,869,164,0,1559,459,3183,685,10808
"35001004743",2560,116,57,0,639,17,1673,100,5162
"35001004744",3318,86,138,0,1952,123,3209,45,8871
"35001004745",4927,131,258,1,1455,22,3271,55,10120
"35001004746",5371,384,214,15,1847,53,3680,334,11898
"35001004747",3329,537,93,240,610,45,1639,233,6726
"35001004748",7395,578,206,13,916,212,3178,348,12846
"35001004749",1901,743,119,12,1467,721,1884,1194,8041
"35001004750",3737,593,166,136,1684,288,3191,658,10453
"35001004751",1969,214,13,0,417,98,715,39,3465
"35001004752",2453,209,83,27,529,603,1211,587,5702
"35001004753",2601,82,70,0,768,35,1478,111,5145
"35001940500",2549,119,0,0,239,18,272,31,3228
"35001940600",3588,645,151,0,1581,537,1978,474,8954
"35001940700",90,0,0,0,1873,578,256,36,2833
"35003976400",2807,581,0,21,96,110,553,155,4323
"35005000201",2743,311,0,13,528,212,1717,353,5877
"35005000202",2070,575,148,27,620,259,1356,664,5719
"35005000300",3844,704,0,0,770,341,2024,530,8213
"35005000400",2097,1056,0,0,771,246,1677,958,6805
"35005000500",739,510,20,60,195,285,564,669,3042
"35005000600",2600,1035,57,0,807,253,2853,1103,8708
"35005000700",2679,653,263,0,868,228,2172,612,7475
"35005000800",3132,1575,227,0,606,410,1583,1282,8815
"35005000900",2875,0,0,0,385,142,1543,142,5087
"35005001001",3668,133,0,0,678,47,1079,25,5630
"35005001002",2922,820,15,0,447,100,855,660,5819
"35005001101",3480,1589,23,42,710,444,3103,1472,10863
"35005001102",3372,294,0,0,117,64,539,172,4558
"35005001200",1090,184,0,0,49,34,415,147,1919
"35005001300",1819,285,0,1,415,181,1436,382,4519
"35005001400",1957,251,5,0,299,224,1321,410,4467
"35006941500",25,38,0,0,2189,987,3,35,3277
"35006945800",167,18,21,0,1086,746,72,45,2155
"35006946100",27,39,0,0,2584,1418,61,31,4160
"35006974201",2129,876,45,24,808,621,1728,889,7120
"35006974202",1565,261,0,8,1249,250,1176,307,4816
"35006974400",1925,497,0,0,559,529,1521,552,5583
"35006974700",3008,482,23,0,923,183,2046,258,6923
"35007950500",2820,485,0,21,376,304,1732,504,6242
"35007950600",2358,413,0,0,501,236,1544,402,5454
"35007950700",4115,735,5,5,527,104,1533,453,7477
"35009000100",1093,848,405,256,868,1024,1641,1548,7683
"35009000201",2629,266,256,44,837,109,1155,139,5435
"35009000202",2022,645,354,30,964,281,1531,682,6509
"35009000301",3861,587,213,90,945,560,1599,825,8680
"35009000303",2618,241,203,33,264,132,401,192,4084
"35009000304",5387,417,210,0,477,0,624,0,7115
"35009000400",1943,914,99,198,1060,275,2022,987,7498
"35009000500",1191,491,130,11,422,145,1049,487,3926
"35009000601",997,179,2,0,4,13,7,45,1247
"35009000602",3732,96,141,6,520,6,1372,22,5895
"35009000603",2366,518,150,17,754,291,1569,566,6231
"35009000900",1270,235,225,0,369,98,424,126,2747
"35011960100",1277,279,0,0,217,179,538,257,2747
"35013000102",3095,493,19,40,256,60,2324,448,6735
"35013000103",3063,1915,47,2,271,79,2199,1687,9263
"35013000104",3754,482,141,0,378,37,1843,205,6840
"35013000201",3192,1438,64,175,408,100,2371,1444,9192
"35013000202",4672,901,78,0,263,50,3077,806,9847
"35013000300",2786,912,19,9,270,102,1772,727,6597
"35013000401",1366,805,19,0,251,202,1260,876,4779
"35013000402",3577,1413,29,46,622,111,3173,1194,10165
"35013000500",1166,634,34,5,363,95,977,379,3653
"35013000600",1212,995,11,35,262,78,1087,896,4576
"35013000700",3736,1340,12,0,375,209,2933,1206,9811
"35013000800",1904,1441,11,142,101,81,1170,929,5779
"35013000900",2916,2872,49,146,420,292,1580,2043,10318
"35013001000",298,774,0,21,178,442,127,499,2339
"35013001102",2313,677,17,0,113,25,1345,467,4957
"35013001103",3367,774,13,0,316,38,1993,772,7273
"35013001104",2830,1816,0,50,201,219,2045,1627,8788
"35013001201",10855,1138,387,0,1222,16,4931,409,18958
"35013001203",3288,616,49,34,509,83,1672,536,6787
"35013001204",3420,374,0,0,132,0,729,278,4933
"35013001205",3625,433,9,23,599,63,1356,268,6376
"35013001303",6248,1342,59,10,643,90,3523,1239,13154
"35013001304",4996,788,70,62,1198,217,4104,841,12276
"35013001305",3275,1128,40,14,366,64,2445,655,7987
"35013001306",7192,1263,90,139,672,17,3718,674,13765
"35013001307",5459,1573,0,0,559,103,4136,1363,13193
"35013001400",2602,1867,0,0,37,22,1736,1679,7943
"35013001500",3866,858,171,0,574,143,1916,602,8130
"35013001600",1858,980,0,0,499,49,1702,966,6054
"35013001701",4614,1292,99,61,247,255,3475,1503,11546
"35013001702",1231,645,0,0,0,5,953,607,3441
"35013001703",2229,610,15,0,387,74,1803,637,5755
"35013001705",1728,1382,0,0,214,13,1872,1395,6604
"35013001706",1962,1274,0,0,282,17,2227,1291,7053
"35013001707",2791,2389,50,0,108,238,2909,2627,11112
"35013001801",3627,2691,23,0,300,32,3221,2538,12432
"35013001802",3942,2507,0,0,115,92,3709,2599,12964
"35013001804",4435,1546,43,27,188,141,3494,1444,11318
"35013001805",1884,1392,0,0,128,155,1970,1547,7076
"35013001806",2405,2475,41,0,432,95,2787,2475,10710
"35013001900",957,101,159,0,159,27,289,0,1692
"35015000100",1079,226,36,0,29,58,390,138,1956
"35015000200",4132,297,120,0,231,84,648,106,5618
"35015000300",4232,591,11,0,185,143,1165,228,6555
"35015000401",2909,323,31,0,548,4,1010,215,5040
"35015000402",3272,668,114,0,602,42,2292,469,7459
"35015000500",2502,291,162,0,357,127,1644,375,5458
"35015000600",3531,460,62,30,685,18,2810,316,7912
"35015000700",4695,297,0,0,772,190,2167,319,8440
"35015000800",1791,349,0,0,102,66,1286,293,3887
"35015000900",3695,557,0,0,614,0,2056,427,7349
"35015001000",4230,812,0,36,374,327,2328,743,8850
"35015001100",5057,572,0,0,792,125,1989,522,9057
"35017964100",2073,176,0,0,163,38,434,0,2884
"35017964200",1996,199,0,0,47,48,318,107,2715
"35017964300",4332,1079,42,31,1016,114,2790,388,9792
"35017964400",2121,917,10,0,795,416,1925,1123,7307
"35017964500",1372,298,0,3,353,325,1024,511,3886
"35017964600",1803,598,22,9,610,298,1821,830,5991
"35017964700",4185,935,0,0,577,58,1297,546,7598
"35017964800",1129,232,0,0,362,67,799,137,2726
"35019961600",2873,479,1,14,397,199,2670,534,7167
"35021000100",510,110,0,0,62,5,187,77,951
"35023970000",1281,607,0,0,184,68,473,218,2831
"35023970200",1926,342,9,0,175,131,1571,440,4594
"35025000100",1687,449,0,0,276,94,1393,378,4277
"35025000200",2101,578,27,58,437,120,1647,409,5377
"35025000300",2253,756,181,92,440,101,2261,801,6885
"35025000400",2056,410,242,279,356,298,1625,523,5789
"35025000502",4722,687,115,167,389,123,2468,467,9138
"35025000503",2979,379,148,12,157,148,1325,380,5528
"35025000504",2652,318,281,0,336,0,633,0,4220
"35025000600",5362,468,137,0,569,53,3045,437,10071
"35025000701",1452,247,0,0,27,0,412,212,2350
"35025000702",1781,187,0,0,4,12,808,134,2926
"35025000703",2005,7,40,0,173,2,517,6,2750
"35025000704",2449,244,0,0,206,2,1069,176,4146
"35025000800",2688,273,0,0,193,56,1299,225,4734
"35025000900",1858,160,15,0,91,34,756,114,3028
"35025001003",2459,568,0,0,417,169,1811,545,5969
"35025001004",2754,670,45,0,279,17,2088,604,6457
"35025001005",2173,999,112,0,388,0,1764,843,6279
"35025001100",4167,215,29,0,337,55,1851,90,6744
"35027960200",1101,250,0,0,114,75,300,218,2058
"35027960300",2089,269,34,7,262,47,626,89,3423
"35027960400",4846,858,0,0,873,364,1947,859,9747
"35027960600",4999,415,46,13,875,114,1027,230,7719
"35027960800",1547,463,0,0,419,82,560,243,3314
"35028000100",3229,136,0,0,357,25,431,50,4228
"35028000200",4513,62,11,0,497,126,896,0,6105
"35028000400",2565,161,16,0,454,12,426,143,3777
"35028000500",4773,262,39,0,617,2,727,23,6443
"35029000100",3252,991,57,54,383,221,2011,1004,7973
"35029000200",2572,1494,5,0,347,81,1813,1290,7602
"35029000300",1672,594,13,18,293,87,1195,611,4483
"35029000400",4175,1096,0,0,160,90,1933,1024,8478
"35029000500",2866,1620,40,0,153,38,1623,1166,7506
"35029000600",1307,660,0,67,48,212,1043,638,3975
"35031940300",8,28,0,0,5645,3936,237,56,9910
"35031940500",92,42,4,0,317,826,4,10,1295
"35031943500",134,16,34,13,2091,1216,71,43,3618
"35031943600",118,41,0,2,2682,2201,17,88,5149
"35031943700",35,11,0,0,2211,1537,19,0,3813
"35031943800",198,7,10,4,4039,2528,92,28,6906
"35031943901",559,26,38,0,2634,1796,330,38,5421
"35031943902",50,2,0,0,2452,1337,199,96,4136
"35031944000",60,4,0,0,1008,937,41,22,2072
"35031945200",1725,174,113,0,1974,2043,1748,203,7980
"35031945300",1263,322,9,0,653,929,1534,594,5304
"35031945400",1021,205,0,7,1288,118,728,201,3568
"35031945500",3072,370,45,0,1874,177,1296,316,7150
"35031945600",998,227,22,0,3417,1010,958,283,6915
"35031945700",169,3,0,0,1247,908,68,59,2454
"35031946000",380,25,0,0,2311,1817,160,28,4721
"35031973100",357,76,0,0,252,125,57,22,889
"35033955200",3035,680,5,2,807,259,3056,854,8698
"35035000100",568,375,71,72,178,198,508,397,2367
"35035000200",952,157,62,19,284,104,598,128,2304
"35035000303",1202,523,65,0,265,78,567,159,2859
"35035000304",2955,275,251,0,247,63,569,232,4592
"35035000305",1949,471,448,49,734,150,857,414,5072
"35035000306",2622,16,109,0,205,28,668,22,3670
"35035000401",4042,235,134,20,373,210,1210,199,6423
"35035000402",6027,389,163,8,690,232,1188,282,8979
"35035000500",2606,1378,20,266,259,523,891,1309,7252
"35035000601",1809,255,368,7,457,38,431,85,3450
"35035000602",2100,427,0,0,230,39,475,19,3290
"35035000603",2296,233,0,0,93,0,336,87,3045
"35035000700",4390,610,46,0,547,185,1718,459,7955
"35035000901",2592,315,0,0,160,24,231,42,3364
"35035000902",3226,3285,0,242,687,459,3128,3699,14726
"35035940000",113,153,0,0,2115,1472,244,267,4364
"35037958601",2180,443,94,0,91,48,979,187,4022
"35037958602",1575,843,0,31,325,126,1085,837,4822
"35037958900",2384,349,0,0,234,39,642,40,3688
"35039000100",2144,607,0,0,649,66,2471,434,6371
"35039000200",2104,736,0,22,154,157,1681,702,5556
"35039000300",4759,1203,0,0,790,5,5091,1174,13022
"35039000400",3073,781,1,22,379,80,2379,835,7550
"35039000500",2849,483,16,0,145,62,1930,344,5829
"35039940700",1312,455,73,0,1022,536,2056,924,6378
"35039940800",2058,166,13,4,1984,617,2554,393,7789
"35039941000",272,89,0,1,2385,704,287,48,3786
"35039944100",3526,981,8,0,1691,649,3915,1231,12001
"35041000100",2572,917,33,117,608,431,769,639,6086
"35041000200",1451,661,0,190,1207,597,1988,1019,7113
"35041000300",2184,532,0,49,437,97,790,169,4258
"35041000401",2325,438,0,41,364,95,671,411,4345
"35041000402",2305,513,12,0,628,137,799,319,4713
"35043010503",1326,663,39,11,1173,120,1859,579,5770
"35043010601",3638,257,1,0,413,55,1139,150,5653
"35043010602",3391,121,17,0,467,30,1142,80,5248
"35043010702",5256,355,100,0,621,0,1650,189,8171
"35043010703",6613,776,131,0,1207,322,2904,538,12491
"35043010705",4223,773,15,16,822,239,2120,439,8647
"35043010712",3551,842,137,78,723,118,1851,550,7850
"35043010713",3213,882,33,20,538,62,1535,468,6751
"35043010714",3593,535,311,47,366,80,1366,336,6634
"35043010715",3051,293,152,13,264,8,1165,111,5057
"35043010716",4693,397,328,36,311,24,937,237,6963
"35043010717",7579,151,123,9,1779,184,3798,48,13671
"35043010718",3637,553,46,18,540,0,1561,346,6701
"35043010719",3090,471,147,0,243,32,1325,183,5491
"35043010720",5606,214,322,0,870,107,2696,136,9951
"35043010721",2709,766,261,7,674,87,1331,459,6294
"35043010722",2739,553,141,0,1150,170,2072,519,7344
"35043010723",6603,870,1031,0,1117,172,3630,597,14020
"35043010900",926,320,16,0,517,109,836,241,2965
"35043011000",676,162,18,0,693,167,372,162,2250
"35043011100",5289,500,35,0,1301,285,1083,169,8662
"35043011200",1404,116,0,0,975,297,447,24,3263
"35043940200",146,33,0,0,2145,1145,156,38,3663
"35043940300",0,0,0,0,0,0,0,0,0
"35043940500",1680,459,27,4,1523,701,2583,917,7894
"35043940600",12,24,1,2,1477,357,3,14,1890
"35043940700",403,109,0,0,2582,1187,382,108,4771
"35043940900",36,8,0,0,937,1290,14,19,2304
"35045000100",1892,721,0,0,2099,652,1613,646,7623
"35045000201",3633,85,0,26,454,151,640,185,5174
"35045000202",4212,93,101,0,596,36,1112,32,6182
"35045000204",1558,287,7,0,702,39,595,245,3433
"35045000205",2872,1131,0,0,1451,1119,1428,786,8787
"35045000301",2710,375,73,0,856,530,467,235,5246
"35045000302",2446,242,0,0,452,129,451,58,3778
"35045000401",3307,532,11,0,889,592,687,170,6188
"35045000402",1031,300,20,10,1171,341,400,100,3373
"35045000503",807,456,32,9,2103,290,771,465,4933
"35045000504",1073,360,0,0,482,109,105,34,2163
"35045000505",2203,778,50,0,2525,562,903,96,7117
"35045000607",1478,81,0,0,1028,219,799,53,3658
"35045000608",4154,300,18,0,1270,81,653,42,6518
"35045000609",1105,118,4,0,57,98,126,138,1646
"35045000610",2444,541,0,0,737,185,768,198,4873
"35045000611",2481,660,11,0,456,92,182,242,4124
"35045000612",1304,321,0,0,206,78,417,119,2445
"35045000613",2947,186,0,0,538,225,888,42,4826
"35045000702",555,133,0,0,161,9,148,39,1045
"35045000705",1857,478,6,0,607,494,821,258,4521
"35045000706",2170,325,0,0,452,121,1350,312,4730
"35045000707",2254,334,85,375,890,365,985,245,5533
"35045000708",1756,1004,0,5,2078,106,809,697,6455
"35045000900",1428,124,5,0,595,0,667,10,2829
"35045942801",28,3,8,2,2217,1062,45,0,3365
"35045942802",309,32,0,0,4114,2199,3,138,6795
"35045942803",11,11,5,0,1330,1458,15,0,2830
"35045942900",51,4,0,2,2976,1975,31,13,5052
"35045943000",59,13,0,0,3119,1585,97,46,4919
"35045943100",25,9,0,0,1257,714,27,3,2035
"35045943201",1065,35,0,3,2329,1693,276,28,5429
"35045943300",2267,513,0,0,303,25,421,66,3595
"35047957200",2202,779,28,87,868,512,2659,1063,8198
"35047957300",1481,716,17,48,439,445,1322,823,5291
"35047957400",1719,941,7,16,686,247,2031,898,6545
"35047957500",2471,784,0,0,691,78,2108,660,6792
"35047957600",3341,781,92,0,1005,476,3374,1041,10110
"35047957700",952,364,0,0,647,451,1183,703,4300
"35047957800",2018,993,43,3,798,397,2384,1339,7975
"35049000101",3549,298,67,0,271,55,574,84,4898
"35049000200",3297,293,0,0,228,50,1099,132,5099
"35049000300",987,160,7,0,124,5,365,56,1704
"35049000400",278,28,4,0,6,0,47,19,382
"35049000500",1568,151,16,0,185,18,285,50,2273
"35049000600",1690,184,0,0,151,67,372,150,2614
"35049000700",1490,139,10,0,294,80,776,42,2831
"35049000800",1710,962,0,0,287,110,912,759,4740
"35049000900",2219,464,0,0,453,33,1557,355,5081
"35049001001",1622,204,0,5,96,50,494,206,2677
"35049001002",1929,1183,8,0,324,107,1466,1093,6110
"35049001102",2318,352,58,2,183,192,891,233,4229
"35049001103",1144,276,8,11,196,35,862,220,2752
"35049001105",1899,223,10,0,220,2,1017,106,3477
"35049001106",1678,675,0,0,333,42,1257,598,4583
"35049001107",3041,561,17,0,693,68,1975,465,6820
"35049001202",2421,1689,44,53,581,724,1939,2132,9583
"35049001203",1948,328,10,0,327,85,1659,309,4666
"35049001204",3027,942,51,0,577,549,2987,1353,9486
"35049001205",3417,1082,23,0,934,156,3830,1165,10607
"35049001301",1262,97,4,0,420,0,1041,90,2914
"35049001302",1486,986,16,0,396,124,1535,1074,5617
"35049001303",4283,1403,160,31,1067,112,3575,1329,11960
"35049001304",625,51,0,0,184,14,685,57,1616
"35049010102",2565,1545,0,0,427,160,2399,1609,8705
"35049010203",942,100,0,0,53,29,241,43,1408
"35049010204",1855,65,0,0,144,0,340,0,2404
"35049010304",2429,420,8,0,373,10,1287,324,4851
"35049010308",1438,331,34,0,366,89,1224,364,3846
"35049010309",1781,120,0,0,57,14,213,20,2205
"35049010310",936,39,0,0,8,0,172,9,1164
"35049010311",3836,85,105,0,324,47,617,35,5049
"35049010312",3457,526,0,0,353,20,972,210,5538
"35049010314",1203,239,14,0,305,0,594,84,2439
"35049010315",2318,209,4,0,442,1,1296,1,4271
"35049010316",1275,48,3,0,135,2,473,7,1943
"35049010400",2347,298,0,0,200,113,382,48,3388
"35049010500",1391,149,0,0,66,4,441,73,2124
"35049010601",3715,290,7,73,429,4,2240,298,7056
"35049010602",2482,214,17,0,124,0,282,0,3119
"35049010603",2103,45,0,0,398,0,1313,27,3886
"35049010700",4886,588,0,0,242,0,638,235,6589
"35049010800",2335,204,0,0,148,76,1112,179,4054
"35049010900",1572,394,11,0,300,18,908,340,3543
"35049940300",1113,99,0,7,690,166,1088,121,3284
"35049940400",793,105,0,0,342,115,408,163,1926
"35049940500",916,100,4,0,780,125,902,117,2944
"35049940600",2342,428,16,3,817,146,2126,433,6311
"35049940900",1752,579,11,3,411,293,1825,736,5610
"35049980000",129,0,0,0,7,0,120,0,256
"35051962200",2348,816,0,0,133,64,814,253,4428
"35051962300",2034,942,64,0,154,116,574,299,4183
"35051962401",1616,326,0,0,130,20,133,303,2528
"35051962402",2389,163,0,0,123,171,714,201,3761
"35053940000",31,0,0,0,452,539,0,0,1022
"35053978100",3648,1063,17,10,645,63,2131,809,8386
"35053978200",1082,65,0,0,280,36,526,8,1997
"35053978301",1993,369,7,0,145,264,821,566,4165
"35053978302",1793,802,0,0,124,202,908,562,4391
"35053978303",2227,788,22,30,432,86,1653,528,5766
"35055940000",722,185,0,0,705,187,1241,298,3338
"35055940100",3710,1013,30,0,3136,655,3164,1028,12736
"35055952100",3209,753,0,0,1160,996,1801,1280,9199
"35055952300",1231,219,0,34,838,543,1470,622,4957
"35055952600",3948,1304,74,0,1116,646,2732,1032,10852
"35055952700",2411,1013,27,0,2064,700,2541,1078,9834
"35057963201",2586,1003,81,53,151,227,431,321,4853
"35057963202",2296,549,0,26,207,162,1024,264,4528
"35057963600",3848,1549,15,0,202,40,1391,860,7905
"35057963700",1315,487,0,0,134,239,807,473,3455
"35059950200",2797,421,39,0,676,54,1251,250,5488
"35061940300",6,6,0,0,684,188,91,0,975
"35061970101",1322,781,163,0,1534,1909,1951,2330,9990
"35061970102",3738,792,30,0,1227,961,2378,1217,10343
"35061970200",2974,168,0,0,610,153,1126,181,5212
"35061970301",3095,1425,0,0,1830,804,3650,1870,12674
"35061970302",1558,207,12,0,893,90,1446,249,4455
"35061970303",3535,794,0,0,1402,432,2754,863,9780
"35061970401",2696,1015,37,0,916,231,2183,905,7983
"35061970404",3472,578,70,42,788,393,2608,667,8618
"35061970405",1391,195,69,0,813,1,956,36,3461
"35061970700",2749,568,14,168,965,276,1987,448,7175
"35061970800",2501,1143,12,0,640,650,2026,1266,8238
"35061970901",2542,629,0,3,498,618,1809,1161,7260
"35061970902",1380,268,22,0,424,198,1017,385,3694
"35061971000",3590,365,42,50,960,229,1991,329,7556
"35061971100",912,151,23,0,296,196,538,241,2357
"35061971300",1162,447,0,0,524,123,960,216,3432
"35061971400",2038,164,0,0,591,117,1585,140,4635
"36001000100",294,259,1057,306,157,46,206,211,2536
"36001000200",433,162,2479,1825,15,364,473,218,5969
"36001000300",1819,519,1433,1194,832,68,755,233,6853
"36001000401",1480,101,149,10,88,0,39,0,1867
"36001000403",2719,174,537,320,263,325,145,68,4551
"36001000404",0,0,3,0,0,0,0,0,3
"36001000501",1604,523,503,247,409,233,593,128,4240
"36001000502",1029,261,71,14,135,179,48,17,1754
"36001000600",748,1125,1274,535,192,473,377,245,4969
"36001000700",273,138,2009,1047,101,176,172,292,4208
"36001000800",235,147,691,770,69,262,130,83,2387
"36001001100",389,299,114,241,196,10,68,17,1334
"36001001400",2433,339,141,45,131,83,89,33,3294
"36001001500",1885,1255,564,159,399,176,272,104,4814
"36001001600",1988,838,269,98,324,57,66,25,3665
"36001001700",2981,338,726,73,438,124,214,96,4990
"36001001801",5504,414,552,15,460,208,218,0,7371
"36001001802",3032,296,202,68,460,110,173,41,4382
"36001001901",1925,327,154,20,188,40,76,40,2770
"36001001902",1940,50,513,0,116,0,109,0,2728
"36001002000",2702,699,1408,314,531,460,317,202,6633
"36001002100",495,258,703,234,307,141,110,139,2387
"36001002200",1195,234,629,96,272,31,135,70,2662
"36001002300",512,156,594,254,52,204,128,52,1952
"36001002500",210,156,1287,584,119,58,61,52,2527
"36001002600",1040,315,2607,428,638,229,128,185,5570
"36001012700",1986,130,23,0,12,0,36,0,2187
"36001012800",2234,686,49,69,251,248,282,236,4055
"36001012900",2218,499,137,98,119,70,77,46,3264
"36001013000",6198,427,146,0,147,35,79,2,7034
"36001013100",1950,288,94,0,131,123,72,0,2658
"36001013200",2630,698,77,106,53,54,18,18,3654
"36001013300",3371,423,427,25,89,54,230,0,4619
"36001013400",1713,145,239,0,13,67,213,0,2390
"36001013503",3406,258,200,85,467,106,181,24,4727
"36001013505",2166,243,63,0,16,45,29,0,2562
"36001013506",4444,248,680,51,559,452,471,73,6978
"36001013507",1948,285,100,0,424,22,129,71,2979
"36001013508",5637,70,170,0,613,124,207,0,6821
"36001013601",5610,404,291,0,1107,91,259,0,7762
"36001013602",2524,319,634,32,630,53,319,9,4520
"36001013703",1326,170,12,0,117,3,10,0,1638
"36001013705",5457,426,107,0,202,0,63,0,6255
"36001013706",2007,65,0,0,176,0,37,0,2285
"36001013707",4821,228,275,0,448,14,291,0,6077
"36001013801",5854,471,569,0,265,0,191,30,7380
"36001013802",3851,79,52,0,245,0,0,14,4241
"36001013901",2026,141,41,12,213,70,47,69,2619
"36001013902",4609,132,156,0,443,2,190,0,5532
"36001014001",3133,216,199,0,305,96,28,9,3986
"36001014002",3787,391,246,15,287,6,219,37,4988
"36001014100",4874,95,70,0,442,0,197,2,5680
"36001014201",4569,192,149,16,792,82,152,0,5952
"36001014202",5185,114,118,0,415,81,116,0,6029
"36001014203",5148,145,33,18,363,2,129,2,5840
"36001014301",2334,356,37,54,28,0,38,0,2847
"36001014302",7190,168,105,0,542,14,153,0,8172
"36001014401",3599,364,89,0,31,28,111,28,4250
"36001014402",2636,245,257,0,90,11,126,14,3379
"36001014501",2020,142,0,0,71,9,60,27,2329
"36001014502",3073,288,0,0,114,183,44,0,3702
"36001014503",2465,94,0,19,218,0,110,34,2940
"36001014606",3293,94,64,0,126,6,34,0,3617
"36001014607",7347,340,67,0,307,0,185,147,8393
"36001014608",2284,172,74,0,146,64,42,0,2782
"36001014609",3695,195,215,129,410,91,186,15,4936
"36001014611",1638,46,32,2,150,11,22,1,1902
"36001014612",1428,56,0,0,25,8,53,5,1575
"36001014613",2810,110,19,6,12,0,19,0,2976
"36001014614",4177,201,87,198,762,47,155,0,5627
"36001014615",1680,76,74,38,550,48,228,1,2695
"36001014700",2402,138,5,0,75,9,47,21,2697
"36001014801",2510,127,89,0,35,33,0,0,2794
"36001014802",1481,371,0,0,31,0,0,0,1883
"36001014803",3084,198,17,0,70,0,6,0,3375
"36003940200",0,0,0,0,9,0,0,0,9
"36003950100",2324,228,0,0,71,6,33,3,2665
"36003950300",2991,624,19,2,43,33,10,0,3722
"36003950400",3145,411,10,8,34,5,13,32,3658
"36003950500",3076,397,0,6,61,7,47,11,3605
"36003950600",2838,792,1,1,61,6,30,6,3735
"36003950700",2942,600,0,0,27,8,18,20,3615
"36003950800",2182,614,1,7,128,9,28,5,2974
"36003950900",3147,630,2,10,42,0,58,6,3895
"36003951000",2594,609,22,55,27,3,11,35,3356
"36003951100",3064,722,10,0,65,0,21,42,3924
"36003951200",3993,719,0,9,40,14,32,1,4808
"36003951300",3312,634,0,0,69,0,34,0,4049
"36005000100",0,0,0,0,0,0,0,0,0
"36005000200",1109,242,1304,199,1537,441,2486,726,8044
"36005000400",1194,131,1440,128,2184,253,3158,323,8811
"36005001600",1214,257,1353,232,1489,427,2927,670,8569
"36005001900",625,370,345,261,464,443,779,782,4069
"36005002000",777,833,2036,1250,1795,1720,2629,2691,13731
"36005002300",813,542,962,1061,506,757,1368,1784,7793
"36005002400",0,0,0,0,0,0,0,0,0
"36005002500",930,878,407,697,886,1297,1957,2104,9156
"36005002701",660,267,753,729,326,437,1007,1043,5222
"36005002702",527,751,888,818,731,807,1294,1685,7501
"36005002800",262,14,3740,309,1413,63,1720,89,7610
"36005003100",192,95,540,48,202,195,422,269,1963
"36005003300",852,373,587,1025,462,669,1623,1212,6803
"36005003500",411,103,573,648,1332,698,1841,826,6432
"36005003700",68,0,39,15,65,55,120,55,417
"36005003800",139,52,247,271,340,242,450,250,1991
"36005003900",1551,742,1028,415,1558,711,3213,1546,10764
"36005004001",238,60,290,0,583,299,386,151,2007
"36005004100",1084,729,902,1296,1262,837,2718,1911,10739
"36005004200",593,1021,2197,1442,1782,394,2367,1617,11413
"36005004300",791,369,889,1046,1175,1026,2162,1946,9404
"36005004400",223,375,1380,580,1039,954,1239,1410,7200
"36005004600",230,134,474,118,538,111,799,231,2635
"36005004800",499,114,632,280,1169,1188,1734,1194,6810
"36005005001",403,30,1306,772,1324,889,1833,1398,7955
"36005005002",668,317,628,524,2252,1222,2707,1539,9857
"36005005100",447,415,1433,967,1672,916,2330,1480,9660
"36005005200",161,152,310,455,582,325,673,498,3156
"36005005300",90,70,1048,653,238,869,272,1052,4292
"36005005400",822,208,960,398,2152,1440,2874,1565,10419
"36005005600",288,98,453,171,961,412,1229,475,4087
"36005005902",298,258,728,168,993,362,1273,769,4849
"36005006000",112,30,87,173,656,194,700,350,2302
"36005006100",150,32,2719,358,402,113,432,145,4351
"36005006200",450,192,1785,1396,2152,1689,2818,2191,12673
"36005006300",904,481,1108,284,1408,823,2052,1199,8259
"36005006400",339,164,1234,338,1288,654,1722,587,6326
"36005006500",616,311,885,1195,1470,1190,1723,1577,8967
"36005006700",899,449,1466,1143,1870,1694,2861,2731,13113
"36005006800",255,20,1035,254,1069,331,1182,322,4468
"36005006900",554,541,2004,1196,1284,1701,2137,2372,11789
"36005007000",402,367,1254,142,1433,1152,1706,1326,7782
"36005007100",333,50,691,330,531,283,1043,337,3598
"36005007200",873,235,706,435,2256,1457,2211,876,9049
"36005007300",374,360,855,406,1010,583,1481,806,5875
"36005007400",637,215,1175,193,1224,419,1862,616,6341
"36005007500",421,306,1109,513,1615,656,2152,916,7688
"36005007600",439,521,1310,633,1876,903,2057,1504,9243
"36005007700",213,129,294,133,673,410,879,525,3256
"36005007800",594,708,970,152,3102,1267,3259,1617,11669
"36005007900",1131,384,1038,876,1520,1131,2771,1821,10672
"36005008300",525,268,1001,1099,1780,1071,2626,1625,9995
"36005008400",312,32,674,149,1098,176,1323,197,3961
"36005008500",437,331,646,481,2477,1357,3046,1673,10448
"36005008600",630,306,428,429,1068,697,1669,1038,6265
"36005008700",500,242,1118,273,2571,1372,3084,1567,10727
"36005008900",487,184,291,443,1036,986,1664,1159,6250
"36005009000",926,445,629,509,975,574,1803,1102,6963
"36005009200",522,164,694,212,2308,1309,2255,1095,8559
"36005009300",1115,566,1194,294,1441,950,2910,1598,10068
"36005009600",267,92,354,96,1218,315,1183,160,3685
"36005009800",931,482,1338,209,1502,428,2367,917,8174
"36005011000",0,0,0,0,132,8,132,8,280
"36005011502",731,784,759,805,588,735,1508,1637,7547
"36005011700",380,208,283,282,209,179,632,460,2633
"36005011800",3231,247,17,13,345,250,542,250,4895
"36005011900",332,287,1333,534,1883,1348,2270,1696,9683
"36005012101",289,86,735,301,752,966,1158,1071,5358
"36005012102",126,136,140,161,534,439,663,594,2793
"36005012300",145,153,796,440,1054,1188,1252,1313,6341
"36005012500",301,110,800,504,1097,1204,1421,1198,6635
"36005012701",457,152,330,188,657,482,976,677,3919
"36005012901",233,199,964,597,670,964,988,1178,5793
"36005013000",823,0,20,22,206,18,417,22,1528
"36005013100",382,150,1456,463,1619,984,2107,1075,8236
"36005013200",3283,197,829,111,2549,429,3376,535,11309
"36005013300",132,110,1997,772,2630,838,2968,1135,10582
"36005013500",107,58,756,702,926,963,902,1080,5494
"36005013800",2234,143,92,0,439,131,867,127,4033
"36005014100",691,192,1370,108,798,547,1606,742,6054
"36005014300",77,28,115,208,157,172,200,153,1110
"36005014400",840,447,1022,1257,1355,732,2004,1439,9096
"36005014500",275,267,1153,1385,1520,1330,1683,1596,9209
"36005014701",327,274,1580,2427,1237,892,1645,1078,9460
"36005014702",162,204,1130,1192,1120,1238,1479,1440,7965
"36005014900",171,171,1103,511,1016,1037,1301,1205,6515
"36005015100",315,376,2092,572,1733,851,2298,1250,9487
"36005015200",1043,172,325,114,922,160,1260,191,4187
"36005015300",281,368,1175,701,572,918,835,1299,6149
"36005015500",356,108,596,75,1354,805,1734,951,5979
"36005015700",200,67,1072,189,701,1057,862,1084,5232
"36005015800",721,44,52,74,200,167,371,95,1724
"36005015900",125,182,27,80,1023,757,1153,981,4328
"36005016000",3567,89,23,0,706,0,762,0,5147
"36005016100",339,287,671,257,1425,1373,1834,1609,7795
"36005016200",926,148,96,31,283,92,493,143,2212
"36005016300",0,0,16,31,16,16,16,16,111
"36005016400",802,15,25,48,116,1,334,6,1347
"36005016500",51,9,392,214,237,179,393,281,1756
"36005016600",1147,144,150,9,753,46,835,82,3166
"36005016700",66,71,861,353,584,232,664,272,3103
"36005016900",17,59,555,395,303,172,380,245,2126
"36005017100",0,0,1,0,0,1,0,1,3
"36005017300",867,337,1330,710,1972,1133,2747,1076,10172
"36005017500",393,126,1776,1151,1350,1507,1840,1926,10069
"36005017701",70,91,706,99,1245,1312,1295,1364,6182
"36005017702",95,396,1107,645,1028,1366,1184,1901,7722
"36005017901",313,143,940,765,1574,1079,2238,1323,8375
"36005017902",266,304,918,345,1322,467,1559,678,5859
"36005018101",275,142,1055,607,655,383,934,561,4612
"36005018102",511,94,1715,781,1425,946,1686,1022,8180
"36005018301",355,390,2024,312,627,735,1313,1044,6800
"36005018302",330,365,1084,229,1639,529,1903,897,6976
"36005018400",2275,253,167,0,874,189,1098,224,5080
"36005018500",258,342,1921,908,1789,1556,2162,1797,10733
"36005018900",935,571,1215,851,2529,1687,3358,2539,13685
"36005019300",285,653,907,1224,1411,729,1738,1636,8583
"36005019400",536,116,225,178,928,165,831,257,3236
"36005019500",564,461,2307,745,2740,729,3477,1316,12339
"36005019700",677,351,1285,782,2586,1845,2700,2072,12298
"36005019900",379,396,2420,426,2013,1698,2281,2072,11685
"36005020000",672,302,196,29,2362,886,1618,753,6818
"36005020100",475,143,983,410,1060,1073,1567,1273,6984
"36005020200",202,90,418,10,1300,246,911,197,3374
"36005020400",561,112,347,12,1650,458,1747,336,5223
"36005020501",271,280,2069,788,2554,1101,3099,1593,11755
"36005020502",318,222,391,297,499,405,747,454,3333
"36005020601",354,69,657,200,1455,349,1083,275,4442
"36005020900",277,221,758,505,1765,853,1971,1154,7504
"36005021001",617,201,5093,412,2136,777,2204,803,12243
"36005021002",503,136,2967,588,1696,410,1104,365,7769
"36005021100",470,296,1445,1223,1035,995,1538,1454,8456
"36005021200",589,26,1997,209,2314,321,1805,40,7301
"36005021301",22,97,89,113,527,504,555,608,2515
"36005021302",423,299,1653,1039,1623,634,2088,1251,9010
"36005021501",331,205,620,285,1532,866,1768,1095,6702
"36005021502",379,221,1270,567,1786,1601,2197,1692,9713
"36005021601",526,544,442,488,1164,968,1497,1159,6788
"36005021602",762,56,2269,427,2052,694,1746,366,8372
"36005021700",215,278,1093,1224,1037,1143,1356,1332,7678
"36005021800",585,38,1224,463,2503,1056,2585,1026,9480
"36005021900",120,42,128,81,691,269,847,335,2513
"36005022000",137,69,99,328,279,589,408,660,2569
"36005022101",454,225,684,238,1357,879,1673,1112,6622
"36005022102",385,695,564,304,1354,1664,1676,2560,9202
"36005022200",549,61,576,132,1241,607,1351,468,4985
"36005022300",829,262,1334,253,2209,904,3261,1132,10184
"36005022401",518,254,459,44,1172,165,1248,263,4123
"36005022403",1078,201,423,7,891,696,1232,753,5281
"36005022404",900,657,680,26,1406,388,1480,277,5814
"36005022500",1220,263,1467,1003,2785,978,3850,1344,12910
"36005022701",410,172,1401,660,2046,1096,2641,1331,9757
"36005022702",175,113,475,104,712,99,818,183,2679
"36005022703",286,25,352,172,751,226,692,213,2717
"36005022800",1371,271,855,45,2963,853,2376,938,9672
"36005022901",299,167,1004,518,1948,891,1898,1327,8052
"36005022902",306,219,793,348,627,972,904,1361,5530
"36005023000",1048,167,237,49,1372,468,1653,543,5537
"36005023100",96,139,399,334,218,206,368,395,2155
"36005023200",606,176,203,30,1301,408,1273,445,4442
"36005023301",133,142,1080,349,1824,1002,2083,1115,7728
"36005023302",256,384,296,361,932,889,1219,1318,5655
"36005023501",122,191,419,244,1732,779,1841,921,6249
"36005023502",666,259,574,494,1729,947,2269,1308,8246
"36005023600",380,138,290,41,854,598,887,610,3798
"36005023702",17,73,155,96,518,424,572,463,2318
"36005023703",353,194,681,303,1901,1511,2147,1650,8740
"36005023704",337,254,566,597,907,942,1264,1422,6289
"36005023800",543,90,327,74,827,689,1004,717,4271
"36005023900",394,382,909,1086,3148,2205,3265,2610,13999
"36005024000",759,60,490,107,1752,634,2125,635,6562
"36005024100",301,314,1084,702,1875,1900,2290,2160,10626
"36005024300",422,293,1044,555,1701,1653,2192,1823,9683
"36005024400",1157,79,70,47,980,200,1182,221,3936
"36005024501",434,269,1376,432,1516,1097,2087,1603,8814
"36005024502",261,332,516,593,1120,1046,1398,1475,6741
"36005024600",1061,61,112,0,1019,12,808,10,3083
"36005024700",132,149,914,155,241,294,451,384,2720
"36005024800",1842,206,118,0,996,89,838,37,4126
"36005024900",0,0,0,0,0,0,0,0,0
"36005025000",1745,113,0,0,665,115,454,160,3252
"36005025100",366,626,1480,482,2656,1240,2820,1794,11464
"36005025200",1270,119,129,48,742,245,606,256,3415
"36005025300",376,112,960,242,2656,1297,2783,1298,9724
"36005025400",1198,190,0,24,370,95,366,95,2338
"36005025500",232,68,956,484,1944,2163,2145,2276,10268
"36005025600",648,29,122,133,678,91,812,91,2604
"36005025700",63,66,503,96,617,537,690,619,3191
"36005026100",151,15,981,68,669,158,633,173,2848
"36005026300",519,124,813,369,2379,1716,2834,1704,10458
"36005026400",3106,297,281,16,1566,559,1641,589,8055
"36005026500",326,292,893,248,3686,1132,3242,1327,11146
"36005026601",1491,200,57,10,933,269,1058,269,4287
"36005026602",2825,521,226,66,1427,307,2231,395,7998
"36005026701",440,124,126,118,1828,870,1836,857,6199
"36005026702",784,190,663,257,2524,1538,3167,1573,10696
"36005026900",263,137,390,121,1586,579,1741,627,5444
"36005027300",1189,150,1345,433,3966,1389,4953,1525,14950
"36005027401",4058,220,0,0,233,288,393,318,5510
"36005027402",2602,189,163,3,417,17,659,43,4093
"36005027600",24,0,37,0,56,0,0,0,117
"36005027700",715,471,748,599,1879,1309,2229,1759,9709
"36005027900",2105,201,892,192,3165,337,3695,449,11036
"36005028100",1941,248,538,84,916,55,1290,110,5182
"36005028300",360,11,710,48,1768,230,2101,245,5473
"36005028400",33,26,15,26,44,12,44,18,218
"36005028500",1687,358,120,0,553,250,629,247,3844
"36005028600",617,113,13,0,143,134,134,125,1279
"36005028700",906,405,309,62,1367,267,1582,284,5182
"36005028800",2604,118,144,1,546,18,222,3,3656
"36005028900",1400,220,151,126,1776,250,2167,293,6383
"36005029301",1374,111,41,0,146,63,171,24,1930
"36005029302",3922,25,246,0,634,0,864,11,5702
"36005029500",2337,124,554,24,1404,18,1160,22,5643
"36005029600",615,91,307,130,463,108,373,87,2174
"36005029700",2580,142,69,12,748,0,408,0,3959
"36005030000",2210,532,97,24,2618,252,2276,274,8283
"36005030100",664,179,40,1,120,11,175,50,1240
"36005030200",828,108,6471,396,1445,424,1647,385,11704
"36005030701",4290,156,272,0,499,125,538,112,5992
"36005030900",2212,81,225,8,218,0,288,1,3033
"36005031000",1874,16,460,0,1439,134,1160,1,5084
"36005031200",1134,98,294,1,549,8,464,44,2592
"36005031400",1286,49,169,0,427,65,498,16,2510
"36005031600",906,39,277,72,607,107,607,38,2653
"36005031800",1507,61,104,4,507,242,550,195,3170
"36005031900",0,48,0,4,0,0,0,0,52
"36005032300",3288,160,383,51,554,58,914,115,5523
"36005032400",703,144,623,69,934,251,1386,405,4515
"36005032600",1859,51,364,9,984,86,1009,83,4445
"36005032800",931,343,702,196,1231,624,1109,775,5911
"36005033000",1894,318,773,635,1466,709,2004,1071,8870
"36005033201",1049,199,708,126,1536,318,1953,448,6337
"36005033202",555,172,733,219,1303,361,1088,459,4890
"36005033400",250,33,293,107,453,97,609,151,1993
"36005033500",1161,64,56,13,362,20,263,27,1966
"36005033600",747,168,2201,625,1726,971,2287,1179,9904
"36005033700",1960,57,81,7,333,39,233,10,2720
"36005033800",167,197,1840,311,839,449,851,547,5201
"36005034000",378,271,1587,194,1060,497,1245,510,5742
"36005034200",263,210,770,126,620,74,614,34,2711
"36005034300",728,40,49,18,330,190,345,170,1870
"36005034400",384,6,1017,43,487,164,365,158,2624
"36005034500",1687,236,302,72,1077,78,704,24,4180
"36005034800",256,80,3231,851,1353,1086,1527,1147,9531
"36005035000",194,14,1052,237,193,141,329,63,2223
"36005035100",1081,186,272,8,490,86,434,191,2748
"36005035600",173,17,1828,61,370,67,360,87,2963
"36005035800",203,11,5892,527,1191,113,1119,123,9179
"36005035900",114,82,352,181,603,571,715,619,3237
"36005036000",725,40,1176,134,894,35,813,79,3896
"36005036100",295,130,775,670,2057,2054,2328,2387,10696
"36005036300",598,442,496,1081,3480,1683,3829,2235,13844
"36005036400",13,0,1828,290,73,0,95,0,2299
"36005036501",217,168,1410,740,438,778,774,917,5442
"36005036502",65,80,359,327,589,680,615,816,3531
"36005036700",192,186,240,295,527,838,785,1010,4073
"36005036800",18,11,1356,227,375,112,437,113,2649
"36005036901",66,176,279,529,690,523,838,1014,4115
"36005036902",17,35,791,319,541,579,757,530,3569
"36005037000",131,42,1488,42,666,69,598,76,3112
"36005037100",409,232,1222,463,719,503,1314,717,5579
"36005037200",257,7,1174,196,487,243,578,223,3165
"36005037300",653,186,1267,294,1382,1384,2037,1542,8745
"36005037400",141,161,1470,479,635,625,795,678,4984
"36005037504",466,658,640,669,843,525,1151,1133,6085
"36005037600",184,0,1228,182,894,129,687,129,3433
"36005037800",339,108,1952,177,419,245,706,288,4234
"36005037900",381,277,1222,1251,1121,877,1622,1135,7886
"36005038000",265,12,2373,1082,231,332,202,285,4782
"36005038100",613,393,1528,407,1482,1480,2287,1999,10189
"36005038200",30,49,1726,244,452,213,468,270,3452
"36005038301",250,429,993,252,1567,1292,2079,1747,8609
"36005038302",116,240,1308,1261,1084,1158,1343,1504,8014
"36005038500",451,526,826,708,1063,1221,1601,1662,8058
"36005038600",177,114,5764,689,935,617,793,690,9779
"36005038700",562,348,583,176,547,725,752,895,4588
"36005038800",67,12,2158,530,165,49,252,162,3395
"36005038900",860,710,426,398,1446,1113,1804,1198,7955
"36005039000",78,71,2000,641,264,159,179,209,3601
"36005039100",1456,569,557,400,1891,1962,2520,2154,11509
"36005039200",131,23,791,504,208,30,276,18,1981
"36005039300",381,392,1218,1353,2215,2025,2639,2403,12626
"36005039400",297,42,2306,638,663,387,894,446,5673
"36005039500",212,156,1165,361,1165,639,1855,919,6472
"36005039600",151,13,1837,931,344,637,374,614,4901
"36005039700",171,122,164,41,251,356,316,281,1702
"36005039800",22,0,2035,341,180,12,167,0,2757
"36005039901",158,263,633,377,2481,1257,2315,1399,8883
"36005039902",395,290,496,350,1960,1277,2187,1526,8481
"36005040100",394,460,481,202,2623,1027,2839,1516,9542
"36005040302",400,232,363,449,1425,816,1904,927,6516
"36005040303",530,158,657,313,1645,868,2035,1027,7233
"36005040304",467,255,236,85,1929,816,2132,1057,6977
"36005040400",0,51,2114,304,286,42,271,42,3110
"36005040501",228,113,1048,189,1431,1179,1436,1277,6901
"36005040502",128,311,1104,657,2030,1395,1889,1662,9176
"36005040600",51,23,2314,470,104,135,179,149,3425
"36005040701",331,158,631,100,1224,698,1354,760,5256
"36005040702",1273,285,1171,282,3042,980,3266,1191,11490
"36005040800",423,163,1829,749,638,328,780,393,5303
"36005040900",547,58,2402,226,363,42,358,66,4062
"36005041100",476,161,598,63,941,823,1090,903,5055
"36005041300",1193,502,628,161,2977,1519,3423,1448,11851
"36005041400",463,26,2497,392,1545,98,1253,133,6407
"36005041500",868,324,960,193,2462,930,2464,1218,9419
"36005041800",174,127,1986,519,624,466,440,599,4935
"36005041900",1052,303,1041,262,2768,1311,2574,1360,10671
"36005042000",201,130,1639,435,556,382,613,514,4470
"36005042100",1345,319,562,257,2571,950,2880,1173,10057
"36005042200",253,62,2339,343,249,42,511,237,4036
"36005042300",957,354,790,174,1175,907,1102,754,6213
"36005042400",100,0,2328,255,18,150,67,0,2918
"36005042500",1166,290,790,240,2425,1588,2562,1409,10470
"36005042600",698,4,5704,963,276,178,830,178,8831
"36005042800",129,0,1508,233,147,61,144,30,2252
"36005042901",656,58,763,71,764,838,1165,677,4992
"36005042902",703,135,817,570,1041,563,1539,741,6109
"36005043000",299,11,2180,222,388,161,285,140,3686
"36005043100",813,541,2094,643,4617,1632,4206,1769,16315
"36005043400",154,114,1937,505,732,54,533,207,4236
"36005043500",0,0,16,0,0,0,0,0,16
"36005043600",69,37,1323,231,390,16,293,16,2375
"36005044200",339,100,2454,797,131,260,407,343,4831
"36005044400",161,18,2691,269,267,163,444,176,4189
"36005044800",158,0,1593,93,251,77,238,77,2487
"36005044901",1260,55,9,22,198,17,238,22,1821
"36005044902",1714,205,0,5,315,34,181,49,2503
"36005045101",1325,72,38,0,39,2,125,9,1610
"36005045102",1469,66,18,4,223,3,212,4,1999
"36005045600",608,6,1426,217,617,333,683,270,4160
"36005045800",329,339,1601,965,1096,1343,1471,1661,8805
"36005046000",51,55,1919,375,80,187,213,263,3143
"36005046201",5174,668,15002,1063,4552,909,8381,1035,36784
"36005046202",198,113,4612,684,1063,541,1145,624,8980
"36005048400",162,83,2796,183,325,28,577,36,4190
"36005050400",14,0,19,0,0,0,12,0,45
"36005051600",3094,258,71,5,694,3,900,0,5025
"36007000100",1387,673,195,155,203,332,52,197,3194
"36007000200",1641,766,224,150,271,137,13,102,3304
"36007000300",1626,533,242,102,153,130,166,18,2970
"36007000400",1315,312,202,91,66,94,50,15,2145
"36007000500",773,590,196,163,90,69,91,92,2064
"36007000600",1185,614,307,97,79,58,76,107,2523
"36007000700",2424,308,131,51,223,245,98,50,3530
"36007000900",961,394,145,145,78,15,41,31,1810
"36007001100",436,506,85,270,137,102,182,202,1920
"36007001200",295,381,14,40,16,43,20,0,809
"36007001300",560,1132,150,358,55,373,78,406,3112
"36007001400",2567,1445,126,113,308,217,132,95,5003
"36007001500",3672,392,212,113,448,235,75,22,5169
"36007001600",1649,184,48,32,111,112,40,0,2176
"36007001700",2419,1052,357,86,231,131,0,217,4493
"36007001800",2164,1008,245,515,182,189,88,108,4499
"36007010200",4681,608,0,0,20,29,0,5,5343
"36007011901",2520,291,23,0,16,48,21,38,2957
"36007011902",2315,373,0,0,20,0,20,26,2754
"36007011903",2363,260,0,0,10,20,24,0,2677
"36007012000",1227,221,0,4,15,0,13,0,1480
"36007012101",3279,332,20,6,0,21,0,21,3679
"36007012102",3775,232,16,14,28,21,23,14,4123
"36007012103",2984,281,33,17,115,1,97,39,3567
"36007012201",2208,188,16,0,72,0,0,0,2484
"36007012202",3299,521,0,0,178,0,8,11,4017
"36007012300",4241,904,16,31,1,4,44,0,5241
"36007012400",2187,292,11,0,51,28,27,3,2599
"36007012500",5442,575,69,0,104,7,42,15,6254
"36007012600",4966,606,0,0,124,105,79,30,5910
"36007012701",4294,1045,13,0,0,40,11,0,5403
"36007012702",4510,248,42,11,68,24,113,0,5016
"36007012800",3506,636,0,95,351,66,99,24,4777
"36007012900",1117,119,0,0,0,0,0,0,1236
"36007013000",3607,361,37,17,257,0,129,5,4413
"36007013100",1936,251,59,31,137,0,31,6,2451
"36007013201",1676,79,15,61,137,0,191,0,2159
"36007013202",2844,282,0,0,219,36,281,0,3662
"36007013301",4039,450,260,50,161,108,15,1,5084
"36007013303",2646,214,0,0,35,0,8,47,2950
"36007013304",5384,268,28,13,268,13,21,1,5996
"36007013400",3184,578,5,48,254,148,134,147,4498
"36007013500",993,496,44,222,132,63,36,21,2007
"36007013600",2731,579,153,229,80,19,29,0,3820
"36007013700",2454,326,45,0,118,0,229,35,3207
"36007013800",2540,444,119,31,36,111,95,31,3407
"36007013900",1195,563,476,100,239,108,67,100,2848
"36007014000",1556,522,73,121,302,425,27,141,3167
"36007014100",2539,379,1,0,71,0,14,18,3022
"36007014200",2345,102,28,24,164,31,156,0,2850
"36007014301",3548,136,120,25,731,136,0,22,4718
"36007014302",1755,291,27,0,362,281,55,87,2858
"36007014400",4296,73,61,100,218,0,168,0,4916
"36007014500",3122,251,207,0,74,0,209,0,3863
"36007014600",5017,155,21,0,270,0,0,0,5463
"36009940000",10,0,0,0,171,136,0,0,317
"36009940200",0,0,0,0,0,0,0,0,0
"36009940300",3044,1093,60,35,1346,712,155,74,6519
"36009960100",3046,424,21,0,7,35,16,6,3555
"36009960200",3678,663,14,0,47,50,19,14,4485
"36009960300",3957,527,9,1,68,0,21,74,4657
"36009960400",3432,368,3,55,259,71,17,35,4240
"36009960500",3933,1264,0,3,50,42,45,32,5369
"36009960600",2878,456,0,3,115,62,46,11,3571
"36009960702",2401,219,8,0,64,18,69,0,2779
"36009960800",3508,732,16,2,45,57,81,22,4463
"36009961000",3791,591,40,0,52,32,10,0,4516
"36009961100",3229,621,44,0,102,3,0,5,4004
"36009961200",3208,367,3,12,42,7,18,4,3661
"36009961300",3179,499,0,15,16,27,30,29,3795
"36009961400",3773,895,9,0,117,49,83,28,4954
"36009961500",1634,208,17,0,18,0,57,0,1934
"36009961600",2930,791,17,0,215,185,57,0,4195
"36009961700",2082,1222,147,0,78,21,45,68,3663
"36009961800",3477,709,243,128,0,0,0,34,4591
"36009962200",2587,426,9,5,40,0,36,7,3110
"36011040100",3993,882,1,0,63,23,21,14,4997
"36011040200",4329,504,145,0,70,12,45,0,5105
"36011040300",3338,523,14,2,38,10,34,3,3962
"36011040400",3892,351,0,4,135,4,68,2,4456
"36011040500",2667,253,15,0,24,0,7,0,2966
"36011040600",3052,121,2,2,40,0,19,0,3236
"36011040700",3539,229,1,0,17,0,8,0,3794
"36011040800",3463,176,26,0,36,20,14,0,3735
"36011040900",3315,573,10,0,67,21,25,7,4018
"36011041000",4071,375,23,2,59,16,132,52,4730
"36011041100",4381,186,7,2,84,3,90,4,4757
"36011041200",4576,269,25,8,86,27,22,26,5039
"36011041300",2720,757,153,7,33,88,80,6,3844
"36011041400",3403,532,21,213,244,0,23,39,4475
"36011041500",2321,340,8,90,52,54,0,39,2904
"36011041600",2350,94,33,0,62,13,104,0,2656
"36011041700",3127,786,129,0,96,0,63,34,4235
"36011041800",3168,585,435,146,87,110,37,2,4570
"36011042100",1486,980,188,132,219,56,49,129,3239
"36011990200",0,0,0,0,0,0,0,0,0
"36013030100",2066,1030,192,37,50,205,18,233,3831
"36013030200",2642,1066,133,13,160,196,426,226,4862
"36013030300",646,720,225,106,215,223,89,207,2431
"36013030400",3562,653,47,60,65,76,208,262,4933
"36013030500",1299,1409,136,33,35,135,213,300,3560
"36013030600",2643,621,28,136,78,191,93,4,3794
"36013030700",3499,912,13,67,58,50,81,197,4877
"36013030800",3511,623,103,0,138,42,32,104,4553
"36013035100",3507,674,0,0,42,0,16,21,4260
"36013035300",2282,256,14,2,35,28,66,47,2730
"36013035400",1651,656,66,14,177,242,512,380,3698
"36013035500",2260,433,151,80,79,214,508,463,4188
"36013035600",2303,542,89,163,103,66,276,219,3761
"36013035700",2054,502,26,75,268,181,496,291,3893
"36013035800",2767,946,30,1,144,0,9,128,4025
"36013035901",3973,954,11,24,35,0,92,0,5089
"36013035902",138,69,0,0,7,0,0,0,214
"36013036000",2994,624,41,167,153,136,175,341,4631
"36013036100",4152,532,13,0,93,24,54,7,4875
"36013036300",3189,623,14,18,42,10,35,21,3952
"36013036401",2523,275,9,4,38,2,52,2,2905
"36013036402",2636,692,0,0,126,0,55,0,3509
"36013036500",4064,577,69,20,6,10,87,85,4918
"36013036600",2482,492,0,14,6,0,11,56,3061
"36013036700",3469,847,0,0,45,18,27,4,4410
"36013036800",3729,464,0,0,91,38,34,17,4373
"36013036901",2427,303,0,2,55,20,10,0,2817
"36013036902",3456,162,36,0,9,0,9,0,3672
"36013037000",3040,288,25,0,22,28,50,27,3480
"36013037100",3315,372,20,6,78,94,89,0,3974
"36013037200",2594,507,49,14,39,13,74,4,3294
"36013037300",4512,719,0,5,66,77,86,65,5530
"36013037400",3325,342,5,1,95,27,30,0,3825
"36013037500",4467,469,23,0,41,5,10,20,5035
"36013037600",2000,567,0,0,72,54,74,95,2862
"36013990000",0,0,0,0,0,0,0,0,0
"36015000100",1541,912,227,150,170,41,20,33,3094
"36015000200",1836,274,85,381,43,96,16,0,2731
"36015000300",0,0,0,0,0,0,0,0,0
"36015000400",1641,121,133,16,24,0,0,0,1935
"36015000500",2498,538,148,2,72,16,91,0,3365
"36015000600",1243,785,236,121,45,190,56,141,2817
"36015000700",665,671,206,222,157,127,61,27,2136
"36015000900",2695,658,28,39,111,84,127,106,3848
"36015001000",1297,766,159,215,50,113,8,33,2641
"36015001100",2256,698,148,42,55,52,63,40,3354
"36015010100",3093,365,4,9,46,11,150,4,3682
"36015010200",5260,400,28,32,145,20,19,1,5905
"36015010300",6792,503,73,2,381,2,75,6,7834
"36015010400",3302,72,9,0,87,0,0,0,3470
"36015010500",2325,291,14,9,120,116,83,0,2958
"36015010600",2504,301,43,0,93,48,0,0,2989
"36015010700",6384,642,66,0,82,0,131,18,7323
"36015010800",2686,670,0,88,115,106,28,0,3693
"36015010900",4475,98,213,0,245,51,0,0,5082
"36015011000",3433,389,11,0,41,0,0,12,3886
"36015011100",5390,1053,113,15,551,156,339,22,7639
"36015011200",4212,234,9,0,29,14,123,0,4621
"36017970100",4949,699,0,11,90,25,74,1,5849
"36017970200",3302,651,0,2,73,30,64,27,4149
"36017970300",3077,611,36,16,76,20,14,0,3850
"36017970400",1870,933,37,0,45,77,35,20,3017
"36017970500",4816,764,0,2,83,37,47,0,5749
"36017970601",3498,685,4,2,68,13,47,13,4330
"36017970602",3324,454,0,0,86,18,121,12,4015
"36017970700",2000,308,0,0,179,56,125,7,2675
"36017970801",3300,449,9,0,35,54,22,42,3911
"36017970802",3326,471,35,30,90,48,65,17,4082
"36017970900",4174,783,0,4,129,20,105,29,5244
"36017971000",2936,339,17,0,28,44,22,36,3422
"36019100100",4759,709,35,2,135,35,69,4,5748
"36019100200",3733,416,3,3,31,26,84,13,4309
"36019100300",4531,1091,27,5,85,48,18,14,5819
"36019100400",3394,691,3,3,74,18,44,23,4250
"36019100600",4789,594,0,0,81,28,8,0,5500
"36019100700",3219,330,29,0,78,21,29,4,3710
"36019100800",3649,387,35,12,31,49,8,39,4210
"36019100900",3907,575,55,73,167,57,91,23,4948
"36019101000",3477,265,39,0,109,91,85,0,4066
"36019101100",65,43,0,0,0,0,0,0,108
"36019101300",1611,897,84,55,14,58,0,76,2795
"36019101400",1394,195,5,0,74,8,0,2,1678
"36019101600",1086,433,20,5,52,54,39,43,1732
"36019101700",4329,679,0,7,146,0,15,15,5191
"36019101800",5080,272,4,6,65,0,27,0,5454
"36019101900",5963,489,101,64,337,17,78,45,7094
"36019102000",2507,460,42,0,40,50,10,0,3109
"36019102100",1566,315,0,0,47,19,16,0,1963
"36019102200",1927,992,54,47,89,23,106,34,3272
"36021000100",2012,125,64,0,116,49,16,0,2382
"36021000200",1327,83,4,0,67,23,28,0,1532
"36021000300",3641,208,18,10,107,6,17,3,4010
"36021000401",2107,32,26,3,62,0,31,5,2266
"36021000402",5299,236,78,20,139,66,151,25,6014
"36021000500",1747,172,69,1,91,11,23,0,2114
"36021000600",2498,237,36,0,0,1,0,7,2779
"36021000700",4530,282,76,89,138,5,82,3,5205
"36021000800",1261,115,24,0,23,0,8,0,1431
"36021000900",1568,134,172,0,31,8,43,0,1956
"36021001000",4809,429,16,19,372,46,293,3,5987
"36021001100",3233,282,91,45,318,37,34,72,4112
"36021001200",1434,589,596,196,556,162,225,187,3945
"36021001300",1672,372,312,15,135,87,74,109,2776
"36021001400",2796,384,45,19,106,13,245,153,3761
"36021001500",980,180,0,1,15,1,36,3,1216
"36021001600",2994,453,0,18,103,0,146,12,3726
"36021001700",1226,179,36,0,33,19,26,6,1525
"36021001800",1626,86,1,2,52,0,22,0,1789
"36021001900",1572,249,9,0,82,16,121,19,2068
"36021002000",1827,86,4,10,70,0,71,0,2068
"36023970100",3060,350,48,23,99,21,47,18,3666
"36023970200",5228,593,8,24,23,16,8,3,5903
"36023970300",2756,144,46,9,123,32,116,23,3249
"36023970400",2527,209,22,2,51,115,58,7,2991
"36023970500",2954,429,0,7,211,54,209,0,3864
"36023970600",2164,619,313,3,0,0,143,8,3250
"36023970700",3305,1077,18,29,76,44,68,75,4692
"36023970800",99,49,0,0,16,0,0,0,164
"36023970900",2745,1235,118,61,329,74,94,33,4689
"36023971000",4412,624,12,0,114,76,23,54,5315
"36023971100",4052,502,12,0,197,0,56,4,4823
"36023971200",3603,269,46,1,176,0,28,0,4123
"36025970100",3613,641,21,3,98,0,59,0,4435
"36025970200",2612,201,8,0,146,49,80,27,3123
"36025970300",2065,131,39,1,10,0,0,3,2249
"36025970400",4849,679,0,0,157,17,130,0,5832
"36025970500",3832,488,32,55,34,48,39,15,4543
"36025970600",4214,1257,0,12,30,0,66,75,5654
"36025970700",1930,327,38,0,46,0,71,0,2412
"36025970800",2926,411,26,33,40,4,7,4,3451
"36025970900",0,0,0,0,8,0,0,0,8
"36025971000",2459,426,44,6,59,44,40,42,3120
"36025971100",1999,302,108,8,56,1,25,45,2544
"36025971200",2888,467,22,5,234,58,291,87,4052
"36025971300",1588,340,4,0,40,0,33,0,2005
"36025971400",2674,385,26,39,22,10,77,27,3260
"36027010000",3399,249,201,38,265,181,503,180,5016
"36027020003",3681,225,221,76,93,0,190,0,4486
"36027020004",2594,44,1,21,118,0,166,0,2944
"36027020005",4785,189,211,2,417,0,514,0,6118
"36027030000",3682,365,89,37,112,9,28,97,4419
"36027040001",4030,305,43,0,259,143,337,137,5254
"36027040003",2651,235,469,10,428,33,367,111,4304
"36027050102",3120,214,9,19,203,1,243,1,3810
"36027050103",4657,155,323,24,352,0,395,0,5906
"36027050104",5527,121,46,0,847,3,362,0,6906
"36027050203",4487,375,352,1,346,31,359,116,6067
"36027050204",2306,27,43,2,433,0,198,0,3009
"36027050205",4726,60,65,2,254,0,269,0,5376
"36027060100",2965,169,644,64,791,10,599,12,5254
"36027060201",2676,29,281,0,74,0,249,0,3309
"36027060202",3082,332,169,17,367,18,430,162,4577
"36027060301",3933,195,142,0,264,1,290,22,4847
"36027060302",1553,15,85,0,647,2,194,2,2498
"36027060400",1516,204,87,0,441,0,267,35,2550
"36027070101",3208,435,219,5,279,28,166,27,4367
"36027070102",3024,135,133,12,75,0,228,12,3619
"36027070201",2638,401,38,20,109,14,125,24,3369
"36027070301",5141,179,457,12,459,6,270,54,6578
"36027070401",2075,341,211,1,76,11,39,5,2759
"36027080103",3853,115,149,58,359,46,274,83,4937
"36027080104",3436,171,21,12,271,33,357,12,4313
"36027080201",3985,22,185,0,204,6,370,0,4772
"36027080202",2409,84,111,1,197,0,106,0,2908
"36027090000",2148,73,41,0,146,0,110,0,2518
"36027100000",2382,153,51,0,395,30,216,36,3263
"36027110003",3623,64,106,2,254,2,118,2,4171
"36027110004",1620,151,7,1,115,60,314,111,2379
"36027110005",1850,172,17,11,200,58,352,94,2754
"36027120000",2112,161,4,2,150,11,179,1,2620
"36027130003",4571,302,206,2,228,0,194,0,5503
"36027130004",1589,70,19,1,0,2,48,0,1729
"36027130005",1912,303,153,0,265,15,208,35,2891
"36027140101",2118,610,461,84,227,32,308,24,3864
"36027140200",4694,523,953,115,734,183,911,7,8120
"36027140300",3384,812,1012,37,651,161,479,124,6660
"36027140400",3887,24,276,1,855,8,549,8,5608
"36027140500",1593,254,199,29,572,69,203,32,2951
"36027140602",2117,203,184,0,119,28,216,86,2953
"36027140700",5510,115,563,59,543,45,300,45,7180
"36027140801",1810,243,46,10,321,123,320,76,2949
"36027150003",1253,281,1,1,114,7,140,3,1800
"36027150004",3298,165,9,0,163,27,8,27,3697
"36027150005",2359,90,46,0,43,0,25,0,2563
"36027150006",1409,215,0,1,137,36,82,15,1895
"36027160003",1971,66,39,11,79,18,93,14,2291
"36027160004",2099,71,29,3,5,0,69,0,2276
"36027160005",2163,207,9,15,73,17,19,44,2547
"36027170000",2966,198,201,61,135,205,226,119,4111
"36027180001",4608,173,23,9,74,0,96,25,5008
"36027190101",3016,28,223,0,964,33,541,0,4805
"36027190102",1311,8,136,0,215,53,316,0,2039
"36027190203",1855,107,192,32,342,1,328,32,2889
"36027190204",3952,122,369,25,668,0,609,0,5745
"36027190301",2422,115,538,5,308,0,478,0,3866
"36027190401",2026,26,87,1,31,0,146,0,2317
"36027190402",2554,81,213,0,395,13,385,0,3641
"36027200001",2942,139,0,0,21,4,44,19,3169
"36027200002",1239,86,0,15,69,82,17,39,1547
"36027210101",3228,321,321,178,554,94,807,143,5646
"36027210201",2226,355,1000,214,415,349,758,436,5753
"36027210301",2936,294,389,48,526,5,687,0,4885
"36027220100",1652,350,686,516,624,94,778,12,4712
"36027220201",992,340,831,393,272,107,457,103,3495
"36027220300",618,330,1690,1445,521,167,620,310,5701
"36027220700",912,190,745,338,357,88,372,68,3070
"36027220801",2037,359,469,299,412,299,443,460,4778
"36027220901",1695,311,1302,198,529,64,545,187,4831
"36027221001",2826,133,685,128,359,11,64,0,4206
"36027221100",1018,381,736,251,625,712,922,887,5532
"36027300000",2857,191,310,5,1447,396,1187,171,6564
"36027410000",1115,280,200,27,123,32,101,27,1905
"36027610000",0,0,0,0,0,0,0,0,0
"36027640001",0,0,0,0,0,0,0,0,0
"36027640002",73,40,85,153,21,1,38,60,471
"36029000110",1513,490,107,0,261,240,205,227,3043
"36029000200",2867,527,0,12,201,377,156,291,4431
"36029000500",1289,464,6,7,111,75,235,102,2289
"36029000600",4005,550,282,16,46,51,114,264,5328
"36029000700",3414,20,7,4,65,0,9,0,3519
"36029000800",3867,497,82,97,171,54,162,9,4939
"36029000900",1897,299,72,0,47,1,121,1,2438
"36029001000",3790,860,63,279,145,7,110,73,5327
"36029001100",1874,680,90,27,65,38,73,55,2902
"36029001402",100,17,1767,1468,98,0,23,13,3486
"36029001500",133,77,937,308,29,1,2,56,1543
"36029001600",277,163,597,498,135,347,30,109,2156
"36029001700",848,345,546,65,81,16,5,8,1914
"36029001900",2521,220,135,0,68,74,66,41,3125
"36029002300",1755,914,236,161,67,80,76,132,3421
"36029002400",2319,820,521,204,280,274,167,118,4703
"36029002502",125,53,1286,385,45,152,37,127,2210
"36029002702",475,68,562,519,345,821,0,13,2803
"36029002800",430,141,727,537,168,135,198,40,2376
"36029002900",447,160,753,776,113,20,0,4,2273
"36029003000",301,61,702,1424,141,20,35,28,2712
"36029003100",47,50,1024,697,9,36,4,4,1871
"36029003301",39,39,2233,1129,126,0,59,0,3625
"36029003302",66,25,1862,1220,47,147,11,52,3430
"36029003400",24,22,1833,501,0,22,10,4,2416
"36029003500",42,84,1522,1217,55,45,73,2,3040
"36029003600",178,160,1097,891,29,195,23,0,2573
"36029003700",378,136,1582,1676,100,63,27,209,4171
"36029003800",457,12,1338,1157,54,190,104,155,3467
"36029003901",14,7,583,369,19,14,0,5,1011
"36029004001",426,170,1845,1246,51,122,30,123,4013
"36029004100",254,42,3040,1013,83,66,0,3,4501
"36029004200",171,23,1875,1261,26,0,0,0,3356
"36029004300",707,61,2366,1798,302,62,158,34,5488
"36029004401",297,24,2503,1016,7,34,19,18,3918
"36029004402",39,12,1006,1508,39,73,20,84,2781
"36029004500",3314,240,1602,164,230,173,278,0,6001
"36029004601",1440,353,529,70,591,479,43,51,3556
"36029004602",15,3,0,0,0,0,0,0,18
"36029004700",883,417,3072,1005,526,413,66,73,6455
"36029004800",3393,178,615,9,179,2,303,2,4681
"36029004900",3882,483,580,360,407,68,236,34,6050
"36029005000",1168,105,448,486,33,94,88,83,2505
"36029005100",3069,586,637,101,149,36,122,256,4956
"36029005201",1708,340,321,166,84,24,63,18,2724
"36029005202",55,339,993,245,125,29,30,23,1839
"36029005300",408,29,175,163,31,33,0,5,844
"36029005400",2879,322,413,55,345,21,124,21,4180
"36029005500",1335,890,229,479,341,537,425,368,4604
"36029005600",1745,509,693,443,272,514,369,573,5118
"36029005700",1349,372,377,125,10,234,322,343,3132
"36029005801",2238,653,130,27,14,229,94,110,3495
"36029005802",2553,602,111,381,216,538,498,220,5119
"36029005900",1849,765,126,268,567,423,488,457,4943
"36029006100",1397,744,648,1057,727,316,524,504,5917
"36029006201",0,0,0,0,0,0,0,0,0
"36029006301",2917,676,290,36,291,716,127,500,5553
"36029006302",2388,250,23,13,32,0,132,0,2838
"36029006501",1735,299,163,72,457,219,216,93,3254
"36029006601",1262,493,51,103,660,450,259,235,3513
"36029006602",1375,185,185,77,49,140,113,140,2264
"36029006701",2025,186,359,104,370,158,282,105,3589
"36029006702",1865,305,538,192,168,113,14,69,3264
"36029006800",2255,699,111,259,457,147,416,136,4480
"36029006901",780,527,536,391,477,849,654,509,4723
"36029006902",1358,463,209,472,604,866,469,843,5284
"36029007000",753,280,213,433,410,739,412,805,4045
"36029007101",760,645,383,680,674,512,1011,942,5607
"36029007102",495,459,356,707,168,507,185,824,3701
"36029007202",1137,129,195,49,322,22,496,108,2458
"36029007302",6971,565,94,17,243,16,202,19,8127
"36029007303",5985,416,142,51,447,36,204,34,7315
"36029007304",4926,135,8,1,264,0,57,0,5391
"36029007600",2793,297,0,2,23,0,10,0,3125
"36029007700",4037,459,9,0,44,21,3,21,4594
"36029007800",4602,616,0,2,63,45,33,0,5361
"36029007901",2656,190,39,0,413,0,88,0,3386
"36029007902",5301,245,144,0,260,10,273,1,6234
"36029007903",3264,113,52,69,26,0,26,34,3584
"36029007904",2841,236,58,0,241,0,200,0,3576
"36029007905",3502,651,0,0,87,62,84,10,4396
"36029008001",4221,593,229,0,456,0,228,43,5770
"36029008002",4689,540,71,108,284,15,60,243,6010
"36029008003",4652,597,86,44,167,118,147,8,5819
"36029008101",5026,262,26,1,259,65,87,20,5746
"36029008102",3800,169,88,0,82,27,22,1,4189
"36029008201",2123,162,13,12,36,0,91,12,2449
"36029008202",3050,356,116,1,7,84,52,10,3676
"36029008300",1441,622,98,120,90,73,42,45,2531
"36029008400",1903,238,0,10,32,8,32,32,2255
"36029008500",2292,90,89,0,64,2,177,0,2714
"36029008600",3896,169,72,0,300,0,17,0,4454
"36029008700",4185,381,196,0,113,0,307,13,5195
"36029008800",2881,359,20,43,151,56,78,19,3607
"36029008900",3906,301,46,33,86,0,61,42,4475
"36029009004",3240,55,97,0,277,0,177,0,3846
"36029009006",6314,214,144,3,564,74,217,0,7530
"36029009007",6231,253,67,1,1074,17,251,0,7894
"36029009008",3626,119,38,0,710,0,156,0,4649
"36029009009",4018,137,180,16,443,56,26,0,4876
"36029009010",4077,251,151,87,613,1,74,17,5271
"36029009104",3555,158,205,4,280,0,132,0,4334
"36029009106",2540,26,308,51,195,0,82,0,3202
"36029009107",3565,603,382,88,526,329,316,312,6121
"36029009109",2403,122,5,2,312,282,77,0,3203
"36029009110",0,0,0,0,0,0,0,0,0
"36029009112",1721,413,62,116,171,66,140,0,2689
"36029009113",6230,157,254,1,376,36,189,10,7253
"36029009114",3169,74,86,44,460,95,228,1,4157
"36029009115",1552,928,194,84,183,431,19,27,3418
"36029009116",3902,522,414,19,290,333,152,13,5645
"36029009200",2871,159,234,62,300,363,0,143,4132
"36029009301",2756,243,654,359,535,317,76,0,4940
"36029009302",1929,270,329,6,171,72,50,0,2827
"36029009401",4104,510,216,0,425,36,12,3,5306
"36029009402",4074,118,62,0,134,18,125,18,4549
"36029009501",4183,134,471,74,84,13,19,0,4978
"36029009502",5789,229,168,14,487,31,150,0,6868
"36029009600",4896,276,137,62,508,16,194,0,6089
"36029009701",2959,224,0,0,76,10,77,0,3346
"36029009702",3948,248,16,0,178,1,61,30,4482
"36029009800",1424,229,0,0,0,0,87,0,1740
"36029009900",2864,594,59,0,13,101,10,0,3641
"36029010001",2703,181,83,0,29,7,43,0,3046
"36029010002",3634,165,2,32,35,11,59,0,3938
"36029010003",3113,442,126,38,120,61,26,2,3928
"36029010101",3819,154,563,40,71,0,38,11,4696
"36029010102",2160,586,473,218,166,7,92,281,3983
"36029010103",3292,410,248,12,30,7,24,23,4046
"36029010201",1986,62,385,229,207,0,97,0,2966
"36029010202",988,49,1244,461,157,87,80,14,3080
"36029010300",449,154,323,177,162,67,66,16,1414
"36029010400",1295,349,347,66,135,114,53,60,2419
"36029010500",1475,70,479,178,111,0,33,0,2346
"36029010600",1983,212,172,0,12,0,14,0,2393
"36029010700",2242,235,151,46,20,31,80,0,2805
"36029010803",1745,113,0,0,0,0,0,0,1858
"36029010804",3448,182,269,0,137,11,72,11,4130
"36029010805",4757,243,0,0,125,0,64,0,5189
"36029010807",4428,340,182,80,197,18,155,33,5433
"36029010808",2844,228,224,30,400,95,189,17,4027
"36029010809",3140,21,0,27,41,0,54,0,3283
"36029010901",1935,210,36,1,12,19,18,18,2249
"36029010902",3325,515,509,105,0,0,103,18,4575
"36029011000",1435,267,0,0,56,142,4,68,1972
"36029011100",1973,191,71,0,0,0,48,0,2283
"36029011200",6046,253,30,0,29,76,215,0,6649
"36029011300",4533,215,74,210,254,0,36,11,5333
"36029011400",1598,461,26,143,107,0,83,11,2429
"36029011500",1366,89,0,10,61,0,47,10,1583
"36029011600",1740,45,0,0,90,13,56,0,1944
"36029011700",3595,357,10,10,20,6,33,6,4037
"36029011800",3251,164,0,38,17,15,17,4,3506
"36029012001",3613,310,13,0,244,0,323,0,4503
"36029012002",3334,76,0,0,57,25,52,0,3544
"36029012003",4758,151,33,5,91,0,81,0,5119
"36029012300",2265,572,69,60,115,0,116,152,3349
"36029012400",1391,489,57,0,17,102,24,83,2163
"36029012501",4042,547,0,24,188,53,160,53,5067
"36029012502",1660,132,0,0,3,269,44,255,2363
"36029012800",2169,283,33,7,45,26,19,22,2604
"36029012901",5442,445,177,0,110,36,77,18,6305
"36029012902",3290,152,15,0,0,0,20,0,3477
"36029013001",2833,211,55,0,3,72,0,0,3174
"36029013002",4655,585,100,0,125,0,64,25,5554
"36029013101",5857,353,204,1,79,0,42,0,6536
"36029013102",7320,355,175,0,209,0,109,0,8168
"36029013201",5111,591,27,30,162,3,224,3,6151
"36029013202",4732,209,0,0,88,0,101,0,5130
"36029013300",3301,133,0,8,189,20,322,20,3993
"36029013400",6154,248,0,0,44,0,89,0,6535
"36029013501",6493,106,15,0,84,10,358,10,7076
"36029013502",7038,147,0,0,40,0,75,0,7300
"36029013600",3106,88,22,28,10,9,63,1,3327
"36029013701",5636,206,77,6,61,0,69,0,6055
"36029013702",5338,141,24,0,149,14,69,0,5735
"36029013800",7080,384,1,0,143,0,13,0,7621
"36029013900",2226,138,0,0,43,0,0,0,2407
"36029014000",3173,112,0,27,80,0,88,0,3480
"36029014101",5827,216,0,2,86,0,86,0,6217
"36029014102",5017,210,0,0,55,0,13,0,5295
"36029014204",3511,234,17,2,82,8,54,1,3909
"36029014206",7005,192,0,5,22,8,294,8,7534
"36029014207",4783,104,45,2,171,113,24,79,5321
"36029014208",4627,100,35,3,94,0,133,0,4992
"36029014209",3788,180,19,2,85,2,38,2,4116
"36029014300",5551,300,5,4,237,0,94,0,6191
"36029014400",3580,496,0,3,41,53,31,6,4210
"36029014501",3218,176,1,0,13,0,20,0,3428
"36029014502",1736,744,0,1,0,0,33,0,2514
"36029014601",4305,146,123,0,316,0,126,0,5016
"36029014603",3462,125,125,1,503,0,24,0,4240
"36029014604",6937,133,75,0,590,0,101,0,7836
"36029014701",4850,246,27,18,209,28,87,2,5467
"36029014702",7244,388,25,26,541,15,98,24,8361
"36029014801",2150,298,0,1,122,0,47,0,2618
"36029014803",5550,210,81,0,144,39,23,0,6047
"36029014901",2192,375,0,5,21,14,37,0,2644
"36029014903",5584,443,32,47,93,0,20,0,6219
"36029014904",0,0,0,0,0,0,0,0,0
"36029015001",5074,189,0,0,55,0,161,0,5479
"36029015002",2581,381,0,0,47,0,49,0,3058
"36029015003",2930,387,1,0,7,7,16,10,3358
"36029015101",3057,166,1,0,43,0,0,0,3267
"36029015102",2567,171,0,0,22,0,4,0,2764
"36029015201",3077,82,0,0,0,0,0,0,3159
"36029015202",4560,207,3,3,59,0,9,27,4868
"36029015301",4626,180,0,4,0,3,79,3,4895
"36029015302",2639,146,0,0,0,0,9,0,2794
"36029015401",2404,182,33,0,9,0,77,0,2705
"36029015402",4831,391,0,0,176,0,42,13,5453
"36029015501",1578,210,0,0,68,11,44,8,1919
"36029015503",2160,115,61,13,42,85,11,0,2487
"36029015504",3552,321,1,0,106,4,0,0,3984
"36029015600",1728,108,12,0,143,79,72,60,2202
"36029015700",3138,277,4,0,43,6,0,0,3468
"36029015800",3766,342,8,0,59,9,10,0,4194
"36029015900",3439,463,34,19,104,42,52,28,4181
"36029016100",20,1,0,1,3,1,3,1,30
"36029016200",1650,107,47,12,212,8,186,7,2229
"36029016300",1750,449,36,262,181,199,119,123,3119
"36029016400",730,327,886,605,282,7,229,91,3157
"36029016500",385,319,138,64,45,41,42,124,1158
"36029016600",12,19,1566,1107,88,30,34,2,2858
"36029016700",1886,365,37,4,7,75,65,137,2576
"36029016800",99,25,2405,1248,165,109,207,62,4320
"36029016900",2097,260,580,156,224,41,150,31,3539
"36029017000",93,5,1683,742,97,28,28,7,2683
"36029017100",914,797,204,1249,726,816,247,797,5750
"36029017200",1524,282,0,0,59,142,1,0,2008
"36029017300",6250,161,64,202,148,0,113,202,7140
"36029017400",1126,922,687,535,199,313,248,296,4326
"36029017501",964,304,0,0,164,3,0,2,1437
"36029017502",2228,237,6,4,18,0,0,0,2493
"36029940000",36,28,5,0,1372,384,151,53,2029
"36029940100",0,0,0,0,17,0,0,0,17
"36029990000",0,0,0,0,0,0,0,0,0
"36031960100",2102,269,9,6,120,61,14,16,2597
"36031960200",2421,182,8,2,108,6,6,2,2735
"36031960300",2472,225,14,2,95,44,20,5,2877
"36031960498",2348,140,72,24,87,42,29,0,2742
"36031960598",3557,315,56,33,114,44,129,28,4276
"36031960700",1755,254,3,0,99,33,8,0,2152
"36031960800",1292,215,7,2,114,6,11,2,1649
"36031960900",2738,371,0,2,328,74,53,46,3612
"36031961000",3798,460,11,42,274,11,17,0,4613
"36031961100",1762,157,7,1,153,3,0,0,2083
"36031961200",3508,961,81,2,331,34,0,5,4922
"36031961300",1323,140,0,6,130,1,13,1,1614
"36031961400",975,171,3,0,5,1,0,2,1157
"36033940000",95,76,0,0,1891,1137,0,0,3199
"36033950100",3501,678,11,12,69,8,23,21,4323
"36033950200",2841,886,11,30,659,182,32,28,4669
"36033950300",5021,1067,5,18,86,73,126,8,6404
"36033950400",4272,602,19,24,87,0,91,0,5095
"36033950501",2444,899,23,94,13,36,51,16,3576
"36033950502",1269,304,0,0,17,0,10,13,1613
"36033950600",1386,238,0,0,53,16,25,8,1726
"36033950700",1766,440,3,1,20,14,11,3,2258
"36033950800",1635,126,1,0,7,0,11,6,1786
"36033950900",2806,609,31,0,59,3,42,0,3550
"36033951000",1752,344,4,19,39,0,0,0,2158
"36033951100",2815,605,6,49,9,0,0,7,3491
"36033951200",2012,153,6,0,23,0,5,0,2199
"36035970100",2322,296,1,0,30,1,18,0,2668
"36035970200",2421,334,1,0,30,9,53,3,2851
"36035970300",3029,580,0,0,34,0,0,0,3643
"36035970400",1546,189,0,0,22,9,3,10,1779
"36035970500",3415,636,0,18,55,8,22,0,4154
"36035970600",5408,923,8,0,63,19,89,41,6551
"36035970700",2345,1077,44,135,24,55,75,173,3928
"36035970800",1904,836,91,33,149,10,26,40,3089
"36035970900",2890,636,5,39,99,79,147,65,3960
"36035971000",1910,472,5,5,3,51,9,46,2501
"36035971100",1640,482,0,0,81,70,0,41,2314
"36035971200",3352,322,56,0,77,44,31,0,3882
"36035971300",3608,576,42,2,183,42,0,1,4454
"36035971400",3002,367,25,0,60,0,34,2,3490
"36035971500",4819,287,0,0,133,7,177,0,5423
"36037940100",26,8,0,0,398,52,0,0,484
"36037950100",4967,419,42,1,43,4,119,35,5630
"36037950200",5088,379,55,12,167,102,257,56,6116
"36037950300",5147,608,49,0,128,50,39,0,6021
"36037950400",5850,589,135,3,163,11,206,28,6985
"36037950500",2283,287,73,4,79,4,0,4,2734
"36037950600",1506,693,52,120,183,16,20,103,2693
"36037950700",1333,263,69,316,24,39,13,36,2093
"36037950800",1605,604,131,45,90,169,68,140,2852
"36037950900",1690,320,42,49,200,43,137,59,2540
"36037951000",1812,276,82,159,106,50,41,26,2552
"36037951100",4669,323,50,0,171,0,30,3,5246
"36037951200",3958,500,179,0,11,3,94,13,4758
"36037951300",3591,490,45,5,51,36,36,0,4254
"36037951400",5111,383,15,1,100,32,16,38,5696
"36039080100",3044,150,11,13,34,1,19,0,3272
"36039080201",3258,434,12,0,0,0,0,17,3721
"36039080202",2275,427,0,0,0,9,0,78,2789
"36039080300",2597,420,6,0,16,3,86,0,3128
"36039080401",2010,496,0,6,126,5,107,0,2750
"36039080402",1737,381,0,0,8,0,29,32,2187
"36039080501",1971,415,6,17,31,0,82,0,2522
"36039080502",3111,1028,0,6,41,4,0,14,4204
"36039080600",2571,419,26,0,115,38,148,127,3444
"36039080700",2412,199,208,103,21,0,198,0,3141
"36039080800",0,0,0,0,0,0,0,0,0
"36039080900",3295,353,46,65,158,87,134,31,4169
"36039081000",2702,822,344,181,84,114,268,22,4537
"36039081101",3359,255,23,0,300,0,31,0,3968
"36039081102",1943,402,220,0,482,28,405,15,3495
"36041950100",1045,70,0,3,13,1,22,0,1154
"36041950300",1203,96,1,1,44,0,0,3,1348
"36041950400",1209,199,0,5,1,3,12,1,1430
"36041950500",767,67,5,7,50,0,8,4,908
"36043010100",5447,567,14,38,209,27,122,39,6463
"36043010201",2794,476,74,14,39,41,18,54,3510
"36043010202",3492,480,48,2,50,25,24,13,4134
"36043010300",4567,417,6,20,12,99,82,66,5269
"36043010400",2340,1098,1,3,28,16,0,0,3486
"36043010501",2207,414,2,2,27,2,1,78,2733
"36043010502",1618,192,0,0,0,0,13,1,1824
"36043010701",2208,566,5,1,60,0,0,8,2848
"36043010702",1565,320,9,21,62,0,26,0,2003
"36043010900",2709,493,19,55,43,44,19,0,3382
"36043011001",1648,311,2,9,0,17,23,6,2016
"36043011002",2669,501,1,0,96,10,13,0,3290
"36043011100",1555,699,30,0,98,0,10,138,2530
"36043011200",4082,1053,11,74,144,0,35,0,5399
"36043011301",1540,104,10,0,55,0,0,0,1709
"36043011302",2959,265,0,0,138,0,168,10,3540
"36043011400",4225,318,33,0,58,3,67,0,4704
"36043011501",2591,433,17,2,131,2,50,2,3228
"36043011502",1894,214,0,0,3,1,0,1,2113
"36045060100",3673,556,44,0,24,58,44,58,4457
"36045060200",5443,500,25,6,98,19,66,0,6157
"36045060300",3443,447,16,5,95,7,52,0,4065
"36045060400",6359,714,14,21,239,4,136,7,7494
"36045060500",4069,356,114,6,348,92,89,47,5121
"36045060600",4476,708,521,85,548,266,638,169,7411
"36045060700",3702,529,26,0,130,20,89,6,4502
"36045060803",3245,908,486,200,852,229,840,33,6793
"36045060804",3337,517,447,50,705,338,680,362,6436
"36045060900",4511,1527,76,2,112,44,267,3,6542
"36045061000",2807,393,149,0,243,39,254,54,3939
"36045061100",4556,385,135,16,631,89,347,110,6269
"36045061200",2009,779,297,52,197,57,152,118,3661
"36045061300",1603,593,113,54,281,252,159,0,3055
"36045061400",2499,906,97,41,209,90,151,65,4058
"36045061500",2443,430,509,47,416,31,247,78,4201
"36045061600",3105,805,59,33,186,8,46,4,4246
"36045061700",1846,343,6,7,98,0,50,5,2355
"36045061800",6407,474,8,12,289,57,151,25,7423
"36045061900",3093,315,113,16,87,70,105,13,3812
"36045062100",3000,1095,173,54,155,167,208,135,4987
"36045062200",3599,257,183,4,197,117,156,109,4622
"36045062400",3173,288,136,0,249,68,82,0,3996
"36045062500",2579,692,23,0,20,5,0,2,3321
"36045980000",0,17,0,0,0,0,0,0,17
"36045990001",0,0,0,0,0,0,0,0,0
"36047000100",3052,480,175,134,608,161,420,102,5132
"36047000200",389,114,81,66,547,384,903,465,2949
"36047000301",3001,371,180,57,485,92,233,118,4537
"36047000501",2674,338,186,2,389,66,47,100,3802
"36047000502",1914,92,60,6,330,46,146,10,2604
"36047000700",3274,157,31,15,314,12,255,20,4078
"36047000900",2875,222,117,65,757,29,257,29,4351
"36047001100",308,32,77,0,146,17,50,0,630
"36047001300",1178,469,141,161,345,267,183,203,2947
"36047001500",1388,311,828,308,994,677,262,535,5303
"36047001800",0,0,0,0,0,0,0,0,0
"36047002000",443,22,78,0,652,181,802,181,2359
"36047002100",2959,49,106,80,507,62,238,73,4074
"36047002200",1644,433,83,17,1523,841,2099,1019,7659
"36047002300",152,156,1277,992,652,663,682,799,5373
"36047002901",50,236,700,1191,292,766,285,683,4203
"36047003000",1313,96,28,54,411,30,366,22,2320
"36047003100",375,5,634,26,456,34,148,34,1712
"36047003300",1481,312,229,82,679,158,430,237,3608
"36047003400",2129,464,1,0,728,1,437,43,3803
"36047003500",407,5,600,58,375,61,171,31,1708
"36047003600",2548,401,172,3,1145,19,507,2,4797
"36047003700",487,30,10,16,79,35,85,42,784
"36047003800",1202,114,10,0,289,115,161,0,1891
"36047003900",1231,213,252,139,587,58,285,131,2896
"36047004100",2353,146,309,108,327,75,187,112,3617
"36047004300",1852,93,56,26,735,103,481,103,3449
"36047004400",2151,107,0,0,198,50,104,57,2667
"36047004500",2914,75,49,0,242,25,222,2,3529
"36047004600",1124,163,7,0,90,0,24,42,1450
"36047004700",838,34,199,15,359,79,337,85,1946
"36047004900",1555,96,25,10,255,10,189,22,2162
"36047005000",2125,69,10,2,91,1,195,1,2494
"36047005100",1659,82,62,0,309,0,241,41,2394
"36047005201",1072,282,0,19,119,206,156,17,1871
"36047005202",2056,135,0,9,217,1,158,1,2577
"36047005300",848,171,316,116,679,229,642,311,3312
"36047005400",2415,438,23,0,538,32,330,74,3850
"36047005601",2025,112,117,123,193,60,245,119,2994
"36047005602",1295,89,0,0,470,0,529,0,2383
"36047005800",2349,430,0,0,442,154,472,71,3918
"36047005900",615,199,72,90,254,43,165,104,1542
"36047006000",2156,131,52,0,290,74,312,53,3068
"36047006200",1597,178,35,124,527,271,465,11,3208
"36047006300",1311,151,18,0,270,6,191,55,2002
"36047006400",2520,262,31,11,829,226,270,94,4243
"36047006500",4178,382,58,45,348,61,358,44,5474
"36047006600",2332,447,72,14,789,41,664,143,4502
"36047006700",3121,119,21,0,228,9,254,19,3771
"36047006800",2477,1090,95,16,1273,376,1099,285,6711
"36047006900",2435,217,89,0,864,34,627,94,4360
"36047007000",1458,196,88,20,695,123,345,22,2947
"36047007100",1098,340,1374,525,730,725,952,938,6682
"36047007200",351,204,9,10,923,590,327,561,2975
"36047007400",1286,957,62,118,2887,778,2693,1610,10391
"36047007500",3388,76,0,5,1328,15,782,15,5609
"36047007600",1198,355,241,6,1347,993,1716,1014,6870
"36047007700",3093,228,137,7,940,18,524,14,4961
"36047007800",1957,677,239,18,1808,738,2967,1198,9602
"36047008000",1207,441,126,0,1955,625,2625,836,7815
"36047008200",945,431,167,37,1936,837,2197,916,7466
"36047008400",1206,325,8,9,1253,864,1667,863,6195
"36047008500",489,466,1526,1561,1544,1447,2151,1695,10879
"36047008600",0,0,0,0,0,0,0,0,0
"36047008800",1339,295,74,0,1129,235,1526,272,4870
"36047009000",478,221,20,0,1579,916,976,361,4551
"36047009200",1308,267,155,66,2004,1284,1399,768,7251
"36047009400",1170,302,54,3,2624,1674,763,215,6805
"36047009600",1902,848,90,8,2538,704,2573,998,9661
"36047009800",1099,437,137,134,3373,2357,2239,1464,11240
"36047010000",1114,401,117,36,2784,1891,1533,1003,8879
"36047010100",1651,563,117,21,1470,386,1811,865,6884
"36047010200",837,265,79,0,3390,750,1054,264,6639
"36047010400",287,115,7,22,3781,2002,430,133,6777
"36047010600",499,35,0,119,2920,2505,337,185,6600
"36047010800",586,135,47,0,2247,1839,530,230,5614
"36047011000",717,200,32,0,1008,595,835,448,3835
"36047011200",2029,1204,178,3,2002,725,1780,582,8503
"36047011400",1605,1481,109,48,805,204,353,211,4816
"36047011600",459,271,74,10,2697,1077,271,166,5025
"36047011700",1720,193,24,0,524,107,560,148,3276
"36047011800",413,11,76,34,1240,717,383,32,2906
"36047011900",1070,48,44,20,381,93,403,93,2152
"36047012000",41,27,0,0,700,547,4,25,1344
"36047012100",1074,106,15,21,716,30,644,51,2657
"36047012200",1296,245,60,1,1981,1432,1259,886,7160
"36047012600",772,506,39,16,966,814,545,345,4003
"36047012700",879,143,1194,392,763,332,999,403,5105
"36047012801",753,160,32,0,992,181,127,120,2365
"36047012901",1203,150,126,5,813,190,644,129,3260
"36047012902",1029,228,239,12,447,60,444,49,2508
"36047013000",2278,903,111,7,1469,203,1006,296,6273
"36047013100",2500,155,438,81,876,254,831,254,5389
"36047013200",905,82,13,0,908,239,252,30,2429
"36047013300",3460,106,148,113,693,94,584,11,5209
"36047013400",2597,405,0,26,940,114,380,33,4495
"36047013500",2489,76,381,27,558,49,438,50,4068
"36047013600",2566,507,42,6,599,106,389,109,4324
"36047013700",2124,310,127,88,542,58,590,159,3998
"36047013800",2845,688,0,0,303,166,502,288,4792
"36047013900",2382,288,369,12,621,68,600,42,4382
"36047014000",1488,157,0,0,221,7,180,44,2097
"36047014100",2514,70,281,36,976,13,868,31,4789
"36047014200",1851,392,26,0,509,202,461,41,3482
"36047014300",1538,79,77,44,1453,597,1407,616,5811
"36047014500",2112,588,216,21,1423,174,1572,104,6210
"36047014700",1217,234,98,0,592,187,691,347,3366
"36047014800",1192,10,0,0,36,0,9,0,1247
"36047014900",4180,176,185,86,867,71,764,115,6444
"36047015000",1416,62,0,1,166,11,40,0,1696
"36047015100",2928,140,66,16,637,36,423,44,4290
"36047015200",1635,159,26,4,513,36,323,20,2716
"36047015300",2213,75,86,0,416,27,285,27,3129
"36047015400",0,0,0,0,0,0,0,0,0
"36047015500",2861,95,212,0,351,38,243,20,3820
"36047015700",3645,78,65,0,457,19,49,3,4316
"36047015900",4034,199,571,4,647,1,199,1,5656
"36047016000",2593,406,156,26,776,556,746,225,5484
"36047016100",2015,157,523,12,500,20,425,4,3656
"36047016200",1403,164,98,0,921,60,290,10,2946
"36047016300",1740,221,726,97,383,50,185,115,3517
"36047016400",330,51,275,0,76,0,317,0,1049
"36047016500",3934,274,198,4,826,59,312,54,5661
"36047016600",1876,126,14,0,56,0,123,60,2255
"36047016700",3684,213,76,0,711,204,578,115,5581
"36047016800",1098,83,83,0,230,77,30,0,1601
"36047016900",2662,453,206,54,647,749,483,654,5908
"36047017000",1971,163,0,0,1120,444,450,25,4173
"36047017100",3193,181,77,8,398,5,128,47,4037
"36047017200",1613,62,233,0,1274,87,435,35,3739
"36047017400",1047,78,0,0,816,40,174,0,2155
"36047017500",0,0,0,0,0,0,0,0,0
"36047017600",964,162,14,0,757,93,195,0,2185
"36047017700",0,0,0,0,0,0,0,0,0
"36047017800",1032,116,28,0,993,201,259,118,2747
"36047017900",795,111,2124,384,294,93,431,171,4403
"36047018000",1308,548,0,0,550,501,523,8,3438
"36047018100",2014,144,802,80,431,136,220,46,3873
"36047018200",1006,14,31,0,1456,539,375,202,3623
"36047018300",1330,89,666,0,628,44,359,39,3155
"36047018400",1166,22,41,0,756,71,31,20,2107
"36047018501",386,213,1242,1299,539,458,565,554,5256
"36047018600",1451,14,25,0,414,65,153,0,2122
"36047018700",842,56,331,35,336,16,303,44,1963
"36047018800",1791,97,14,6,1145,135,77,28,3293
"36047019000",2118,363,25,29,1839,1024,898,679,6975
"36047019100",850,277,645,119,368,393,378,381,3411
"36047019200",1266,618,29,5,817,273,237,180,3425
"36047019300",862,696,1924,224,480,32,685,19,4922
"36047019400",1093,173,47,39,2130,205,409,6,4102
"36047019500",1346,273,1343,130,1093,51,1183,82,5501
"36047019600",1648,504,107,52,1815,1014,915,391,6446
"36047019700",1441,191,949,132,500,72,175,35,3495
"36047019800",1279,179,33,0,233,129,44,0,1897
"36047019900",1209,149,717,147,482,0,248,19,2971
"36047020000",1173,205,0,0,738,53,358,100,2627
"36047020100",1539,131,1426,139,328,11,298,11,3883
"36047020200",1378,79,0,0,521,47,35,0,2060
"36047020300",737,121,304,164,390,47,223,30,2016
"36047020400",1176,140,0,0,324,0,21,0,1661
"36047020500",1542,73,616,48,341,59,185,42,2906
"36047020600",1686,62,19,0,709,104,155,5,2740
"36047020700",2534,91,1060,53,671,68,597,52,5126
"36047020800",1725,106,8,0,1029,170,191,28,3257
"36047021000",1619,245,13,0,2245,683,223,74,5102
"36047021100",429,23,394,145,208,23,383,73,1678
"36047021200",1075,184,21,0,2774,1225,261,6,5546
"36047021300",441,231,2497,949,280,17,352,0,4767
"36047021400",767,412,0,0,848,406,143,46,2622
"36047021500",2153,426,1532,324,680,385,680,240,6420
"36047021600",1506,1510,0,11,798,164,72,160,4221
"36047021700",816,75,1402,401,510,56,187,31,3478
"36047021800",2172,2262,0,0,361,128,97,183,5203
"36047021900",530,182,1745,719,377,111,271,39,3974
"36047022000",2325,1952,9,4,401,136,269,20,5116
"36047022100",998,215,1851,644,461,228,556,244,5197
"36047022200",2249,1801,35,12,183,91,313,204,4888
"36047022400",2867,1298,95,20,674,765,794,642,7155
"36047022600",757,68,20,38,1349,319,1465,259,4275
"36047022700",626,101,1698,354,360,171,332,78,3720
"36047022800",1466,386,14,9,1244,465,583,261,4428
"36047022900",900,86,1889,218,374,109,204,123,3903
"36047023000",1578,1499,50,0,581,293,692,320,5013
"36047023100",1236,412,950,199,403,122,149,61,3532
"36047023200",2724,2571,0,41,415,499,414,140,6804
"36047023300",706,164,1996,1239,477,543,476,480,6081
"36047023400",3007,2244,0,0,26,0,31,0,5308
"36047023500",1248,1430,583,145,278,299,701,560,5244
"36047023600",2680,2256,0,0,40,16,181,0,5173
"36047023800",2790,1045,0,0,0,37,0,0,3872
"36047024000",2287,1230,0,11,292,43,316,10,4189
"36047024100",746,387,662,101,122,122,377,109,2626
"36047024200",2182,656,10,0,218,54,145,18,3283
"36047024300",798,309,2199,572,196,34,374,159,4641
"36047024400",1750,961,8,1,505,99,402,79,3805
"36047024500",375,8,2227,784,500,152,102,45,4193
"36047024600",1863,406,34,1,808,310,95,92,3609
"36047024700",349,29,1148,351,125,18,123,0,2143
"36047024800",1450,263,17,0,840,327,507,176,3580
"36047024900",380,151,2266,630,128,43,24,44,3666
"36047025000",322,78,26,8,1014,279,97,11,1835
"36047025100",215,57,1951,901,258,178,189,172,3921
"36047025200",2794,338,45,0,2293,449,998,96,7013
"36047025300",502,119,938,214,199,181,342,166,2661
"36047025400",1168,195,78,0,1793,638,588,141,4601
"36047025500",234,322,1563,874,1162,867,1457,1401,7880
"36047025600",1181,222,0,0,1575,275,266,47,3566
"36047025700",234,158,701,156,398,258,554,395,2854
"36047025800",2389,524,29,0,1199,447,711,111,5410
"36047025901",515,147,583,252,153,100,468,242,2460
"36047025902",182,271,980,1481,127,513,604,718,4876
"36047026000",1368,166,14,0,1585,557,278,76,4044
"36047026100",628,249,2625,765,330,249,430,342,5618
"36047026200",1149,68,4,0,986,281,286,3,2777
"36047026300",91,88,1470,261,54,63,76,187,2290
"36047026400",1641,502,0,19,1688,661,495,194,5200
"36047026500",281,44,2166,1029,201,205,120,109,4155
"36047026600",2129,154,0,18,1255,109,332,79,4076
"36047026700",410,102,1664,402,195,135,139,56,3103
"36047026800",2480,419,34,0,1288,95,890,0,5206
"36047026900",255,21,2024,175,4,0,120,60,2659
"36047027000",1310,263,0,0,502,109,138,76,2398
"36047027100",68,2,1647,481,249,66,139,12,2664
"36047027200",1517,321,0,0,1330,130,471,0,3769
"36047027300",209,2,1562,684,171,75,125,75,2903
"36047027400",1061,253,3,3,1311,172,63,49,2915
"36047027500",235,64,2499,774,437,156,295,102,4562
"36047027600",1087,217,0,12,1881,695,913,241,5046
"36047027700",103,13,2339,1655,209,51,372,66,4808
"36047027800",1426,228,0,12,755,399,203,9,3032
"36047027900",172,92,2957,335,174,87,294,81,4192
"36047028000",1026,12,6,1,497,100,115,39,1796
"36047028100",541,857,1806,941,328,461,743,1277,6954
"36047028200",1431,234,0,10,1022,363,101,17,3178
"36047028300",267,273,1075,937,563,465,797,836,5213
"36047028400",1998,410,0,23,1036,324,568,60,4419
"36047028501",100,34,0,4,177,0,184,0,499
"36047028502",552,279,906,658,238,100,964,432,4129
"36047028600",2275,277,161,0,1330,344,614,260,5261
"36047028700",519,75,1027,630,169,305,398,159,3282
"36047028800",1036,334,0,6,1129,402,220,184,3311
"36047028900",453,493,1193,870,414,114,661,829,5027
"36047029000",1977,610,21,14,853,324,138,327,4264
"36047029100",159,49,1885,528,174,119,280,160,3354
"36047029200",1098,246,0,19,730,180,365,60,2698
"36047029300",270,49,1663,689,406,98,716,129,4020
"36047029400",1278,312,65,29,390,157,144,84,2459
"36047029500",459,43,2607,385,220,141,485,2,4342
"36047029600",2666,496,135,0,817,262,187,85,4648
"36047029700",184,77,2020,1086,203,224,86,30,3910
"36047029800",2161,176,30,2,956,471,841,123,4760
"36047029900",35,21,1234,835,256,89,219,116,2805
"36047030000",1457,98,0,0,1410,283,316,113,3677
"36047030100",9,60,1781,453,108,114,51,53,2629
"36047030200",1222,217,32,0,2132,350,240,26,4219
"36047030300",12,21,2257,2458,25,304,260,377,5714
"36047030400",1647,422,19,19,1667,158,345,0,4277
"36047030500",1625,269,2332,487,1048,428,537,249,6975
"36047030600",1075,152,0,0,752,237,86,38,2340
"36047030700",29,25,2370,1202,160,283,381,405,4855
"36047030800",1509,146,5,0,279,96,369,36,2440
"36047030900",22,116,917,770,3,99,32,208,2167
"36047031100",93,142,2048,723,95,0,165,123,3389
"36047031300",374,37,2979,757,168,114,132,158,4719
"36047031400",2645,410,79,13,1134,119,371,24,4795
"36047031500",663,112,2576,1156,474,97,342,61,5481
"36047031701",321,78,1984,641,124,72,115,56,3391
"36047031702",338,120,1994,568,331,244,380,230,4205
"36047031900",465,70,2354,745,25,98,118,137,4012
"36047032100",493,149,4026,847,257,184,510,206,6672
"36047032300",368,65,2488,467,198,210,273,146,4215
"36047032500",170,284,3908,1661,66,207,229,232,6757
"36047032600",793,523,2048,1554,1059,838,557,628,8000
"36047032700",292,96,1475,479,247,35,288,32,2944
"36047032800",406,48,558,520,989,456,443,121,3541
"36047032900",1123,370,2802,656,675,51,592,37,6306
"36047033000",855,406,1129,672,404,426,689,304,4885
"36047033100",2115,554,1087,131,111,112,161,112,4383
"36047033300",2343,682,1384,167,124,129,99,146,5074
"36047033500",1372,458,661,134,368,0,286,43,3322
"36047033600",2924,422,311,35,396,127,476,55,4746
"36047033700",1425,325,1541,158,9,21,113,118,3710
"36047033900",617,54,2176,882,310,137,183,126,4485
"36047034000",408,560,474,273,213,109,291,319,2647
"36047034100",203,20,1630,232,136,15,188,23,2447
"36047034200",1160,804,1441,802,459,651,545,446,6308
"36047034300",248,97,2461,1314,750,274,798,325,6267
"36047034500",0,1,1540,616,109,101,92,119,2578
"36047034700",51,33,1687,957,100,161,222,176,3387
"36047034800",832,336,107,39,425,385,517,512,3153
"36047034900",144,179,3112,1488,354,382,203,459,6321
"36047035000",2223,525,0,0,110,21,0,0,2879
"36047035100",76,475,2701,452,252,603,324,277,5160
"36047035200",242,254,129,55,37,48,107,44,916
"36047035300",867,233,2524,705,510,143,533,245,5760
"36047035400",4669,489,47,0,0,0,52,0,5257
"36047035500",481,235,2862,701,338,174,374,274,5439
"36047035601",2223,333,12,0,0,0,53,0,2621
"36047035602",3868,684,102,2,1,0,16,0,4673
"36047035700",39,13,836,1042,111,256,148,299,2744
"36047035900",15,53,2467,2319,101,150,175,302,5582
"36047036001",1960,839,0,25,54,0,79,8,2965
"36047036002",1867,1322,0,0,128,0,101,0,3418
"36047036100",7,10,1254,565,252,206,271,186,2751
"36047036200",1422,1210,14,36,619,325,810,916,5352
"36047036300",48,57,2765,582,462,93,523,242,4772
"36047036400",980,503,23,23,582,168,149,261,2689
"36047036501",26,107,1792,452,192,0,173,0,2742
"36047036502",45,0,631,200,185,82,303,70,1516
"36047036600",1837,475,113,95,991,396,764,234,4905
"36047036700",68,33,547,77,372,66,389,88,1640
"36047036900",373,7,2310,1217,313,501,551,506,5778
"36047037000",2460,353,9,9,1152,86,145,118,4332
"36047037100",7,22,3231,770,172,66,404,68,4740
"36047037300",113,174,1970,631,383,391,399,551,4612
"36047037401",3189,425,89,0,452,144,152,35,4486
"36047037402",2783,526,166,0,454,37,127,0,4093
"36047037500",245,26,1998,459,153,10,418,35,3344
"36047037700",225,125,2660,575,264,164,351,182,4546
"36047037900",166,72,2494,900,101,50,154,144,4081
"36047038100",69,112,2398,1644,370,220,390,285,5488
"36047038200",885,381,1205,766,1127,1207,857,752,7180
"36047038300",196,18,3360,411,174,27,351,52,4589
"36047038500",99,230,2052,700,156,73,380,195,3885
"36047038600",1596,437,2,3,1271,275,450,142,4176
"36047038700",296,450,1519,771,456,75,529,491,4587
"36047038800",3034,484,2,12,239,389,127,131,4418
"36047038900",625,349,100,98,1112,658,1261,753,4956
"36047039000",1862,232,0,0,150,41,25,0,2310
"36047039100",672,290,51,77,1408,343,1571,531,4943
"36047039200",1855,223,45,0,118,123,179,11,2554
"36047039300",1532,288,1057,157,407,240,1753,556,5990
"36047039400",2011,156,0,0,228,21,152,14,2582
"36047039500",841,1205,941,161,161,246,915,1360,5830
"36047039600",1696,165,0,0,6,27,114,0,2008
"36047039700",477,297,1487,582,317,225,730,424,4539
"36047039800",1133,57,0,0,1029,165,328,54,2766
"36047039900",1134,200,1103,756,619,151,1672,502,6137
"36047040000",1152,212,11,0,1491,335,231,24,3456
"36047040100",568,106,1309,562,459,266,825,323,4418
"36047040200",1089,171,0,0,828,289,233,65,2675
"36047040300",435,197,1599,978,263,312,602,509,4895
"36047040400",1215,116,0,61,719,93,118,6,2328
"36047040500",245,104,645,153,265,41,584,97,2134
"36047040600",1156,131,19,0,1597,113,317,52,3385
"36047040700",0,0,0,0,0,0,0,0,0
"36047040800",1157,133,152,0,1414,301,50,13,3220
"36047040900",748,471,796,407,943,435,1746,845,6391
"36047041000",1279,64,0,0,344,43,416,20,2166
"36047041100",231,49,1040,523,672,583,813,576,4487
"36047041200",1740,237,17,0,626,35,483,55,3193
"36047041300",1126,246,1095,116,781,461,1839,704,6368
"36047041401",949,90,0,0,64,15,43,11,1172
"36047041402",1485,245,0,0,52,0,0,0,1782
"36047041500",1689,398,1872,264,340,113,2257,531,7464
"36047041600",1885,418,0,44,307,122,112,188,3076
"36047041700",1172,437,752,219,622,333,1716,717,5968
"36047041800",1611,257,0,0,46,0,56,55,2025
"36047041900",1147,409,813,220,524,614,1670,932,6329
"36047042000",1305,412,11,0,261,115,81,154,2339
"36047042100",1596,433,724,40,529,389,2031,685,6427
"36047042200",1862,274,66,46,638,72,284,57,3299
"36047042300",2092,886,593,0,453,279,2444,1092,7839
"36047042400",1606,357,71,0,942,106,249,29,3360
"36047042500",821,126,273,63,766,487,1286,539,4361
"36047042600",1748,283,159,0,1504,706,254,271,4925
"36047042700",1748,887,330,247,1544,1138,2624,1902,10420
"36047042800",2110,383,14,0,1071,215,248,25,4066
"36047042900",2042,590,470,263,1473,1316,3161,1862,11177
"36047043000",1477,345,0,0,969,239,345,23,3398
"36047043100",866,930,498,171,1755,1171,2258,1720,9369
"36047043200",2360,384,61,0,1352,350,771,88,5366
"36047043300",1790,492,730,140,615,717,2534,1163,8181
"36047043400",2098,226,40,74,795,327,265,0,3825
"36047043500",1547,836,1126,681,1019,398,2834,1592,10033
"36047043600",2315,837,0,2,927,195,267,67,4610
"36047043700",1808,619,949,763,1338,426,2678,1086,9667
"36047043800",1771,453,12,5,323,72,252,106,2994
"36047043900",1380,324,460,384,1413,349,2659,645,7614
"36047044000",1874,373,0,2,142,137,95,84,2707
"36047044100",1315,695,785,136,2500,1137,3569,1638,11775
"36047044200",2111,289,0,0,46,58,8,15,2527
"36047044300",2005,763,241,57,2522,917,3326,1455,11286
"36047044400",2346,497,9,0,276,0,213,11,3352
"36047044500",1322,859,348,40,1562,563,1527,1174,7395
"36047044600",889,167,2,2,575,170,103,66,1974
"36047044700",921,57,388,102,652,317,1319,351,4107
"36047044800",1375,180,41,0,221,10,109,10,1946
"36047044900",1033,262,690,407,553,151,847,251,4194
"36047045000",424,85,38,0,156,0,166,6,875
"36047045200",2323,102,0,0,37,37,65,13,2577
"36047045300",751,263,84,203,277,228,501,428,2735
"36047045400",1463,111,12,2,119,176,122,64,2069
"36047045600",1525,563,17,5,293,34,64,2,2503
"36047045800",1420,51,11,0,14,13,14,0,1523
"36047046000",1539,431,465,31,876,270,128,43,3783
"36047046201",1290,547,0,0,426,205,203,28,2699
"36047046202",1363,516,0,5,207,70,284,75,2520
"36047046400",1756,755,0,6,160,55,48,6,2786
"36047046800",1298,822,1,2,53,2,0,2,2180
"36047047000",1613,1341,14,0,30,0,27,4,3029
"36047047200",2182,899,0,0,0,5,8,0,3094
"36047047400",2279,338,0,0,129,28,100,0,2874
"36047047600",2617,932,0,1,0,47,51,1,3649
"36047047700",2355,361,105,3,322,38,215,199,3598
"36047047800",1800,1547,0,9,543,324,520,299,5042
"36047048000",1850,1067,3,38,292,371,162,381,4164
"36047048100",1722,498,42,8,322,80,806,120,3598
"36047048200",2098,1344,202,56,1072,815,252,75,5914
"36047048400",2756,1276,459,7,765,119,395,41,5818
"36047048500",1702,267,44,52,484,245,772,294,3860
"36047048600",852,437,36,0,1476,771,767,256,4595
"36047048800",1891,680,144,20,558,779,456,111,4639
"36047048900",713,526,1051,671,832,376,1738,945,6852
"36047049000",2249,1380,772,9,1362,345,792,156,7065
"36047049100",1292,517,928,103,2279,700,2054,476,8349
"36047049200",991,589,393,158,973,429,329,240,4102
"36047049300",2794,878,637,504,2318,645,4054,1367,13197
"36047049400",2381,705,401,107,1436,535,574,95,6234
"36047049500",2098,268,58,5,268,132,669,79,3577
"36047049600",1470,209,135,59,1958,284,702,147,4964
"36047049700",2205,270,2,1,296,38,237,11,3060
"36047049800",1790,368,193,38,1438,546,160,15,4548
"36047049900",1402,70,4,0,140,38,238,14,1906
"36047050000",2165,288,377,0,576,128,242,11,3787
"36047050100",2387,145,9,12,240,136,542,114,3585
"36047050202",1872,182,12,30,209,44,233,39,2621
"36047050300",2058,245,0,0,198,54,322,107,2984
"36047050400",2816,264,619,0,786,70,707,92,5354
"36047050500",1137,535,498,275,810,923,1255,972,6405
"36047050600",722,572,2100,399,1273,481,1234,951,7732
"36047050700",570,1433,71,18,272,71,373,305,3113
"36047050801",258,132,2299,667,560,218,830,144,5108
"36047050803",335,27,1364,363,25,127,86,157,2484
"36047050804",627,142,3098,590,1096,574,1223,383,7733
"36047050900",1555,1833,41,0,175,93,245,72,4014
"36047051001",69,158,2765,219,292,28,337,134,4002
"36047051002",645,64,2459,903,404,188,712,186,5561
"36047051100",1372,352,290,38,879,658,1088,598,5275
"36047051200",588,67,3598,577,821,371,1033,311,7366
"36047051300",2982,282,0,78,458,351,1390,378,5919
"36047051400",751,285,3231,824,1596,365,1520,494,9066
"36047051500",1096,66,5,0,212,16,364,28,1787
"36047051601",245,115,2874,1428,413,618,505,664,6862
"36047051602",124,50,1979,711,390,42,489,6,3791
"36047051700",1188,142,250,0,193,0,316,10,2099
"36047051800",840,131,1224,83,952,183,519,260,4192
"36047051900",2980,260,64,8,540,106,786,30,4774
"36047052000",1132,95,1082,110,1238,559,288,133,4637
"36047052300",3807,796,213,112,830,338,2930,1109,10135
"36047052500",1401,1504,104,25,159,103,737,257,4290
"36047052600",1755,322,1060,35,1177,188,1278,75,5890
"36047052700",2598,1854,193,172,1146,625,2226,2353,11167
"36047052800",982,35,249,0,710,141,218,0,2335
"36047052900",1668,2126,14,16,100,118,170,138,4350
"36047053000",1666,462,111,66,545,187,59,13,3109
"36047053100",4522,3688,0,0,33,1,568,0,8812
"36047053200",1501,132,178,17,504,235,182,19,2768
"36047053300",2564,4186,10,62,27,10,134,36,7029
"36047053400",1439,895,131,31,769,272,235,21,3793
"36047053500",1438,2219,0,0,309,85,375,85,4511
"36047053700",1356,1970,0,0,50,19,21,0,3416
"36047053800",2046,886,38,3,832,117,530,73,4525
"36047053900",1286,1409,113,20,16,14,307,29,3194
"36047054200",2974,770,45,41,237,227,170,76,4540
"36047054300",136,0,28,39,17,0,15,0,235
"36047054400",2243,326,0,0,276,27,0,0,2872
"36047054500",2279,3298,189,425,109,318,857,583,8058
"36047054600",3431,679,46,4,157,102,208,50,4677
"36047054700",1974,2185,205,85,536,96,773,450,6304
"36047054800",1656,297,9,1,412,83,33,1,2492
"36047054900",1730,1085,52,6,439,90,280,413,4095
"36047055000",2394,863,28,1,500,7,334,266,4393
"36047055100",3408,530,255,85,666,299,2101,544,7888
"36047055200",2072,277,22,2,624,298,154,21,3470
"36047055300",1804,217,70,13,546,86,259,154,3149
"36047055400",2489,443,36,40,554,134,408,165,4269
"36047055500",2550,229,189,65,616,140,596,123,4508
"36047055600",3025,404,12,3,207,12,86,14,3763
"36047055700",1464,245,11,0,184,21,282,23,2230
"36047055800",1667,291,0,0,320,0,202,12,2492
"36047056000",2381,491,0,5,99,107,94,17,3194
"36047056100",2408,260,22,0,171,51,191,20,3123
"36047056200",1353,176,0,0,111,43,0,0,1683
"36047056300",2362,543,51,99,716,462,686,343,5262
"36047056400",2168,73,40,0,219,0,191,0,2691
"36047056500",2412,256,36,0,412,13,337,21,3487
"36047056600",1612,173,43,15,819,176,177,2,3017
"36047056800",985,13,0,0,235,62,92,0,1387
"36047056900",1352,53,0,0,72,20,273,14,1784
"36047057000",2090,174,43,21,773,115,141,8,3365
"36047057100",3581,353,16,0,110,17,191,0,4268
"36047057200",578,1200,1248,1211,155,223,495,853,5963
"36047057300",1640,418,92,0,114,31,106,49,2450
"36047057400",1630,36,6,0,1118,52,123,5,2970
"36047057500",2068,644,0,6,983,110,613,97,4521
"36047057600",1654,323,18,0,1221,88,0,0,3304
"36047057800",1694,231,35,17,1027,87,178,1,3270
"36047057900",634,66,0,0,203,33,346,54,1336
"36047058000",1584,362,13,0,1386,279,553,30,4207
"36047058200",1427,161,0,0,810,487,254,0,3139
"36047058400",2383,379,34,28,628,54,108,6,3620
"36047058600",885,174,125,0,1237,200,269,59,2949
"36047058800",2184,504,79,7,548,259,311,84,3976
"36047058900",1406,166,2,0,309,16,27,16,1942
"36047059000",469,76,136,52,974,91,84,8,1890
"36047059100",2979,345,0,0,318,5,362,151,4160
"36047059200",2269,371,89,0,1196,230,129,6,4290
"36047059300",1349,172,0,0,147,39,140,132,1979
"36047059401",4193,690,98,2,2155,504,46,55,7743
"36047059402",3402,285,40,0,833,24,147,21,4752
"36047059600",2078,179,25,0,56,0,14,12,2364
"36047059800",2290,402,341,58,181,12,21,12,3317
"36047060000",4321,597,143,1,216,206,411,92,5987
"36047060600",1643,312,34,31,340,268,247,20,2895
"36047060800",2460,342,102,51,99,0,78,45,3177
"36047061002",3626,593,0,0,294,50,95,0,4658
"36047061003",605,300,129,0,614,156,200,61,2065
"36047061004",3838,1610,82,69,215,70,186,168,6238
"36047061200",795,209,0,0,0,0,0,0,1004
"36047061600",1345,297,34,41,0,10,18,33,1778
"36047062000",1915,158,0,0,22,0,28,0,2123
"36047062200",2533,307,116,51,70,55,212,82,3426
"36047062600",1369,321,35,16,540,338,169,159,2947
"36047062800",4806,406,20,0,143,0,278,117,5770
"36047063200",1165,112,10,1,165,3,150,1,1607
"36047063600",1033,88,0,0,115,0,136,0,1372
"36047063800",1274,6,2,0,413,0,64,0,1759
"36047064000",1638,83,0,0,67,233,103,0,2124
"36047064200",2330,129,0,0,155,32,62,19,2727
"36047064400",1901,240,0,11,342,37,226,70,2827
"36047064600",1848,259,184,0,127,0,336,110,2864
"36047064800",1032,41,503,50,243,0,255,0,2124
"36047065000",534,45,534,153,247,25,139,0,1677
"36047065200",975,55,48,0,291,0,19,0,1388
"36047065400",1279,177,0,0,173,0,100,0,1729
"36047065600",1381,95,26,0,350,20,200,0,2072
"36047065800",1846,73,4,0,218,16,91,8,2256
"36047066000",1610,82,3,4,191,0,281,24,2195
"36047066200",991,53,0,1,688,38,177,20,1968
"36047066600",0,0,0,0,0,0,0,0,0
"36047067000",714,106,1550,59,419,48,412,121,3429
"36047067200",213,96,1037,62,79,45,94,56,1682
"36047067400",604,6,823,52,222,276,253,225,2461
"36047067600",294,53,1660,16,26,0,165,42,2256
"36047067800",360,10,2056,71,37,1,58,1,2594
"36047068000",322,3,878,502,151,145,180,303,2484
"36047068200",590,4,1839,76,275,0,260,0,3044
"36047068600",669,79,458,0,240,8,52,8,1514
"36047068800",699,22,1021,80,5,0,233,13,2073
"36047069000",422,22,1086,16,51,1,222,11,1831
"36047069200",303,79,1839,56,125,16,176,39,2633
"36047069601",1933,592,1371,36,133,14,237,82,4398
"36047069602",4146,237,1234,0,640,17,933,34,7241
"36047069800",1181,212,0,0,81,0,81,0,1555
"36047070000",1815,26,0,1,0,0,18,0,1860
"36047070201",5401,583,215,0,41,0,171,17,6428
"36047070202",27,108,0,0,0,0,0,0,135
"36047070203",0,0,0,0,0,0,0,0,0
"36047070600",2724,11,44,0,6,0,202,0,2987
"36047072000",165,26,1643,198,121,0,15,0,2168
"36047072200",55,0,2583,298,98,18,77,5,3134
"36047072400",67,25,1911,46,21,6,57,2,2135
"36047072600",87,0,2232,77,18,0,21,0,2435
"36047072800",257,52,2871,194,193,15,245,0,3827
"36047073000",137,16,2119,109,227,5,139,0,2752
"36047073200",168,0,2355,327,14,0,113,0,2977
"36047073400",65,0,1847,102,262,26,235,0,2537
"36047073600",441,46,2061,335,472,170,233,27,3785
"36047073800",1401,39,1687,209,200,2,253,41,3832
"36047074000",363,170,2322,182,507,51,258,124,3977
"36047074200",1594,280,1394,42,230,55,180,114,3889
"36047074400",2167,110,45,99,174,2,69,4,2670
"36047074600",1221,148,428,6,168,74,133,42,2220
"36047074800",997,386,220,229,0,57,16,57,1962
"36047075000",1971,699,365,88,66,53,122,7,3371
"36047075200",829,129,22,0,0,0,0,0,980
"36047075400",1285,166,0,1,0,0,0,0,1452
"36047075600",1424,248,22,83,196,1,46,8,2028
"36047075800",1442,291,0,0,211,0,123,0,2067
"36047076000",1821,344,25,0,134,159,159,23,2665
"36047076200",1827,692,454,28,898,664,475,485,5523
"36047076400",938,271,1418,103,835,194,640,275,4674
"36047076600",273,27,1491,218,301,0,265,0,2575
"36047076800",2259,404,47,9,533,157,206,168,3783
"36047077000",387,24,1738,382,161,35,125,21,2873
"36047077200",1076,664,1257,367,241,44,254,29,3932
"36047077400",653,86,1406,202,269,222,371,67,3276
"36047077600",199,28,3043,440,349,11,279,13,4362
"36047078000",60,0,2139,103,31,0,109,0,2442
"36047078200",28,7,3233,562,183,0,90,0,4103
"36047078400",78,12,2290,88,247,0,114,0,2829
"36047078600",161,100,2887,509,924,161,652,29,5423
"36047078800",152,0,2146,838,225,73,290,73,3797
"36047079000",151,12,3681,664,498,224,157,202,5589
"36047079200",22,22,2777,765,193,69,200,82,4130
"36047079400",35,2,1387,362,155,71,53,71,2136
"36047079601",749,49,2768,377,389,84,280,137,4833
"36047079602",121,29,3272,788,378,254,390,361,5593
"36047079801",538,87,2069,262,192,71,193,51,3463
"36047079802",594,319,3104,887,402,16,355,0,5677
"36047080000",621,65,1869,946,287,29,68,70,3955
"36047080200",329,83,2769,895,332,385,408,387,5588
"36047080400",333,62,1465,654,370,41,319,10,3254
"36047080600",1227,45,2100,248,57,96,129,0,3902
"36047080800",16,67,97,332,108,227,44,128,1019
"36047081000",18,8,1618,293,130,42,83,0,2192
"36047081400",2,2,1735,445,172,13,155,20,2544
"36047081600",23,17,2044,463,249,61,210,44,3111
"36047081800",348,47,2511,1224,317,156,769,236,5608
"36047082000",91,58,3798,667,165,180,299,205,5463
"36047082200",200,312,4423,1234,456,54,472,330,7481
"36047082400",177,26,2969,672,315,54,421,70,4704
"36047082600",68,24,4222,1113,50,31,59,190,5757
"36047082800",143,43,2685,385,123,67,201,28,3675
"36047083000",111,1,5152,561,307,54,247,154,6587
"36047083200",177,0,1929,27,134,0,118,0,2385
"36047083400",10,113,1610,41,74,0,55,0,1903
"36047083600",21,14,1766,261,58,7,11,7,2145
"36047083800",75,7,2570,221,0,1,176,1,3051
"36047084000",83,3,2163,50,256,3,309,6,2873
"36047084600",32,30,1406,167,11,40,31,27,1744
"36047084800",1,2,1596,213,28,47,7,9,1903
"36047085000",23,0,1394,134,42,5,106,0,1704
"36047085200",0,0,8,0,0,0,0,0,8
"36047085400",14,17,1702,103,54,0,103,0,1993
"36047085600",63,0,3174,400,76,0,308,12,4033
"36047085800",66,0,2076,279,105,45,16,45,2632
"36047086000",0,8,2723,765,118,0,141,28,3783
"36047086200",0,0,2193,420,152,25,113,0,2903
"36047086400",0,0,2016,195,136,46,35,46,2474
"36047086600",54,22,2743,367,58,14,117,0,3375
"36047086800",74,141,2545,598,18,21,125,0,3522
"36047087000",2,1,2387,585,158,45,175,45,3398
"36047087200",22,0,2010,364,160,0,218,1,2775
"36047087401",100,215,2426,695,48,196,187,190,4057
"36047087600",349,24,1142,73,0,134,141,25,1888
"36047087800",0,92,2026,1215,31,110,98,167,3739
"36047088000",105,68,2410,325,46,0,97,137,3188
"36047088200",1,141,4938,1089,271,74,52,175,6741
"36047088400",83,22,3964,696,250,0,280,23,5318
"36047088600",0,21,3398,800,75,24,144,35,4497
"36047088800",70,0,3148,398,121,208,149,225,4319
"36047089000",126,58,3604,2456,140,219,143,484,7230
"36047089200",54,27,2518,1055,80,12,219,21,3986
"36047089400",208,4,2606,765,93,152,232,143,4203
"36047089600",46,0,2005,787,231,26,116,47,3258
"36047089800",104,16,1282,535,71,32,152,32,2224
"36047090000",129,113,3382,1177,390,369,490,567,6617
"36047090200",66,131,1768,1287,194,238,183,567,4434
"36047090600",197,175,1668,1363,534,430,676,670,5713
"36047090800",62,188,1427,1592,191,229,312,462,4463
"36047091000",147,462,1566,3130,162,414,319,1020,7220
"36047091200",96,287,2648,2117,421,618,563,913,7663
"36047091600",26,53,2418,1049,50,230,45,273,4144
"36047091800",86,190,1522,702,270,251,519,719,4259
"36047092000",66,20,1957,955,110,57,193,86,3444
"36047092200",0,170,2426,185,36,0,30,170,3017
"36047092400",24,0,1960,837,35,0,114,75,3045
"36047092800",0,11,2151,331,107,19,62,7,2688
"36047093000",6,1,2222,210,100,6,13,0,2558
"36047093200",25,0,1306,24,9,7,45,0,1416
"36047093400",72,5,2349,129,14,0,113,0,2682
"36047093600",8,0,1824,83,135,0,14,0,2064
"36047093800",12,27,1639,536,0,15,0,15,2244
"36047094401",37,0,3181,523,24,0,16,0,3781
"36047094402",236,131,1571,776,52,20,211,76,3073
"36047094600",142,54,1681,72,86,44,140,0,2219
"36047095000",36,5,2832,296,23,41,56,41,3330
"36047095400",57,8,4115,255,46,0,80,0,4561
"36047095600",293,10,3763,404,211,181,352,46,5260
"36047095800",111,16,2497,254,468,27,358,24,3755
"36047096000",0,0,0,0,0,0,0,0,0
"36047096200",109,9,1182,174,140,2,181,2,1799
"36047096400",207,0,1432,326,510,28,446,36,2985
"36047096600",264,0,1353,266,529,0,377,32,2821
"36047096800",259,17,1094,176,69,42,62,23,1742
"36047097000",305,16,1069,266,126,7,221,62,2072
"36047097400",80,131,2038,326,264,149,146,197,3331
"36047098200",73,267,1790,1139,370,399,472,654,5164
"36047098400",50,0,1434,427,32,0,56,0,1999
"36047098600",89,0,2980,112,112,44,192,13,3542
"36047098800",305,92,2252,415,110,10,250,6,3440
"36047099000",36,10,978,232,203,7,0,0,1466
"36047099200",120,23,1232,166,78,46,112,0,1777
"36047099400",119,0,1670,118,25,129,0,166,2227
"36047099600",122,0,3302,241,69,0,67,0,3801
"36047099800",200,0,3447,416,91,0,122,0,4276
"36047100400",175,0,2297,265,120,0,64,0,2921
"36047100600",143,10,2212,129,185,0,151,0,2830
"36047100800",298,98,1344,135,97,126,111,14,2223
"36047101000",138,4,1802,173,236,100,107,16,2576
"36047101200",109,31,1561,186,286,33,99,0,2305
"36047101400",74,22,1725,267,133,9,45,0,2275
"36047101600",73,0,1330,32,36,0,0,0,1471
"36047101800",63,0,1378,38,90,0,62,0,1631
"36047102000",134,17,1723,96,49,35,58,0,2112
"36047102200",150,11,1399,75,169,139,13,24,1980
"36047102400",115,0,1492,33,85,67,28,67,1887
"36047102600",94,56,2588,197,5,0,39,37,3016
"36047102800",22,34,1102,129,116,21,15,31,1470
"36047103400",431,374,1355,1015,226,263,340,438,4442
"36047105801",1712,629,2597,972,390,407,903,430,8040
"36047105804",1234,961,2289,712,554,358,1001,575,7684
"36047107000",135,23,471,62,19,10,131,12,863
"36047107800",139,0,3341,201,151,25,312,25,4194
"36047109800",100,60,1481,267,93,56,110,50,2217
"36047110400",129,18,3329,775,491,199,538,231,5710
"36047110600",389,88,2345,1333,350,73,886,184,5648
"36047111000",190,105,1376,1363,319,9,608,169,4139
"36047111600",426,131,1345,1124,59,4,499,98,3686
"36047111800",452,84,1142,1014,59,0,473,84,3308
"36047112000",360,364,2303,552,108,195,769,705,5356
"36047112200",154,58,1677,824,110,138,318,131,3410
"36047112400",21,46,2265,1089,3,42,41,93,3600
"36047112600",383,47,1844,903,203,263,489,364,4496
"36047112800",163,96,2205,696,332,308,424,403,4627
"36047113000",131,158,2128,1464,228,320,464,562,5455
"36047113200",318,75,1391,173,75,116,653,166,2967
"36047113400",289,234,798,711,215,395,677,675,3994
"36047114201",875,92,573,3,229,39,892,105,2808
"36047114202",151,349,735,306,464,118,719,552,3394
"36047114400",119,295,1328,691,156,192,326,479,3586
"36047114600",510,278,785,115,586,386,1093,627,4380
"36047115000",140,74,974,517,517,314,648,268,3452
"36047115200",188,182,1002,1045,487,115,608,297,3924
"36047115600",187,123,955,1870,636,440,847,795,5853
"36047115800",489,235,1353,420,270,53,833,284,3937
"36047116000",57,29,983,626,286,329,434,358,3102
"36047116200",63,13,1400,472,101,21,179,79,2328
"36047116400",147,245,2138,446,187,53,452,298,3966
"36047116600",271,345,1276,760,206,88,487,429,3862
"36047116800",512,280,359,249,201,108,574,320,2603
"36047117000",260,110,520,159,541,314,683,327,2914
"36047117201",640,60,353,49,1073,255,1610,278,4318
"36047117202",1398,453,1027,186,302,92,1608,634,5700
"36047117400",1640,787,661,120,522,97,2035,707,6569
"36047117601",1467,506,563,181,329,91,1684,602,5423
"36047117602",1011,510,409,226,614,243,1419,690,5122
"36047117800",175,254,322,136,316,68,394,254,1919
"36047118000",0,0,0,0,0,0,0,0,0
"36047118201",1011,409,405,401,666,165,1493,544,5094
"36047118202",1139,511,440,320,229,146,1278,726,4789
"36047118400",2005,688,732,323,1010,471,2243,766,8238
"36047118600",1144,447,488,268,426,194,1208,554,4729
"36047118800",698,507,1183,934,562,379,935,536,5734
"36047119000",605,482,366,339,278,196,645,588,3499
"36047119200",755,860,584,651,576,43,1200,899,5568
"36047119400",375,378,2195,792,113,0,660,378,4891
"36047119600",493,522,2231,892,719,197,797,514,6365
"36047119800",308,233,881,647,762,145,935,353,4264
"36047120000",293,274,741,244,59,501,409,396,2917
"36047120200",316,505,502,63,560,163,374,554,3037
"36047120800",742,391,5082,1709,517,45,1175,491,10152
"36047121000",286,1141,1233,1181,233,150,652,1429,6305
"36047121400",473,645,1546,1130,209,199,656,810,5668
"36047122000",449,50,3035,1221,428,225,727,384,6519
"36047123700",2205,3631,174,23,545,179,1058,175,7990
"36047150200",2019,65,61,6,718,20,383,28,3300
"36047152200",1578,164,1111,21,701,173,128,121,3997
"36047990100",0,0,0,0,0,0,0,0,0
"36049950100",2043,225,0,0,5,21,24,21,2339
"36049950200",3901,662,15,6,43,4,79,0,4710
"36049950300",6328,892,60,5,187,45,101,61,7679
"36049950400",2415,303,26,0,41,0,10,0,2795
"36049950500",2027,307,18,0,16,0,0,11,2379
"36049950600",1447,355,8,18,23,8,30,0,1889
"36049950700",4426,754,76,8,25,9,20,8,5326
"36051030100",3828,253,71,7,51,21,32,0,4263
"36051030201",3696,1099,38,4,148,167,95,26,5273
"36051030202",5122,326,81,0,151,53,35,66,5834
"36051030300",3041,223,23,0,67,0,53,44,3451
"36051030400",2401,754,12,0,190,70,56,35,3518
"36051030500",0,0,0,0,0,0,0,0,0
"36051030600",3383,362,0,0,230,43,19,11,4048
"36051030700",7107,504,7,0,97,9,36,0,7760
"36051030800",4227,476,22,0,127,198,55,207,5312
"36051030900",1969,606,45,16,77,8,142,160,3023
"36051031000",12,5,1,6,5,0,1,2,32
"36051031100",4060,508,24,0,131,39,0,31,4793
"36051031200",3270,579,0,5,72,4,57,0,3987
"36051031300",3694,609,0,1,34,23,24,0,4385
"36051031400",3711,879,7,67,14,0,83,34,4795
"36053030101",2186,545,18,4,68,19,0,9,2849
"36053030102",3423,839,9,0,129,15,23,51,4489
"36053030103",3294,166,52,0,144,20,117,0,3793
"36053030200",3000,213,0,30,36,108,0,0,3387
"36053030300",4692,581,114,50,141,38,46,0,5662
"36053030401",6430,736,0,0,19,0,90,113,7388
"36053030402",2834,208,0,0,14,0,25,0,3081
"36053030403",4465,448,1,5,53,0,82,5,5059
"36053030501",2287,266,0,0,14,0,26,0,2593
"36053030502",3555,91,0,0,47,11,20,0,3724
"36053030600",6203,678,5,1,268,163,63,0,7381
"36053030700",4694,492,0,70,94,6,26,67,5449
"36053030800",3036,513,33,0,37,11,0,0,3630
"36053030900",1464,313,8,8,147,0,0,0,1940
"36053031000",4553,595,18,0,172,0,119,0,5457
"36053031100",1942,325,0,0,29,6,0,7,2309
"36055000200",147,341,354,942,230,438,45,525,3022
"36055000700",170,176,638,541,213,211,216,382,2547
"36055001000",2236,255,208,107,60,27,67,45,3005
"36055001300",200,128,437,732,143,247,274,441,2602
"36055001500",76,24,341,272,54,249,152,286,1454
"36055001800",2575,409,645,340,693,451,630,202,5945
"36055001900",1198,272,981,99,154,133,430,156,3423
"36055002000",1688,334,845,593,424,106,237,168,4395
"36055002100",1223,139,1621,440,247,15,421,93,4199
"36055002200",482,238,378,602,442,287,189,86,2704
"36055002300",625,460,972,968,426,677,242,358,4728
"36055002400",660,441,644,916,221,90,275,247,3494
"36055002700",2,7,611,604,24,23,0,49,1320
"36055002900",2566,632,169,66,276,59,69,62,3899
"36055003000",1049,321,265,180,168,45,37,75,2140
"36055003100",3530,526,155,11,119,35,159,18,4553
"36055003200",815,327,120,339,37,77,79,41,1835
"36055003300",982,308,75,199,6,22,17,9,1618
"36055003400",1352,345,283,279,125,51,26,24,2485
"36055003500",878,134,38,79,69,14,83,5,1300
"36055003600",1966,226,114,249,152,37,151,70,2965
"36055003700",2204,230,113,113,78,133,69,133,3073
"36055003802",0,0,0,0,0,0,0,0,0
"36055003805",2296,936,390,446,560,299,205,45,5177
"36055003900",151,255,698,309,203,314,295,506,2731
"36055004000",397,383,273,469,125,152,206,408,2413
"36055004100",226,203,139,275,139,109,187,144,1422
"36055004602",575,316,800,379,202,29,417,116,2834
"36055004701",1069,260,984,359,396,103,620,255,4046
"36055004702",482,133,458,322,467,253,532,441,3088
"36055004800",176,238,564,598,271,344,333,524,3048
"36055004900",222,117,734,528,260,176,386,291,2714
"36055005000",168,188,442,243,311,406,210,481,2449
"36055005100",168,58,523,442,157,101,284,174,1907
"36055005200",310,66,304,888,63,78,322,112,2143
"36055005300",240,211,686,444,52,322,283,403,2641
"36055005400",1379,168,1632,384,309,356,455,450,5133
"36055005500",107,313,731,446,399,219,371,463,3049
"36055005600",178,269,594,809,249,245,367,176,2887
"36055005700",51,119,360,883,127,237,52,93,1922
"36055005800",892,247,1484,1101,508,151,510,227,5120
"36055005900",171,237,488,220,142,201,231,160,1850
"36055006000",2127,272,309,139,132,27,220,75,3301
"36055006100",1970,186,126,0,80,9,33,1,2405
"36055006200",361,159,1825,657,30,11,48,75,3166
"36055006300",317,189,1920,685,53,78,92,233,3567
"36055006400",93,27,1222,1013,32,65,14,67,2533
"36055006500",55,97,787,752,23,21,69,58,1862
"36055006600",93,92,959,603,59,307,18,211,2342
"36055006700",288,174,2084,478,293,18,183,40,3558
"36055006800",687,73,1486,418,139,57,96,8,2964
"36055006900",162,72,870,733,89,50,43,17,2036
"36055007000",820,239,1160,226,182,109,65,17,2818
"36055007100",673,105,1656,532,79,61,155,42,3303
"36055007500",462,104,1170,1134,187,54,183,313,3607
"36055007600",2048,206,379,132,82,213,228,177,3465
"36055007700",1830,172,246,107,97,68,0,66,2586
"36055007801",2096,255,42,23,71,69,111,0,2667
"36055007802",1173,48,155,5,52,2,8,2,1445
"36055007900",203,214,365,693,158,167,241,480,2521
"36055008000",199,126,738,542,185,394,285,192,2661
"36055008100",1298,412,1180,312,535,272,1097,436,5542
"36055008200",860,249,1292,194,565,98,765,125,4148
"36055008301",1770,376,1141,413,596,124,1303,241,5964
"36055008400",512,318,1217,255,499,205,909,354,4269
"36055008500",2432,748,81,43,62,146,358,84,3954
"36055008600",3546,325,411,57,102,0,507,63,5011
"36055008701",1473,482,988,281,670,64,425,112,4495
"36055008702",308,177,398,171,52,103,130,6,1345
"36055008800",647,541,764,224,194,144,204,466,3184
"36055009200",168,381,315,274,67,168,267,478,2118
"36055009301",254,573,646,948,254,296,336,804,4111
"36055009302",763,190,191,307,121,36,42,26,1676
"36055009400",839,882,359,647,76,211,129,189,3332
"36055009500",1027,219,959,773,114,108,87,80,3367
"36055009601",180,45,613,474,32,5,96,27,1472
"36055009602",292,72,310,698,77,291,146,95,1981
"36055009603",395,236,341,540,178,382,159,268,2499
"36055009604",315,446,134,93,53,88,98,327,1554
"36055010100",3223,264,34,21,66,0,226,8,3842
"36055010200",3620,198,23,0,157,0,63,0,4061
"36055010300",3688,65,24,2,39,21,15,7,3861
"36055010400",3730,437,382,321,396,14,326,63,5669
"36055010500",4247,98,94,0,103,40,268,0,4850
"36055010601",1951,219,167,55,149,39,145,105,2830
"36055010602",3165,261,131,2,154,17,169,17,3916
"36055010700",3137,265,26,50,78,0,369,9,3934
"36055010800",2645,140,153,11,28,0,270,0,3247
"36055010901",1992,512,1039,631,290,223,584,337,5608
"36055010902",2136,402,390,79,171,0,156,35,3369
"36055011000",3749,311,397,3,395,33,452,33,5373
"36055011100",3207,145,317,142,379,49,161,0,4400
"36055011201",3145,140,52,0,47,0,60,10,3454
"36055011203",1782,38,39,5,29,8,56,0,1957
"36055011205",4675,84,32,0,258,41,73,0,5163
"36055011207",4387,289,36,6,159,0,103,24,5004
"36055011208",4298,348,78,0,373,0,29,0,5126
"36055011301",7488,166,0,0,200,11,46,0,7911
"36055011302",5404,209,39,14,124,0,139,1,5930
"36055011400",6401,1588,259,0,602,104,235,138,9327
"36055011501",5762,179,83,4,257,0,241,3,6529
"36055011503",5367,107,104,21,115,28,114,29,5885
"36055011504",5681,203,102,17,397,0,83,0,6483
"36055011505",5338,224,198,3,192,0,109,0,6064
"36055011601",5029,380,111,12,250,83,57,30,5952
"36055011603",991,165,10,0,85,24,77,33,1385
"36055011604",1997,79,37,2,185,0,50,1,2351
"36055011605",1925,74,27,5,67,0,184,0,2282
"36055011703",7721,240,60,33,421,81,355,2,8913
"36055011705",4767,326,18,7,225,0,1,0,5344
"36055011706",4177,230,100,2,181,0,62,1,4753
"36055011707",6428,340,19,1,151,8,13,1,6961
"36055011708",3017,123,96,0,195,0,24,0,3455
"36055011800",4664,211,0,3,315,5,66,42,5306
"36055011901",4716,637,17,77,431,34,147,3,6062
"36055011902",5442,403,137,61,68,0,27,4,6142
"36055012000",2185,552,22,43,27,18,84,13,2944
"36055012100",3006,272,188,109,137,29,70,65,3876
"36055012201",3146,166,209,9,111,18,38,29,3726
"36055012202",3011,257,71,1,87,0,21,0,3448
"36055012301",5122,486,85,22,354,0,71,2,6142
"36055012304",3908,21,67,1,406,0,34,2,4439
"36055012305",3451,10,56,2,810,0,265,7,4601
"36055012306",3919,119,123,22,797,70,65,2,5117
"36055012401",2864,213,0,0,30,0,62,0,3169
"36055012402",5798,66,15,0,203,0,71,0,6153
"36055012500",4096,145,122,0,220,0,31,0,4614
"36055012600",3905,227,116,0,359,38,142,0,4787
"36055012700",3086,248,144,4,189,45,155,0,3871
"36055012800",3589,190,134,126,670,13,267,9,4998
"36055012900",3945,214,242,31,620,32,13,7,5104
"36055013001",2339,684,238,19,1230,683,41,0,5234
"36055013002",4405,333,97,15,1084,241,271,16,6462
"36055013101",4843,592,444,0,427,52,277,216,6851
"36055013103",1108,686,122,0,58,205,64,238,2481
"36055013104",2851,597,683,20,589,76,142,19,4977
"36055013203",4499,256,590,173,298,5,199,139,6159
"36055013204",6213,398,543,160,816,91,137,28,8386
"36055013205",2872,569,441,37,200,274,0,51,4444
"36055013206",3782,686,526,0,838,105,163,26,6126
"36055013300",3189,146,0,9,55,0,76,1,3476
"36055013401",2889,259,554,168,127,16,197,17,4227
"36055013402",2883,133,147,0,114,0,26,0,3303
"36055013503",4943,120,142,1,342,8,195,0,5751
"36055013505",3075,321,85,42,155,108,292,0,4078
"36055013506",7478,388,658,0,405,0,269,19,9217
"36055013507",5939,98,3,0,32,0,0,0,6072
"36055013508",3606,158,96,0,164,0,74,0,4098
"36055013601",4112,263,210,54,188,14,255,54,5150
"36055013603",4948,206,87,0,154,14,194,0,5603
"36055013604",3678,268,549,116,329,17,50,97,5104
"36055013701",1959,102,33,0,86,0,6,0,2186
"36055013702",3268,140,35,0,0,14,277,15,3749
"36055013800",4186,1495,142,104,352,390,457,316,7442
"36055013901",3394,105,76,79,404,0,179,0,4237
"36055013902",2444,380,420,511,202,1,175,126,4259
"36055014001",3971,303,276,105,294,12,167,40,5168
"36055014003",3997,257,140,0,168,20,152,47,4781
"36055014004",2634,241,376,0,169,71,326,63,3880
"36055014102",2847,206,194,10,118,115,190,142,3822
"36055014103",3802,184,75,0,106,0,95,20,4282
"36055014104",2913,240,33,274,179,124,217,124,4104
"36055014202",4974,336,668,7,141,163,62,0,6351
"36055014203",5026,518,375,139,672,64,218,334,7346
"36055014204",1952,81,214,11,40,11,46,0,2355
"36055014301",2315,297,206,2,197,9,276,7,3309
"36055014302",3772,276,599,41,540,26,334,55,5643
"36055014400",3607,121,526,82,274,27,148,16,4801
"36055014501",3693,141,250,8,70,20,68,2,4252
"36055014503",2672,193,553,6,85,1,121,69,3700
"36055014504",4344,95,717,2,175,0,14,0,5347
"36055014505",4077,347,128,26,278,122,96,101,5175
"36055014601",4574,119,386,63,112,0,181,0,5435
"36055014602",3628,406,683,118,227,11,227,153,5453
"36055014700",4083,252,146,72,177,20,98,88,4936
"36055014802",4375,652,113,0,53,0,131,53,5377
"36055014803",3072,240,1,0,71,0,50,12,3446
"36055014804",6608,421,5,24,59,0,228,2,7347
"36055014901",4695,327,115,3,227,0,242,65,5674
"36055014903",4515,75,199,0,307,52,47,69,5264
"36055014905",5030,138,165,0,216,0,313,12,5874
"36055014906",2909,409,81,0,99,12,46,0,3556
"36055015000",5240,237,80,2,82,56,254,0,5951
"36055015101",4110,367,125,63,116,66,22,3,4872
"36055015102",3719,292,0,4,146,0,133,50,4344
"36055015200",5893,564,0,32,65,8,85,29,6676
"36055015301",329,162,0,34,32,0,0,0,557
"36055015303",2371,341,39,76,176,26,42,0,3071
"36055015304",2880,1073,63,0,308,95,148,63,4630
"36055015400",3319,311,0,28,60,0,37,28,3783
"36055980000",0,0,0,0,0,0,0,0,0
"36055980100",4,0,0,0,3,0,0,0,7
"36055990000",0,0,0,0,0,0,0,0,0
"36057070200",1225,432,10,0,112,290,161,421,2651
"36057070300",870,555,9,31,276,149,403,264,2557
"36057070400",1561,139,40,0,77,18,146,0,1981
"36057070500",2176,211,0,3,366,0,455,91,3302
"36057070600",1424,444,28,55,254,90,673,256,3224
"36057070700",1900,299,16,12,314,59,295,96,2991
"36057070800",1603,631,143,99,387,220,496,473,4052
"36057070900",743,265,114,66,280,200,442,370,2480
"36057072100",4773,600,31,2,87,18,160,106,5777
"36057072200",3131,399,16,22,248,0,161,0,3977
"36057072300",2517,515,10,2,59,30,26,30,3189
"36057072400",1633,826,0,0,9,13,12,10,2503
"36057072500",2829,1240,0,0,87,71,19,57,4303
"36057072600",3172,339,16,26,80,31,59,0,3723
"36057072700",3629,424,22,15,55,0,34,5,4184
"36057072800",3382,337,35,2,145,9,60,7,3977
"36059300100",4013,175,10,47,77,17,41,18,4398
"36059300300",3307,347,49,0,382,51,302,4,4442
"36059300400",4637,322,104,0,829,0,229,0,6121
"36059300500",4459,181,42,3,709,0,192,0,5586
"36059300600",4536,193,53,17,1658,103,258,12,6830
"36059300700",4481,214,60,13,1120,51,672,17,6628
"36059300800",2405,7,340,0,1168,0,178,0,4098
"36059300900",5245,87,37,16,2035,91,92,5,7608
"36059301000",4904,58,27,3,364,32,201,2,5591
"36059301101",4568,241,97,3,1444,231,1379,233,8196
"36059301102",3876,48,192,1,516,37,442,0,5112
"36059301200",5078,314,3,0,366,76,1003,161,7001
"36059301300",3203,81,321,92,955,82,1074,119,5927
"36059301400",1865,33,0,0,147,0,78,0,2123
"36059301500",2895,61,0,0,345,15,127,10,3453
"36059301600",3740,384,19,2,538,14,171,134,5002
"36059301700",2495,36,0,0,146,6,90,0,2773
"36059301800",2568,385,522,108,1359,8,1083,190,6223
"36059301900",2710,11,0,0,279,0,158,0,3158
"36059302000",3928,142,107,0,516,114,154,43,5004
"36059302101",3510,118,7,0,348,41,36,0,4060
"36059302102",2627,190,0,1,559,25,167,0,3569
"36059302200",2273,115,280,72,1527,9,735,14,5025
"36059302300",2348,44,0,9,1945,6,103,0,4455
"36059302400",3835,138,0,0,1277,10,348,51,5659
"36059302501",1906,72,0,0,657,0,50,0,2685
"36059302502",1878,13,25,2,631,32,103,35,2719
"36059302600",1788,51,153,0,441,12,588,0,3033
"36059302700",2420,47,70,0,1690,201,166,0,4594
"36059302800",3485,30,0,0,2270,67,755,0,6607
"36059302900",3101,125,28,2,975,70,452,42,4795
"36059303000",3551,177,0,0,1913,41,492,0,6174
"36059303101",1980,46,55,0,1553,77,292,0,4003
"36059303102",2402,20,56,0,1822,22,193,0,4515
"36059303201",1699,13,110,9,1948,31,297,0,4107
"36059303202",2452,151,14,2,1163,74,620,74,4550
"36059303301",2386,114,0,0,940,0,336,101,3877
"36059303302",3413,125,10,3,294,0,232,8,4085
"36059303400",2456,31,0,0,83,0,122,0,2692
"36059303500",4130,210,8,0,972,270,651,313,6554
"36059303600",5030,234,134,39,1376,188,1799,211,9011
"36059303700",5573,83,88,0,473,14,802,35,7068
"36059303800",4069,167,166,80,950,168,565,41,6206
"36059303900",1677,25,1902,75,183,25,489,27,4403
"36059304001",2287,57,24,0,240,0,56,0,2664
"36059304002",2584,98,199,22,1387,68,1156,77,5591
"36059304100",549,108,1478,40,1785,256,1538,217,5971
"36059304202",1244,72,668,0,1280,126,1590,130,5110
"36059304203",599,253,3222,312,1503,103,1585,373,7950
"36059304204",200,100,961,309,1987,843,2098,917,7415
"36059404300",1909,63,22,19,1169,14,294,3,3493
"36059404400",4555,175,29,1,120,9,300,29,5218
"36059404500",3310,91,232,3,603,0,396,48,4683
"36059404600",3815,76,0,0,445,0,215,0,4551
"36059404700",4317,77,80,0,1684,138,1144,138,7578
"36059404800",1852,25,2340,328,2342,73,1855,29,8844
"36059404901",392,43,3579,51,886,45,313,45,5354
"36059404902",388,152,1869,125,1558,338,720,349,5499
"36059405000",1467,24,2341,25,2176,179,1306,176,7694
"36059405100",1421,98,4659,26,1440,269,1121,113,9147
"36059405200",2268,97,1902,297,2343,514,1586,463,9470
"36059405301",2519,311,97,0,645,75,387,39,4073
"36059405302",3074,133,55,0,816,70,528,62,4738
"36059405400",4545,194,812,166,2422,19,1278,120,9556
"36059405500",4809,169,44,0,493,24,674,24,6237
"36059405600",3487,75,33,1,430,0,539,0,4565
"36059405700",3917,116,206,0,588,114,703,51,5695
"36059405800",3253,46,41,0,547,68,432,0,4387
"36059405900",3781,53,367,0,754,0,605,0,5560
"36059406001",2962,407,212,1,918,345,503,155,5503
"36059406002",2282,65,292,0,386,0,383,27,3435
"36059406100",2151,52,188,20,248,62,275,17,3013
"36059406201",1137,157,870,71,706,42,833,73,3889
"36059406202",580,38,4064,176,508,324,663,350,6703
"36059406300",3531,200,0,5,295,86,219,0,4336
"36059406400",5971,139,0,0,122,20,187,0,6439
"36059406501",6183,173,20,12,178,0,237,0,6803
"36059406600",3738,164,0,0,476,48,167,0,4593
"36059406701",675,212,669,253,861,211,1123,325,4329
"36059406702",1629,170,1300,867,660,467,1337,441,6871
"36059406801",530,239,1078,309,1693,168,2151,394,6562
"36059406802",395,48,1285,76,1991,662,2287,626,7370
"36059406900",759,297,2896,815,1687,765,2077,722,10018
"36059407000",179,34,2896,1170,2144,450,2031,321,9225
"36059407101",281,275,2977,207,1161,199,1301,459,6860
"36059407102",891,0,3272,132,1047,354,1605,354,7655
"36059407201",1033,331,990,736,2035,652,2723,602,9102
"36059407203",283,147,1824,232,1051,47,1356,0,4940
"36059407204",536,198,1157,95,508,116,581,151,3342
"36059407301",1404,136,456,39,192,28,59,38,2352
"36059407302",1433,245,1640,130,1101,189,1773,124,6635
"36059407401",1433,100,2770,280,1062,165,1930,225,7965
"36059407402",291,68,1706,86,617,402,662,417,4249
"36059407501",491,55,2345,93,1523,344,1665,364,6880
"36059407502",1035,20,2751,333,895,55,1499,0,6588
"36059407600",3870,109,151,0,1182,129,536,22,5999
"36059407700",3798,120,227,2,788,53,565,49,5602
"36059407801",4083,183,21,0,1242,119,1058,118,6824
"36059407802",482,29,0,0,139,52,38,0,740
"36059407900",3639,129,402,24,887,213,265,64,5623
"36059408000",5153,120,18,0,738,0,594,32,6655
"36059408100",5563,93,69,179,792,0,487,0,7183
"36059408200",5326,89,132,0,854,19,831,3,7254
"36059408300",5471,99,104,0,1071,96,830,89,7760
"36059408400",3108,40,201,2,270,5,312,14,3952
"36059408500",5713,32,119,1,240,216,252,0,6573
"36059408600",3849,80,41,0,718,0,648,44,5380
"36059408700",4287,91,91,0,568,0,752,0,5789
"36059408800",6164,83,13,0,883,29,816,29,8017
"36059408900",4906,76,17,12,584,152,563,30,6340
"36059409000",5062,88,39,1,770,0,728,6,6694
"36059409100",4602,55,11,0,658,0,558,0,5884
"36059409200",4955,282,0,0,870,0,990,19,7116
"36059409300",3947,80,0,0,169,0,231,0,4427
"36059409400",3735,120,33,2,762,93,608,0,5353
"36059409500",3902,62,0,0,224,0,124,0,4312
"36059409600",4650,89,21,1,280,0,450,0,5491
"36059409700",3753,45,11,0,252,61,227,7,4356
"36059409800",708,106,3991,167,622,0,560,4,6158
"36059409900",2295,98,3721,101,1550,66,1280,33,9144
"36059410000",1341,104,836,205,803,7,313,0,3609
"36059410100",5260,16,129,0,402,0,263,0,6070
"36059410200",3514,113,9,0,148,0,389,7,4180
"36059410300",2341,45,1606,157,1755,201,1584,135,7824
"36059410400",939,6,2105,344,2171,164,1828,70,7627
"36059410500",3331,85,1496,28,1962,817,1756,494,9969
"36059410600",3587,231,712,0,2057,196,1553,196,8532
"36059410700",3881,658,214,45,1630,101,1791,352,8672
"36059410800",3173,67,394,10,941,61,861,10,5517
"36059410900",2339,213,1892,109,1746,120,904,1,7324
"36059411000",2265,224,465,333,1446,313,1762,320,7128
"36059411100",784,114,1230,390,1738,465,2041,540,7302
"36059411200",5717,166,0,0,513,192,647,79,7314
"36059411301",2955,171,256,0,488,0,37,43,3950
"36059411302",6481,8,28,0,214,0,196,0,6927
"36059411400",5178,482,34,72,637,0,178,41,6622
"36059411500",2617,47,9,0,86,10,108,0,2877
"36059411600",6208,175,14,2,104,1,255,0,6759
"36059411700",6123,109,4,5,294,140,243,0,6918
"36059411800",5133,163,264,0,579,0,578,0,6717
"36059411901",2776,123,64,0,438,0,510,0,3911
"36059411902",2843,149,63,0,501,0,422,20,3998
"36059412000",5080,518,345,2,419,0,965,172,7501
"36059412100",5617,197,30,34,304,0,606,62,6850
"36059412200",5292,56,0,0,0,0,281,0,5629
"36059412301",2593,180,24,8,285,1,271,74,3436
"36059412302",2640,147,142,115,445,0,401,59,3949
"36059412400",3908,119,596,195,129,195,294,286,5722
"36059412500",4069,99,0,0,223,10,238,0,4639
"36059412600",3209,231,34,0,192,0,160,1,3827
"36059412700",3907,52,0,0,41,0,255,0,4255
"36059412800",2323,86,382,0,307,0,656,10,3764
"36059412900",1090,61,3077,169,909,81,857,97,6341
"36059413001",3112,249,1,11,354,0,253,31,4011
"36059413002",3223,133,0,0,236,0,115,0,3707
"36059413100",4471,63,43,2,502,7,678,0,5766
"36059413200",5173,320,247,0,96,0,507,44,6387
"36059413300",5865,146,0,2,325,0,573,22,6933
"36059413400",4954,188,40,1,150,68,412,0,5813
"36059413500",3524,252,2232,15,1113,39,1674,113,8962
"36059413600",2974,257,1018,183,810,253,1310,266,7071
"36059413700",3977,380,586,8,691,30,962,335,6969
"36059413803",2161,130,1437,6,480,44,637,0,4895
"36059413804",2286,152,702,0,499,5,604,10,4258
"36059413900",741,384,3645,965,952,254,1461,542,8944
"36059414001",251,21,2549,214,961,39,893,39,4967
"36059414002",795,180,2547,418,1068,47,1624,222,6901
"36059414100",1148,82,3313,142,1101,3,1434,7,7230
"36059414201",2151,443,1241,123,1330,621,2473,802,9184
"36059414202",1110,53,1819,133,1117,277,1986,315,6810
"36059414301",1030,226,272,164,1126,345,1295,529,4987
"36059414303",1779,18,1669,45,683,405,1172,415,6186
"36059414304",1245,411,545,49,968,434,1922,476,6050
"36059414400",951,248,1975,244,1049,850,1253,969,7539
"36059414501",3425,108,1137,128,614,78,1304,98,6892
"36059414502",2522,59,524,14,702,118,882,126,4947
"36059414600",2985,122,6,0,406,1,200,1,3721
"36059414700",4368,150,11,0,141,0,131,0,4801
"36059414800",5688,132,3,0,686,22,715,11,7257
"36059414900",5629,553,189,3,618,224,920,83,8219
"36059415000",4932,142,319,1,645,52,854,1,6946
"36059415101",2249,68,20,2,105,13,62,34,2553
"36059415102",4767,33,37,0,121,0,40,0,4998
"36059415201",3353,44,8,1,317,1,311,26,4061
"36059415202",3718,127,0,0,119,0,254,0,4218
"36059415300",5490,78,34,0,415,0,459,45,6521
"36059415401",5031,107,37,0,244,1,241,1,5662
"36059415402",4301,46,0,4,334,0,272,0,4957
"36059415500",2469,109,1,0,0,0,45,0,2624
"36059415600",4896,335,0,2,407,3,89,0,5732
"36059415700",5236,70,1,22,361,0,328,0,6018
"36059415802",7029,100,46,0,140,4,404,0,7723
"36059416000",3615,89,2,0,212,0,215,2,4135
"36059416100",6098,219,0,0,136,0,478,16,6947
"36059416201",3535,118,59,18,268,29,586,39,4652
"36059416202",3158,286,24,2,827,213,1002,180,5692
"36059416300",3534,127,46,0,49,0,155,5,3916
"36059416401",3332,207,10,0,16,0,81,9,3655
"36059416402",2212,41,65,77,172,22,256,22,2867
"36059416500",3164,281,469,670,1459,389,1837,439,8708
"36059416600",4489,217,100,66,400,10,643,8,5933
"36059416701",2960,164,82,2,757,228,917,225,5335
"36059416702",2960,441,117,0,497,48,451,341,4855
"36059416801",1920,0,0,0,178,11,100,0,2209
"36059416802",3438,419,0,0,174,0,174,24,4229
"36059416900",3870,18,0,2,161,0,278,0,4329
"36059517000",2358,118,117,11,258,12,203,22,3099
"36059517101",2729,203,334,171,1538,447,1637,532,7591
"36059517102",2063,13,3,0,127,0,231,0,2437
"36059517200",3189,788,572,334,2453,829,2553,1089,11807
"36059517301",2164,280,30,0,197,4,309,161,3145
"36059517302",3401,140,289,0,899,267,837,265,6098
"36059517400",4343,165,226,11,211,0,340,0,5296
"36059517500",3478,56,46,0,224,0,105,48,3957
"36059517600",4313,68,24,10,233,25,604,25,5302
"36059517701",5857,206,188,41,1396,67,319,58,8132
"36059517705",2370,26,86,9,389,0,44,6,2930
"36059517801",3236,127,46,13,166,24,156,9,3777
"36059517802",2944,62,57,0,174,14,303,0,3554
"36059517901",4515,108,0,5,112,13,306,0,5059
"36059517902",2546,207,24,1,81,25,68,15,2967
"36059518000",5082,208,316,16,426,40,704,40,6832
"36059518100",2424,95,0,2,168,0,132,0,2821
"36059518201",3739,72,14,9,386,8,143,2,4373
"36059518203",2996,57,8,0,410,47,46,5,3569
"36059518204",3930,105,61,2,249,1,68,1,4417
"36059518300",4182,227,0,0,1261,92,346,27,6135
"36059518400",3288,25,0,3,1002,0,226,0,4544
"36059518501",3814,175,111,32,2255,0,58,0,6445
"36059518502",1879,37,51,0,1049,150,108,0,3274
"36059518600",2948,1,0,0,975,2,63,1,3990
"36059518700",3537,218,17,74,1626,31,252,0,5755
"36059518800",2510,7,14,9,650,36,162,10,3398
"36059518900",4282,251,491,4,1633,40,1046,236,7983
"36059519000",4432,176,210,3,1631,171,525,70,7218
"36059519100",4645,142,87,0,1341,0,1341,0,7556
"36059519200",4082,255,144,24,1403,43,546,59,6556
"36059519300",3471,352,68,39,1630,21,791,42,6414
"36059519400",3625,60,12,0,752,75,335,9,4868
"36059519500",4382,169,11,0,1580,2,438,2,6584
"36059519601",3439,109,0,6,850,36,261,27,4728
"36059519602",1927,24,0,0,176,0,70,0,2197
"36059519702",4891,137,41,0,442,0,236,0,5747
"36059519703",3063,0,0,0,515,15,141,15,3749
"36059519704",2595,68,5,3,395,14,115,0,3195
"36059519801",1876,21,0,0,520,0,124,0,2541
"36059519802",3907,225,80,0,555,9,171,33,4980
"36059519900",4834,74,15,2,370,10,321,0,5626
"36059520001",6010,202,0,0,631,0,429,0,7272
"36059520002",3810,161,1,2,467,19,437,0,4897
"36059520100",4906,212,8,0,335,0,173,50,5684
"36059520200",2607,8,0,2,649,0,271,0,3537
"36059520300",5332,238,46,0,190,0,536,0,6342
"36059520401",3004,123,56,0,461,4,292,0,3940
"36059520402",3756,252,22,7,334,11,832,141,5355
"36059520501",3236,131,10,0,258,27,235,70,3967
"36059520502",4586,106,103,0,146,30,203,0,5174
"36059520600",5179,107,159,0,558,0,753,0,6756
"36059520700",4438,179,111,0,80,0,302,0,5110
"36059520800",3640,274,0,1,94,1,241,21,4272
"36059520900",4374,112,29,0,197,0,322,0,5034
"36059521000",4663,198,0,0,164,0,179,36,5240
"36059521100",4366,133,0,0,73,8,163,8,4751
"36059521200",2931,60,2,2,134,9,246,0,3384
"36059521301",2181,28,8,2,158,0,200,0,2577
"36059521302",5257,91,0,0,28,0,185,45,5606
"36059521400",6265,100,0,0,17,2,164,2,6550
"36059521500",4296,91,12,0,112,0,316,0,4827
"36059521601",4407,61,0,0,34,1,218,1,4722
"36059521602",3326,37,11,0,36,0,414,0,3824
"36059521700",4132,168,3,0,294,11,234,12,4854
"36059521801",3152,48,204,0,49,0,111,0,3564
"36059521802",3799,155,34,0,34,0,176,0,4198
"36059521902",4175,36,1,1,33,1,108,1,4356
"36059522000",2909,253,2239,125,1526,286,2225,426,9989
"36059522700",4866,59,0,0,147,1,237,0,5310
"36059980100",0,0,0,0,0,0,0,0,0
"36059981100",0,0,0,0,0,0,0,0,0
"36059982100",0,0,0,0,0,0,0,0,0
"36059990100",0,0,0,0,0,0,0,0,0
"36059990200",0,0,0,0,0,0,0,0,0
"36059990301",0,0,0,0,0,0,0,0,0
"36059990302",0,0,0,0,0,0,0,0,0
"36059990400",0,0,0,0,0,0,0,0,0
"36061000100",0,0,0,0,0,0,0,0,0
"36061000201",347,326,63,136,1039,910,591,336,3748
"36061000202",2983,817,662,329,2481,728,2920,846,11766
"36061000500",0,0,0,0,0,0,0,0,0
"36061000600",591,553,290,541,6197,3180,1951,1063,14366
"36061000700",5043,497,165,2,1695,318,367,74,8161
"36061000800",591,187,153,1,6059,3374,264,38,10667
"36061000900",841,71,9,17,192,8,125,9,1272
"36061001001",1254,88,28,10,364,5,375,5,2129
"36061001002",1186,673,949,591,2121,881,2522,1367,10290
"36061001200",1900,201,133,7,943,305,800,219,4508
"36061001300",2595,207,113,56,714,91,271,74,4121
"36061001401",2353,83,145,2,566,81,435,0,3665
"36061001402",911,254,93,1,1221,578,709,338,4105
"36061001501",3140,254,172,27,1378,239,389,19,5618
"36061001502",4072,339,196,15,1291,192,390,13,6508
"36061001600",888,78,44,0,4411,2815,216,41,8493
"36061001800",2137,391,76,105,3532,1586,654,241,8722
"36061002000",806,430,615,271,1132,1541,1575,1441,7811
"36061002100",4578,24,151,15,1105,78,218,2,6171
"36061002201",1845,256,738,118,2594,1192,1994,752,9489
"36061002202",1192,101,65,37,576,266,148,64,2449
"36061002400",985,294,552,448,2115,1381,2037,1075,8887
"36061002500",532,428,297,191,1849,1731,1102,882,7012
"36061002601",1436,304,198,253,1249,324,1163,338,5265
"36061002602",2014,205,139,48,1875,239,938,143,5601
"36061002700",159,31,12,4,830,155,11,0,1202
"36061002800",2279,848,640,127,1894,1493,2200,1441,10922
"36061002900",247,13,54,1,3166,1013,34,33,4561
"36061003001",2313,397,56,7,1285,243,387,353,5041
"36061003002",1686,230,243,74,665,133,526,137,3694
"36061003100",1058,42,59,24,335,77,98,53,1746
"36061003200",5069,512,154,70,1285,298,501,162,8051
"36061003300",4167,218,0,47,702,40,291,30,5495
"36061003400",4725,743,61,45,773,359,951,219,7876
"36061003601",1360,141,207,160,708,723,801,400,4500
"36061003602",1369,291,204,318,382,197,230,165,3156
"36061003700",1791,189,4,0,254,47,98,15,2398
"36061003800",5036,737,427,64,1229,742,649,115,8999
"36061003900",3599,289,130,29,1151,55,494,84,5831
"36061004000",5692,853,343,41,997,157,604,162,8849
"36061004100",1964,213,90,26,3716,1367,147,4,7527
"36061004200",2134,164,101,30,465,159,121,47,3221
"36061004300",2355,336,2,3,1045,526,372,55,4694
"36061004400",12388,1316,519,2,3018,467,1123,114,18947
"36061004500",659,14,1,2,125,39,20,0,860
"36061004700",1685,241,0,0,341,0,79,11,2357
"36061004800",4820,394,143,69,1306,53,320,95,7200
"36061004900",4232,161,149,0,396,13,196,23,5170
"36061005000",3936,361,0,0,666,31,143,53,5190
"36061005200",2287,112,8,38,671,93,135,13,3357
"36061005400",3433,258,0,10,718,65,283,65,4832
"36061005501",3746,148,100,0,656,11,26,0,4687
"36061005502",1632,183,41,69,404,54,222,15,2620
"36061005600",1633,308,96,113,453,15,303,81,3002
"36061005700",2332,117,32,0,419,37,89,51,3077
"36061005800",1910,144,35,63,969,43,65,45,3274
"36061005900",3650,340,55,42,543,33,126,27,4816
"36061006000",3541,195,278,0,950,322,345,73,5704
"36061006100",2658,298,0,12,383,89,147,20,3607
"36061006200",1494,367,221,286,772,496,397,127,4160
"36061006300",4738,271,39,6,875,52,306,42,6329
"36061006400",4968,737,123,26,1337,127,437,87,7842
"36061006500",4008,457,113,28,640,32,205,95,5578
"36061006600",6831,823,631,66,2641,434,1866,438,13730
"36061006700",4040,271,155,1,501,16,210,0,5194
"36061006800",4207,383,149,256,833,103,454,98,6483
"36061006900",1854,111,82,10,217,48,136,12,2470
"36061007000",5926,467,108,0,1471,330,265,93,8660
"36061007100",4210,335,12,35,832,71,131,51,5677
"36061007200",5456,470,59,53,1353,93,548,16,8048
"36061007300",4482,189,116,75,715,38,442,1,6058
"36061007400",2460,290,12,64,739,103,331,0,3999
"36061007500",3854,220,49,24,178,62,397,4,4788
"36061007600",1067,168,66,11,743,148,83,24,2310
"36061007700",4326,310,135,0,586,47,388,0,5792
"36061007800",5277,577,98,3,1338,87,680,23,8083
"36061007900",3855,178,33,0,311,29,306,0,4712
"36061008000",3692,304,60,14,656,154,350,14,5244
"36061008100",6643,442,155,45,1250,96,884,109,9624
"36061008200",2196,179,391,23,584,28,245,43,3689
"36061008300",2108,303,355,110,844,480,779,226,5205
"36061008400",804,74,67,9,614,158,102,7,1835
"36061008601",1744,111,57,0,527,112,140,0,2691
"36061008602",0,0,0,0,0,0,0,0,0
"36061008603",4137,85,14,0,165,22,274,22,4719
"36061008700",5242,195,117,0,1088,29,1016,25,7712
"36061008800",4796,412,80,0,1621,55,447,8,7419
"36061008900",3665,347,246,178,748,59,490,270,6003
"36061009000",4844,338,80,87,1482,195,442,96,7564
"36061009100",4108,638,95,63,1190,321,338,284,7037
"36061009200",1392,41,28,32,214,33,118,45,1903
"36061009300",6640,298,568,1021,638,540,1611,366,11682
"36061009400",25,0,0,0,4,0,0,0,29
"36061009500",1467,95,55,2,540,153,83,0,2395
"36061009600",107,0,0,0,36,10,8,0,161
"36061009700",2705,327,376,36,1045,209,918,226,5842
"36061009800",5647,229,72,62,1055,40,399,49,7553
"36061009900",2166,135,83,31,964,51,243,0,3673
"36061010000",1152,99,44,3,515,14,302,27,2156
"36061010100",668,16,70,34,284,33,107,0,1212
"36061010200",278,20,2,6,7,0,29,4,346
"36061010300",1106,117,149,12,419,56,74,14,1947
"36061010400",687,128,8,3,197,8,141,13,1185
"36061010601",6290,122,113,32,563,118,457,0,7695
"36061010602",3576,190,262,0,745,0,248,0,5021
"36061010800",6517,277,232,0,1134,64,548,1,8773
"36061010900",128,13,0,8,11,22,0,3,185
"36061011000",6774,141,49,61,564,48,486,0,8123
"36061011100",2126,242,284,92,927,282,591,315,4859
"36061011201",725,20,17,0,65,0,27,0,854
"36061011202",260,5,0,0,14,0,4,0,283
"36061011203",794,149,0,30,183,20,116,8,1300
"36061011300",49,21,3,13,81,0,0,19,186
"36061011401",1031,54,14,3,112,6,0,2,1222
"36061011402",2160,76,29,0,321,15,98,0,2699
"36061011500",1194,230,201,88,670,96,439,143,3061
"36061011600",2304,117,383,1,812,0,136,9,3762
"36061011700",1673,165,253,1,646,200,490,174,3602
"36061011800",7925,679,35,3,917,79,488,0,10126
"36061011900",278,232,208,190,73,98,40,195,1314
"36061012000",3209,205,0,45,181,10,120,116,3886
"36061012100",5527,694,469,143,1416,117,1264,104,9734
"36061012200",3078,54,0,0,48,0,120,15,3315
"36061012400",6685,563,531,23,1585,55,433,97,9972
"36061012500",1189,233,62,52,699,204,108,45,2592
"36061012600",9508,357,117,57,923,27,622,5,11616
"36061012700",3792,500,293,87,1365,400,1288,217,7942
"36061012800",5298,295,10,0,129,0,228,27,5987
"36061012900",3243,209,176,217,1103,341,543,221,6053
"36061013000",3303,85,0,11,263,12,52,5,3731
"36061013100",1621,239,137,21,331,140,244,150,2883
"36061013200",7963,666,47,0,816,77,499,157,10225
"36061013300",3472,372,104,180,1041,194,894,182,6439
"36061013400",8358,1199,2,53,720,142,514,164,11152
"36061013500",3106,515,688,152,1102,393,1676,609,8241
"36061013600",12632,463,241,1,1475,121,1189,1,16123
"36061013700",4777,500,45,16,1033,186,292,15,6864
"36061013800",10192,857,113,17,919,168,699,125,13090
"36061013900",6007,369,337,23,726,127,687,75,8351
"36061014000",6719,436,59,0,691,40,429,102,8476
"36061014200",3564,257,9,10,514,0,226,71,4651
"36061014300",0,1,0,1,0,1,0,2,5
"36061014401",4185,207,30,0,412,35,244,12,5125
"36061014402",6056,252,174,46,679,0,253,38,7498
"36061014500",3540,427,124,26,789,19,391,135,5451
"36061014601",3140,165,68,24,470,102,173,95,4237
"36061014602",6068,402,69,50,1301,14,398,26,8328
"36061014700",1544,48,39,130,771,42,112,61,2747
"36061014801",2257,65,85,0,282,8,73,8,2778
"36061014802",5899,251,107,1,519,230,208,37,7252
"36061014900",4504,221,58,41,509,50,365,45,5793
"36061015001",1716,110,102,0,203,30,18,0,2179
"36061015002",4973,294,6,3,149,0,449,39,5913
"36061015100",4065,338,943,296,1384,1079,1249,940,10294
"36061015200",4090,735,743,134,1154,221,1052,569,8698
"36061015300",7516,372,194,3,669,162,975,21,9912
"36061015400",10673,801,478,23,1638,231,1560,383,15787
"36061015500",7705,198,172,0,1550,119,340,5,10089
"36061015601",4007,416,316,42,739,14,548,184,6266
"36061015602",768,141,267,157,577,305,590,398,3203
"36061015700",9187,458,51,46,596,48,614,12,11012
"36061015801",4482,221,261,59,221,51,220,105,5620
"36061015802",2055,185,132,10,1075,64,392,77,3990
"36061015900",6320,775,136,5,1046,175,259,99,8815
"36061016001",3184,114,2,45,266,45,309,7,3972
"36061016002",1880,115,59,1,483,62,410,54,3064
"36061016100",5085,351,84,0,897,50,232,0,6699
"36061016200",1548,626,3366,1316,1013,1182,2338,1658,13047
"36061016300",5727,386,53,52,1072,82,281,62,7715
"36061016400",1987,355,1371,233,2037,596,2325,906,9810
"36061016500",5921,254,278,24,566,19,615,93,7770
"36061016600",2644,1118,1077,208,1620,932,2631,1568,11798
"36061016700",5445,446,99,17,687,11,433,13,7151
"36061016800",1324,426,658,683,867,270,1480,655,6363
"36061016900",6241,389,253,78,500,34,542,88,8125
"36061017000",2156,389,1722,436,1912,1322,2477,1335,11749
"36061017100",7303,443,616,311,752,56,737,140,10358
"36061017200",1907,423,1541,382,1132,299,2425,553,8662
"36061017300",6526,247,689,313,1381,26,1435,103,10720
"36061017401",1085,305,1138,469,1075,517,1225,993,6807
"36061017402",495,149,949,305,609,155,644,160,3466
"36061017500",8368,275,176,86,1380,44,1001,41,11371
"36061017700",4414,574,1555,377,1098,495,1250,699,10462
"36061017800",1265,335,447,333,1021,564,1337,666,5968
"36061017900",6989,791,374,204,821,173,525,305,10182
"36061018000",983,900,1804,736,2387,739,2624,1331,11504
"36061018100",5171,525,1716,225,881,157,1350,37,10062
"36061018200",815,537,969,650,2171,889,2480,1124,9635
"36061018300",6546,473,420,190,1499,114,1343,260,10845
"36061018400",1347,437,1862,1225,2209,979,2969,1096,12124
"36061018500",3147,209,616,42,855,86,464,3,5422
"36061018600",553,412,2387,1733,684,917,945,1293,8924
"36061018700",6118,320,398,578,963,303,781,579,10040
"36061018800",1016,920,937,245,1725,688,2323,1119,8973
"36061018900",3071,1557,3075,1441,1748,931,2537,2503,16863
"36061019000",514,85,1347,461,518,29,309,68,3331
"36061019100",6794,328,861,222,1193,179,1032,117,10726
"36061019200",230,212,672,979,952,936,1063,1203,6247
"36061019300",3148,1408,1053,999,2263,886,2701,2186,14644
"36061019400",457,294,1183,1517,1179,1431,1531,1620,9212
"36061019500",4931,714,511,0,972,310,1337,193,8968
"36061019600",357,193,530,287,1288,1332,1439,1453,6879
"36061019701",489,100,66,11,63,215,52,80,1076
"36061019702",595,67,862,177,238,181,261,280,2661
"36061019800",524,28,1237,98,141,53,193,77,2351
"36061019900",4190,792,179,162,1275,752,846,143,8339
"36061020000",616,35,1479,245,546,12,307,48,3288
"36061020101",427,121,64,3,74,13,23,1,726
"36061020102",1188,126,1532,573,651,52,782,134,5038
"36061020300",386,199,162,45,168,108,103,18,1189
"36061020500",1849,83,42,20,421,19,226,39,2699
"36061020600",273,69,1202,690,269,103,308,151,3065
"36061020701",1321,277,66,11,500,486,191,61,2913
"36061020800",830,203,1954,1062,645,459,188,435,5776
"36061020901",364,184,1681,713,618,492,899,698,5649
"36061021000",222,297,4297,1481,751,429,738,1029,9244
"36061021100",3290,405,1832,377,2574,950,1399,827,11654
"36061021200",241,20,2711,152,586,63,521,88,4382
"36061021303",728,269,2070,929,1255,549,1130,774,7704
"36061021400",200,59,1829,508,179,56,59,10,2900
"36061021500",452,128,1439,420,448,331,473,403,4094
"36061021600",1383,373,4538,1024,733,321,832,237,9441
"36061021703",0,0,0,0,0,0,0,0,0
"36061021800",1442,378,2769,1729,463,220,447,294,7742
"36061021900",209,379,1158,866,1760,1558,1770,1702,9402
"36061022000",732,103,2839,1477,879,293,655,309,7287
"36061022102",492,81,1130,246,256,61,160,18,2444
"36061022200",697,65,987,868,243,88,246,108,3302
"36061022301",1764,494,480,477,3525,1539,4435,1776,14490
"36061022302",558,162,901,485,684,620,1098,1019,5527
"36061022400",514,153,2252,1885,1229,856,1453,848,9190
"36061022500",3131,363,1884,1436,2277,1045,4688,1610,16434
"36061022600",430,63,1928,1110,434,322,308,303,4898
"36061022700",744,221,2460,787,851,428,896,639,7026
"36061022800",867,126,2635,751,600,303,300,402,5984
"36061022900",1506,706,2370,505,1953,1366,3032,1866,13304
"36061023000",1274,298,4714,1381,1289,631,2128,617,12332
"36061023100",1594,544,1693,567,1346,312,1493,643,8192
"36061023200",304,293,4532,1798,690,657,1489,1042,10805
"36061023300",1618,367,2446,252,981,763,1787,1013,9227
"36061023400",621,197,2074,1031,1148,125,1218,275,6689
"36061023501",796,127,2697,656,1128,1095,1116,1101,8716
"36061023502",221,72,967,446,271,35,302,59,2373
"36061023600",324,0,4515,1213,554,190,906,230,7932
"36061023700",1412,479,1888,718,2364,906,3528,1305,12600
"36061023801",4666,263,1042,244,2514,419,1323,85,10556
"36061023802",876,133,26,92,186,67,37,93,1510
"36061023900",380,241,1120,182,243,93,634,343,3236
"36061024000",68,352,77,645,32,166,59,357,1756
"36061024100",1261,213,2492,422,2205,1062,2618,1291,11564
"36061024200",320,196,1208,672,457,658,696,823,5030
"36061024301",486,504,1217,630,731,380,953,1097,5998
"36061024302",517,646,2626,1777,636,611,1594,1321,9728
"36061024500",3310,1475,1564,848,6226,2636,9377,4037,29473
"36061024700",1781,670,1052,264,2790,1530,3770,2197,14054
"36061024900",159,45,87,23,504,211,631,210,1870
"36061025100",394,397,310,197,1200,85,1399,389,4371
"36061025300",2619,849,1106,314,4560,1686,6223,2376,19733
"36061025500",1975,494,230,98,1559,664,1917,783,7720
"36061025700",1160,33,1702,527,665,259,518,291,5155
"36061025900",856,210,1345,563,622,313,720,586,5215
"36061026100",2120,1098,999,553,6100,2459,8103,3842,25274
"36061026300",1691,913,533,254,3837,1720,5051,2679,16678
"36061026500",2559,448,658,16,2817,609,3463,939,11509
"36061026700",459,325,69,79,531,78,714,201,2456
"36061026900",1593,687,570,210,3926,1800,5690,2317,16793
"36061027100",3868,727,358,190,2732,1495,4469,1983,15822
"36061027300",4215,738,501,48,1370,364,1799,180,9215
"36061027500",2603,109,184,9,389,19,493,0,3806
"36061027700",1306,396,277,258,2207,1698,3382,2174,11698
"36061027900",2967,750,867,158,5483,1445,6817,2098,20585
"36061028100",2468,157,78,7,195,11,355,8,3279
"36061028300",3079,580,537,155,2331,659,3853,874,12068
"36061028500",1562,611,609,186,4080,1056,5358,1606,15068
"36061028700",1373,468,220,28,1641,511,1845,884,6970
"36061029100",1701,554,642,245,6376,2647,8015,3315,23495
"36061029300",2150,951,430,119,3826,1510,5610,2454,17050
"36061029500",2931,470,337,103,2850,807,3225,961,11684
"36061029700",0,0,0,0,0,0,0,0,0
"36061029900",766,360,787,245,1384,742,2115,1116,7515
"36061030300",1816,251,204,161,627,993,1132,1252,6436
"36061030700",2545,59,196,180,611,50,1015,213,4869
"36061030900",1639,766,1436,1005,2820,1345,4276,2453,15740
"36061031100",0,0,0,0,0,0,0,0,0
"36061031703",5996,254,47,0,2337,36,1069,0,9739
"36061031704",4153,212,75,0,2112,58,949,0,7559
"36061031900",0,0,0,0,0,0,0,0,0
"36063020100",2677,694,47,41,65,31,56,0,3611
"36063020200",69,277,1034,1115,49,88,3,83,2718
"36063020300",1491,230,254,76,74,92,0,99,2316
"36063020400",554,141,598,264,0,16,28,0,1601
"36063020500",1012,569,374,313,36,22,27,9,2362
"36063020600",284,136,435,391,33,0,8,0,1287
"36063020700",1562,213,658,163,0,112,0,78,2786
"36063020900",784,386,551,751,50,88,21,119,2750
"36063021000",1400,540,431,190,27,141,6,36,2771
"36063021100",449,194,313,125,148,20,0,0,1249
"36063021200",844,406,626,160,29,49,99,18,2231
"36063021300",865,397,293,246,176,122,55,0,2154
"36063021400",1187,206,250,75,39,115,8,3,1883
"36063021700",1868,645,469,166,84,38,64,0,3334
"36063022000",2467,683,64,32,5,34,66,38,3389
"36063022100",2062,444,56,173,52,37,0,94,2918
"36063022200",3216,359,296,9,102,0,31,15,4028
"36063022300",2479,59,21,23,131,1,0,0,2714
"36063022401",1635,132,59,0,21,0,33,0,1880
"36063022500",2231,269,14,12,92,25,25,0,2668
"36063022601",2012,277,68,53,152,21,93,0,2676
"36063022602",4494,634,261,0,320,2,40,0,5751
"36063022702",6169,60,177,0,21,13,0,0,6440
"36063022711",9270,473,92,13,186,0,276,0,10310
"36063022712",6667,650,41,15,432,22,201,7,8035
"36063022803",3366,114,72,0,54,0,136,0,3742
"36063022804",3289,103,10,0,0,72,48,9,3531
"36063022901",1757,306,0,0,0,0,19,0,2082
"36063022902",2800,258,21,1,51,0,38,20,3189
"36063023001",1736,264,50,0,49,0,111,0,2210
"36063023100",2027,350,0,10,10,0,79,26,2502
"36063023200",2054,602,42,2,2,0,41,18,2761
"36063023300",5268,1154,0,100,371,87,56,23,7059
"36063023401",5815,547,97,83,93,54,209,0,6898
"36063023402",3630,227,22,15,126,35,92,16,4163
"36063023404",4348,247,281,36,72,50,55,49,5138
"36063023405",2871,600,26,23,330,41,119,18,4028
"36063023500",1461,303,204,393,17,85,53,56,2572
"36063023600",2470,642,254,62,250,105,83,0,3866
"36063023700",857,504,259,190,201,80,143,7,2241
"36063023800",2491,401,81,156,49,130,128,49,3485
"36063023901",3171,617,84,158,62,7,40,0,4139
"36063023902",4097,260,68,0,396,0,189,24,5034
"36063024001",4906,631,34,0,400,0,9,0,5980
"36063024002",1505,165,0,0,26,0,7,0,1703
"36063024101",3422,418,0,0,0,41,35,42,3958
"36063024102",2388,281,1,5,58,40,139,39,2951
"36063024201",5711,561,12,4,80,54,0,0,6422
"36063024202",2591,321,0,8,19,13,34,3,2989
"36063024301",1010,184,0,0,4,0,0,0,1198
"36063024302",4366,325,0,16,15,36,19,24,4801
"36063024303",5207,172,119,2,253,0,192,33,5978
"36063024401",2303,246,0,0,40,0,13,2,2604
"36063024404",4357,167,36,7,52,0,0,0,4619
"36063024405",5041,153,0,0,119,0,156,0,5469
"36063024406",1958,64,0,0,35,0,44,7,2108
"36063024501",2663,149,40,0,19,0,74,5,2950
"36063024502",3370,283,30,8,124,0,53,67,3935
"36063024600",4333,301,83,1,45,1,0,0,4764
"36063940001",61,3,0,0,704,223,3,5,999
"36063940100",0,0,0,0,0,0,0,0,0
"36063990000",0,0,0,0,0,0,0,0,0
"36065020102",522,216,108,71,59,108,60,31,1175
"36065020300",221,408,193,118,167,82,18,122,1329
"36065020705",1533,320,158,0,87,39,101,13,2251
"36065020802",2290,660,344,204,236,259,249,470,4712
"36065020803",664,793,116,103,347,828,169,568,3588
"36065020900",940,502,266,263,91,48,15,64,2189
"36065021000",482,332,125,65,147,195,122,193,1661
"36065021101",311,136,97,31,141,179,76,32,1003
"36065021102",784,286,227,284,379,581,36,232,2809
"36065021103",798,315,153,26,95,46,108,82,1623
"36065021201",579,267,212,105,334,94,229,81,1901
"36065021202",957,241,186,156,679,549,219,59,3046
"36065021301",2068,245,52,413,50,16,0,13,2857
"36065021302",2572,733,121,42,285,155,366,152,4426
"36065021303",2434,110,13,0,29,7,50,7,2650
"36065021401",1325,594,292,432,351,224,85,185,3488
"36065021402",863,330,217,372,64,129,59,126,2160
"36065021500",388,221,539,323,350,369,130,188,2508
"36065021601",3931,599,203,106,182,96,244,349,5710
"36065021602",1992,87,49,0,121,10,50,0,2309
"36065021701",2894,171,73,0,167,0,106,0,3411
"36065021702",2118,205,210,91,155,158,108,102,3147
"36065021900",1503,344,73,5,83,81,119,68,2276
"36065022000",1975,1180,135,41,153,163,143,45,3835
"36065022100",2311,199,0,0,43,7,44,20,2624
"36065022200",2404,73,30,25,16,0,0,0,2548
"36065022400",3171,329,197,4,173,18,23,0,3915
"36065022500",2139,871,112,147,143,148,158,62,3780
"36065022701",1807,67,5,2,83,0,34,2,2000
"36065022702",3776,181,58,4,108,0,40,0,4167
"36065022800",2201,215,70,22,97,68,0,13,2686
"36065023000",5461,451,3,0,176,14,57,81,6243
"36065023200",3807,568,64,0,30,0,65,0,4534
"36065023300",2164,420,0,0,62,21,53,24,2744
"36065023400",3507,660,154,59,63,34,173,12,4662
"36065023501",2263,85,0,0,9,0,5,0,2362
"36065023502",4137,287,0,0,48,9,38,0,4519
"36065023702",3456,210,19,0,127,0,89,0,3901
"36065023901",2209,95,1,1,32,0,29,0,2367
"36065023902",1738,166,21,0,4,0,6,0,1935
"36065024000",4079,280,0,2,77,22,9,8,4477
"36065024101",1231,195,0,0,37,1,0,0,1464
"36065024102",2582,396,17,2,34,26,3,24,3084
"36065024200",3688,603,0,0,109,17,21,9,4447
"36065024301",2582,67,86,1,60,0,51,0,2847
"36065024302",3008,493,54,0,37,47,131,21,3791
"36065024303",2182,188,50,0,72,9,48,19,2568
"36065024400",3206,733,3,2,33,13,60,0,4050
"36065024500",4211,559,10,5,47,46,46,18,4942
"36065024700",5511,707,0,1,13,21,27,21,6301
"36065024800",2843,180,43,1,12,2,79,2,3162
"36065024900",4795,555,1,8,47,10,49,14,5479
"36065025001",2727,241,0,0,8,0,50,0,3026
"36065025002",3373,333,57,1,133,7,59,0,3963
"36065025003",1112,66,14,1,35,8,0,0,1236
"36065025100",1595,103,0,34,0,0,18,0,1750
"36065025200",3842,95,0,5,111,0,0,0,4053
"36065025300",6361,305,57,0,359,105,100,20,7307
"36065025400",5269,218,18,53,162,0,25,36,5781
"36065025500",3992,351,10,19,28,0,20,37,4457
"36065025600",3717,513,20,1,48,3,28,4,4334
"36065025700",1933,415,4,0,88,0,65,2,2507
"36065025800",1167,266,44,0,18,7,0,0,1502
"36065025900",31,28,0,0,0,0,0,0,59
"36065026100",1991,145,0,0,50,0,25,0,2211
"36065026200",4882,163,80,0,306,24,0,12,5467
"36065026300",2011,772,164,25,441,94,370,96,3973
"36065026400",1006,524,583,716,939,1115,249,300,5432
"36065026500",57,61,7,7,0,0,7,27,166
"36065026600",73,84,0,40,7,20,0,22,246
"36065026700",4772,594,0,0,68,5,0,0,5439
"36065980002",0,0,0,0,0,0,0,0,0
"36065980003",0,0,0,0,0,0,0,0,0
"36065980100",0,0,0,0,0,0,0,0,0
"36067000100",300,100,74,0,11,33,0,11,529
"36067000200",1145,995,212,161,173,143,60,26,2915
"36067000300",1132,77,142,58,246,38,111,0,1804
"36067000400",2501,362,212,102,154,140,42,102,3615
"36067000501",596,398,202,118,288,343,4,0,1949
"36067000600",1508,542,368,343,526,766,78,176,4307
"36067000700",598,80,341,136,405,152,124,16,1852
"36067000800",1252,276,532,228,136,39,64,64,2591
"36067000900",2335,140,415,53,160,58,47,0,3208
"36067001000",2107,332,713,235,123,468,46,388,4412
"36067001400",947,511,291,359,650,739,348,62,3907
"36067001500",721,202,309,668,403,547,291,72,3213
"36067001600",775,1257,447,257,152,52,47,914,3901
"36067001701",1157,357,41,499,127,311,217,144,2853
"36067001702",1783,313,44,88,346,0,293,18,2885
"36067001800",2037,138,99,147,131,22,71,0,2645
"36067001900",2697,406,265,13,129,21,103,0,3634
"36067002000",1400,458,160,92,94,5,55,30,2294
"36067002101",1229,912,377,499,182,108,251,416,3974
"36067002300",461,181,240,453,258,86,116,125,1920
"36067002400",590,297,218,461,284,93,120,56,2119
"36067002700",1313,253,41,5,24,215,33,0,1884
"36067002901",1994,244,120,1,167,232,55,18,2831
"36067003000",221,441,383,470,51,318,122,597,2603
"36067003200",462,255,49,73,247,242,19,9,1356
"36067003400",213,368,231,125,125,159,7,84,1312
"36067003500",518,171,342,676,156,280,50,84,2277
"36067003601",269,387,983,610,122,62,57,138,2628
"36067003602",608,50,1144,111,79,50,124,43,2209
"36067003800",747,721,468,172,258,191,258,199,3014
"36067003900",658,711,597,803,161,496,197,713,4336
"36067004000",519,162,578,325,140,38,117,44,1923
"36067004200",40,137,631,1184,61,125,42,160,2380
"36067004301",70,177,121,331,71,36,46,21,873
"36067004302",127,453,60,77,25,152,48,93,1035
"36067004400",504,1438,0,30,125,113,0,46,2256
"36067004500",2080,1234,217,38,123,465,38,63,4258
"36067004600",3203,200,451,297,321,21,57,2,4552
"36067004800",1181,38,114,63,6,0,13,0,1415
"36067004900",885,233,152,143,43,102,24,65,1647
"36067005000",1832,99,639,365,33,0,64,214,3246
"36067005100",285,290,847,582,77,90,25,252,2448
"36067005200",102,106,995,664,45,135,5,82,2134
"36067005300",107,37,530,920,3,54,28,42,1721
"36067005400",171,131,1185,1034,171,242,129,294,3357
"36067005500",1076,448,731,298,510,349,92,22,3526
"36067005601",1037,22,137,28,90,32,21,0,1367
"36067005602",65,214,10,43,7,199,0,35,573
"36067005700",603,11,635,487,76,37,45,12,1906
"36067005800",230,180,920,1023,111,101,185,156,2906
"36067005900",194,29,848,503,38,41,103,46,1802
"36067006000",1926,273,852,516,303,0,176,0,4046
"36067006101",703,169,1525,675,155,442,71,90,3830
"36067006102",940,269,176,242,234,137,20,18,2036
"36067006103",1791,42,499,74,153,0,96,0,2655
"36067010100",2744,155,0,0,76,0,104,0,3079
"36067010200",4904,586,117,0,283,0,39,0,5929
"36067010301",5091,327,249,0,60,42,100,0,5869
"36067010321",2590,58,51,0,153,0,0,0,2852
"36067010322",3346,123,17,0,344,0,38,0,3868
"36067010400",3691,132,9,0,34,20,143,6,4035
"36067010500",2074,193,43,0,73,2,30,2,2417
"36067010600",1959,104,10,17,19,7,1,0,2117
"36067010700",1633,149,19,0,49,13,11,0,1874
"36067010800",4300,201,57,0,264,26,189,17,5054
"36067010900",1887,104,129,0,56,0,56,0,2232
"36067011011",2716,118,44,0,227,0,14,0,3119
"36067011012",3507,226,32,9,189,0,63,0,4026
"36067011021",2549,98,224,0,142,13,20,0,3046
"36067011022",2714,276,160,0,87,0,0,77,3314
"36067011101",4910,169,314,1,298,0,135,16,5843
"36067011102",2685,620,183,109,192,70,8,57,3924
"36067011201",2854,424,184,9,146,97,78,23,3815
"36067011202",4417,123,100,0,238,18,206,15,5117
"36067011231",4120,170,64,1,244,79,83,10,4771
"36067011232",3340,231,124,36,224,1,31,1,3988
"36067011241",2060,113,6,0,108,0,44,0,2331
"36067011242",5509,244,168,12,298,0,199,34,6464
"36067011300",2496,118,0,0,36,8,0,0,2658
"36067011401",5997,378,125,0,469,79,248,30,7326
"36067011402",3948,282,14,0,129,3,55,3,4434
"36067011500",4933,203,62,0,313,21,0,1,5533
"36067011600",4419,178,103,66,200,47,97,0,5110
"36067011700",2368,465,33,38,65,0,89,0,3058
"36067011800",5242,563,131,0,229,32,64,0,6261
"36067011900",3523,228,10,0,136,51,149,27,4124
"36067012000",5293,409,0,1,170,0,49,22,5944
"36067012100",4034,126,25,0,188,1,216,1,4591
"36067012200",948,188,3,33,6,0,7,9,1194
"36067012300",2993,59,0,0,179,1,72,1,3305
"36067012400",3855,276,25,0,77,0,20,0,4253
"36067012500",3431,268,28,9,83,28,112,29,3988
"36067012600",4601,213,183,0,56,80,53,47,5233
"36067012700",1518,480,35,0,67,14,44,92,2250
"36067012800",3111,116,0,0,74,0,87,0,3388
"36067012900",1909,504,151,1,25,1,142,37,2770
"36067013000",3497,262,12,14,166,0,180,0,4131
"36067013100",4123,161,0,1,64,0,21,0,4370
"36067013200",2390,79,30,5,44,0,161,0,2709
"36067013300",2008,125,56,7,39,38,37,39,2349
"36067013400",4626,328,120,43,243,91,177,51,5679
"36067013500",4212,164,108,13,257,36,32,0,4822
"36067013600",2665,165,30,0,140,32,68,45,3145
"36067013701",3901,405,198,199,150,35,170,5,5063
"36067013800",1948,101,179,2,19,0,12,0,2261
"36067013900",2268,384,205,10,131,0,63,0,3061
"36067014000",3006,471,118,0,232,16,124,15,3982
"36067014200",3003,383,60,140,338,14,54,125,4117
"36067014300",2242,491,71,1,236,21,65,20,3147
"36067014400",1778,191,130,22,46,0,0,0,2167
"36067014500",3414,192,75,72,180,0,170,0,4103
"36067014600",2674,421,458,108,532,14,86,49,4342
"36067014700",4709,206,362,0,749,6,213,0,6245
"36067014800",2755,16,56,0,180,0,29,0,3036
"36067014900",1447,145,33,10,164,0,16,0,1815
"36067015000",3801,71,35,0,295,0,158,2,4362
"36067015100",5297,191,30,42,262,13,28,0,5863
"36067015201",2635,191,57,0,99,88,107,0,3177
"36067015202",3669,70,169,1,476,22,19,0,4426
"36067015203",2321,73,0,0,236,7,22,0,2659
"36067015400",5614,193,101,4,136,0,79,0,6127
"36067015500",2452,108,42,0,107,11,0,0,2720
"36067015601",2774,388,13,1,73,9,52,0,3310
"36067015700",6547,114,21,0,453,0,175,19,7329
"36067015800",4383,194,17,0,344,0,0,0,4938
"36067016001",3394,82,11,0,84,53,41,0,3665
"36067016002",2982,56,0,4,81,0,84,0,3207
"36067016100",1553,85,72,1,271,68,157,44,2251
"36067016200",1609,121,73,61,278,109,31,58,2340
"36067016300",6031,416,153,66,192,94,135,0,7087
"36067016400",3616,89,35,29,36,17,190,0,4012
"36067016501",1632,100,0,19,21,0,42,0,1814
"36067016502",4011,227,0,0,192,0,0,0,4430
"36067016600",4107,289,0,0,52,0,63,11,4522
"36067016700",2692,38,0,0,0,0,13,1,2744
"36067016801",1620,60,0,0,36,4,18,0,1738
"36067016802",2432,84,0,0,13,0,15,0,2544
"36067016901",2498,123,35,1,73,14,61,7,2812
"36067016902",1935,60,2,17,192,13,135,23,2377
"36067940000",0,0,0,0,179,0,179,0,358
"36069050101",3229,46,35,1,21,0,8,1,3341
"36069050102",10151,290,38,8,500,0,296,0,11283
"36069050201",5201,500,102,0,272,129,76,149,6429
"36069050202",5092,132,189,72,299,82,392,0,6258
"36069050301",4048,272,94,6,150,28,103,28,4729
"36069050302",3976,382,6,24,89,33,53,21,4584
"36069050400",6246,595,52,5,144,7,97,41,7187
"36069050500",5409,504,2,0,90,8,4,2,6019
"36069050601",5249,438,39,62,171,16,67,19,6061
"36069050602",3490,385,26,44,97,37,137,37,4253
"36069050800",2758,221,2,5,117,11,97,1,3212
"36069050900",2051,70,0,6,104,35,50,0,2316
"36069051000",2007,461,0,2,121,19,11,13,2634
"36069051100",1760,304,38,5,87,25,38,13,2270
"36069051200",2964,235,29,5,140,45,73,18,3509
"36069051300",3693,426,12,8,36,74,31,7,4287
"36069051400",2569,142,1,2,12,1,24,1,2752
"36069051500",2837,105,158,9,67,101,209,101,3587
"36069051600",2945,278,224,237,137,54,272,230,4377
"36069051700",894,365,121,157,68,68,167,275,2115
"36069051800",1402,437,186,15,178,116,213,74,2621
"36069051900",1977,688,14,139,86,88,165,108,3265
"36069052000",4488,328,0,0,163,0,32,0,5011
"36069052100",3507,232,0,0,81,9,39,6,3874
"36069052200",2255,338,0,2,20,9,5,3,2632
"36071000100",902,150,668,159,1021,155,1045,71,4171
"36071000200",1354,160,371,175,415,0,845,0,3320
"36071000300",2928,406,516,888,1486,813,3235,1180,11452
"36071000400",788,260,1822,861,328,562,1111,509,6241
"36071000501",736,259,485,399,637,461,1256,650,4883
"36071000502",520,288,765,975,1203,567,1466,704,6488
"36071000600",1034,377,893,232,597,247,1345,537,5262
"36071001100",1676,234,1054,148,970,489,1485,571,6627
"36071001200",838,226,365,126,1031,431,1366,528,4911
"36071001300",2139,31,506,0,712,69,771,75,4303
"36071001500",1950,366,710,118,1429,428,1582,520,7103
"36071001600",3010,222,1494,239,1435,416,1423,389,8628
"36071002100",1956,486,248,76,453,155,257,58,3689
"36071002200",2169,586,209,61,198,29,231,25,3508
"36071002300",1596,154,136,0,206,0,178,37,2307
"36071010101",4114,4,581,0,262,60,853,0,5874
"36071010102",3495,457,284,122,414,103,658,246,5779
"36071010200",3686,120,403,109,336,57,354,135,5200
"36071010300",2205,88,635,48,369,12,385,30,3772
"36071010400",2781,56,413,0,439,1,750,3,4443
"36071010500",5973,302,992,16,669,376,1569,382,10279
"36071010600",6579,226,146,0,429,0,567,0,7947
"36071010700",4433,808,302,51,1059,254,1265,422,8594
"36071010801",2619,137,357,19,389,29,706,0,4256
"36071010802",4307,146,223,0,90,77,476,0,5319
"36071010901",2998,134,91,0,373,0,417,0,4013
"36071010902",5058,273,31,0,309,0,424,24,6119
"36071011000",3548,363,207,0,352,31,616,87,5204
"36071011101",1518,89,564,0,937,0,786,22,3916
"36071011102",2819,46,696,18,584,17,858,18,5056
"36071011200",2026,108,1064,155,985,99,1122,111,5670
"36071011300",3496,436,1342,101,1498,306,1833,350,9362
"36071011400",3360,120,100,0,293,0,401,0,4274
"36071011500",4288,327,164,57,368,70,573,100,5947
"36071011601",3182,618,100,0,446,10,305,60,4721
"36071011602",2728,410,119,0,191,31,168,38,3685
"36071011701",3512,348,241,2,494,3,598,5,5203
"36071011702",4021,297,43,0,84,49,154,3,4651
"36071011801",3790,353,76,0,407,0,725,90,5441
"36071011802",2374,46,71,4,59,32,72,2,2660
"36071011900",3643,475,176,0,805,12,488,90,5689
"36071012100",2430,132,104,9,532,37,518,30,3792
"36071012200",2841,60,286,0,454,12,371,5,4029
"36071012300",4497,77,332,22,382,0,177,0,5487
"36071012601",2407,25,542,0,465,0,595,0,4034
"36071012602",2056,118,164,196,616,166,845,175,4336
"36071012700",2194,141,784,154,862,33,861,45,5074
"36071012800",3543,59,695,59,447,10,901,11,5725
"36071012900",2427,210,6,0,156,23,64,0,2886
"36071013000",4324,178,0,0,245,28,701,9,5485
"36071013100",4511,117,128,0,194,24,363,0,5337
"36071013201",3846,224,264,0,953,10,1309,30,6636
"36071013202",1458,112,120,4,410,41,621,7,2773
"36071013300",6341,435,34,31,461,0,1120,13,8435
"36071013400",2520,195,188,6,234,50,447,37,3677
"36071013500",5129,441,349,0,373,0,738,0,7030
"36071013600",2169,60,28,0,238,36,424,44,2999
"36071013700",1591,249,548,39,524,24,528,49,3552
"36071013800",2013,129,102,24,88,57,155,54,2622
"36071013900",3636,116,35,0,544,4,645,2,4982
"36071014101",2946,455,219,0,426,260,506,560,5372
"36071014102",3629,36,617,0,1010,0,1043,18,6353
"36071014201",2988,276,219,0,453,44,496,45,4521
"36071014202",5078,175,195,0,885,20,658,20,7031
"36071014301",3773,108,877,74,425,71,765,90,6183
"36071014302",5206,99,441,0,753,0,805,0,7304
"36071014400",3531,244,340,51,414,0,545,0,5125
"36071014501",3791,301,18,25,610,3,628,41,5417
"36071014502",4346,281,237,0,210,0,422,0,5496
"36071014600",6063,366,107,0,237,42,300,138,7253
"36071014700",2567,126,328,0,467,106,334,106,4034
"36071014800",5101,521,163,4,661,1,938,159,7548
"36071014900",3142,54,66,0,336,14,166,0,3778
"36071015003",1264,2264,0,0,0,9,28,9,3574
"36071015004",2177,4369,0,11,34,15,77,196,6879
"36071015005",2595,2056,0,0,267,22,275,22,5237
"36071015006",2493,3709,0,0,16,17,10,9,6254
"36071015100",1693,580,878,196,740,724,879,960,6650
"36071015200",7909,277,500,0,824,55,1190,82,10837
"36073040200",2981,263,22,0,49,0,91,32,3438
"36073040300",1950,335,18,119,221,36,95,30,2804
"36073040400",2447,322,130,124,182,140,347,13,3705
"36073040500",1659,406,132,216,21,0,15,0,2449
"36073040600",4858,496,13,13,136,6,199,3,5724
"36073040700",4090,1070,292,48,142,85,135,235,6097
"36073040801",4156,448,31,0,58,0,74,2,4769
"36073040802",3336,431,26,0,83,0,45,0,3921
"36073401200",2750,267,67,16,65,7,23,0,3195
"36073401300",4187,470,115,17,160,6,70,0,5025
"36073990000",0,0,0,0,0,0,0,0,0
"36075020100",2997,512,0,10,47,38,16,41,3661
"36075020200",3137,548,0,2,93,132,10,3,3925
"36075020301",1675,546,0,0,17,4,17,0,2259
"36075020302",2607,706,7,0,66,24,56,0,3466
"36075020400",4250,815,0,0,66,69,16,18,5234
"36075020500",4917,856,0,0,111,21,12,7,5924
"36075020600",4123,638,0,0,203,4,96,3,5067
"36075020701",3554,533,0,12,149,0,27,0,4275
"36075020702",3836,472,0,0,71,0,24,8,4411
"36075020703",4077,808,0,0,99,18,12,0,5014
"36075020800",3130,489,0,7,11,0,0,13,3650
"36075020901",1929,534,21,1,20,36,82,42,2665
"36075020902",5291,415,28,5,174,0,21,5,5939
"36075021000",5312,327,0,1,93,0,42,0,5775
"36075021101",2497,1339,18,0,128,226,118,213,4539
"36075021102",1139,1002,0,21,61,127,45,245,2640
"36075021103",2318,432,0,1,37,0,59,14,2861
"36075021104",1834,517,2,0,38,0,20,39,2450
"36075021200",5833,798,71,0,28,0,79,0,6809
"36075021300",3942,704,38,12,98,6,8,35,4843
"36075021401",3551,373,13,19,23,29,29,29,4066
"36075021402",1348,202,17,1,28,0,17,0,1613
"36075021501",2570,245,0,3,9,0,0,0,2827
"36075021502",5778,804,42,0,155,20,54,44,6897
"36075021601",1754,1231,42,66,130,31,25,67,3346
"36075021602",2019,995,44,20,58,67,122,74,3399
"36075021603",3055,493,0,0,70,1,84,1,3704
"36075021604",2683,957,0,1,156,79,40,115,4031
"36075021605",2196,748,139,33,147,15,63,29,3370
"36075990000",0,0,0,0,0,0,0,0,0
"36077590100",3830,466,8,12,144,20,62,13,4555
"36077590201",1610,253,0,0,19,8,45,0,1935
"36077590202",3113,386,9,7,112,0,17,2,3646
"36077590300",3461,554,3,0,176,15,42,2,4253
"36077590400",4657,688,9,0,115,16,64,0,5549
"36077590500",2608,388,0,2,0,2,0,0,3000
"36077590600",1666,192,5,2,62,11,21,1,1960
"36077590700",3676,491,25,8,65,18,207,0,4490
"36077590800",4069,270,93,308,246,133,198,113,5430
"36077590900",1735,202,57,35,75,15,170,15,2304
"36077591000",2164,1189,0,12,70,54,133,45,3667
"36077591100",1881,1011,61,55,34,71,59,74,3246
"36077591200",799,77,0,0,6,107,0,0,989
"36077591300",79,0,0,0,0,0,0,0,79
"36077591400",4594,921,0,0,118,30,115,86,5864
"36077591500",2851,517,2,3,55,33,39,4,3504
"36077591600",3969,284,0,8,95,9,117,0,4482
"36079010100",3307,265,105,14,322,11,416,11,4451
"36079010200",5719,621,125,96,754,216,481,193,8205
"36079010300",3932,306,87,0,399,183,746,264,5917
"36079010400",2325,51,291,1,255,17,372,0,3312
"36079010500",5005,146,145,7,174,0,469,0,5946
"36079010600",3439,125,26,14,195,0,174,0,3973
"36079010700",2208,177,7,2,114,6,182,46,2742
"36079010800",2776,314,7,32,215,19,67,107,3537
"36079010900",6237,430,118,0,598,61,694,61,8199
"36079011000",3775,195,22,2,305,36,735,24,5094
"36079011100",5105,1,165,2,444,152,532,0,6401
"36079011200",6212,128,17,0,728,0,1274,13,8372
"36079011300",3835,165,0,0,167,39,274,83,4563
"36079011400",4673,123,4,3,161,21,467,21,5473
"36079011500",5582,276,5,4,334,50,557,55,6863
"36079011600",5228,23,135,0,274,0,427,3,6090
"36079011700",4734,121,90,15,161,20,460,28,5629
"36079011800",5856,749,233,0,979,272,1395,573,10057
"36079011900",4306,119,149,0,355,64,530,70,5593
"36081000100",3335,273,90,69,1185,208,321,88,5569
"36081000200",963,152,71,20,1620,280,1471,283,4860
"36081000400",1480,197,461,39,2425,473,2532,390,7997
"36081000600",1162,114,263,118,1842,297,1959,241,5996
"36081000700",3680,79,169,0,915,148,976,49,6016
"36081000800",1786,239,104,27,1293,384,2139,533,6505
"36081001000",1304,128,217,106,1581,251,1677,353,5617
"36081001200",2525,264,172,9,1289,274,2270,236,7039
"36081001400",2027,230,16,0,1221,210,2227,343,6274
"36081001600",1066,367,59,33,953,632,1398,799,5307
"36081001800",848,131,261,0,1502,492,1647,423,5304
"36081001900",576,56,51,0,465,33,350,0,1531
"36081002000",482,0,71,30,972,219,780,125,2679
"36081002200",821,107,59,1,779,166,903,166,3002
"36081002400",1185,179,302,16,644,53,1048,168,3595
"36081002500",1296,676,2188,1184,1182,440,2466,789,10221
"36081002600",809,69,335,2,1176,54,998,63,3506
"36081002800",1200,99,150,205,1331,119,1401,141,4646
"36081003000",425,259,290,0,671,105,595,351,2696
"36081003100",724,134,41,0,143,82,450,124,1698
"36081003200",377,149,48,0,663,94,540,115,1986
"36081003300",579,521,138,33,952,301,225,485,3234
"36081003400",625,27,172,40,1171,112,1086,87,3320
"36081003600",802,0,212,54,2211,257,1297,53,4886
"36081003700",0,0,0,0,0,0,0,0,0
"36081003800",640,176,90,55,1332,355,1233,307,4188
"36081003900",631,305,40,223,293,109,531,417,2549
"36081004001",526,69,107,0,1295,117,879,45,3038
"36081004002",218,78,42,0,558,148,245,52,1341
"36081004200",1292,130,338,15,2470,583,1765,256,6849
"36081004300",558,205,413,348,237,370,477,506,3114
"36081004401",776,64,273,26,1826,800,861,129,4755
"36081004500",1685,166,186,37,606,114,523,67,3384
"36081004700",1095,594,976,372,537,345,674,596,5189
"36081005000",0,0,0,0,0,0,0,0,0
"36081005100",591,202,6,26,822,431,168,135,2381
"36081005200",510,38,275,28,1751,391,834,333,4160
"36081005300",2498,410,15,0,1089,202,775,81,5070
"36081005400",1750,277,338,0,2133,917,1523,581,7519
"36081005500",402,133,21,0,519,99,531,102,1807
"36081005700",2270,339,105,31,1121,383,1603,208,6060
"36081005800",2626,415,138,136,2638,78,2603,265,8899
"36081005900",2376,458,28,8,644,137,952,157,4760
"36081006100",3725,491,46,81,1134,331,1259,111,7178
"36081006201",3928,353,489,0,852,40,1379,20,7061
"36081006202",4009,428,506,87,1381,349,2043,502,9305
"36081006300",3769,740,165,38,775,250,1131,301,7169
"36081006501",2483,431,81,7,371,30,483,44,3930
"36081006502",2595,508,183,8,624,108,788,103,4917
"36081006900",2233,523,110,0,1385,162,1010,308,5731
"36081007100",2146,287,46,0,758,268,737,126,4368
"36081007300",2789,276,58,0,847,541,649,13,5173
"36081007500",2569,651,35,0,637,324,869,248,5333
"36081007700",743,60,19,24,420,60,218,16,1560
"36081007900",871,366,37,116,1754,467,1080,205,4896
"36081008100",368,33,18,0,684,51,406,24,1584
"36081008300",1674,150,383,33,1344,312,1476,102,5474
"36081008500",289,176,44,0,472,102,416,23,1522
"36081008600",1169,149,142,0,1130,50,693,129,3462
"36081008700",735,206,1468,768,616,510,1137,851,6291
"36081008800",2291,103,230,0,823,92,1704,9,5252
"36081009100",1421,221,96,1,819,159,510,40,3267
"36081009400",504,131,404,0,1444,453,532,213,3681
"36081009500",1579,203,50,0,790,36,387,59,3104
"36081009600",773,49,397,189,1705,189,800,72,4174
"36081009700",2814,253,11,0,252,110,381,135,3956
"36081009800",203,0,495,87,1474,383,156,6,2804
"36081009900",0,0,0,0,0,0,0,0,0
"36081010000",356,142,785,31,2330,134,635,156,4569
"36081010100",1942,203,9,11,320,110,385,31,3011
"36081010200",341,48,484,1,1955,189,715,138,3871
"36081010300",2234,510,65,8,786,105,481,66,4255
"36081010400",360,34,384,92,2098,667,263,33,3931
"36081010500",2003,655,273,96,1179,69,1753,292,6320
"36081010600",475,12,375,9,1870,758,630,70,4199
"36081010701",0,0,0,0,0,0,0,0,0
"36081010800",743,71,56,64,2216,334,826,62,4372
"36081011000",600,43,343,54,1716,465,847,80,4148
"36081011100",2321,273,8,0,580,16,576,85,3859
"36081011200",453,82,19,4,1525,271,297,62,2713
"36081011300",2757,195,18,2,933,295,770,189,5159
"36081011400",432,81,25,40,228,75,456,127,1464
"36081011500",1524,293,20,10,391,224,337,203,3002
"36081011600",473,33,85,76,1464,246,658,65,3100
"36081011700",2485,215,66,77,422,7,391,89,3752
"36081011800",520,76,180,0,1395,462,519,124,3276
"36081011900",1054,130,10,9,333,87,330,97,2050
"36081012000",262,21,94,95,1448,551,455,198,3124
"36081012100",1527,149,31,0,297,41,560,21,2626
"36081012200",450,124,162,95,1580,502,527,175,3615
"36081012301",1961,382,26,0,108,45,104,153,2779
"36081012400",860,161,98,69,1272,415,1020,253,4148
"36081012500",1355,44,12,9,434,83,732,43,2712
"36081012601",707,87,130,15,1601,283,1514,154,4491
"36081012602",905,217,162,10,1158,116,1256,227,4051
"36081012800",681,47,205,0,805,178,1045,139,3100
"36081013000",889,54,157,9,516,2,463,17,2107
"36081013200",1003,78,186,0,512,46,483,68,2376
"36081013400",3119,249,485,0,1084,424,1097,85,6543
"36081013500",1343,115,0,0,187,0,174,0,1819
"36081013600",924,206,143,0,564,61,488,46,2432
"36081013700",1386,165,5,0,134,121,154,184,2149
"36081013800",1731,39,184,81,1251,271,1138,89,4784
"36081014000",1934,137,87,38,1438,57,840,54,4585
"36081014100",1226,135,72,4,140,102,340,49,2068
"36081014201",927,207,329,22,2595,327,1501,240,6148
"36081014202",688,75,92,15,1106,310,912,188,3386
"36081014300",2477,421,85,0,835,203,1126,249,5396
"36081014400",205,109,92,25,1414,221,644,129,2839
"36081014500",1411,194,114,0,222,13,258,46,2258
"36081014700",2266,191,36,35,337,10,473,10,3358
"36081014800",304,19,80,92,1592,236,626,141,3090
"36081014900",1552,139,0,3,379,36,651,42,2802
"36081015000",143,218,401,13,1587,174,272,49,2857
"36081015100",1988,147,0,0,483,53,476,86,3233
"36081015200",241,6,555,95,1836,247,462,41,3483
"36081015300",1037,105,34,17,573,187,316,68,2337
"36081015400",163,1,187,153,1349,358,379,0,2590
"36081015500",1601,163,28,0,286,148,449,25,2700
"36081015600",272,27,608,141,1899,504,290,6,3747
"36081015700",721,106,37,0,469,228,479,45,2085
"36081015801",340,31,988,235,1804,300,640,88,4426
"36081015802",386,178,402,60,3432,151,615,178,5402
"36081015900",2635,650,69,0,670,254,465,522,5265
"36081016100",1365,248,124,7,489,156,780,265,3434
"36081016300",1601,428,732,423,654,300,1453,494,6085
"36081016400",79,0,1082,353,1944,189,294,51,3992
"36081016600",436,147,529,194,2138,150,880,145,4619
"36081016800",264,17,515,43,2287,117,753,108,4104
"36081016900",3161,182,56,0,2001,204,1086,84,6774
"36081017000",189,28,828,235,1047,55,260,30,2672
"36081017100",0,0,0,0,0,0,0,0,0
"36081017200",223,4,921,109,856,212,340,4,2669
"36081017400",185,33,989,206,1128,175,334,120,3170
"36081017600",125,9,995,50,943,218,356,40,2736
"36081017800",38,9,1007,168,879,142,285,92,2620
"36081017900",658,26,0,9,223,29,438,30,1413
"36081018000",190,0,500,93,423,42,214,19,1481
"36081018101",1797,351,0,0,1481,393,877,224,5123
"36081018102",2149,262,38,0,1080,217,541,98,4385
"36081018200",126,10,1113,72,675,109,367,58,2530
"36081018300",3068,192,114,1,1642,528,1452,242,7239
"36081018401",109,0,1742,328,378,13,205,0,2775
"36081018402",77,39,1632,399,160,6,176,21,2510
"36081018501",1987,295,80,34,1024,31,893,188,4532
"36081018502",2142,220,32,0,668,323,792,128,4305
"36081018600",53,1,926,116,308,75,136,11,1626
"36081018700",1291,45,107,0,1321,89,741,39,3633
"36081018800",4,5,1034,130,144,1,139,10,1467
"36081018900",1683,229,229,12,1115,228,1402,135,5033
"36081019000",8,12,1146,72,819,66,417,89,2629
"36081019200",249,7,991,39,397,126,435,21,2265
"36081019400",106,0,1400,208,583,56,186,0,2539
"36081019600",110,121,1208,324,877,2,342,120,3104
"36081019800",184,99,715,387,967,456,511,339,3658
"36081019900",300,32,45,0,269,58,359,66,1129
"36081020200",17,0,575,59,709,396,363,87,2206
"36081020400",80,11,903,311,547,142,382,86,2462
"36081020500",533,170,11,7,269,14,538,160,1702
"36081020600",171,0,331,6,914,124,710,107,2363
"36081020800",915,28,748,52,917,126,891,100,3777
"36081021200",440,92,126,55,1229,438,1057,283,3720
"36081021400",1104,332,540,34,3187,551,1498,812,8058
"36081021600",1746,146,694,4,1604,181,1462,122,5959
"36081021900",4,0,0,0,0,0,0,0,4
"36081022001",2154,336,497,222,2237,362,1224,443,7475
"36081022002",2273,488,1048,50,1902,164,1574,130,7629
"36081022900",0,0,0,0,0,0,0,0,0
"36081023000",689,36,100,0,1292,118,621,33,2889
"36081023200",870,275,333,186,3001,316,1365,135,6481
"36081023500",3132,936,108,15,2756,1052,3653,1358,13010
"36081023600",299,236,158,0,1552,209,643,254,3351
"36081023800",305,131,474,83,2386,1037,1743,425,6584
"36081024000",786,471,723,146,2919,910,2548,990,9493
"36081024300",2453,367,26,0,2344,385,1463,366,7404
"36081024500",3236,327,132,17,1501,616,1688,703,8220
"36081024600",0,0,0,0,0,0,0,0,0
"36081024700",590,55,19,0,644,84,431,74,1897
"36081024900",1830,257,29,3,2579,323,1128,229,6378
"36081025100",2384,267,17,0,2125,456,1955,183,7387
"36081025301",2567,173,17,8,1183,160,1605,85,5798
"36081025302",1338,103,35,0,859,290,982,139,3746
"36081025400",55,46,4387,1734,1293,1175,798,534,10022
"36081025500",529,60,0,0,650,57,209,25,1530
"36081025700",656,85,0,0,432,20,421,47,1661
"36081025800",72,33,1242,343,110,0,53,33,1886
"36081025900",1516,48,51,0,1157,288,1261,98,4419
"36081026000",137,16,1300,769,317,35,401,44,3019
"36081026100",1889,854,391,0,3147,868,1739,1055,9943
"36081026200",57,0,727,186,364,76,308,41,1759
"36081026300",1362,113,29,0,4214,463,1756,142,8079
"36081026400",160,69,1214,333,179,27,256,103,2341
"36081026500",751,66,37,18,2671,424,599,190,4756
"36081026600",58,14,1262,234,282,129,251,32,2262
"36081026700",2573,302,42,0,2394,682,2539,305,8837
"36081026901",1890,521,0,0,2327,394,2229,583,7944
"36081026902",1078,518,75,4,2417,550,1261,570,6473
"36081027000",114,4,903,266,355,15,336,14,2007
"36081027100",3069,251,383,16,3317,1428,3285,457,12206
"36081027200",0,0,2110,169,47,15,10,30,2381
"36081027300",4371,1278,212,38,1647,720,5228,1626,15120
"36081027400",174,26,1271,197,269,0,301,26,2264
"36081027500",3416,967,92,0,1791,491,3595,1308,11660
"36081027600",55,0,669,63,211,82,149,86,1315
"36081027700",4084,828,52,14,1725,993,4130,1619,13445
"36081027800",91,82,1667,386,253,211,352,231,3273
"36081027900",2772,843,290,1,2259,316,3545,1000,11026
"36081028000",0,0,1517,66,163,0,139,0,1885
"36081028100",3835,326,54,0,749,87,2903,323,8277
"36081028200",0,0,1336,64,135,0,57,0,1592
"36081028300",3456,769,155,94,1576,455,2740,946,10191
"36081028400",110,0,2749,385,307,132,247,132,4062
"36081028500",2901,271,45,0,977,412,1049,550,6205
"36081028700",3112,710,108,0,1424,676,1943,446,8419
"36081028800",58,43,3002,266,606,21,310,77,4383
"36081028900",1934,422,149,0,2385,343,1758,404,7395
"36081029100",1675,424,15,2,2862,1258,1237,613,8086
"36081029300",582,12,9,0,465,75,486,4,1633
"36081029400",76,41,5365,650,489,76,473,161,7331
"36081029500",1589,172,139,0,1737,314,1001,70,5022
"36081029700",1107,222,61,0,512,118,327,215,2562
"36081029900",0,0,0,0,0,0,0,0,0
"36081030600",65,26,3121,353,259,13,203,68,4108
"36081030902",2681,636,80,2,3520,1666,2063,494,11142
"36081030903",1358,185,26,0,4617,302,2168,169,8825
"36081030904",953,156,101,3,2301,245,1819,122,5700
"36081031700",4087,477,231,0,848,238,775,99,6755
"36081032000",83,45,3184,715,247,225,85,210,4794
"36081032700",1324,256,165,0,1604,583,1902,359,6193
"36081032800",195,20,1971,150,49,59,137,1,2582
"36081032900",1593,156,219,28,2186,568,2469,415,7634
"36081033000",76,1,5006,1054,559,54,491,55,7296
"36081033100",0,0,0,0,0,0,0,0,0
"36081033401",70,0,2634,320,343,0,321,0,3688
"36081033402",178,62,10930,1170,395,0,638,224,13597
"36081033700",782,62,37,0,2253,279,2290,244,5947
"36081033900",985,207,261,0,1983,294,1836,173,5739
"36081034700",475,267,274,10,1892,319,1836,423,5496
"36081035100",1062,312,91,10,2363,274,2257,536,6905
"36081035200",70,0,2259,274,195,5,97,5,2905
"36081035300",573,55,113,115,985,277,1408,201,3727
"36081035700",931,215,1069,228,1695,355,2179,209,6881
"36081035800",3,1,4056,168,137,0,176,0,4541
"36081036100",327,288,564,138,1201,435,1437,693,5083
"36081036300",65,0,571,38,1445,217,1525,173,4034
"36081036500",955,192,397,69,1757,523,2619,684,7196
"36081036600",18,1,2197,334,239,7,281,0,3077
"36081036700",126,109,1393,82,948,52,865,109,3684
"36081036800",70,7,2145,151,58,0,197,0,2628
"36081037100",270,74,447,137,833,240,915,155,3071
"36081037300",480,46,460,28,1355,533,1671,485,5058
"36081037500",1627,468,75,32,904,431,2162,722,6421
"36081037600",0,0,5864,131,403,52,264,52,6766
"36081037700",1089,702,353,101,1236,453,2052,1029,7015
"36081037900",1764,735,179,211,3162,1024,4851,1747,13673
"36081038100",1897,1111,928,170,1893,646,3735,1662,12042
"36081038301",0,0,0,0,0,0,0,0,0
"36081038302",0,0,0,0,29,0,0,0,29
"36081038400",63,0,1854,173,284,0,184,0,2558
"36081039400",85,0,2479,158,156,104,209,80,3271
"36081039800",98,0,1598,102,39,1,70,0,1908
"36081039900",1155,321,20,10,1435,818,2331,624,6714
"36081040000",15,0,1076,152,222,0,35,0,1500
"36081040100",2829,567,228,54,2913,875,4995,1343,13804
"36081040200",4,0,1192,22,41,18,16,4,1297
"36081040300",2816,930,112,35,2691,482,4838,1321,13225
"36081040400",11,19,2996,558,543,39,244,37,4447
"36081040500",1558,364,62,0,964,535,2399,842,6724
"36081040700",2674,758,457,25,2316,559,4766,1216,12771
"36081040900",1532,646,109,126,2081,721,3186,1277,9678
"36081041100",1317,559,79,17,979,575,1952,934,6412
"36081041300",1614,410,0,0,1641,841,2076,1048,7630
"36081041400",32,146,2326,458,285,206,273,554,4280
"36081041500",1704,409,64,1,800,518,1969,547,6012
"36081042400",11,0,2256,171,48,7,34,0,2527
"36081042600",28,23,0,30,0,10,0,19,110
"36081042700",2059,291,284,43,1413,790,3135,804,8819
"36081043200",1,49,1190,17,74,0,39,49,1419
"36081043400",107,0,1106,77,360,19,92,0,1761
"36081043701",1307,281,182,97,988,267,1585,537,5244
"36081043702",2463,558,674,255,1915,300,3110,619,9894
"36081043900",1538,759,26,106,1189,783,2448,1324,8173
"36081044000",20,0,2251,629,945,155,576,17,4593
"36081044301",728,1041,356,73,1161,302,1436,1054,6151
"36081044302",1273,186,501,84,2339,504,1733,267,6887
"36081044400",88,120,707,111,1178,431,585,169,3389
"36081044601",757,71,880,93,903,427,1182,254,4567
"36081044602",262,279,1070,374,1635,1053,674,712,6059
"36081044800",183,29,240,66,1647,479,569,131,3344
"36081045000",807,24,21,0,672,282,413,5,2224
"36081045200",71,9,64,55,205,246,138,0,788
"36081045400",366,60,394,42,2632,494,359,26,4373
"36081045500",3822,871,5650,860,1574,314,3683,601,17375
"36081045600",240,0,20,62,1026,87,67,13,1515
"36081045700",614,71,13,0,2267,380,812,55,4212
"36081045800",227,25,218,5,1418,395,239,18,2545
"36081045900",1208,119,0,3,2040,777,1372,270,5789
"36081046000",259,188,874,133,2380,2221,1087,1113,8255
"36081046100",770,292,0,14,1863,322,1170,371,4802
"36081046200",949,196,573,184,3908,1917,2712,467,10906
"36081046300",1083,649,11,24,1144,565,1224,734,5434
"36081046400",510,0,283,11,538,81,451,19,1893
"36081046500",2543,525,0,0,495,217,2614,639,7033
"36081046600",537,225,899,52,986,744,359,52,3854
"36081046700",2247,1549,140,1,1919,470,2424,1634,10384
"36081046800",359,38,694,59,2244,248,600,168,4410
"36081046900",2822,1092,124,141,2918,1505,3153,1131,12886
"36081047000",293,1,360,19,2432,338,588,28,4059
"36081047100",608,71,0,0,2167,1046,800,63,4755
"36081047200",654,269,779,12,1396,63,335,26,3534
"36081047300",1098,40,89,0,1531,565,793,93,4209
"36081047500",1297,131,26,0,2942,502,933,235,6066
"36081047600",585,49,216,2,487,56,103,41,1539
"36081047800",1367,69,1636,172,2089,124,909,10,6376
"36081047900",1886,87,40,1,3247,640,1135,123,7159
"36081048000",392,97,564,52,1553,86,801,75,3620
"36081048100",1891,782,242,108,3202,487,2041,647,9400
"36081048200",144,10,422,57,841,63,414,70,2021
"36081048300",1246,154,37,0,1805,595,1206,383,5426
"36081048400",342,69,1162,175,2855,183,434,63,5283
"36081048500",1354,163,77,0,3029,478,1301,75,6477
"36081048900",426,26,5,0,1067,50,508,27,2109
"36081049200",692,58,2090,125,1007,504,634,10,5120
"36081049301",1028,124,0,12,586,58,335,92,2235
"36081049302",1615,158,16,0,110,183,197,117,2396
"36081049500",1088,131,0,0,308,9,690,48,2274
"36081049600",375,32,1007,6,1575,205,586,37,3823
"36081049700",1437,74,1,4,1186,107,507,26,3342
"36081049900",1431,75,1,2,3285,555,789,62,6200
"36081050000",81,138,2291,705,479,195,430,192,4511
"36081050201",43,0,1006,111,252,0,209,0,1621
"36081050202",43,2,956,49,186,63,146,10,1455
"36081050400",57,2,1462,200,121,0,115,0,1957
"36081050500",935,117,23,13,401,67,325,13,1894
"36081050600",2,0,1118,133,309,0,25,0,1587
"36081050700",2283,200,26,1,1383,29,483,14,4419
"36081050800",42,0,1589,154,132,0,54,0,1971
"36081051000",0,0,1198,189,402,1,78,0,1868
"36081051100",1696,178,48,0,202,1,413,153,2691
"36081051200",114,0,2302,222,507,26,360,0,3531
"36081051300",1021,95,12,0,652,105,364,0,2249
"36081051500",1930,228,52,0,225,40,219,130,2824
"36081051600",78,0,1530,121,139,0,238,0,2106
"36081051700",1347,108,0,15,233,116,430,125,2374
"36081051800",0,96,2143,88,111,1,112,95,2646
"36081052000",47,4,1534,60,101,2,142,26,1916
"36081052100",1118,116,53,0,126,75,225,32,1745
"36081052200",13,55,1483,167,153,14,224,7,2116
"36081052400",6,10,1399,49,104,84,67,84,1803
"36081052500",1321,147,0,0,207,53,497,40,2265
"36081052600",44,37,1086,224,260,35,167,35,1888
"36081052800",66,15,1004,211,63,0,71,15,1445
"36081053000",0,0,1854,270,134,0,66,10,2334
"36081053100",2519,274,26,0,282,68,973,147,4289
"36081053200",74,0,1289,79,145,0,116,0,1703
"36081053401",72,0,1958,157,81,0,74,0,2342
"36081053500",634,66,0,6,408,174,752,238,2278
"36081053601",138,0,1206,177,383,11,246,11,2172
"36081053800",38,0,1475,155,124,10,86,10,1898
"36081053900",2290,473,102,2,1079,351,1840,400,6537
"36081054000",138,234,2573,623,564,191,213,350,4886
"36081054200",831,191,1382,59,2751,489,1160,142,7005
"36081054500",2237,458,17,0,849,297,2153,384,6395
"36081054700",2298,779,142,15,699,615,2226,965,7739
"36081054800",211,0,819,45,1383,65,252,47,2822
"36081054900",3378,976,142,178,854,232,3049,873,9682
"36081055100",3092,714,72,36,758,218,1870,605,7365
"36081055200",399,22,885,65,1606,335,560,45,3917
"36081055300",885,351,32,24,684,205,1048,445,3674
"36081055400",529,5,547,24,1367,145,511,70,3198
"36081055500",1409,387,75,26,173,52,1122,420,3664
"36081055600",487,12,240,32,1789,102,637,8,3307
"36081055700",2143,821,58,13,728,327,1704,901,6695
"36081055800",332,2,364,0,1204,19,546,0,2467
"36081055900",772,325,19,0,337,90,950,381,2874
"36081056000",411,2,319,84,476,279,255,0,1826
"36081056100",76,0,40,0,30,0,55,0,201
"36081056200",394,87,227,0,735,203,369,282,2297
"36081056400",721,6,251,11,779,44,517,22,2351
"36081056500",897,280,0,14,52,360,820,459,2882
"36081056600",301,78,227,0,1162,48,642,69,2527
"36081056700",3741,362,44,0,314,46,2337,319,7163
"36081056800",665,71,3372,303,669,23,998,59,6160
"36081057700",2851,391,66,0,191,346,948,309,5102
"36081057900",823,413,5,0,92,13,260,156,1762
"36081058000",57,6,3082,257,278,0,293,48,4021
"36081058100",2100,514,53,0,159,41,991,290,4148
"36081058200",57,175,3858,609,469,110,228,266,5772
"36081058300",2226,446,98,30,321,65,801,153,4140
"36081058500",3269,748,0,0,411,25,1372,584,6409
"36081058700",2144,368,90,0,154,126,444,185,3511
"36081058900",2705,763,7,30,445,155,1241,581,5927
"36081059000",30,0,925,188,143,0,106,0,1392
"36081059100",3548,910,37,0,535,217,2248,783,8278
"36081059200",130,0,1051,63,19,0,56,0,1319
"36081059300",2605,478,135,0,518,17,878,301,4932
"36081059400",7,0,1424,28,175,15,26,19,1694
"36081059500",3132,388,200,10,522,99,1580,346,6277
"36081059600",3,0,1315,38,0,0,5,0,1361
"36081059800",72,2,1419,150,236,0,136,1,2016
"36081059900",1125,76,0,0,118,32,212,49,1612
"36081060000",17,0,898,22,21,4,51,0,1013
"36081060100",1385,236,19,0,272,60,530,138,2640
"36081060300",1573,78,5,0,230,20,436,89,2431
"36081060600",31,0,1121,18,30,27,25,27,1279
"36081060701",0,0,0,0,0,0,0,0,0
"36081060800",0,0,1392,57,16,0,4,0,1469
"36081061000",97,0,1472,14,45,15,77,6,1726
"36081061200",109,0,1364,93,9,0,176,0,1751
"36081061301",3889,656,127,0,643,379,963,493,7150
"36081061302",3,0,4,0,0,0,0,0,7
"36081061400",26,0,1166,58,75,0,34,0,1359
"36081061601",19,5,2184,46,28,5,46,0,2333
"36081061602",70,12,1013,79,85,0,158,9,1426
"36081061800",54,7,1520,31,53,6,15,7,1693
"36081061900",2433,235,40,0,182,56,573,129,3648
"36081062000",50,0,977,98,264,0,106,0,1495
"36081062100",2102,314,7,0,108,124,388,268,3311
"36081062200",18,0,1514,86,53,0,39,0,1710
"36081062300",1657,160,0,0,137,24,319,93,2390
"36081062400",0,0,0,0,0,0,0,0,0
"36081062500",1975,166,15,14,171,1,411,113,2866
"36081062600",114,147,2571,228,53,10,117,170,3410
"36081062700",1964,504,0,0,326,0,920,245,3959
"36081062900",2279,330,62,2,355,21,777,82,3908
"36081063000",29,0,1565,38,38,2,111,0,1783
"36081063200",19,0,1667,84,120,23,25,23,1961
"36081063301",968,74,0,0,48,12,312,6,1420
"36081063302",1579,16,9,0,51,0,560,0,2215
"36081063500",2231,61,21,8,11,1,686,13,3032
"36081063700",2548,46,0,29,231,38,640,67,3599
"36081063800",229,6,3089,440,354,1,344,0,4463
"36081063900",1768,108,54,0,506,21,395,9,2861
"36081064101",1467,146,12,0,340,0,363,109,2437
"36081064102",126,0,0,0,0,0,0,0,126
"36081064500",905,106,14,2,907,57,315,16,2322
"36081064600",40,0,2327,196,157,0,103,18,2841
"36081065000",35,0,2623,160,184,0,131,0,3133
"36081065400",399,28,2288,21,170,8,324,28,3266
"36081065501",0,0,0,0,0,0,0,0,0
"36081065600",277,44,4361,240,188,14,235,18,5377
"36081065702",1340,69,92,20,112,0,156,0,1789
"36081065703",2362,104,0,4,93,0,405,9,2977
"36081065900",1716,73,0,0,33,0,207,0,2029
"36081066000",417,87,2912,51,161,0,295,76,3999
"36081066100",1286,48,8,0,79,0,129,0,1550
"36081066300",2122,265,0,0,221,0,79,9,2696
"36081066400",657,63,8564,560,938,64,607,3,11456
"36081066501",3087,215,77,1,21,2,128,1,3532
"36081066701",2424,82,36,0,202,34,417,34,3229
"36081066900",1728,41,17,0,69,0,116,0,1971
"36081067100",1713,97,6,13,210,10,254,0,2303
"36081067700",1642,64,13,0,241,0,54,0,2014
"36081067900",2403,440,105,3,397,98,1109,121,4676
"36081068000",293,1,4024,181,403,44,391,1,5338
"36081068200",0,0,1254,58,62,0,20,0,1394
"36081068300",1909,332,335,0,1488,253,1764,351,6432
"36081068700",1963,164,45,0,2174,341,695,89,5471
"36081069000",0,3,3161,377,64,2,7,20,3634
"36081069300",1525,101,103,0,867,78,790,66,3530
"36081069400",305,0,1890,410,162,0,379,0,3146
"36081069500",1050,56,5,0,714,70,497,56,2448
"36081069701",1933,296,276,64,1135,88,911,95,4798
"36081069702",2333,49,29,0,1180,201,228,15,4035
"36081070300",1048,85,41,0,612,14,312,40,2152
"36081070700",1354,63,0,0,843,85,360,18,2723
"36081070900",1546,7,28,0,918,39,252,0,2790
"36081071100",3160,707,34,0,1445,67,484,99,5996
"36081071303",3756,149,54,0,1024,160,761,9,5913
"36081071304",3730,761,145,0,1158,244,644,86,6768
"36081071305",2514,300,100,0,1496,411,482,197,5500
"36081071306",2911,721,254,0,1801,222,955,110,6974
"36081071600",0,0,0,0,0,0,0,0,0
"36081071701",3581,442,129,47,1091,125,368,93,5876
"36081071702",2080,547,83,0,1030,86,753,7,4586
"36081071900",1257,336,75,15,725,42,339,118,2907
"36081072100",2743,287,47,0,1398,230,516,207,5428
"36081072300",1369,4,42,0,488,0,86,0,1989
"36081072900",696,46,0,0,382,76,137,1,1338
"36081073100",1018,33,0,0,379,0,155,0,1585
"36081073700",1273,10,8,0,534,27,202,1,2055
"36081073900",3199,151,217,0,1317,14,745,1,5644
"36081074100",2183,127,15,0,710,27,242,6,3310
"36081074300",2575,436,13,0,1565,124,658,13,5384
"36081074500",2165,488,312,57,653,152,361,135,4323
"36081074700",1015,174,331,41,1529,182,237,37,3546
"36081074900",1252,18,0,0,369,16,108,0,1763
"36081075701",2991,114,0,29,1510,154,486,26,5310
"36081075702",2735,84,276,49,1174,27,537,0,4882
"36081076901",2741,47,107,0,885,230,468,23,4501
"36081076902",744,16,34,0,599,98,307,0,1798
"36081077300",1432,203,223,0,352,10,204,0,2424
"36081077500",1647,134,33,0,203,32,154,133,2336
"36081077902",4247,252,160,10,458,38,324,51,5540
"36081077903",1537,71,114,3,920,38,689,54,3426
"36081077904",2959,959,182,0,2109,296,720,0,7225
"36081077905",984,219,109,41,1005,1,320,16,2695
"36081077906",1544,391,190,13,841,174,484,76,3713
"36081077907",2004,585,200,0,670,29,503,0,3991
"36081077908",1096,94,915,18,1086,493,569,183,4454
"36081078800",132,11,1034,152,147,0,81,17,1574
"36081079000",19,67,1307,380,549,46,118,119,2605
"36081079200",88,0,1474,226,353,20,213,5,2379
"36081079300",0,0,0,0,0,0,0,0,0
"36081079701",452,82,340,13,4853,1003,590,66,7399
"36081079702",392,83,57,1,2438,933,593,73,4570
"36081079900",675,48,60,0,2390,550,566,149,4438
"36081080301",864,144,9,0,3106,537,1202,24,5886
"36081080302",1433,16,59,2,1431,146,558,37,3682
"36081080900",3821,382,235,165,2570,48,783,16,8020
"36081081400",189,148,1926,170,1006,104,427,148,4118
"36081081800",527,2,1538,179,1557,359,946,95,5203
"36081083700",863,48,79,0,3648,730,406,13,5787
"36081083800",1422,37,747,10,3647,312,1536,111,7822
"36081084000",1229,71,829,111,3391,271,1253,71,7226
"36081084500",690,95,518,113,2552,801,603,24,5396
"36081084601",1187,19,216,32,1510,109,631,62,3766
"36081084602",163,97,21,74,666,34,444,113,1612
"36081084900",630,188,60,52,4947,1500,1117,128,8622
"36081085300",387,183,84,5,2720,1143,452,159,5133
"36081085500",1600,172,97,0,3790,884,1530,135,8208
"36081085700",717,142,125,51,3242,1468,817,135,6697
"36081085900",1021,99,52,2,2919,1282,553,64,5992
"36081086100",416,47,15,32,1745,266,333,52,2906
"36081086300",701,123,139,51,4112,1747,960,395,8228
"36081086400",989,68,242,18,1157,157,803,86,3520
"36081086500",791,212,3,7,2362,797,297,37,4506
"36081086900",150,0,15,7,1632,439,201,0,2444
"36081087100",154,89,304,303,776,366,385,306,2683
"36081088400",6675,315,40,1,176,163,742,149,8261
"36081088901",2688,198,353,107,5029,1614,706,815,11510
"36081089200",7502,434,0,0,312,0,651,0,8899
"36081090700",592,106,0,61,292,78,192,99,1420
"36081091601",4084,91,1,2,44,0,31,1,4254
"36081091602",0,0,0,0,0,0,0,0,0
"36081091800",15,0,0,0,0,0,0,0,15
"36081091900",1874,137,53,0,2957,826,2017,351,8215
"36081092200",2055,67,0,0,0,0,19,0,2141
"36081092500",1213,170,56,87,1522,317,1148,357,4870
"36081092800",3195,51,5,0,21,0,54,0,3326
"36081092900",1941,52,208,2,3872,142,2734,51,9002
"36081093401",3616,249,18,4,230,16,615,54,4802
"36081093402",3066,240,182,61,273,4,419,0,4245
"36081093800",3694,499,549,20,344,65,608,91,5870
"36081093900",1822,139,41,0,2641,175,1071,213,6102
"36081094201",1604,173,991,239,587,183,1164,212,5153
"36081094202",1227,421,1348,908,807,193,656,590,6150
"36081094203",3108,259,1203,23,459,31,813,31,5927
"36081094500",2290,235,126,1,845,317,834,151,4799
"36081094700",920,174,16,9,1137,142,925,19,3342
"36081095400",888,230,2407,400,564,181,693,129,5492
"36081096400",189,189,2253,541,661,82,618,189,4722
"36081097202",430,344,895,775,27,65,346,545,3427
"36081097203",267,1284,2606,1953,548,665,979,1675,9977
"36081097204",116,30,1775,438,360,49,397,29,3194
"36081097300",1898,18,0,1,284,1,416,1,2619
"36081098100",1537,64,8,0,676,61,298,19,2663
"36081098700",2403,24,0,0,333,0,340,0,3100
"36081099100",5402,220,0,1,996,26,913,54,7612
"36081099200",376,512,1798,443,541,64,988,386,5108
"36081099701",1856,104,20,0,460,83,96,20,2639
"36081099703",2916,41,12,0,1274,46,528,0,4817
"36081099704",4384,322,114,17,1717,351,772,0,7677
"36081099705",1585,15,0,17,898,30,119,0,2664
"36081099801",1204,158,3594,569,657,58,1465,152,7857
"36081099802",1198,650,2346,435,198,104,870,162,5963
"36081099900",0,0,0,0,0,0,0,0,0
"36081100801",744,287,1089,176,242,17,252,33,2840
"36081100802",1835,609,3569,864,907,651,1276,879,10590
"36081101001",2563,1207,2083,1030,1498,333,1988,1045,11747
"36081101002",3059,817,164,324,127,24,328,155,4998
"36081101700",4216,129,16,1,1421,143,600,3,6529
"36081102900",2378,145,0,1,915,11,808,38,4296
"36081103201",485,657,3507,1010,566,383,1371,907,8886
"36081103202",3219,364,1721,203,734,204,1456,290,8191
"36081103300",2970,163,8,0,1190,160,423,0,4914
"36081103900",4471,260,0,0,1936,26,503,173,7369
"36081104700",3511,49,59,1,3138,221,1141,0,8120
"36081105900",2538,24,0,0,1151,64,351,1,4129
"36081107201",1912,181,1,1,19,1,55,55,2225
"36081107202",0,0,0,0,0,0,0,0,0
"36081108500",1309,112,25,2,936,116,198,18,2716
"36081109300",1938,10,31,0,1347,15,599,0,3940
"36081109700",1231,69,34,2,347,32,365,32,2112
"36081109900",2129,290,81,0,1074,301,787,13,4675
"36081111300",1357,73,17,7,1106,79,294,14,2947
"36081112300",1013,19,21,1,1200,218,546,97,3115
"36081112900",1572,22,85,0,522,66,32,1,2300
"36081113300",1108,27,0,0,471,8,57,15,1686
"36081113900",1592,391,35,1,1468,163,382,80,4112
"36081114100",1340,12,0,3,813,2,142,2,2314
"36081114700",941,224,38,0,586,137,67,0,1993
"36081115100",610,11,20,0,385,19,20,0,1065
"36081115500",737,30,72,0,1332,375,576,17,3139
"36081115700",933,18,31,1,2238,307,84,0,3612
"36081115900",607,303,157,0,2678,581,667,171,5164
"36081116100",809,60,138,0,2518,881,854,72,5332
"36081116300",920,178,217,30,4836,1955,1124,164,9424
"36081116700",281,45,0,1,1176,364,382,222,2471
"36081117100",801,133,28,16,1438,576,318,295,3605
"36081117500",1590,28,174,3,2966,445,526,163,5895
"36081118100",775,57,55,0,838,55,221,0,2001
"36081118500",573,35,59,0,1351,149,490,63,2720
"36081118700",425,46,41,0,1416,334,464,57,2783
"36081118900",380,32,24,1,1796,459,185,26,2903
"36081119100",873,104,10,0,2077,384,648,142,4238
"36081119300",701,81,50,0,1030,260,157,29,2308
"36081119500",713,12,90,0,681,26,345,0,1867
"36081119900",453,11,59,8,784,317,110,1,1743
"36081120100",326,23,2,2,1120,214,142,0,1829
"36081120300",342,79,191,0,938,156,287,24,2017
"36081120500",261,63,74,0,1689,540,174,4,2805
"36081120700",1362,19,4,5,1379,154,497,6,3426
"36081121100",0,0,0,0,0,0,0,0,0
"36081121500",1095,96,37,0,2481,668,767,140,5284
"36081122300",1547,58,0,0,1752,433,651,100,4541
"36081122701",3520,377,566,231,4530,1291,2326,10,12851
"36081122702",1483,483,967,1101,854,1209,1036,787,7920
"36081124100",1545,167,270,1,1077,346,264,8,3678
"36081124700",2174,208,35,24,907,123,159,4,3634
"36081125700",308,235,567,31,1436,477,147,117,3318
"36081126500",506,47,73,12,883,96,259,28,1904
"36081126700",722,75,76,10,1358,233,438,11,2923
"36081127700",2671,28,187,9,510,155,131,9,3700
"36081128300",55,0,0,0,5,0,0,0,60
"36081129102",2258,79,0,2,906,9,183,2,3439
"36081129103",2250,259,50,0,852,91,252,0,3754
"36081129104",2147,150,217,56,1587,105,134,35,4431
"36081130100",1621,121,602,11,1634,312,609,0,4910
"36081133300",2103,98,33,4,1310,121,358,0,4027
"36081133900",663,187,1,0,608,40,137,12,1648
"36081134100",1179,6,57,0,1867,286,269,21,3685
"36081134700",2389,281,549,25,5091,1325,1368,114,11142
"36081136700",2407,80,176,5,3287,259,530,20,6764
"36081137700",1905,317,41,14,3711,384,292,129,6793
"36081138501",1330,86,0,0,2426,517,400,0,4759
"36081138502",10,8,0,0,0,0,10,0,28
"36081139900",855,44,0,0,780,32,91,7,1809
"36081140300",808,84,14,0,1389,251,413,0,2959
"36081140901",333,48,14,0,494,27,23,24,963
"36081140902",816,122,117,5,1668,8,136,97,2969
"36081141700",1674,116,87,0,2557,69,667,41,5211
"36081142900",1725,146,0,0,1286,305,364,0,3826
"36081143500",921,53,0,0,1202,48,254,0,2478
"36081144100",1360,91,12,0,1436,262,260,28,3449
"36081144700",546,86,435,5,1583,301,361,50,3367
"36081145101",941,21,0,0,596,57,163,2,1780
"36081145102",830,0,25,0,1691,98,358,0,3002
"36081145900",1651,45,9,0,1168,73,326,27,3299
"36081146300",1073,170,10,1,1125,194,227,112,2912
"36081146700",1925,218,27,0,917,117,271,102,3577
"36081147100",1775,74,32,0,1410,116,572,43,4022
"36081147900",2541,19,30,0,1951,142,934,116,5733
"36081148300",1722,74,21,11,960,49,143,0,2980
"36081150701",2114,42,1,0,593,103,207,0,3060
"36081150702",1695,77,0,0,932,195,310,157,3366
"36081152901",2724,112,181,3,3236,468,663,55,7442
"36081152902",2259,348,344,3,1989,118,110,2,5173
"36081155101",1975,65,15,0,0,0,73,0,2128
"36081155102",3502,261,439,15,3194,104,690,47,8252
"36081156700",67,87,83,109,447,66,15,49,923
"36081157101",3138,309,337,13,3753,524,1142,26,9242
"36081157102",589,6,27,0,1039,98,320,0,2079
"36081157901",2154,338,54,0,2440,157,160,233,5536
"36081157902",1246,69,188,0,2051,200,276,32,4062
"36081157903",1891,64,0,0,1690,55,212,0,3912
"36081161700",3034,67,10,0,1438,47,942,20,5558
"36081162100",1959,469,489,1,3903,259,1633,346,9059
"36081990100",0,0,0,0,0,0,0,0,0
"36083040100",2676,579,138,603,280,164,69,379,4888
"36083040200",2798,584,387,162,310,23,179,11,4454
"36083040300",1383,920,235,153,290,32,113,94,3220
"36083040400",567,514,550,531,107,114,159,340,2882
"36083040500",781,650,250,378,81,6,290,101,2537
"36083040600",388,526,236,176,217,64,3,26,1636
"36083040700",1852,1204,523,290,354,222,76,241,4762
"36083040800",945,251,329,40,50,104,31,73,1823
"36083040900",1382,453,267,300,165,89,159,205,3020
"36083041000",1734,690,363,259,356,299,193,267,4161
"36083041100",3488,495,404,249,431,267,319,237,5890
"36083041200",2509,260,14,61,155,0,154,11,3164
"36083041300",2194,512,141,79,159,26,8,48,3167
"36083041400",2731,436,148,7,277,83,74,119,3875
"36083051500",1541,597,110,66,267,23,60,0,2664
"36083051600",5182,873,168,65,370,176,209,50,7093
"36083051701",2895,454,0,0,65,0,13,0,3427
"36083051702",2924,340,29,0,56,40,22,0,3411
"36083051800",5098,535,81,0,5,2,5,0,5726
"36083051901",3382,280,40,242,89,0,69,0,4102
"36083051902",3229,105,112,24,89,0,70,0,3629
"36083052002",1525,84,5,0,39,0,19,0,1672
"36083052003",4046,170,71,2,152,21,5,0,4467
"36083052004",5421,61,53,25,370,0,139,4,6073
"36083052101",1763,50,32,0,43,0,4,0,1892
"36083052102",1539,147,0,0,25,0,0,0,1711
"36083052103",1796,97,0,0,16,0,15,0,1924
"36083052201",4367,36,1,3,74,0,14,0,4495
"36083052203",5255,134,154,3,194,0,121,0,5861
"36083052204",2744,46,0,0,0,0,31,0,2821
"36083052301",3280,171,107,6,131,14,98,0,3807
"36083052303",1180,172,4,0,3,0,3,0,1362
"36083052304",5935,210,153,0,187,5,49,0,6539
"36083052402",1714,72,49,1,103,1,56,0,1996
"36083052403",5699,439,197,1,256,3,185,24,6804
"36083052404",6465,296,96,4,625,0,546,0,8032
"36083052501",5564,426,58,17,213,15,17,0,6310
"36083052502",4774,307,0,0,35,0,80,32,5228
"36083052503",1242,57,10,6,25,1,26,2,1369
"36083052601",3356,132,112,2,111,46,62,0,3821
"36083052602",971,45,15,0,65,3,33,0,1132
"36083052603",2524,292,0,0,83,0,50,9,2958
"36085000300",774,84,159,145,468,1,111,65,1807
"36085000600",1689,181,137,16,193,69,365,60,2710
"36085000700",1175,236,1374,1287,755,385,1044,569,6825
"36085000800",4046,233,182,48,839,540,1331,380,7599
"36085000900",629,56,808,122,385,57,658,30,2745
"36085001100",804,547,1220,282,147,92,420,531,4043
"36085001700",723,102,177,83,383,42,407,87,2004
"36085001800",648,0,29,0,61,0,125,0,863
"36085002001",1978,75,72,1,314,11,360,16,2827
"36085002002",2335,205,132,2,605,30,138,11,3458
"36085002100",1603,431,662,229,773,422,1310,670,6100
"36085002700",171,150,277,193,650,218,375,313,2347
"36085002900",892,215,1983,1328,1165,213,1503,391,7690
"36085003300",1702,210,855,294,773,63,542,152,4591
"36085003600",1559,16,77,0,821,118,706,48,3345
"36085003900",1317,155,241,28,287,6,561,1,2596
"36085004000",2348,1120,4681,1806,2800,660,2664,1378,17457
"36085004700",1726,85,332,2,145,34,409,0,2733
"36085005000",2442,233,135,7,512,115,494,126,4064
"36085005900",2220,112,122,0,133,15,291,17,2910
"36085006400",1796,264,342,286,401,16,283,157,3545
"36085006700",2178,205,164,10,221,88,322,43,3231
"36085007000",6677,741,282,60,1322,370,753,350,10555
"36085007400",3029,354,20,6,615,287,264,172,4747
"36085007500",2184,525,500,380,418,250,1382,618,6257
"36085007700",262,234,464,177,300,8,348,167,1960
"36085008100",1325,401,522,254,438,259,521,238,3958
"36085009601",2337,572,52,3,430,169,603,142,4308
"36085009602",2793,105,0,2,395,2,332,1,3630
"36085009700",1613,246,1148,229,240,194,592,445,4707
"36085010500",2482,673,739,199,723,280,1253,406,6755
"36085011201",4556,150,0,0,803,0,731,0,6240
"36085011202",4841,290,74,3,717,356,703,216,7200
"36085011401",1598,241,307,262,439,135,323,271,3576
"36085011402",2431,230,90,59,307,152,301,48,3618
"36085012100",2751,399,0,0,106,118,198,203,3775
"36085012200",3084,129,31,0,167,0,229,44,3684
"36085012500",1455,116,488,456,244,298,629,374,4060
"36085012804",3153,147,116,0,693,28,746,52,4935
"36085012805",2955,55,0,0,67,10,211,0,3298
"36085012806",4738,393,562,0,546,77,1453,120,7889
"36085013201",1327,53,0,0,69,0,47,0,1496
"36085013203",4885,294,27,0,220,0,581,1,6008
"36085013204",4090,205,61,8,382,2,300,34,5082
"36085013301",126,251,479,447,125,141,180,199,1948
"36085013302",761,111,1593,209,765,276,767,312,4794
"36085013400",3362,167,14,0,378,110,728,169,4928
"36085013800",5912,124,45,0,62,0,381,0,6524
"36085014100",1229,626,391,87,458,21,1072,248,4132
"36085014604",6861,407,0,0,183,77,622,246,8396
"36085014605",3161,71,0,3,219,42,94,0,3590
"36085014606",7263,101,62,0,237,65,673,0,8401
"36085014607",4071,315,0,2,302,0,270,15,4975
"36085014608",3298,53,0,0,165,110,405,0,4031
"36085014700",3050,237,0,0,105,0,315,52,3759
"36085015100",4305,402,66,0,482,83,383,116,5837
"36085015400",0,0,0,0,0,0,0,0,0
"36085015601",5378,406,0,3,198,71,563,77,6696
"36085015602",3009,172,0,0,108,0,161,0,3450
"36085015603",4449,339,14,0,148,11,468,0,5429
"36085016901",2595,254,146,0,306,73,688,126,4188
"36085017005",3972,214,0,0,280,1,123,11,4601
"36085017007",3565,278,226,0,734,142,820,53,5818
"36085017008",6389,151,0,15,352,62,833,16,7818
"36085017009",3842,157,24,0,83,0,355,0,4461
"36085017010",7498,460,56,0,400,141,718,34,9307
"36085017011",4280,514,17,5,180,0,584,36,5616
"36085017012",3692,357,0,35,320,0,364,0,4768
"36085017300",1029,211,387,170,531,50,417,112,2907
"36085017600",4172,335,0,0,154,8,215,0,4884
"36085017700",5516,302,179,1,1116,46,533,26,7719
"36085018100",2416,314,6,15,201,11,345,27,3335
"36085018701",1260,95,100,0,212,39,124,5,1835
"36085018702",3548,355,197,247,2005,249,1022,311,7934
"36085018901",3635,553,166,4,738,47,431,79,5653
"36085018902",3052,231,187,21,1489,251,536,251,6018
"36085019700",1551,16,6,0,216,16,94,16,1915
"36085019800",6140,283,0,0,338,18,430,27,7236
"36085020100",2604,124,124,43,487,175,863,32,4452
"36085020700",1422,989,1557,191,535,392,1345,1303,7734
"36085020801",7207,820,168,1,422,70,647,132,9467
"36085020803",5529,436,12,0,129,0,482,85,6673
"36085020804",4535,400,0,0,492,43,160,0,5630
"36085021300",2064,816,652,200,911,409,1292,870,7214
"36085022300",1056,131,865,9,380,222,864,247,3774
"36085022600",6790,358,222,6,812,27,1389,100,9704
"36085022800",228,0,0,0,0,0,145,0,373
"36085023100",1532,555,1099,100,826,145,1358,381,5996
"36085023900",1191,237,382,20,773,296,1170,445,4514
"36085024401",5914,275,0,0,169,21,273,63,6715
"36085024402",3490,138,0,0,418,0,520,1,4567
"36085024700",1078,514,611,169,305,27,339,356,3399
"36085024800",4454,214,84,7,134,111,327,112,5443
"36085025100",4709,636,15,0,387,0,371,0,6118
"36085027301",2950,207,130,76,434,132,292,0,4221
"36085027302",2770,233,142,1,954,147,151,1,4399
"36085027702",4289,478,263,25,676,93,572,187,6583
"36085027704",3239,179,0,0,633,28,358,0,4437
"36085027705",3831,148,100,0,1336,198,395,209,6217
"36085027706",2042,92,5,14,816,196,304,228,3697
"36085027900",1710,121,1,1,92,14,82,17,2038
"36085029102",1841,86,128,43,308,53,419,24,2902
"36085029103",6747,232,44,47,540,0,605,16,8231
"36085029104",5407,322,152,39,690,92,787,92,7581
"36085030301",3115,162,649,26,1130,53,1233,82,6450
"36085030302",2461,483,1385,129,1185,605,2291,451,8990
"36085031901",287,462,1080,451,608,135,419,592,4034
"36085031902",702,540,2112,868,204,63,566,412,5467
"36085032300",360,111,272,32,360,0,451,103,1689
"36085990100",0,0,0,0,0,0,0,0,0
"36087010101",4738,261,284,0,253,0,351,10,5897
"36087010102",4055,13,301,20,604,134,1005,134,6266
"36087010200",3388,196,386,16,407,76,602,129,5200
"36087010501",4282,251,412,3,321,0,799,144,6212
"36087010502",4420,380,720,12,869,437,2210,588,9636
"36087010503",1481,38,511,0,306,7,254,12,2609
"36087010601",3010,253,267,112,227,29,1309,213,5420
"36087010602",3077,817,1048,14,1389,86,2492,613,9536
"36087010701",1746,141,980,89,1122,42,1700,136,5956
"36087010702",1569,646,612,106,835,380,2318,1058,7524
"36087010703",1691,297,514,98,678,149,1639,377,5443
"36087010801",3343,78,269,1,473,0,201,0,4365
"36087010802",4289,190,99,86,569,34,286,0,5553
"36087010803",4095,88,145,184,961,98,306,16,5893
"36087010804",3057,207,145,0,667,0,493,168,4737
"36087010901",4151,115,131,0,603,1,509,15,5525
"36087010902",2907,119,345,30,707,71,514,71,4764
"36087011000",1715,92,63,17,86,0,110,9,2092
"36087011101",4249,271,255,116,885,47,676,77,6576
"36087011102",3239,161,1122,2,1278,114,700,94,6710
"36087011200",4793,173,118,28,1011,0,430,11,6564
"36087011301",1678,152,2198,457,1930,695,1709,726,9545
"36087011302",4242,212,202,13,1133,41,644,76,6563
"36087011303",4582,113,139,0,605,27,490,37,5993
"36087011401",3598,68,11,5,563,35,287,22,4589
"36087011403",4896,68,61,3,449,26,409,5,5917
"36087011404",2691,196,415,0,837,36,731,62,4968
"36087011405",2556,103,560,2,536,0,332,4,4093
"36087011501",6815,324,311,4,596,0,402,42,8494
"36087011502",4308,159,1338,43,1935,130,1688,171,9772
"36087011504",1121,81,4739,33,1347,67,1320,67,8775
"36087011505",1187,1903,0,3,98,7,13,44,3255
"36087011506",1044,3092,18,14,53,47,5,29,4302
"36087011601",2723,101,305,0,204,10,142,10,3495
"36087011602",4956,322,121,33,587,0,415,19,6453
"36087011603",4467,151,95,33,403,37,489,37,5712
"36087011700",2546,84,95,37,220,0,268,0,3250
"36087011800",324,96,252,15,187,6,152,8,1040
"36087011901",2866,89,116,0,254,88,338,118,3869
"36087011902",2152,136,454,15,596,108,779,118,4358
"36087012000",2900,80,137,3,548,126,103,133,4030
"36087012101",3390,2717,0,0,15,0,24,0,6146
"36087012102",2678,4302,169,0,0,25,41,0,7215
"36087012103",2750,2311,0,0,0,125,9,95,5290
"36087012105",2282,2032,87,0,226,130,190,66,5013
"36087012106",1198,1716,632,10,546,21,811,20,4954
"36087012202",437,266,3129,648,1172,523,934,408,7517
"36087012203",2125,583,235,0,8,0,19,0,2970
"36087012204",1844,747,404,0,163,8,189,8,3363
"36087012300",253,390,1617,786,2145,1050,2132,1050,9423
"36087012401",1251,141,2255,295,706,161,612,59,5480
"36087012402",579,222,1568,85,2210,1055,2160,1150,9029
"36087012501",3798,529,439,0,687,59,504,60,6076
"36087012502",3000,278,951,10,551,110,438,56,5394
"36087012600",5107,534,81,0,535,0,110,0,6367
"36087012700",3599,161,25,37,374,27,229,68,4520
"36087012800",5458,206,96,0,848,5,225,0,6838
"36087013001",1849,107,44,72,448,32,239,48,2839
"36087013002",3848,271,0,15,975,116,212,238,5675
"36087013003",2091,347,217,11,210,10,191,9,3086
"36087013100",3827,609,1008,318,276,82,537,84,6741
"36087013200",1917,131,281,4,318,56,57,0,2764
"36087013300",1938,133,68,0,380,12,158,33,2722
"36087013401",3413,71,207,0,589,2,709,22,5013
"36087013402",3149,204,124,0,569,0,216,82,4344
"36089490100",2522,1015,17,4,60,0,0,40,3658
"36089490200",3125,438,7,0,81,0,4,25,3680
"36089490300",3844,976,43,0,275,94,28,0,5260
"36089490400",2443,312,0,0,162,198,57,10,3182
"36089490500",3014,694,0,29,163,17,24,8,3949
"36089490600",3520,1049,8,13,44,18,0,0,4652
"36089490700",4711,930,50,3,128,78,61,3,5964
"36089490800",1946,598,2,11,88,23,37,4,2709
"36089490900",2208,1060,69,9,73,121,20,15,3575
"36089491000",3488,606,0,5,245,70,47,10,4471
"36089491100",17,4,3,0,18,0,0,0,42
"36089491200",117,128,0,0,2,0,0,0,247
"36089491300",3245,699,0,0,123,0,25,1,4093
"36089491400",2491,885,11,18,117,24,0,15,3561
"36089491500",2862,749,0,0,23,35,31,13,3713
"36089491600",1710,491,0,0,16,2,47,26,2292
"36089491700",3083,956,16,4,60,32,13,3,4167
"36089491800",3235,981,12,3,48,13,38,6,4336
"36089491900",0,0,0,0,0,0,0,0,0
"36089492000",3695,527,27,6,210,16,84,0,4565
"36089492100",2832,473,13,0,59,36,40,41,3494
"36089492300",5286,778,18,9,93,29,25,37,6275
"36089492400",2297,436,16,2,64,40,2,6,2863
"36089492500",2073,362,2,9,71,15,34,8,2574
"36089492600",4668,809,15,1,73,36,37,2,5641
"36089492700",4465,1480,35,6,66,50,41,0,6143
"36089492800",2353,561,4,2,33,7,0,0,2960
"36089492900",2010,405,7,0,40,10,11,9,2492
"36091060101",4697,440,107,27,78,0,54,0,5403
"36091060102",4962,298,25,0,76,0,74,0,5435
"36091060200",3139,269,127,12,14,0,65,12,3638
"36091060300",3200,487,0,99,52,0,87,0,3925
"36091060400",1966,413,40,0,89,25,54,0,2587
"36091060501",1387,204,0,0,30,9,5,0,1635
"36091060502",2021,259,10,0,14,3,44,0,2351
"36091060503",1989,113,0,4,46,15,63,2,2232
"36091060601",2478,262,66,3,154,0,18,0,2981
"36091060602",4418,300,0,2,81,0,10,0,4811
"36091060701",6320,514,42,2,129,0,173,0,7180
"36091060702",8629,125,69,133,289,38,51,0,9334
"36091060800",4697,276,0,1,102,0,83,0,5159
"36091060901",3385,151,102,9,35,0,266,0,3948
"36091060902",1674,225,9,7,23,31,2,2,1973
"36091061000",3009,693,36,11,325,0,198,16,4288
"36091061100",4760,436,230,94,163,0,118,32,5833
"36091061200",3832,512,93,0,133,19,199,28,4816
"36091061301",3200,45,33,0,210,0,103,0,3591
"36091061302",6374,107,81,16,240,17,260,17,7112
"36091061303",0,0,0,0,0,0,0,0,0
"36091061401",4485,466,0,0,46,2,8,29,5036
"36091061403",5515,228,1,14,38,0,97,0,5893
"36091061404",2774,125,20,1,60,0,0,0,2980
"36091061500",3331,156,0,0,0,58,7,0,3552
"36091061600",3830,109,21,2,170,0,6,0,4138
"36091061701",3722,372,31,68,106,11,93,60,4463
"36091061702",4131,172,25,0,109,0,73,22,4532
"36091061800",4824,445,0,0,136,24,92,19,5540
"36091061901",7994,237,75,3,311,25,229,0,8874
"36091061903",5482,232,71,3,271,32,303,7,6401
"36091062000",5791,300,52,0,19,0,167,0,6329
"36091062100",1612,301,4,0,41,0,49,38,2045
"36091062200",2426,421,8,0,116,34,32,11,3048
"36091062300",1792,320,15,11,40,12,29,0,2219
"36091062403",5710,483,43,28,299,1,95,80,6739
"36091062404",1508,16,26,0,33,0,55,10,1648
"36091062405",4498,635,167,0,1042,179,264,268,7053
"36091062406",3215,205,29,0,101,105,64,20,3739
"36091062501",4780,66,57,0,85,46,107,0,5141
"36091062503",5569,28,41,0,141,0,277,0,6056
"36091062505",3088,141,94,0,324,0,90,0,3737
"36091062506",5031,37,200,14,350,0,46,0,5678
"36091062507",3062,151,30,26,142,14,120,11,3556
"36091062508",3703,185,162,10,166,38,111,2,4377
"36091062509",3067,19,31,10,103,0,6,0,3236
"36091062601",2083,46,46,1,231,26,99,2,2534
"36091062602",6087,46,77,1,623,19,186,0,7039
"36091062700",5364,536,52,0,286,29,17,13,6297
"36091062800",1809,134,44,6,130,21,72,12,2228
"36093020101",1720,50,59,10,376,6,11,4,2236
"36093020102",1280,412,627,305,261,54,145,320,3404
"36093020200",1194,432,85,187,98,67,150,182,2395
"36093020300",491,317,70,0,63,32,38,6,1017
"36093020500",3388,405,482,72,336,143,266,39,5131
"36093020600",1895,51,212,34,341,84,92,43,2752
"36093020700",1934,351,926,445,832,525,594,234,5841
"36093020800",1263,428,642,411,574,90,140,107,3655
"36093020900",568,384,736,943,348,746,172,370,4267
"36093021001",144,123,125,75,84,44,38,18,651
"36093021002",605,748,710,506,168,45,154,687,3623
"36093021200",2105,415,110,73,68,55,73,149,3048
"36093021400",955,579,823,430,349,67,102,141,3446
"36093021500",1072,480,912,122,416,392,324,509,4227
"36093021600",1919,292,411,189,942,226,387,89,4455
"36093021700",1365,444,860,389,518,591,276,304,4747
"36093021800",5198,260,562,143,800,5,226,0,7194
"36093031900",6436,240,0,27,863,97,379,26,8068
"36093032000",5233,172,113,7,758,5,90,5,6383
"36093032101",4619,206,0,7,685,0,91,120,5728
"36093032102",1625,46,0,0,99,13,74,3,1860
"36093032200",4227,88,191,4,229,0,231,0,4970
"36093032300",2559,206,83,0,115,0,45,1,3009
"36093032402",2804,106,57,0,194,5,34,0,3200
"36093032403",1994,67,36,13,106,0,56,0,2272
"36093032404",5920,183,21,0,44,17,77,0,6262
"36093032502",3108,138,0,36,146,0,79,0,3507
"36093032503",3570,384,80,0,101,0,9,29,4173
"36093032504",2041,114,5,0,128,0,82,0,2370
"36093032601",1837,110,7,0,53,6,43,0,2056
"36093032602",3576,191,40,0,146,0,98,0,4051
"36093032700",3758,231,24,0,114,0,120,0,4247
"36093032901",3791,147,93,2,170,0,113,0,4316
"36093032902",3537,184,112,1,258,37,100,13,4242
"36093033002",2211,44,19,0,47,0,0,0,2321
"36093033003",2862,118,74,0,207,0,97,0,3358
"36093033004",2230,397,0,0,154,0,59,0,2840
"36093033101",2128,145,0,8,0,0,0,0,2281
"36093033102",5657,191,0,0,162,0,42,0,6052
"36093033200",2311,198,281,566,410,21,210,16,4013
"36093033300",2025,120,1,0,30,10,62,9,2257
"36093033400",1267,93,99,11,117,61,135,24,1807
"36093033500",1583,285,110,39,55,53,32,11,2168
"36095740100",4705,327,33,0,29,2,56,31,5183
"36095740200",4451,619,0,8,137,34,70,25,5344
"36095740300",0,0,0,0,0,0,0,0,0
"36095740400",4351,637,63,7,126,23,84,13,5304
"36095740500",3225,414,45,0,82,37,179,24,4006
"36095740600",2545,379,18,0,54,18,33,1,3048
"36095740700",4714,709,9,12,54,17,174,9,5698
"36095740800",2586,300,15,3,57,11,54,2,3028
"36097950100",4519,290,0,1,105,36,69,1,5021
"36097950200",1515,53,9,0,31,0,32,0,1640
"36097950300",2651,466,0,11,58,12,0,13,3211
"36097950400",3119,524,0,0,29,0,12,12,3696
"36097950500",3680,639,3,8,36,11,12,47,4436
"36099950100",1801,455,4,14,2,0,61,5,2342
"36099950200",2045,283,3,8,19,8,5,0,2371
"36099950300",3029,353,1,0,127,109,124,37,3780
"36099950400",2352,447,0,0,17,104,0,31,2951
"36099950500",3232,400,5,2,31,16,15,0,3701
"36099950600",3134,274,49,0,16,45,66,28,3612
"36099950700",3648,201,0,13,29,34,2,10,3937
"36099950800",3354,325,100,12,120,11,52,33,4007
"36099950900",2966,572,40,7,114,21,25,0,3745
"36099951000",1918,254,0,2,79,1,52,0,2306
"36101960100",1129,190,2,0,14,5,0,0,1340
"36101960200",2818,496,9,0,32,17,46,31,3449
"36101960300",2103,404,0,0,52,8,25,0,2592
"36101960400",3169,762,42,0,34,52,41,0,4100
"36101960500",2285,264,6,3,27,0,39,0,2624
"36101960600",3413,445,5,1,170,29,35,28,4126
"36101960700",2069,605,215,14,135,56,40,84,3218
"36101960800",2146,385,1,2,70,2,20,16,2642
"36101960900",2066,529,0,9,0,0,0,0,2604
"36101961000",2907,658,6,1,26,22,25,23,3668
"36101961100",3334,745,303,102,39,31,46,53,4653
"36101961200",3083,388,33,83,74,42,0,42,3745
"36101961300",2870,503,10,20,74,37,2,27,3543
"36101961400",1893,151,48,5,23,0,0,6,2126
"36101961500",1697,195,0,0,24,0,9,0,1925
"36101961600",1453,113,11,4,17,5,3,0,1606
"36101961700",2956,411,0,0,0,3,0,8,3378
"36101961800",2669,664,0,9,6,20,10,0,3378
"36101961900",2814,460,0,24,60,23,9,60,3450
"36101962000",3304,940,38,0,79,1,14,1,4377
"36101962100",2488,856,3,0,24,72,3,7,3453
"36101962200",2173,303,3,0,105,3,8,0,2595
"36101962300",6617,619,167,16,630,59,228,16,8352
"36101962400",2179,388,117,63,151,8,37,0,2943
"36101962500",1588,658,6,29,34,39,54,21,2429
"36101962600",1983,284,18,15,189,12,74,21,2596
"36101962700",2325,771,23,28,68,16,28,30,3289
"36101962800",3171,381,32,0,90,0,9,0,3683
"36101962900",2173,171,73,0,108,0,12,0,2537
"36101963000",3927,354,5,0,38,17,35,25,4401
"36103110101",3426,69,0,0,112,17,83,17,3724
"36103110102",4747,58,0,0,106,0,79,10,5000
"36103110200",4678,136,0,0,102,60,136,75,5187
"36103110300",4775,126,5,1,114,19,174,19,5233
"36103110401",2689,14,5,0,170,4,283,0,3165
"36103110402",2756,86,53,0,61,79,40,0,3075
"36103110501",2993,149,0,0,88,0,106,0,3336
"36103110502",2501,83,53,0,116,0,259,0,3012
"36103110600",6762,202,0,8,433,0,107,0,7512
"36103110801",1865,30,4,0,55,6,91,0,2051
"36103110803",5039,248,4,36,293,11,72,64,5767
"36103110901",2406,107,0,0,295,0,256,0,3064
"36103110902",1982,308,765,42,520,417,756,547,5337
"36103111001",1574,126,111,19,297,52,175,42,2396
"36103111002",2296,356,292,441,1338,210,1763,512,7208
"36103111100",5047,339,190,34,2970,508,4109,684,13881
"36103111201",2387,254,272,82,762,394,1411,468,6030
"36103111202",3192,185,358,0,754,1,1165,15,5670
"36103111300",4272,227,174,0,88,0,220,9,4990
"36103111401",1243,15,46,6,67,16,115,0,1508
"36103111402",4399,186,130,0,397,9,373,74,5568
"36103111503",3256,134,420,330,291,69,312,0,4812
"36103111504",1126,13,46,0,329,1,112,0,1627
"36103111505",3570,111,1295,200,1417,29,1414,29,8065
"36103111506",2155,50,641,30,660,5,575,12,4128
"36103111601",3329,56,18,1,178,32,118,32,3764
"36103111602",3037,44,109,4,108,0,73,0,3375
"36103111701",5281,273,0,18,294,27,484,36,6413
"36103111703",2866,122,0,0,83,44,326,0,3441
"36103111704",3002,26,20,0,65,0,164,0,3277
"36103111801",5096,43,2,0,438,40,126,41,5786
"36103111802",2799,56,36,0,21,36,27,0,2975
"36103111803",2323,28,0,0,318,0,191,0,2860
"36103111804",2144,61,0,0,204,23,53,16,2501
"36103111900",4468,126,11,0,509,7,192,0,5313
"36103112001",3555,248,38,11,565,29,445,3,4894
"36103112002",4190,69,80,0,349,10,286,10,4994
"36103112102",3410,41,88,0,330,36,301,0,4206
"36103112103",3614,148,0,0,196,0,365,0,4323
"36103112104",1738,96,0,2,537,20,86,14,2493
"36103112204",3557,91,69,0,123,0,231,0,4071
"36103112206",6541,321,92,210,978,76,606,0,8824
"36103112210",5485,55,259,19,1069,0,230,9,7126
"36103112211",4153,45,158,0,300,15,309,0,4980
"36103112212",2404,101,341,2,472,11,154,0,3485
"36103112213",3792,138,333,22,835,42,347,12,5521
"36103112214",5594,210,731,87,660,0,100,0,7382
"36103122300",2900,161,87,0,751,0,781,34,4714
"36103122403",662,10,1392,164,338,0,223,0,2789
"36103122404",2919,127,291,0,291,39,700,39,4406
"36103122405",695,39,2521,239,480,0,456,52,4482
"36103122406",584,48,2641,855,796,241,1145,221,6531
"36103122501",439,137,2232,420,397,24,779,101,4529
"36103122502",193,5,3366,232,695,0,831,0,5322
"36103122601",4172,318,269,1,843,53,820,35,6511
"36103122602",3923,128,403,12,414,24,573,0,5477
"36103122603",4651,168,396,0,393,12,562,22,6204
"36103122704",1454,59,375,0,56,6,114,0,2064
"36103122705",1859,173,63,9,388,77,209,2,2780
"36103122706",2780,185,214,8,304,0,372,39,3902
"36103122707",2422,107,199,0,658,15,208,0,3609
"36103122801",2428,308,2403,159,401,318,521,26,6564
"36103122802",3199,136,562,30,95,134,419,55,4630
"36103122901",5231,371,17,0,904,0,946,91,7560
"36103122902",3936,202,59,132,111,43,339,92,4914
"36103123001",4927,137,246,26,860,69,1250,139,7654
"36103123002",3273,85,74,56,1062,0,913,2,5465
"36103123101",3036,25,50,18,460,0,520,14,4123
"36103123102",3084,102,174,0,325,0,409,0,4094
"36103123201",777,69,772,21,419,44,426,63,2591
"36103123202",2080,530,4623,330,1666,84,3375,328,13016
"36103123301",1784,374,4389,306,1156,231,2390,291,10921
"36103123302",308,0,743,98,452,109,700,69,2479
"36103123401",3630,145,152,0,417,10,942,10,5306
"36103123402",5839,323,260,12,648,351,1175,262,8870
"36103123500",3206,311,887,100,789,401,874,463,7031
"36103123600",3018,89,0,0,198,0,202,0,3507
"36103123701",3469,469,627,275,1557,211,3218,434,10260
"36103123702",5669,179,526,168,1266,35,1851,68,9762
"36103123801",3735,122,189,0,97,0,173,7,4323
"36103123802",3257,196,18,0,45,0,198,0,3714
"36103123900",4110,254,355,0,171,0,530,26,5446
"36103124001",4058,268,30,11,151,0,814,0,5332
"36103124002",3395,95,15,0,88,18,283,23,3917
"36103124101",4450,73,13,0,286,0,393,0,5215
"36103124102",3069,72,0,0,104,194,154,194,3787
"36103124200",5400,217,17,1,307,0,581,0,6523
"36103124300",5109,462,135,0,531,179,634,180,7230
"36103124401",3145,173,47,0,121,19,375,19,3899
"36103124402",3774,68,0,0,59,0,94,0,3995
"36103124500",4185,188,22,29,593,115,503,27,5662
"36103124601",2579,42,50,0,132,0,83,0,2886
"36103124602",3680,211,48,39,199,9,196,51,4433
"36103134702",4932,173,0,0,215,231,227,231,6009
"36103134703",3780,50,16,9,292,0,144,0,4291
"36103134704",2085,151,18,0,223,0,26,0,2503
"36103134902",4007,320,13,0,118,39,118,21,4636
"36103134903",1187,47,103,0,0,3,30,38,1408
"36103134904",5636,169,40,0,371,0,303,3,6522
"36103134906",5094,256,2,1,101,20,388,0,5862
"36103134907",4608,178,0,39,92,15,33,17,4982
"36103135002",4803,228,0,0,151,0,30,25,5237
"36103135003",4326,68,84,0,64,7,183,0,4732
"36103135004",2795,94,10,0,36,0,68,2,3005
"36103135005",2590,117,0,1,83,0,108,1,2900
"36103135101",3146,43,189,1,459,1,193,0,4032
"36103135102",3988,88,0,9,239,0,404,54,4782
"36103135103",4506,119,42,0,258,14,176,52,5167
"36103135104",4910,310,0,0,165,0,233,0,5618
"36103135201",1986,32,0,3,59,0,26,0,2106
"36103135204",4119,109,23,3,139,0,166,0,4559
"36103135205",4453,222,16,0,328,32,420,0,5471
"36103135208",2823,89,14,0,57,0,44,0,3027
"36103135209",3246,15,37,0,106,31,332,0,3767
"36103135301",3609,231,53,0,99,1,142,0,4135
"36103135303",4106,86,35,0,271,0,273,0,4771
"36103135304",2964,48,0,0,248,0,165,0,3425
"36103135401",5444,176,221,1,319,270,97,77,6605
"36103135402",6496,131,27,1,455,0,507,0,7617
"36103135403",3727,221,201,0,270,17,275,137,4848
"36103145602",2513,200,1139,3,1108,748,2905,879,9495
"36103145603",2455,296,1056,99,2117,519,4187,765,11494
"36103145604",2484,161,242,13,2068,233,3741,385,9327
"36103145605",1356,39,757,28,928,262,1765,262,5397
"36103145701",4332,257,96,103,782,0,506,108,6184
"36103145702",2575,104,399,0,2553,376,4138,480,10625
"36103145703",2439,468,788,7,2149,324,3475,621,10271
"36103145704",3788,182,1493,179,1341,32,2916,80,10011
"36103145803",4544,199,42,0,215,0,445,57,5502
"36103145804",2211,96,549,0,422,10,920,13,4221
"36103145805",5694,119,32,34,243,51,496,74,6743
"36103145807",3974,232,106,0,181,0,546,98,5137
"36103145808",3166,162,0,0,116,80,99,105,3728
"36103145901",2119,77,539,22,1130,143,1701,221,5952
"36103145902",3948,339,1804,181,1914,314,4173,306,12979
"36103145903",3997,154,843,33,770,27,1445,43,7312
"36103146001",2036,43,1172,115,1663,327,3179,338,8873
"36103146002",3115,115,723,0,2244,289,4531,390,11407
"36103146003",3962,222,1822,48,1949,84,3067,138,11292
"36103146102",1013,48,383,0,831,39,1237,69,3620
"36103146103",3221,0,58,0,593,9,648,9,4538
"36103146105",2586,183,1273,16,2138,92,3646,219,10153
"36103146106",1652,158,676,13,1466,74,2143,116,6298
"36103146201",1666,146,425,5,1509,573,2611,659,7594
"36103146202",1643,251,1742,258,1460,172,3129,367,9022
"36103146203",2815,630,1248,67,1035,323,3099,854,10071
"36103146204",2394,34,1446,123,2113,244,3832,324,10510
"36103146205",2143,13,29,1,42,0,291,0,2519
"36103146206",1657,105,384,12,578,109,1034,109,3988
"36103146300",1431,179,469,20,175,20,191,37,2522
"36103146402",3648,78,39,0,320,0,335,0,4420
"36103146403",2213,208,1182,91,1557,188,2943,245,8627
"36103146404",1620,262,636,27,1153,149,1782,287,5916
"36103146500",4577,254,50,0,284,0,468,61,5694
"36103146604",3729,135,138,7,475,16,419,16,4935
"36103146605",813,13,0,0,92,0,205,0,1123
"36103146606",7404,325,20,0,225,0,593,0,8567
"36103146607",2234,91,23,0,144,33,232,27,2784
"36103146608",2223,154,23,0,82,0,195,0,2677
"36103146611",3009,105,39,0,82,59,294,0,3588
"36103146612",4916,46,10,34,271,23,553,0,5853
"36103146613",3551,103,36,0,147,10,533,77,4457
"36103146614",4864,248,23,0,530,0,659,18,6342
"36103146615",3723,172,277,1,377,73,421,75,5119
"36103146703",2358,185,499,0,757,7,1210,63,5079
"36103146704",1769,51,0,0,109,0,112,0,2041
"36103146705",3459,36,28,2,0,0,281,0,3806
"36103146706",2524,29,1,3,41,1,203,1,2803
"36103146800",5719,62,0,0,125,0,154,0,6060
"36103146901",4851,393,0,0,219,0,447,71,5981
"36103146902",3354,203,0,0,128,0,67,0,3752
"36103147001",4007,141,0,0,96,0,89,0,4333
"36103147003",4151,93,94,0,261,0,824,3,5426
"36103147004",238,12,0,0,4,0,9,0,263
"36103147100",2755,119,6,6,207,7,181,18,3299
"36103147200",3538,253,981,36,1114,0,1736,41,7699
"36103147300",4499,221,1872,132,900,669,2034,703,11030
"36103147401",4896,215,629,16,228,16,734,128,6862
"36103147402",3481,31,0,0,86,0,64,0,3662
"36103147501",6537,251,136,94,48,0,697,0,7763
"36103147502",6189,129,0,0,201,0,251,0,6770
"36103147503",1453,1,1,2,133,0,67,0,1657
"36103147601",2037,38,38,0,28,0,183,0,2324
"36103147602",4590,147,44,4,235,0,158,0,5178
"36103147701",2907,85,9,0,97,40,134,0,3272
"36103147702",4470,111,12,0,150,25,256,20,5044
"36103147802",3470,77,11,2,21,0,182,0,3763
"36103147803",2812,188,89,0,63,19,186,8,3365
"36103147804",5534,162,0,2,109,0,115,34,5956
"36103147901",3615,255,270,52,169,46,217,18,4642
"36103147902",3920,136,0,8,62,0,251,0,4377
"36103158001",3908,81,43,0,545,0,194,0,4771
"36103158002",5431,151,59,0,474,0,540,0,6655
"36103158006",5581,80,231,0,458,249,470,3,7072
"36103158007",37,0,0,0,78,0,0,0,115
"36103158009",2620,11,0,0,138,13,99,0,2881
"36103158010",3196,37,0,0,334,0,89,0,3656
"36103158011",3755,260,118,13,681,0,101,0,4928
"36103158102",4214,135,75,0,680,0,1215,11,6330
"36103158103",3536,192,562,118,174,4,946,22,5554
"36103158104",5073,170,46,0,489,28,556,0,6362
"36103158107",3314,268,148,1,315,30,357,93,4526
"36103158108",1954,231,40,0,565,65,120,45,3020
"36103158110",3259,79,35,0,274,31,465,27,4170
"36103158111",2863,128,66,9,185,16,429,15,3711
"36103158112",3336,278,23,4,419,120,696,128,5004
"36103158114",2755,134,0,1,373,8,197,28,3496
"36103158115",5820,98,300,0,433,0,513,0,7164
"36103158116",1478,70,91,0,318,83,80,10,2130
"36103158202",7267,783,25,12,443,85,1233,489,10337
"36103158203",1511,30,46,0,184,0,25,25,1821
"36103158205",1952,35,0,0,40,0,70,0,2097
"36103158206",3113,297,30,11,244,31,241,32,3999
"36103158207",3860,117,120,4,483,27,335,8,4954
"36103158304",6398,158,27,11,224,0,427,34,7279
"36103158306",5244,94,36,0,106,0,614,0,6094
"36103158308",7109,325,0,2,1057,0,1951,3,10447
"36103158309",3563,255,554,22,368,67,763,17,5609
"36103158310",3085,198,163,6,380,0,251,11,4094
"36103158315",3549,45,213,29,359,77,575,1,4848
"36103158317",5079,610,0,0,192,15,838,0,6734
"36103158318",4231,146,9,2,170,13,274,13,4858
"36103158319",2778,215,192,27,261,101,342,26,3942
"36103158320",5452,216,44,46,181,275,149,2,6365
"36103158321",7010,306,712,21,1735,114,1391,71,11360
"36103158322",1730,6,170,0,323,0,0,0,2229
"36103158323",6003,320,119,2,413,4,324,4,7189
"36103158401",1319,28,0,0,81,0,122,1,1551
"36103158402",4058,181,0,7,123,0,211,0,4580
"36103158403",1688,88,104,9,165,18,177,20,2269
"36103158405",4531,100,0,0,193,0,334,13,5171
"36103158407",5368,73,50,0,115,12,442,12,6072
"36103158408",3472,394,30,0,190,48,468,19,4621
"36103158409",2960,114,367,21,232,7,332,0,4033
"36103158410",2898,298,77,1,0,0,0,0,3274
"36103158502",3383,305,60,0,148,0,531,0,4427
"36103158505",3733,381,71,0,353,57,326,122,5043
"36103158506",2067,153,12,0,342,17,239,17,2847
"36103158507",3354,112,22,0,460,81,623,0,4652
"36103158508",5837,207,50,70,322,131,735,206,7558
"36103158509",3781,428,166,49,533,65,919,155,6096
"36103158510",6423,193,178,2,464,175,629,238,8302
"36103158511",5605,226,90,0,626,40,1104,16,7707
"36103158512",3224,108,0,48,165,14,401,34,3994
"36103158604",4698,93,0,0,372,3,627,3,5796
"36103158605",4452,250,139,8,373,1,554,83,5860
"36103158606",4117,152,0,0,431,30,713,40,5483
"36103158607",2419,270,290,0,518,34,704,78,4313
"36103158608",2708,192,25,2,337,110,302,23,3699
"36103158609",3934,53,101,4,339,22,334,3,4790
"36103158704",6026,575,1050,358,587,138,1436,138,10308
"36103158705",1085,282,1781,370,228,155,792,139,4832
"36103158707",1300,125,66,9,58,0,177,0,1735
"36103158708",2646,254,393,69,301,0,226,1,3890
"36103158709",1703,334,45,17,85,14,260,28,2486
"36103158710",2967,304,160,169,66,28,286,12,3992
"36103158711",3616,205,751,1,687,41,421,62,5784
"36103158712",6001,675,571,18,218,0,1798,73,9354
"36103158802",4326,137,0,0,75,0,224,0,4762
"36103158803",5803,126,257,2,140,35,841,25,7229
"36103158804",6054,378,41,127,372,62,1245,124,8403
"36103158900",5156,1036,359,325,157,29,1351,618,9031
"36103159000",3531,407,406,73,308,0,982,193,5900
"36103159102",3977,1489,342,70,270,9,563,651,7371
"36103159103",2247,670,1363,891,507,442,1711,831,8662
"36103159105",5838,279,352,68,510,90,1664,96,8897
"36103159106",4137,134,612,1,577,6,833,59,6359
"36103159107",3352,193,0,0,86,0,237,44,3912
"36103159108",6986,372,250,0,544,16,2087,136,10391
"36103159201",2931,105,25,0,30,0,861,23,3975
"36103159203",4901,610,38,16,56,1,453,69,6144
"36103159204",3297,106,191,14,26,0,556,7,4197
"36103159300",1971,93,28,0,59,0,78,8,2237
"36103159404",4849,1012,612,83,844,64,1297,697,9458
"36103159406",3505,292,181,0,125,13,626,81,4823
"36103159407",5250,282,266,53,349,346,983,32,7561
"36103159408",3165,272,248,41,303,11,515,63,4618
"36103159410",7551,243,509,0,165,6,288,0,8762
"36103159411",2698,253,183,29,161,115,228,115,3782
"36103159412",6950,142,73,0,55,44,112,58,7434
"36103159505",6478,206,613,66,687,194,1548,0,9792
"36103159506",5773,767,463,230,713,163,1005,84,9198
"36103159508",5905,764,512,140,266,229,1216,271,9303
"36103159509",2111,242,240,134,48,0,284,46,3105
"36103159510",201,10,0,0,27,0,46,0,284
"36103159511",6006,243,219,207,666,212,1660,15,9228
"36103159512",1917,151,70,487,36,0,196,35,2892
"36103159601",5986,87,33,9,31,0,103,0,6249
"36103159602",3759,128,38,0,56,0,175,0,4156
"36103169701",7366,260,47,0,217,0,422,68,8380
"36103169703",1521,21,8,0,12,2,12,2,1578
"36103169704",5693,292,394,46,275,79,741,0,7520
"36103169800",3773,175,342,399,704,307,1237,307,7244
"36103169901",3628,122,654,757,466,127,412,193,6359
"36103169902",4439,628,53,312,0,0,393,278,6103
"36103170001",5022,148,110,0,158,0,191,25,5654
"36103170002",3592,134,123,16,63,0,87,13,4028
"36103170101",1474,263,196,7,148,151,437,312,2988
"36103170201",5872,129,0,0,180,0,120,0,6301
"36103170202",3495,261,1,0,65,7,205,43,4077
"36103180300",2365,29,22,0,41,0,107,0,2564
"36103190401",4203,864,1346,24,581,261,1971,747,9997
"36103190402",2214,83,25,13,55,0,451,0,2841
"36103190403",2977,195,20,0,177,24,858,38,4289
"36103190502",2222,182,25,0,133,87,169,120,2938
"36103190503",2527,178,22,24,201,0,284,108,3344
"36103190504",1586,29,0,1,11,6,7,0,1640
"36103190601",4122,98,86,0,115,2,90,2,4515
"36103190603",3578,252,0,17,250,69,1182,118,5466
"36103190604",3769,287,20,1,52,0,783,87,4999
"36103190704",2473,43,29,23,61,11,227,0,2867
"36103190705",2811,411,28,0,348,38,624,317,4577
"36103190706",3962,292,143,4,210,0,660,79,5350
"36103190707",4054,431,0,0,309,56,327,425,5602
"36103190708",1959,108,20,2,45,0,118,24,2276
"36103190800",2161,118,227,200,211,11,119,12,3059
"36103200901",1078,26,0,0,24,1,113,1,1243
"36103200902",5847,459,235,0,465,22,768,232,8028
"36103201001",5243,205,43,9,535,211,2263,21,8530
"36103201003",2869,292,407,7,117,0,873,60,4625
"36103201004",2829,355,73,16,108,53,213,90,3737
"36103201100",1941,335,747,24,2690,112,3412,246,9507
"36103990100",0,0,0,0,0,0,0,0,0
"36105950100",3163,318,53,1,7,0,184,10,3736
"36105950200",2844,492,42,157,127,47,148,56,3913
"36105950300",1323,103,19,4,13,0,28,0,1490
"36105950400",2588,408,3,11,17,0,94,29,3150
"36105950500",2005,404,93,40,369,127,238,157,3433
"36105950600",1275,370,2,0,110,2,102,86,1947
"36105950700",3029,658,174,187,423,178,997,336,5982
"36105950800",2558,642,183,219,597,120,552,32,4903
"36105950900",1268,745,81,252,477,68,685,119,3695
"36105951000",1116,129,183,59,145,64,245,125,2066
"36105951100",1660,111,86,51,351,49,633,52,2993
"36105951200",6282,567,386,0,408,22,726,48,8439
"36105951300",3418,463,30,17,307,20,302,120,4677
"36105951500",1063,686,178,24,375,48,452,42,2868
"36105951600",1580,618,85,87,63,158,84,263,2938
"36105951700",3484,217,221,41,182,0,227,44,4416
"36105951800",1925,917,1463,965,664,576,1286,648,8444
"36105951900",1198,369,15,71,244,37,173,117,2224
"36105952000",1944,146,40,74,92,0,44,40,2380
"36105952100",2142,249,24,85,98,44,117,50,2809
"36105952200",1020,116,30,1,42,56,41,50,1356
"36105952300",1039,101,91,31,113,0,48,0,1423
"36105952400",1862,358,86,37,72,11,29,39,2494
"36105952500",2040,364,38,0,175,0,176,59,2852
"36107020100",5453,830,6,2,89,46,27,19,6472
"36107020200",4673,369,29,0,163,12,37,0,5283
"36107020300",6120,336,22,0,123,124,57,0,6782
"36107020401",4744,274,16,3,75,6,37,0,5155
"36107020402",3598,85,0,2,204,1,52,1,3943
"36107020500",3050,505,42,11,179,3,188,94,4072
"36107020600",6699,579,0,0,77,20,56,52,7483
"36107020701",2793,264,24,2,20,0,63,0,3166
"36107020702",3958,464,30,0,12,1,13,1,4479
"36107020703",3291,690,60,27,24,43,10,7,4152
"36109000100",852,219,80,67,184,137,77,72,1688
"36109000200",802,2185,0,10,444,1683,96,252,5472
"36109000300",151,24,0,0,4,24,7,0,210
"36109000400",252,117,0,0,357,79,161,72,1038
"36109000500",2445,370,425,97,911,207,117,3,4575
"36109000600",2460,437,30,3,1184,309,246,156,4825
"36109000700",1803,697,13,24,352,552,151,149,3741
"36109000800",1268,294,94,150,237,120,162,134,2459
"36109000900",2516,375,118,89,198,166,14,139,3615
"36109001000",1892,877,145,292,521,31,235,372,4365
"36109001100",2952,1307,55,84,179,133,69,0,4779
"36109001200",63,30,2,2,36,0,31,0,164
"36109001300",3400,685,164,152,862,1001,127,60,6451
"36109001400",3296,204,24,67,218,19,143,10,3981
"36109001500",4098,445,29,138,1185,179,17,0,6091
"36109001600",3248,574,2,18,132,95,54,6,4129
"36109001700",3951,561,69,90,163,19,50,0,4903
"36109001800",4210,447,43,0,176,0,99,0,4975
"36109001900",5541,558,64,0,111,0,25,0,6299
"36109002000",3197,284,39,29,113,0,44,29,3735
"36109002100",3844,653,8,0,41,0,24,0,4570
"36109002200",3932,445,7,0,47,4,20,4,4459
"36109002300",5094,336,16,0,199,0,313,0,5958
"36111950100",4844,229,169,0,104,0,316,0,5662
"36111950200",3328,456,25,20,110,62,325,204,4530
"36111950300",3862,146,236,17,144,0,166,10,4581
"36111950400",3459,226,19,45,341,19,138,12,4259
"36111950500",2551,156,2,8,252,34,41,13,3057
"36111950600",2397,313,71,0,94,26,126,0,3027
"36111950900",1102,152,18,0,4,29,12,29,1346
"36111951000",3715,449,2,62,177,1,151,0,4557
"36111951100",2034,65,82,0,121,0,108,0,2410
"36111951200",3578,279,46,0,47,0,54,44,4048
"36111951300",3139,378,70,13,52,88,99,0,3839
"36111951400",2701,457,56,2,251,0,111,25,3603
"36111951500",2743,230,36,0,248,58,100,35,3450
"36111951600",1898,125,55,0,78,0,90,27,2273
"36111951700",2597,509,682,113,295,296,342,261,5095
"36111951800",1033,161,276,53,167,20,47,0,1757
"36111951900",1560,334,195,122,321,0,374,0,2906
"36111952000",1234,169,411,121,351,32,385,34,2737
"36111952100",1613,879,801,176,442,345,608,763,5627
"36111952200",3104,274,172,56,67,24,295,55,4047
"36111952300",1370,98,69,0,193,24,119,0,1873
"36111952400",1868,192,242,92,149,11,156,14,2724
"36111952500",2677,188,227,6,237,7,41,7,3390
"36111952600",4983,451,0,26,0,10,145,18,5633
"36111952700",2402,211,36,32,43,22,180,58,2984
"36111952800",2847,214,63,12,56,9,274,0,3475
"36111952900",4973,263,0,25,316,28,63,12,5680
"36111953000",1630,280,0,7,42,0,17,4,1980
"36111953300",3489,130,81,8,230,85,239,115,4377
"36111953400",3346,1098,53,85,190,130,422,132,5456
"36111953500",1391,930,32,41,91,26,74,20,2605
"36111953600",3592,496,266,102,416,108,239,269,5488
"36111953700",4675,267,248,6,100,54,231,0,5581
"36111953800",3270,204,167,1,84,28,188,1,3943
"36111953900",3941,516,186,0,179,230,229,224,5505
"36111954000",3926,386,24,0,348,0,616,31,5331
"36111954100",3815,511,716,74,521,56,1371,98,7162
"36111954200",4850,619,85,7,98,21,330,50,6060
"36111954400",6727,2090,218,220,456,180,458,414,10763
"36111954500",2389,319,11,0,36,46,202,65,3068
"36111954600",1425,391,21,0,24,53,267,0,2181
"36111954700",1419,327,95,52,267,74,365,18,2617
"36111954800",2719,646,357,144,594,158,1087,325,6030
"36111954900",1353,136,0,0,37,0,14,0,1540
"36111955000",4337,425,11,0,491,51,271,45,5631
"36111955300",1941,185,4,7,290,0,47,0,2474
"36111955400",3082,84,2,0,84,14,141,17,3424
"36113070100",2548,193,20,0,50,0,19,0,2830
"36113070200",1301,536,15,43,0,7,15,16,1933
"36113070300",3448,297,43,26,12,0,102,23,3951
"36113070400",3076,475,44,5,141,4,135,9,3889
"36113070500",1666,410,20,16,102,13,27,3,2257
"36113070601",4971,155,0,133,50,0,181,0,5490
"36113070602",1219,165,0,0,83,0,70,0,1537
"36113070701",3346,219,41,0,142,5,81,0,3834
"36113070702",4151,387,49,0,258,113,54,47,5059
"36113070800",5947,1108,0,19,161,0,41,47,7323
"36113070900",4478,175,1,1,44,13,21,0,4733
"36113071000",3137,176,0,17,12,0,50,0,3392
"36113072000",3114,338,1,1,21,7,29,6,3517
"36113073000",3547,468,7,0,0,24,17,24,4087
"36113073500",1610,285,5,16,134,0,43,0,2093
"36113074000",1550,306,0,0,14,0,6,0,1876
"36113075000",2479,521,0,0,0,3,0,2,3005
"36113076000",2042,213,13,0,68,83,20,0,2439
"36113078000",2160,77,85,7,14,0,120,0,2463
"36115080100",3560,1115,5,0,22,119,64,77,4962
"36115080200",1989,339,2,0,71,22,0,0,2423
"36115080300",4796,394,14,0,180,14,143,7,5548
"36115081000",3161,247,33,4,91,0,34,0,3570
"36115082001",3856,986,27,4,60,1,62,17,5013
"36115082002",1050,179,0,0,15,1,16,1,1262
"36115084000",5240,1066,0,19,77,30,54,27,6513
"36115085000",2092,148,0,3,22,6,0,3,2274
"36115086000",1401,265,0,28,18,15,13,0,1740
"36115087000",3243,291,0,0,91,0,0,0,3625
"36115088000",5031,874,6,29,74,11,38,8,6071
"36115089000",4364,377,17,0,113,0,123,11,5005
"36115090000",2296,370,9,4,16,14,56,46,2811
"36115091000",1443,243,3,0,24,0,20,0,1733
"36115092000",2990,282,0,0,64,13,78,0,3427
"36115093000",1762,256,5,0,108,0,0,0,2131
"36115094000",2272,119,0,3,18,0,53,0,2465
"36117020101",4962,111,131,4,145,2,169,2,5526
"36117020102",4161,411,111,0,100,0,124,61,4968
"36117020201",4423,194,16,1,57,0,69,1,4761
"36117020202",4547,58,0,0,102,0,107,0,4814
"36117020301",3476,302,9,0,24,28,22,0,3861
"36117020302",4826,270,7,7,135,10,213,1,5469
"36117020401",2473,87,88,78,12,26,0,26,2790
"36117020402",3447,343,14,140,122,92,188,25,4371
"36117020500",4132,378,15,59,121,3,16,3,4727
"36117020600",3546,568,9,0,147,41,18,0,4329
"36117020700",2853,526,3,72,25,110,80,0,3669
"36117020800",2485,179,107,129,44,2,27,7,2980
"36117020900",3652,666,375,216,239,16,162,53,5379
"36117021000",4963,739,20,58,101,11,91,41,6024
"36117021100",3861,700,310,25,217,10,377,24,5524
"36117021200",2935,632,302,140,272,46,403,70,4800
"36117021400",2528,732,275,43,110,57,193,95,4033
"36117021501",1904,107,0,0,0,144,23,90,2268
"36117021502",3530,531,12,30,54,30,51,65,4303
"36117021600",3640,501,61,39,51,8,89,70,4459
"36117021700",3319,286,36,39,112,0,227,49,4068
"36117021800",1545,314,45,7,58,13,25,28,2035
"36117990100",0,0,0,0,0,0,0,0,0
"36119000101",520,376,847,115,1822,773,2190,1099,7742
"36119000103",843,631,1304,855,1367,609,1747,1068,8424
"36119000104",0,0,0,0,0,0,0,0,0
"36119000201",1445,273,942,335,3396,918,4318,1102,12729
"36119000202",1453,64,404,231,1500,268,1679,302,5901
"36119000203",1570,137,312,50,1084,88,1390,124,4755
"36119000300",1469,371,813,277,1048,685,2096,1057,7816
"36119000401",1097,466,885,408,604,220,1060,569,5309
"36119000402",759,404,1800,567,1086,293,1367,771,7047
"36119000500",792,478,716,204,528,564,1299,933,5514
"36119000600",2006,1468,2053,229,1140,188,2043,1359,10486
"36119000701",2051,92,651,20,692,26,936,23,4491
"36119000702",2277,162,1737,154,286,258,1209,343,6426
"36119000801",3566,755,615,0,524,83,965,632,7140
"36119000802",1686,116,433,25,382,8,671,122,3443
"36119000803",2622,281,523,59,615,140,1244,225,5709
"36119000900",1971,226,327,3,467,0,493,143,3630
"36119001000",186,248,589,352,309,126,387,264,2461
"36119001101",1203,317,332,371,560,612,1403,777,5575
"36119001102",1343,208,779,484,1260,759,1328,776,6937
"36119001200",1637,416,265,468,1160,590,1773,1022,7331
"36119001301",2010,48,768,0,1866,21,2283,21,7017
"36119001302",1004,288,684,287,1038,369,1077,547,5294
"36119001303",368,408,856,708,3597,1621,2902,1779,12239
"36119001401",2364,176,440,2,762,130,830,195,4899
"36119001402",1190,17,129,23,383,106,363,93,2304
"36119001403",2387,266,176,17,648,0,761,119,4374
"36119001502",1904,202,297,0,178,129,574,52,3336
"36119001503",2295,109,165,0,391,53,569,9,3591
"36119001504",3398,81,445,9,778,117,718,0,5546
"36119001505",979,173,297,43,290,15,457,63,2317
"36119001600",1696,531,299,38,538,107,1054,461,4724
"36119001700",5652,140,1014,93,644,14,1701,46,9304
"36119001800",463,21,1011,51,124,46,368,46,2130
"36119001900",1053,10,171,0,343,0,261,0,1838
"36119002000",3349,27,266,12,962,0,897,0,5513
"36119002101",2376,131,402,0,672,0,421,34,4036
"36119002103",2922,55,109,1,143,1,131,0,3362
"36119002104",3871,128,657,13,693,0,1255,30,6647
"36119002105",1550,22,73,2,344,0,109,1,2101
"36119002106",581,35,746,28,1263,137,423,52,3265
"36119002107",873,87,76,14,403,254,191,273,2171
"36119002201",1876,72,252,74,282,7,286,20,2869
"36119002202",4252,133,74,0,416,10,505,38,5428
"36119002203",1043,129,124,0,267,0,200,65,1828
"36119002204",3295,344,230,0,144,77,475,109,4674
"36119002300",2506,188,296,220,430,121,598,165,4524
"36119002401",1232,18,120,0,264,29,325,30,2018
"36119002402",2302,265,393,21,596,73,936,77,4663
"36119002403",3307,430,783,9,811,334,1050,105,6829
"36119002404",1854,106,77,11,693,158,486,93,3478
"36119002405",1983,140,0,20,848,53,646,23,3713
"36119002600",130,46,2463,839,319,11,208,42,4058
"36119002700",24,218,2331,718,153,181,109,335,4069
"36119002800",29,7,1408,636,181,0,14,7,2282
"36119002900",61,0,2668,1062,135,0,157,27,4110
"36119003000",134,30,1745,112,748,98,493,98,3458
"36119003100",92,6,1394,465,181,45,296,0,2479
"36119003200",172,0,1579,436,147,67,246,137,2784
"36119003300",184,34,2030,490,46,10,135,44,2973
"36119003400",356,120,3298,478,315,48,602,206,5423
"36119003500",264,81,995,408,271,65,367,120,2571
"36119003600",1025,168,1287,211,870,155,1029,245,4990
"36119003700",1380,149,956,296,721,328,818,363,5011
"36119003800",1458,130,798,295,495,24,445,70,3715
"36119003900",2243,118,852,25,178,0,674,38,4128
"36119004000",1461,367,3753,341,716,38,794,191,7661
"36119004100",368,151,2703,279,626,57,269,163,4616
"36119004200",1720,20,2649,124,224,18,359,0,5114
"36119004300",460,60,684,5,83,9,45,0,1346
"36119004400",2049,72,740,10,281,220,14,1,3387
"36119004500",1224,252,242,33,60,6,151,0,1968
"36119004600",2455,33,0,1,353,83,103,1,3029
"36119004700",2919,84,13,0,155,6,218,0,3395
"36119004800",4470,238,878,54,794,68,654,175,7331
"36119004900",2058,152,51,0,402,20,88,0,2771
"36119005001",2735,53,177,0,695,41,306,0,4007
"36119005002",4034,72,11,12,281,0,200,0,4610
"36119005100",3543,97,136,90,150,0,260,0,4276
"36119005200",4398,162,12,1,267,15,215,21,5091
"36119005300",3345,85,632,12,1106,47,772,35,6034
"36119005400",1446,7,7,8,169,40,112,40,1829
"36119005500",4840,163,270,12,234,0,219,0,5738
"36119005600",0,0,0,0,0,0,0,0,0
"36119005701",4432,249,645,207,341,326,1388,0,7588
"36119005702",1358,209,460,64,360,259,611,243,3564
"36119005800",2583,196,608,18,782,44,1798,138,6167
"36119005901",2335,397,299,164,420,87,1473,275,5450
"36119005902",3130,168,1292,125,565,29,850,67,6226
"36119006000",2089,462,664,185,696,69,789,449,5403
"36119006100",1761,946,649,78,469,34,737,615,5289
"36119006200",3298,799,634,113,818,237,2680,824,9403
"36119006300",2476,262,755,644,1457,524,2849,682,9649
"36119006400",1665,225,2484,473,698,22,1343,89,6999
"36119006500",2089,141,1471,324,994,154,1447,295,6915
"36119006600",4209,534,659,12,332,68,676,114,6604
"36119006700",4381,123,218,25,239,74,189,14,5263
"36119006801",4938,70,93,0,480,2,101,0,5684
"36119006802",4838,109,447,20,203,28,279,20,5944
"36119006900",5325,128,38,2,392,0,149,13,6047
"36119007000",5497,322,0,4,339,0,198,0,6360
"36119007100",5122,227,16,5,422,106,319,21,6238
"36119007200",4473,180,154,58,1135,308,775,173,7256
"36119007300",2373,222,199,35,1518,414,1569,384,6714
"36119007401",3624,83,220,7,603,10,835,2,5384
"36119007402",2738,52,21,8,257,0,278,0,3354
"36119007500",4056,106,12,1,444,17,190,0,4826
"36119007600",6026,48,19,20,174,0,158,0,6445
"36119007700",4010,186,93,0,398,110,396,166,5359
"36119007800",1202,42,607,177,1871,499,2619,508,7525
"36119007900",2519,290,669,33,3435,907,3706,958,12517
"36119008000",530,209,400,154,2695,998,2810,1121,8917
"36119008100",2631,49,159,15,1389,387,2152,381,7163
"36119008200",4734,295,395,11,1437,110,1818,172,8972
"36119008301",1961,99,176,23,444,117,512,117,3449
"36119008302",5813,247,0,4,389,18,224,0,6695
"36119008401",1775,55,10,0,321,0,149,0,2310
"36119008403",2754,77,39,3,910,96,491,60,4430
"36119008404",3550,265,14,6,990,222,639,255,5941
"36119008500",2920,107,13,0,133,0,123,0,3296
"36119008602",3690,138,73,21,310,19,81,0,4332
"36119008700",4357,507,19,0,612,286,1446,590,7817
"36119008800",1982,245,669,48,1191,177,1035,267,5614
"36119008901",3779,232,365,61,901,50,1905,89,7382
"36119008902",1777,39,319,38,1313,143,1525,155,5309
"36119009000",2124,299,350,122,1189,213,1139,408,5844
"36119009100",2460,321,766,121,2022,113,3006,317,9126
"36119009200",3160,333,686,326,2239,76,3333,456,10609
"36119009300",942,108,548,573,613,74,455,125,3438
"36119009400",1575,238,528,129,1310,388,1312,518,5998
"36119009500",3110,101,487,76,1004,28,1597,13,6416
"36119009600",3708,22,338,10,222,75,168,75,4618
"36119009701",2636,38,11,0,155,4,172,0,3016
"36119009702",1794,67,129,22,261,22,145,34,2474
"36119009703",3633,98,113,0,513,60,322,56,4795
"36119009800",3884,21,21,37,424,1,126,23,4537
"36119009900",2326,70,67,3,477,5,103,1,3052
"36119010000",4109,14,80,16,1034,0,134,0,5387
"36119010100",3600,76,0,0,1012,51,293,0,5032
"36119010200",4369,33,60,2,262,34,167,26,4953
"36119010300",2319,226,7,0,288,0,320,0,3160
"36119010400",2327,36,66,113,615,0,697,40,3894
"36119010500",5607,177,168,26,818,0,671,0,7467
"36119010600",3251,72,165,0,928,45,521,13,4995
"36119010701",3877,307,168,13,1189,12,121,0,5687
"36119010702",4126,65,197,7,970,105,197,0,5667
"36119010801",2242,110,235,0,635,45,276,11,3554
"36119010803",2221,52,276,28,627,14,400,7,3625
"36119010804",1670,97,152,0,381,58,213,25,2596
"36119010901",1118,25,548,38,248,18,125,17,2137
"36119010902",2466,10,2363,112,1122,0,1046,5,7124
"36119010903",1540,58,2149,303,740,122,1092,156,6160
"36119011000",699,36,1084,0,807,27,636,27,3316
"36119011101",3625,107,542,9,1257,0,846,49,6435
"36119011102",2014,49,219,8,487,0,173,0,2950
"36119011200",1628,120,873,16,1077,363,893,416,5386
"36119011300",5376,198,68,0,818,0,698,0,7158
"36119011400",5047,183,273,2,449,5,595,0,6554
"36119011500",2972,300,420,6,1100,20,1443,76,6337
"36119011600",3992,457,190,91,1673,677,3819,1043,11942
"36119011700",2248,153,0,5,360,2,181,3,2952
"36119011800",4190,84,19,5,658,7,227,2,5192
"36119011902",3358,122,0,24,616,9,475,22,4626
"36119012000",4030,123,13,50,309,10,352,0,4887
"36119012101",4699,148,36,0,414,48,325,23,5693
"36119012102",4209,100,43,0,419,105,584,98,5558
"36119012200",6221,101,84,14,336,0,543,0,7299
"36119012301",1725,34,155,0,447,111,362,111,2945
"36119012303",4554,92,43,69,250,0,288,0,5296
"36119012304",4113,103,54,0,172,0,119,0,4561
"36119012400",4665,176,94,0,154,56,178,0,5323
"36119012501",2521,52,10,3,173,2,62,3,2826
"36119012502",5442,176,91,0,393,9,255,0,6366
"36119012503",3219,28,146,1,223,0,141,0,3758
"36119012600",3460,102,138,6,557,119,289,89,4760
"36119012700",3941,147,43,0,300,15,345,0,4791
"36119012802",5427,385,304,1,989,12,1291,248,8657
"36119012900",2390,167,82,25,1366,592,1637,602,6861
"36119013000",3765,237,339,169,1443,282,1608,353,8196
"36119013102",5211,301,136,34,630,27,182,14,6535
"36119013103",4214,62,47,0,500,39,166,15,5043
"36119013104",5313,67,72,0,783,0,156,0,6391
"36119013201",3196,52,37,15,517,0,126,1,3944
"36119013202",2175,207,17,0,312,14,150,14,2889
"36119013301",629,279,518,104,840,594,1264,730,4958
"36119013304",1890,181,570,121,1687,346,2308,567,7670
"36119013400",3567,703,323,30,1512,419,2199,822,9575
"36119013500",2624,61,173,2,751,123,1070,130,4934
"36119013600",2331,262,209,76,1305,748,1465,974,7370
"36119013700",4277,276,122,13,531,25,560,7,5811
"36119013800",2869,77,63,1,145,1,174,28,3358
"36119013900",3757,212,438,11,414,1,664,23,5520
"36119014000",1690,22,91,12,366,65,373,46,2665
"36119014100",2863,342,923,335,1138,263,1386,236,7486
"36119014200",1374,40,847,41,1041,348,1211,362,5264
"36119014300",456,117,801,264,1418,576,1291,582,5505
"36119014400",2440,119,1623,219,1497,157,1706,176,7937
"36119014500",2684,96,320,297,745,84,460,247,4933
"36119014604",3061,156,134,0,512,58,508,57,4486
"36119014605",2060,87,181,0,720,10,522,0,3580
"36119014606",4786,109,275,0,389,88,225,88,5960
"36119014607",3223,78,407,0,571,18,672,37,5006
"36119014701",3575,91,491,56,528,11,636,28,5416
"36119014703",5055,135,98,33,927,41,1228,48,7565
"36119014704",1785,169,340,95,208,146,514,263,3520
"36119014804",6246,61,57,42,870,125,1337,120,8858
"36119014805",3228,91,81,3,384,0,331,2,4120
"36119014806",5885,37,263,0,343,13,636,0,7177
"36119014808",3200,38,23,2,192,1,281,1,3738
"36119014809",5929,40,202,77,458,8,574,0,7288
"36119014810",1873,74,32,0,83,0,193,0,2255
"36119014811",5421,117,141,2,281,0,324,88,6374
"36119014901",5586,150,8,0,268,24,125,26,6187
"36119014903",3728,104,16,0,248,0,121,0,4217
"36119014907",3382,20,45,1,235,0,122,1,3806
"36119014908",2794,20,31,2,211,0,127,2,3187
"36119014909",2923,241,14,0,143,0,130,117,3568
"36119015000",4403,147,46,0,287,0,300,56,5239
"36119981000",84,244,15,83,261,84,16,42,829
"36119982000",8,3,0,0,0,0,0,0,11
"36119983000",13,68,34,113,0,0,11,33,272
"36119984000",26,25,5,11,46,0,46,12,171
"36119985000",0,0,0,0,0,0,0,0,0
"36121970100",2428,185,0,0,4,22,12,8,2659
"36121970200",3670,216,43,0,75,25,24,0,4053
"36121970300",3132,172,0,0,35,11,43,0,3393
"36121970400",3378,232,27,13,22,16,5,25,3718
"36121970500",3901,772,0,0,46,56,0,82,4857
"36121970600",3785,659,49,27,46,30,9,3,4608
"36121970700",2485,354,15,0,15,0,4,149,3022
"36121970800",2689,309,0,1,39,0,24,11,3073
"36121970900",1917,88,6,0,27,9,0,0,2047
"36121971000",3707,415,0,1,35,0,7,13,4178
"36121971100",2279,344,4,0,28,23,62,12,2752
"36123150100",4856,1099,0,21,94,30,148,25,6273
"36123150200",4616,708,24,14,6,0,41,2,5411
"36123150300",4251,926,5,22,30,22,22,35,5313
"36123150400",2524,439,3,0,63,37,69,37,3172
"36123150500",3584,499,0,0,140,0,10,6,4239
"37001020100",2478,510,471,379,125,274,233,220,4690
"37001020200",1207,470,636,322,680,455,710,471,4951
"37001020300",2378,791,1826,760,971,490,1030,818,9064
"37001020400",1030,189,2212,954,412,477,484,208,5966
"37001020501",2438,315,262,210,402,140,270,117,4154
"37001020502",1111,289,875,552,591,432,684,432,4966
"37001020601",2941,162,29,0,521,0,131,0,3784
"37001020602",2003,105,185,47,193,44,84,0,2661
"37001020701",3543,221,596,46,354,0,135,0,4895
"37001020702",2438,410,1148,150,206,21,35,42,4450
"37001020801",1175,27,45,190,24,5,72,0,1538
"37001020802",1948,605,1275,1069,840,345,744,192,7018
"37001020901",2165,322,325,87,430,316,839,370,4854
"37001020902",2158,84,222,0,168,713,138,713,4196
"37001021000",994,648,551,351,484,229,393,209,3859
"37001021101",1484,169,456,49,596,118,405,134,3411
"37001021102",2360,238,380,269,137,15,44,0,3443
"37001021201",2269,514,1021,379,667,225,687,315,6077
"37001021204",2793,396,630,160,464,176,678,277,5574
"37001021205",3602,420,604,183,82,0,128,0,5019
"37001021206",2805,343,754,35,863,766,586,766,6918
"37001021207",2359,444,98,181,72,16,94,0,3264
"37001021300",3439,280,1374,310,309,94,178,50,6034
"37001021400",1912,260,74,34,35,132,78,61,2586
"37001021500",3484,499,273,151,195,15,149,15,4781
"37001021600",3090,847,703,7,154,0,35,0,4836
"37001021701",2938,132,136,2,338,0,326,0,3872
"37001021702",3018,591,428,192,94,33,0,25,4381
"37001021703",3336,414,343,65,498,517,121,504,5798
"37001021801",3699,668,217,0,0,0,83,0,4667
"37001021802",3279,466,159,0,32,0,0,0,3936
"37001021803",2755,275,19,7,54,0,278,2,3390
"37001021901",3265,400,253,26,213,276,164,276,4873
"37001021902",3138,406,266,62,134,47,219,7,4279
"37001022001",2340,150,275,75,152,41,144,41,3218
"37001022002",2538,148,510,152,226,160,280,141,4155
"37003040100",2946,471,8,12,6,9,0,4,3456
"37003040200",3069,390,101,0,32,6,47,6,3651
"37003040300",2655,185,49,177,108,0,0,0,3174
"37003040400",3987,1402,604,202,136,165,122,182,6800
"37003040500",5058,1154,399,0,573,379,446,283,8292
"37003040600",4013,694,36,6,117,238,156,219,5479
"37003040700",5814,729,86,0,241,0,87,0,6957
"37005950100",3311,628,0,10,0,183,198,119,4449
"37005950200",2286,726,26,7,338,120,406,117,4026
"37005950300",2650,414,2,2,57,55,102,89,3371
"37007920100",1379,316,1039,196,57,12,0,0,2999
"37007920200",918,188,460,160,33,10,0,0,1769
"37007920300",3321,497,1376,690,174,80,16,0,6154
"37007920400",508,188,1613,314,0,69,71,68,2831
"37007920500",2437,499,1644,881,244,60,255,0,6020
"37007920600",1376,427,1901,1310,4,0,12,288,5318
"37009970200",2524,519,0,12,39,12,26,22,3154
"37009970300",1687,605,0,8,48,22,61,0,2431
"37009970400",3028,821,8,12,108,29,126,54,4186
"37009970500",4568,1349,31,0,147,345,92,411,6943
"37009970700",4837,658,0,22,103,2,47,2,5671
"37009970800",3818,834,12,0,127,379,52,422,5644
"37011930100",1948,656,7,1,60,1,45,43,2761
"37011930200",2628,309,0,3,167,69,51,131,3358
"37011930301",2591,436,11,13,301,51,135,128,3666
"37011930302",1966,796,0,0,210,16,0,25,3013
"37011930400",2619,303,0,30,238,122,94,78,3484
"37013930100",3096,394,1091,1010,105,152,391,165,6404
"37013930200",3954,1035,968,369,76,0,24,334,6760
"37013930300",1344,491,1043,874,133,96,71,111,4163
"37013930400",2052,220,1022,1109,0,79,123,59,4664
"37013930501",2839,250,400,173,540,683,566,731,6182
"37013930502",2523,236,536,92,123,174,51,174,3909
"37013930600",2720,403,0,31,37,0,25,0,3216
"37013930700",2454,260,231,24,29,1,0,1,3000
"37013930800",1281,96,866,274,33,62,10,0,2622
"37013930900",2710,150,532,161,76,0,105,0,3734
"37013931000",3697,362,669,611,45,3,349,0,5736
"37015960100",2492,217,2075,524,47,11,1,0,5367
"37015960200",1132,195,1993,448,0,39,3,143,3953
"37015960300",725,92,1717,954,12,0,5,0,3505
"37015960400",2030,311,2839,1790,47,31,105,3,7156
"37017950100",3284,777,720,562,62,317,96,102,5920
"37017950200",1515,354,798,449,207,108,188,197,3816
"37017950300",2998,941,1064,268,361,403,221,920,7176
"37017950400",2000,457,1909,1327,269,186,198,176,6522
"37017950500",4557,612,684,536,41,36,200,20,6686
"37017950600",2171,222,2344,1156,496,149,125,43,6706
"37019020101",1096,359,533,650,102,36,218,146,3140
"37019020102",1594,450,178,95,217,71,102,279,2986
"37019020103",6012,684,513,277,368,33,542,0,8429
"37019020104",2522,605,867,93,1146,232,716,381,6562
"37019020201",2365,148,642,8,236,35,142,21,3597
"37019020202",4973,529,302,476,402,0,128,0,6810
"37019020203",1962,223,138,117,32,9,65,0,2546
"37019020204",4332,825,372,12,94,136,1,0,5772
"37019020303",1895,388,175,0,90,0,0,0,2548
"37019020304",4549,126,61,0,94,0,85,0,4915
"37019020305",1970,187,288,289,92,43,20,11,2900
"37019020306",1632,261,0,3,144,0,0,0,2040
"37019020307",126,6,0,0,0,0,0,0,132
"37019020308",1625,106,0,0,0,0,0,0,1731
"37019020309",2144,234,157,0,81,8,48,0,2672
"37019020310",2027,267,0,0,31,10,18,0,2353
"37019020402",2016,429,5,22,120,94,72,17,2775
"37019020403",2914,595,130,88,111,94,0,80,4012
"37019020404",1751,625,272,1,77,13,116,1,2856
"37019020405",2131,458,66,244,60,0,28,0,2987
"37019020504",1279,6,88,44,30,0,6,0,1453
"37019020505",1774,854,543,588,177,39,369,153,4497
"37019020506",3052,652,397,104,31,45,198,54,4533
"37019020507",5089,970,238,74,136,0,63,29,6599
"37019020508",2004,354,46,34,51,0,170,0,2659
"37019020509",3600,707,63,30,42,15,173,164,4794
"37019020510",1455,518,0,0,55,21,75,65,2189
"37019020511",2133,245,0,0,10,49,85,49,2571
"37019020512",988,35,0,0,4,0,39,0,1066
"37019020601",3236,513,552,179,207,80,190,60,5017
"37019020602",3627,400,920,40,64,38,97,29,5215
"37019020603",1026,393,499,410,95,60,170,8,2661
"37019990100",0,0,0,0,0,0,0,0,0
"37021000100",602,280,30,45,25,3,73,30,1088
"37021000200",804,270,90,271,45,55,36,25,1596
"37021000300",1024,520,386,150,45,28,116,32,2301
"37021000400",1982,621,121,21,74,11,21,0,2851
"37021000500",3108,273,49,1,131,0,95,59,3716
"37021000600",1171,363,325,114,113,15,27,13,2141
"37021000700",598,158,413,105,3,7,0,0,1284
"37021000800",2335,276,149,73,197,0,37,0,3067
"37021000900",588,527,881,1050,111,95,80,68,3400
"37021001000",2680,529,310,570,183,119,66,209,4666
"37021001100",3243,459,163,233,155,22,77,30,4382
"37021001200",3485,658,71,163,118,72,101,24,4692
"37021001300",2375,838,124,181,221,224,162,308,4433
"37021001400",3796,2241,575,289,608,116,465,955,9045
"37021001500",1504,471,48,1,186,0,92,83,2385
"37021001600",4479,985,41,47,69,0,150,113,5884
"37021001700",1948,267,0,0,63,0,38,0,2316
"37021001801",2770,510,282,10,26,0,124,0,3722
"37021001802",3489,409,187,0,240,8,98,34,4465
"37021001900",2353,253,88,52,153,7,131,14,3051
"37021002000",2882,804,945,469,205,110,176,0,5591
"37021002101",1499,46,0,0,15,0,38,0,1598
"37021002102",3095,758,983,176,417,41,631,95,6196
"37021002203",3029,1261,351,286,677,62,739,1013,7418
"37021002204",5867,684,219,115,438,0,320,45,7688
"37021002205",6301,189,105,94,198,25,318,25,7255
"37021002206",3692,480,55,133,446,0,125,0,4931
"37021002301",5377,327,59,342,269,203,429,494,7500
"37021002302",6614,568,69,5,196,0,163,58,7673
"37021002401",2468,991,0,2,16,27,68,27,3599
"37021002402",4207,753,0,37,46,0,286,462,5791
"37021002503",3241,838,0,0,154,147,393,242,5015
"37021002504",3141,1022,4,0,267,16,0,0,4450
"37021002505",3479,640,33,2,11,0,173,0,4338
"37021002506",2346,396,42,37,90,0,70,0,2981
"37021002603",3386,506,1,2,20,0,50,0,3965
"37021002604",4455,1032,5,0,394,0,211,37,6134
"37021002605",3841,833,53,1,55,25,187,109,5104
"37021002606",2978,397,146,0,162,139,101,154,4077
"37021002607",3490,511,57,2,185,0,263,0,4508
"37021002701",2392,424,2,1,107,0,106,178,3210
"37021002702",3533,340,10,0,106,46,68,0,4103
"37021002703",4575,889,12,0,153,0,151,104,5884
"37021002803",3777,530,23,1,81,20,100,169,4701
"37021002804",4089,139,12,0,237,0,0,0,4477
"37021002900",2588,474,0,0,140,33,0,0,3235
"37021003001",6871,842,144,178,210,33,168,18,8464
"37021003002",5226,952,231,173,82,26,248,180,7118
"37021003102",4004,579,246,270,123,68,77,0,5367
"37021003103",1365,238,51,25,102,0,0,0,1781
"37021003104",3964,856,17,406,114,0,108,92,5557
"37021003201",1409,69,36,1,130,0,53,0,1698
"37021003202",3474,459,32,0,100,0,28,0,4093
"37021003203",4703,549,152,1,190,86,625,150,6456
"37021003204",4753,485,179,0,271,227,378,0,6293
"37021003205",1312,169,0,0,33,17,25,17,1573
"37023020100",3021,761,348,144,87,180,83,249,4873
"37023020201",4318,718,209,71,11,44,18,78,5467
"37023020202",3104,382,228,14,370,180,97,0,4375
"37023020301",3331,479,614,53,516,39,55,12,5099
"37023020302",5937,691,46,81,698,157,163,0,7773
"37023020500",1861,332,223,207,137,251,194,81,3286
"37023020600",2805,1097,631,333,336,720,86,1109,7117
"37023020801",3802,894,202,120,245,168,62,143,5636
"37023020802",2453,335,72,41,281,31,130,0,3343
"37023020900",5731,860,108,9,805,15,93,126,7747
"37023021000",4570,1051,14,29,365,95,21,3,6148
"37023021100",4066,1072,96,61,231,129,61,168,5884
"37023021201",2783,653,18,0,59,90,26,19,3648
"37023021202",2788,729,0,0,212,148,189,140,4206
"37023021203",3139,1152,76,0,97,0,0,0,4464
"37023021301",3494,707,8,41,47,243,28,93,4661
"37023021302",2080,758,0,0,43,79,9,0,2969
"37023021400",2772,602,294,224,313,221,792,286,5504
"37025040500",7079,1825,1758,136,690,118,986,1327,13919
"37025040600",5481,533,212,2,111,0,0,0,6339
"37025040701",1001,651,47,0,0,0,52,0,1751
"37025040702",3565,656,1931,199,400,17,656,383,7807
"37025040703",907,75,795,457,153,0,108,0,2495
"37025040800",2092,634,485,225,99,50,279,119,3983
"37025040900",1143,328,262,0,169,5,231,5,2143
"37025041000",2936,1774,1184,608,118,171,166,667,7624
"37025041100",4948,312,987,320,199,64,228,91,7149
"37025041200",4007,522,505,79,319,105,146,84,5767
"37025041301",3366,241,508,75,231,0,109,0,4530
"37025041302",5173,236,1913,46,409,32,468,0,8277
"37025041303",5059,247,1375,10,1355,0,788,172,9006
"37025041501",6821,492,1610,0,453,94,171,0,9641
"37025041502",4389,1011,667,68,377,56,232,264,7064
"37025041503",2487,74,405,0,222,11,248,21,3468
"37025041601",6523,523,437,21,193,0,168,43,7908
"37025041602",2463,188,22,24,14,17,11,0,2739
"37025041701",3352,251,128,25,100,13,0,0,3869
"37025041702",2799,450,9,0,56,0,19,0,3333
"37025041901",479,693,618,75,27,35,107,594,2628
"37025041902",1761,1199,352,210,438,76,808,772,5616
"37025042000",2875,613,370,254,96,8,147,149,4512
"37025042101",843,72,1049,868,108,102,634,108,3784
"37025042102",2649,177,420,333,82,84,233,32,4010
"37025042200",5443,331,247,46,471,1,741,75,7355
"37025042300",3130,480,392,272,346,116,624,323,5683
"37025042401",2977,219,123,14,22,62,255,62,3734
"37025042402",2976,286,609,313,324,33,952,172,5665
"37025042501",3502,191,301,19,162,0,24,0,4199
"37025042502",2026,83,602,148,38,0,366,0,3263
"37025042503",2446,154,280,212,334,48,113,78,3665
"37025042504",1117,169,97,0,59,0,0,0,1442
"37025042601",4368,53,356,91,353,0,225,0,5446
"37025042602",2243,629,347,193,641,284,383,392,5112
"37025042603",5627,271,722,0,173,0,338,0,7131
"37025042604",3554,211,297,0,485,0,221,8,4776
"37027030100",2421,633,482,544,323,414,328,112,5257
"37027030200",2926,1320,404,259,297,100,267,38,5611
"37027030300",2362,749,592,61,202,13,70,364,4413
"37027030400",3049,884,26,80,545,137,507,158,5386
"37027030500",3583,431,155,3,97,87,91,0,4447
"37027030600",3940,665,0,0,63,12,112,0,4792
"37027030700",5271,1146,0,0,337,0,313,0,7067
"37027030800",5311,1210,284,149,612,46,488,17,8117
"37027030900",3303,1297,173,65,154,16,67,0,5075
"37027031000",2623,326,24,0,62,6,61,0,3102
"37027031100",3355,389,29,11,60,17,12,0,3873
"37027031201",3824,816,22,14,107,36,119,0,4938
"37027031202",3718,848,65,0,21,0,7,0,4659
"37027031300",7247,1049,0,0,173,16,187,0,8672
"37027031401",2709,536,0,32,135,332,122,92,3958
"37027031402",2443,571,74,8,52,65,158,132,3503
"37027031403",1727,429,3,0,9,0,50,0,2218
"37029950101",3778,212,591,142,217,18,82,0,5040
"37029950102",4096,125,512,101,181,0,156,0,5171
"37031970101",982,140,0,0,0,0,0,25,1147
"37031970102",2224,400,90,61,43,0,19,39,2876
"37031970103",2651,273,0,0,0,0,0,0,2924
"37031970200",1358,91,0,0,5,3,0,0,1457
"37031970301",3089,544,385,234,68,111,42,190,4663
"37031970302",471,257,216,133,4,114,0,38,1233
"37031970303",485,19,50,0,0,0,0,0,554
"37031970304",1370,320,153,276,45,67,14,37,2282
"37031970401",703,351,113,4,69,185,16,57,1498
"37031970402",683,273,212,271,59,37,5,12,1552
"37031970403",1011,148,0,0,0,0,0,0,1159
"37031970501",1333,525,363,44,69,53,69,139,2595
"37031970502",1655,90,22,0,157,0,191,0,2115
"37031970503",1928,208,212,79,19,12,0,6,2464
"37031970504",1256,307,8,8,156,15,171,88,2009
"37031970601",981,147,27,0,32,38,3,0,1228
"37031970602",1107,14,0,0,24,0,0,0,1145
"37031970603",1171,194,60,0,176,47,81,0,1729
"37031970604",1884,128,0,0,0,0,41,0,2053
"37031970605",1064,97,91,0,35,13,0,9,1309
"37031970701",1003,252,57,0,31,0,78,0,1421
"37031970702",2305,590,122,138,325,24,197,217,3918
"37031970703",3182,450,282,31,381,79,105,0,4510
"37031970704",1780,299,0,2,182,2,21,0,2286
"37031970801",1947,134,26,5,67,0,0,0,2179
"37031970802",1576,84,17,0,58,0,31,0,1766
"37031970803",1364,103,8,0,6,0,17,0,1498
"37031970804",2970,79,73,4,126,16,81,12,3361
"37031970805",1363,346,0,9,35,0,49,0,1802
"37031970901",1131,65,0,0,78,0,98,0,1372
"37031970902",1078,40,0,0,0,0,77,0,1195
"37031970903",1053,126,0,0,87,0,61,0,1327
"37031971001",282,14,0,0,0,0,0,0,296
"37031971002",1420,82,0,0,35,0,50,0,1587
"37031971101",938,52,0,0,14,90,0,0,1094
"37031971102",696,69,0,0,41,0,0,0,806
"37031980100",0,0,0,0,0,0,0,0,0
"37031990100",0,0,0,0,0,0,0,0,0
"37031990200",0,0,0,0,0,0,0,0,0
"37033930100",842,357,688,453,94,0,91,26,2551
"37033930200",1633,454,1377,910,206,129,69,35,4813
"37033930300",2515,785,478,201,73,36,52,75,4215
"37033930400",1210,254,830,80,5,2,0,0,2381
"37033930500",1914,404,972,101,17,121,38,40,3607
"37033930600",3406,392,827,309,61,26,154,52,5227
"37035010101",5184,568,12,210,233,15,0,20,6242
"37035010102",3371,168,253,3,227,12,185,12,4231
"37035010201",3664,440,43,0,287,533,525,184,5676
"37035010202",5096,980,499,359,867,140,736,357,9034
"37035010301",4332,344,13,3,386,61,458,269,5866
"37035010302",4487,233,177,97,267,0,80,29,5370
"37035010303",2918,700,52,25,286,61,74,400,4516
"37035010304",2935,320,86,38,756,100,789,148,5172
"37035010401",4514,847,511,42,329,656,423,724,8046
"37035010402",1842,683,336,168,390,305,339,444,4507
"37035010501",2654,130,176,16,153,91,152,40,3412
"37035010502",3035,240,55,0,39,0,9,73,3451
"37035010600",4072,767,310,340,362,144,41,103,6139
"37035010700",1123,524,228,77,143,116,242,75,2528
"37035010900",583,360,1538,847,469,48,388,34,4267
"37035011000",1009,357,304,255,182,193,250,263,2813
"37035011101",2583,157,385,81,162,0,325,0,3693
"37035011102",4632,1167,775,79,412,338,523,313,8239
"37035011200",3482,508,382,238,480,46,681,12,5829
"37035011300",4052,1274,553,313,519,519,538,739,8507
"37035011401",2891,223,219,25,226,83,23,101,3791
"37035011402",3043,489,128,30,90,0,78,106,3964
"37035011501",4260,362,219,48,73,8,91,3,5064
"37035011503",3473,49,0,18,106,116,118,84,3964
"37035011504",4678,199,83,0,150,0,15,0,5125
"37035011601",3070,271,265,58,366,58,133,26,4247
"37035011602",4095,1101,54,1,82,0,61,111,5505
"37035011701",3031,491,253,120,561,81,279,74,4890
"37035011702",5052,689,639,85,846,0,84,21,7416
"37035011801",5444,307,386,3,338,35,233,27,6773
"37035011802",5268,597,0,20,277,253,206,127,6748
"37037020103",3019,196,255,22,631,71,544,82,4820
"37037020104",4667,122,157,0,78,29,0,0,5053
"37037020105",2343,181,180,67,65,0,112,129,3077
"37037020106",3205,166,349,33,276,20,91,0,4140
"37037020200",6196,606,520,61,224,0,180,147,7934
"37037020300",2094,206,446,46,17,37,217,119,3182
"37037020401",2702,814,857,177,1128,43,1970,741,8432
"37037020402",1349,1132,1176,142,684,330,1171,1251,7235
"37037020500",3205,621,353,60,59,0,156,40,4494
"37037020600",3955,430,593,361,204,41,253,27,5864
"37037020701",4115,191,197,26,443,138,215,0,5325
"37037020702",2864,206,492,138,152,5,54,7,3918
"37037020800",5443,744,1151,326,257,132,355,392,8800
"37039930100",3377,742,26,30,444,85,199,75,4978
"37039930200",1539,207,0,0,122,0,24,0,1892
"37039930300",1479,388,0,2,198,66,87,0,2220
"37039930400",4920,1026,68,68,301,53,139,41,6616
"37039930500",3981,737,14,86,77,29,38,0,4962
"37039930601",2698,544,0,0,0,56,40,34,3372
"37039930602",2821,693,18,0,15,0,32,0,3579
"37041930101",1461,750,1365,1507,0,0,32,0,5115
"37041930102",1507,171,182,200,204,0,10,0,2274
"37041930200",4373,1002,928,535,233,14,217,208,7510
"37043950100",3752,1011,25,14,15,0,19,0,4836
"37043950200",4046,1326,3,0,101,192,31,230,5929
"37045950101",4329,878,10,0,102,101,80,108,5608
"37045950102",2192,115,145,0,25,0,1,0,2478
"37045950200",2896,478,747,114,67,9,76,43,4430
"37045950301",2598,251,649,249,13,113,91,58,4022
"37045950302",4062,641,614,162,42,0,15,131,5667
"37045950400",4012,900,858,254,229,168,111,0,6532
"37045950500",2406,930,304,257,95,51,127,31,4201
"37045950601",3128,479,234,59,63,8,0,0,3971
"37045950602",3882,1238,511,102,275,0,121,3,6132
"37045950700",4416,547,1225,719,53,24,185,0,7169
"37045950800",2799,218,1121,414,55,20,427,9,5063
"37045950900",399,330,1236,962,75,22,0,37,3061
"37045951000",1762,253,304,992,13,84,0,41,3449
"37045951100",962,186,589,860,163,24,74,31,2889
"37045951200",3027,461,1068,631,281,40,225,40,5773
"37045951300",2303,300,131,145,8,2,102,62,3053
"37045951400",4270,829,939,219,152,0,123,82,6614
"37045951501",3621,496,589,35,42,18,45,64,4910
"37045951502",974,126,114,9,0,27,0,32,1282
"37045951503",2007,170,118,29,37,0,56,0,2417
"37045951601",2534,177,1268,465,13,6,13,0,4476
"37045951602",3382,891,502,150,50,0,75,24,5074
"37047930100",1736,390,1527,150,152,125,130,28,4238
"37047930200",777,96,362,246,442,155,11,117,2206
"37047930300",1286,106,129,194,487,70,0,11,2283
"37047930400",1865,370,985,694,403,55,182,0,4554
"37047930500",2381,291,824,331,480,1,382,1,4691
"37047930600",2059,354,524,611,88,58,76,43,3813
"37047930700",2021,264,1345,696,213,19,88,0,4646
"37047930800",2168,398,552,473,564,64,521,64,4804
"37047930900",1398,869,989,1121,82,264,0,0,4723
"37047931000",3253,588,399,218,30,568,19,533,5608
"37047931100",2452,613,57,61,53,1,1,33,3271
"37047931200",3451,849,1307,1408,155,66,40,123,7399
"37047931300",3591,637,653,282,75,2,0,145,5385
"37049960101",3565,125,114,0,60,0,174,0,4038
"37049960102",4020,583,171,111,196,69,122,55,5327
"37049960200",4042,584,1701,435,288,266,407,207,7930
"37049960300",3593,514,1582,462,440,33,318,33,6975
"37049960401",2880,161,588,59,182,98,31,0,3999
"37049960402",1737,58,1043,254,231,363,4,22,3712
"37049960403",4055,137,0,0,0,0,25,9,4226
"37049960404",2748,200,91,11,59,10,104,20,3243
"37049960500",4155,708,1871,582,494,526,530,405,9271
"37049960600",2157,252,916,477,343,145,146,2,4438
"37049960700",1409,85,71,50,225,52,64,0,1956
"37049960800",355,79,873,1450,25,57,25,11,2875
"37049960900",849,153,148,1255,1,379,72,0,2857
"37049961001",7393,442,984,402,298,25,279,12,9835
"37049961002",3174,333,233,77,151,106,79,115,4268
"37049961100",6384,601,1058,263,738,79,598,28,9749
"37049961201",2873,700,330,0,178,46,375,295,4797
"37049961202",560,60,43,0,237,5,97,0,1002
"37049961301",2472,654,545,0,550,241,253,555,5270
"37049961302",3113,626,792,651,238,118,557,245,6340
"37049961303",2113,110,1436,319,283,0,104,0,4365
"37051000200",131,67,570,888,17,99,38,25,1835
"37051000500",880,205,244,395,220,131,80,63,2218
"37051000600",3334,332,1362,163,225,0,33,0,5449
"37051000701",4204,177,508,107,664,58,152,14,5884
"37051000702",1582,175,166,211,80,198,9,0,2421
"37051000800",1502,389,465,230,165,35,124,12,2922
"37051000900",2821,350,567,332,264,193,414,191,5132
"37051001000",304,37,1077,1052,136,79,154,59,2898
"37051001100",100,20,2040,982,66,159,12,106,3485
"37051001200",1270,174,2141,1390,360,30,164,11,5540
"37051001400",2490,328,1669,593,293,158,333,69,5933
"37051001500",1403,326,655,191,126,15,116,115,2947
"37051001601",3561,559,1976,248,921,224,536,168,8193
"37051001603",1940,295,767,646,348,140,190,30,4356
"37051001604",2580,531,2464,986,781,132,629,104,8207
"37051001700",3676,633,2509,773,1190,462,808,454,10505
"37051001800",1190,412,453,51,205,73,104,13,2501
"37051001901",958,107,318,258,247,197,159,95,2339
"37051001902",1896,502,1583,281,608,215,486,143,5714
"37051001903",1719,534,870,391,425,56,252,84,4331
"37051002001",1681,100,670,92,390,13,410,48,3404
"37051002002",1922,354,1740,344,537,123,691,107,5818
"37051002100",2313,93,730,202,488,154,372,93,4445
"37051002200",511,198,376,145,215,63,172,60,1740
"37051002300",1049,217,1653,752,444,163,412,83,4773
"37051002401",183,44,674,816,231,129,290,126,2493
"37051002402",559,65,1674,569,209,97,181,37,3391
"37051002501",1918,332,3932,489,620,37,447,19,7794
"37051002502",2859,427,1445,596,506,108,404,61,6406
"37051002503",2466,58,1510,342,286,90,386,0,5138
"37051002504",3305,200,1835,417,412,214,445,131,6959
"37051002600",2579,370,645,285,178,26,3,14,4100
"37051002700",4972,467,1618,172,647,90,249,183,8398
"37051002800",4860,470,620,109,290,53,117,74,6593
"37051002900",2624,488,927,350,221,92,85,0,4787
"37051003001",6691,669,1810,273,1598,292,1009,229,12571
"37051003002",1702,103,598,177,96,42,163,13,2894
"37051003102",2800,344,893,112,275,45,482,19,4970
"37051003103",3054,353,1246,106,352,169,305,59,5644
"37051003104",3205,874,965,334,427,339,549,341,7034
"37051003201",7139,555,2625,125,1619,99,1030,28,13220
"37051003203",1983,246,2180,817,805,99,738,96,6964
"37051003204",3422,669,2838,418,842,149,794,169,9301
"37051003205",1694,66,2105,406,734,206,408,189,5808
"37051003302",1462,116,2265,1123,300,261,211,76,5814
"37051003304",2607,128,2534,817,694,118,318,358,7574
"37051003305",2038,124,2629,304,623,130,782,46,6676
"37051003307",1369,45,1673,414,497,81,425,90,4594
"37051003309",3233,211,1590,175,667,29,936,29,6870
"37051003310",1908,571,1848,289,419,0,478,172,5685
"37051003311",1125,38,801,137,211,99,162,8,2581
"37051003312",2499,647,2537,273,941,60,587,345,7889
"37051003313",1306,162,2653,369,786,15,614,72,5977
"37051003314",2251,287,2531,593,528,62,675,82,7009
"37051003401",2175,196,531,130,378,200,728,212,4550
"37051003402",0,0,0,0,0,0,0,0,0
"37051003403",2064,274,243,93,904,145,727,108,4558
"37051003404",0,0,0,0,0,0,0,0,0
"37051003405",1255,105,230,14,231,207,451,84,2577
"37051003406",968,0,66,0,59,13,128,13,1247
"37051003407",328,198,235,130,212,50,139,165,1457
"37051003408",3107,491,875,24,610,15,790,86,5998
"37051003500",1674,310,1587,683,695,434,431,216,6030
"37051003600",1907,500,1346,557,534,152,421,137,5554
"37051003700",4648,663,1239,167,382,0,319,0,7418
"37051003800",276,51,892,992,107,55,113,14,2500
"37051980100",0,0,0,0,0,0,0,0,0
"37051980200",0,0,0,0,0,0,0,0,0
"37053110101",783,51,0,0,4,0,0,0,838
"37053110102",1615,124,0,0,3,0,30,13,1785
"37053110200",5716,396,226,295,358,0,156,0,7147
"37053110301",3526,431,70,53,157,0,147,0,4384
"37053110302",2005,227,157,17,61,0,61,89,2617
"37053110401",2561,309,115,3,20,7,103,0,3118
"37053110402",3439,308,464,68,111,22,161,0,4573
"37053990100",0,0,0,0,0,0,0,0,0
"37055970101",3423,93,0,0,171,0,113,0,3800
"37055970102",3001,210,0,4,65,25,24,0,3329
"37055970200",4102,222,56,53,163,21,232,62,4911
"37055970300",5331,523,69,4,139,58,123,0,6247
"37055970400",2494,164,0,2,47,0,166,0,2873
"37055970501",1063,157,7,0,51,48,67,0,1393
"37055970502",3202,310,0,0,613,11,717,1,4854
"37055970601",4411,486,423,360,338,153,562,194,6927
"37055970602",1885,68,0,0,8,8,0,0,1969
"37055990100",0,0,0,0,0,0,0,0,0
"37055990200",0,0,0,0,0,0,0,0,0
"37057060101",3962,171,1004,0,119,0,289,0,5545
"37057060102",6595,573,63,0,125,0,218,0,7574
"37057060201",4193,266,298,92,74,20,174,21,5138
"37057060202",2361,226,22,10,48,0,96,0,2763
"37057060203",4479,724,135,0,39,0,197,33,5607
"37057060301",3783,204,483,0,91,0,45,0,4606
"37057060302",3229,195,77,0,129,30,19,0,3679
"37057060303",3573,458,347,32,42,132,103,35,4722
"37057060304",3038,455,0,1,18,36,18,108,3674
"37057060400",4392,502,259,0,349,63,143,14,5722
"37057060500",4592,462,0,0,226,0,330,7,5617
"37057060601",3985,279,0,13,96,0,59,148,4580
"37057060602",2679,105,18,0,0,0,217,0,3019
"37057060700",2221,414,918,944,96,104,451,222,5370
"37057060800",1294,741,955,941,123,409,267,539,5269
"37057060900",2837,732,462,129,582,50,815,109,5716
"37057061000",2698,758,330,703,456,282,632,372,6231
"37057061100",4851,1288,284,0,61,25,196,193,6898
"37057061201",2998,1540,399,176,953,93,186,669,7014
"37057061202",2786,152,8,0,143,0,328,0,3417
"37057061300",1300,243,124,270,44,0,91,0,2072
"37057061400",947,564,362,674,49,30,507,166,3299
"37057061500",2651,408,1614,505,159,228,649,134,6348
"37057061600",1569,517,230,272,93,85,257,292,3315
"37057061701",4180,538,95,20,72,26,40,0,4971
"37057061702",5618,666,150,46,228,0,225,0,6933
"37057061703",3385,405,0,22,213,29,274,0,4328
"37057061802",5484,1087,15,0,169,62,159,0,6976
"37057061803",2163,401,673,155,152,99,82,83,3808
"37057061804",5433,583,204,0,88,0,0,0,6308
"37057061901",5191,1422,18,0,90,0,136,25,6882
"37057061902",4485,463,0,2,87,136,16,12,5201
"37057062001",3777,828,0,0,10,0,0,0,4615
"37057062002",2862,783,3,3,7,3,7,13,3681
"37059080100",6448,922,261,16,424,154,647,195,9067
"37059080200",4587,345,60,0,192,0,191,0,5375
"37059080300",7543,290,285,9,257,76,177,0,8637
"37059080400",4437,540,30,80,2,18,0,4,5111
"37059080500",2449,721,448,92,220,123,463,80,4596
"37059080600",2467,343,309,126,52,0,65,0,3362
"37059080700",4148,731,445,487,341,384,294,435,7265
"37061090100",5226,677,279,53,1188,1954,1672,2150,13199
"37061090200",1957,285,652,250,510,504,597,519,5274
"37061090300",1867,204,1598,932,502,345,609,311,6368
"37061090400",2533,218,2133,942,519,377,784,461,7967
"37061090501",3650,1246,415,68,59,190,63,212,5903
"37061090502",2676,522,870,228,224,45,203,125,4893
"37061090600",2491,512,448,50,58,78,32,0,3669
"37061090701",1490,235,728,1041,586,275,586,275,5216
"37061090702",3152,607,1096,417,889,216,918,331,7626
"37061090801",503,196,653,298,470,585,508,678,3891
"37061090802",2176,645,655,698,720,408,710,431,6443
"37063000101",750,140,893,429,462,26,334,8,3042
"37063000102",1948,495,891,534,339,116,777,490,5590
"37063000200",1213,307,663,743,176,130,286,265,3783
"37063000301",833,362,805,198,307,160,275,313,3253
"37063000302",2143,342,511,134,306,135,626,35,4232
"37063000401",2510,159,48,5,133,88,82,13,3038
"37063000402",1064,362,117,56,327,27,116,40,2109
"37063000500",363,253,894,672,192,207,118,10,2709
"37063000600",2732,517,886,946,349,222,969,236,6857
"37063000700",1621,128,644,311,198,31,305,0,3238
"37063000900",265,145,683,472,99,60,274,157,2155
"37063001001",147,1124,1286,1148,339,545,327,1224,6140
"37063001002",642,816,1512,1313,751,390,1051,1011,7486
"37063001100",377,307,874,1026,106,134,243,347,3414
"37063001301",102,23,448,328,9,98,85,32,1125
"37063001303",100,6,829,274,36,3,117,6,1371
"37063001304",53,138,1216,1178,109,64,43,156,2957
"37063001400",27,0,1085,1489,97,165,115,0,2978
"37063001501",9,21,0,0,0,43,0,6,79
"37063001502",951,1159,1134,817,1658,421,1123,780,8043
"37063001503",0,0,0,0,0,0,0,0,0
"37063001601",3354,138,1731,331,572,24,694,28,6872
"37063001603",4422,357,1079,42,367,0,542,44,6853
"37063001604",5137,55,904,87,425,36,40,0,6684
"37063001705",2396,348,1125,26,392,0,386,193,4866
"37063001706",1939,308,1201,269,442,294,77,286,4816
"37063001707",5279,282,300,9,710,383,399,359,7721
"37063001708",271,148,3309,289,438,157,81,96,4789
"37063001709",927,122,2541,2152,352,204,717,58,7073
"37063001710",1379,309,1506,209,670,57,580,187,4897
"37063001711",1397,168,1464,218,524,498,729,483,5481
"37063001801",2281,393,3558,674,433,30,658,354,8381
"37063001802",1213,414,3175,1009,692,451,1013,739,8706
"37063001806",2297,378,2398,84,269,0,308,244,5978
"37063001807",2370,412,4494,581,938,478,831,746,10850
"37063001808",2747,51,1983,8,511,0,526,0,5826
"37063001809",2747,520,2170,126,666,59,584,341,7213
"37063001900",1979,93,165,50,89,0,118,0,2494
"37063002007",2753,120,1361,29,446,115,355,115,5294
"37063002008",2762,14,53,0,270,0,159,0,3258
"37063002009",211,114,2940,623,318,426,395,473,5500
"37063002013",2915,92,871,111,559,88,340,37,5013
"37063002015",1865,297,1047,545,876,319,723,360,6032
"37063002016",1688,1095,1342,459,594,637,1100,1346,8261
"37063002017",4922,168,556,68,841,135,342,14,7046
"37063002018",5623,492,927,429,650,1,114,76,8312
"37063002019",3594,521,261,11,330,108,324,0,5149
"37063002020",3588,354,1481,5,707,11,327,2,6475
"37063002021",2389,294,1036,190,455,101,158,136,4759
"37063002022",2070,369,1495,114,520,59,387,12,5026
"37063002023",1998,19,440,79,120,25,171,0,2852
"37063002024",3351,155,1265,117,769,42,279,0,5978
"37063002025",2092,56,2917,114,546,161,644,80,6610
"37063002026",1268,54,2901,978,264,124,509,0,6098
"37063002027",3096,269,2169,775,1149,154,960,109,8681
"37063002028",3270,144,1443,217,891,45,439,40,6489
"37063002100",5015,129,730,12,125,49,84,68,6212
"37063002200",868,269,164,206,246,42,129,0,1924
"37063002300",16,180,311,303,5,232,0,320,1367
"37063980100",90,0,0,0,0,0,0,0,90
"37065020200",686,255,2819,1904,27,93,0,55,5839
"37065020300",416,227,2879,1602,8,102,0,19,5253
"37065020400",169,39,2772,1776,0,9,15,0,4780
"37065020600",819,193,1209,353,28,0,47,64,2713
"37065020700",557,36,841,424,284,0,214,0,2356
"37065020800",1089,266,1707,413,4,0,14,0,3493
"37065020900",140,10,2050,871,27,11,12,0,3121
"37065021000",1008,41,1126,671,49,0,81,0,2976
"37065021100",1839,373,1554,306,4,182,251,437,4946
"37065021200",2643,121,1277,471,157,0,111,0,4780
"37065021300",3020,231,1008,459,218,439,145,485,6005
"37065021400",2825,681,519,178,13,0,136,0,4352
"37065021500",1567,225,976,482,0,0,0,0,3250
"37065021600",1949,149,468,195,95,2,36,0,2894
"37067000100",580,203,139,128,22,81,0,7,1160
"37067000200",408,189,94,403,7,3,7,0,1111
"37067000301",81,135,1091,656,14,4,59,91,2131
"37067000302",37,201,526,485,201,74,233,230,1987
"37067000400",95,356,1697,1042,138,137,208,553,4226
"37067000500",23,317,742,1197,57,153,76,384,2949
"37067000600",42,119,1032,966,8,53,13,171,2404
"37067000700",0,6,528,1260,0,0,0,0,1794
"37067000801",9,177,168,367,53,40,56,200,1070
"37067000802",180,426,484,511,110,63,206,500,2480
"37067000900",980,647,404,418,143,57,145,471,3265
"37067001000",2534,1315,581,130,266,334,668,1131,6959
"37067001100",1053,283,245,252,141,11,57,88,2130
"37067001200",1740,26,148,7,49,0,43,6,2019
"37067001300",860,515,95,99,53,0,14,12,1648
"37067001400",755,630,1711,378,179,246,588,707,5194
"37067001500",1101,487,1332,698,198,146,575,385,4922
"37067001601",64,31,3222,864,163,38,113,61,4556
"37067001602",149,255,1214,1400,127,0,110,185,3440
"37067001700",737,168,2233,1366,112,298,280,489,5683
"37067001800",238,332,1714,1214,232,299,260,491,4780
"37067001901",280,509,368,204,4,87,152,395,1999
"37067001902",947,121,346,147,0,17,131,23,1732
"37067002001",719,105,687,282,222,229,352,237,2833
"37067002002",1235,495,708,201,203,78,306,485,3711
"37067002100",1477,175,308,45,46,0,97,0,2148
"37067002200",3005,327,323,50,210,60,446,44,4465
"37067002501",2433,81,21,0,28,0,38,0,2601
"37067002502",2860,8,0,0,0,0,7,0,2875
"37067002601",2432,89,39,33,180,5,9,5,2792
"37067002603",4493,488,766,35,570,143,659,75,7229
"37067002604",4578,103,658,90,118,334,322,334,6537
"37067002701",1725,928,1627,658,515,405,1090,774,7722
"37067002702",1403,458,1747,922,495,24,715,153,5917
"37067002703",1292,1318,1735,912,705,125,609,270,6966
"37067002801",3645,367,414,0,21,0,50,0,4497
"37067002804",2550,131,760,250,186,0,727,73,4677
"37067002806",1344,169,807,37,119,39,532,67,3114
"37067002807",3065,365,975,264,181,0,539,173,5562
"37067002808",2905,65,246,23,183,9,18,0,3449
"37067002809",1491,152,227,65,155,0,146,0,2236
"37067002901",2495,697,1285,74,119,25,195,299,5189
"37067002903",1972,892,1113,39,30,32,142,400,4620
"37067002904",1602,370,21,0,58,25,39,56,2171
"37067003002",1457,618,1488,393,13,56,16,87,4128
"37067003003",2211,103,451,66,10,0,190,0,3031
"37067003004",2976,93,620,6,116,0,69,0,3880
"37067003103",4897,167,400,17,85,13,181,0,5760
"37067003105",2612,364,388,151,70,119,43,132,3879
"37067003106",2703,185,38,6,94,10,140,10,3186
"37067003107",3171,219,355,330,231,67,400,15,4788
"37067003108",2818,349,137,186,118,195,616,367,4786
"37067003201",3663,159,306,212,193,76,155,76,4840
"37067003202",2159,465,96,59,292,289,185,393,3938
"37067003307",2305,424,373,87,156,0,69,0,3414
"37067003308",6214,148,897,92,425,232,477,167,8652
"37067003309",1946,206,1713,215,317,56,784,50,5287
"37067003310",2248,444,1510,50,104,80,125,244,4805
"37067003311",1217,82,476,16,181,0,134,16,2122
"37067003312",2190,114,73,11,178,15,34,11,2626
"37067003313",1273,107,21,18,0,0,0,21,1440
"37067003314",2460,293,51,85,144,31,138,0,3202
"37067003315",2692,194,466,50,269,10,303,0,3984
"37067003402",1543,287,40,10,81,30,122,51,2164
"37067003403",1046,743,708,274,122,459,316,1022,4690
"37067003404",1021,600,1329,561,211,363,449,867,5401
"37067003500",2382,426,1557,672,477,700,1297,795,8306
"37067003600",3494,803,1003,298,409,148,566,670,7391
"37067003701",1792,1200,1572,623,436,200,749,1144,7716
"37067003702",2307,238,1129,181,673,58,738,29,5353
"37067003703",3718,239,1713,166,563,14,891,13,7317
"37067003803",2716,136,1199,310,152,0,242,44,4799
"37067003804",2345,505,804,205,300,66,103,297,4625
"37067003805",2240,984,1904,721,312,0,282,575,7018
"37067003806",1976,187,584,167,320,0,238,0,3472
"37067003903",1895,209,861,170,550,456,484,80,4705
"37067003904",3792,553,774,234,699,0,170,250,6472
"37067003905",2473,333,311,46,257,120,97,137,3774
"37067003906",3043,143,71,9,139,0,117,0,3522
"37067003908",2784,28,82,209,56,0,28,0,3187
"37067003909",3868,60,135,14,224,0,183,0,4484
"37067004005",4189,211,74,1,106,14,28,0,4623
"37067004007",6800,113,302,44,244,11,183,0,7697
"37067004009",3393,171,100,0,111,10,49,71,3905
"37067004010",2604,118,300,175,144,0,44,0,3385
"37067004011",4428,157,493,0,142,0,137,0,5357
"37067004012",3813,398,596,58,477,82,313,82,5819
"37067004013",2046,307,147,0,833,88,891,210,4522
"37067004014",2351,203,21,0,175,0,105,0,2855
"37067004015",2828,203,498,8,203,0,90,0,3830
"37067004102",2550,600,231,22,101,20,16,0,3540
"37067004103",2796,401,300,29,351,54,77,0,4008
"37067004104",3339,256,301,0,213,0,25,0,4134
"37069060100",1791,296,1199,710,45,97,14,57,4209
"37069060200",1629,430,765,184,207,233,190,234,3872
"37069060301",2760,381,1409,514,20,0,412,0,5496
"37069060302",711,499,1004,142,1,57,1,31,2446
"37069060401",1509,284,582,52,170,27,235,93,2952
"37069060402",1873,417,1747,547,149,132,228,129,5222
"37069060501",4029,453,1007,127,260,0,423,0,6299
"37069060502",5829,386,629,30,680,213,581,73,8421
"37069060600",5655,742,746,244,493,349,457,111,8797
"37069060700",3476,666,1075,91,222,94,77,421,6122
"37069060801",2385,286,860,410,155,77,361,308,4842
"37069060802",3702,315,766,64,299,0,283,13,5442
"37071030101",2265,417,221,11,131,28,46,0,3119
"37071030102",2287,522,495,68,128,23,43,48,3614
"37071030203",2022,174,48,0,17,28,0,0,2289
"37071030204",2246,128,291,0,42,43,129,43,2922
"37071030205",2482,889,12,0,11,0,0,0,3394
"37071030301",1952,433,68,14,24,43,0,55,2589
"37071030302",2279,570,5,3,19,9,23,0,2908
"37071030401",3416,585,1,9,64,0,59,0,4134
"37071030402",2827,493,339,0,11,0,36,17,3723
"37071030501",1768,505,10,0,116,0,60,0,2459
"37071030502",2794,286,227,314,46,0,47,0,3714
"37071030601",2193,468,85,20,176,18,69,137,3166
"37071030602",1450,253,198,3,151,6,142,0,2203
"37071030700",1898,438,437,45,174,22,23,54,3091
"37071030801",943,119,35,40,0,16,0,8,1161
"37071030802",2598,1017,270,161,38,231,38,186,4539
"37071030901",1546,377,364,77,101,0,75,0,2540
"37071030902",1646,681,844,130,90,0,251,47,3689
"37071031001",2276,477,0,0,115,47,32,47,2994
"37071031003",3662,168,41,0,106,104,8,104,4193
"37071031004",1905,236,83,0,160,0,0,0,2384
"37071031101",1472,278,513,71,34,0,0,0,2368
"37071031102",1355,403,272,66,25,59,43,0,2223
"37071031201",2060,306,193,0,415,27,327,54,3382
"37071031202",1366,143,144,200,90,1,274,0,2218
"37071031301",2425,244,438,86,268,43,275,32,3811
"37071031302",2879,636,460,11,682,233,687,354,5942
"37071031401",867,707,263,323,357,154,344,154,3169
"37071031402",1948,227,104,0,196,0,56,0,2531
"37071031500",1327,779,659,483,13,341,79,565,4246
"37071031600",2296,553,810,272,111,8,39,0,4089
"37071031701",2408,473,153,15,131,66,100,48,3394
"37071031703",2046,271,406,40,9,0,44,20,2836
"37071031704",2487,718,182,206,83,174,0,11,3861
"37071031800",1015,511,1193,558,435,276,516,369,4873
"37071031900",300,322,940,902,62,155,56,0,2737
"37071032000",582,203,879,399,83,26,45,6,2223
"37071032100",1126,208,472,149,164,97,140,79,2435
"37071032200",2810,381,199,31,179,25,125,0,3750
"37071032301",1848,184,200,71,83,0,156,0,2542
"37071032302",1861,507,54,7,160,8,0,16,2613
"37071032401",3811,248,146,11,32,0,92,0,4340
"37071032402",3979,116,97,11,393,0,140,0,4736
"37071032502",3020,239,101,0,154,0,76,0,3590
"37071032505",1637,64,877,160,251,100,81,92,3262
"37071032506",1556,31,692,125,418,320,284,296,3722
"37071032507",2614,193,324,38,692,56,349,82,4348
"37071032508",2308,49,107,44,53,0,121,0,2682
"37071032600",3162,287,526,0,177,52,294,0,4498
"37071032702",1142,149,283,14,278,17,63,14,1960
"37071032703",933,163,322,121,175,2,117,3,1836
"37071032704",2912,270,817,62,187,207,180,198,4833
"37071032800",2932,613,1044,814,182,245,136,35,6001
"37071032900",1555,842,641,763,50,53,5,146,4055
"37071033100",1026,139,699,173,123,182,145,18,2505
"37071033202",1418,249,59,142,106,158,149,0,2281
"37071033203",939,140,656,227,195,261,391,228,3037
"37071033204",1389,376,646,445,571,295,549,328,4599
"37071033303",2745,107,227,0,85,0,83,0,3247
"37071033304",3211,348,434,19,58,71,58,83,4282
"37071033305",3445,403,227,23,306,0,116,0,4520
"37071033306",1230,183,1,14,58,23,27,0,1536
"37071033307",1653,204,133,1,26,20,19,0,2056
"37071033400",1528,378,173,130,66,204,52,174,2705
"37071033500",3748,698,438,31,464,45,257,27,5708
"37073970100",2815,479,873,461,31,10,98,10,4777
"37073970200",2267,241,1007,435,73,6,84,0,4113
"37073970300",1627,194,761,495,103,13,0,0,3193
"37075920100",1972,350,6,0,88,12,0,20,2448
"37075920200",2315,617,0,0,188,0,0,0,3120
"37075920300",1840,647,23,4,387,191,110,68,3270
"37077970101",2404,288,1460,615,116,74,3,16,4976
"37077970102",2074,170,1296,265,106,97,163,26,4197
"37077970200",2143,596,1148,314,162,4,184,330,4881
"37077970300",2573,311,491,287,249,41,62,89,4103
"37077970400",1215,39,1436,1060,30,153,71,15,4019
"37077970500",1670,139,1382,397,53,365,99,450,4555
"37077970601",3978,448,655,24,420,78,423,78,6104
"37077970602",5601,469,865,145,524,14,513,0,8131
"37077970603",3769,223,1544,411,76,18,161,53,6255
"37077970701",3257,249,996,202,549,26,454,23,5756
"37077970702",644,360,683,115,135,175,198,140,2450
"37077970703",1878,218,414,37,297,0,306,100,3250
"37077970704",0,0,0,0,0,0,0,0,0
"37079950101",1783,517,718,244,304,669,258,1029,5522
"37079950102",1264,85,807,518,232,270,211,183,3570
"37079950200",2624,383,978,112,282,197,426,340,5342
"37079950300",3524,234,2126,934,168,326,145,319,7776
"37081010100",230,102,820,215,173,6,0,6,1552
"37081010200",1701,320,789,805,635,258,439,148,5095
"37081010300",451,173,539,191,661,455,319,248,3037
"37081010401",1366,83,10,53,102,56,0,0,1670
"37081010403",1150,76,235,52,73,1,60,1,1648
"37081010404",2277,24,257,0,50,110,12,0,2730
"37081010500",1669,299,35,11,33,0,21,0,2068
"37081010601",1780,446,176,242,219,38,89,114,3104
"37081010602",1789,1415,182,163,105,188,34,50,3926
"37081010701",1026,341,66,20,117,11,9,17,1607
"37081010702",680,343,18,60,41,49,17,36,1244
"37081010800",1021,130,183,276,39,19,63,7,1738
"37081010900",862,94,282,659,71,17,12,60,2057
"37081011000",0,0,662,513,73,0,58,0,1306
"37081011101",271,128,2464,1407,49,160,36,192,4707
"37081011102",8,9,2152,877,52,0,11,0,3109
"37081011200",346,233,1938,1597,208,217,54,136,4729
"37081011300",15,66,1822,890,133,7,35,42,3010
"37081011400",61,156,1425,2763,93,115,0,100,4713
"37081011500",816,623,579,479,144,36,296,236,3209
"37081011601",653,144,635,458,267,68,186,16,2427
"37081011602",1240,535,768,360,197,278,744,597,4719
"37081011904",787,229,2143,641,301,191,117,100,4509
"37081011905",1080,290,2106,613,200,227,200,365,5081
"37081012503",2880,397,445,129,430,376,253,123,5033
"37081012504",1284,189,1092,553,265,115,209,132,3839
"37081012505",4063,64,93,2,227,0,53,0,4502
"37081012508",2815,182,125,11,197,0,73,0,3403
"37081012509",1935,65,128,0,66,16,0,16,2226
"37081012510",2823,85,82,23,211,0,21,0,3245
"37081012511",4508,75,142,7,85,0,18,0,4835
"37081012601",2597,525,1385,547,277,77,1122,290,6820
"37081012604",1244,156,2688,665,592,210,702,97,6354
"37081012607",1212,32,826,36,157,9,409,0,2681
"37081012608",706,361,910,534,545,108,950,397,4511
"37081012609",2242,268,1875,1073,1589,240,537,331,8155
"37081012610",670,180,1044,447,413,385,146,142,3427
"37081012611",663,494,944,575,411,151,185,299,3722
"37081012612",1070,295,2695,1263,418,121,0,124,5986
"37081012617",663,185,1612,473,410,43,70,175,3631
"37081012703",2684,106,1499,786,430,107,86,0,5698
"37081012704",798,79,1131,329,430,607,214,412,4000
"37081012705",27,17,1987,1699,231,173,7,102,4243
"37081012706",137,246,1652,978,128,109,20,171,3441
"37081012707",244,194,937,749,69,208,229,365,2995
"37081012803",1785,656,3569,721,158,123,88,301,7401
"37081012804",282,72,2739,471,193,32,136,0,3925
"37081012805",180,166,1652,257,403,14,14,15,2701
"37081013601",281,21,511,437,23,27,70,4,1374
"37081013602",1686,251,1255,515,235,398,315,312,4967
"37081013700",2968,349,332,26,164,3,160,23,4025
"37081013800",384,268,1788,1213,115,321,122,253,4464
"37081013900",224,123,1185,2175,77,665,199,294,4942
"37081014000",1220,604,384,416,253,306,265,219,3667
"37081014200",485,393,1509,886,107,277,138,241,4036
"37081014300",466,336,366,907,166,261,220,273,2995
"37081014406",346,92,1574,281,151,0,119,12,2575
"37081014407",3949,345,467,639,302,15,461,103,6281
"37081014408",531,243,729,377,279,221,317,325,3022
"37081014409",1977,212,247,266,155,92,229,0,3178
"37081014410",2031,368,847,338,73,145,98,279,4179
"37081014411",1233,165,2226,616,294,207,650,37,5428
"37081014412",1323,84,703,65,113,24,139,0,2451
"37081014501",607,272,109,136,169,77,188,150,1708
"37081014502",1497,675,1184,458,423,465,247,230,5179
"37081014503",557,454,1332,437,243,480,133,238,3874
"37081015100",2862,395,645,33,311,0,314,0,4560
"37081015200",4805,528,1897,204,785,121,654,68,9062
"37081015300",4442,417,2674,181,103,67,243,0,8127
"37081015401",3163,174,1719,23,179,0,169,30,5457
"37081015402",2742,718,1812,1097,436,949,551,868,9173
"37081015500",1785,694,3077,654,361,95,381,0,7047
"37081015600",8129,431,499,8,282,509,390,495,10743
"37081015703",3936,264,983,117,381,0,237,0,5918
"37081015704",4027,384,1231,168,589,41,284,16,6740
"37081015705",2176,311,414,144,106,0,100,0,3251
"37081015706",3461,196,1585,285,193,67,248,44,6079
"37081015707",5046,268,1214,213,215,0,105,0,7061
"37081015800",6584,205,388,0,304,234,49,234,7998
"37081015901",4144,238,130,1,383,322,425,333,5976
"37081015902",3019,97,376,35,252,0,102,0,3881
"37081016003",3555,64,256,94,195,0,108,0,4272
"37081016005",1247,64,129,0,268,0,76,0,1784
"37081016006",2326,97,700,54,239,1,236,0,3653
"37081016007",3960,347,714,128,310,35,201,34,5729
"37081016008",5528,317,298,2,652,0,183,29,7009
"37081016009",2901,230,383,12,300,48,108,23,4005
"37081016010",1798,143,274,56,460,9,422,0,3162
"37081016011",2304,288,1986,345,743,34,543,0,6243
"37081016101",3267,484,347,31,136,32,43,32,4372
"37081016102",1293,376,1093,631,283,18,41,50,3785
"37081016103",2894,375,1130,331,410,20,384,30,5574
"37081016201",4815,154,64,0,492,0,235,16,5776
"37081016203",3296,132,297,0,404,0,105,26,4260
"37081016204",2086,75,543,8,391,4,61,0,3168
"37081016205",2326,27,607,94,562,112,142,28,3898
"37081016303",3106,75,263,243,39,0,219,0,3945
"37081016304",3208,71,158,2,264,62,52,62,3879
"37081016305",2493,83,373,24,268,10,12,0,3263
"37081016306",2990,109,1080,248,361,20,134,0,4942
"37081016405",560,101,789,153,140,0,22,0,1765
"37081016406",1728,86,829,95,352,141,164,0,3395
"37081016407",2685,60,879,0,793,355,89,0,4861
"37081016408",1588,25,113,48,127,0,25,0,1926
"37081016409",1836,82,143,153,75,0,78,0,2367
"37081016410",2568,224,2026,292,896,213,374,0,6593
"37081016502",4474,353,766,210,297,8,251,50,6409
"37081016503",1834,92,1254,222,475,55,252,13,4197
"37081016505",3024,106,1130,222,283,20,32,0,4817
"37081016506",3420,125,1014,33,335,16,255,28,5226
"37081016600",1566,110,45,15,538,0,152,0,2426
"37081016701",1914,224,2544,329,462,36,148,313,5970
"37081016702",3145,234,0,74,51,19,291,2,3816
"37081016800",3303,1074,1843,242,202,119,188,330,7301
"37081016900",3602,295,103,0,376,0,34,75,4485
"37081017000",3907,307,132,3,132,0,147,14,4642
"37081017100",5410,619,759,49,226,0,69,52,7184
"37081017200",4494,567,1424,17,412,0,355,15,7284
"37081980100",0,0,0,0,0,0,0,0,0
"37083930100",666,189,1519,1080,26,33,0,0,3513
"37083930200",3349,116,604,390,79,8,81,0,4627
"37083930300",3051,674,576,827,136,65,71,0,5400
"37083930400",1805,144,494,833,195,199,28,80,3778
"37083930501",1746,422,1080,841,78,61,328,37,4593
"37083930502",2245,182,1605,815,102,230,31,46,5256
"37083930600",1497,175,1169,810,302,151,124,56,4284
"37083930700",1843,210,1443,550,87,104,20,0,4257
"37083930800",394,78,1752,780,1593,632,85,43,5357
"37083930900",470,32,3083,1628,64,0,0,0,5277
"37083931000",518,37,1200,426,134,0,0,3,2318
"37083931100",1252,207,2000,1364,37,129,63,129,5181
"37085070100",2132,364,797,720,227,134,305,54,4733
"37085070200",1336,415,770,590,117,211,212,84,3735
"37085070300",2828,407,948,619,183,120,255,292,5652
"37085070401",2660,438,260,233,409,29,602,89,4720
"37085070402",4448,918,261,405,444,290,558,697,8021
"37085070500",4090,663,552,226,139,36,189,151,6046
"37085070600",2023,288,1520,255,232,136,111,0,4565
"37085070700",2321,289,1189,449,149,21,236,44,4698
"37085070801",1425,354,87,88,178,57,297,293,2779
"37085070802",1926,397,278,145,173,167,87,4,3177
"37085070901",1705,207,197,96,0,35,279,18,2537
"37085070902",2319,295,214,15,51,0,184,43,3121
"37085070903",1915,177,242,73,158,85,225,128,3003
"37085070904",1785,217,368,55,94,28,190,28,2765
"37085071001",4331,471,781,99,50,0,381,0,6113
"37085071002",2584,470,11,10,191,92,180,168,3706
"37085071101",2031,623,254,170,325,40,223,277,3943
"37085071102",2665,80,969,165,301,18,308,36,4542
"37085071201",1117,269,405,140,201,69,266,28,2495
"37085071202",2185,514,973,314,563,317,503,252,5621
"37085071203",439,387,197,144,250,25,103,101,1646
"37085071204",3159,606,711,87,493,29,461,122,5668
"37085071301",2250,354,529,161,102,262,156,72,3886
"37085071302",3479,159,1153,9,384,103,425,103,5815
"37085071303",5883,342,1206,265,1130,127,1077,0,10030
"37085071401",1383,810,633,404,754,50,711,50,4795
"37085071402",4630,537,2236,255,1127,88,1203,11,10087
"37087920101",3016,961,0,0,22,36,21,70,4126
"37087920102",3367,572,2,0,151,26,104,0,4222
"37087920200",5162,806,1,1,233,0,304,99,6606
"37087920300",2514,427,166,0,144,18,68,9,3346
"37087920400",1725,171,0,1,0,0,51,0,1948
"37087920500",4263,1129,3,2,221,56,206,80,5960
"37087920600",3644,685,0,0,81,0,129,36,4575
"37087920700",2413,788,16,1,54,12,35,0,3319
"37087920800",2507,419,0,0,76,10,68,23,3103
"37087920900",1180,476,14,40,47,4,38,7,1806
"37087921000",2450,518,141,18,58,73,29,67,3354
"37087921100",2406,296,34,22,47,23,67,0,2895
"37087921200",3667,798,2,1,375,151,303,77,5374
"37087921301",3478,419,0,0,123,0,90,0,4110
"37087921302",4691,705,0,7,51,0,22,0,5476
"37087980100",0,0,0,0,0,0,0,0,0
"37089930100",3763,604,66,21,140,45,762,70,5471
"37089930200",5228,1129,15,0,723,75,1120,346,8636
"37089930300",4458,485,37,0,105,243,876,494,6698
"37089930401",1973,310,92,0,61,204,119,256,3015
"37089930402",1729,674,0,0,30,58,182,403,3076
"37089930501",2917,410,194,92,418,84,292,198,4605
"37089930502",3874,163,137,13,309,0,0,0,4496
"37089930600",3906,381,38,1,171,1,171,69,4738
"37089930701",3076,168,127,58,24,10,110,0,3573
"37089930702",3772,372,27,0,396,28,96,28,4719
"37089930703",5111,308,0,0,132,0,0,62,5613
"37089930800",4135,526,94,0,73,0,140,28,4996
"37089930900",3397,229,77,1,91,50,469,30,4344
"37089931000",4187,1036,110,130,94,129,332,457,6475
"37089931100",856,382,147,464,369,10,261,104,2593
"37089931200",1071,467,262,156,75,250,113,167,2561
"37089931300",2120,546,224,12,452,0,377,124,3855
"37089931400",2608,1281,119,65,463,90,842,453,5921
"37089931500",3052,415,105,0,88,46,45,0,3751
"37089931600",4135,549,11,0,24,16,149,206,5090
"37089931700",2826,375,59,2,44,0,35,7,3348
"37089931801",2953,293,53,97,29,0,0,0,3425
"37089931802",4388,338,129,13,55,6,323,0,5252
"37089931901",3160,269,38,0,53,0,40,33,3593
"37089931902",2379,116,51,0,54,0,86,14,2700
"37089932000",3552,679,59,0,21,0,0,3,4314
"37089980100",0,0,0,0,0,0,0,0,0
"37091950100",2277,139,2605,1450,112,23,56,30,6692
"37091950200",1171,264,1625,1221,180,89,11,9,4570
"37091950300",1293,215,1455,133,246,3,2,6,3353
"37091950401",1229,102,737,833,225,21,8,1,3156
"37091950402",1104,197,1735,927,139,54,24,15,4195
"37093970101",3258,575,2342,834,1141,104,1067,79,9400
"37093970102",4564,754,2671,455,1245,610,870,646,11815
"37093970103",4523,585,2259,353,719,379,820,338,9976
"37093970201",2066,504,711,358,542,116,148,74,4519
"37093970202",1316,137,1066,247,473,315,442,31,4027
"37093970300",1395,239,1600,1171,241,311,321,423,5701
"37093970401",1408,385,568,180,724,937,224,107,4533
"37093970402",557,211,644,404,700,735,81,313,3645
"37093980100",0,0,0,0,0,0,0,0,0
"37095920100",3005,359,738,935,24,5,194,34,5294
"37095990100",0,0,0,0,0,0,0,0,0
"37095990200",0,0,0,0,0,0,0,0,0
"37097060100",2737,1050,557,410,45,135,242,331,5507
"37097060200",380,33,800,978,20,492,215,483,3401
"37097060300",596,304,608,345,349,95,487,166,2950
"37097060400",1273,414,1102,1016,241,142,201,258,4647
"37097060500",2047,327,506,537,314,9,527,0,4267
"37097060601",1988,400,1516,657,291,12,262,171,5297
"37097060602",1735,46,97,35,69,7,129,1,2119
"37097060603",1074,332,166,76,123,18,68,193,2050
"37097060701",1954,185,152,25,183,182,158,138,2977
"37097060702",2900,328,513,0,84,78,151,0,4054
"37097060703",2304,279,101,21,36,29,0,29,2799
"37097060801",2515,736,181,43,240,19,330,183,4247
"37097060802",2590,666,228,22,0,16,12,85,3619
"37097060901",2894,164,0,48,206,0,212,0,3524
"37097060902",3509,523,42,0,5,15,5,15,4114
"37097061001",3410,93,103,1,66,36,100,0,3809
"37097061002",3288,588,171,82,252,155,315,354,5205
"37097061003",2414,125,491,154,293,109,100,109,3795
"37097061101",2077,158,125,43,361,0,173,0,2937
"37097061102",2762,337,212,0,297,0,168,0,3776
"37097061103",2240,245,46,101,177,0,86,0,2895
"37097061104",1308,252,133,65,29,11,49,0,1847
"37097061201",2828,160,245,46,97,0,104,74,3554
"37097061202",3868,249,502,58,133,0,71,18,4899
"37097061203",2839,549,261,11,286,0,211,0,4157
"37097061204",2805,135,0,0,92,0,183,0,3215
"37097061205",3092,787,0,0,53,0,0,0,3932
"37097061301",1304,877,242,157,101,64,76,30,2851
"37097061302",2559,324,491,242,61,0,61,96,3834
"37097061303",4335,109,85,0,31,0,397,0,4957
"37097061304",3690,234,583,12,400,27,414,108,5468
"37097061401",3938,385,0,0,60,16,50,44,4493
"37097061402",4358,183,42,0,380,0,106,0,5069
"37097061403",2518,247,244,60,18,0,123,13,3223
"37097061404",1468,51,0,5,225,16,31,0,1796
"37097061405",3508,359,36,0,64,0,209,80,4256
"37097061406",4320,97,62,0,73,0,205,10,4767
"37097061407",3254,68,85,0,98,0,31,0,3536
"37097061408",3040,102,226,54,115,0,82,0,3619
"37097061501",2587,69,381,475,45,9,180,0,3746
"37097061502",3256,335,0,0,303,0,66,8,3968
"37097061503",3479,274,351,0,46,0,171,26,4347
"37097061601",1491,390,653,135,488,0,861,22,4040
"37097061602",4216,606,806,209,896,0,414,0,7147
"37099940200",2085,399,52,19,2647,968,209,0,6379
"37099950200",1480,142,0,0,106,0,0,0,1728
"37099950300",4058,565,71,73,97,92,94,0,5050
"37099950400",3402,755,26,26,112,114,29,82,4546
"37099950500",4198,656,0,279,148,19,20,279,5599
"37099950600",3951,1815,61,7,37,335,1,302,6509
"37099950700",1966,937,23,0,109,52,0,371,3458
"37099950800",1336,259,27,0,195,179,279,198,2473
"37099950900",2461,303,28,0,74,0,34,0,2900
"37101040100",4170,1280,485,229,24,2,290,133,6613
"37101040201",3806,593,846,573,64,44,397,533,6856
"37101040202",4752,675,972,173,105,40,560,350,7627
"37101040203",12088,498,1017,0,826,33,860,112,15434
"37101040301",1628,798,428,405,266,397,572,829,5323
"37101040302",2060,1161,1101,274,185,310,576,1195,6862
"37101040400",3018,449,205,182,114,511,448,648,5575
"37101040500",4997,1498,339,41,82,60,213,405,7635
"37101040600",2072,336,348,363,214,39,482,156,4010
"37101040700",1594,185,810,314,158,8,218,0,3287
"37101040800",2292,361,353,447,61,0,57,155,3726
"37101040901",6710,1024,1010,467,327,305,1145,341,11329
"37101040902",4469,752,876,663,347,265,330,787,8489
"37101041001",3663,422,2093,902,425,130,811,247,8693
"37101041002",5305,653,965,140,314,114,484,62,8037
"37101041101",5098,781,1061,271,586,129,551,443,8920
"37101041102",7702,424,1204,106,542,235,723,312,11248
"37101041103",10668,282,1225,284,143,0,527,0,13129
"37101041201",2660,629,360,201,64,160,241,333,4648
"37101041202",3011,1428,112,129,80,377,652,939,6728
"37101041300",3945,577,260,452,337,73,243,228,6115
"37101041400",3695,680,459,503,595,621,347,844,7744
"37101041501",5136,412,333,16,246,339,156,339,6977
"37101041502",6359,550,603,43,320,78,852,321,9126
"37101041503",5520,1233,656,1,101,134,381,402,8428
"37103920100",1941,126,1125,460,183,17,73,0,3925
"37103920200",1595,330,629,201,176,1,173,131,3236
"37103920300",2086,358,589,184,83,14,30,8,3352
"37105030101",2518,461,422,123,337,218,393,358,4830
"37105030102",4710,71,206,35,470,22,187,0,5701
"37105030200",1312,536,550,324,896,362,1503,459,5942
"37105030300",333,270,1085,877,12,80,208,208,3073
"37105030401",1225,500,868,359,302,570,679,690,5193
"37105030402",2676,836,1291,367,969,395,1277,624,8435
"37105030501",2839,552,97,10,469,33,603,117,4720
"37105030502",1488,199,311,34,301,68,594,149,3144
"37105030503",4461,685,562,114,393,581,763,591,8150
"37105030601",2933,21,481,111,45,0,134,0,3725
"37105030602",3545,264,1136,376,243,49,384,49,6046
"37105030701",2834,408,642,80,389,51,383,131,4918
"37105030702",2807,486,184,155,382,180,340,176,4710
"37107010100",2019,439,1199,807,103,270,136,361,5334
"37107010200",130,0,1524,942,8,19,16,0,2639
"37107010300",17,0,606,1160,50,23,0,0,1856
"37107010400",0,0,372,395,0,0,0,22,789
"37107010500",214,70,2231,1747,32,67,78,46,4485
"37107010600",1581,201,1242,264,46,0,13,62,3409
"37107010700",524,240,503,909,69,44,101,38,2428
"37107010800",2394,190,1499,225,437,12,336,0,5093
"37107010900",1481,255,1099,408,227,174,125,301,4070
"37107011001",3081,253,630,202,138,19,103,48,4474
"37107011002",2469,287,347,177,262,107,206,54,3909
"37107011100",2700,455,1528,552,131,163,13,163,5705
"37107011200",4503,630,1004,45,250,406,353,407,7598
"37107011300",2670,354,1231,164,74,219,343,219,5274
"37107011400",3297,816,420,16,39,73,77,275,5013
"37109070100",2708,843,329,311,85,114,205,157,4752
"37109070201",2433,874,314,496,337,16,448,518,5436
"37109070202",2773,116,188,3,250,0,181,0,3511
"37109070300",3277,220,117,0,111,0,255,0,3980
"37109070400",4431,1478,152,42,197,24,371,220,6915
"37109070500",3985,665,36,90,41,47,125,47,5036
"37109070600",3431,1014,0,43,61,222,70,197,5038
"37109070700",2700,302,0,1,84,0,92,0,3179
"37109070800",4074,691,366,357,104,382,652,103,6729
"37109070901",2450,701,0,26,130,35,108,35,3485
"37109070902",4913,640,250,33,777,0,409,374,7396
"37109071001",4060,532,237,36,96,0,107,0,5068
"37109071002",1778,586,179,65,53,0,18,75,2754
"37109071101",4808,529,143,15,26,15,399,0,5935
"37109071102",4560,276,9,24,111,0,0,0,4980
"37109071201",1562,81,32,0,17,0,21,0,1713
"37109071202",2959,124,7,0,62,0,27,0,3179
"37109071203",3838,75,67,41,53,0,153,8,4235
"37111970100",4026,663,0,5,343,7,287,119,5450
"37111970200",3763,921,169,6,109,194,87,185,5434
"37111970300",2136,804,106,13,142,12,105,209,3527
"37111970400",1322,1210,90,4,19,298,19,465,3427
"37111970500",2756,975,406,83,25,175,53,271,4744
"37111970600",2954,360,126,15,154,192,356,183,4340
"37111970700",3930,565,97,28,76,0,19,0,4715
"37111970800",3107,690,0,33,85,45,0,0,3960
"37111970901",4448,1299,37,97,76,0,26,0,5983
"37111970902",3840,902,61,2,0,71,0,0,4876
"37113970100",2204,528,0,0,46,0,77,7,2862
"37113970200",3226,600,0,11,4,19,26,21,3907
"37113970301",2439,820,0,0,437,148,532,288,4664
"37113970302",2502,929,185,0,42,96,182,77,4013
"37113970400",2831,936,0,0,111,340,18,343,4579
"37113970501",1041,80,10,0,20,0,0,0,1151
"37113970502",1726,387,0,4,52,0,0,44,2213
"37113970600",4458,1122,0,0,291,152,159,134,6316
"37113970700",4374,904,107,0,169,16,256,48,5874
"37115010100",2107,620,0,0,0,3,74,13,2817
"37115010200",1528,438,8,0,9,42,7,63,2095
"37115010400",1339,141,0,0,44,50,0,0,1574
"37115010500",4104,825,3,13,139,20,87,0,5191
"37115010600",4603,678,5,16,97,0,18,33,5450
"37115010700",2356,568,6,0,51,12,143,12,3148
"37117970100",2270,573,1164,298,127,232,53,228,4945
"37117970200",1585,229,1354,937,60,0,114,0,4279
"37117970300",1660,268,1472,483,146,16,81,180,4306
"37117970400",1118,198,966,572,8,4,0,4,2870
"37117970500",3407,659,490,217,87,11,49,11,4931
"37117970600",737,224,1700,644,59,0,51,23,3438
"37119000100",2800,286,149,5,284,20,215,0,3759
"37119000300",271,16,51,91,16,0,5,0,450
"37119000400",1446,112,270,125,136,0,118,9,2216
"37119000500",2243,447,814,519,115,0,78,0,4216
"37119000600",1285,137,704,290,54,0,79,19,2568
"37119000700",204,3,165,194,181,14,12,12,785
"37119000800",127,77,1099,764,118,13,107,26,2331
"37119000900",273,44,798,344,16,0,18,0,1493
"37119001000",1944,107,187,35,169,0,123,0,2565
"37119001100",1551,102,112,4,69,0,24,0,1862
"37119001200",3252,479,643,217,464,909,947,839,7750
"37119001300",1002,277,1045,1082,143,176,153,0,3878
"37119001400",1473,234,456,411,71,94,146,58,2943
"37119001504",1435,225,3036,1278,387,376,930,531,8198
"37119001505",1133,230,1094,51,620,250,539,251,4168
"37119001507",697,249,1271,767,483,538,883,903,5791
"37119001508",2215,147,2153,556,1075,6,1285,101,7538
"37119001509",131,82,1705,498,422,601,430,305,4174
"37119001510",299,265,1772,180,190,8,87,111,2912
"37119001603",1793,476,1163,230,316,191,549,574,5292
"37119001605",785,751,423,121,48,130,318,477,3053
"37119001606",1858,210,875,56,566,587,1205,477,5834
"37119001607",1053,238,548,891,375,566,730,651,5052
"37119001608",519,181,1108,685,467,630,341,614,4545
"37119001609",647,232,1184,169,468,209,484,399,3792
"37119001701",1213,177,779,379,483,363,494,71,3959
"37119001702",1612,1291,1072,636,980,156,799,1140,7686
"37119001801",678,19,267,300,25,14,17,0,1320
"37119001802",1196,177,541,162,383,137,23,92,2711
"37119001910",1410,529,1644,461,978,307,1472,856,7657
"37119001911",1863,325,1850,610,395,538,340,603,6524
"37119001912",546,1496,2266,732,493,356,508,1692,8089
"37119001914",1261,251,904,307,572,197,831,292,4615
"37119001915",2082,626,2165,639,263,623,847,712,7957
"37119001916",1334,111,1227,226,401,77,420,31,3827
"37119001917",1650,654,645,191,667,225,885,439,5356
"37119001918",823,382,1726,512,104,39,149,332,4067
"37119001919",1370,319,1064,741,173,605,188,349,4809
"37119001920",1009,233,1128,962,819,45,933,183,5312
"37119001921",847,76,671,294,383,45,542,75,2933
"37119001922",1000,496,1535,524,960,240,667,727,6149
"37119001923",829,257,1168,943,310,372,429,352,4660
"37119002002",4896,331,376,146,498,14,76,60,6397
"37119002003",4684,184,310,275,355,167,433,202,6610
"37119002004",3532,321,386,137,96,6,417,210,5105
"37119002100",1211,189,594,154,58,62,127,144,2539
"37119002200",3913,152,253,19,208,1,66,1,4613
"37119002300",309,144,914,1394,28,15,288,94,3186
"37119002400",2108,176,142,94,163,0,11,12,2706
"37119002500",1086,138,84,170,67,0,39,0,1584
"37119002600",420,69,187,34,29,0,33,18,790
"37119002701",1904,30,29,0,18,0,110,0,2091
"37119002702",4475,200,103,0,57,0,19,16,4870
"37119002800",3468,156,10,29,114,5,137,0,3919
"37119002903",3000,71,117,11,116,0,68,0,3383
"37119002904",5118,191,633,213,461,183,204,166,7169
"37119002905",2699,290,87,4,98,0,21,0,3199
"37119002906",3304,192,75,56,490,26,11,7,4161
"37119003006",3440,182,179,0,200,42,37,0,4080
"37119003007",5772,180,534,170,268,0,131,0,7055
"37119003008",4423,236,330,16,561,10,275,12,5863
"37119003011",4783,255,234,19,80,84,227,0,5682
"37119003012",3227,206,210,10,354,0,370,47,4424
"37119003013",4625,75,281,0,200,21,353,21,5576
"37119003015",3773,154,202,23,212,0,229,0,4593
"37119003016",3337,168,545,12,317,153,247,6,4785
"37119003017",2825,217,132,104,55,0,93,0,3426
"37119003018",1687,166,294,2,264,1,104,1,2519
"37119003102",2284,833,312,66,532,16,241,627,4911
"37119003103",3500,276,319,29,430,52,444,120,5170
"37119003105",3354,32,36,19,161,0,178,0,3780
"37119003106",2037,284,288,37,314,0,817,194,3971
"37119003108",1369,225,656,447,204,144,695,259,3999
"37119003109",1089,677,1018,503,541,185,931,674,5618
"37119003201",1270,654,50,136,717,92,824,609,4352
"37119003203",1335,492,548,221,157,57,286,209,3305
"37119003204",2344,221,132,46,127,427,25,259,3581
"37119003300",1874,271,394,122,94,169,81,163,3168
"37119003400",4333,159,8,0,150,27,15,15,4707
"37119003500",2380,94,18,7,60,0,78,0,2637
"37119003600",524,40,1444,1139,48,0,19,0,3214
"37119003700",334,22,918,1165,109,0,74,0,2622
"37119003802",270,288,1930,707,190,233,166,331,4115
"37119003805",492,29,99,184,982,16,48,5,1855
"37119003806",3098,549,3481,777,1699,365,2621,438,13028
"37119003807",1074,408,1683,719,133,652,977,950,6596
"37119003808",1779,1369,1354,403,677,288,1849,1570,9289
"37119003902",117,6,3051,1325,294,234,57,55,5139
"37119003903",71,85,453,855,48,107,40,56,1715
"37119004000",594,260,2199,556,307,0,36,0,3952
"37119004100",962,179,1175,599,185,183,29,173,3485
"37119004200",343,19,1367,1459,44,64,0,6,3302
"37119004302",840,183,1984,1169,345,57,270,117,4965
"37119004303",668,106,702,393,307,169,171,123,2639
"37119004304",598,24,1994,336,548,112,0,126,3738
"37119004305",1244,112,2153,1030,550,56,875,128,6148
"37119004400",257,215,3175,394,538,51,217,50,4897
"37119004500",91,62,1008,1429,467,8,15,0,3080
"37119004600",36,36,2175,900,7,139,0,0,3293
"37119004700",56,50,510,353,61,0,32,14,1076
"37119004800",95,37,1952,742,203,8,171,35,3243
"37119004900",13,15,491,106,7,0,0,0,632
"37119005000",34,0,611,651,12,24,6,67,1405
"37119005100",95,76,1064,1022,181,36,71,22,2567
"37119005200",165,177,778,1830,0,15,93,81,3139
"37119005301",368,175,995,973,669,415,765,403,4763
"37119005305",229,84,3126,768,562,0,827,54,5650
"37119005306",118,148,1307,319,183,73,202,138,2488
"37119005307",611,164,1465,618,457,76,997,182,4570
"37119005308",922,366,479,861,387,115,1244,421,4795
"37119005401",747,86,4346,1441,313,199,494,56,7682
"37119005403",1041,292,1912,103,397,52,583,104,4484
"37119005404",1006,358,2740,1148,30,1,288,328,5899
"37119005508",2684,363,641,113,152,0,172,10,4135
"37119005509",2598,139,2134,0,402,18,485,0,5776
"37119005510",1276,543,2416,416,261,75,651,564,6202
"37119005511",1405,109,2048,119,431,154,369,13,4648
"37119005512",1185,129,2507,443,201,117,255,74,4911
"37119005513",1865,48,1608,94,283,62,143,0,4103
"37119005514",3701,488,2268,196,478,55,459,260,7905
"37119005515",1585,96,455,2,176,0,189,0,2503
"37119005516",1364,6,208,5,215,0,159,0,1957
"37119005517",3078,167,1218,12,87,0,178,0,4740
"37119005518",2911,71,1387,89,766,2,633,0,5859
"37119005519",2892,88,1618,81,417,0,159,0,5255
"37119005520",1426,104,1750,5,1307,0,373,0,4965
"37119005521",1408,643,2960,126,951,296,463,0,6847
"37119005522",1336,324,1923,181,868,0,504,0,5136
"37119005523",1567,530,802,158,1254,501,86,113,5011
"37119005524",1448,284,3135,1137,1465,37,661,0,8167
"37119005604",380,686,162,243,153,236,78,76,2014
"37119005605",1416,671,2012,410,584,318,328,76,5815
"37119005609",280,865,705,459,463,519,303,133,3727
"37119005610",760,569,1436,524,601,135,248,78,4351
"37119005611",946,229,1013,80,295,50,294,63,2970
"37119005612",1279,131,2043,10,944,151,837,90,5485
"37119005613",268,37,1118,346,254,0,192,0,2215
"37119005614",2328,133,3183,265,472,0,544,66,6991
"37119005615",777,9,300,14,204,30,322,30,1686
"37119005616",687,227,628,22,492,29,736,101,2922
"37119005617",423,61,950,72,475,110,185,171,2447
"37119005618",1605,84,1414,0,313,0,388,56,3860
"37119005619",1428,93,1536,440,535,2,534,2,4570
"37119005620",2165,330,2794,427,775,185,1001,314,7991
"37119005621",2552,53,1050,60,229,257,269,167,4637
"37119005706",4155,417,818,12,913,353,520,84,7272
"37119005709",2756,278,389,27,232,0,282,197,4161
"37119005710",1263,155,1101,321,619,127,556,61,4203
"37119005711",5313,311,530,83,121,0,161,20,6539
"37119005712",3127,163,372,26,87,179,253,0,4207
"37119005713",3117,121,61,0,226,0,149,0,3674
"37119005714",3808,379,525,16,225,0,193,0,5146
"37119005715",2287,101,49,0,91,47,20,21,2616
"37119005716",2472,76,923,377,484,37,826,59,5254
"37119005717",2955,212,1812,239,464,109,279,15,6085
"37119005811",3135,158,385,64,82,0,137,59,4020
"37119005812",3896,556,1126,103,512,68,359,62,6682
"37119005815",2821,98,255,63,149,59,129,9,3583
"37119005816",3458,53,141,0,224,58,210,10,4154
"37119005817",3354,222,84,0,451,0,516,0,4627
"37119005823",7043,116,493,21,857,0,397,0,8927
"37119005824",1438,220,727,682,75,66,1089,261,4558
"37119005825",2464,715,660,361,284,215,809,554,6062
"37119005826",2072,212,215,70,181,166,502,79,3497
"37119005827",988,164,1055,202,79,8,299,0,2795
"37119005828",3435,138,159,13,111,35,97,0,3988
"37119005829",914,157,781,64,411,40,587,24,2978
"37119005830",2689,129,176,79,450,0,473,9,4005
"37119005831",3207,192,700,0,284,14,78,0,4475
"37119005832",2208,231,102,17,480,174,327,0,3539
"37119005833",3931,241,84,0,265,0,36,0,4557
"37119005834",3078,362,476,157,257,18,176,1,4525
"37119005835",2208,138,45,9,163,0,24,0,2587
"37119005836",3328,230,440,0,374,0,739,79,5190
"37119005837",4626,157,221,41,1299,74,554,16,6988
"37119005838",4307,143,732,61,1191,26,440,143,7043
"37119005839",1891,242,144,0,444,0,81,0,2802
"37119005840",1703,22,0,0,230,0,167,0,2122
"37119005841",4782,283,259,91,607,0,90,197,6309
"37119005842",4729,136,234,0,751,0,189,71,6110
"37119005843",2337,56,67,39,382,0,79,0,2960
"37119005844",5392,140,340,20,978,11,358,0,7239
"37119005845",2700,34,238,0,984,0,177,0,4133
"37119005846",3528,45,38,0,361,0,53,9,4034
"37119005847",3223,51,132,0,583,280,221,56,4546
"37119005848",4591,27,399,0,517,0,78,0,5612
"37119005906",2112,613,320,273,230,159,344,262,4313
"37119005907",2495,96,1137,11,610,124,925,158,5556
"37119005908",1296,22,294,34,49,0,0,0,1695
"37119005909",3117,197,1703,499,1031,42,917,229,7735
"37119005910",2523,100,1555,70,790,0,967,0,6005
"37119005911",3075,428,1125,0,244,0,156,9,5037
"37119005912",2120,281,1607,125,648,432,1071,533,6817
"37119005913",3166,168,1785,104,1226,200,1491,228,8368
"37119005914",2269,313,1719,44,724,430,781,372,6652
"37119005915",657,42,529,60,202,105,132,0,1727
"37119005916",285,19,1037,361,351,35,232,47,2367
"37119005917",3138,128,1669,214,307,60,438,102,6056
"37119005918",1859,110,875,27,522,160,701,142,4396
"37119006005",1412,37,971,64,193,182,114,182,3155
"37119006006",1885,304,1718,825,599,266,429,173,6199
"37119006007",3221,187,2339,328,571,13,352,8,7019
"37119006008",2015,40,1130,118,320,0,326,25,3974
"37119006009",1165,30,978,370,71,9,99,0,2722
"37119006010",1932,301,3330,474,349,54,458,123,7021
"37119006103",2045,132,1171,83,227,0,68,0,3726
"37119006104",2802,231,4379,1166,535,46,147,0,9306
"37119006105",1391,67,877,264,232,0,74,0,2905
"37119006106",1847,23,1104,7,290,8,177,0,3456
"37119006107",1709,355,924,144,742,81,419,227,4601
"37119006108",1060,222,2528,54,627,50,540,161,5242
"37119006109",358,74,1769,808,3,78,167,49,3306
"37119006203",4507,174,92,0,65,0,101,49,4988
"37119006204",6495,145,51,0,118,0,223,0,7032
"37119006208",1843,95,267,0,211,0,89,5,2510
"37119006209",3246,446,449,0,64,0,160,0,4365
"37119006210",3796,203,251,10,123,0,0,0,4383
"37119006211",5168,150,276,38,279,18,196,0,6125
"37119006212",2162,127,452,0,420,0,140,7,3308
"37119006213",4665,70,390,0,558,0,135,0,5818
"37119006214",3300,272,332,0,206,0,164,0,4274
"37119006215",2723,423,668,131,60,69,172,290,4536
"37119006302",4673,181,872,171,356,0,471,2,6726
"37119006303",3842,427,177,150,191,0,32,76,4895
"37119006304",5282,138,89,0,372,11,412,0,6304
"37119006403",2714,384,632,67,204,9,342,62,4414
"37119006404",4239,199,114,0,335,0,271,52,5210
"37119006405",2103,277,127,2,274,22,37,22,2864
"37119006406",5224,928,438,106,391,26,440,598,8151
"37119006407",2980,58,155,0,39,290,100,0,3622
"37119980100",0,0,0,0,0,0,0,0,0
"37119980200",0,0,0,0,0,0,0,0,0
"37119980300",0,0,0,0,0,0,0,0,0
"37121950100",2173,398,0,0,9,15,23,78,2696
"37121950200",2863,621,0,9,22,14,23,25,3577
"37121950300",3359,1181,11,10,39,3,225,108,4936
"37121950400",3829,392,0,3,8,120,0,173,4525
"37123960100",4475,784,283,376,142,139,1114,355,7668
"37123960200",3922,1114,342,498,142,114,180,208,6520
"37123960300",3297,646,0,0,20,24,0,24,4011
"37123960401",949,90,793,427,93,8,0,0,2360
"37123960402",1190,110,339,391,185,136,21,35,2407
"37123960500",2813,1447,795,449,69,75,988,1052,7688
"37125950100",2390,580,13,46,14,0,128,0,3171
"37125950200",4651,2333,201,27,263,92,595,1228,9390
"37125950301",4594,227,342,126,72,138,173,95,5767
"37125950302",4274,662,288,4,34,1,27,1,5291
"37125950401",3018,377,130,125,99,25,7,0,3781
"37125950402",2691,466,761,263,38,72,133,5,4429
"37125950501",3632,1113,471,122,165,351,88,241,6183
"37125950502",6419,555,203,602,454,59,224,398,8914
"37125950601",3168,194,140,0,40,0,0,153,3695
"37125950602",5165,144,624,464,206,80,191,92,6966
"37125950701",3662,204,220,90,42,0,44,0,4262
"37125950702",1863,78,116,81,22,23,38,0,2221
"37125950801",1921,112,1717,498,167,106,304,0,4825
"37125950802",2979,168,178,138,98,0,0,0,3561
"37125950900",1504,385,351,46,19,97,129,59,2590
"37125951000",4119,150,103,50,138,0,146,0,4706
"37125951100",5636,567,1142,427,257,365,451,0,8845
"37125951200",2599,616,965,174,394,152,344,109,5353
"37127010200",677,99,2732,1495,143,13,112,0,5271
"37127010300",2370,270,2432,1093,488,114,219,0,6986
"37127010400",588,114,1326,787,415,49,219,117,3615
"37127010502",3713,323,1910,547,306,26,93,0,6918
"37127010503",1592,142,891,204,159,60,150,36,3234
"37127010504",3146,307,1345,937,138,24,72,76,6045
"37127010601",1516,14,866,119,200,15,30,0,2760
"37127010602",2259,362,2098,381,172,192,264,245,5973
"37127010700",926,49,1220,194,143,4,43,1,2580
"37127010800",5117,418,1377,213,3,19,56,20,7223
"37127010900",2519,376,1759,428,316,29,47,115,5589
"37127011000",2123,226,1350,454,275,18,492,0,4938
"37127011101",2843,198,1827,62,351,5,421,3,5710
"37127011102",3520,540,1574,936,141,73,23,34,6841
"37127011200",4631,502,894,160,150,1,16,1,6355
"37127011300",3522,395,227,219,791,166,1210,204,6734
"37127011400",2095,178,983,345,469,331,675,326,5402
"37127011500",3893,873,633,688,366,44,482,165,7144
"37129010100",574,55,633,1147,9,21,0,0,2439
"37129010200",1264,326,1159,809,23,6,34,27,3648
"37129010300",1638,566,2169,881,122,43,109,0,5528
"37129010400",2255,547,128,48,45,10,41,34,3108
"37129010501",1589,820,873,574,115,64,339,345,4719
"37129010502",3793,2487,417,758,121,668,162,369,8775
"37129010600",3376,171,142,15,277,14,85,0,4080
"37129010700",1772,416,883,639,204,86,125,105,4230
"37129010800",1206,492,184,91,297,150,439,293,3152
"37129010900",1810,327,107,11,74,23,81,56,2489
"37129011000",753,460,349,511,0,124,32,82,2311
"37129011100",103,67,1274,1085,21,50,9,0,2609
"37129011200",949,249,681,264,23,0,66,0,2232
"37129011300",958,212,99,162,90,104,18,104,1747
"37129011400",296,218,619,492,8,0,21,0,1654
"37129011500",5178,1283,1148,458,293,52,384,811,9607
"37129011603",4613,292,1045,41,215,74,177,15,6472
"37129011605",3174,319,1045,113,309,170,586,0,5716
"37129011606",3195,387,563,35,94,9,177,67,4527
"37129011607",8921,756,986,0,298,24,636,65,11686
"37129011608",4344,237,870,0,196,0,40,0,5687
"37129011701",3636,884,125,0,130,0,135,43,4953
"37129011703",3478,381,0,0,68,0,0,255,4182
"37129011705",7246,730,28,0,238,15,227,12,8496
"37129011800",1974,477,0,2,16,0,15,17,2501
"37129011902",4075,1421,510,15,65,0,480,285,6851
"37129011903",2741,1811,20,217,31,121,280,11,5232
"37129011904",1432,60,96,0,48,0,13,0,1649
"37129012001",5229,293,339,34,192,217,263,238,6805
"37129012004",3247,177,45,13,231,24,0,39,3776
"37129012006",2993,391,269,0,44,0,124,0,3821
"37129012007",3183,278,35,34,132,41,121,0,3824
"37129012008",3777,556,556,30,328,380,114,278,6019
"37129012009",5936,192,637,67,233,0,135,0,7200
"37129012010",4641,133,162,0,177,0,50,0,5163
"37129012101",5922,755,341,137,636,311,564,305,8971
"37129012103",3719,167,165,0,36,0,113,0,4200
"37129012104",3930,480,427,3,429,17,98,28,5412
"37129012105",8956,912,397,657,601,109,193,192,12017
"37129012201",2552,347,0,0,59,0,20,4,2982
"37129012202",2427,215,62,69,55,0,20,0,2848
"37129012203",1806,62,14,0,103,16,17,0,2018
"37129012300",6180,289,252,0,96,0,142,2,6961
"37129980100",0,0,0,0,0,0,0,0,0
"37129990100",0,0,0,0,0,0,0,0,0
"37131920100",3109,219,1294,478,83,33,30,19,5265
"37131920200",1300,357,1484,1241,75,53,10,6,4526
"37131920300",959,31,2917,1415,5,373,24,0,5724
"37131920401",957,234,1739,786,44,91,173,70,4094
"37131920402",1012,112,350,55,21,0,0,11,1561
"37133000102",6895,850,101,110,215,75,414,89,8749
"37133000103",4374,482,582,137,481,15,428,8,6507
"37133000201",6924,551,957,390,441,482,792,484,11021
"37133000202",6922,866,896,385,474,0,731,8,10282
"37133000301",4998,568,396,328,233,70,247,34,6874
"37133000302",5941,862,846,744,608,158,1223,159,10541
"37133000401",3976,743,96,37,34,0,105,13,5004
"37133000402",4612,1232,27,0,119,65,138,99,6292
"37133000403",1287,137,24,0,50,0,14,0,1512
"37133000500",0,0,0,0,0,0,0,0,0
"37133000600",44,0,0,0,0,0,0,0,44
"37133000700",3866,286,1386,41,966,0,1131,9,7685
"37133000800",706,134,247,0,93,0,86,24,1290
"37133000900",3063,447,700,323,729,183,776,78,6299
"37133001000",546,171,78,0,52,12,180,12,1051
"37133001101",2775,738,313,27,339,225,273,208,4898
"37133001102",2856,392,630,162,158,0,407,16,4621
"37133001200",6199,1174,2249,167,970,350,715,364,12188
"37133001300",8228,803,2487,252,938,123,1438,101,14370
"37133001400",3894,106,268,255,344,67,501,21,5456
"37133001500",1512,344,737,262,216,120,182,92,3465
"37133001700",1693,32,314,45,241,35,305,0,2665
"37133001800",1192,149,95,44,128,0,119,0,1727
"37133002100",3026,343,1541,600,815,46,960,94,7425
"37133002201",3691,445,818,24,658,119,688,16,6459
"37133002202",2634,379,893,642,267,19,855,187,5876
"37133002300",2824,336,885,49,464,28,434,70,5090
"37133002400",3185,967,1277,268,653,99,193,243,6885
"37133002500",1729,619,153,241,306,236,306,245,3835
"37133002600",1096,240,1174,1275,203,93,244,40,4365
"37133002800",7163,1177,369,133,503,39,784,17,10185
"37133990100",0,0,0,0,0,0,0,0,0
"37135010701",1566,149,324,12,31,0,9,86,2177
"37135010703",2951,493,621,233,1197,734,1199,506,7934
"37135010704",2940,563,441,57,846,354,663,378,6242
"37135010705",2432,758,565,112,309,54,231,334,4795
"37135010706",2984,51,0,1,375,0,110,6,3527
"37135010801",3087,569,797,102,164,48,213,29,5009
"37135010802",3555,496,487,22,233,13,56,208,5070
"37135010901",4265,663,428,19,0,404,283,796,6858
"37135010902",2997,492,263,0,332,82,410,301,4877
"37135011000",5203,475,454,329,333,39,154,162,7149
"37135011101",4783,459,1727,660,389,45,478,110,8651
"37135011102",3967,512,825,333,230,28,241,293,6429
"37135011202",5651,535,446,96,321,189,273,81,7592
"37135011203",3974,464,556,189,128,64,125,0,5500
"37135011204",2852,231,180,18,229,131,58,243,3942
"37135011205",3918,321,141,322,2498,245,437,209,8091
"37135011300",712,1442,202,522,86,74,18,30,3086
"37135011400",1744,1164,83,95,129,148,59,24,3446
"37135011500",1140,631,69,53,87,29,94,15,2118
"37135011601",6,135,0,132,0,0,6,4,283
"37135011602",201,308,8,118,300,136,9,80,1160
"37135011700",1423,1351,200,39,192,60,85,8,3358
"37135011800",2014,912,50,287,226,151,169,27,3836
"37135011901",3414,604,369,196,632,0,169,131,5515
"37135011902",2550,111,347,0,754,61,209,9,4041
"37135012100",4567,595,757,64,1021,121,382,0,7507
"37135012201",2190,88,97,0,312,15,33,0,2735
"37135012202",3456,417,234,17,966,182,179,100,5551
"37137950101",2146,541,193,4,125,99,0,0,3108
"37137950102",1677,255,830,341,49,8,20,0,3180
"37137950201",3050,174,438,73,122,20,319,41,4237
"37137950202",1827,100,257,102,33,0,22,0,2341
"37137990100",0,0,0,0,0,0,0,0,0
"37139960100",538,158,527,161,67,0,70,21,1542
"37139960200",1534,198,1243,664,64,0,0,0,3703
"37139960300",324,302,976,1120,95,68,46,105,3036
"37139960400",2006,628,1051,696,30,86,201,246,4944
"37139960501",2503,38,489,157,54,0,54,0,3295
"37139960502",2915,256,457,293,310,0,47,59,4337
"37139960503",1201,230,844,158,11,26,44,0,2514
"37139960600",3654,345,2064,187,299,34,226,0,6809
"37139960701",3148,314,1454,494,244,230,307,171,6362
"37139960702",2574,80,363,19,23,54,54,8,3175
"37141920101",393,33,0,0,6,1,6,1,440
"37141920102",1118,190,0,0,3,14,0,0,1325
"37141920103",3577,547,109,0,70,53,57,15,4428
"37141920201",4123,454,131,81,156,65,236,68,5314
"37141920202",5953,511,101,22,25,22,168,0,6802
"37141920203",2897,407,401,80,390,89,19,0,4283
"37141920204",655,427,420,630,0,7,0,0,2139
"37141920300",2231,479,359,387,128,19,203,48,3854
"37141920401",1045,155,406,478,132,1,210,11,2438
"37141920402",1539,539,534,66,0,35,47,9,2769
"37141920403",2209,404,552,139,12,280,16,303,3915
"37141920501",1898,192,1271,926,272,118,589,159,5425
"37141920502",1257,123,396,132,73,3,41,0,2025
"37141920601",2088,138,209,233,352,253,464,253,3990
"37141920602",3777,870,494,311,254,130,140,203,6179
"37141990100",0,0,0,0,0,0,0,0,0
"37143920100",4373,430,1226,363,206,25,126,6,6755
"37143920201",1567,360,573,427,125,0,71,70,3193
"37143920202",2351,531,198,559,27,0,22,0,3688
"37145920100",3455,624,2274,534,174,24,17,2,7104
"37145920200",4653,515,1060,358,259,12,318,0,7175
"37145920300",2109,939,855,1659,298,46,230,217,6353
"37145920400",879,357,950,265,41,91,18,107,2708
"37145920500",5670,288,1044,151,213,0,184,0,7550
"37145920601",3387,615,551,349,0,15,307,203,5427
"37145920602",3265,83,629,99,151,0,10,0,4237
"37147000100",991,1462,511,723,54,29,52,29,3851
"37147000201",1743,1674,1016,359,38,200,68,150,5248
"37147000202",1615,245,464,43,269,145,218,17,3016
"37147000301",2404,191,324,19,68,0,0,0,3006
"37147000302",5046,1969,1099,744,458,160,300,101,9877
"37147000400",1383,270,16,40,41,82,24,6,1862
"37147000501",3206,339,1411,590,382,91,146,0,6165
"37147000502",3093,1889,1153,408,453,301,85,124,7506
"37147000601",1658,505,2204,1108,227,0,40,0,5742
"37147000602",1406,742,1955,1250,161,58,41,162,5775
"37147000603",5303,571,3304,170,1183,20,485,145,11181
"37147000701",376,288,1614,1813,45,40,52,57,4285
"37147000702",133,120,1284,1260,0,0,34,5,2836
"37147000800",753,484,1356,1133,193,94,246,318,4577
"37147000900",2879,1489,1752,1153,625,278,488,293,8957
"37147001001",1292,220,231,435,151,113,111,111,2664
"37147001002",4376,329,1086,25,161,0,290,47,6314
"37147001003",4096,253,813,227,189,0,0,0,5578
"37147001100",3782,275,670,168,341,123,439,123,5921
"37147001200",3976,1086,496,222,606,67,637,200,7290
"37147001301",2095,38,1097,353,245,0,145,0,3973
"37147001302",2806,110,1661,555,260,44,147,26,5609
"37147001303",5770,256,886,0,267,110,205,0,7494
"37147001401",1947,135,1420,1050,50,9,161,41,4813
"37147001402",912,180,424,478,191,115,117,173,2590
"37147001500",1843,119,400,606,241,10,330,10,3559
"37147001600",4087,630,1961,396,515,41,284,53,7967
"37147001700",2550,166,760,232,91,80,14,94,3987
"37147001800",2480,389,1682,988,287,191,300,160,6477
"37147001900",1674,283,625,203,58,30,25,88,2986
"37147002001",1187,734,2041,1151,408,461,521,653,7156
"37147002002",2030,452,1495,1109,73,64,19,42,5284
"37149920101",2536,475,38,52,190,129,272,160,3852
"37149920103",2232,456,43,0,24,0,0,115,2870
"37149920104",2700,571,11,5,72,0,179,95,3633
"37149920200",3200,811,192,390,76,17,81,0,4767
"37149920301",1275,52,0,8,24,1,97,1,1458
"37149920303",1595,107,0,0,109,16,92,16,1935
"37149920304",2208,240,221,18,11,0,11,0,2709
"37151030100",2424,920,126,152,403,440,641,567,5673
"37151030201",2172,446,202,48,173,200,333,246,3820
"37151030202",3934,1085,251,69,20,0,1257,494,7110
"37151030301",4392,1134,167,110,346,134,1347,316,7946
"37151030302",577,309,469,592,181,219,130,231,2708
"37151030400",2588,679,175,290,485,268,1351,449,6285
"37151030502",3129,243,163,103,105,10,451,40,4244
"37151030503",4402,822,2,15,330,0,511,0,6082
"37151030504",4785,1070,0,0,16,0,0,0,5871
"37151030600",5616,695,21,10,430,105,868,164,7909
"37151030700",5071,874,1,0,314,34,323,78,6695
"37151030801",5253,1365,216,89,73,47,744,154,7941
"37151030802",5209,741,254,215,76,51,445,74,7065
"37151030900",2734,620,155,119,189,140,68,51,4076
"37151031000",4447,934,1013,103,164,253,258,366,7538
"37151031100",4994,798,91,62,83,43,645,122,6838
"37151031200",3218,692,422,83,75,223,187,125,5025
"37151031303",3166,768,11,0,26,0,0,0,3971
"37151031304",4050,659,39,4,269,0,13,85,5119
"37151031305",2745,381,55,76,74,79,70,0,3480
"37151031306",5889,595,129,22,82,0,263,1,6981
"37151031400",5803,1300,554,80,248,110,618,20,8733
"37151031501",4905,1187,74,0,99,17,0,72,6354
"37151031503",2067,481,84,31,244,49,122,35,3113
"37151031504",4214,331,106,26,584,9,115,13,5398
"37151031505",2915,25,162,0,47,45,88,0,3282
"37151031601",3000,693,210,0,111,28,100,118,4260
"37151031602",988,246,73,25,190,0,104,26,1652
"37153970100",1485,147,725,174,179,55,125,0,2890
"37153970200",2204,1022,1107,524,414,110,364,544,6289
"37153970300",2930,594,621,243,74,224,85,246,5017
"37153970400",2415,244,469,325,340,78,61,30,3962
"37153970500",1249,239,541,554,93,22,109,0,2807
"37153970600",1642,425,719,1184,273,60,270,60,4633
"37153970700",1496,743,224,159,136,433,167,349,3707
"37153970800",2438,692,877,382,238,17,233,57,4934
"37153970900",3827,354,296,35,238,62,53,0,4865
"37153971000",1407,357,1159,1119,141,47,8,0,4238
"37153971100",1949,292,1207,793,353,18,0,0,4612
"37155960101",1406,835,922,431,229,112,178,582,4695
"37155960102",2140,638,771,135,789,414,245,369,5501
"37155960201",2258,591,1649,253,596,651,287,36,6321
"37155960202",727,350,432,55,2310,865,648,383,5770
"37155960300",1062,1168,1564,960,1300,962,331,1137,8484
"37155960401",421,345,113,201,4490,2267,0,51,7888
"37155960402",323,52,70,216,2424,775,285,165,4310
"37155960501",29,108,115,329,2196,789,16,7,3589
"37155960502",150,359,263,668,1444,1117,0,18,4019
"37155960503",101,57,118,103,1091,241,22,0,1733
"37155960600",641,152,533,162,3546,2001,291,22,7348
"37155960701",987,553,222,143,2166,2003,451,1022,7547
"37155960702",507,300,454,43,1465,689,205,345,4008
"37155960801",151,79,1156,1144,502,339,0,0,3371
"37155960802",254,146,1101,255,72,211,0,44,2083
"37155960900",1171,239,164,85,359,41,48,192,2299
"37155961000",852,170,325,181,312,207,76,38,2161
"37155961100",496,358,278,320,275,196,140,92,2155
"37155961200",1128,436,608,265,297,135,98,194,3161
"37155961301",1843,375,754,33,532,494,18,82,4131
"37155961302",1863,402,1306,450,740,768,726,583,6838
"37155961400",1869,245,467,202,739,161,106,42,3831
"37155961500",2628,828,508,130,1079,907,33,228,6341
"37155961601",1469,281,380,509,955,127,90,51,3862
"37155961602",1858,253,572,373,346,156,168,5,3731
"37155961700",1233,225,1152,1461,671,598,27,197,5564
"37155961801",96,47,391,198,2513,874,0,0,4119
"37155961802",728,51,682,126,2193,966,25,0,4771
"37155961900",1108,268,1397,671,1192,413,129,41,5219
"37155962001",430,73,1310,636,724,648,12,11,3844
"37155962002",294,25,409,93,1354,566,26,0,2767
"37157040101",2734,730,308,251,110,28,21,8,4190
"37157040102",1971,418,225,38,1,37,75,1,2766
"37157040200",1920,603,737,388,135,266,111,265,4425
"37157040300",2311,285,501,207,160,71,142,108,3785
"37157040400",2998,1270,902,343,110,42,35,0,5700
"37157040501",1981,566,504,241,219,83,146,62,3802
"37157040502",1922,264,412,124,344,36,344,15,3461
"37157040601",2932,290,305,49,345,2,402,0,4325
"37157040602",3129,353,408,71,457,507,534,608,6067
"37157040700",3551,490,245,42,84,10,0,0,4422
"37157040800",818,104,269,435,33,17,0,32,1708
"37157040900",1545,417,232,86,25,9,13,3,2330
"37157041001",4386,658,269,11,396,82,253,90,6145
"37157041002",4834,754,13,6,135,1,49,123,5915
"37157041100",4516,511,866,100,190,42,32,0,6257
"37157041200",1496,407,2262,1137,194,80,0,139,5715
"37157041300",3293,703,1579,286,343,212,660,295,7371
"37157041400",1366,565,968,270,174,118,246,149,3856
"37157041500",4652,123,1276,219,103,0,36,43,6452
"37157041601",2806,326,243,15,36,12,32,26,3496
"37157041602",3588,588,270,2,134,24,29,30,4665
"37159050201",1494,531,1081,254,202,80,117,51,3810
"37159050202",1353,533,1104,677,197,84,239,0,4187
"37159050300",2015,383,1112,356,6,348,100,199,4519
"37159050400",303,501,1007,371,82,19,250,165,2698
"37159050500",1805,200,236,183,86,79,8,0,2597
"37159050700",1070,545,825,431,152,154,49,93,3319
"37159050800",586,187,965,871,10,53,38,98,2808
"37159050901",3454,509,135,0,90,0,106,0,4294
"37159050903",4645,818,356,121,150,13,273,42,6418
"37159050904",2287,535,19,0,0,0,16,0,2857
"37159051001",5721,1114,0,30,43,68,69,111,7156
"37159051002",4581,652,116,60,94,24,74,38,5639
"37159051101",5094,766,157,30,425,153,396,111,7132
"37159051102",2661,677,46,0,528,218,487,246,4863
"37159051201",3956,910,304,107,837,71,1016,223,7424
"37159051202",2473,352,356,49,216,21,510,59,4036
"37159051204",2356,313,207,255,294,348,465,388,4626
"37159051301",1368,245,572,66,113,20,90,20,2494
"37159051302",3048,217,675,315,314,40,263,32,4904
"37159051303",2619,273,1132,662,271,33,100,41,5131
"37159051400",5369,1049,138,87,300,224,641,145,7953
"37159051501",2047,263,892,369,130,127,810,183,4821
"37159051502",2436,350,0,6,27,38,123,38,3018
"37159051600",4070,1214,438,286,160,17,641,179,7005
"37159051700",5950,761,141,270,279,273,402,229,8305
"37159051801",3977,254,42,1,0,0,44,0,4318
"37159051802",3739,215,82,36,71,16,226,16,4401
"37159051901",3239,362,232,78,20,154,0,97,4182
"37159051902",4583,774,558,316,78,72,38,69,6488
"37159052000",948,178,643,366,93,25,161,0,2414
"37161960100",4468,1053,65,13,55,0,14,12,5680
"37161960200",5607,1301,111,24,139,22,255,0,7459
"37161960300",2092,487,170,38,82,7,8,0,2884
"37161960400",2458,348,49,7,175,0,12,9,3058
"37161960500",5477,595,399,307,461,83,291,60,7673
"37161960600",2341,497,698,410,98,14,72,14,4144
"37161960700",2462,895,497,259,158,49,101,95,4516
"37161960800",1876,800,844,903,47,320,212,349,5351
"37161960900",3377,1265,574,142,111,19,282,211,5981
"37161961000",5964,1376,90,329,99,19,27,0,7904
"37161961101",4004,1300,49,204,100,233,15,114,6019
"37161961102",2322,254,240,0,15,0,55,0,2886
"37161961200",3931,583,0,12,95,20,177,20,4838
"37163970100",2526,558,1608,492,1443,348,1370,472,8817
"37163970200",4192,807,651,230,794,184,985,488,8331
"37163970301",4204,797,770,105,252,198,158,595,7079
"37163970302",3105,455,596,128,496,177,580,256,5793
"37163970400",2924,776,891,468,276,77,254,80,5746
"37163970500",3299,483,1351,262,194,259,286,214,6348
"37163970600",2004,302,772,987,346,204,230,173,5018
"37163970700",2921,446,1680,421,526,429,472,522,7417
"37163970800",2309,462,1482,687,1259,699,1127,703,8728
"37163970900",1395,287,606,546,393,229,309,138,3903
"37163971000",1657,339,917,766,592,729,713,599,6312
"37165010101",2012,193,619,314,273,172,54,22,3659
"37165010102",2345,521,610,1513,212,185,0,46,5432
"37165010200",372,270,1353,1314,234,180,0,30,3753
"37165010300",1113,296,1454,899,281,132,106,7,4288
"37165010400",1363,185,318,148,590,470,24,0,3098
"37165010500",3369,613,893,514,551,853,102,33,6928
"37165010600",2913,739,1858,1246,502,340,91,270,7959
"37167930101",3077,397,111,68,31,5,18,0,3707
"37167930102",2301,782,496,90,182,0,0,0,3851
"37167930200",2273,400,218,37,333,9,21,7,3298
"37167930300",3107,507,123,21,165,67,49,54,4093
"37167930500",2239,401,343,202,184,18,56,56,3499
"37167930700",3771,440,2,9,9,0,18,0,4249
"37167930801",3939,540,29,35,163,52,84,41,4883
"37167930802",4242,472,0,1,7,15,314,45,5096
"37167930900",4537,757,697,58,230,49,544,226,7098
"37167931000",4241,895,296,11,104,107,0,0,5654
"37167931100",4062,566,472,292,107,46,40,137,5722
"37167931201",2672,554,1245,1068,237,76,214,61,6127
"37167931202",2264,289,57,25,305,35,30,89,3094
"37169070100",4864,989,324,56,193,20,321,45,6812
"37169070200",3264,493,0,10,45,60,21,53,3946
"37169070300",3724,1019,167,25,85,169,15,0,5204
"37169070400",4065,786,35,0,0,0,0,0,4886
"37169070501",5000,1129,104,0,0,42,60,293,6628
"37169070503",4866,510,91,1,202,65,81,32,5848
"37169070504",2876,420,0,1,60,33,98,14,3502
"37169070600",4659,493,0,0,31,0,101,0,5284
"37169070700",3735,743,672,241,98,59,109,0,5657
"37171930101",1538,400,74,1,96,68,0,33,2210
"37171930102",3618,992,0,1,40,23,33,401,5108
"37171930201",2407,714,99,55,89,149,80,38,3631
"37171930202",2723,366,63,75,0,11,484,22,3744
"37171930301",1558,115,66,137,76,88,14,77,2131
"37171930302",2473,361,215,139,39,38,149,53,3467
"37171930400",1448,787,82,167,178,56,341,247,3306
"37171930501",2589,362,60,0,0,0,34,0,3045
"37171930502",2381,516,176,22,55,0,158,45,3353
"37171930600",2554,514,45,147,148,14,279,210,3911
"37171930700",3470,608,98,66,0,0,0,76,4318
"37171930801",3567,898,35,37,109,1,128,81,4856
"37171930802",2506,545,13,6,51,3,13,2,3139
"37171930901",3017,413,251,129,300,73,865,79,5127
"37171930902",1388,52,22,0,68,0,50,0,1580
"37171931001",1848,636,0,11,141,42,337,133,3148
"37171931002",3440,915,17,14,72,276,233,514,5481
"37171931003",1977,897,53,0,213,359,196,916,4611
"37171931101",2441,503,7,0,124,0,351,136,3562
"37171931102",3016,619,12,5,50,46,210,4,3962
"37171931103",1681,403,0,4,0,0,13,0,2101
"37171931200",2917,451,159,31,56,22,9,121,3766
"37173940100",886,278,0,41,1690,1810,150,140,4995
"37173960200",2327,528,9,277,126,28,109,0,3404
"37173960301",2485,380,0,2,94,32,7,1,3001
"37173960302",2009,259,0,0,343,96,99,0,2806
"37173980200",0,0,0,0,0,0,0,0,0
"37175960100",3932,662,232,22,99,56,18,55,5076
"37175960200",2261,588,250,232,378,370,50,273,4402
"37175960300",5060,507,20,63,340,26,177,24,6217
"37175960401",3811,159,30,0,154,1,156,0,4311
"37175960402",3639,304,42,0,59,0,99,0,4143
"37175960500",4565,971,0,0,171,104,36,12,5859
"37175960600",2258,492,19,0,58,0,9,0,2836
"37177960100",2075,348,561,263,255,146,287,118,4053
"37179020100",5458,417,56,33,0,100,31,0,6095
"37179020202",5960,261,351,13,236,0,17,0,6838
"37179020203",3321,221,0,0,322,0,406,68,4338
"37179020204",3379,168,51,0,39,0,0,0,3637
"37179020305",3891,162,444,0,168,1,143,1,4810
"37179020306",4444,1056,1054,1,406,106,546,975,8588
"37179020307",5412,244,532,39,230,0,514,142,7113
"37179020308",4852,225,361,70,356,8,747,8,6627
"37179020309",1882,387,12,60,70,0,43,121,2575
"37179020310",4593,156,500,85,154,36,275,0,5799
"37179020311",4333,301,318,42,430,95,313,82,5914
"37179020312",3032,384,498,0,310,117,301,108,4750
"37179020313",1732,233,85,5,197,0,108,154,2514
"37179020314",4642,232,234,43,448,129,450,181,6359
"37179020315",4606,112,231,0,211,0,258,0,5418
"37179020316",3756,24,440,0,94,126,121,126,4687
"37179020317",3816,18,1196,5,543,35,452,20,6085
"37179020401",4713,131,745,265,432,20,459,78,6843
"37179020403",3059,629,488,109,257,102,392,267,5303
"37179020404",2643,562,1075,549,695,612,1605,829,8570
"37179020501",3030,626,1065,187,393,17,1254,481,7053
"37179020502",2509,164,644,132,271,26,388,55,4189
"37179020601",2399,519,749,540,156,307,1098,459,6227
"37179020602",1916,480,1003,425,652,327,1287,565,6655
"37179020701",1910,389,1420,160,387,374,679,550,5869
"37179020702",2804,264,665,278,127,17,893,23,5071
"37179020800",3358,240,1124,404,109,25,279,33,5572
"37179020901",3811,372,319,75,231,10,65,46,4929
"37179020902",4295,454,373,171,90,0,107,31,5521
"37179021004",3927,294,171,0,91,0,161,0,4644
"37179021005",2848,505,586,160,67,0,101,24,4291
"37179021006",5186,92,106,0,131,13,303,0,5831
"37179021007",5257,114,219,23,765,0,274,0,6652
"37179021008",5468,256,589,0,585,68,230,57,7253
"37179021009",2176,84,210,0,198,0,200,0,2868
"37179021010",5788,158,348,0,342,12,305,0,6953
"37179021011",5311,262,405,11,209,0,684,0,6882
"37179021012",3316,98,19,0,8,98,104,98,3741
"37179021013",3107,241,764,0,50,65,291,20,4538
"37179021014",2400,113,188,89,0,0,37,0,2827
"37179021015",3325,457,186,94,80,114,0,0,4256
"37181960100",1906,268,1384,1087,101,1,101,0,4848
"37181960200",1344,329,2041,601,132,14,77,1,4539
"37181960300",2328,284,1558,412,201,90,21,157,5051
"37181960400",2298,162,770,679,35,17,0,0,3961
"37181960500",942,150,1831,911,99,0,82,34,4049
"37181960600",235,150,389,347,142,45,169,45,1522
"37181960700",194,258,1744,1884,0,151,77,108,4416
"37181960800",362,244,949,286,38,238,45,218,2380
"37181960900",3140,645,1786,1186,708,670,800,744,9679
"37181961000",3397,552,1861,526,134,246,149,227,7092
"37183050100",1587,214,263,166,80,21,8,16,2355
"37183050300",1907,159,131,243,55,48,0,30,2573
"37183050400",1040,49,312,42,3,0,0,0,1446
"37183050500",2019,129,415,698,88,0,29,8,3386
"37183050600",646,24,1352,585,154,35,30,0,2826
"37183050700",387,37,1478,1298,58,61,200,115,3634
"37183050800",243,527,585,920,30,105,226,652,3288
"37183050900",115,52,569,1133,171,126,117,108,2391
"37183051000",1515,249,110,160,101,17,46,4,2202
"37183051101",281,402,335,161,577,77,60,89,1982
"37183051102",26,33,0,1,1,8,5,8,82
"37183051200",2250,856,84,37,128,56,9,67,3487
"37183051400",3080,1344,276,84,205,220,258,0,5467
"37183051501",2879,187,8,7,98,0,7,0,3186
"37183051502",1680,289,11,23,197,422,15,13,2650
"37183051600",4084,237,11,0,56,0,0,0,4388
"37183051700",2963,102,0,1,73,0,8,0,3147
"37183051800",3143,304,419,217,101,16,141,147,4488
"37183051900",1616,83,1803,1021,277,159,439,170,5568
"37183052001",729,557,1401,682,104,64,692,607,4836
"37183052002",197,307,2935,889,12,30,0,208,4578
"37183052101",719,510,4612,843,673,59,612,455,8483
"37183052102",697,232,3479,1573,82,38,711,232,7044
"37183052301",2769,1149,908,75,313,244,179,89,5726
"37183052302",2266,2015,793,579,492,306,143,17,6611
"37183052401",1472,401,1129,39,88,65,370,13,3577
"37183052404",2404,860,228,138,573,161,450,181,4995
"37183052406",2925,1062,1286,795,224,130,613,161,7196
"37183052407",2013,949,494,578,76,121,388,403,5022
"37183052408",1318,629,284,277,73,0,269,112,2962
"37183052409",868,790,310,279,745,500,343,262,4097
"37183052503",5145,354,825,242,287,27,88,13,6981
"37183052504",4150,268,358,407,235,0,649,116,6183
"37183052505",3285,102,741,0,832,0,459,0,5419
"37183052506",1415,60,132,0,112,11,30,13,1773
"37183052507",2194,158,551,61,140,20,438,11,3573
"37183052601",2496,113,254,1,73,0,13,0,2950
"37183052602",3280,140,156,117,77,10,30,7,3817
"37183052603",2015,101,302,84,125,61,104,52,2844
"37183052701",2479,221,515,190,850,703,829,816,6603
"37183052704",1497,1026,2154,912,949,321,1597,1265,9721
"37183052705",2193,462,855,109,217,74,314,258,4482
"37183052706",1897,477,1056,199,272,108,391,490,4890
"37183052707",3170,449,1525,670,852,35,873,291,7865
"37183052801",4946,52,1214,147,19,0,124,0,6502
"37183052802",3525,134,1270,609,481,11,561,32,6623
"37183052803",1778,628,5389,1336,422,12,494,558,10617
"37183052806",2788,1303,9554,538,843,76,1461,1169,17732
"37183052807",1948,170,1664,295,359,44,487,141,5108
"37183052808",5557,685,2617,103,286,0,375,173,9796
"37183052809",1651,177,1053,23,280,64,256,56,3560
"37183052901",1793,64,143,54,13,45,157,0,2269
"37183052902",4154,281,653,75,265,2,243,171,5844
"37183052903",2498,121,345,69,154,0,195,2,3384
"37183052904",5918,256,843,13,384,0,453,0,7867
"37183053003",3901,659,631,22,578,506,61,313,6671
"37183053004",2045,39,49,0,431,0,107,0,2671
"37183053005",4705,156,75,0,401,0,162,0,5499
"37183053006",2755,38,6,0,267,0,49,0,3115
"37183053007",2561,14,31,0,306,0,0,0,2912
"37183053008",5473,779,818,214,1062,75,366,37,8824
"37183053009",4396,1521,1040,15,297,424,1251,1584,10528
"37183053105",2943,25,429,0,166,0,92,0,3655
"37183053106",2059,73,533,483,35,27,18,27,3255
"37183053107",5891,562,1627,377,330,0,664,203,9654
"37183053108",4786,428,734,92,339,180,325,153,7037
"37183053109",6988,421,405,15,382,61,787,188,9247
"37183053110",4649,203,592,24,211,59,431,59,6228
"37183053111",3241,731,508,141,438,19,238,615,5931
"37183053201",8541,229,1126,1,683,348,465,324,11717
"37183053202",4478,125,189,14,224,0,100,0,5130
"37183053203",5556,298,980,69,503,67,247,0,7720
"37183053204",3483,14,966,33,340,0,97,0,4933
"37183053205",1695,84,72,52,27,0,5,0,1935
"37183053206",2406,120,798,318,527,0,155,70,4394
"37183053207",5576,357,624,26,383,0,275,0,7241
"37183053405",4180,45,220,0,363,0,127,0,4935
"37183053408",2767,125,15,0,1084,36,96,0,4123
"37183053409",5414,62,110,76,1350,47,477,0,7536
"37183053410",2802,73,141,0,1735,0,252,13,5016
"37183053411",4685,316,207,0,1496,0,153,0,6857
"37183053412",4725,106,156,0,919,161,385,0,6452
"37183053413",4298,29,206,26,650,64,219,0,5492
"37183053414",7070,53,441,0,903,0,637,0,9104
"37183053415",2414,9,174,0,667,7,306,9,3586
"37183053416",4038,176,903,53,683,0,334,53,6240
"37183053417",1423,100,967,17,140,0,68,22,2737
"37183053418",4457,189,518,148,282,78,445,20,6137
"37183053419",2491,0,81,0,85,0,32,0,2689
"37183053420",3749,226,749,0,312,230,756,255,6277
"37183053421",3568,172,416,49,774,31,187,0,5197
"37183053422",2104,82,53,0,248,31,47,0,2565
"37183053423",1720,88,59,0,241,0,67,0,2175
"37183053424",3090,26,262,0,796,117,230,72,4593
"37183053425",1678,19,81,5,935,0,65,5,2788
"37183053505",2770,302,468,46,137,0,132,0,3855
"37183053506",3851,208,280,23,513,0,738,0,5613
"37183053507",2450,337,502,86,284,204,504,202,4569
"37183053509",4407,145,53,0,584,0,377,0,5566
"37183053512",4557,114,272,0,1150,0,277,36,6406
"37183053513",2161,243,699,119,705,121,503,121,4672
"37183053516",2304,123,656,106,524,20,611,76,4420
"37183053517",2640,651,293,77,1024,291,1722,675,7373
"37183053518",3300,227,44,20,143,0,51,0,3785
"37183053519",2584,465,522,294,345,301,720,504,5735
"37183053520",3153,205,1080,117,793,282,599,169,6398
"37183053521",2384,75,127,10,767,18,118,0,3499
"37183053522",2895,89,556,0,1854,0,496,0,5890
"37183053523",3643,128,513,0,1021,38,101,48,5492
"37183053524",2546,242,145,0,577,30,391,12,3943
"37183053525",2127,0,131,0,286,0,155,0,2699
"37183053601",3562,116,486,120,2000,13,430,0,6727
"37183053602",1674,39,996,0,2141,0,283,0,5133
"37183053603",2716,25,205,5,859,85,19,0,3914
"37183053604",3005,8,93,0,1059,14,79,0,4258
"37183053605",1311,10,130,0,273,0,49,0,1773
"37183053606",2018,104,294,9,271,51,52,9,2808
"37183053607",3381,34,362,0,3452,144,485,0,7858
"37183053608",1335,0,768,54,860,71,28,0,3116
"37183053609",448,8,134,0,155,0,11,0,756
"37183053610",4994,150,2226,69,1160,83,145,77,8904
"37183053707",4248,237,1061,136,292,242,154,171,6541
"37183053709",3922,545,1351,96,595,137,365,126,7137
"37183053711",4415,79,534,89,222,72,52,0,5463
"37183053712",2402,79,176,0,108,0,43,0,2808
"37183053713",1766,183,975,63,172,8,243,0,3410
"37183053714",3120,359,646,108,426,54,60,0,4773
"37183053715",2756,127,283,14,134,28,76,21,3439
"37183053716",2243,125,1034,11,201,67,42,8,3731
"37183053717",1851,55,363,23,501,47,288,9,3137
"37183053718",2871,85,160,1,141,0,172,0,3430
"37183053719",3200,23,100,357,277,8,170,0,4135
"37183053720",3658,48,211,0,299,0,212,0,4428
"37183053721",2612,9,207,0,288,53,47,0,3216
"37183053722",3778,228,166,0,330,0,8,46,4556
"37183053723",2437,311,263,0,149,0,202,0,3362
"37183053724",4232,87,389,0,1728,0,522,0,6958
"37183053725",3614,184,757,149,469,0,267,0,5440
"37183053726",1514,44,863,183,903,20,863,0,4390
"37183053803",3197,28,402,0,127,0,89,0,3843
"37183053804",3439,19,155,1,49,0,418,0,4081
"37183053805",1833,227,31,0,131,0,58,96,2376
"37183053806",3465,25,188,1,138,0,65,0,3882
"37183053807",3633,16,140,0,312,0,57,0,4158
"37183053808",4630,22,345,0,364,0,195,0,5556
"37183053900",6035,635,391,38,238,0,398,0,7735
"37183054001",3337,643,1094,100,472,0,525,397,6568
"37183054004",3149,237,1054,150,412,475,785,541,6803
"37183054006",1836,350,574,53,348,210,207,217,3795
"37183054007",2585,118,935,98,242,0,284,11,4273
"37183054008",1510,911,1893,1031,755,425,1106,1059,8690
"37183054011",2640,104,166,59,25,24,132,73,3223
"37183054012",3053,24,346,30,140,10,158,0,3761
"37183054013",9815,645,887,471,925,18,581,0,13342
"37183054014",5825,818,3051,630,1963,382,2762,702,16133
"37183054015",889,65,764,129,629,19,449,18,2962
"37183054016",4793,97,481,44,341,27,254,0,6037
"37183054017",1388,49,697,136,83,190,163,155,2861
"37183054018",816,111,1294,265,307,353,233,348,3727
"37183054104",4905,254,3958,337,1186,24,2003,144,12811
"37183054105",6609,122,3964,624,399,73,780,0,12571
"37183054106",1446,624,3682,296,716,454,492,833,8543
"37183054108",3240,467,1996,146,478,52,1237,162,7778
"37183054109",2036,230,758,22,196,102,67,134,3545
"37183054110",4592,272,2269,290,1086,263,325,0,9097
"37183054111",1342,229,348,10,40,17,0,15,2001
"37183054112",1571,280,1236,25,154,0,657,199,4122
"37183054113",1445,42,778,34,16,0,547,36,2898
"37183054114",2478,532,1342,0,295,28,857,483,6015
"37183054115",4460,145,2770,359,338,88,1013,0,9173
"37183054203",3166,18,104,0,253,0,228,0,3769
"37183054204",2953,527,501,214,175,61,126,0,4557
"37183054205",2680,387,663,368,348,0,324,2,4772
"37183054206",4246,201,177,218,95,0,35,34,5006
"37183054207",6567,355,1061,119,677,70,585,89,9523
"37183054208",5424,172,346,105,527,9,233,89,6905
"37183054209",5622,94,2657,56,712,14,447,49,9651
"37183054210",6411,441,1316,198,201,0,215,0,8782
"37183054211",6968,480,907,63,794,13,654,193,10072
"37183054301",3728,559,1029,114,131,0,195,271,6027
"37183054302",3903,338,1790,472,280,115,1152,208,8258
"37183054402",3972,675,743,91,254,0,491,253,6479
"37183054403",1973,513,863,73,207,96,493,479,4697
"37183054404",3376,143,1077,345,1091,107,1122,16,7277
"37183054500",2825,1504,1355,737,632,256,833,1431,9573
"37183980100",0,0,0,0,0,0,0,0,0
"37183980200",93,0,0,0,2,0,0,0,95
"37185950101",1537,167,402,59,265,0,89,0,2519
"37185950102",628,66,269,128,33,0,50,0,1174
"37185950103",467,98,810,336,686,336,82,22,2837
"37185950200",1782,468,2015,1156,100,103,10,62,5696
"37185950300",923,147,1912,1019,165,137,111,115,4529
"37185950400",1153,254,1584,655,41,121,42,117,3967
"37187950100",1987,270,1641,917,344,28,337,38,5562
"37187950200",2121,356,2285,1298,19,38,22,97,6236
"37187950300",1069,105,312,28,0,0,0,0,1514
"37189920100",3395,1300,96,32,358,93,44,17,5335
"37189920200",3389,275,0,0,68,170,33,125,4060
"37189920300",1901,275,0,5,118,18,117,5,2439
"37189920400",3638,4443,170,12,203,479,218,139,9302
"37189920500",729,1214,11,28,31,113,12,45,2183
"37189920601",1992,2195,52,20,48,144,145,84,4680
"37189920602",1136,394,0,6,18,73,0,68,1695
"37189920701",1531,74,30,29,18,0,0,0,1682
"37189920702",2570,291,0,86,71,15,87,0,3120
"37189920703",4060,674,74,125,115,289,127,191,5655
"37189920800",2225,391,0,6,13,72,13,49,2769
"37189920900",3033,717,23,0,113,294,57,2,4239
"37189921000",464,68,0,0,24,0,4,0,560
"37191000101",5222,1106,1156,168,199,136,203,21,8211
"37191000102",4454,354,1314,22,310,37,42,37,6570
"37191000200",1888,268,467,247,119,109,70,168,3336
"37191000302",2890,505,1669,269,256,590,143,590,6912
"37191000303",4057,403,1247,192,613,39,162,31,6744
"37191000304",3349,756,889,123,180,0,170,15,5482
"37191000401",3178,453,449,396,166,494,7,349,5492
"37191000402",1723,384,710,605,399,806,148,743,5518
"37191000500",1231,270,741,0,331,26,228,19,2846
"37191000601",1279,303,1682,529,447,372,488,363,5463
"37191000602",3778,1046,910,238,1612,1298,1977,1474,12333
"37191000700",603,129,1287,394,104,154,181,154,3006
"37191000800",907,207,243,352,147,402,158,450,2866
"37191000901",2542,698,636,391,502,739,264,699,6471
"37191000902",2180,511,977,421,708,60,666,172,5695
"37191001000",2841,422,260,54,222,364,167,364,4694
"37191001101",4901,695,286,198,233,0,181,0,6494
"37191001102",2574,218,335,64,55,3,0,0,3249
"37191001200",1415,79,1013,767,226,18,159,0,3677
"37191001301",2679,237,2083,222,430,35,352,11,6049
"37191001302",1775,260,827,83,186,104,159,11,3405
"37191001400",1373,105,2801,1907,508,74,345,66,7179
"37191001500",335,51,1533,914,15,49,70,0,2967
"37191001800",335,82,947,1015,42,46,0,87,2554
"37191001900",1061,200,1578,862,141,47,31,25,3945
"37191002000",133,66,525,312,56,0,56,0,1148
"37193960100",5180,1550,366,3,27,136,22,65,7349
"37193960200",2820,681,41,0,13,0,1,0,3556
"37193960300",4976,1159,26,56,155,24,169,86,6651
"37193960400",5688,1475,58,9,73,187,118,165,7773
"37193960500",1830,706,80,78,69,166,37,107,3073
"37193960600",1466,691,149,162,0,383,8,507,3366
"37193960700",2234,739,57,87,43,362,193,263,3978
"37193960801",2982,815,188,0,267,125,322,125,4824
"37193960802",3362,612,22,18,184,132,183,132,4645
"37193960900",3757,963,0,0,0,0,12,0,4732
"37193961001",3975,653,61,79,101,227,325,66,5487
"37193961002",4046,534,41,68,139,102,223,238,5391
"37193961100",1840,440,347,268,241,16,169,16,3337
"37193961200",5218,1647,419,0,86,144,198,74,7786
"37195000100",361,138,1093,830,39,348,68,342,3219
"37195000200",12,85,163,677,0,6,0,92,1035
"37195000300",319,67,944,1005,154,233,186,241,3149
"37195000400",3551,295,2011,839,416,167,210,328,7817
"37195000501",3513,72,68,0,80,5,0,5,3743
"37195000502",3139,122,1121,496,225,35,9,0,5147
"37195000600",3066,252,2052,699,355,0,163,24,6611
"37195000700",444,340,2028,2139,328,801,633,659,7372
"37195000801",20,17,686,757,29,163,49,148,1869
"37195000802",978,381,1660,412,244,348,184,432,4639
"37195000900",2548,496,559,82,245,31,271,204,4436
"37195001000",782,62,843,137,61,6,84,15,1990
"37195001100",766,104,461,32,3,1,3,0,1370
"37195001200",1798,178,1035,456,213,326,293,203,4502
"37195001300",2849,264,1400,664,130,123,146,54,5630
"37195001400",4888,558,2217,555,564,496,93,509,9880
"37195001500",2930,506,797,75,829,348,902,359,6746
"37195001600",1944,323,244,251,384,32,270,16,3464
"37195001700",2570,199,800,214,267,264,302,260,4876
"37197050101",4374,995,126,25,73,58,323,183,6157
"37197050102",3306,529,45,31,0,0,154,0,4065
"37197050200",3669,400,202,6,17,0,18,172,4484
"37197050300",4816,801,206,77,238,359,240,240,6977
"37197050400",4455,704,143,12,515,336,625,268,7058
"37197050501",4899,1008,93,136,133,501,376,667,7813
"37197050502",3497,907,16,46,46,70,239,322,5143
"37199960101",2888,432,3,0,16,81,26,143,3589
"37199960102",1747,696,0,0,16,22,142,0,2623
"37199960200",3042,889,135,2,72,99,119,80,4438
"37199960300",2441,812,7,14,0,3,83,227,3587
"37199960400",3599,453,0,0,38,10,0,0,4100
"38001965600",1993,198,6,0,43,26,32,0,2298
"38003967900",1533,94,0,0,36,2,0,0,1665
"38003968000",2517,223,5,0,59,9,38,0,2851
"38003968200",2046,293,32,0,241,13,64,0,2689
"38003968300",3042,298,13,0,36,44,34,7,3474
"38005940100",349,52,0,5,703,1219,67,0,2395
"38005940200",310,59,0,0,1057,753,15,2,2196
"38005956500",1088,114,0,0,13,0,6,0,1221
"38005956600",749,174,0,0,1,8,5,0,937
"38007963100",789,62,0,0,13,12,0,3,879
"38009952300",1779,201,0,0,163,13,46,7,2209
"38009952400",1885,216,0,0,60,34,3,0,2198
"38009952500",1628,223,4,0,22,0,16,17,1910
"38011965200",1430,177,0,0,79,0,65,12,1763
"38011965300",1296,69,2,1,29,5,29,0,1431
"38013953300",1779,245,19,0,36,15,39,51,2184
"38015010100",2158,406,42,0,215,155,58,0,3034
"38015010200",3483,549,68,0,209,74,94,0,4477
"38015010300",5714,492,0,1,106,56,33,0,6402
"38015010400",3337,123,44,0,157,0,124,5,3790
"38015010500",4174,511,0,0,196,22,0,0,4903
"38015010600",3468,210,43,37,100,527,14,28,4427
"38015010700",3908,399,0,0,107,44,68,7,4533
"38015010800",2959,379,0,0,218,321,0,0,3877
"38015010900",3522,211,25,29,91,48,85,29,4040
"38015011001",4199,418,41,12,322,48,0,0,5040
"38015011002",5389,145,34,0,423,0,190,10,6191
"38015011101",4255,441,36,0,162,30,119,0,5043
"38015011103",2871,50,31,0,135,17,19,0,3123
"38015011104",4046,13,0,0,239,22,0,0,4320
"38015011105",3734,0,0,0,113,0,22,0,3869
"38015011200",4825,262,0,0,131,65,52,39,5374
"38015011300",5194,164,9,0,249,210,71,0,5897
"38015011400",2178,68,0,0,113,13,19,0,2391
"38015011500",1345,107,0,0,28,5,4,17,1506
"38017000100",4741,43,19,0,116,9,0,0,4928
"38017000201",2965,344,0,0,292,0,39,0,3640
"38017000202",2223,505,26,55,226,84,133,0,3252
"38017000300",1231,215,28,24,193,279,0,0,1970
"38017000400",2631,640,24,34,75,155,29,11,3599
"38017000501",2878,526,17,0,137,189,34,113,3894
"38017000502",1279,1102,72,15,172,159,47,8,2854
"38017000600",3266,1119,3,0,283,449,0,58,5178
"38017000700",1016,706,6,0,5,25,35,15,1808
"38017000801",2761,216,0,0,269,0,106,0,3352
"38017000802",3441,578,11,364,465,139,234,111,5343
"38017000901",4734,189,13,35,191,106,12,70,5350
"38017000903",2269,659,114,84,238,12,34,37,3447
"38017000904",3125,243,60,23,106,138,45,0,3740
"38017001001",4014,747,101,11,248,134,26,154,5435
"38017001002",1798,487,82,26,47,15,137,3,2595
"38017010106",3096,1093,36,390,337,67,231,0,5250
"38017010107",2051,399,75,0,65,65,74,10,2739
"38017010108",4230,508,236,299,334,0,80,15,5702
"38017010109",2971,418,16,1,310,173,146,0,4035
"38017010201",4885,168,0,0,237,0,24,0,5314
"38017010203",2604,166,50,0,28,36,42,30,2956
"38017010204",5230,380,252,173,256,89,0,0,6380
"38017010303",5809,403,19,0,317,13,73,0,6634
"38017010305",4507,833,112,338,462,77,154,145,6628
"38017010306",3189,213,37,96,275,53,145,115,4123
"38017010307",2025,55,0,0,102,0,0,0,2182
"38017040100",1716,69,0,0,6,0,16,0,1807
"38017040200",2208,97,0,0,31,7,4,0,2347
"38017040300",3126,78,0,0,37,0,0,3,3244
"38017040400",3786,99,3,60,27,1,29,1,4006
"38017040500",23002,1449,341,50,832,89,371,13,26147
"38017040600",2777,92,2,0,29,6,27,0,2933
"38019950900",1617,112,0,0,78,0,0,0,1807
"38019951100",1905,75,0,0,45,0,0,0,2025
"38021973200",1987,119,6,17,28,34,115,0,2306
"38021973300",1249,122,4,0,0,0,0,0,1375
"38021973400",1116,177,20,2,50,6,0,3,1374
"38023954500",1888,177,0,0,42,0,0,0,2107
"38025962200",2850,284,12,0,479,90,102,0,3817
"38027959200",1902,302,0,0,72,13,60,20,2369
"38029966500",2903,513,0,0,43,4,8,0,3471
"38031959600",2877,356,0,0,32,8,48,0,3321
"38033962900",1420,172,0,1,11,30,13,0,1647
"38035010100",2344,566,97,0,197,16,165,129,3514
"38035010200",3185,715,0,7,87,173,189,34,4390
"38035010300",611,999,181,87,113,202,30,4,2227
"38035010400",3218,1568,32,244,404,330,141,141,6078
"38035010600",1433,419,0,6,44,96,18,6,2022
"38035010700",1575,161,15,17,45,6,41,0,1860
"38035010801",3341,664,0,0,219,205,6,0,4435
"38035010803",3662,892,167,152,224,106,127,52,5382
"38035010804",3087,561,92,0,318,134,53,16,4261
"38035010900",1554,69,0,0,67,4,71,0,1765
"38035011000",2136,101,11,0,269,171,156,0,2844
"38035011100",4758,89,15,0,125,0,83,0,5070
"38035011200",5322,370,29,31,613,101,68,0,6534
"38035011400",2114,198,0,0,52,14,12,32,2422
"38035011700",4981,206,16,0,159,35,92,5,5494
"38035011800",1344,83,10,0,30,0,14,0,1481
"38035011900",1524,89,210,0,91,9,169,0,2092
"38035012000",2605,131,11,12,82,3,108,16,2968
"38037965900",1869,311,2,5,117,13,8,1,2326
"38039968600",2103,160,4,0,26,0,9,0,2302
"38041964700",970,152,0,0,3,3,0,0,1128
"38041964800",1154,103,0,0,22,0,17,0,1296
"38043966800",2081,251,0,0,85,0,105,0,2522
"38045972100",1371,131,0,0,12,0,10,3,1527
"38045972200",2280,218,0,2,26,0,12,0,2538
"38047972500",1678,187,0,6,33,0,22,0,1926
"38049955600",2166,302,3,0,70,5,53,5,2604
"38049955900",2481,462,0,0,24,13,40,9,3029
"38051972900",2235,347,1,0,60,21,3,5,2672
"38053940100",46,11,13,0,775,636,64,8,1553
"38053962300",1746,89,0,0,41,18,0,39,1933
"38053962400",2151,152,4,0,84,2,35,34,2462
"38053962500",1392,87,0,0,20,5,36,7,1547
"38055960800",3343,499,2,0,86,1,11,84,4026
"38055961000",4022,354,0,0,535,121,34,0,5066
"38057961600",2243,117,52,13,90,36,67,13,2631
"38057961700",2989,255,0,0,17,0,44,0,3305
"38057961800",2215,170,4,0,127,19,17,0,2552
"38059020100",4587,659,0,0,288,89,0,138,5761
"38059020200",6002,326,73,0,411,33,35,33,6913
"38059020300",7195,493,53,0,373,189,101,0,8404
"38059020400",2835,155,0,0,73,0,0,0,3063
"38059020500",2950,352,0,0,181,25,145,33,3686
"38061940300",523,68,8,0,561,182,29,0,1371
"38061940400",660,56,16,0,1517,365,152,31,2797
"38061955200",3712,289,0,0,130,40,111,25,4307
"38063959000",2697,208,17,22,48,0,36,0,3028
"38065961200",1639,103,0,0,31,31,10,23,1837
"38067950100",1159,107,4,0,11,0,13,0,1294
"38067950200",1325,176,0,0,143,0,34,16,1694
"38067950300",1235,55,0,0,62,17,34,0,1403
"38067950400",1184,129,0,0,12,8,7,0,1340
"38067950500",1314,129,0,0,53,0,64,22,1582
"38069956100",1314,115,0,0,5,25,0,0,1459
"38069956200",2209,348,0,0,32,107,38,15,2749
"38071957600",2953,330,42,0,222,325,39,0,3911
"38071957700",2661,193,0,0,77,47,87,0,3065
"38071957800",3318,227,33,0,351,210,52,0,4191
"38073968900",1224,224,14,0,23,4,2,2,1493
"38073969000",1662,51,12,0,12,0,22,0,1759
"38073969100",1777,221,0,0,55,4,32,14,2103
"38075952900",2237,161,6,0,41,11,3,0,2459
"38077970700",1907,66,0,0,0,30,0,0,2003
"38077970800",1919,132,0,0,12,5,15,4,2087
"38077970900",2408,437,20,0,103,51,65,0,3084
"38077971000",3033,462,0,0,246,91,112,78,4022
"38077971100",1170,48,0,0,158,2,6,0,1384
"38077971400",2325,449,0,0,79,20,4,2,2879
"38079941800",125,26,20,0,3689,2167,21,33,6081
"38079951600",635,140,9,0,339,302,0,0,1425
"38079951700",586,108,4,5,2073,1970,0,18,4764
"38079951900",1047,100,3,0,401,196,7,0,1754
"38081974000",1277,87,0,0,25,6,13,0,1408
"38081974200",2160,172,11,10,55,7,47,8,2470
"38083960200",1120,149,4,0,9,31,3,0,1316
"38085940800",374,45,0,0,546,513,4,0,1482
"38085940900",96,11,0,0,1457,1113,54,48,2779
"38087965000",672,66,0,0,0,0,3,2,743
"38089963300",1216,125,0,0,27,3,13,0,1384
"38089963400",3229,198,5,0,111,8,0,8,3559
"38089963500",4150,218,0,9,136,64,59,0,4636
"38089963600",1720,195,39,39,34,6,83,5,2121
"38089963700",3336,369,27,1,259,88,188,36,4304
"38089963800",3910,232,59,0,269,0,180,0,4650
"38089963900",2753,176,15,0,145,19,57,1,3166
"38089964000",1556,137,0,0,31,1,25,1,1751
"38091968700",1793,121,0,0,32,0,53,0,1999
"38093967000",2454,69,0,1,31,3,16,0,2574
"38093967200",2275,265,0,0,50,38,11,0,2639
"38093967300",1537,428,0,0,0,13,14,5,1997
"38093967400",4047,361,15,0,218,74,128,0,4843
"38093967500",3139,488,0,0,82,0,0,149,3858
"38093967800",3140,502,0,87,147,0,12,0,3888
"38095951500",2014,126,13,0,42,42,0,9,2246
"38097970100",2112,244,0,0,63,21,0,0,2440
"38097970200",1870,275,17,2,29,22,15,6,2236
"38097970300",1285,53,0,0,10,3,10,2,1363
"38097970400",1457,197,12,0,77,11,80,88,1922
"38099957800",1351,149,9,0,141,10,175,81,1916
"38099957900",1037,128,0,0,206,38,335,40,1784
"38099958000",2140,345,0,6,239,24,125,66,2945
"38099958100",2016,124,0,0,115,4,164,11,2434
"38099958200",1276,218,0,0,35,15,31,26,1601
"38099958300",1138,87,4,0,31,2,1,0,1263
"38101010100",2170,458,88,0,239,49,84,5,3093
"38101010200",3519,376,0,66,137,98,39,15,4250
"38101010301",3197,79,135,32,258,77,146,27,3951
"38101010302",4630,525,144,0,687,142,419,0,6547
"38101010400",4052,458,58,0,260,78,71,44,5021
"38101010500",5643,248,31,22,355,2,178,0,6479
"38101010600",5849,840,119,19,509,63,223,0,7622
"38101010700",5567,777,230,0,599,62,48,90,7373
"38101010800",3289,115,22,0,61,69,70,2,3628
"38101010900",3276,150,649,30,558,48,523,48,5282
"38101011000",1726,189,0,9,4,3,15,12,1958
"38101011200",3225,120,0,0,92,12,30,0,3479
"38101011300",4383,350,13,0,246,20,93,4,5109
"38103959800",1514,261,0,0,18,15,0,0,1808
"38103960000",2172,92,0,0,51,0,6,0,2321
"38105953400",1620,103,0,0,101,0,73,0,1897
"38105953500",971,80,5,0,455,29,3,15,1558
"38105953600",2178,143,0,0,146,21,7,0,2495
"38105953700",6170,715,0,0,500,0,76,223,7684
"38105953800",2426,219,0,0,199,44,117,7,3012
"38105953900",2972,53,6,0,13,41,17,0,3102
"38105954100",4281,467,22,138,352,56,143,22,5481
"39001770100",3708,1153,17,14,48,61,49,6,5056
"39001770200",3500,1024,14,0,0,124,32,26,4720
"39001770300",5989,1299,0,0,47,0,79,0,7414
"39001770400",3720,1002,3,16,14,0,15,0,4770
"39001770500",2026,778,0,1,95,62,1,1,2964
"39001770600",2382,824,0,0,91,14,10,16,3337
"39003010100",3433,296,38,22,39,16,77,29,3950
"39003010200",3756,197,45,0,60,0,56,0,4114
"39003010300",1388,180,16,0,23,7,12,7,1633
"39003010600",4329,400,35,9,154,47,6,19,4999
"39003010800",7328,153,111,9,315,0,206,0,8122
"39003010900",2892,439,362,62,329,41,49,41,4215
"39003011000",3293,1414,218,266,537,15,188,10,5941
"39003011200",966,201,8,15,12,0,44,76,1322
"39003011300",6135,465,151,164,189,103,15,213,7435
"39003011400",2783,173,0,0,1,35,57,2,3051
"39003011500",2166,446,0,0,117,10,71,0,2810
"39003011600",2263,170,43,23,31,0,25,0,2555
"39003011800",2109,124,167,39,50,52,34,0,2575
"39003011900",2588,237,208,0,62,27,26,10,3158
"39003012000",1998,50,50,0,44,0,11,6,2159
"39003012100",2619,274,58,18,296,60,55,10,3390
"39003012200",1792,585,659,113,110,114,62,0,3435
"39003012300",2467,678,314,292,90,35,42,26,3944
"39003012400",1332,760,386,196,121,34,10,29,2868
"39003012600",1154,671,66,336,23,48,10,49,2357
"39003012700",632,523,332,320,74,11,0,13,1905
"39003012900",627,349,143,570,198,19,15,0,1921
"39003013000",2760,822,521,41,109,102,41,89,4485
"39003013100",1905,134,221,148,9,0,103,38,2558
"39003013200",1198,84,309,81,87,62,33,27,1881
"39003013300",530,24,266,226,22,6,4,8,1086
"39003013400",443,968,372,375,109,114,50,44,2475
"39003013600",340,314,198,185,14,240,5,0,1296
"39003013700",289,161,212,508,19,28,0,17,1234
"39003013800",638,182,637,507,108,212,0,97,2381
"39003013900",2785,476,15,2,10,0,63,0,3351
"39003014000",3040,226,54,0,22,0,59,21,3422
"39003014100",564,491,451,201,170,17,159,9,2062
"39005970100",6257,2171,0,0,111,0,119,0,8658
"39005970200",4760,663,9,3,127,4,53,4,5623
"39005970300",3201,695,0,10,117,20,0,42,4085
"39005970400",2946,685,0,12,92,108,70,21,3934
"39005970500",1919,573,8,4,65,2,53,0,2624
"39005970600",3437,315,0,0,88,0,29,0,3869
"39005970700",4646,456,43,48,91,41,37,0,5362
"39005970800",2936,473,56,17,49,40,28,0,3599
"39005970900",4071,732,7,0,66,20,26,5,4927
"39005971000",4291,421,0,0,22,20,15,2,4771
"39005971100",3201,748,5,2,15,0,2,0,3973
"39007000101",2291,636,28,78,0,47,44,9,3133
"39007000102",2634,576,40,0,155,50,22,0,3477
"39007000103",2501,906,63,10,41,89,0,25,3635
"39007000200",3821,300,18,1,177,0,82,37,4436
"39007000300",1932,242,6,0,18,0,29,0,2227
"39007000400",1038,553,0,0,14,7,0,0,1612
"39007000500",3374,765,21,0,7,26,93,8,4294
"39007000601",1572,543,259,82,106,12,0,90,2664
"39007000602",2612,467,0,10,24,144,37,43,3337
"39007000603",3092,575,38,17,282,0,61,20,4085
"39007000701",1453,946,268,422,137,168,202,265,3861
"39007000702",2202,263,62,0,70,15,178,28,2818
"39007000703",1835,1272,220,248,108,100,128,100,4011
"39007000704",2717,1106,25,48,231,8,110,342,4587
"39007000801",1406,454,0,2,12,29,39,21,1963
"39007000802",4162,813,24,0,197,41,265,284,5786
"39007000900",3849,464,22,11,55,13,73,64,4551
"39007001001",4897,392,45,17,104,46,59,0,5560
"39007001002",2675,500,0,0,85,0,70,21,3351
"39007001101",1834,224,0,0,31,17,9,17,2132
"39007001102",5444,406,0,0,31,0,0,0,5881
"39007001200",6355,915,146,0,87,0,377,0,7880
"39007001301",2724,893,0,8,6,101,12,18,3762
"39007001302",2877,893,45,24,1,96,55,9,4000
"39007001400",6105,1054,33,41,86,0,7,4,7330
"39007990000",0,0,0,0,0,0,0,0,0
"39009972600",2861,1374,8,35,118,27,65,0,4488
"39009972700",2890,1041,2,0,33,0,36,49,4051
"39009972800",2563,902,0,38,54,34,0,0,3591
"39009972900",3050,1440,102,9,371,13,45,0,5030
"39009973000",1907,1181,12,41,73,30,162,0,3406
"39009973101",309,1618,9,40,35,107,42,0,2160
"39009973200",2891,1281,44,181,215,137,12,38,4799
"39009973300",2736,545,75,27,228,148,132,45,3936
"39009973400",2513,882,3,115,65,67,37,0,3682
"39009973500",2396,547,65,0,203,0,46,0,3257
"39009973600",3266,439,0,1,55,0,0,0,3761
"39009973700",3245,504,22,14,69,54,0,0,3908
"39009973800",4176,669,0,17,5,140,32,64,5103
"39009973901",140,810,8,0,107,493,0,65,1623
"39009973902",676,2314,0,51,162,133,61,17,3414
"39011040100",3506,339,1,0,81,6,50,2,3985
"39011040200",3490,385,1,0,74,0,93,51,4094
"39011040300",3119,729,12,30,21,11,28,19,3969
"39011040400",5730,254,8,17,199,8,73,56,6345
"39011040500",4653,243,0,0,19,33,5,0,4953
"39011040600",3092,293,8,5,157,33,26,0,3614
"39011040900",3430,289,0,0,31,3,57,3,3813
"39011041000",3395,155,1,0,6,19,0,18,3594
"39011041100",3926,145,4,0,73,6,13,0,4167
"39011041201",1627,393,19,0,15,0,33,0,2087
"39011041202",4449,604,6,1,108,0,45,0,5213
"39013010100",3352,562,118,7,94,35,1,0,4169
"39013010200",2916,950,143,58,35,42,12,12,4168
"39013010300",2972,229,0,1,1,0,1,0,3204
"39013010600",3091,583,1,2,35,0,1,86,3799
"39013010700",2303,354,0,0,51,0,18,0,2726
"39013010802",2079,351,0,0,41,47,0,0,2518
"39013010900",5573,551,45,77,144,0,10,0,6400
"39013011000",3925,494,0,0,156,53,14,11,4653
"39013011200",3243,449,11,0,39,0,8,0,3750
"39013011300",3433,343,0,0,17,37,0,0,3830
"39013011400",3668,722,2,0,18,0,18,0,4428
"39013011500",1258,368,20,23,15,0,0,0,1684
"39013011600",743,327,0,0,0,0,0,0,1070
"39013011700",843,422,75,5,0,65,0,0,1410
"39013011900",2342,434,204,0,29,0,26,13,3048
"39013012000",1590,624,70,19,65,244,0,23,2635
"39013012100",704,295,10,3,41,95,0,0,1148
"39013012200",3080,271,5,3,61,0,30,0,3450
"39013012300",3372,208,64,0,106,12,11,0,3773
"39013012400",4042,233,141,11,0,0,5,0,4432
"39015951201",4024,278,0,1,10,2,0,0,4315
"39015951202",3911,645,0,0,58,29,76,0,4719
"39015951300",6753,1080,68,0,83,0,164,0,8148
"39015951400",3495,627,0,0,46,46,0,0,4214
"39015951500",4543,504,69,0,232,0,12,0,5360
"39015951600",2342,989,5,20,52,10,0,36,3454
"39015951700",2118,406,109,20,74,37,0,0,2764
"39015951800",4074,868,75,0,41,0,15,0,5073
"39015951900",5394,622,0,0,13,0,0,0,6029
"39017000100",3634,512,140,49,46,7,18,173,4579
"39017000200",3111,924,304,0,51,0,97,19,4506
"39017000300",931,381,933,535,135,121,165,69,3270
"39017000400",1238,1145,414,347,207,473,209,689,4722
"39017000500",2603,1093,197,125,146,93,97,54,4408
"39017000600",3173,1658,23,68,94,256,237,358,5867
"39017001001",4623,546,284,53,123,0,101,53,5783
"39017001002",4364,507,156,39,152,16,0,0,5234
"39017001100",3300,1008,50,28,228,0,77,17,4708
"39017001300",4001,252,9,0,121,0,122,0,4505
"39017010101",1139,3837,82,126,320,179,95,42,5820
"39017010102",1976,368,115,87,251,0,79,51,2927
"39017010103",3831,1122,25,269,177,312,157,54,5947
"39017010104",37,37,10,14,11,0,0,0,109
"39017010201",22,0,0,0,0,0,0,0,22
"39017010202",3529,369,78,0,108,0,0,0,4084
"39017010203",5208,305,0,0,18,0,0,0,5531
"39017010301",3929,347,0,1,130,7,0,0,4414
"39017010302",3335,79,11,0,76,0,113,0,3614
"39017010500",1547,599,27,75,78,57,40,64,2487
"39017010600",2847,407,0,3,64,0,59,0,3380
"39017010800",6370,107,1,0,87,0,0,0,6565
"39017010901",3919,308,98,10,10,55,313,9,4722
"39017010903",4215,215,450,0,100,24,29,0,5033
"39017010904",3115,150,194,144,166,21,71,21,3882
"39017010906",4950,753,1108,361,275,101,527,225,8300
"39017010907",2073,118,95,5,109,0,36,0,2436
"39017010908",3477,303,899,80,438,18,333,5,5553
"39017010909",2767,183,1210,387,211,10,198,9,4975
"39017010910",3819,115,236,0,294,0,151,14,4629
"39017010911",3670,46,273,0,54,0,68,0,4111
"39017011002",10669,176,1065,8,607,0,136,0,12661
"39017011003",5466,13,202,0,142,155,0,0,5978
"39017011004",3407,753,770,173,151,247,119,302,5922
"39017011109",3649,269,79,120,133,83,80,30,4443
"39017011110",4852,132,166,3,142,20,136,0,5451
"39017011111",5402,352,84,0,644,96,0,0,6578
"39017011112",4318,89,521,0,517,0,129,0,5574
"39017011116",6638,345,667,0,631,26,130,26,8463
"39017011117",9286,534,412,15,949,160,575,390,12321
"39017011118",2777,28,111,0,108,0,115,0,3139
"39017011120",5888,49,466,289,568,0,35,0,7295
"39017011121",6415,390,759,76,302,66,77,33,8118
"39017011122",3521,22,610,0,671,0,447,0,5271
"39017011123",2122,935,172,856,293,249,477,828,5932
"39017011125",2864,13,163,0,360,169,15,0,3584
"39017011126",3711,248,571,24,1350,257,662,84,6907
"39017011127",3551,67,363,0,385,100,32,0,4498
"39017011128",2762,72,101,0,344,0,44,0,3323
"39017011129",3250,189,226,29,314,0,126,0,4134
"39017011130",4556,140,544,0,85,173,625,229,6352
"39017011131",2509,84,84,0,112,5,137,0,2931
"39017011200",6714,217,64,33,284,130,218,0,7660
"39017011300",3720,552,190,17,156,0,120,151,4906
"39017011800",5132,210,0,0,216,0,216,0,5774
"39017012100",2738,449,0,0,25,0,12,0,3224
"39017012200",1788,753,161,12,68,110,10,0,2902
"39017012300",1703,500,5,60,45,0,0,13,2326
"39017012400",1928,118,157,0,0,5,15,0,2223
"39017012500",4383,124,105,1,187,0,183,1,4984
"39017012600",1942,91,209,15,118,67,60,0,2502
"39017012700",2466,413,476,0,0,0,23,0,3378
"39017013000",357,143,711,251,4,139,126,54,1785
"39017013100",513,453,821,255,151,219,90,70,2572
"39017013200",2061,1055,117,146,119,97,190,154,3939
"39017013300",1901,139,4,17,119,0,0,0,2180
"39017013400",1341,405,60,134,5,36,7,0,1988
"39017013500",1835,566,90,56,240,103,0,0,2890
"39017013600",3170,999,165,312,141,34,423,133,5377
"39017013900",2199,445,0,0,14,37,0,0,2695
"39017014000",835,669,274,401,65,181,147,231,2803
"39017014100",1123,523,143,153,250,111,72,0,2375
"39017014300",4072,372,42,10,61,33,0,0,4590
"39017014400",791,619,53,31,9,9,22,9,1543
"39017014600",256,417,134,18,20,32,17,49,943
"39017014700",2909,782,46,89,53,23,8,14,3924
"39017014800",5532,1028,91,393,155,152,109,0,7460
"39017014900",4390,508,16,0,66,30,41,0,5051
"39017015000",6849,492,146,0,101,19,290,19,7916
"39017015100",5951,923,47,46,169,47,108,0,7291
"39019720100",3207,265,0,0,58,4,39,0,3573
"39019720200",2785,668,57,0,111,0,48,0,3669
"39019720300",4250,757,32,3,43,23,5,0,5113
"39019720400",3841,454,44,4,0,0,18,0,4361
"39019720500",3931,1082,7,29,48,15,0,0,5112
"39019720600",2917,599,0,0,74,7,94,0,3691
"39019720700",2509,471,0,0,66,22,51,7,3126
"39021010100",1804,93,0,0,34,21,11,0,1963
"39021010200",6094,938,0,14,73,24,43,45,7231
"39021010400",2752,1089,71,90,78,80,70,41,4271
"39021010500",2702,627,120,9,250,74,21,56,3859
"39021010600",2813,193,322,68,131,12,0,0,3539
"39021011001",2414,333,0,0,25,0,0,0,2772
"39021011501",4146,355,0,0,63,0,92,0,4656
"39021011504",4332,485,0,0,134,0,9,16,4976
"39021011505",2724,431,25,38,104,32,14,2,3370
"39021011506",2423,178,11,0,80,30,38,3,2763
"39023000200",289,191,428,541,132,120,22,58,1781
"39023000300",664,581,324,142,20,0,16,5,1752
"39023000400",1008,729,193,58,39,120,57,178,2382
"39023000500",826,492,47,6,142,92,87,81,1773
"39023000600",1346,699,245,197,26,134,0,0,2647
"39023000700",403,801,118,85,47,113,4,94,1665
"39023000901",997,730,41,505,181,49,41,19,2563
"39023000902",80,179,615,106,29,0,13,0,1022
"39023001000",815,77,300,94,39,54,0,0,1379
"39023001101",255,189,667,206,170,70,100,62,1719
"39023001102",820,160,1527,471,90,0,0,0,3068
"39023001200",836,1232,840,1046,136,227,10,33,4360
"39023001300",2508,784,157,21,74,35,49,0,3628
"39023001400",2070,440,413,42,183,38,102,9,3297
"39023001500",2992,1125,248,67,376,186,124,68,5186
"39023001600",3367,583,39,0,62,0,18,0,4069
"39023001700",1173,576,168,109,182,105,8,8,2329
"39023001900",2265,377,20,51,63,0,0,0,2776
"39023002000",2102,117,0,0,20,0,0,0,2239
"39023002100",724,404,171,0,44,8,19,2,1372
"39023002200",4165,152,50,0,67,0,33,0,4467
"39023002301",2678,515,0,0,24,0,16,10,3243
"39023002403",2882,354,182,55,177,112,102,164,4028
"39023002404",2353,202,179,0,68,0,81,0,2883
"39023002501",1662,128,89,5,24,2,0,2,1912
"39023002502",2442,295,51,18,49,89,8,35,2987
"39023002601",3666,231,0,0,23,0,0,0,3920
"39023002602",3484,501,7,9,51,0,35,0,4087
"39023002605",3559,111,84,0,70,0,7,0,3831
"39023002606",7275,369,0,1,87,0,50,0,7782
"39023002701",2799,286,61,0,4,0,191,0,3341
"39023002702",1719,373,0,0,255,189,223,228,2987
"39023002800",4076,152,0,0,79,3,1,2,4313
"39023002901",3088,475,0,0,418,39,93,45,4158
"39023002902",3429,826,0,7,94,101,266,193,4916
"39023003001",2835,130,28,23,78,0,39,0,3133
"39023003002",2972,373,32,0,62,0,83,12,3534
"39023003101",2125,85,7,0,128,112,86,0,2543
"39023003102",1628,235,0,0,43,35,23,0,1964
"39023003200",2514,221,18,0,30,0,36,0,2819
"39023003301",3109,234,0,9,133,32,159,48,3724
"39023003302",2107,363,0,0,53,4,5,0,2532
"39023003400",2021,1021,117,17,104,261,64,191,3796
"39023003700",3203,625,173,14,180,0,37,1,4233
"39025040101",4134,563,25,21,66,0,12,0,4821
"39025040102",2852,187,0,1,29,0,0,0,3069
"39025040202",1932,384,0,0,16,5,11,5,2353
"39025040203",5060,505,33,0,253,0,83,0,5934
"39025040204",5992,928,37,105,13,30,196,4,7305
"39025040301",3442,31,60,0,305,0,49,13,3900
"39025040302",3228,70,0,0,52,5,190,0,3545
"39025040303",6766,188,97,0,252,72,72,0,7447
"39025040401",3043,220,186,0,82,142,0,0,3673
"39025040403",2367,169,116,5,41,140,22,0,2860
"39025040404",3181,61,0,7,64,0,9,0,3322
"39025040405",2165,352,13,32,182,0,50,0,2794
"39025040500",3180,944,330,15,83,0,35,0,4587
"39025040600",6497,212,58,28,186,0,96,0,7077
"39025040701",5832,493,144,71,57,12,10,0,6619
"39025040702",3292,464,6,0,44,0,166,72,4044
"39025040800",5182,581,13,0,156,0,24,0,5956
"39025040900",4688,987,0,13,12,34,35,8,5777
"39025041000",6011,628,7,163,185,31,64,0,7089
"39025041101",2414,140,103,0,32,0,15,0,2704
"39025041102",2754,1325,67,69,93,254,88,76,4726
"39025041103",7513,571,62,0,382,16,302,0,8846
"39025041200",7447,570,79,0,296,5,44,0,8441
"39025041303",4620,325,20,0,102,299,14,336,5716
"39025041304",44,0,0,0,0,0,0,0,44
"39025041305",4518,142,1,1,94,0,47,0,4803
"39025041306",3215,411,18,30,168,43,18,43,3946
"39025041307",4189,197,149,13,163,0,141,0,4852
"39025041403",3606,563,16,0,92,161,49,0,4487
"39025041404",3963,281,20,0,114,26,68,8,4480
"39025041405",4729,607,0,12,22,82,71,93,5616
"39025041406",4813,7,0,0,180,0,74,0,5074
"39025041501",5987,522,188,0,56,0,19,21,6793
"39025041502",6965,401,0,0,249,0,0,28,7643
"39025041600",3947,1083,69,0,38,0,5,19,5161
"39025041701",3664,568,26,0,103,16,140,0,4517
"39025041702",2965,386,14,0,21,12,16,12,3426
"39025041800",2961,704,0,11,57,0,30,5,3768
"39025041900",5192,456,0,0,17,0,0,0,5665
"39025042000",5545,787,11,0,110,19,62,25,6559
"39027964300",2910,922,0,0,27,16,21,0,3896
"39027964400",4771,337,14,0,34,6,151,0,5313
"39027964500",5060,812,204,159,102,103,48,11,6499
"39027964600",1448,589,198,125,36,121,28,110,2655
"39027964700",3542,808,98,65,25,76,0,159,4773
"39027964800",4582,479,11,0,44,10,5,0,5131
"39027964900",3800,860,0,0,209,34,0,0,4903
"39027965000",3365,482,49,0,88,0,28,0,4012
"39027965100",3325,627,10,0,70,94,16,0,4142
"39029950100",4484,876,6,0,65,18,12,7,5468
"39029950200",4126,326,0,0,21,0,67,0,4540
"39029950300",4353,777,7,0,36,0,63,0,5236
"39029950400",3873,403,10,0,46,6,15,6,4359
"39029950500",4911,949,37,0,37,0,87,0,6021
"39029950600",3811,1026,15,0,78,0,39,0,4969
"39029950700",3570,1511,0,2,202,31,76,2,5394
"39029950800",3653,685,0,0,30,0,13,0,4381
"39029950900",3601,217,22,18,52,0,6,0,3916
"39029951000",4200,1230,89,0,86,9,41,19,5674
"39029951100",3577,735,10,0,28,2,41,0,4393
"39029951200",4020,735,0,0,92,63,25,0,4935
"39029951300",3260,221,0,0,43,0,13,0,3537
"39029951400",4424,802,13,7,32,0,6,64,5348
"39029951500",3714,609,18,78,207,18,41,95,4780
"39029951600",5154,418,0,1,104,16,0,0,5693
"39029951700",4197,582,26,0,49,0,22,0,4876
"39029951800",2007,993,42,51,97,122,0,70,3382
"39029951900",2852,666,99,76,10,11,0,0,3714
"39029952000",2146,424,32,15,29,7,0,0,2653
"39029952100",713,332,75,2,34,3,0,0,1159
"39029952200",1307,688,95,37,79,36,3,27,2272
"39029952300",1774,894,117,142,50,110,56,0,3143
"39029952400",3425,261,39,50,102,40,0,0,3917
"39031960900",4061,457,0,0,10,5,0,0,4533
"39031961000",3754,822,98,0,45,7,41,0,4767
"39031961100",3535,489,38,0,35,12,38,0,4147
"39031961200",2480,340,0,0,116,0,14,0,2950
"39031961300",2912,885,76,0,63,80,106,0,4122
"39031961400",2372,843,0,34,20,17,0,0,3286
"39031961500",1478,643,109,2,134,68,0,0,2434
"39031961600",2221,292,42,4,47,0,12,0,2618
"39031961700",2353,300,0,0,34,0,40,0,2727
"39031961800",4167,843,3,0,38,14,38,14,5117
"39033974100",3307,184,0,1,71,6,27,5,3601
"39033974200",3894,348,0,0,24,0,32,0,4298
"39033974300",2111,457,4,0,76,0,62,3,2713
"39033974400",2708,758,6,0,77,6,15,0,3570
"39033974500",2906,822,4,36,97,65,5,0,3935
"39033974600",2024,415,68,0,0,8,72,99,2686
"39033974700",3673,252,64,0,20,9,36,0,4054
"39033974800",1444,501,3,0,9,94,7,0,2058
"39033974900",2620,642,56,36,62,0,9,0,3425
"39033975000",3107,444,0,0,24,67,30,92,3764
"39033975100",2113,804,0,58,115,22,11,0,3123
"39033975200",2211,255,0,0,0,0,37,0,2503
"39033975300",2653,732,0,0,18,36,8,0,3447
"39035101101",272,368,294,477,24,107,67,143,1752
"39035101102",3228,378,631,105,96,101,85,69,4693
"39035101200",1135,690,351,311,123,96,187,273,3166
"39035101300",450,338,161,337,97,44,35,91,1553
"39035101400",808,300,269,161,176,59,60,135,1968
"39035101501",820,420,316,253,149,359,245,388,2950
"39035101603",728,509,223,384,119,70,304,370,2707
"39035101700",856,383,576,402,179,240,599,203,3438
"39035101800",839,436,150,376,55,97,164,233,2350
"39035101901",690,330,245,149,36,85,136,248,1919
"39035102101",1098,596,574,751,291,26,514,118,3968
"39035102102",1559,316,351,158,247,13,333,185,3162
"39035102200",1826,168,321,135,424,65,465,96,3500
"39035102300",811,613,478,71,140,180,229,376,2898
"39035102401",1105,437,241,304,90,182,550,241,3150
"39035102402",1213,729,580,308,349,213,714,253,4359
"39035102700",1183,1463,464,672,150,213,456,596,5197
"39035102800",471,674,87,113,361,13,483,406,2608
"39035102900",1065,435,195,105,138,117,686,363,3104
"39035103100",613,357,78,60,63,5,122,170,1468
"39035103300",522,80,315,1057,33,51,46,74,2178
"39035103400",942,547,174,222,282,180,298,337,2982
"39035103500",979,622,144,258,184,157,272,564,3180
"39035103602",1554,510,231,568,154,129,78,65,3289
"39035103800",1012,277,188,48,84,94,148,130,1981
"39035103900",508,370,136,502,88,167,270,394,2435
"39035104100",393,418,38,49,84,27,186,254,1449
"39035104200",536,205,138,174,33,42,30,83,1241
"39035104300",1142,352,107,79,39,15,33,90,1857
"39035104400",863,406,47,78,19,22,78,36,1549
"39035104600",323,305,276,154,150,91,155,280,1734
"39035104800",787,280,180,366,92,428,316,666,3115
"39035104900",819,305,260,218,273,270,484,397,3026
"39035105100",1670,893,247,255,52,135,586,351,4189
"39035105300",1012,754,224,501,369,255,797,604,4516
"39035105400",1610,721,513,201,321,136,687,403,4592
"39035105500",582,660,125,227,133,91,241,381,2440
"39035105602",914,645,227,289,128,230,363,285,3081
"39035105700",2286,702,568,481,681,27,747,12,5504
"39035105900",1918,789,54,52,49,149,121,275,3407
"39035106100",2501,357,393,78,389,18,646,104,4486
"39035106200",2421,407,166,116,339,205,333,106,4093
"39035106300",1629,445,191,186,270,121,383,96,3321
"39035106400",761,62,27,0,84,31,55,29,1049
"39035106500",2119,371,91,12,232,0,442,0,3267
"39035106600",2350,779,0,19,172,109,259,119,3807
"39035106800",1769,542,185,241,181,35,467,173,3593
"39035106900",2958,265,150,94,131,184,198,241,4221
"39035107000",1346,34,30,2,126,0,144,21,1703
"39035107101",1732,252,236,179,60,21,100,20,2600
"39035107701",749,359,185,303,146,73,18,4,1837
"39035107802",626,487,313,891,614,111,43,11,3096
"39035108201",605,292,153,86,121,112,65,17,1451
"39035108301",332,98,141,207,408,140,61,0,1387
"39035108400",249,251,97,209,277,101,132,215,1531
"39035108701",154,89,920,2635,32,19,40,60,3949
"39035109301",5,83,491,821,6,56,0,80,1542
"39035109701",11,15,589,1001,0,16,0,0,1632
"39035109801",0,15,313,1626,25,29,0,15,2023
"39035110501",167,80,229,70,24,14,11,19,614
"39035110801",433,218,314,206,0,85,130,147,1533
"39035110901",707,682,459,786,178,121,37,53,3023
"39035111202",216,67,403,536,189,30,121,16,1578
"39035111401",35,0,623,575,69,0,0,0,1302
"39035111500",143,197,265,357,23,17,3,21,1026
"39035111600",65,36,404,701,75,30,22,12,1345
"39035111700",90,11,542,729,0,5,26,8,1411
"39035111800",23,4,585,184,11,0,14,0,821
"39035111902",22,9,469,148,6,0,0,0,654
"39035112100",4,6,571,963,0,12,26,0,1582
"39035112200",11,5,783,731,10,8,10,18,1576
"39035112301",0,0,530,686,3,0,0,0,1219
"39035112400",10,13,888,235,11,0,13,0,1170
"39035112500",19,0,1030,250,28,0,0,0,1327
"39035112600",50,0,415,415,21,0,10,0,911
"39035112800",58,26,622,276,159,34,0,0,1175
"39035113101",13,11,395,392,0,0,0,0,811
"39035113500",0,0,671,559,0,13,0,0,1243
"39035113600",0,2,510,411,17,0,0,0,940
"39035113801",12,84,573,1019,16,41,0,45,1790
"39035114100",0,2,656,509,0,0,32,0,1199
"39035114300",0,49,208,1333,0,6,0,101,1697
"39035114501",27,111,620,543,2,0,0,1,1304
"39035114600",341,69,269,350,0,14,9,0,1052
"39035114700",0,112,156,315,0,0,0,149,732
"39035114900",289,398,353,642,0,21,31,134,1868
"39035115100",369,215,194,356,12,29,5,12,1192
"39035115200",143,133,146,174,18,70,0,114,798
"39035115300",127,182,312,324,0,83,0,0,1028
"39035115400",500,271,378,298,54,47,54,0,1602
"39035115700",319,380,175,398,109,43,9,38,1471
"39035115800",854,480,657,872,18,0,195,0,3076
"39035115900",1560,280,993,499,46,24,96,16,3514
"39035116100",0,7,635,505,0,0,0,4,1151
"39035116200",9,0,434,493,7,0,0,0,943
"39035116300",38,0,1408,498,10,0,0,0,1954
"39035116400",9,2,1546,1330,14,30,0,33,2964
"39035116500",0,0,1441,716,25,0,2,0,2184
"39035116600",1,3,1621,940,7,59,0,28,2659
"39035116700",18,0,1144,486,0,0,29,0,1677
"39035116800",0,3,1730,998,7,22,0,0,2760
"39035116900",5,30,802,366,23,79,0,0,1305
"39035117101",548,40,1402,1163,157,0,35,23,3368
"39035117102",29,7,1006,278,0,0,0,0,1320
"39035117201",409,132,732,1602,0,58,0,0,2933
"39035117202",239,67,1111,466,0,26,1,57,1967
"39035117300",101,66,965,1253,25,60,25,71,2566
"39035117400",199,43,630,521,35,12,0,0,1440
"39035117500",163,39,1673,915,76,0,0,0,2866
"39035117600",746,128,1656,745,147,0,95,5,3522
"39035117700",2003,359,1865,308,167,26,0,0,4728
"39035117800",302,206,984,783,18,3,0,0,2296
"39035117900",99,18,1507,842,20,34,0,4,2524
"39035118101",40,0,1043,764,88,0,7,0,1942
"39035118200",9,0,955,1001,13,41,9,0,2028
"39035118301",169,7,1334,1114,17,0,39,0,2680
"39035118400",4,2,1124,403,3,79,0,0,1615
"39035118500",0,22,445,153,12,4,0,0,636
"39035118602",1,10,755,1668,8,26,8,0,2476
"39035118700",285,231,298,336,26,106,0,20,1302
"39035118800",801,537,155,76,446,268,58,136,2477
"39035118900",72,50,698,546,81,12,39,22,1520
"39035119100",44,6,14,0,0,6,0,0,70
"39035119202",161,6,292,294,0,13,0,0,766
"39035119300",0,87,1418,2451,0,27,55,84,4122
"39035119401",178,95,1024,321,288,34,0,0,1940
"39035119402",45,15,997,700,6,20,6,2,1791
"39035119501",731,194,1296,482,184,78,53,68,3086
"39035119502",397,102,922,373,78,0,65,11,1948
"39035119600",105,27,1466,743,3,0,59,0,2403
"39035119701",0,23,975,413,82,83,24,16,1616
"39035119702",1,0,1013,941,25,28,25,28,2061
"39035119800",0,1,1798,1978,9,24,0,1,3811
"39035119900",0,77,1116,431,48,19,10,0,1701
"39035120200",11,54,1532,902,86,38,83,40,2746
"39035120400",0,0,1493,850,30,0,12,0,2385
"39035120500",27,0,1355,970,92,16,0,0,2460
"39035120600",9,28,1991,703,0,9,0,0,2740
"39035120701",1,7,1111,627,0,0,0,0,1746
"39035120702",5,0,1215,475,54,0,4,0,1753
"39035120801",17,0,1239,546,29,0,67,7,1905
"39035120802",63,7,1260,502,0,5,0,0,1837
"39035121100",0,12,1205,809,0,28,0,0,2054
"39035121200",0,10,872,805,14,6,0,0,1707
"39035121300",57,104,1557,710,19,78,11,7,2543
"39035121401",0,0,1177,741,13,85,13,5,2034
"39035121403",11,16,2021,784,1,0,0,0,2833
"39035121500",0,47,2483,778,38,0,0,83,3429
"39035121700",12,15,2967,501,45,0,43,0,3583
"39035121800",17,21,1151,511,46,19,3,0,1768
"39035121900",5,0,1043,261,12,0,12,0,1333
"39035122100",1,3,2221,736,16,0,0,1,2978
"39035122200",11,0,1437,354,5,11,34,0,1852
"39035122300",21,7,1319,676,92,28,39,8,2190
"39035123100",2129,163,24,0,140,74,14,0,2544
"39035123200",2599,451,106,11,154,11,82,8,3422
"39035123400",3335,400,70,0,63,10,121,123,4122
"39035123501",1884,559,211,276,181,109,218,64,3502
"39035123502",1941,339,176,69,251,59,462,246,3543
"39035123601",2517,269,158,29,54,0,64,43,3134
"39035123602",2387,158,122,159,93,143,81,143,3286
"39035123603",2895,135,59,89,81,1,126,28,3414
"39035123700",1903,193,95,76,211,0,102,42,2622
"39035123800",623,493,206,980,40,152,34,267,2795
"39035123900",1730,223,269,56,404,7,434,13,3136
"39035124100",2349,961,556,482,452,268,570,642,6280
"39035124201",1773,264,111,237,215,114,287,211,3212
"39035124202",957,293,97,26,66,46,86,60,1631
"39035124300",1953,255,1207,409,672,57,485,249,5287
"39035124500",2315,526,332,42,383,124,324,77,4123
"39035124600",2161,962,324,137,170,172,554,170,4650
"39035126100",124,15,1970,600,0,0,1,0,2710
"39035127501",114,167,1798,1125,0,29,0,21,3254
"39035130103",4064,43,6,0,159,0,6,0,4278
"39035130104",3821,178,29,5,83,0,9,10,4135
"39035130105",3245,138,0,4,54,0,75,0,3516
"39035130106",3244,239,47,1,12,0,54,0,3597
"39035131102",1928,75,514,0,417,18,70,0,3022
"39035131103",3859,41,91,2,241,0,31,0,4265
"39035131104",2933,153,85,0,461,56,34,0,3722
"39035132100",1730,381,1730,311,116,204,76,0,4548
"39035132200",1346,130,1609,88,56,0,53,86,3368
"39035132301",1337,73,1599,219,121,16,10,0,3375
"39035132302",900,120,609,214,71,0,0,0,1914
"39035133103",371,185,2138,243,76,0,0,0,3013
"39035133104",462,80,1578,351,115,87,108,74,2855
"39035134100",927,95,103,36,103,48,62,8,1382
"39035134203",2679,138,140,2,174,0,68,0,3201
"39035134204",3149,709,145,19,29,35,0,0,4086
"39035134205",2262,216,133,0,86,0,152,1,2850
"39035134206",2390,314,85,34,95,73,18,0,3009
"39035134300",2268,159,261,24,0,0,141,0,2853
"39035135103",2086,17,22,0,9,9,66,0,2209
"39035135104",3992,45,57,0,39,15,23,0,4171
"39035135105",5240,191,38,31,334,0,0,0,5834
"39035135106",1212,28,0,0,0,0,0,0,1240
"39035136101",5043,368,47,0,572,71,63,0,6164
"39035136102",5831,159,438,18,562,126,165,0,7299
"39035136103",5175,519,0,2,195,0,0,2,5893
"39035137101",1639,247,140,128,198,37,169,20,2578
"39035137102",3114,681,313,13,230,100,233,171,4855
"39035137103",3063,429,96,0,558,73,443,13,4675
"39035138105",800,95,240,82,70,0,39,67,1393
"39035138106",2783,381,57,0,58,50,110,169,3608
"39035138107",1974,118,56,0,0,0,35,2,2185
"39035138108",3539,173,16,6,139,0,80,0,3953
"39035138109",3614,380,89,65,196,0,174,65,4583
"39035138110",3427,295,70,1,229,2,158,8,4190
"39035140100",169,5,877,197,46,0,2,0,1296
"39035140301",55,32,1397,729,7,36,0,0,2256
"39035140302",844,194,1139,381,105,37,0,0,2700
"39035140400",1031,93,1631,198,160,0,7,0,3120
"39035140500",994,169,1534,533,144,78,6,0,3458
"39035140600",455,38,357,105,80,72,47,72,1226
"39035140701",637,93,744,677,67,175,61,0,2454
"39035140702",707,6,817,59,94,31,0,0,1714
"39035140800",1283,623,1186,185,395,134,47,10,3863
"39035140900",656,65,1137,355,3,0,8,68,2292
"39035141000",340,86,245,610,3,0,21,56,1361
"39035141100",2131,628,239,518,522,95,35,31,4199
"39035141200",2098,292,189,14,338,79,79,0,3089
"39035141300",1544,214,95,203,64,113,43,0,2276
"39035141400",2105,14,165,154,95,24,43,0,2600
"39035141500",1191,134,224,115,46,34,19,35,1798
"39035141601",1316,26,162,0,124,0,65,0,1693
"39035141602",486,101,524,88,32,0,12,0,1243
"39035141700",1073,19,221,23,129,0,75,0,1540
"39035150100",0,0,1803,445,7,0,0,0,2255
"39035150300",17,7,767,1270,7,0,0,1,2069
"39035150400",23,0,772,682,0,26,0,14,1517
"39035151100",27,11,652,456,23,266,0,275,1710
"39035151200",57,7,747,515,53,17,0,0,1396
"39035151300",215,254,1106,412,0,8,0,0,1995
"39035151400",20,84,938,503,27,0,2,0,1574
"39035151500",6,16,619,506,6,0,1,0,1154
"39035151600",31,0,675,386,19,9,0,0,1120
"39035151700",29,67,595,536,17,39,28,49,1360
"39035151800",50,6,721,911,16,10,0,0,1714
"39035152101",1561,78,581,1,15,0,14,0,2250
"39035152102",1994,235,1495,534,135,20,23,0,4436
"39035152201",746,72,1593,576,131,0,95,0,3213
"39035152202",1813,130,1036,468,95,39,62,0,3643
"39035152301",874,51,1314,139,58,4,0,0,2440
"39035152302",2246,392,1637,376,114,0,28,0,4793
"39035152303",2020,124,1039,523,84,0,154,0,3944
"39035152400",741,202,631,240,75,0,23,0,1912
"39035152501",1588,319,1462,200,126,9,97,0,3801
"39035152502",721,132,1255,492,151,41,55,17,2864
"39035152603",213,20,604,186,40,19,0,0,1082
"39035152604",1679,173,1577,953,1,97,29,13,4522
"39035152701",82,49,1141,619,28,9,0,0,1928
"39035152702",341,22,1477,467,70,0,26,0,2403
"39035152703",579,86,903,17,13,0,46,0,1644
"39035153103",2567,89,0,22,50,0,145,0,2873
"39035153104",2553,117,64,0,139,0,131,0,3004
"39035153105",3087,485,156,11,94,49,101,0,3983
"39035153106",3299,113,0,0,82,13,85,13,3605
"39035153107",2930,412,23,10,250,45,176,17,3863
"39035154100",961,208,408,152,55,21,20,8,1833
"39035154200",744,53,316,181,9,41,15,0,1359
"39035154300",13,25,620,282,18,0,5,0,963
"39035154400",1565,125,806,411,102,0,75,8,3092
"39035154501",2245,221,679,499,99,11,59,14,3827
"39035154502",1849,19,707,213,200,0,90,0,3078
"39035154601",2940,235,928,272,129,51,127,0,4682
"39035154603",2194,226,656,137,52,0,30,0,3295
"39035154604",2549,169,826,155,237,13,93,0,4042
"39035154700",55,0,2023,457,0,0,33,0,2568
"39035155101",4512,89,12,1,468,0,181,1,5264
"39035155102",2968,116,13,7,106,0,34,56,3300
"39035156101",1162,47,28,0,39,0,59,0,1335
"39035156102",5661,156,2,0,16,12,16,1,5864
"39035160100",1762,61,90,0,11,0,50,0,1974
"39035160200",1861,138,61,12,65,0,46,0,2183
"39035160300",1659,70,71,28,33,126,75,14,2076
"39035160400",2462,474,136,1,115,23,34,8,3253
"39035160500",2761,568,63,38,27,0,96,103,3656
"39035160601",3788,362,370,53,192,83,181,52,5081
"39035160602",1749,394,224,273,256,141,201,24,3262
"39035160700",1128,514,114,7,19,29,52,36,1899
"39035160800",791,79,3,3,61,6,25,0,968
"39035160900",3042,271,139,70,111,0,26,32,3691
"39035161000",1427,226,10,0,92,30,102,27,1914
"39035161100",3034,341,51,112,158,0,171,11,3878
"39035161200",2194,364,212,93,315,6,40,0,3224
"39035161300",2014,414,183,11,227,30,74,5,2958
"39035161400",2677,544,81,98,89,8,61,8,3566
"39035161500",2915,605,372,49,46,45,86,55,4173
"39035161600",1428,475,55,59,121,20,122,20,2300
"39035161700",924,395,162,261,305,34,72,3,2156
"39035161800",460,316,69,63,153,3,14,14,1092
"39035170101",2226,0,432,29,133,0,0,0,2820
"39035170102",4433,172,270,95,117,12,109,1,5209
"39035170201",1878,116,20,6,1,0,11,0,2032
"39035170202",3472,136,114,2,43,16,6,0,3789
"39035171102",950,168,3112,772,23,77,41,40,5183
"39035171103",509,44,2436,642,135,0,49,0,3815
"39035171104",672,23,2104,1419,37,206,0,35,4496
"39035171203",1195,91,883,77,75,24,0,0,2345
"39035171204",624,149,814,413,15,0,36,83,2134
"39035171205",895,139,1511,74,145,0,40,0,2804
"39035171206",1071,15,819,122,362,0,281,0,2670
"39035172101",2182,69,138,5,98,0,102,0,2594
"39035172102",3172,300,147,55,131,11,27,10,3853
"39035172103",2476,447,902,27,912,38,213,0,5015
"39035172201",3401,147,120,54,270,23,24,0,4039
"39035172202",2847,159,457,20,199,71,0,0,3753
"39035173103",2364,282,37,1,115,9,89,9,2906
"39035173104",3466,362,21,18,101,0,77,36,4081
"39035173105",2235,83,18,0,283,0,60,0,2679
"39035173106",2233,293,15,0,975,98,57,55,3726
"39035173107",2330,58,6,0,60,0,34,0,2488
"39035174103",2501,190,157,92,90,0,117,0,3147
"39035174104",1922,315,56,0,28,0,133,0,2454
"39035174105",2769,148,25,0,224,0,137,0,3303
"39035174106",2698,107,45,0,219,9,85,0,3163
"39035174107",3589,456,12,0,72,0,0,0,4129
"39035174203",2796,23,243,0,117,0,25,0,3204
"39035174204",3285,270,14,0,212,0,91,10,3882
"39035174205",3762,180,96,0,457,15,303,22,4835
"39035174206",1461,85,10,0,181,0,97,16,1850
"39035174207",2651,409,151,1,68,8,66,8,3362
"39035175103",5721,334,120,0,349,0,173,0,6697
"39035175104",4832,408,222,0,366,9,75,20,5932
"39035175105",4559,156,0,1,299,0,21,0,5036
"39035175106",2787,104,0,0,223,0,0,0,3114
"39035175201",6018,120,31,1,260,10,172,0,6612
"39035175202",2851,129,26,16,62,0,61,0,3145
"39035176100",2018,63,1,3,5,5,18,0,2113
"39035176200",5096,209,97,17,249,0,312,14,5994
"39035177101",2688,432,268,215,196,153,239,92,4283
"39035177103",3174,633,115,26,178,109,191,126,4552
"39035177104",2899,397,5,9,56,39,86,24,3515
"39035177201",3280,406,126,23,165,39,98,32,4169
"39035177202",2884,346,159,0,84,39,229,0,3741
"39035177302",2133,140,33,0,45,0,205,0,2556
"39035177303",3840,597,21,11,100,42,99,0,4710
"39035177304",2041,670,94,60,183,75,108,164,3395
"39035177403",2698,395,0,0,150,34,200,9,3486
"39035177404",2645,186,9,6,39,18,46,16,2965
"39035177405",4017,197,0,0,123,8,162,0,4507
"39035177406",3139,458,131,1,341,10,291,54,4425
"39035177501",3622,420,9,0,82,1,215,59,4408
"39035177503",3231,170,38,9,220,0,203,0,3871
"39035177504",3634,214,62,92,75,61,51,15,4204
"39035177505",4129,111,0,28,47,0,66,0,4381
"39035177604",1826,149,14,7,31,7,62,7,2103
"39035177605",2638,201,0,13,77,0,140,0,3069
"39035177606",2938,89,40,32,197,19,218,0,3533
"39035177607",3126,411,9,1,512,0,405,8,4472
"39035177608",4289,550,400,12,57,168,47,17,5540
"39035177609",1799,114,2,14,33,0,37,0,1999
"39035178101",2169,400,0,54,265,0,92,106,3086
"39035178102",3526,487,156,224,410,0,66,0,4869
"39035178201",3189,148,28,4,201,0,185,8,3763
"39035178204",3308,863,47,0,210,27,113,13,4581
"39035178205",1771,97,0,0,41,0,0,0,1909
"39035178206",2468,150,2,2,71,0,8,0,2701
"39035179101",2458,198,227,16,102,29,111,0,3141
"39035179102",2436,40,60,0,213,9,66,0,2824
"39035180102",1815,191,1385,44,314,29,39,0,3817
"39035180103",1498,141,1397,10,488,0,23,0,3557
"39035180104",911,30,1580,252,196,27,113,1,3110
"39035181100",6264,139,0,2,129,0,45,2,6581
"39035181201",4677,460,63,31,165,19,22,93,5530
"39035181203",2751,72,69,56,35,0,47,12,3042
"39035181204",4697,189,0,14,94,8,96,0,5098
"39035182103",2389,64,0,0,60,48,0,0,2561
"39035182104",2469,105,19,0,62,0,67,0,2722
"39035182105",3070,204,0,0,87,0,9,0,3370
"39035182106",3000,57,30,0,92,0,28,0,3207
"39035183100",1652,157,502,58,536,116,0,8,3029
"39035183200",2030,31,200,0,159,1,33,0,2454
"39035183300",3427,57,370,45,321,0,122,17,4359
"39035183401",1385,35,327,91,172,45,73,46,2174
"39035183402",214,25,715,181,107,3,5,0,1250
"39035183501",1430,125,1031,34,398,12,183,8,3221
"39035183502",2268,67,920,243,233,38,43,0,3812
"39035183603",19,0,785,483,31,0,11,0,1329
"39035183604",392,126,1581,206,94,28,9,9,2445
"39035183605",1248,15,926,216,284,0,0,92,2781
"39035183606",497,22,1019,71,166,48,22,0,1845
"39035184103",3425,41,226,0,341,0,73,0,4106
"39035184104",1247,30,241,19,146,0,103,0,1786
"39035184105",3231,39,575,28,855,6,37,0,4771
"39035184106",1632,143,392,25,101,22,99,0,2414
"39035184108",5299,173,631,60,1060,221,108,0,7552
"39035185101",435,16,1731,179,147,0,0,0,2508
"39035185102",1453,71,1069,0,109,0,0,0,2702
"39035185103",1084,93,938,0,127,24,57,56,2379
"39035185104",2682,145,856,75,62,10,48,0,3878
"39035185201",383,109,960,60,32,30,20,0,1594
"39035185202",2261,60,2489,306,94,0,167,0,5377
"39035185203",2301,423,533,39,86,148,45,0,3575
"39035186103",3841,93,96,0,285,1,70,1,4387
"39035186104",2417,94,36,0,68,0,77,65,2757
"39035186105",3089,116,171,10,56,0,102,0,3544
"39035186106",3012,861,107,174,474,106,261,50,5045
"39035186107",5129,242,206,1,389,0,0,0,5967
"39035186201",4582,272,262,13,493,0,316,0,5938
"39035186202",4192,133,142,8,304,0,157,0,4936
"39035186203",3417,51,112,0,71,0,128,0,3779
"39035186205",4587,10,27,0,338,0,52,0,5014
"39035186206",3823,18,26,0,359,0,10,0,4236
"39035187103",1115,187,1366,254,63,122,49,0,3156
"39035187104",2442,64,451,26,122,10,107,0,3222
"39035187105",1476,140,154,13,129,34,193,12,2151
"39035187106",3010,184,219,8,106,0,50,0,3577
"39035188103",50,13,2589,577,70,0,8,7,3314
"39035188104",75,0,1263,392,26,0,6,0,1762
"39035188105",123,1,2432,505,80,9,0,0,3150
"39035188106",101,22,1959,383,10,0,0,0,2475
"39035188107",155,0,1733,627,37,22,5,0,2579
"39035189105",3798,105,2,8,214,34,59,1,4221
"39035189107",4108,327,0,2,336,0,39,33,4845
"39035189108",4361,115,30,2,462,0,285,2,5257
"39035189109",2649,109,285,0,122,9,54,4,3232
"39035189110",3407,117,147,0,360,0,222,0,4253
"39035189111",5089,302,148,0,772,61,147,99,6618
"39035189112",3334,113,56,13,557,0,118,0,4191
"39035190502",2085,199,0,0,16,0,0,0,2300
"39035190503",1718,27,20,2,38,7,101,4,1917
"39035190504",9197,428,320,0,304,0,268,0,10517
"39035192300",1411,58,2,1,10,12,31,0,1525
"39035192800",986,26,164,15,38,31,4,0,1264
"39035192900",1826,42,0,56,34,0,24,0,1982
"39035193800",65,4,590,195,12,6,12,0,884
"39035193900",69,32,312,183,4,8,6,6,620
"39035194100",1913,103,101,8,26,0,0,0,2151
"39035194300",2944,59,105,0,257,55,7,0,3427
"39035194500",2101,87,31,6,91,0,26,0,2342
"39035194800",144,65,567,59,82,46,30,15,1008
"39035194900",2527,22,256,85,380,35,52,0,3357
"39035195600",617,79,3299,429,384,21,81,3,4913
"39035195700",1285,461,2300,90,171,17,71,295,4690
"39035195800",2984,83,401,27,330,0,90,0,3915
"39035195900",3844,235,0,1,65,0,28,0,4173
"39035196000",491,47,1009,72,6,0,21,0,1646
"39035196100",1798,344,149,208,88,48,55,2,2692
"39035196200",244,12,1976,1414,51,7,47,0,3751
"39035196300",3460,144,32,1,265,0,189,0,4091
"39035196400",764,171,947,622,35,21,370,88,3018
"39035196500",10,12,850,757,15,0,15,0,1659
"39035980100",0,0,0,0,0,0,0,0,0
"39035980500",0,0,0,0,0,0,0,0,0
"39035981100",0,0,0,0,0,0,0,0,0
"39035990000",0,0,0,0,0,0,0,0,0
"39037500100",3579,454,2,3,6,3,17,3,4067
"39037510100",3115,724,18,2,70,17,187,52,4185
"39037520100",2446,566,0,0,8,10,43,14,3087
"39037530100",4157,208,0,0,39,0,14,0,4418
"39037540100",3036,343,0,0,46,0,74,7,3506
"39037550100",3098,226,4,0,0,0,16,0,3344
"39037555000",5029,796,10,21,130,19,19,19,6043
"39037555101",2979,445,8,111,26,55,33,39,3696
"39037555102",2916,913,15,15,107,79,17,7,4069
"39037560100",5918,1254,87,4,71,22,42,4,7402
"39037570101",2719,162,0,0,73,10,14,0,2978
"39037570102",5083,639,1,0,48,0,14,39,5824
"39039958100",3919,276,38,0,91,28,158,28,4538
"39039958200",4346,721,3,0,57,8,97,61,5293
"39039958300",3209,479,0,0,203,27,180,21,4119
"39039958400",3537,553,27,0,141,70,190,101,4619
"39039958500",2697,595,121,0,244,59,342,74,4132
"39039958600",3060,474,38,123,166,81,152,125,4219
"39039958700",3551,443,110,0,120,307,427,333,5291
"39039958800",2202,728,146,27,69,18,509,164,3863
"39039958900",4210,263,41,16,359,0,458,47,5394
"39041010100",3042,621,42,43,35,50,74,25,3932
"39041010200",4853,449,12,13,102,50,52,0,5531
"39041010420",2418,289,58,0,140,0,73,0,2978
"39041010421",2051,126,20,0,40,0,40,0,2277
"39041010422",5476,224,143,18,199,56,61,0,6177
"39041010520",4547,138,151,0,205,10,251,0,5302
"39041010530",1593,649,134,148,280,48,48,0,2900
"39041011101",2448,551,0,0,33,2,8,16,3058
"39041011102",4703,198,85,18,146,0,115,0,5265
"39041011200",2772,137,54,0,35,0,20,0,3018
"39041011411",2559,23,70,0,227,14,40,0,2933
"39041011412",4142,36,17,0,382,25,109,0,4711
"39041011413",5836,184,179,2,453,22,54,0,6730
"39041011421",5791,36,285,8,559,0,59,12,6750
"39041011423",6160,31,112,0,349,46,0,0,6698
"39041011430",2370,87,117,0,107,0,118,0,2799
"39041011520",2935,60,106,45,282,21,185,0,3634
"39041011530",2883,201,60,23,484,62,188,0,3901
"39041011540",4663,29,230,0,661,0,105,0,5688
"39041011550",6060,811,731,3,1305,0,207,333,9450
"39041011560",6952,21,274,6,541,0,106,0,7900
"39041011561",3455,244,358,95,520,12,201,0,4885
"39041011604",5146,135,137,0,200,5,188,24,5835
"39041011710",5136,192,407,0,438,0,49,0,6222
"39041011730",5939,43,366,0,520,0,329,0,7197
"39041011740",4893,41,266,0,278,12,80,11,5581
"39041011750",5837,47,164,0,215,0,71,0,6334
"39041011760",3905,533,28,0,16,0,67,27,4576
"39041011762",4853,90,162,0,301,0,68,0,5474
"39041011900",4094,180,132,0,573,0,66,0,5045
"39041012000",4724,246,0,0,23,0,98,29,5120
"39041012100",5826,184,134,0,703,80,46,0,6973
"39041012200",4264,181,33,0,147,0,0,5,4630
"39041012300",3417,411,146,0,144,0,39,22,4179
"39041012400",3836,114,331,0,648,91,82,104,5206
"39043040100",5264,350,21,0,57,38,127,48,5905
"39043040200",3475,258,0,0,94,0,39,0,3866
"39043040300",5377,438,0,22,140,113,41,45,6176
"39043040400",4572,380,19,0,77,18,122,0,5188
"39043040500",4302,591,91,0,55,81,166,0,5286
"39043040600",823,45,17,11,33,0,16,0,945
"39043040700",2351,728,487,336,151,185,201,26,4465
"39043040800",1804,734,423,420,377,131,73,86,4048
"39043040900",2495,404,60,312,72,27,56,59,3485
"39043041000",1575,238,681,228,59,99,128,110,3118
"39043041100",2278,535,567,95,345,32,118,88,4058
"39043041200",1421,174,546,160,103,47,151,30,2632
"39043041300",2125,503,576,382,40,152,56,182,4016
"39043041400",1739,156,234,28,55,163,27,14,2416
"39043041500",3166,56,69,6,78,6,43,6,3430
"39043041600",4773,273,174,30,303,0,195,13,5761
"39043041700",5592,684,0,0,134,25,230,121,6786
"39043041800",5697,331,36,1,173,8,81,0,6327
"39043990100",0,0,0,0,0,0,0,0,0
"39045030100",3322,506,0,0,6,8,17,0,3859
"39045030200",2430,368,0,0,115,55,12,0,2980
"39045030300",2455,708,0,0,31,22,0,90,3306
"39045030400",4433,229,11,0,35,12,57,12,4789
"39045030600",7300,270,1618,63,528,53,60,0,9892
"39045030700",2709,110,95,0,67,7,0,7,2995
"39045030800",5206,199,1,6,81,9,52,2,5556
"39045030900",7519,234,26,0,227,6,60,0,8072
"39045031000",4953,470,2,0,34,11,3,0,5473
"39045031100",5082,844,24,0,3,18,37,10,6018
"39045031200",3861,646,9,144,78,41,15,73,4867
"39045031300",2213,647,0,13,14,0,0,0,2887
"39045031400",5373,992,77,14,163,79,79,31,6808
"39045031500",2064,417,0,144,16,10,125,7,2783
"39045031600",4393,1010,58,0,51,88,45,11,5656
"39045031700",2561,1431,20,0,15,30,0,0,4057
"39045032000",2055,881,0,33,12,15,33,0,3029
"39045032100",3167,338,17,11,39,0,46,0,3618
"39045032200",2790,1065,9,0,53,36,36,0,3989
"39045032300",3260,832,0,0,108,0,0,0,4200
"39045032500",4277,636,0,1,108,11,84,0,5117
"39045032600",6013,682,9,0,58,2,28,36,6828
"39045032701",2329,195,985,206,448,11,42,0,4216
"39045032702",3210,313,1582,463,1165,146,899,32,7810
"39045032800",3746,46,241,0,164,0,160,0,4357
"39045032900",8361,269,758,0,787,0,46,0,10221
"39045033000",3273,297,326,0,157,180,38,32,4303
"39045033100",7102,381,782,131,451,1,200,0,9048
"39047925800",3098,468,5,9,28,154,37,170,3969
"39047925900",2646,809,39,0,248,15,61,22,3840
"39047926000",2986,637,0,45,93,16,28,0,3805
"39047926100",2983,1483,117,31,44,21,38,0,4717
"39047926200",3283,933,200,0,172,35,73,29,4725
"39047926300",2724,474,53,0,106,20,42,17,3436
"39047926400",3693,528,9,0,74,8,0,0,4312
"39049000110",3173,278,26,0,162,20,50,0,3709
"39049000120",2748,213,19,19,173,0,75,0,3247
"39049000210",2938,173,42,2,103,18,118,30,3424
"39049000220",3728,102,19,0,89,0,24,0,3962
"39049000310",1740,217,598,226,139,101,50,0,3071
"39049000320",1560,127,487,10,105,14,11,9,2323
"39049000330",920,822,153,256,155,0,38,0,2344
"39049000410",2070,111,147,6,156,0,36,0,2526
"39049000420",2901,131,19,1,134,30,54,0,3270
"39049000500",3336,454,94,44,296,208,47,16,4495
"39049000600",2498,729,113,11,585,107,145,6,4194
"39049000710",1371,682,270,690,84,73,94,0,3264
"39049000720",540,408,886,780,135,96,15,5,2865
"39049000730",74,92,1588,1382,39,40,77,33,3325
"39049000810",1339,273,449,233,191,8,176,0,2669
"39049000820",945,419,690,310,127,125,7,113,2736
"39049000910",532,252,1326,1500,101,39,11,40,3801
"39049000920",294,115,501,681,76,59,7,0,1733
"39049001000",2063,1780,47,153,184,313,102,11,4653
"39049001110",679,1260,0,47,114,430,45,42,2617
"39049001121",13,218,0,0,4,0,8,0,243
"39049001122",374,377,6,101,267,218,13,31,1387
"39049001200",758,2967,46,108,37,192,60,51,4219
"39049001300",673,3395,72,164,112,358,65,206,5045
"39049001400",114,119,509,788,131,9,0,15,1685
"39049001500",13,37,405,1136,63,28,9,0,1691
"39049001600",233,227,110,371,26,58,13,16,1054
"39049001700",537,425,118,461,194,303,161,166,2365
"39049001810",623,1987,15,87,278,326,51,41,3408
"39049001820",1639,460,174,96,128,51,18,19,2585
"39049001901",1663,336,132,9,73,27,78,0,2318
"39049001902",2524,415,14,58,200,129,93,48,3481
"39049002000",2527,462,64,17,224,0,138,0,3432
"39049002100",1292,176,46,4,189,9,40,0,1756
"39049002200",1209,426,74,91,95,0,75,19,1989
"39049002300",162,73,481,660,12,31,6,13,1438
"39049002510",358,267,1630,649,106,42,72,144,3268
"39049002520",284,85,1417,419,64,66,0,0,2335
"39049002600",963,628,1060,923,248,185,573,418,4998
"39049002710",142,110,663,663,245,205,197,235,2460
"39049002730",310,29,619,810,114,180,103,103,2268
"39049002740",1850,232,435,45,40,0,9,0,2611
"39049002750",677,239,714,728,37,0,196,28,2619
"39049002760",1534,290,650,708,100,161,10,138,3591
"39049002770",503,85,675,593,141,120,69,81,2267
"39049002780",1206,118,647,65,133,0,62,0,2231
"39049002800",226,139,1005,822,115,48,8,4,2367
"39049002900",74,163,541,1302,6,246,36,125,2493
"39049003000",1483,351,179,408,145,31,45,13,2655
"39049003200",1479,314,77,0,270,17,126,0,2283
"39049003600",206,55,711,261,60,30,95,1,1419
"39049003700",477,281,1318,818,256,46,6,0,3202
"39049003800",719,127,626,491,26,27,0,0,2016
"39049004000",1470,468,245,275,191,58,47,0,2754
"39049004200",131,170,20,416,0,67,0,0,804
"39049004300",3179,1742,326,198,217,135,40,142,5979
"39049004500",2716,1156,309,283,226,74,211,71,5046
"39049004610",2113,441,304,8,188,66,196,73,3389
"39049004620",967,650,236,263,144,169,6,0,2435
"39049004700",1076,1594,1127,361,155,306,182,256,5057
"39049004810",1930,839,209,155,63,26,50,36,3308
"39049004820",1345,692,174,234,83,66,93,103,2790
"39049004900",2067,1295,991,427,0,430,88,139,5437
"39049005000",1607,1612,427,536,92,176,26,54,4530
"39049005100",464,428,45,779,10,130,8,54,1918
"39049005200",2166,128,195,11,133,9,34,0,2676
"39049005300",476,180,1127,715,117,75,91,0,2781
"39049005410",98,31,435,682,13,45,44,0,1348
"39049005420",131,81,920,1192,55,37,0,0,2416
"39049005500",297,100,2182,1509,146,244,90,169,4737
"39049005610",256,175,667,536,47,59,12,0,1752
"39049005620",950,805,691,252,53,203,27,51,3032
"39049005700",2771,223,96,0,105,59,42,0,3296
"39049005810",2258,410,124,0,56,10,27,64,2949
"39049005820",1493,463,74,14,128,8,51,0,2231
"39049005900",414,107,1264,700,54,60,34,9,2642
"39049006000",866,373,260,329,9,215,10,0,2062
"39049006100",1063,1043,269,184,181,110,119,171,3140
"39049006220",5963,269,244,0,889,0,478,28,7871
"39049006230",9299,589,322,59,3998,74,194,0,14535
"39049006236",5354,244,43,0,396,0,330,12,6379
"39049006310",4228,122,7,0,273,0,138,11,4779
"39049006321",3768,116,13,0,370,4,121,0,4392
"39049006323",2800,322,0,9,242,55,93,0,3521
"39049006330",4393,379,26,20,227,19,181,0,5245
"39049006340",2587,85,15,0,223,52,21,0,2983
"39049006351",2828,290,116,10,332,104,107,0,3787
"39049006352",1398,606,253,23,364,194,141,152,3131
"39049006353",2958,534,186,0,429,0,63,0,4170
"39049006371",4988,555,295,1,792,139,130,0,6900
"39049006372",3348,1097,1026,40,1078,39,484,247,7359
"39049006383",6845,761,528,10,762,89,780,119,9894
"39049006384",5924,111,287,0,796,11,418,0,7547
"39049006386",3208,150,41,29,655,142,596,88,4909
"39049006387",4585,200,196,0,569,338,138,284,6310
"39049006391",4054,62,200,0,345,0,81,0,4742
"39049006392",3726,14,144,0,395,0,16,0,4295
"39049006393",4172,39,184,162,774,145,37,46,5559
"39049006394",2174,110,325,63,209,0,0,19,2900
"39049006395",2389,250,89,0,697,184,91,0,3700
"39049006396",3432,311,228,31,470,276,243,0,4991
"39049006410",2353,100,48,40,197,31,64,52,2885
"39049006430",3781,118,46,0,566,0,253,0,4764
"39049006500",3525,53,0,0,83,0,0,0,3661
"39049006600",3202,312,32,0,161,0,35,0,3742
"39049006710",2464,142,61,11,163,0,56,0,2897
"39049006721",3151,5,0,1,146,8,45,8,3364
"39049006722",2361,208,41,0,106,36,47,0,2799
"39049006810",1962,32,0,0,34,0,41,0,2069
"39049006821",2005,670,300,179,193,61,218,18,3644
"39049006822",1817,96,16,1,73,0,31,0,2034
"39049006910",1408,22,3,0,152,0,0,0,1585
"39049006921",2284,373,628,289,279,118,406,204,4581
"39049006923",1731,359,873,248,106,36,70,53,3476
"39049006924",1819,375,820,187,116,96,19,146,3578
"39049006931",1851,617,1898,1621,806,182,168,389,7532
"39049006932",2169,484,1971,479,524,64,256,77,6024
"39049006933",984,374,1791,1169,207,57,169,199,4950
"39049006942",539,41,367,167,164,30,108,17,1433
"39049006943",2346,336,1108,517,279,19,125,29,4759
"39049006944",2876,123,605,114,360,39,257,10,4384
"39049006945",1615,712,1885,873,321,349,384,582,6721
"39049006950",2410,65,56,1,108,0,0,0,2640
"39049006990",4287,131,1103,163,451,132,246,99,6612
"39049007010",1612,332,115,236,96,0,147,10,2548
"39049007020",5082,332,102,0,353,144,95,22,6130
"39049007041",1675,37,85,0,174,0,43,0,2014
"39049007043",3110,69,264,162,465,44,633,189,4936
"39049007044",4209,90,524,0,1298,43,221,0,6385
"39049007047",2539,136,313,141,502,14,176,25,3846
"39049007048",4128,107,507,109,961,61,175,0,6048
"39049007112",3130,402,1669,422,347,11,135,18,6134
"39049007113",1942,224,1258,336,422,54,197,0,4433
"39049007114",2747,330,1103,349,278,57,22,9,4895
"39049007115",1884,410,1314,687,321,2,210,0,4828
"39049007120",3510,312,739,39,467,88,64,0,5219
"39049007132",5740,134,1162,63,766,44,532,69,8510
"39049007193",5554,69,356,0,281,0,64,0,6324
"39049007194",5113,481,123,135,477,16,24,29,6398
"39049007198",2140,184,327,20,154,0,68,0,2893
"39049007199",3380,155,966,97,390,59,112,59,5218
"39049007201",542,49,0,0,35,0,0,0,626
"39049007202",1822,147,852,108,198,70,21,0,3218
"39049007203",2258,132,148,0,826,0,59,0,3423
"39049007205",3036,68,132,0,433,0,44,0,3713
"39049007207",2986,85,251,79,422,25,109,0,3957
"39049007209",4209,228,521,365,761,0,76,0,6160
"39049007210",7287,156,87,0,850,0,119,0,8499
"39049007393",7184,261,944,0,361,26,22,0,8798
"39049007394",2258,24,183,0,287,0,86,0,2838
"39049007395",7885,280,3451,542,700,0,358,0,13216
"39049007396",6111,287,1395,1343,648,92,319,13,10208
"39049007424",3986,284,640,65,229,43,123,0,5370
"39049007425",2182,195,129,6,119,0,23,0,2654
"39049007426",2077,336,105,48,19,0,32,0,2617
"39049007427",4325,273,914,181,287,37,83,0,6100
"39049007492",4863,130,683,0,499,0,91,0,6266
"39049007494",3151,171,626,23,299,0,111,0,4381
"39049007511",61,40,949,550,22,23,9,15,1669
"39049007512",278,13,2574,844,89,0,7,0,3805
"39049007520",339,162,1214,1145,305,33,0,16,3214
"39049007531",612,164,795,506,223,102,264,42,2708
"39049007532",275,144,863,609,101,25,262,76,2355
"39049007533",141,209,964,157,126,66,86,150,1899
"39049007534",200,215,1405,1143,62,122,0,178,3325
"39049007550",317,115,1407,443,258,24,55,8,2627
"39049007551",1240,68,4154,2868,578,23,461,0,9392
"39049007710",1646,386,1225,561,160,32,139,150,4299
"39049007721",1548,404,1038,695,479,534,297,34,5029
"39049007722",1424,597,423,202,100,176,45,0,2967
"39049007730",1556,318,907,43,94,33,56,0,3007
"39049007740",1229,116,302,67,43,0,32,0,1789
"39049007811",2818,562,83,34,98,97,43,36,3771
"39049007812",2792,1011,169,98,126,62,106,30,4394
"39049007820",1050,795,165,46,950,442,19,110,3577
"39049007830",1316,512,82,15,277,180,31,64,2477
"39049007921",6922,451,210,327,679,0,73,0,8662
"39049007922",3887,85,80,0,357,12,48,0,4469
"39049007931",3977,113,14,155,314,0,231,0,4804
"39049007933",7025,348,170,0,771,0,473,0,8787
"39049007941",1885,51,227,26,355,62,12,0,2618
"39049007951",7760,426,251,0,803,148,110,0,9498
"39049007952",6854,264,182,47,318,0,131,0,7796
"39049007953",5036,666,99,215,649,286,105,15,7071
"39049007954",4970,1176,486,509,886,275,715,511,9528
"39049008000",4630,183,45,7,264,18,76,0,5223
"39049008110",2465,738,497,18,270,9,334,169,4500
"39049008120",2719,516,303,19,182,46,963,182,4930
"39049008132",4658,754,568,171,640,105,774,83,7753
"39049008141",6280,650,269,159,1094,44,632,152,9280
"39049008142",4505,650,245,49,985,79,521,0,7034
"39049008161",5108,842,748,426,328,44,627,195,8318
"39049008162",6213,856,211,230,1002,147,988,646,10293
"39049008163",2470,1230,75,15,72,45,498,725,5130
"39049008164",2438,590,175,0,96,162,497,344,4302
"39049008210",842,670,297,25,132,81,34,412,2493
"39049008230",566,413,386,66,194,88,519,201,2433
"39049008241",1181,554,211,187,54,209,98,368,2862
"39049008242",3949,404,275,0,945,177,185,179,6114
"39049008311",2386,450,281,1465,421,114,570,312,5999
"39049008312",1986,579,359,1027,88,279,197,384,4899
"39049008321",1493,406,226,129,395,111,224,60,3044
"39049008322",2386,906,180,32,259,55,150,43,4011
"39049008330",1132,384,0,0,35,0,0,13,1564
"39049008340",3935,935,440,201,455,76,57,0,6099
"39049008350",3352,1202,473,1980,367,161,892,374,8801
"39049008360",4636,369,272,117,613,36,96,0,6139
"39049008370",5744,1122,167,69,515,14,33,30,7694
"39049008380",3248,321,270,10,193,52,243,44,4381
"39049008400",2654,97,63,29,110,12,10,0,2975
"39049008500",4075,369,29,10,119,0,161,0,4763
"39049008710",478,144,1589,536,323,0,0,12,3082
"39049008720",874,142,1099,245,454,190,269,202,3475
"39049008730",232,117,412,450,119,215,106,204,1855
"39049008811",950,603,294,0,79,0,9,37,1972
"39049008812",694,72,1606,457,44,7,58,0,2938
"39049008813",248,73,1248,756,141,0,3,0,2469
"39049008821",1834,592,56,0,112,31,9,9,2643
"39049008822",2466,656,594,315,145,153,111,46,4486
"39049008825",4986,763,523,204,142,27,17,0,6662
"39049008900",3171,655,233,0,96,12,51,0,4218
"39049009000",2619,119,169,1,75,7,9,0,2999
"39049009100",4214,242,162,12,243,6,184,0,5063
"39049009210",1122,424,1578,491,437,296,330,60,4738
"39049009220",1315,279,61,137,145,67,203,0,2207
"39049009230",2385,554,856,510,396,119,587,146,5553
"39049009240",1298,263,135,52,117,75,99,93,2132
"39049009250",1060,290,303,221,127,0,148,20,2169
"39049009311",829,91,1298,147,333,42,62,30,2832
"39049009312",931,139,1041,587,220,14,213,0,3145
"39049009321",527,63,811,134,431,236,178,234,2614
"39049009322",1058,117,1396,433,342,211,267,203,4027
"39049009323",572,91,1417,483,403,269,383,62,3680
"39049009325",540,614,1643,1054,11,0,157,454,4473
"39049009326",299,199,1124,176,17,30,77,155,2077
"39049009331",289,17,332,301,30,49,11,50,1079
"39049009332",366,117,1797,439,180,14,51,0,2964
"39049009333",427,147,1028,322,250,127,25,87,2413
"39049009334",436,70,1742,547,106,117,54,0,3072
"39049009336",784,331,1108,493,155,164,24,77,3136
"39049009337",447,32,2128,1168,63,39,92,0,3969
"39049009340",1259,215,781,286,174,13,361,0,3089
"39049009350",896,173,1075,176,269,125,91,179,2984
"39049009361",2604,98,2335,232,296,21,243,21,5850
"39049009362",4943,263,1042,417,160,0,172,0,6997
"39049009371",1436,268,2890,518,316,55,61,27,5571
"39049009372",1308,127,1872,686,419,30,133,0,4575
"39049009373",1409,158,2474,1708,606,137,243,72,6807
"39049009374",3297,712,3009,737,720,36,27,138,8676
"39049009381",3147,258,1254,508,271,0,184,0,5622
"39049009382",1777,446,109,78,135,217,0,136,2898
"39049009383",1286,204,259,200,239,0,0,3,2191
"39049009384",1338,260,384,48,145,0,49,138,2362
"39049009385",2526,137,568,126,128,22,58,0,3565
"39049009386",1014,496,760,617,86,38,252,76,3339
"39049009390",3602,380,1096,0,453,0,59,48,5638
"39049009410",1672,387,438,369,50,0,18,17,2951
"39049009420",3797,258,990,112,357,15,56,25,5610
"39049009430",3682,368,2055,451,495,175,246,21,7493
"39049009440",3116,402,661,11,211,93,52,0,4546
"39049009450",7286,222,1057,2,809,1,34,0,9411
"39049009495",2468,318,775,281,361,25,194,24,4446
"39049009497",1531,69,1,1,27,0,13,6,1648
"39049009520",3279,401,323,121,38,31,15,0,4208
"39049009590",4026,644,367,0,89,17,4,0,5147
"39049009600",2882,421,432,379,77,46,86,39,4362
"39049009711",3360,471,25,1,182,72,109,0,4220
"39049009712",2250,233,6,1,35,0,14,0,2539
"39049009720",4937,955,89,75,169,235,121,243,6824
"39049009740",12766,321,75,41,735,50,120,0,14108
"39049009751",4987,185,22,24,33,13,0,0,5264
"39049009752",4767,401,454,60,239,0,124,0,6045
"39049009800",5877,785,82,8,92,24,0,140,7008
"39049009900",388,74,379,307,216,102,180,98,1744
"39049010000",3987,270,586,46,461,5,122,0,5477
"39049010100",300,56,575,0,114,0,0,0,1045
"39049010200",8774,473,4016,1544,994,204,580,31,16616
"39049010300",1380,704,660,101,75,82,151,56,3209
"39049010400",5418,210,76,15,1452,82,184,0,7437
"39049010500",6419,111,344,0,962,17,176,0,8029
"39049010601",4095,42,72,0,536,0,46,0,4791
"39049010602",5658,290,61,0,531,19,19,63,6641
"39049010700",1067,172,112,39,12,17,78,0,1497
"39049980000",0,0,0,0,0,0,0,0,0
"39051040100",2694,239,6,8,88,60,61,39,3195
"39051040200",4102,282,24,6,17,5,149,0,4585
"39051040300",4222,536,0,0,111,0,55,5,4929
"39051040400",2953,408,38,6,191,0,311,57,3964
"39051040500",4914,214,0,0,38,16,211,10,5403
"39051040600",3916,556,0,25,53,0,336,6,4892
"39051040700",5786,841,7,11,142,411,788,341,8327
"39051040800",4119,539,19,4,135,38,207,60,5121
"39051040900",3443,441,0,41,354,114,498,234,5125
"39053953500",3980,594,160,56,60,0,83,0,4933
"39053953600",3485,851,10,0,47,8,38,13,4452
"39053953700",2874,735,14,46,119,16,106,0,3910
"39053953800",3241,570,0,0,65,10,0,0,3886
"39053953900",5831,1001,75,43,125,83,15,0,7173
"39053954000",2669,639,154,16,85,6,0,33,3602
"39053954100",1473,615,77,17,163,6,8,0,2359
"39055310100",2052,157,0,0,0,0,0,0,2209
"39055310200",1864,86,0,0,42,6,107,0,2105
"39055310600",6082,118,0,0,55,0,0,0,6255
"39055310700",3570,346,0,0,93,0,45,0,4054
"39055310800",6127,221,44,0,134,0,37,0,6563
"39055310900",2815,293,32,7,30,0,1,24,3202
"39055311000",3208,261,30,0,66,0,0,0,3565
"39055311300",3826,464,0,0,38,6,28,18,4380
"39055311400",4757,630,40,1,36,35,20,0,5519
"39055311500",4963,271,0,0,124,13,41,0,5412
"39055311600",3757,34,0,0,41,0,20,0,3852
"39055311700",3544,184,356,69,108,0,135,0,4396
"39055311800",6323,275,303,4,227,0,81,0,7213
"39055311900",5954,399,0,1,101,0,92,0,6547
"39055312000",2285,458,0,6,0,44,3,27,2823
"39055312100",3502,596,0,0,44,0,34,0,4176
"39055312201",4820,351,0,48,194,58,129,0,5600
"39055312202",3897,92,0,13,179,0,30,0,4211
"39055312203",4159,452,0,0,15,0,70,0,4696
"39055312300",3700,525,0,24,67,12,63,7,4398
"39055312400",1713,934,10,0,27,0,17,40,2741
"39057200101",1599,453,151,79,55,34,33,17,2421
"39057200103",1897,661,322,637,378,32,226,20,4173
"39057200104",1333,1623,365,362,316,106,20,54,4179
"39057200300",2772,790,33,34,97,42,0,2,3770
"39057200400",1482,413,84,6,80,19,15,0,2099
"39057200500",3599,1392,16,167,205,28,0,26,5433
"39057200600",2756,325,86,30,142,0,94,5,3438
"39057200700",1918,1104,378,53,296,76,145,64,4034
"39057200900",4929,281,112,0,465,36,155,0,5978
"39057210100",3847,329,289,25,792,165,299,0,5746
"39057210200",7028,373,115,2,559,0,215,0,8292
"39057210300",3076,127,26,14,159,9,13,6,3430
"39057210401",3983,276,186,0,436,19,109,19,5028
"39057210402",4716,315,0,0,298,0,100,0,5429
"39057210500",4874,39,34,5,378,0,194,0,5524
"39057210601",6895,446,401,57,742,44,285,0,8870
"39057210602",4606,117,45,2,435,130,177,51,5563
"39057210603",5050,223,121,0,411,0,140,0,5945
"39057220100",6942,184,0,0,499,10,139,0,7774
"39057220200",6291,573,30,530,244,89,95,21,7873
"39057230100",2428,174,0,0,15,0,0,0,2617
"39057240100",2380,439,267,93,107,9,16,0,3311
"39057240200",2944,949,274,20,76,83,82,39,4467
"39057240301",6118,1644,705,104,151,371,122,2,9217
"39057240302",2100,592,245,215,84,64,53,0,3353
"39057240500",3209,543,313,82,136,24,0,13,4320
"39057240600",1426,488,741,348,102,29,0,0,3134
"39057240700",2042,228,62,11,32,12,0,0,2387
"39057255000",2257,292,376,25,74,177,52,100,3353
"39057260100",3366,517,41,10,61,34,17,10,4056
"39057270100",3301,308,27,0,40,0,8,14,3698
"39057280101",2323,100,28,0,24,112,38,0,2625
"39057280102",1934,97,0,12,37,22,3,0,2105
"39057280200",1147,47,71,0,86,0,29,0,1380
"39057280300",1363,116,233,0,102,0,200,0,2014
"39059977100",3418,1120,98,0,82,9,0,0,4727
"39059977200",4130,738,0,0,0,0,0,3,4871
"39059977300",2077,1117,35,34,73,93,25,0,3454
"39059977400",2796,561,55,26,74,78,34,0,3624
"39059977500",2533,513,0,17,177,23,138,0,3401
"39059977600",2143,902,73,2,56,37,0,0,3213
"39059977700",3127,410,36,6,38,3,47,0,3667
"39059977800",2811,654,0,14,13,6,15,0,3513
"39059977900",3508,917,199,0,47,0,0,0,4671
"39059978000",3607,685,39,0,73,7,6,0,4417
"39061000200",43,28,495,392,18,0,18,0,994
"39061000700",1094,224,177,19,200,23,153,34,1924
"39061000900",240,241,123,315,16,80,5,94,1114
"39061001000",486,96,191,174,32,32,24,0,1035
"39061001100",148,54,390,404,0,3,0,0,999
"39061001600",81,30,180,469,49,4,0,0,813
"39061001700",77,53,126,524,13,244,0,0,1037
"39061001800",692,46,281,245,140,3,12,3,1422
"39061001900",839,76,390,140,26,12,111,19,1613
"39061002000",840,116,263,127,55,9,23,27,1460
"39061002200",383,109,982,460,40,46,0,0,2020
"39061002300",171,78,296,501,105,0,0,0,1151
"39061002500",719,1257,190,76,0,142,0,48,2432
"39061002600",1083,2034,221,268,204,168,59,61,4098
"39061002700",630,488,102,327,57,91,6,22,1723
"39061002800",617,179,107,157,13,183,10,58,1324
"39061002900",1904,886,253,66,575,449,0,0,4133
"39061003000",274,559,19,46,78,265,22,58,1321
"39061003200",370,341,298,161,210,85,20,5,1490
"39061003300",317,681,232,303,101,44,47,11,1736
"39061003600",8,60,449,931,35,0,27,21,1531
"39061003700",69,23,448,975,56,99,0,0,1670
"39061003800",118,38,1306,759,0,58,0,0,2279
"39061003900",205,109,1012,665,65,0,35,0,2091
"39061004000",446,52,1109,579,77,0,55,35,2353
"39061004100",608,36,332,315,34,51,5,0,1381
"39061004200",1084,86,566,95,75,10,17,0,1933
"39061004500",1017,113,0,0,17,0,27,0,1174
"39061004602",4158,324,64,208,104,11,93,0,4962
"39061004603",2524,255,146,14,103,0,88,0,3130
"39061004604",2798,307,109,65,51,28,94,0,3452
"39061004605",2053,109,114,0,31,74,0,0,2381
"39061004701",2868,56,135,8,72,1,27,0,3167
"39061004702",509,261,0,8,11,0,0,0,789
"39061004800",3277,87,0,0,92,37,30,0,3523
"39061004900",5648,807,219,15,306,38,103,0,7136
"39061005000",3778,247,360,60,445,0,187,0,5077
"39061005100",2037,175,32,13,117,0,71,3,2448
"39061005200",2985,244,56,167,133,27,55,50,3717
"39061005301",2188,148,200,60,157,0,63,0,2816
"39061005302",2127,245,92,15,200,40,54,0,2773
"39061005400",564,40,170,34,16,22,20,0,866
"39061005500",980,141,1453,1082,176,41,55,13,3941
"39061005600",2935,465,1559,800,35,26,0,56,5876
"39061005701",1965,256,560,283,14,0,18,0,3096
"39061005702",2488,156,894,752,33,59,81,84,4547
"39061005800",1088,87,2892,541,343,41,54,0,5046
"39061005900",614,99,261,192,53,13,17,50,1299
"39061006000",2811,656,1518,426,115,0,230,121,5877
"39061006100",1344,597,597,213,19,36,392,162,3360
"39061006300",254,21,2597,661,173,0,13,0,3719
"39061006400",84,13,1944,945,71,11,20,0,3088
"39061006500",1225,88,2057,690,132,39,38,0,4269
"39061006600",215,254,738,1047,45,27,48,0,2374
"39061006800",103,37,1970,1162,56,0,12,0,3340
"39061006900",49,42,1494,972,34,0,23,0,2614
"39061007000",1226,365,411,237,111,173,59,0,2582
"39061007100",2574,298,165,178,188,104,61,12,3580
"39061007200",1333,246,201,94,125,191,42,0,2232
"39061007300",583,159,945,384,11,110,0,51,2243
"39061007400",665,293,317,329,48,0,12,0,1664
"39061007500",928,236,363,155,47,0,0,0,1729
"39061007700",34,55,851,1466,27,113,0,23,2569
"39061007800",1091,383,526,236,47,78,21,0,2382
"39061007900",703,161,545,66,21,20,12,0,1528
"39061008000",309,181,1222,3138,51,315,102,115,5433
"39061008100",226,51,1690,459,122,5,50,20,2623
"39061008201",1387,143,2042,308,85,44,29,0,4038
"39061008202",912,228,1129,645,123,32,6,24,3099
"39061008300",1571,222,2428,362,144,0,216,167,5110
"39061008400",782,49,278,859,20,7,0,0,1995
"39061008501",366,115,753,1858,193,30,126,24,3465
"39061008502",25,115,315,1104,0,99,32,100,1790
"39061008601",314,74,695,1162,88,179,27,0,2539
"39061008800",166,220,1283,1532,17,9,135,99,3461
"39061009200",1101,835,475,1029,424,317,367,454,5002
"39061009300",837,393,529,543,67,37,51,0,2457
"39061009400",558,438,179,484,20,54,0,54,1787
"39061009500",995,459,493,301,220,38,126,287,2919
"39061009600",2120,682,338,670,181,40,104,175,4310
"39061009700",2247,1172,691,1113,307,280,540,77,6427
"39061009800",600,189,536,659,46,247,43,202,2522
"39061009901",3440,469,327,14,204,0,15,0,4469
"39061009902",2010,710,271,483,144,68,75,29,3790
"39061010002",845,292,2592,1452,232,39,0,3,5455
"39061010003",971,124,1918,633,118,329,7,126,4226
"39061010004",775,92,2806,811,377,129,33,100,5123
"39061010005",841,34,442,352,27,0,3,21,1720
"39061010100",1986,588,1368,745,98,135,62,12,4994
"39061010201",3149,531,838,402,72,8,35,1,5036
"39061010202",1374,106,526,268,158,0,53,0,2485
"39061010300",613,480,286,345,0,146,0,146,2016
"39061010400",953,97,29,0,30,0,0,0,1109
"39061010500",1036,337,0,0,9,0,26,150,1558
"39061010600",1202,129,0,1,34,19,0,0,1385
"39061010700",1369,168,41,34,23,48,25,0,1708
"39061010800",276,28,363,41,112,13,0,0,833
"39061010900",1237,314,362,140,185,0,10,0,2248
"39061011000",321,80,1305,842,20,138,0,0,2706
"39061011100",1172,111,1866,127,79,0,15,0,3370
"39061020401",4154,804,24,48,49,9,44,0,5132
"39061020403",4846,516,0,0,96,48,126,0,5632
"39061020404",4775,133,0,0,51,54,9,0,5022
"39061020501",2063,109,0,29,42,0,0,0,2243
"39061020502",4295,67,172,0,205,8,23,0,4770
"39061020504",2749,66,487,55,226,0,130,0,3713
"39061020505",3067,139,1189,57,117,6,28,9,4612
"39061020601",5728,224,39,0,206,0,0,0,6197
"39061020602",6732,408,77,0,120,106,106,0,7549
"39061020701",5306,550,320,71,395,0,74,210,6926
"39061020705",2015,208,651,169,213,12,0,1,3269
"39061020707",4652,128,29,0,63,0,103,0,4975
"39061020741",1799,133,599,251,80,200,0,12,3074
"39061020742",2333,467,1163,100,152,15,124,55,4409
"39061020761",4637,802,852,260,152,0,7,27,6737
"39061020762",1725,524,578,144,56,14,5,9,3055
"39061020802",5186,236,101,4,134,1,0,1,5663
"39061020811",4169,298,1046,294,135,0,10,0,5952
"39061020812",4052,263,47,40,12,0,0,0,4414
"39061020901",2745,254,257,38,42,11,104,0,3451
"39061020902",3989,920,423,70,34,73,15,98,5622
"39061021001",2870,78,8,98,17,0,0,0,3071
"39061021002",3409,264,0,0,53,0,56,0,3782
"39061021003",2981,291,0,0,0,0,0,0,3272
"39061021101",4786,210,0,0,65,2,46,0,5109
"39061021102",6300,198,0,0,182,0,23,0,6703
"39061021201",1931,67,0,0,19,0,0,0,2017
"39061021202",4692,466,147,77,124,0,0,0,5506
"39061021302",5365,212,0,0,115,2,0,0,5694
"39061021303",4493,437,29,3,30,0,42,0,5034
"39061021304",3838,243,66,30,78,34,4,0,4293
"39061021401",4138,517,149,16,112,87,81,0,5100
"39061021421",3783,327,154,0,104,7,0,7,4382
"39061021422",2523,163,12,0,267,103,84,0,3152
"39061021501",2156,270,1387,177,256,57,41,144,4488
"39061021504",1537,108,2886,1015,147,0,320,47,6060
"39061021505",794,44,1650,480,10,13,10,0,3001
"39061021506",456,20,2037,491,197,83,11,0,3295
"39061021508",3795,113,1435,64,230,0,89,0,5726
"39061021509",3046,204,1441,1420,195,112,25,1,6444
"39061021571",1498,40,867,498,420,73,89,0,3485
"39061021572",1133,296,3804,501,157,51,490,156,6588
"39061021602",575,3,1164,834,274,51,0,0,2901
"39061021603",1954,299,883,298,247,15,180,0,3876
"39061021604",1173,56,1458,599,339,0,59,0,3684
"39061021701",1603,250,541,103,84,0,49,63,2693
"39061021702",1675,709,1093,942,173,88,67,0,4747
"39061021801",2358,425,2189,696,390,0,207,14,6279
"39061021802",1389,67,1400,209,31,24,24,0,3144
"39061021900",610,38,417,360,0,90,0,23,1538
"39061022000",3183,336,147,7,43,0,166,2,3884
"39061022101",3029,114,657,48,99,56,25,6,4034
"39061022102",4149,75,1722,477,212,38,168,0,6841
"39061022200",2990,218,815,26,168,13,131,0,4361
"39061022301",2901,1485,996,287,344,291,710,1380,8394
"39061022302",4356,350,512,0,195,61,166,213,5853
"39061022400",1705,92,269,4,97,0,42,4,2213
"39061022500",1060,287,2061,150,316,31,44,0,3949
"39061022601",4700,159,258,8,521,0,49,0,5695
"39061022602",1625,225,552,0,223,20,116,51,2812
"39061022700",12,0,2129,1098,106,0,75,0,3420
"39061023001",2620,464,582,291,466,0,109,175,4707
"39061023002",4128,307,251,0,444,0,48,0,5178
"39061023100",2235,103,226,0,204,0,0,0,2768
"39061023201",1782,488,250,99,128,74,0,0,2821
"39061023210",3906,601,549,462,121,51,67,0,5757
"39061023222",1972,223,450,200,18,0,20,0,2883
"39061023300",3345,207,285,0,131,0,66,0,4034
"39061023400",484,180,2251,442,84,156,12,0,3609
"39061023501",3115,66,237,0,754,57,157,0,4386
"39061023521",1788,66,239,70,141,28,116,13,2461
"39061023522",4707,238,400,31,485,208,31,0,6100
"39061023600",3059,506,197,228,72,9,36,8,4115
"39061023701",2191,124,151,71,118,0,7,0,2662
"39061023702",2371,285,60,0,127,0,0,0,2843
"39061023800",1944,336,1943,406,335,0,147,16,5127
"39061023901",3129,177,297,0,905,8,53,0,4569
"39061023902",4316,123,63,1,324,0,25,0,4852
"39061024001",3929,56,381,15,521,93,139,0,5134
"39061024002",1968,191,140,7,128,3,4,0,2441
"39061024100",6035,277,15,0,172,0,184,0,6683
"39061024200",1827,10,253,175,206,30,14,0,2515
"39061024301",2430,312,270,343,649,19,88,67,4178
"39061024303",5099,515,170,228,333,0,59,0,6404
"39061024321",6652,288,92,0,504,0,411,0,7947
"39061024322",7214,223,183,0,578,77,517,0,8792
"39061024400",6113,131,256,57,681,24,92,0,7354
"39061024700",1598,73,44,3,40,4,24,0,1786
"39061024800",2946,124,0,0,144,0,101,0,3315
"39061024901",852,186,0,0,11,0,47,0,1096
"39061024902",7358,108,11,0,296,18,118,0,7909
"39061025001",5159,456,20,153,333,9,77,0,6207
"39061025002",6725,303,0,58,81,0,0,0,7167
"39061025101",4517,57,21,0,243,0,46,0,4884
"39061025102",7118,416,13,0,295,0,134,0,7976
"39061025103",5379,528,111,8,313,0,0,0,6339
"39061025104",1980,58,1,4,96,0,73,0,2212
"39061025200",3245,573,330,39,206,9,90,0,4492
"39061025300",1851,479,28,35,156,22,279,22,2872
"39061025401",1239,295,40,48,0,0,21,0,1643
"39061025402",2263,329,65,120,45,0,9,52,2883
"39061025500",2745,845,272,249,108,0,135,71,4425
"39061025600",2236,656,131,195,76,24,37,13,3368
"39061025700",1029,581,220,97,42,9,31,15,2024
"39061025800",3170,200,430,385,162,8,7,8,4370
"39061026001",4603,252,0,0,28,10,44,17,4954
"39061026002",4107,354,33,0,90,0,0,0,4584
"39061026101",6865,405,0,2,60,68,0,0,7400
"39061026102",2829,200,80,0,0,0,16,0,3125
"39061026200",1111,657,0,0,71,0,0,69,1908
"39061026300",244,547,83,84,15,9,8,51,1041
"39061026400",189,36,1003,1337,7,0,8,0,2580
"39061026500",1141,162,243,509,35,13,115,0,2218
"39061026600",1059,240,79,4,11,1,10,0,1404
"39061026700",33,76,665,538,0,4,0,30,1346
"39061026800",1336,81,28,0,42,0,1,0,1488
"39061026900",93,180,532,775,83,34,0,0,1697
"39061027000",77,247,1042,1641,18,62,0,41,3128
"39061027100",301,138,2188,929,0,20,18,20,3614
"39061027200",320,446,996,490,60,41,13,78,2444
"39061027300",2544,130,19,0,33,0,11,0,2737
"39061027400",2194,568,679,698,56,12,266,302,4775
"39063000100",3473,388,9,0,163,76,153,104,4366
"39063000200",5220,99,44,0,204,0,132,0,5699
"39063000300",7643,527,0,0,144,76,203,172,8765
"39063000400",6064,556,0,18,555,28,505,39,7765
"39063000500",2985,1584,87,190,259,149,90,148,5492
"39063000600",4668,1082,85,128,497,202,247,192,7101
"39063000700",5260,333,8,16,231,11,289,52,6200
"39063000800",2663,715,101,104,82,30,59,10,3764
"39063000900",3242,1654,30,5,57,94,166,190,5438
"39063001000",5164,730,13,95,139,1,199,15,6356
"39063001100",3307,475,31,9,226,10,191,74,4323
"39063001200",5233,386,14,16,128,27,59,16,5879
"39063001300",4803,413,0,0,44,11,203,0,5474
"39065000100",2871,465,12,0,20,5,21,2,3396
"39065000200",3984,763,6,11,218,0,190,0,5172
"39065000300",3278,396,3,3,52,2,4,10,3748
"39065000400",3716,926,0,25,158,67,18,23,4933
"39065000500",3404,544,32,7,35,61,26,19,4128
"39065000600",2302,893,11,6,62,71,82,17,3444
"39065000700",3900,1099,10,4,104,6,10,0,5133
"39067975600",2748,975,93,6,138,20,19,18,4017
"39067975700",2735,526,0,0,8,4,43,0,3316
"39067975800",1688,381,0,0,14,0,0,2,2085
"39067975900",2240,315,0,0,0,0,0,0,2555
"39067976000",2831,436,87,151,9,19,19,0,3552
"39069000100",4235,522,0,12,64,13,155,54,5055
"39069000200",3370,34,2,1,54,0,89,1,3551
"39069000300",4418,713,2,0,95,54,101,131,5514
"39069000400",2335,557,9,0,209,159,156,119,3544
"39069000500",2667,530,4,1,82,30,124,42,3480
"39069000600",2823,380,1,0,117,63,235,99,3718
"39069000700",3316,597,3,7,174,55,446,175,4773
"39071954400",2992,824,6,6,74,0,0,0,3902
"39071954500",3164,1069,0,0,14,13,0,0,4260
"39071954600",4870,633,15,0,3,20,11,0,5552
"39071954700",5018,858,0,0,27,0,6,0,5909
"39071954800",2833,1129,34,8,61,151,26,98,4340
"39071954900",2604,491,105,76,196,65,0,0,3537
"39071955000",2636,1149,37,29,0,40,0,24,3915
"39071955100",4893,724,0,45,224,187,118,0,6191
"39071955200",4562,843,39,0,36,0,46,0,5526
"39073964900",4094,529,0,1,0,9,28,0,4661
"39073965000",2597,544,0,0,24,0,0,0,3165
"39073965100",4064,446,0,13,31,28,0,30,4612
"39073965200",3705,675,54,32,52,69,24,34,4645
"39073965300",2820,735,0,3,51,11,15,0,3635
"39073965400",3224,930,43,11,146,0,65,0,4419
"39073965500",2982,501,0,0,83,0,5,0,3571
"39075976301",3607,805,0,0,0,0,14,0,4426
"39075976302",5181,742,9,0,19,3,0,3,5957
"39075976400",7763,1086,0,0,23,0,36,0,8908
"39075976500",4561,638,0,0,24,0,0,74,5297
"39075976600",3410,567,74,20,42,29,32,25,4199
"39075976700",3350,581,1,0,20,47,45,13,4057
"39075976801",3534,1013,0,0,38,14,28,0,4627
"39075976802",3630,1057,0,0,58,14,70,0,4829
"39077915400",4056,577,0,0,66,13,24,15,4751
"39077915500",4807,557,13,0,464,19,309,58,6227
"39077915600",3895,614,1,72,46,60,118,97,4903
"39077915700",3388,627,85,1,54,162,244,161,4722
"39077915800",3834,787,91,17,44,55,109,218,5155
"39077915900",3899,197,0,0,33,1,24,1,4155
"39077916000",3513,332,0,0,25,49,48,7,3974
"39077916100",3151,289,21,0,55,88,93,22,3719
"39077916200",3509,833,0,39,362,592,452,763,6550
"39077916300",2574,436,9,30,97,103,162,235,3646
"39077916400",4137,501,2,0,129,3,47,8,4827
"39077916500",4578,294,0,0,24,0,22,0,4918
"39077916600",3329,561,113,5,157,2,87,0,4254
"39079957200",3516,1359,0,0,106,146,0,0,5127
"39079957300",2389,812,3,0,7,90,5,0,3306
"39079957400",4269,1321,55,0,47,0,35,0,5727
"39079957500",4158,916,0,57,108,47,45,95,5426
"39079957600",2203,737,0,6,26,6,6,28,3012
"39079957700",3865,1163,16,0,91,47,14,0,5196
"39079957800",3677,1274,0,0,72,47,33,37,5140
"39081000200",388,546,174,179,25,77,24,0,1413
"39081000400",1454,1202,423,589,61,96,4,0,3829
"39081000600",1805,104,58,47,34,3,0,0,2051
"39081000800",231,122,82,179,18,73,0,54,759
"39081001000",2163,120,169,1,0,0,23,0,2476
"39081001200",3978,476,323,142,133,33,114,0,5199
"39081001300",691,363,29,106,72,85,0,0,1346
"39081001400",2818,297,227,90,47,0,68,0,3547
"39081001700",798,349,262,181,110,56,46,60,1862
"39081011000",1324,358,1,0,2,2,0,0,1687
"39081011100",2720,506,33,0,40,8,0,0,3307
"39081011200",1281,609,0,0,0,7,16,1,1914
"39081011300",2285,353,0,0,36,11,21,0,2706
"39081011401",3709,556,7,22,35,44,0,0,4373
"39081011402",3501,175,0,0,114,0,47,0,3837
"39081011500",4503,363,22,8,7,0,46,6,4955
"39081011700",3953,285,147,0,118,13,12,0,4528
"39081011800",2820,435,109,0,23,70,0,0,3457
"39081011900",3295,389,0,9,14,0,0,0,3707
"39081012000",2563,397,28,17,67,15,71,68,3226
"39081012100",2579,290,9,1,12,3,3,0,2897
"39081012200",1672,271,0,2,10,28,5,0,1988
"39081012300",1898,325,10,0,20,4,3,0,2260
"39083006700",4367,634,0,0,98,10,53,0,5162
"39083006801",5350,342,0,2,58,0,35,0,5787
"39083006802",3838,478,21,0,119,0,66,0,4522
"39083006900",5399,724,5,0,101,31,29,27,6316
"39083007000",2515,382,0,0,64,0,88,0,3049
"39083007100",2927,1081,0,26,41,84,18,0,4177
"39083007200",4178,766,0,40,50,41,0,0,5075
"39083007300",3517,661,96,36,135,0,17,0,4462
"39083007400",4371,963,24,0,24,1,33,0,5416
"39083007500",2708,556,26,10,116,17,13,31,3477
"39083007600",3699,648,59,0,120,0,0,0,4526
"39083007700",5055,632,6,0,250,15,296,0,6254
"39085200100",1476,130,116,17,43,29,31,24,1866
"39085200200",2357,220,22,0,109,21,147,0,2876
"39085200300",2766,165,18,0,20,1,29,0,2999
"39085200400",2936,505,13,0,43,0,53,0,3550
"39085200500",2872,100,0,0,138,0,59,0,3169
"39085200600",3052,161,0,0,69,42,17,0,3341
"39085200700",3217,326,335,74,102,0,60,0,4114
"39085200800",2996,188,181,54,192,6,35,0,3652
"39085200900",1136,197,52,0,44,46,2,0,1477
"39085201000",3559,140,1197,42,145,0,62,0,5145
"39085201100",3372,163,412,0,412,13,51,0,4423
"39085201200",2874,144,242,8,227,96,126,0,3717
"39085201300",3208,309,0,0,87,0,41,0,3645
"39085201400",3517,257,9,0,26,0,57,0,3866
"39085201500",1750,0,0,0,54,0,48,0,1852
"39085201600",3153,155,134,16,329,25,10,0,3822
"39085201700",4506,435,99,282,95,0,211,0,5628
"39085201800",3283,167,7,0,39,0,10,0,3506
"39085201900",2648,128,160,24,16,0,12,11,2999
"39085202000",5436,405,86,0,158,0,56,0,6141
"39085202100",1861,321,75,0,15,0,168,0,2440
"39085202400",2892,188,0,0,50,0,32,0,3162
"39085202500",3652,434,73,10,132,0,36,0,4337
"39085202600",3682,270,0,0,17,1,10,0,3980
"39085202700",5812,239,0,38,43,0,35,0,6167
"39085202800",5332,520,15,4,162,0,64,0,6097
"39085202900",5778,674,97,0,41,0,61,0,6651
"39085203000",6589,146,0,0,44,25,85,0,6889
"39085203200",2568,533,175,66,128,0,79,0,3549
"39085203400",3905,260,11,86,48,0,19,10,4339
"39085203500",6326,167,0,15,229,0,169,0,6906
"39085203700",3074,143,0,1,1,0,15,0,3234
"39085204000",2421,655,1,12,9,1,0,209,3308
"39085204200",1992,628,496,355,454,416,1040,306,5687
"39085204301",1484,90,54,0,55,32,99,0,1814
"39085204302",4189,772,444,630,309,60,708,217,7329
"39085204400",1786,462,138,35,385,184,599,239,3828
"39085204500",1601,868,193,29,306,190,670,403,4260
"39085204700",3650,422,32,0,147,0,139,78,4468
"39085204800",4482,535,69,32,33,0,154,22,5327
"39085204900",5399,253,86,52,264,22,128,0,6204
"39085205001",5189,424,66,0,77,0,13,3,5772
"39085205002",5251,133,192,0,247,0,97,0,5920
"39085205100",6057,111,0,1,253,0,61,0,6483
"39085205200",2906,97,10,0,40,0,23,0,3076
"39085205300",2274,79,56,7,0,0,9,0,2425
"39085205400",1435,181,0,5,36,10,6,47,1720
"39085205701",3271,1125,12,20,93,0,173,275,4969
"39085205702",3157,132,10,3,72,0,0,1,3375
"39085205800",1006,65,37,0,137,0,4,0,1249
"39085205900",739,55,13,10,36,0,0,0,853
"39085206000",4525,667,0,0,31,18,16,0,5257
"39085206100",2592,469,0,3,71,0,13,0,3148
"39085206200",1305,242,101,12,2,0,12,2,1676
"39085206300",4350,317,105,16,63,29,296,29,5205
"39085206400",4435,162,0,1,49,1,49,1,4698
"39085206500",2304,95,154,0,103,21,43,0,2720
"39085206600",4083,396,3,0,198,0,0,0,4680
"39085990000",0,0,0,0,0,0,0,0,0
"39087050100",1731,308,86,39,97,14,0,0,2275
"39087050200",1898,234,31,0,9,20,0,0,2192
"39087050300",1238,329,291,174,161,118,7,0,2318
"39087050400",2449,631,32,31,0,0,49,0,3192
"39087050500",5873,818,0,0,172,19,0,0,6882
"39087050600",1087,169,0,0,20,0,0,0,1276
"39087050700",2986,669,0,0,30,0,0,0,3685
"39087050800",2906,884,29,15,57,0,17,0,3908
"39087050900",1772,448,10,0,13,9,6,0,2258
"39087051001",3298,431,55,124,91,242,29,65,4335
"39087051002",3330,1442,0,0,30,57,8,0,4867
"39087051100",5100,1286,52,0,148,70,16,0,6672
"39087051200",3828,1238,9,3,143,16,81,0,5318
"39087051300",3242,579,0,0,9,9,52,2,3893
"39087051401",5147,217,15,0,27,0,142,0,5548
"39087051402",2738,591,13,4,38,11,0,2,3397
"39089750700",2531,721,8,43,8,141,0,0,3452
"39089751000",1508,706,11,46,114,53,26,0,2464
"39089751300",2729,569,68,37,126,70,22,21,3642
"39089751600",2638,529,25,7,91,0,149,8,3447
"39089751900",3354,542,22,27,64,29,21,13,4072
"39089752200",3508,795,72,103,94,0,26,5,4603
"39089752500",2259,1152,86,78,104,48,0,0,3727
"39089752800",5441,636,127,0,409,55,0,26,6694
"39089753100",4073,533,48,37,82,70,21,14,4878
"39089753300",5132,1061,249,182,153,174,31,0,6982
"39089753600",1643,189,14,0,9,11,21,0,1887
"39089753900",4158,365,104,26,96,18,27,13,4807
"39089754101",6111,1012,76,0,168,0,128,105,7600
"39089754102",2320,23,0,0,20,0,0,0,2363
"39089754400",5475,953,0,0,63,0,0,0,6491
"39089754700",5658,510,0,0,191,88,96,74,6617
"39089755000",6397,135,26,0,137,0,56,0,6751
"39089755300",6540,371,49,42,45,59,266,45,7417
"39089755600",4847,146,4,12,52,0,68,0,5129
"39089755900",5423,349,467,38,344,0,75,0,6696
"39089756201",1677,171,317,13,2,7,0,0,2187
"39089756202",5402,342,1818,23,629,48,414,0,8676
"39089756500",3344,524,92,4,233,0,20,0,4217
"39089756800",7086,327,136,39,204,121,109,0,8022
"39089757100",3737,160,14,0,4,0,0,0,3915
"39089757400",5527,380,53,128,43,0,165,7,6303
"39089757700",4897,211,0,0,106,0,52,0,5266
"39089758300",1798,825,0,0,71,8,87,45,2834
"39089758600",5976,619,26,0,325,68,37,0,7051
"39089758900",5098,1068,24,0,61,0,36,0,6287
"39089759000",2073,1042,174,79,75,51,0,11,3505
"39089759100",6492,518,18,0,324,0,42,9,7403
"39091003800",3193,573,14,0,151,6,0,0,3937
"39091003900",3708,617,21,0,63,10,70,20,4509
"39091004000",2490,306,0,8,15,0,10,0,2829
"39091004100",2348,446,0,3,72,11,6,4,2890
"39091004200",1256,282,30,13,1,43,6,17,1648
"39091004300",4918,1136,39,0,148,38,73,50,6402
"39091004400",3235,874,55,45,126,169,41,0,4545
"39091004500",3044,1106,273,35,103,131,9,56,4757
"39091004600",3848,818,92,1,131,34,10,96,5030
"39091004700",4650,145,0,24,124,0,44,2,4989
"39091004800",3673,263,12,14,52,0,33,8,4055
"39093010200",3904,155,0,0,145,61,131,61,4457
"39093010300",4705,233,0,0,178,0,79,0,5195
"39093010400",2526,132,81,10,19,0,30,10,2808
"39093013100",9152,150,0,0,492,12,230,2,10038
"39093013200",9609,552,172,204,471,11,431,0,11450
"39093021100",2756,285,64,13,92,0,190,41,3441
"39093021200",4675,961,18,0,219,0,288,23,6184
"39093022100",1456,123,189,6,35,28,154,18,2009
"39093022200",1589,855,78,60,128,18,236,192,3156
"39093022400",1772,598,270,663,279,262,413,348,4605
"39093022500",1236,64,133,60,87,7,258,10,1855
"39093022601",1220,399,275,274,295,33,136,46,2678
"39093022800",1498,763,552,937,286,480,819,787,6122
"39093023000",2711,1157,462,965,178,412,536,101,6522
"39093023100",1264,434,210,442,466,456,1162,851,5285
"39093023200",1118,552,366,281,171,183,619,318,3608
"39093023300",1062,312,355,493,190,128,535,321,3396
"39093023400",1429,145,232,0,0,0,121,0,1927
"39093023500",1685,340,72,0,106,0,404,147,2754
"39093023600",1488,644,131,18,522,307,1032,636,4778
"39093023700",3187,1108,438,158,409,356,1096,1161,7913
"39093023800",949,287,13,45,226,193,394,304,2411
"39093023900",912,286,135,6,226,166,298,176,2205
"39093024000",1115,124,140,119,155,25,230,13,1921
"39093024100",1703,501,155,57,255,219,322,325,3537
"39093024200",2637,436,422,102,465,194,793,50,5099
"39093028100",3460,175,29,56,223,34,258,0,4235
"39093030100",5293,1027,0,3,107,0,166,0,6596
"39093050100",2999,46,70,0,64,0,81,0,3260
"39093050200",3129,376,0,0,35,14,118,1,3673
"39093050300",6719,517,30,0,280,0,252,2,7800
"39093050400",2007,47,5,177,69,0,61,0,2366
"39093057100",3437,255,23,5,37,3,259,16,4035
"39093060100",1924,348,787,91,344,27,145,50,3716
"39093060200",2019,739,277,27,130,19,8,24,3243
"39093070101",3146,92,215,0,234,0,327,0,4014
"39093070102",4424,405,433,270,154,70,285,178,6219
"39093070200",1588,78,116,0,143,32,227,38,2222
"39093070300",2181,481,293,45,40,32,26,0,3098
"39093070400",2395,657,860,276,176,395,94,79,4932
"39093070500",1615,567,272,151,138,120,132,57,3052
"39093070600",3384,725,252,0,140,9,68,0,4578
"39093070700",1654,480,249,3,130,108,199,83,2906
"39093070800",481,276,71,150,0,23,11,9,1021
"39093070901",494,356,315,308,148,140,63,72,1896
"39093070902",2406,325,525,230,55,11,17,0,3569
"39093071000",856,402,195,121,85,68,81,38,1846
"39093071100",3783,383,115,54,187,86,84,55,4747
"39093071201",3400,460,403,136,98,36,146,84,4763
"39093071202",3271,123,417,7,239,13,64,0,4134
"39093071300",3678,463,34,332,299,25,146,0,4977
"39093071400",1451,314,654,542,286,94,104,161,3606
"39093071500",1388,189,12,7,85,0,0,0,1681
"39093077100",3093,310,29,2,7,2,105,0,3548
"39093080101",1977,204,33,4,28,5,70,0,2321
"39093080103",3913,296,18,12,70,0,109,0,4418
"39093080104",3287,109,43,0,172,19,101,19,3750
"39093080500",5729,161,173,1,24,0,142,0,6230
"39093080600",5106,414,32,1,45,106,202,0,5906
"39093080700",6952,637,81,1,145,0,253,2,8071
"39093090100",3216,132,0,1,5,28,64,0,3446
"39093090200",3173,264,6,0,101,6,0,0,3550
"39093091100",2546,167,126,41,78,0,114,0,3072
"39093091200",1820,117,55,0,53,0,12,0,2057
"39093092100",2239,125,7,0,16,22,106,0,2515
"39093093100",2692,199,2,0,65,0,33,0,2991
"39093094100",7583,364,19,0,120,0,106,30,8222
"39093095100",5856,242,25,1,161,0,44,0,6329
"39093096100",5414,488,66,23,26,0,22,0,6039
"39093097100",3103,82,7,0,26,0,15,21,3254
"39093097200",5228,943,428,163,578,206,1005,55,8606
"39093097300",719,723,771,425,177,374,440,643,4272
"39093097400",9496,419,198,8,352,12,187,188,10860
"39093990200",0,0,0,0,0,0,0,0,0
"39095000200",3303,369,399,151,79,206,404,0,4911
"39095000300",3054,421,323,529,62,17,187,0,4593
"39095000400",2167,555,191,123,157,259,123,181,3756
"39095000600",2853,952,554,331,340,176,273,150,5629
"39095000700",3209,424,822,367,299,147,338,25,5631
"39095000800",89,21,792,237,77,16,27,13,1272
"39095000900",648,273,1287,357,127,93,103,110,2998
"39095001000",1289,174,1122,740,246,112,431,139,4253
"39095001100",391,193,815,611,29,151,38,71,2299
"39095001201",1585,120,220,147,379,60,339,37,2887
"39095001202",333,243,67,1010,97,166,81,161,2158
"39095001301",2123,121,225,7,59,26,81,0,2642
"39095001302",612,372,477,229,61,157,23,36,1967
"39095001303",1338,98,916,330,168,18,56,0,2924
"39095001400",159,72,813,358,52,97,27,8,1586
"39095001500",98,47,692,547,13,38,19,45,1499
"39095001600",695,78,1683,627,157,14,13,18,3285
"39095001700",377,383,372,425,33,58,114,46,1808
"39095001800",618,267,900,374,173,227,146,257,2962
"39095001900",202,272,530,596,65,255,146,25,2091
"39095002000",888,439,83,239,97,77,171,83,2077
"39095002100",1088,201,732,553,78,0,54,2,2708
"39095002200",100,49,417,831,0,137,0,32,1566
"39095002300",62,125,421,799,45,15,29,4,1500
"39095002401",720,786,1176,426,105,153,56,28,3450
"39095002402",11,59,1062,725,43,0,7,47,1954
"39095002500",36,36,993,832,51,54,0,0,2002
"39095002600",8,0,751,360,66,3,0,0,1188
"39095002700",245,160,136,293,39,65,15,51,1004
"39095002800",297,129,105,241,83,17,63,13,948
"39095002900",107,201,70,910,139,43,116,76,1662
"39095003000",669,260,205,436,105,76,183,82,2016
"39095003100",75,33,593,210,0,33,50,0,994
"39095003200",27,8,545,789,0,17,0,17,1403
"39095003300",28,19,949,1012,13,15,30,16,2082
"39095003400",11,158,217,425,4,28,3,116,962
"39095003500",44,59,1039,487,96,4,4,18,1751
"39095003600",24,54,559,709,5,17,0,4,1372
"39095003700",191,134,226,766,12,6,15,19,1369
"39095003900",2695,760,538,345,315,171,379,201,5404
"39095004000",591,328,574,252,182,100,269,103,2399
"39095004200",713,398,76,266,113,72,127,126,1891
"39095004400",2324,477,559,174,422,176,306,69,4507
"39095004501",2369,341,67,129,25,3,343,0,3277
"39095004503",2085,281,36,11,60,29,63,0,2565
"39095004504",3308,40,63,0,161,7,164,7,3750
"39095004600",1757,729,87,112,30,55,276,252,3298
"39095004701",1274,976,140,125,106,190,214,252,3277
"39095004702",1808,1051,54,441,189,363,370,501,4777
"39095004800",1043,1260,193,247,125,293,159,457,3777
"39095004900",1280,667,24,90,239,106,196,281,2883
"39095005000",1137,259,39,62,199,132,217,30,2075
"39095005100",1534,1004,273,791,417,450,444,345,5258
"39095005200",2088,991,100,27,211,52,432,138,4039
"39095005300",1054,503,77,12,234,304,550,497,3231
"39095005400",1553,728,173,238,455,192,680,155,4174
"39095005501",1923,604,11,158,127,42,101,17,2983
"39095005502",2856,254,24,0,42,6,66,0,3248
"39095005503",1928,176,0,0,110,0,280,15,2509
"39095005600",4604,629,58,0,122,65,174,0,5652
"39095005701",2298,779,162,237,24,197,0,194,3891
"39095005702",4061,491,200,142,178,97,72,28,5269
"39095005703",1889,352,32,0,61,24,116,24,2498
"39095005801",2483,494,362,250,196,101,202,0,4088
"39095005802",3594,667,238,57,38,89,76,110,4869
"39095005901",2337,173,10,0,76,0,78,0,2674
"39095005902",2640,907,165,163,140,40,83,114,4252
"39095006000",1810,182,228,60,134,19,70,0,2503
"39095006100",2557,92,255,9,254,20,189,2,3378
"39095006200",2060,361,109,14,146,51,83,26,2850
"39095006300",2041,428,298,50,28,45,132,20,3042
"39095006400",1684,272,34,132,46,0,91,0,2259
"39095006500",1281,348,283,118,58,20,0,0,2108
"39095006600",287,507,1132,462,56,80,1,36,2561
"39095006700",314,383,662,208,93,7,43,50,1760
"39095006800",1412,665,877,1245,300,234,83,109,4925
"39095006900",2225,174,89,55,25,0,78,0,2646
"39095007001",3475,259,0,0,86,0,169,0,3989
"39095007002",1927,57,26,0,20,0,38,0,2068
"39095007101",3736,356,217,25,187,147,140,45,4853
"39095007102",3240,317,41,0,74,8,22,9,3711
"39095007202",2407,270,404,174,123,19,70,24,3491
"39095007203",3526,77,356,24,198,0,271,47,4499
"39095007204",2892,416,860,80,254,48,227,59,4836
"39095007205",2619,449,1496,680,285,120,242,0,5891
"39095007301",2699,324,929,240,375,29,209,8,4813
"39095007302",1319,187,1202,297,220,88,143,36,3492
"39095007303",711,446,1801,1467,311,485,106,219,5546
"39095007400",1682,685,1849,1011,568,94,338,17,6244
"39095007500",1697,857,921,129,127,472,70,11,4284
"39095007600",3744,134,98,0,554,7,11,0,4548
"39095007700",2592,446,161,29,133,0,92,12,3465
"39095007800",3397,450,140,44,51,0,106,29,4217
"39095007901",1754,146,0,0,20,8,134,12,2074
"39095007902",4179,611,426,83,227,135,18,21,5700
"39095008000",3436,444,44,0,72,27,163,20,4206
"39095008100",3031,340,71,202,171,212,66,45,4138
"39095008201",4319,156,26,0,229,51,137,0,4918
"39095008202",4968,179,251,4,150,0,52,0,5604
"39095008203",6029,280,159,158,370,149,199,60,7404
"39095008301",4440,652,73,0,235,33,52,42,5527
"39095008302",1538,77,33,0,23,0,28,0,1699
"39095008400",3436,184,443,85,200,0,103,15,4466
"39095008500",2853,218,529,313,128,69,134,32,4276
"39095008600",3262,608,714,357,178,46,62,95,5322
"39095008700",4324,1565,850,708,546,351,463,122,8929
"39095008800",5500,779,375,44,479,110,217,88,7592
"39095008901",4582,252,0,51,151,0,113,37,5186
"39095008902",5476,268,0,0,312,0,156,0,6212
"39095009000",10546,524,498,0,502,10,315,19,12414
"39095009101",3307,152,84,0,380,25,40,15,4003
"39095009102",3602,701,361,4,201,43,418,137,5467
"39095009201",7256,527,51,16,495,64,62,36,8507
"39095009202",6361,206,298,0,288,31,178,0,7362
"39095009300",1694,65,11,0,2,0,0,0,1772
"39095009400",1808,99,208,33,117,31,89,0,2385
"39095009500",2587,246,23,7,65,0,253,23,3204
"39095009600",2899,305,19,0,109,4,80,6,3422
"39095009700",2772,130,32,0,115,55,68,0,3172
"39095009800",4010,177,0,0,87,0,102,0,4376
"39095009900",3913,358,44,0,265,59,169,18,4826
"39095010001",3411,247,111,113,151,41,427,146,4647
"39095010002",2609,271,9,0,137,183,152,132,3493
"39095010100",3239,492,0,10,97,11,148,96,4093
"39095010200",1613,468,107,69,58,118,112,161,2706
"39095010300",923,664,83,252,216,214,501,347,3200
"39095010400",115,60,49,0,0,0,13,9,246
"39095990000",0,0,0,0,0,0,0,0,0
"39097040101",2108,59,0,3,69,0,7,0,2246
"39097040102",4168,625,0,0,75,0,100,0,4968
"39097040201",2332,90,0,0,59,0,7,0,2488
"39097040202",2515,162,0,0,44,0,36,0,2757
"39097040400",2431,166,0,0,10,0,0,0,2607
"39097040500",3905,334,0,28,96,65,33,2,4463
"39097040600",4776,314,67,206,270,76,156,0,5865
"39097040700",1948,421,107,28,167,12,54,24,2761
"39097041000",163,269,152,176,17,51,13,39,880
"39097041100",4114,376,51,22,11,17,35,0,4626
"39097041200",2586,380,2,1,21,10,7,1,3008
"39097041300",1998,344,0,0,4,0,0,0,2346
"39099800300",99,58,756,195,0,33,22,28,1191
"39099800400",18,129,692,157,0,83,0,0,1079
"39099800500",214,413,655,1294,43,37,68,334,3058
"39099800600",219,207,486,288,19,46,145,147,1557
"39099801000",415,340,292,331,36,83,72,125,1694
"39099801100",784,394,513,601,171,154,362,40,3019
"39099801200",789,390,322,51,31,46,111,17,1757
"39099801300",1034,461,221,332,57,66,37,104,2312
"39099801400",1785,328,45,26,24,0,88,13,2309
"39099801500",860,111,582,123,166,58,157,2,2059
"39099801600",454,319,866,1141,215,102,137,23,3257
"39099801700",198,167,186,351,110,8,43,114,1177
"39099802100",23,13,584,258,38,3,12,9,940
"39099802300",106,100,343,128,41,283,41,299,1341
"39099802400",257,199,1025,694,127,98,18,257,2675
"39099802500",179,154,796,328,8,29,36,108,1638
"39099802600",1053,310,199,151,102,93,94,45,2047
"39099802701",2385,222,158,28,11,0,71,0,2875
"39099802702",2368,184,279,0,118,2,48,0,2999
"39099802800",2104,419,110,14,22,9,184,27,2889
"39099802900",1310,555,72,821,7,31,0,20,2816
"39099803000",1303,414,156,102,44,3,63,36,2121
"39099804000",227,460,612,348,16,61,39,27,1790
"39099804100",184,56,628,328,7,0,0,0,1203
"39099804200",481,63,1376,228,216,69,45,50,2528
"39099804300",284,257,241,312,20,32,69,43,1258
"39099810100",2920,397,320,163,117,58,169,27,4171
"39099810200",1354,268,485,92,19,125,385,119,2847
"39099810300",510,277,503,289,176,108,284,100,2247
"39099810600",2001,859,46,57,214,0,280,73,3530
"39099810700",4492,687,0,1,21,18,19,66,5304
"39099810800",1578,387,79,14,39,68,22,78,2265
"39099810900",1904,200,88,16,19,0,42,0,2269
"39099811001",3633,301,10,0,46,0,43,0,4033
"39099811002",7030,432,0,0,98,0,43,0,7603
"39099811100",828,249,0,3,6,0,32,0,1118
"39099811200",2267,126,0,0,4,0,22,0,2419
"39099811300",4996,891,408,98,284,0,525,282,7484
"39099811400",1861,660,453,228,216,17,49,7,3491
"39099811500",5510,114,59,0,105,17,99,54,5958
"39099811600",2834,180,209,57,30,8,47,32,3397
"39099811700",2186,179,115,0,49,30,31,6,2596
"39099811800",972,176,20,14,9,0,0,15,1206
"39099811901",3720,193,146,66,152,22,142,47,4488
"39099811902",2822,167,35,1,198,26,51,46,3346
"39099812001",4779,431,0,57,194,23,122,0,5606
"39099812002",3471,193,142,38,168,0,84,0,4096
"39099812100",8378,392,150,10,418,43,112,0,9503
"39099812200",5785,610,0,0,237,0,116,0,6748
"39099812301",2937,715,24,238,61,0,105,0,4080
"39099812302",5611,377,283,133,277,42,163,0,6886
"39099812400",2455,331,100,96,78,5,51,0,3116
"39099812500",4253,531,135,7,40,19,89,0,5074
"39099812601",2888,607,352,323,69,7,79,7,4332
"39099812602",4293,150,239,26,0,12,0,0,4720
"39099812603",7331,255,452,0,154,11,187,23,8413
"39099812700",1851,129,0,0,37,0,33,0,2050
"39099812800",3163,463,0,0,56,12,23,33,3750
"39099812900",3895,228,0,6,40,2,30,0,4201
"39099813000",3845,400,43,0,112,68,0,0,4468
"39099813200",3526,621,0,1,0,0,255,0,4403
"39099813300",2865,245,0,0,87,0,55,0,3252
"39099813400",3090,375,0,21,8,32,98,0,3624
"39099813500",6154,490,30,0,17,42,49,0,6782
"39099813600",7378,754,14,2,142,107,156,0,8553
"39099813700",320,557,530,424,42,19,151,279,2322
"39099813800",334,166,1104,788,19,130,123,215,2879
"39099813900",75,94,1047,867,26,8,0,0,2117
"39099814000",223,435,901,878,132,27,37,297,2930
"39099814100",903,331,281,696,43,69,46,13,2382
"39101000100",637,433,20,3,34,0,30,0,1157
"39101000200",2023,1000,59,38,93,29,11,17,3270
"39101000300",1515,499,6,44,0,27,6,49,2146
"39101000400",2730,1056,17,35,13,27,20,0,3898
"39101000501",1810,700,23,6,74,95,47,28,2783
"39101000502",2015,465,7,24,17,0,2,0,2530
"39101000600",3722,344,80,26,227,235,154,0,4788
"39101000700",2071,268,20,7,79,0,29,26,2500
"39101000800",1589,705,17,11,0,22,0,2,2346
"39101000900",1938,1386,139,93,30,186,19,213,4004
"39101001000",2616,150,4,0,95,0,65,0,2930
"39101001100",1608,525,69,0,35,34,79,0,2350
"39101010100",4561,313,9,0,234,0,9,2,5128
"39101010201",4577,311,20,0,154,0,51,0,5113
"39101010202",190,153,144,177,24,12,36,23,759
"39101010300",3798,530,1,10,233,157,70,82,4881
"39101010400",4253,629,8,0,62,0,16,0,4968
"39101010500",5191,340,0,0,161,65,22,65,5844
"39103400100",7403,171,26,6,91,17,41,0,7755
"39103402000",4699,322,0,0,34,9,247,0,5311
"39103403001",2761,386,1,0,74,27,1,0,3250
"39103403002",2875,189,21,0,50,0,59,0,3194
"39103404000",3675,169,16,0,86,0,63,8,4017
"39103405000",4268,154,0,0,60,0,43,0,4525
"39103406000",4549,390,47,1,267,0,19,0,5273
"39103407000",5915,141,10,10,294,0,73,0,6443
"39103408001",2461,347,74,34,6,43,28,0,2993
"39103408002",1625,103,0,0,43,3,92,0,1866
"39103408003",2697,268,0,0,50,41,48,41,3145
"39103408100",5796,524,346,316,124,46,69,83,7304
"39103408201",2951,744,56,56,190,6,94,0,4097
"39103408202",5099,203,41,0,122,0,26,0,5491
"39103408301",3224,88,220,0,80,0,37,0,3649
"39103408302",8307,717,217,141,205,124,156,0,9867
"39103409001",2005,104,4,0,40,7,57,0,2217
"39103409002",3975,318,62,0,198,2,75,2,4632
"39103410000",3517,771,0,0,0,0,33,0,4321
"39103411001",1533,144,0,0,4,0,4,0,1685
"39103411002",2356,459,0,63,46,34,24,30,3012
"39103412000",4110,98,2,1,22,0,20,0,4253
"39103413000",4846,465,4,0,34,73,21,0,5443
"39103415100",3722,94,0,0,0,0,4,0,3820
"39103415200",4044,162,4,0,87,0,65,0,4362
"39103415300",3793,206,28,0,241,0,88,1,4357
"39103415400",4326,196,0,0,165,0,261,0,4948
"39103415800",6227,203,82,0,405,20,151,0,7088
"39103416000",4742,355,7,6,129,21,105,0,5365
"39103416100",4212,441,76,0,27,0,182,0,4938
"39103416200",3406,285,75,32,76,0,35,81,3990
"39103416300",2417,146,38,0,3,0,13,0,2617
"39103416400",3055,343,0,28,88,0,114,2,3630
"39103417000",7147,399,0,38,181,51,36,0,7852
"39103417100",5308,228,52,0,299,21,138,0,6046
"39103417200",6514,388,0,2,164,87,94,11,7260
"39103417300",3820,446,0,18,153,86,0,43,4566
"39105964100",3423,764,52,0,16,20,4,52,4331
"39105964200",3530,958,0,56,12,0,0,9,4565
"39105964300",4135,547,29,0,47,25,4,0,4787
"39105964400",2024,1176,57,0,28,76,0,0,3361
"39105964500",2228,856,16,46,21,0,2,4,3173
"39105964600",2553,570,8,0,39,12,3,39,3224
"39107967200",3179,465,1,2,5,11,15,8,3686
"39107967300",4232,396,0,0,19,26,8,0,4681
"39107967400",3693,782,4,38,118,3,53,17,4708
"39107967500",4225,473,66,0,137,19,68,13,5001
"39107967600",1954,599,4,2,57,133,19,75,2843
"39107967700",5783,257,0,7,105,0,128,6,6286
"39107967800",1822,172,0,0,21,21,16,0,2052
"39107967900",6075,320,7,19,55,7,125,7,6615
"39107968000",4783,42,4,0,39,0,76,1,4945
"39109300100",3608,455,132,0,65,97,0,0,4357
"39109315001",3082,363,222,10,145,44,77,0,3943
"39109315002",3653,931,49,72,72,143,7,0,4927
"39109315100",3916,1141,273,145,180,201,0,28,5884
"39109315300",3355,1310,51,137,0,59,58,18,4988
"39109320100",3183,506,0,0,21,0,13,0,3723
"39109325000",2238,397,0,0,16,26,23,0,2700
"39109330100",3086,286,30,2,6,0,67,0,3477
"39109340100",4641,334,0,3,15,9,27,1,5030
"39109345000",4351,361,0,0,128,29,26,0,4895
"39109350100",7441,229,0,0,75,72,202,11,8030
"39109355001",5307,553,29,2,76,2,49,0,6018
"39109355002",1577,79,0,1,14,0,2,1,1674
"39109365000",6366,1023,264,0,750,0,106,284,8793
"39109365101",3392,318,27,0,112,36,0,0,3885
"39109365102",4613,407,56,64,21,0,86,0,5247
"39109365200",2763,692,113,3,0,0,4,3,3578
"39109365301",3952,1022,150,240,49,118,0,0,5531
"39109365302",4377,542,91,10,405,44,85,0,5554
"39109380100",5729,437,18,0,79,0,172,0,6435
"39109390100",3996,230,38,0,74,0,52,0,4390
"39111966600",2822,509,0,0,30,6,10,0,3377
"39111966700",2873,703,15,0,77,50,49,0,3767
"39111966800",2902,743,10,30,38,0,0,0,3723
"39111966900",2951,703,0,5,10,0,29,0,3698
"39113000100",333,196,1830,467,10,0,0,0,2836
"39113000200",96,45,1431,942,18,23,0,0,2555
"39113000300",131,41,990,735,23,2,39,2,1963
"39113000400",202,40,1995,1246,82,0,42,0,3607
"39113000500",610,138,2435,543,56,0,17,0,3799
"39113000600",78,8,1264,217,50,0,5,0,1622
"39113000700",104,41,1279,1236,20,32,0,0,2712
"39113000801",680,99,1667,592,190,26,68,0,3322
"39113000802",279,190,860,754,89,20,34,107,2333
"39113000900",521,323,1042,965,7,73,14,21,2966
"39113001000",174,89,517,414,0,10,0,2,1206
"39113001100",796,704,1478,1388,73,118,22,223,4802
"39113001200",390,123,285,307,15,30,0,0,1150
"39113001501",1461,593,224,461,16,59,65,0,2879
"39113001600",1121,190,306,195,77,60,33,43,2025
"39113001700",342,318,36,95,5,15,1,6,818
"39113001800",2839,1547,441,786,165,58,43,52,5931
"39113001900",2393,1762,179,268,86,213,204,385,5490
"39113002000",1589,794,355,152,74,84,122,250,3420
"39113002200",957,1479,16,88,145,102,243,232,3262
"39113002300",1186,1152,53,270,10,128,58,34,2891
"39113002400",1636,628,30,69,0,111,47,110,2631
"39113002500",3129,1349,422,147,226,201,101,247,5822
"39113002600",3486,1924,82,42,48,127,14,119,5842
"39113002700",1562,334,250,27,44,31,26,14,2288
"39113002800",1701,237,62,9,16,9,8,0,2042
"39113002900",3223,438,138,13,21,0,0,12,3845
"39113003000",2406,336,0,5,94,57,81,11,2990
"39113003100",2120,352,53,25,63,0,60,0,2673
"39113003201",2248,574,98,133,142,90,16,101,3402
"39113003300",2738,1007,114,303,223,68,211,0,4664
"39113003402",422,811,7,160,3,18,0,15,1436
"39113003403",97,308,0,17,14,0,0,0,436
"39113003404",1191,453,131,80,27,28,38,0,1948
"39113003500",41,0,930,922,25,10,0,0,1928
"39113003800",34,157,1725,1295,7,69,0,45,3332
"39113003900",41,20,1386,739,0,101,41,9,2337
"39113004100",13,24,1164,1043,24,78,0,0,2346
"39113004200",2,7,895,1419,13,22,0,0,2358
"39113004300",85,116,1052,754,42,23,0,0,2072
"39113004400",44,0,1403,508,0,0,0,0,1955
"39113004600",85,161,623,519,22,45,0,45,1500
"39113010100",1937,61,0,0,35,0,124,0,2157
"39113010200",6619,166,60,0,236,0,31,0,7112
"39113020100",2458,202,32,6,75,98,25,25,2921
"39113020200",2040,92,178,39,49,0,23,6,2427
"39113020300",2587,152,0,0,73,16,190,0,3018
"39113020400",5419,447,175,93,351,100,67,73,6725
"39113020500",1149,184,52,13,77,7,59,6,1547
"39113020601",1574,132,0,0,42,0,32,32,1812
"39113020602",1572,7,0,0,33,0,58,0,1670
"39113020700",2706,170,13,0,81,24,52,0,3046
"39113020800",2097,67,49,11,44,0,8,11,2287
"39113020900",2098,339,28,0,52,36,28,0,2581
"39113021000",1407,239,0,0,50,0,5,0,1701
"39113021100",2448,483,89,9,165,51,76,0,3321
"39113021200",1353,114,11,0,170,47,23,0,1718
"39113021301",2354,513,6,5,19,47,37,0,2981
"39113021302",1815,232,0,0,27,60,0,0,2134
"39113021400",2024,427,0,19,64,12,41,0,2587
"39113021501",2156,365,43,87,70,26,38,20,2805
"39113021502",1375,170,40,16,31,3,23,19,1677
"39113021601",1762,214,144,0,51,76,43,0,2290
"39113021602",3114,180,54,1,37,0,97,0,3483
"39113021700",2074,210,0,9,102,0,30,0,2425
"39113021800",1291,328,116,194,110,123,22,27,2211
"39113021900",1675,103,133,5,113,6,64,0,2099
"39113030100",2773,614,234,706,108,89,20,0,4544
"39113030200",1961,363,235,138,10,15,44,10,2776
"39113040101",1698,32,8,0,44,7,20,0,1809
"39113040102",1764,59,22,0,253,21,92,0,2211
"39113040103",2230,75,0,11,0,26,43,13,2398
"39113040201",2518,55,0,0,65,9,69,0,2716
"39113040203",2271,113,31,0,115,13,0,0,2543
"39113040204",4061,367,314,13,40,30,9,2,4836
"39113040302",4419,297,330,417,110,9,97,43,5722
"39113040303",4452,45,9,0,270,194,80,159,5209
"39113040305",2410,20,40,0,321,0,92,0,2883
"39113040306",4116,106,405,0,377,0,79,0,5083
"39113040401",4346,199,102,6,267,24,34,0,4978
"39113040403",3274,243,126,0,302,0,98,0,4043
"39113040405",3575,628,624,76,653,29,90,11,5686
"39113040406",5378,114,264,2,668,0,33,0,6459
"39113050101",2931,263,170,217,137,23,41,0,3782
"39113050103",5059,622,794,118,1884,86,167,105,8835
"39113050104",1922,129,81,42,38,7,11,0,2230
"39113050105",3972,117,429,223,255,0,295,0,5291
"39113050301",2145,495,148,57,55,25,0,0,2925
"39113050302",4552,315,439,17,150,13,59,0,5545
"39113050303",2248,668,523,246,257,96,104,153,4295
"39113050401",4591,287,227,0,90,0,40,8,5243
"39113050402",1516,616,141,0,79,0,30,0,2382
"39113050502",2141,520,18,11,156,0,42,2,2890
"39113050503",5299,677,89,47,42,0,0,0,6154
"39113050504",4194,1026,281,0,303,0,31,0,5835
"39113050600",3474,539,23,0,34,16,18,11,4115
"39113060100",1436,246,920,285,46,0,0,0,2933
"39113060200",458,263,462,326,47,34,0,0,1590
"39113060300",183,44,1772,858,92,14,17,3,2983
"39113070101",1398,127,2366,597,213,45,214,0,4960
"39113070102",751,65,2182,204,77,59,5,0,3343
"39113070201",587,410,226,307,80,52,11,0,1673
"39113070202",67,55,1199,374,44,16,0,5,1760
"39113070300",396,120,1414,372,110,139,109,149,2809
"39113070400",726,259,996,294,80,13,7,0,2375
"39113070500",682,44,2217,710,40,29,6,0,3728
"39113070600",14,13,1110,59,75,6,0,0,1277
"39113070700",570,164,1672,876,17,15,0,0,3314
"39113080100",1279,348,2400,1141,249,53,120,25,5615
"39113080200",1242,148,875,265,52,0,32,0,2614
"39113080300",355,224,1051,172,64,140,68,230,2304
"39113080400",1049,280,1076,470,347,84,100,5,3411
"39113080500",3684,478,561,1226,151,371,146,91,6708
"39113080600",1150,346,32,12,32,42,0,10,1624
"39113080700",1666,330,9,0,0,0,0,18,2023
"39113090302",4195,896,370,79,218,146,38,10,5952
"39113090303",2438,191,494,40,416,19,137,129,3864
"39113090304",4612,567,1027,57,775,0,87,0,7125
"39113090600",2329,1075,129,31,108,19,101,0,3792
"39113090700",1115,307,55,0,73,0,12,6,1568
"39113090800",1114,96,45,43,15,13,0,0,1326
"39113090900",3103,270,61,26,116,0,88,26,3690
"39113091000",1947,324,155,0,52,0,12,0,2490
"39113091100",2173,168,154,0,299,0,416,0,3210
"39113100101",4197,509,752,192,351,302,297,89,6689
"39113100102",4191,256,1171,0,168,54,40,0,5880
"39113100201",3138,303,705,33,240,0,145,0,4564
"39113100202",1573,89,444,206,296,47,140,0,2795
"39113100203",3781,467,421,4,420,10,314,18,5435
"39113100301",2577,243,380,1,609,85,75,0,3970
"39113100302",2294,449,187,0,122,0,193,0,3245
"39113100400",3288,358,472,81,366,76,177,0,4818
"39113110100",1202,23,0,0,65,0,0,0,1290
"39113110201",4032,164,199,0,140,0,82,0,4617
"39113110202",1859,204,534,53,162,16,9,0,2837
"39113115002",3010,246,52,0,174,0,51,0,3533
"39113115011",4181,850,142,35,432,85,37,74,5836
"39113115012",4280,239,618,94,179,30,12,0,5452
"39113120101",3879,200,738,26,467,4,27,0,5341
"39113120102",3235,385,981,77,77,50,70,0,4875
"39113120103",1582,109,649,29,212,29,96,10,2716
"39113125000",5934,112,9,82,86,0,136,0,6359
"39113125101",5341,318,606,38,531,272,0,0,7106
"39113125102",4928,665,570,0,124,19,35,16,6357
"39113130101",2423,110,0,0,27,0,12,0,2572
"39113130102",5548,510,0,21,73,29,69,0,6250
"39113140100",5312,575,0,0,82,0,0,0,5969
"39113150100",5673,353,0,0,128,0,5,0,6159
"39113160100",1951,146,0,0,0,0,0,0,2097
"39113165000",5596,443,0,0,246,0,52,0,6337
"39113165100",59,132,1302,986,0,13,0,39,2531
"39113165200",595,158,374,567,17,53,25,0,1789
"39113980000",0,0,0,0,0,0,0,0,0
"39115968800",3034,454,0,0,100,0,13,0,3601
"39115968900",2963,778,111,65,64,51,0,0,4032
"39115969000",3032,752,80,64,46,53,29,30,4086
"39115969100",2083,665,165,34,75,64,31,0,3117
"39117965000",3602,528,39,0,0,0,29,0,4198
"39117965100",3782,799,0,0,48,0,47,0,4676
"39117965200",5672,1004,40,16,130,22,37,66,6987
"39117965300",4746,840,0,3,202,23,0,0,5814
"39117965400",5392,795,30,22,52,0,5,0,6296
"39117965500",5760,625,0,0,140,0,186,0,6711
"39119911000",4329,673,0,0,59,0,0,20,5081
"39119911100",5411,401,13,0,84,17,55,0,5981
"39119911200",5872,658,168,11,251,56,0,0,7016
"39119911300",5272,382,48,25,77,29,3,0,5836
"39119911400",1826,969,194,229,169,237,37,17,3678
"39119911500",3484,772,131,64,20,70,13,32,4586
"39119911600",5294,435,331,0,237,0,24,0,6321
"39119911700",2219,588,71,12,114,39,17,0,3060
"39119911800",2240,587,146,9,13,29,11,0,3035
"39119911900",1860,815,39,140,125,22,0,0,3001
"39119912000",1887,989,16,114,47,0,14,9,3076
"39119912100",1571,1176,400,88,312,96,0,0,3643
"39119912200",2121,519,134,28,191,119,0,0,3112
"39119912300",3207,733,60,31,63,197,11,18,4320
"39119912400",3024,865,10,0,108,86,156,0,4249
"39119912500",3475,974,0,24,43,8,0,0,4524
"39119912600",2809,347,0,0,16,0,0,0,3172
"39119912700",4459,829,21,12,53,51,73,0,5498
"39119912800",4110,477,11,13,32,11,10,5,4669
"39121968300",3376,712,0,0,25,3,0,0,4116
"39121968400",4119,578,0,3,60,12,7,0,4779
"39121968500",2616,525,0,0,0,0,0,0,3141
"39123050100",620,31,7,3,10,0,38,0,709
"39123050201",1706,79,0,24,26,3,99,2,1939
"39123050202",1627,40,53,2,21,2,62,2,1809
"39123050301",2579,143,41,17,0,0,25,0,2805
"39123050302",2049,216,7,0,33,0,0,0,2305
"39123050500",2220,474,17,0,141,128,86,115,3181
"39123050600",2480,758,44,37,89,34,137,86,3665
"39123050700",3086,227,0,16,72,0,102,0,3503
"39123050800",3729,334,0,0,8,28,79,108,4286
"39123050900",5158,271,4,46,83,32,158,86,5838
"39123051000",4124,548,0,15,223,77,249,32,5268
"39123051100",3269,333,0,4,98,0,191,0,3895
"39123051200",2589,541,15,23,63,0,11,181,3423
"39125960100",2676,241,25,0,37,0,54,13,3046
"39125960200",3672,592,8,0,107,22,270,2,4673
"39125960300",3361,443,14,17,113,9,108,24,4089
"39125960400",3187,513,41,48,152,109,149,158,4357
"39125960500",3096,613,3,0,73,21,23,18,3847
"39127965800",6469,434,0,0,85,8,83,0,7079
"39127965900",5736,1036,0,0,32,5,0,0,6809
"39127966000",3537,1379,0,0,93,83,19,0,5111
"39127966100",3703,1038,0,1,32,11,0,23,4808
"39127966200",4287,1242,9,0,43,221,31,33,5866
"39127966300",4614,1509,37,0,34,24,18,0,6236
"39129020100",1159,364,72,7,42,18,0,0,1662
"39129020200",2013,583,26,5,3,0,0,0,2630
"39129020310",3794,668,77,2,230,6,82,0,4859
"39129020320",2561,619,4,7,43,0,10,0,3244
"39129020400",1931,336,13,55,80,10,0,0,2425
"39129021100",7092,720,1,1,60,0,87,0,7961
"39129021200",5844,1230,7,40,319,118,108,114,7780
"39129021300",0,0,0,0,0,0,0,0,0
"39129021401",3055,286,0,0,27,6,0,0,3374
"39129021402",5746,368,3,11,225,5,32,0,6390
"39129021500",3050,202,0,0,35,11,17,0,3315
"39129021600",2857,378,0,0,12,4,25,1,3277
"39129021700",4010,750,26,19,5,0,22,0,4832
"39131952200",4281,1867,161,0,94,43,0,7,6453
"39131952300",3463,1012,0,0,85,44,80,19,4703
"39131952400",2554,492,33,2,48,10,0,0,3139
"39131952500",2839,963,0,5,0,5,0,40,3852
"39131952600",4070,1350,0,0,178,0,72,0,5670
"39131952700",3409,800,0,0,198,0,0,0,4407
"39133600102",2461,163,12,7,14,20,47,5,2729
"39133600103",5203,567,13,0,64,36,58,43,5984
"39133600200",5205,643,0,1,91,48,95,31,6114
"39133600301",6930,479,634,42,456,58,17,94,8710
"39133600302",5855,165,198,23,373,0,66,0,6680
"39133600401",4993,297,685,47,294,6,115,0,6437
"39133600402",4378,443,69,58,114,0,94,0,5156
"39133600403",3939,324,204,27,148,0,132,0,4774
"39133600500",4559,713,0,0,0,0,0,0,5272
"39133600602",2476,336,0,0,6,0,0,0,2818
"39133600603",2592,977,6,55,19,75,37,9,3770
"39133600703",1427,357,0,0,0,0,47,26,1857
"39133600704",1642,185,0,0,14,0,14,0,1855
"39133600705",2356,114,0,0,118,0,68,0,2656
"39133600706",2589,207,93,2,22,0,27,0,2940
"39133600800",2369,628,66,13,128,82,9,22,3317
"39133600901",2324,1001,202,112,26,135,57,0,3857
"39133600902",4173,891,9,95,200,44,55,48,5515
"39133601000",1513,488,270,64,125,108,0,60,2628
"39133601100",4698,800,53,0,10,9,10,0,5580
"39133601200",3146,1171,168,148,265,106,94,21,5119
"39133601300",5433,1041,391,471,282,506,72,0,8196
"39133601400",3298,1062,126,343,155,120,89,81,5274
"39133601501",1196,1206,35,34,69,84,5,0,2629
"39133601502",426,796,129,53,55,208,0,43,1710
"39133601503",2336,1607,167,182,195,294,0,92,4873
"39133601600",3162,400,17,0,213,26,28,9,3855
"39133601701",4164,1027,140,87,217,169,31,0,5835
"39133601702",5019,588,68,0,172,35,69,0,5951
"39133601801",3595,344,17,15,64,0,10,0,4045
"39133601802",3903,229,0,0,9,0,1,0,4142
"39133601901",2530,175,0,0,17,0,185,0,2907
"39133601902",2418,391,0,0,0,0,82,0,2891
"39133602000",4787,426,0,0,37,29,0,0,5279
"39133602100",6334,878,18,0,32,0,0,0,7262
"39135400100",2602,515,32,0,32,11,34,0,3226
"39135410100",1920,278,0,10,23,0,0,0,2231
"39135420100",4039,370,0,4,56,29,0,0,4498
"39135430100",2572,169,6,0,29,0,13,0,2789
"39135440100",3290,449,0,0,41,60,8,11,3859
"39135450100",1856,86,0,0,17,52,0,0,2011
"39135455001",1774,488,6,7,79,25,0,26,2405
"39135455002",4211,1074,0,30,85,0,71,0,5471
"39135460100",2743,179,14,0,47,28,0,46,3057
"39135470101",3359,145,0,0,73,0,0,0,3577
"39135470102",3439,656,27,0,41,36,0,10,4209
"39135480100",3940,367,20,0,21,1,27,0,4376
"39137030100",3575,376,0,8,379,134,599,181,5252
"39137030200",5334,318,0,9,90,2,105,5,5863
"39137030300",6748,480,0,0,402,14,566,80,8290
"39137030400",2745,246,13,44,96,10,58,149,3361
"39137030500",3490,205,0,0,47,14,125,4,3885
"39137030600",4216,310,0,1,19,0,0,0,4546
"39137030700",4395,171,3,0,37,0,25,0,4631
"39139000400",1496,407,448,55,97,54,18,0,2575
"39139000500",2050,770,395,316,26,45,21,0,3623
"39139000600",1016,819,605,427,122,222,75,4,3290
"39139000700",758,441,1018,612,13,75,0,0,2917
"39139000800",1915,646,129,0,72,32,37,6,2837
"39139000900",3526,717,19,2,95,11,62,0,4432
"39139001000",3202,912,142,193,157,133,0,101,4840
"39139001100",2542,239,88,12,20,0,33,0,2934
"39139001200",2885,416,83,83,95,0,36,0,3598
"39139001300",2431,535,212,88,78,14,66,0,3424
"39139001400",1281,360,157,135,5,190,60,28,2216
"39139001500",1258,495,5,67,11,137,4,5,1982
"39139001600",1274,650,12,0,14,62,0,25,2037
"39139001700",243,13,13,0,0,0,0,0,269
"39139001800",2524,463,163,69,181,35,18,49,3502
"39139001900",5220,608,71,0,112,12,82,0,6105
"39139002000",4866,362,0,0,55,0,0,0,5283
"39139002101",3709,370,912,0,396,32,23,0,5442
"39139002102",4273,215,99,0,61,0,0,0,4648
"39139002200",5916,655,61,0,134,135,54,0,6955
"39139002300",5034,439,121,16,244,0,108,0,5962
"39139002400",4815,313,49,0,555,0,138,0,5870
"39139002500",3601,482,0,0,6,0,0,0,4089
"39139002600",4040,609,0,0,57,0,138,0,4844
"39139002700",4500,344,38,0,0,9,0,65,4956
"39139002800",3386,412,0,0,3,0,35,0,3836
"39139002900",3918,562,0,0,18,35,14,35,4582
"39139003001",4645,490,13,0,10,0,48,0,5206
"39139003002",2892,389,17,0,85,84,0,0,3467
"39139003100",474,443,530,184,64,94,31,41,1861
"39141955500",4982,780,0,2,225,50,116,20,6175
"39141955601",1953,276,26,0,63,12,0,0,2330
"39141955602",195,61,8,0,26,0,13,0,303
"39141955603",3158,811,2,3,54,30,2,0,4060
"39141955700",4424,1047,52,2,369,0,75,0,5969
"39141955800",5652,1269,45,3,143,57,4,0,7173
"39141955900",3537,234,129,17,244,9,68,0,4238
"39141956000",3410,1249,52,33,192,130,27,80,5173
"39141956100",2368,469,171,55,77,22,11,0,3173
"39141956200",1641,446,116,148,100,47,35,0,2533
"39141956300",2059,498,64,10,16,127,28,9,2811
"39141956400",2136,950,56,59,32,52,0,3,3288
"39141956500",2244,1298,66,63,193,181,62,4,4111
"39141956600",4625,630,10,0,63,78,2,0,5408
"39141956700",3591,580,43,14,241,64,47,0,4580
"39141956800",4610,1225,43,0,102,160,0,0,6140
"39141956900",3561,802,21,0,217,44,9,0,4654
"39143960800",3129,333,0,0,53,12,55,12,3594
"39143960900",2914,438,14,1,64,3,107,34,3575
"39143961000",3454,371,5,5,139,86,213,26,4299
"39143961100",3505,352,0,2,197,59,322,10,4447
"39143961200",3487,225,34,34,22,0,33,57,3892
"39143961300",3597,379,119,51,92,52,292,281,4863
"39143961400",1871,598,196,42,178,135,505,151,3676
"39143961500",2731,496,306,136,391,0,679,232,4971
"39143961600",1883,669,148,86,71,0,114,29,3000
"39143961700",2170,313,97,49,300,201,559,158,3847
"39143961800",2888,547,95,248,417,75,470,230,4970
"39143961900",3096,406,2,16,96,43,165,78,3902
"39143962000",5030,928,0,0,311,0,404,73,6746
"39143962100",4191,513,14,0,54,0,39,7,4818
"39143962200",3569,566,0,8,65,0,89,7,4304
"39145002100",3982,713,8,0,91,10,0,10,4814
"39145002200",2765,999,0,0,62,0,0,0,3826
"39145002300",2913,1457,0,0,118,0,0,0,4488
"39145002400",4423,1337,0,0,22,73,15,70,5940
"39145002500",2359,553,0,0,32,0,0,0,2944
"39145002600",3366,875,22,0,26,3,18,25,4335
"39145002700",4688,294,0,1,164,3,0,2,5152
"39145002800",3004,1107,0,0,90,35,0,2,4238
"39145002900",4720,1265,54,0,0,0,109,0,6148
"39145003000",2306,846,0,0,21,49,0,0,3222
"39145003100",2407,1086,0,0,75,12,50,34,3664
"39145003200",1115,883,9,15,81,0,0,0,2103
"39145003300",1707,413,70,1,300,13,0,0,2504
"39145003400",1992,745,165,23,35,95,0,38,3093
"39145003500",1215,1175,0,0,75,9,75,4,2553
"39145003600",649,802,104,21,22,35,0,0,1633
"39145003700",1487,622,465,151,70,63,80,12,2950
"39145003800",3803,625,24,46,170,0,140,0,4808
"39145003900",2564,456,0,0,182,5,0,0,3207
"39145004000",3527,610,0,0,91,5,62,25,4320
"39147962500",2992,447,56,31,70,4,34,7,3641
"39147962600",3847,337,0,0,46,73,126,83,4512
"39147962700",3066,228,0,7,53,24,128,12,3518
"39147962800",2412,611,231,16,248,11,329,101,3959
"39147962900",2407,989,210,81,157,125,314,26,4309
"39147963000",2368,515,34,226,150,19,192,71,3575
"39147963100",4045,297,0,7,5,2,5,7,4368
"39147963200",3237,757,0,1,21,0,121,0,4137
"39147963300",2627,603,21,0,47,54,56,185,3593
"39147963400",2813,954,11,48,42,0,169,26,4063
"39147963500",2884,289,13,15,31,146,0,0,3378
"39147963600",3601,432,0,1,36,60,155,110,4395
"39147963700",3774,346,0,0,194,0,137,64,4515
"39147963800",3464,511,0,0,51,18,42,0,4086
"39149971400",4014,299,0,0,36,7,26,0,4382
"39149971500",4875,346,11,12,161,38,23,13,5479
"39149971600",4375,369,0,0,2,0,21,4,4771
"39149971700",3799,460,27,5,10,0,45,0,4346
"39149971800",3877,1326,90,64,218,0,102,66,5743
"39149971900",3499,493,79,41,194,45,132,0,4483
"39149972000",2158,754,343,49,93,37,101,19,3554
"39149972100",4872,438,324,0,114,12,11,12,5783
"39149972200",4504,539,0,0,262,0,64,20,5389
"39149972300",4958,207,0,0,143,2,20,0,5330
"39151700100",386,321,130,194,13,24,0,8,1076
"39151700200",2681,1091,1595,317,347,86,208,7,6332
"39151700300",848,623,422,468,8,250,6,13,2638
"39151700400",3051,653,673,130,211,12,37,0,4767
"39151700500",871,720,647,256,158,304,18,81,3055
"39151700600",1571,328,432,355,43,36,90,8,2863
"39151700700",4600,578,251,70,179,14,307,60,6059
"39151700800",2080,488,537,427,173,151,54,29,3939
"39151701000",1731,750,249,416,216,258,0,245,3865
"39151701100",2179,570,289,18,165,102,20,53,3396
"39151701200",2333,595,115,297,28,19,24,0,3411
"39151701300",2194,944,218,331,223,476,30,30,4446
"39151701500",1204,937,494,90,188,119,60,0,3092
"39151701700",1394,876,250,501,24,135,166,14,3360
"39151701800",447,323,560,655,40,137,0,13,2175
"39151702100",297,626,1758,567,156,118,32,3,3557
"39151702300",388,819,779,1006,0,281,0,80,3353
"39151702500",1875,794,109,148,194,87,119,7,3333
"39151710200",2779,933,408,237,75,122,8,147,4709
"39151710300",2034,660,197,153,140,15,137,27,3363
"39151710400",120,659,65,62,0,38,0,0,944
"39151710500",2181,1213,500,236,169,63,11,33,4406
"39151710600",3903,700,157,5,131,0,187,0,5083
"39151710700",2062,115,155,0,37,0,23,0,2392
"39151710800",3942,879,133,18,52,2,73,0,5099
"39151710900",3922,212,65,39,54,64,3,0,4359
"39151711000",6282,546,43,5,203,16,5,0,7100
"39151711111",4548,328,10,0,21,0,126,0,5033
"39151711112",5245,84,0,0,85,0,12,0,5426
"39151711121",6122,84,74,0,272,0,173,0,6725
"39151711122",4810,604,34,0,338,0,52,61,5899
"39151711202",3934,192,0,0,96,0,14,0,4236
"39151711211",5711,591,19,12,127,8,8,8,6484
"39151711212",2328,356,0,0,33,43,0,0,2760
"39151711311",7115,281,84,1,496,19,190,0,8186
"39151711312",6320,475,28,0,276,0,168,9,7276
"39151711321",3385,233,189,0,106,0,118,0,4031
"39151711322",2455,268,131,0,91,13,0,6,2964
"39151711402",5328,445,206,64,424,3,38,2,6510
"39151711411",3624,17,0,1,159,18,0,0,3819
"39151711412",3946,270,45,3,108,156,22,0,4550
"39151711501",3248,275,70,1,116,117,50,11,3888
"39151711502",2940,161,81,0,197,1,51,13,3444
"39151711600",4818,685,52,3,126,0,34,10,5728
"39151711700",3979,546,168,47,143,282,75,29,5269
"39151711800",4554,398,20,26,49,0,73,94,5214
"39151711900",4239,255,24,47,196,0,19,0,4780
"39151712000",3580,281,10,0,50,0,52,0,3973
"39151712102",5890,756,140,39,546,35,24,128,7558
"39151712111",5594,225,35,0,18,64,83,0,6019
"39151712112",1709,58,0,26,0,0,29,0,1822
"39151712201",4472,478,130,239,80,23,19,30,5471
"39151712202",5209,267,187,0,134,0,16,0,5813
"39151712300",4473,587,549,56,127,0,131,0,5923
"39151712400",4942,687,321,406,160,17,0,6,6539
"39151712500",1774,81,0,0,25,0,3,4,1887
"39151712601",2084,251,0,0,35,0,11,0,2381
"39151712602",4227,330,0,0,31,36,59,0,4683
"39151712700",4989,340,0,0,20,0,35,0,5384
"39151712800",4273,330,0,0,91,0,45,0,4739
"39151712900",3388,462,0,0,46,17,38,30,3981
"39151713000",3204,335,38,0,220,39,92,41,3969
"39151713100",4512,559,301,85,162,171,59,21,5870
"39151713201",5939,872,273,3,127,54,50,0,7318
"39151713202",1997,98,29,0,16,2,6,2,2150
"39151713300",3746,576,108,29,147,0,120,7,4733
"39151713401",4706,301,0,1,212,38,37,0,5295
"39151713402",3650,598,96,0,23,0,50,0,4417
"39151713501",4451,367,94,19,98,1,39,0,5069
"39151713502",4302,746,54,97,27,0,8,76,5310
"39151713600",1954,209,56,15,31,4,9,0,2278
"39151713700",1624,244,116,83,100,28,0,0,2195
"39151713900",1578,543,23,0,9,0,0,107,2260
"39151714000",3379,490,61,0,58,16,13,0,4017
"39151714100",2501,893,97,95,0,11,101,29,3727
"39151714200",959,840,583,202,135,72,10,32,2833
"39151714302",3092,412,218,199,37,0,76,18,4052
"39151714400",2471,358,329,8,117,96,32,120,3531
"39151714600",3651,282,23,0,138,0,30,0,4124
"39151714701",5339,505,25,57,0,18,22,0,5966
"39151714702",2593,237,0,0,31,0,0,0,2861
"39151714801",5551,670,8,0,98,15,54,9,6405
"39151714802",2404,341,0,0,2,34,0,0,2781
"39151714901",3509,360,0,0,78,11,4,11,3973
"39151714902",3036,350,81,63,46,66,17,0,3659
"39151715000",2068,505,170,37,47,0,127,0,2954
"39153501100",395,114,323,274,32,7,0,0,1145
"39153501700",297,664,128,252,126,15,47,19,1548
"39153501800",31,8,496,309,0,0,9,0,853
"39153501900",159,554,653,875,152,98,0,141,2632
"39153502101",1368,461,578,185,244,148,124,0,3108
"39153502102",2378,558,721,276,200,28,37,23,4221
"39153502200",2815,1094,495,491,830,255,66,265,6311
"39153502300",2235,541,1131,570,255,120,0,0,4852
"39153502500",292,228,80,251,25,83,16,0,975
"39153502600",1654,565,408,146,87,161,15,15,3051
"39153502700",4899,479,463,646,139,87,41,14,6768
"39153502800",3414,475,254,19,111,28,58,0,4359
"39153503100",684,482,188,340,306,164,0,23,2187
"39153503200",391,222,640,492,166,193,50,20,2174
"39153503300",2300,744,781,878,402,152,0,20,5277
"39153503400",57,42,664,460,4,6,0,11,1244
"39153503500",791,668,780,934,277,120,12,213,3795
"39153503600",3565,356,90,11,240,71,0,0,4333
"39153503701",4985,566,76,222,74,0,142,0,6065
"39153503702",5083,819,44,1,85,14,35,1,6082
"39153503800",1800,519,255,905,110,147,44,80,3860
"39153504100",179,459,23,312,133,28,0,0,1134
"39153504200",511,740,393,227,53,51,38,14,2027
"39153504400",371,263,388,348,11,39,4,0,1424
"39153504500",700,426,378,482,171,0,71,131,2359
"39153504600",1240,654,728,521,87,244,60,0,3534
"39153504700",3382,362,452,247,269,66,75,10,4863
"39153504800",3503,444,177,60,325,59,0,0,4568
"39153505200",379,67,522,258,77,31,40,17,1391
"39153505300",270,162,345,644,83,100,69,0,1673
"39153505400",2332,663,159,156,16,57,22,0,3405
"39153505500",1945,293,299,73,79,0,74,0,2763
"39153505600",393,405,140,336,79,65,10,16,1444
"39153505700",1333,922,34,268,126,52,57,12,2804
"39153505800",3327,594,289,54,188,420,301,0,5173
"39153505900",2091,482,51,13,78,22,0,0,2737
"39153506100",2821,545,1638,578,82,105,0,0,5769
"39153506200",381,133,2343,769,223,77,8,30,3964
"39153506400",1360,608,302,444,52,119,10,0,2895
"39153506500",224,82,1309,921,86,24,0,0,2646
"39153506600",1036,460,520,588,63,99,39,24,2829
"39153506700",8,8,742,468,22,18,0,17,1283
"39153506800",137,135,520,508,0,17,20,36,1373
"39153507101",2841,131,939,440,88,44,106,0,4589
"39153507102",2137,194,188,11,124,0,36,0,2690
"39153507201",1767,178,337,148,148,0,7,0,2585
"39153507202",2662,351,245,10,116,32,52,15,3483
"39153507203",3510,276,674,38,247,217,174,0,5136
"39153507300",1991,342,349,28,62,41,0,0,2813
"39153507400",233,106,313,102,31,98,0,0,883
"39153507500",2510,727,1920,961,249,143,225,42,6777
"39153507600",2843,573,243,176,75,191,217,0,4318
"39153508000",3155,467,857,119,134,67,242,138,5179
"39153508301",299,618,181,622,13,167,28,18,1946
"39153508399",1110,507,2280,826,114,35,7,0,4879
"39153508600",106,99,2108,657,66,82,8,0,3126
"39153508800",193,263,3813,1690,71,0,5,0,6035
"39153508900",572,1060,230,164,292,254,0,0,2572
"39153509000",427,229,567,426,122,42,0,0,1813
"39153510100",1715,735,74,55,59,157,51,0,2846
"39153510200",3352,636,0,88,106,32,11,38,4263
"39153510301",2130,1061,838,184,88,278,131,132,4842
"39153510302",5099,966,85,64,30,0,102,0,6346
"39153510400",3535,330,24,8,28,10,0,0,3935
"39153510500",3341,796,17,0,123,0,101,0,4378
"39153520103",1382,169,90,15,80,0,0,4,1740
"39153520104",3489,672,25,161,91,12,96,0,4546
"39153520105",3641,707,104,6,13,0,21,29,4521
"39153520106",1910,404,96,0,191,0,37,0,2638
"39153520201",2722,72,0,2,85,6,32,7,2926
"39153520202",3887,535,106,5,29,4,0,4,4570
"39153520301",3028,449,34,27,32,0,72,0,3642
"39153520302",3223,181,50,0,28,0,42,0,3524
"39153520400",4271,344,0,0,63,104,240,70,5092
"39153520500",3982,323,37,25,38,48,65,13,4531
"39153520600",3030,375,29,0,41,50,88,50,3663
"39153530101",4404,14,531,0,411,0,58,0,5418
"39153530103",3464,41,812,0,355,0,28,0,4700
"39153530104",5478,240,927,40,301,47,29,0,7062
"39153530105",917,241,288,434,101,124,15,0,2120
"39153530108",3216,53,916,0,372,85,25,0,4667
"39153530401",2959,114,120,28,73,33,0,18,3345
"39153530402",2852,275,15,41,93,31,119,0,3426
"39153530501",4250,792,80,14,251,172,49,64,5672
"39153530502",2914,218,20,22,138,18,44,0,3374
"39153530603",3878,357,23,1,282,6,44,0,4591
"39153530604",2941,154,130,2,169,0,34,0,3430
"39153530605",4758,147,0,17,235,19,62,0,5238
"39153530606",5449,143,44,0,78,0,47,0,5761
"39153530700",2386,77,0,2,50,0,12,0,2527
"39153530800",6208,125,80,0,294,0,113,0,6820
"39153530901",3120,475,137,323,129,150,0,0,4334
"39153530902",5075,532,51,0,37,16,27,0,5738
"39153530903",4816,192,20,9,161,9,63,9,5279
"39153531001",2926,501,1,0,90,1,36,0,3555
"39153531002",4708,662,33,2,103,0,36,0,5544
"39153531101",2882,192,10,0,117,3,27,0,3231
"39153531102",3689,458,140,0,97,0,28,0,4412
"39153531103",2649,330,65,2,177,0,76,41,3340
"39153531401",6780,238,19,0,128,1,36,1,7203
"39153531405",3682,499,74,0,60,46,0,0,4361
"39153531500",7206,327,47,3,379,91,103,2,8158
"39153531601",3843,435,0,20,87,17,0,0,4402
"39153531602",2962,13,0,0,57,0,0,0,3032
"39153531701",3275,192,49,0,30,4,55,0,3605
"39153531702",4028,386,0,0,7,0,33,0,4454
"39153531801",4550,672,27,1,47,9,46,1,5353
"39153531802",3598,409,471,10,188,61,0,0,4737
"39153532001",3341,233,101,0,22,0,61,8,3766
"39153532003",4166,266,0,1,25,0,12,0,4470
"39153532004",3488,235,115,11,27,0,71,0,3947
"39153532202",4598,121,723,31,299,0,37,0,5809
"39153532301",5146,200,147,10,201,0,168,0,5872
"39153532302",4870,126,217,13,148,0,15,0,5389
"39153532501",2672,162,97,14,0,40,37,0,3022
"39153532502",2877,24,10,0,58,1,22,0,2992
"39153532600",2607,210,50,0,74,0,33,0,2974
"39153532701",5352,77,1180,22,439,0,61,0,7131
"39153532702",2905,127,41,8,500,81,74,0,3736
"39153532703",4504,284,578,140,296,0,232,0,6034
"39153532705",5996,241,379,72,247,71,141,11,7158
"39153532706",3466,76,120,0,32,0,106,0,3800
"39153532708",4613,34,621,0,173,0,38,0,5479
"39153532901",1391,60,17,0,43,0,50,0,1561
"39153532902",5851,916,385,208,404,37,102,0,7903
"39153532999",4535,761,243,47,225,97,28,0,5936
"39153533000",1397,182,0,1,17,0,0,0,1597
"39153533101",4568,186,0,0,166,9,81,0,5010
"39153533102",2343,79,42,17,133,21,146,0,2781
"39153533200",4637,132,128,7,332,26,0,0,5262
"39153533400",4259,333,1070,60,217,9,118,0,6066
"39153533501",6106,248,476,0,1242,12,186,0,8270
"39153533502",3361,195,205,7,79,0,81,0,3928
"39153534000",5766,196,87,0,544,23,31,0,6647
"39153534100",2441,47,0,0,159,65,38,65,2815
"39155920300",2317,303,162,16,33,58,11,9,2909
"39155920400",1450,455,157,230,26,78,23,0,2419
"39155920500",176,74,225,296,0,0,0,0,771
"39155920600",522,732,650,1277,0,164,0,80,3425
"39155920700",1699,440,525,554,131,17,74,18,3458
"39155920800",723,521,367,262,38,123,0,82,2116
"39155920900",1322,498,921,746,162,37,0,0,3686
"39155921000",2557,267,1532,494,156,199,0,0,5205
"39155921100",2293,890,256,355,65,109,0,13,3981
"39155921200",1068,501,164,224,40,33,29,127,2186
"39155921300",1680,376,137,8,0,0,0,82,2283
"39155921400",2827,365,129,18,30,0,35,0,3404
"39155921500",4158,551,194,186,20,53,133,26,5321
"39155921600",1897,1571,648,352,83,132,52,34,4769
"39155930101",2377,537,17,12,73,26,0,0,3042
"39155930102",2222,238,0,0,6,0,76,0,2542
"39155930200",2437,238,0,0,0,14,0,0,2689
"39155930300",3434,299,0,0,37,8,43,0,3821
"39155930400",3838,257,9,22,17,0,66,0,4209
"39155930500",4638,1283,71,9,38,4,87,10,6140
"39155930600",3353,304,9,20,0,0,0,0,3686
"39155930700",3857,409,43,0,0,10,101,0,4420
"39155930800",4095,407,62,20,101,0,46,0,4731
"39155930900",6509,507,99,0,100,52,8,13,7288
"39155931000",4949,474,67,9,249,0,0,0,5748
"39155931100",2069,214,8,0,49,0,0,0,2340
"39155931200",3259,601,29,12,50,2,0,104,4057
"39155931300",3840,307,45,4,7,0,35,0,4238
"39155931400",3102,942,186,111,64,0,0,0,4405
"39155931500",3555,228,0,0,73,18,44,0,3918
"39155931601",3414,669,18,36,132,74,107,0,4450
"39155931602",2997,254,10,0,29,0,47,0,3337
"39155931700",1613,188,81,4,7,0,63,0,1956
"39155931900",3821,470,1062,439,190,0,53,0,6035
"39155932000",4974,398,274,63,189,0,0,0,5898
"39155932200",1927,466,92,41,15,235,21,65,2862
"39155932300",4796,491,37,2,42,41,204,19,5632
"39155932500",2533,661,8,0,0,0,31,73,3306
"39155932600",2799,416,40,41,99,26,15,0,3436
"39155932701",4477,995,28,230,59,99,0,41,5929
"39155932702",2048,469,167,9,76,16,22,7,2814
"39155932801",1904,691,110,36,61,0,15,62,2879
"39155932802",2928,530,0,10,29,43,0,0,3540
"39155932900",1722,260,41,0,98,0,27,43,2191
"39155933001",5498,369,0,0,106,0,83,0,6056
"39155933002",3361,285,116,69,149,11,21,18,4030
"39155933100",2055,285,66,0,46,0,18,0,2470
"39155933301",1908,552,15,0,54,0,8,0,2537
"39155933302",4008,439,23,0,7,0,23,0,4500
"39155933400",2973,338,26,0,35,18,11,0,3401
"39155933500",3409,280,13,0,155,26,58,0,3941
"39155933600",3822,1055,14,0,43,15,30,81,5060
"39155933700",2390,278,38,38,0,0,2,80,2826
"39155933800",1318,728,262,198,42,141,0,38,2727
"39155933900",1488,734,9,136,68,8,6,0,2449
"39157020100",4921,374,0,5,35,6,90,15,5446
"39157020200",3294,331,7,0,50,35,206,0,3923
"39157020300",3427,151,2,2,25,1,0,0,3608
"39157020400",4282,1105,0,0,66,0,0,0,5453
"39157020500",4692,380,0,0,89,0,48,60,5269
"39157020600",4492,269,35,0,97,2,11,0,4906
"39157020700",4977,1477,0,46,106,29,232,293,7160
"39157020800",4296,950,54,10,112,190,227,190,6029
"39157020900",3145,567,71,34,136,167,39,81,4240
"39157021000",3902,769,8,0,0,0,66,0,4745
"39157021100",1801,451,22,44,0,10,59,5,2392
"39157021200",2496,362,8,0,58,0,95,0,3019
"39157021300",4350,246,0,0,50,0,26,0,4672
"39157021400",2040,180,0,0,93,0,0,0,2313
"39157021500",6838,542,0,1,106,5,0,0,7492
"39157021600",3792,695,80,15,56,12,25,14,4689
"39157021700",3919,974,44,233,123,25,0,29,5347
"39157021800",2160,734,0,0,27,0,0,0,2921
"39157021900",2353,198,0,1,0,0,0,0,2552
"39157022001",2801,574,8,2,27,0,0,0,3412
"39157022002",2401,1050,0,0,19,49,0,23,3542
"39159050100",3655,285,0,0,29,5,51,5,4030
"39159050200",3697,647,5,2,156,0,22,0,4529
"39159050301",3437,127,0,0,17,0,0,0,3581
"39159050303",5653,308,114,0,315,0,0,16,6406
"39159050304",2286,128,28,0,10,0,0,0,2452
"39159050400",5827,494,0,1,348,0,138,18,6826
"39159050500",3744,857,0,16,329,34,0,0,4980
"39159050601",3804,183,136,0,747,0,87,0,4957
"39159050602",3205,423,26,0,428,33,107,0,4222
"39159050700",7289,229,1,70,23,2,107,4,7725
"39161020100",3538,150,4,0,61,0,246,8,4007
"39161020200",4079,339,0,43,89,20,45,0,4615
"39161020300",2467,223,0,0,8,15,12,0,2725
"39161020400",2685,277,5,0,21,8,7,8,3011
"39161020500",2821,358,0,0,39,0,0,35,3253
"39161020600",1197,421,7,62,95,17,109,11,1919
"39161020700",1355,343,0,4,36,29,43,0,1810
"39161020800",3096,876,46,19,56,5,96,70,4264
"39161020900",2815,268,55,5,51,27,52,6,3279
"39163953000",4543,873,0,0,104,42,0,0,5562
"39163953100",3666,982,0,0,147,55,1,0,4851
"39163953200",2052,781,0,0,10,4,0,0,2847
"39165030101",4093,47,0,0,63,0,13,0,4216
"39165030102",3316,356,0,0,74,8,21,1,3776
"39165030200",957,192,0,0,35,13,32,8,1237
"39165030501",3008,369,0,22,166,9,0,9,3583
"39165030503",4411,434,25,0,343,9,22,13,5257
"39165030504",4547,83,29,0,234,0,94,0,4987
"39165030600",3444,328,0,0,93,26,10,14,3915
"39165030700",5860,146,71,140,204,0,207,55,6683
"39165030800",6346,82,40,10,176,0,121,0,6775
"39165030900",11626,108,622,0,607,0,196,0,13159
"39165031000",7493,554,3,0,139,44,62,38,8333
"39165031100",3253,242,0,17,127,71,94,0,3804
"39165031200",7613,274,28,2,181,0,198,0,8296
"39165031300",4333,300,0,0,145,0,135,43,4956
"39165031400",3094,899,272,325,99,61,22,0,4772
"39165031500",3775,789,273,1,71,104,48,260,5321
"39165031600",7110,546,209,2,143,0,0,0,8010
"39165031700",0,0,0,0,0,0,0,0,0
"39165031902",7860,390,642,0,1099,71,312,26,10400
"39165031903",13198,309,624,0,2910,28,836,0,17905
"39165031904",4997,379,112,20,708,0,0,0,6216
"39165032003",6097,285,87,0,331,0,135,0,6935
"39165032004",4778,12,274,22,948,0,141,0,6175
"39165032005",6841,172,463,0,2224,0,213,0,9913
"39165032006",3240,155,37,18,177,0,175,46,3848
"39165032007",5603,424,104,1,458,16,319,2,6927
"39165032100",5076,667,77,4,186,0,262,0,6272
"39165032201",17172,1273,319,2,246,0,246,81,19339
"39165032202",5115,368,36,0,153,0,83,0,5755
"39165032300",4023,316,6,4,62,0,30,0,4441
"39165032400",4493,248,1,0,27,2,54,0,4825
"39165032501",3000,588,21,0,57,0,64,0,3730
"39165032502",3516,787,0,14,15,0,15,0,4347
"39167020101",3071,513,96,21,92,19,48,22,3882
"39167020102",1463,689,0,23,18,1,0,0,2194
"39167020200",5508,977,0,0,125,71,0,0,6681
"39167020300",3194,361,0,0,76,0,114,0,3745
"39167020400",1749,324,24,0,0,7,0,0,2104
"39167020500",1035,487,7,0,23,33,0,0,1585
"39167020800",2886,798,13,0,116,0,42,44,3899
"39167020900",2030,281,0,0,37,17,0,37,2402
"39167021000",2417,933,76,0,116,122,0,52,3716
"39167021100",3182,639,13,1,141,65,0,0,4041
"39167021200",4843,1000,0,0,11,4,23,8,5889
"39167021300",4077,498,0,0,93,13,3,4,4688
"39167021400",3401,313,0,0,131,14,95,0,3954
"39167021500",1468,56,0,0,7,11,5,0,1547
"39167021600",3330,299,0,0,56,18,0,0,3703
"39167021700",5435,466,52,14,118,36,0,0,6121
"39169000100",2411,482,99,82,151,145,37,8,3415
"39169000200",2453,117,3,0,223,0,28,0,2824
"39169000300",1870,382,26,21,19,31,23,0,2372
"39169000500",2447,525,32,44,94,17,171,29,3359
"39169000600",4367,972,38,37,32,12,24,17,5499
"39169000700",6005,477,24,0,156,0,78,16,6756
"39169000800",5165,1126,173,22,380,0,67,0,6933
"39169000900",3348,371,31,0,118,0,15,0,3883
"39169001000",2193,212,25,12,15,157,0,33,2647
"39169001100",1261,89,47,0,0,0,21,7,1425
"39169001200",955,312,119,13,8,42,13,0,1462
"39169001300",2934,939,98,20,97,39,32,43,4202
"39169001400",2268,694,64,70,14,30,166,159,3465
"39169001700",6296,1175,0,2,24,0,229,0,7726
"39169001800",3641,215,0,0,0,0,10,0,3866
"39169001900",2592,373,4,0,75,30,30,10,3114
"39169002000",2819,194,20,20,15,33,0,0,3101
"39169002100",2348,433,0,4,16,0,0,0,2801
"39169002200",3364,507,28,0,79,7,15,0,4000
"39169002300",2700,178,4,3,159,0,148,0,3192
"39169002400",3246,344,12,0,7,0,2,4,3615
"39169002500",2363,203,0,0,11,27,0,0,2604
"39169002901",3219,226,1,0,15,42,35,18,3556
"39169002902",4780,178,84,15,42,0,122,3,5224
"39169003000",2112,84,0,0,21,0,19,0,2236
"39169003100",2039,77,0,0,69,0,0,0,2185
"39169003200",3397,52,76,0,61,8,20,0,3614
"39169003300",2557,387,39,0,7,0,0,0,2990
"39169003400",2301,633,20,0,164,0,0,0,3118
"39169003500",3243,241,0,0,38,0,0,0,3522
"39169003700",3164,428,0,0,12,13,12,3,3632
"39169980000",104,113,0,0,0,0,0,0,217
"39171950100",4476,580,10,6,44,52,153,109,5430
"39171950200",3756,599,1,0,18,31,13,6,4424
"39171950300",3418,751,0,6,132,35,162,19,4523
"39171950400",4025,367,0,0,53,16,39,5,4505
"39171950500",2777,374,34,16,107,4,147,36,3495
"39171950600",3111,1198,16,0,139,92,290,121,4967
"39171950700",3586,307,30,8,101,16,168,0,4216
"39171950800",3025,279,0,0,52,0,30,0,3386
"39171950900",2466,252,27,5,42,0,65,10,2867
"39173020100",4709,467,0,0,65,48,219,0,5508
"39173020200",2512,110,184,0,40,88,93,0,3027
"39173020300",4217,347,28,0,166,38,186,28,5010
"39173020401",4569,379,68,0,96,10,104,0,5226
"39173020402",4436,173,251,4,592,0,123,12,5591
"39173020500",1981,147,51,8,56,69,0,21,2333
"39173020601",3542,202,101,0,355,0,248,68,4516
"39173020602",6016,145,91,0,715,0,359,0,7326
"39173020700",4956,1171,60,2,183,158,103,71,6704
"39173020800",3263,538,16,2,2,7,21,0,3849
"39173020900",5985,675,210,87,180,3,258,155,7553
"39173021000",3384,364,0,3,87,31,93,41,4003
"39173021100",3373,277,0,4,87,163,208,38,4150
"39173021200",5071,223,65,15,241,3,166,0,5784
"39173021300",2969,261,2,13,58,80,49,14,3446
"39173021400",2500,357,2,1,189,63,322,41,3475
"39173021500",2196,122,0,0,283,0,312,0,2913
"39173021600",5492,861,53,151,136,144,172,48,7057
"39173021701",1385,1606,42,11,54,62,46,21,3227
"39173021702",2839,1875,57,57,213,187,231,79,5538
"39173021800",48,100,0,0,3,23,14,1,189
"39173021901",3486,262,5,0,237,0,251,22,4263
"39173021902",2434,1958,131,365,251,210,381,202,5932
"39173022100",3340,782,3,0,99,27,179,112,4542
"39173022200",1773,549,49,3,33,0,37,69,2513
"39173022300",3353,270,7,14,157,69,103,38,4011
"39173022400",3123,357,0,0,181,16,190,21,3888
"39173022500",3077,637,121,118,74,45,159,37,4268
"39175938000",3613,281,1,1,9,39,46,23,4013
"39175938100",4169,353,33,9,147,0,110,0,4821
"39175938200",3376,276,0,2,39,0,106,0,3799
"39175938300",2969,553,1,0,28,15,0,0,3566
"39175938400",2459,511,0,0,47,11,66,109,3203
"39175938500",2588,398,11,0,176,6,61,9,3249
"40001376600",1401,247,0,0,839,240,64,26,2817
"40001376700",2114,716,31,0,1910,643,76,135,5625
"40001376800",1569,264,6,0,2102,603,35,43,4622
"40001376900",1070,625,0,26,1664,908,218,456,4967
"40001377000",1349,617,0,9,2197,945,113,76,5306
"40003955600",1049,164,0,0,104,6,31,18,1372
"40003955700",1187,147,0,0,77,30,59,0,1500
"40003956000",1536,188,3,2,80,55,15,5,1884
"40005587600",844,107,1,6,288,29,23,15,1313
"40005587700",1810,714,82,240,443,281,121,30,3721
"40005587800",2703,332,3,0,624,184,71,20,3937
"40005587900",2373,661,3,4,741,202,93,11,4088
"40007951600",1919,334,18,9,383,0,570,155,3388
"40007951700",1170,71,0,0,16,10,41,5,1313
"40007951800",1193,120,0,0,270,5,343,33,1964
"40009966100",5570,960,129,0,647,115,598,314,8333
"40009966200",5285,923,40,0,336,48,400,171,7203
"40009966500",1143,458,0,0,83,12,11,25,1732
"40009966800",3889,558,34,0,418,53,478,21,5451
"40011958600",1206,60,5,0,70,0,71,0,1412
"40011958700",1342,111,0,0,120,35,116,0,1724
"40011958800",1050,142,0,0,74,65,50,20,1401
"40011958900",1514,408,168,38,162,124,129,43,2586
"40011959000",1221,156,12,2,162,113,106,75,1847
"40013795600",1578,425,0,0,384,117,13,54,2571
"40013795700",2330,437,6,8,629,171,34,0,3615
"40013795900",1285,134,31,17,250,60,25,0,1802
"40013796001",3953,678,27,2,1074,246,193,213,6386
"40013796002",2867,341,54,0,1228,237,123,39,4889
"40013796100",5405,728,59,0,1404,311,308,15,8230
"40013796200",1984,396,45,89,508,249,251,32,3554
"40013796300",847,378,10,0,255,26,74,0,1590
"40013796400",793,776,7,0,391,356,209,67,2599
"40013796500",1409,187,16,0,390,171,0,15,2188
"40013796600",3457,888,220,66,1164,198,424,72,6489
"40015161600",3267,652,5,21,898,227,459,215,5744
"40015161700",1320,147,6,3,97,112,114,98,1897
"40015161800",1583,497,6,13,699,335,359,101,3593
"40015161900",995,172,18,14,326,261,35,28,1849
"40015162000",2028,136,10,0,752,90,87,34,3137
"40015162100",1858,728,142,133,2916,1457,440,584,8258
"40015162200",1680,58,4,21,793,278,150,48,3032
"40015162300",2088,309,27,2,411,24,56,51,2968
"40017300100",1856,330,9,60,178,175,35,31,2674
"40017300201",4703,233,43,0,537,4,252,2,5774
"40017300202",3260,265,66,54,517,116,240,47,4565
"40017300300",2348,373,0,2,782,221,681,205,4612
"40017300400",322,10,291,7,142,65,60,50,947
"40017300500",1763,412,140,28,825,115,437,123,3843
"40017300600",2689,297,0,0,455,82,206,28,3757
"40017300700",3008,534,37,3,730,134,126,3,4575
"40017300801",7203,93,476,0,1044,14,717,0,9547
"40017300802",2108,69,0,0,107,91,23,0,2398
"40017300901",4760,287,38,0,713,37,318,0,6153
"40017300902",2010,117,45,0,359,15,98,0,2644
"40017300904",2401,36,0,0,685,41,354,0,3517
"40017300905",3610,70,211,0,775,32,50,25,4773
"40017301001",135,9,17,0,69,0,0,0,230
"40017301003",4776,290,103,0,879,0,429,9,6486
"40017301006",2175,49,21,0,602,94,338,15,3294
"40017301007",4356,162,118,0,815,0,200,0,5651
"40017301008",4135,228,159,0,1939,0,409,0,6870
"40017301009",2295,126,0,0,161,36,56,36,2710
"40017301100",5153,380,0,0,509,0,453,176,6671
"40017301201",2898,605,112,0,314,13,168,50,4160
"40017301202",2347,252,7,0,128,54,128,50,2966
"40017301300",3867,195,40,0,428,94,250,0,4874
"40017301406",4282,277,28,0,381,130,306,102,5506
"40017301407",4512,387,7,0,574,50,250,27,5807
"40017301408",1801,148,0,0,181,0,0,0,2130
"40017301409",2694,93,3,0,98,0,113,0,3001
"40017301410",3643,88,0,0,779,0,505,0,5015
"40019892100",1610,348,246,61,381,75,12,50,2783
"40019892200",975,68,32,0,113,12,61,0,1261
"40019892300",2576,373,0,0,311,18,6,41,3325
"40019892400",2394,514,3,0,408,81,43,34,3477
"40019892500",6263,953,186,56,1375,110,119,0,9062
"40019892600",3665,620,712,195,662,127,264,0,6245
"40019892700",3987,199,171,6,662,211,310,0,5546
"40019892800",1812,773,422,328,700,863,221,585,5704
"40019892900",1238,245,125,102,305,17,112,43,2187
"40019893000",4472,572,190,100,961,184,418,0,6897
"40019893100",1692,307,336,25,408,119,371,49,3307
"40021977600",2101,449,27,0,1729,440,52,49,4847
"40021977700",4066,478,36,0,2396,426,160,98,7660
"40021977800",2250,713,33,1,2737,998,397,120,7249
"40021977900",1954,1128,83,46,2026,703,283,115,6338
"40021978000",1448,715,0,34,732,695,158,325,4107
"40021978100",2115,476,0,11,1772,662,179,118,5333
"40021978201",1071,180,15,24,1309,320,105,72,3096
"40021978202",1338,145,0,0,981,356,15,61,2896
"40021978300",2904,489,51,22,2002,872,362,212,6914
"40023966900",1728,450,27,20,444,131,60,35,2895
"40023967000",1753,303,152,57,645,160,51,24,3145
"40023967100",1561,728,358,75,269,401,0,107,3499
"40023967200",809,379,270,418,375,207,73,10,2541
"40023967300",1405,398,118,42,984,278,61,54,3340
"40025950100",837,237,0,0,148,0,125,48,1395
"40025950300",750,157,0,0,177,85,236,85,1490
"40027200100",88,130,0,0,8,11,0,22,259
"40027200200",1292,320,0,0,126,161,46,165,2110
"40027200300",2461,744,30,8,380,112,373,45,4153
"40027200400",1237,415,0,0,188,117,64,102,2123
"40027200500",1964,1100,122,0,264,118,105,114,3787
"40027200601",2364,1408,519,41,609,528,80,43,5592
"40027200602",1967,836,179,10,283,73,92,91,3531
"40027200700",57,83,0,0,0,14,0,14,168
"40027200800",5329,266,586,69,511,111,273,65,7210
"40027200900",3295,541,119,8,247,56,90,244,4600
"40027201000",4171,682,234,111,433,115,355,135,6236
"40027201101",3520,548,153,0,840,403,61,195,5720
"40027201102",2054,373,24,7,123,177,81,43,2882
"40027201201",698,599,0,85,163,170,75,84,1874
"40027201202",63,306,0,22,11,27,12,7,448
"40027201203",2823,955,119,263,607,364,185,39,5355
"40027201301",3522,1546,460,330,1107,312,482,133,7892
"40027201403",3914,264,124,0,591,33,110,188,5224
"40027201404",2169,432,14,16,158,80,124,73,3066
"40027201405",4693,342,0,110,432,0,131,0,5708
"40027201505",4596,127,37,0,415,104,140,0,5419
"40027201507",4775,334,119,86,974,462,111,169,7030
"40027201508",2188,567,20,0,302,101,262,44,3484
"40027201509",2134,47,14,3,513,30,64,0,2805
"40027201510",5455,177,581,0,1124,90,170,23,7620
"40027201602",2205,144,106,0,328,162,112,77,3134
"40027201603",2574,558,89,157,536,158,377,39,4488
"40027201604",2980,261,0,0,323,196,387,21,4168
"40027201607",3873,32,47,88,839,125,113,0,5117
"40027201609",2937,222,143,0,956,0,218,0,4476
"40027201610",2435,72,50,0,888,0,445,0,3890
"40027201611",1833,24,41,0,270,33,201,0,2402
"40027201612",4102,151,280,0,647,221,431,92,5924
"40027201700",1569,52,123,0,69,0,29,0,1842
"40027201801",2959,28,8,0,1112,6,165,0,4278
"40027201802",2804,161,32,0,412,0,324,0,3733
"40027201902",2744,264,692,102,745,92,427,83,5149
"40027201903",1767,144,449,54,564,107,208,54,3347
"40027201904",3212,113,463,9,780,130,546,48,5301
"40027202002",2872,367,105,44,387,60,198,15,4048
"40027202004",2755,123,48,90,442,7,411,20,3896
"40027202005",3787,1184,137,50,843,265,587,236,7089
"40027202006",1717,240,316,8,390,60,57,122,2910
"40027202007",2181,250,92,0,489,101,304,287,3704
"40027202008",2959,255,167,0,687,95,319,0,4482
"40027202102",1888,412,29,0,212,93,136,89,2859
"40027202104",1701,167,56,0,376,12,89,17,2418
"40027202105",3074,343,123,21,932,158,976,173,5800
"40027202106",4547,366,14,100,1444,84,374,69,6998
"40027202107",1781,99,368,0,428,0,277,0,2953
"40027202201",2495,82,344,0,389,6,459,0,3775
"40027202203",2369,187,109,8,792,103,386,37,3991
"40027202205",5109,114,138,197,946,138,556,82,7280
"40027202206",2042,109,187,0,430,40,218,6,3032
"40027202301",4503,259,39,0,391,19,216,19,5446
"40027202302",4227,435,53,0,695,0,262,22,5694
"40027202402",4392,521,41,0,955,146,138,16,6209
"40027202403",3896,288,0,42,854,24,489,44,5637
"40027202404",3291,306,0,23,418,50,33,18,4139
"40027202405",2955,764,18,0,289,11,107,28,4172
"40027202500",5016,757,0,0,791,92,97,91,6844
"40027202600",1958,364,26,6,359,34,120,130,2997
"40029388100",2198,579,22,6,758,258,106,49,3976
"40029388200",1154,321,0,0,457,100,16,6,2054
"40031000100",2029,283,385,270,598,470,391,258,4684
"40031000200",1004,289,379,298,335,288,412,157,3162
"40031000300",3014,489,963,296,495,249,704,274,6484
"40031000401",3053,436,1225,263,1724,109,929,67,7806
"40031000402",2561,156,902,184,653,240,488,184,5368
"40031000403",2781,161,698,1,717,49,275,43,4725
"40031000501",4115,535,1839,350,850,87,472,16,8264
"40031000502",3866,441,1403,381,1518,194,1173,45,9021
"40031000600",1478,174,115,191,173,12,238,12,2393
"40031000700",1671,162,304,44,634,48,498,27,3388
"40031000800",1167,282,243,213,252,91,232,11,2491
"40031000900",1389,84,100,0,278,24,200,0,2075
"40031001000",1351,399,148,33,301,18,191,39,2480
"40031001100",1143,296,131,244,146,110,88,12,2170
"40031001400",284,235,164,77,317,169,130,152,1528
"40031001500",1212,719,387,367,205,98,135,36,3159
"40031001600",407,340,555,289,318,265,138,46,2358
"40031001700",1326,468,130,74,414,318,611,128,3469
"40031001901",1002,205,310,78,345,0,289,36,2265
"40031001902",637,268,464,270,57,28,177,47,1948
"40031002001",3183,143,823,31,806,77,561,29,5653
"40031002003",1674,73,63,0,93,19,42,0,1964
"40031002004",2053,394,567,227,675,2,232,2,4152
"40031002005",1625,202,259,124,589,140,289,92,3320
"40031002100",5236,653,199,0,823,113,296,88,7408
"40031002200",4186,646,188,81,857,196,222,10,6386
"40031002301",4118,326,263,42,679,156,323,21,5928
"40031002302",2566,574,44,0,866,585,166,60,4861
"40031002401",3,0,0,0,11,0,0,0,14
"40031002403",904,518,418,0,231,152,356,551,3130
"40031002404",1705,448,281,43,463,18,586,81,3625
"40031002500",1036,304,227,268,248,93,160,88,2424
"40033871100",2525,345,29,0,624,108,180,24,3835
"40033871200",1653,290,47,4,235,135,47,132,2543
"40035373100",1904,212,15,0,859,169,96,38,3293
"40035373200",1393,289,0,0,742,120,54,14,2612
"40035373300",1741,473,204,21,566,289,22,12,3328
"40035373400",1430,354,68,11,691,154,73,0,2781
"40035373500",1331,323,13,0,542,80,14,19,2322
"40037020101",1508,243,0,39,307,36,36,10,2179
"40037020102",810,158,0,15,229,70,62,5,1349
"40037020103",2252,99,0,0,537,144,77,37,3146
"40037020601",3633,652,41,15,1218,405,290,31,6285
"40037020602",2496,332,21,0,206,51,114,0,3220
"40037020702",2878,325,29,0,697,25,49,8,4011
"40037020704",1188,339,0,3,247,8,82,0,1867
"40037020705",2188,156,0,0,379,65,18,0,2806
"40037020706",3859,380,105,0,534,212,8,93,5191
"40037020707",1410,129,3,0,274,28,14,9,1867
"40037020800",2249,549,7,4,424,105,23,0,3361
"40037020900",1680,407,102,64,333,154,6,0,2746
"40037021000",2002,652,141,93,529,181,12,33,3643
"40037021101",2133,225,108,51,376,47,65,2,3007
"40037021102",2147,464,46,11,568,205,113,5,3559
"40037021201",1654,72,0,0,268,12,130,0,2136
"40037021202",2746,359,228,169,513,155,161,0,4331
"40037021300",1429,492,0,0,385,118,74,79,2577
"40037021400",4500,448,0,106,593,314,231,55,6247
"40037021500",3815,345,39,28,896,184,335,39,5681
"40037021600",1755,210,0,15,421,40,30,12,2483
"40039950800",2191,540,109,187,367,588,1289,480,5751
"40039960400",5382,314,56,63,794,168,1030,256,8063
"40039960600",2388,1203,0,182,216,245,354,178,4766
"40039960700",6840,755,45,98,341,223,378,53,8733
"40039961000",2417,378,0,0,346,145,59,0,3345
"40041375601",2080,772,0,0,491,82,45,167,3637
"40041375602",2368,427,0,0,391,177,15,13,3391
"40041375700",4934,902,0,1,1095,262,173,0,7367
"40041375801",2095,567,6,0,625,158,9,27,3487
"40041375802",2322,387,0,0,353,96,34,5,3197
"40041375900",1710,485,26,0,1004,299,37,15,3576
"40041376000",1949,554,21,0,2332,1067,187,214,6324
"40041376100",1886,192,0,13,2175,979,43,29,5317
"40041976200",2967,690,39,2,1252,546,152,59,5707
"40043959100",1285,140,0,0,197,48,61,4,1735
"40043959200",1179,258,0,0,96,31,109,48,1721
"40043959300",1105,177,11,0,145,10,27,7,1482
"40045952600",2232,560,0,0,87,11,106,69,3065
"40045952800",1009,79,0,0,97,2,86,17,1290
"40047000100",3387,834,99,56,1054,164,747,21,6362
"40047000200",2073,262,7,5,241,187,94,44,2913
"40047000600",3681,896,394,94,698,66,356,29,6214
"40047000700",2805,1023,139,26,957,772,811,833,7366
"40047001100",3020,301,0,0,153,28,84,8,3594
"40047001200",3109,378,40,0,291,29,183,61,4091
"40047001300",6633,336,72,0,565,0,146,57,7809
"40047001401",2896,263,94,0,189,47,61,0,3550
"40047001402",3648,294,15,0,641,190,366,34,5188
"40047001500",4353,742,343,85,785,422,839,503,8072
"40047001601",4118,406,59,13,491,72,275,58,5492
"40047001602",3797,180,116,39,185,25,81,0,4423
"40049681100",2110,473,0,0,306,215,37,5,3146
"40049681200",2589,570,7,24,342,100,162,200,3994
"40049681300",1849,524,116,35,234,293,322,249,3622
"40049681400",3020,493,123,12,748,216,352,92,5056
"40049681500",1605,350,154,108,250,78,41,24,2610
"40049681600",1461,296,0,0,353,59,37,24,2230
"40049681700",1227,331,0,0,237,16,22,0,1833
"40049681800",2109,478,0,0,361,39,150,12,3149
"40049681900",2351,391,8,8,269,31,49,25,3132
"40051000100",714,425,0,0,113,64,109,11,1436
"40051000400",2147,534,0,24,447,103,297,27,3579
"40051000500",4739,589,93,13,516,166,237,140,6493
"40051000600",4125,467,97,4,543,156,247,61,5700
"40051000700",4854,1210,2,0,700,107,231,79,7183
"40051000800",5348,609,16,0,703,144,186,38,7044
"40051000901",1924,161,0,0,199,33,45,35,2397
"40051000902",4528,725,11,0,731,194,112,99,6400
"40051000903",8370,627,31,0,781,262,113,169,10353
"40051001000",2087,453,648,37,299,132,216,4,3876
"40053956400",1293,143,0,0,103,43,79,11,1672
"40053956500",2433,168,10,4,162,28,73,0,2878
"40055967100",1289,119,0,0,145,47,114,35,1749
"40055967200",2671,284,56,19,380,30,381,9,3830
"40057967800",1581,350,91,96,297,350,419,323,3507
"40059952100",1536,243,0,0,35,20,280,123,2237
"40059952200",1492,217,0,0,49,63,170,106,2097
"40061279100",1356,349,0,0,472,62,7,13,2259
"40061279200",2266,585,36,0,906,125,171,55,4144
"40061279300",2136,489,62,2,662,180,125,17,3673
"40061279400",1922,275,0,0,672,137,42,23,3071
"40063484600",1179,314,49,63,672,249,41,30,2597
"40063484700",2035,201,15,0,533,133,7,0,2924
"40063484800",1076,259,66,11,379,261,72,13,2137
"40063484900",1200,348,9,0,332,370,71,201,2531
"40063485000",1674,266,1,9,366,77,48,7,2448
"40065968100",2331,193,4,0,95,8,180,32,2843
"40065968200",1197,193,3,0,143,110,130,95,1871
"40065968300",1116,320,14,6,205,79,199,151,2090
"40065968400",3894,220,120,0,779,39,835,39,5926
"40065968500",2595,168,336,64,440,15,231,75,3924
"40065968600",2174,786,306,121,896,356,1134,557,6330
"40065968700",1164,250,133,249,223,219,487,304,3029
"40065968800",2049,634,358,39,487,95,820,254,4736
"40067371600",1250,354,0,1,330,148,75,39,2197
"40067371700",1201,217,3,0,211,84,127,75,1918
"40067371800",1808,405,17,0,138,87,160,79,2694
"40069660198",1939,346,50,0,657,187,89,32,3300
"40069660200",2594,763,29,44,899,460,131,81,5001
"40069660300",1630,467,0,0,484,89,60,43,2773
"40071000100",3473,1025,194,76,613,374,169,177,6101
"40071000201",2112,392,57,20,566,87,174,21,3429
"40071000202",3654,528,43,13,709,62,155,14,5178
"40071000300",3644,127,40,35,327,29,99,6,4307
"40071000400",1140,395,157,48,319,211,112,115,2497
"40071000500",2261,654,24,24,651,464,244,302,4624
"40071000600",2663,230,0,0,471,367,82,9,3822
"40071001100",2535,421,2,3,576,255,164,90,4046
"40071001200",3295,395,6,0,581,136,92,38,4543
"40071001301",2593,825,0,11,589,84,470,85,4657
"40071001302",3101,728,0,0,463,168,292,92,4844
"40073958100",3449,374,17,0,542,156,999,297,5834
"40073958200",1959,127,10,2,247,27,232,27,2631
"40073958300",4500,244,12,0,647,37,462,34,5936
"40073958400",2034,208,0,0,193,58,24,0,2517
"40075963600",1145,185,8,0,198,63,29,4,1632
"40075963700",2403,668,148,70,519,232,173,187,4400
"40075964200",2369,568,34,54,262,226,291,185,3989
"40077087100",1399,170,0,0,745,119,4,28,2465
"40077087200",3495,465,2,0,896,456,82,98,5494
"40077087300",1475,231,52,9,662,318,37,48,2832
"40079040102",2831,683,45,37,624,169,44,3,4436
"40079040198",1133,571,0,5,229,62,102,13,2115
"40079040299",2467,789,12,49,479,96,130,88,4110
"40079040301",4054,1076,35,2,775,193,158,21,6314
"40079040302",2596,458,0,0,619,223,26,4,3926
"40079040303",1820,568,247,68,588,132,0,20,3443
"40079040401",3214,431,42,162,799,172,394,114,5328
"40079040402",2124,478,69,27,462,287,133,205,3785
"40079040500",3030,829,0,0,1144,168,120,27,5318
"40079040601",2336,577,0,0,762,598,460,543,5276
"40079040602",2384,662,3,40,732,391,290,202,4704
"40079040700",1457,517,14,22,686,270,33,139,3138
"40081961100",2831,765,6,15,657,25,79,0,4378
"40081961200",3185,754,13,4,405,180,64,38,4643
"40081961300",3018,618,34,34,310,58,64,53,4189
"40081961400",5576,1063,78,8,900,194,151,62,8032
"40081961500",3946,437,112,15,493,58,182,0,5243
"40081961600",2527,390,23,33,303,51,108,8,3443
"40081961700",3592,464,112,89,334,137,66,6,4800
"40083600100",2358,479,569,309,382,62,36,11,4206
"40083600200",1533,495,184,316,157,125,126,57,2993
"40083600300",1718,299,345,40,88,95,114,2,2701
"40083600400",8371,367,0,1,557,127,860,86,10369
"40083600500",4645,683,287,249,636,64,119,136,6819
"40083600600",1948,495,523,162,158,117,28,60,3491
"40083600700",3615,444,57,18,575,48,157,7,4921
"40083600800",6948,444,159,0,450,19,239,225,8484
"40085094100",1727,550,25,71,262,93,591,303,3622
"40085094200",3474,437,93,0,527,129,172,90,4922
"40085094300",1568,255,0,0,166,26,55,2,2072
"40087400101",5293,433,72,0,1003,45,280,14,7140
"40087400102",7097,831,53,0,857,324,284,25,9471
"40087400201",2890,329,0,6,780,56,225,16,4302
"40087400202",6381,682,3,0,929,81,595,77,8748
"40087400300",3817,657,113,62,608,271,570,410,6508
"40087400400",854,159,0,0,96,108,8,10,1235
"40089098200",1540,373,0,0,719,349,62,76,3119
"40089098300",875,105,6,14,488,139,6,0,1633
"40089098400",2551,1006,113,41,742,216,168,21,4858
"40089098500",3229,989,98,19,1074,269,117,26,5821
"40089098600",2871,691,304,93,929,711,132,177,5908
"40089098700",1453,620,457,556,445,317,156,203,4207
"40089098800",2808,763,511,328,874,396,335,28,6043
"40089098900",1488,392,240,59,210,34,15,75,2513
"40091779600",3353,429,73,13,674,244,108,33,4927
"40091779700",2032,489,176,42,523,339,91,0,3692
"40091779900",1422,320,36,80,697,308,25,0,2888
"40091780100",1435,221,30,27,462,260,14,0,2449
"40091780200",1355,389,77,80,794,313,98,8,3114
"40091780300",2118,510,47,0,577,88,7,57,3404
"40093955100",2677,225,0,0,331,53,366,45,3697
"40093955200",1192,55,0,0,120,28,79,0,1474
"40093955300",2158,470,0,5,90,113,29,91,2956
"40095094698",2307,292,14,0,787,98,247,0,3745
"40095094700",2613,547,136,71,1273,224,1477,224,6565
"40095094801",2280,649,0,0,527,139,62,43,3700
"40095094802",2265,573,0,0,711,105,264,0,3918
"40097040100",2526,883,0,13,928,261,195,171,4977
"40097040200",2966,459,15,0,1138,185,144,12,4919
"40097040300",2551,207,0,0,868,247,72,0,3945
"40097040400",3457,693,22,20,1045,730,102,90,6159
"40097040501",2219,294,0,0,844,317,74,0,3748
"40097040502",1871,500,0,0,998,267,53,4,3693
"40097040600",1646,423,0,0,1004,633,42,31,3779
"40097040700",2007,799,6,12,783,477,67,23,4174
"40097040800",3854,345,13,0,1705,209,67,13,6206
"40099790600",1758,178,37,9,435,35,62,0,2514
"40099790700",3612,474,32,39,1064,61,227,0,5509
"40099790800",3240,731,0,18,1049,363,256,139,5796
"40101000100",1459,633,531,593,985,353,18,70,4642
"40101000200",407,333,333,502,187,163,20,9,1954
"40101000300",833,373,787,600,494,337,41,24,3489
"40101000400",219,161,369,240,167,171,76,46,1449
"40101000600",1933,496,286,322,883,188,115,159,4382
"40101000700",2146,1142,135,173,824,525,617,299,5861
"40101000801",3125,364,241,13,912,487,27,191,5360
"40101000802",1520,170,103,6,292,71,102,0,2264
"40101000900",4994,675,245,103,1546,415,473,87,8538
"40101001000",1030,459,240,27,155,123,118,109,2261
"40101001100",1718,243,145,135,885,155,49,37,3367
"40101001200",1572,213,229,74,463,122,55,0,2728
"40101001300",3548,792,84,27,1654,201,109,162,6577
"40101001400",4033,817,102,0,1864,332,85,196,7429
"40101001500",2902,657,30,34,1638,419,94,26,5800
"40101001600",2146,569,432,66,720,206,109,75,4323
"40103956600",2007,198,19,16,769,131,125,20,3285
"40103956900",2766,363,40,24,262,199,131,0,3785
"40103957000",1442,338,0,76,88,8,0,0,1952
"40103957100",2261,186,0,29,120,30,40,0,2666
"40105172100",1756,166,0,13,466,80,64,11,2556
"40105172200",859,184,16,3,511,89,6,16,1684
"40105172300",1392,161,0,0,409,133,72,3,2170
"40105172400",2133,511,74,64,1022,310,85,14,4213
"40107080600",1705,323,101,9,490,222,56,0,2906
"40107080700",1343,490,220,138,379,62,44,0,2676
"40107080900",1549,641,74,57,579,769,36,126,3831
"40107081000",988,162,54,91,569,229,36,69,2198
"40109100100",1911,774,254,137,345,175,278,496,4370
"40109100200",3125,1117,271,157,576,537,512,631,6926
"40109100300",2129,95,66,10,333,83,20,13,2749
"40109100400",37,114,1240,566,157,62,38,43,2257
"40109100500",101,0,1230,482,59,20,14,0,1906
"40109100600",551,52,4,0,23,124,36,40,830
"40109100700",769,95,74,35,205,25,159,0,1362
"40109100800",978,495,441,35,454,133,154,83,2773
"40109100900",1304,89,72,8,100,152,37,0,1762
"40109101000",615,457,101,109,649,191,220,182,2524
"40109101100",376,202,79,38,40,10,19,0,764
"40109101200",701,142,66,63,285,19,35,0,1311
"40109101300",17,149,1581,1086,85,96,0,39,3053
"40109101400",42,173,552,210,65,30,16,60,1148
"40109101500",449,115,587,191,168,69,17,0,1596
"40109101600",339,20,9,19,130,17,65,0,599
"40109101700",1061,31,36,0,164,17,9,0,1318
"40109101800",1017,84,41,26,159,44,27,0,1398
"40109101900",1692,197,122,106,521,54,378,95,3165
"40109102000",1438,572,257,190,642,45,353,260,3757
"40109102100",1175,268,143,107,449,32,531,128,2833
"40109102200",1122,454,21,177,595,43,693,306,3411
"40109102300",1674,746,145,50,463,291,771,782,4922
"40109102400",1311,841,137,160,943,332,1302,530,5556
"40109102500",228,91,42,35,44,26,56,26,548
"40109102600",58,73,83,224,15,97,0,8,558
"40109102700",30,39,0,5,17,8,0,0,99
"40109102800",142,164,969,812,193,96,131,109,2616
"40109102900",46,161,560,91,20,82,0,7,967
"40109103000",29,4,49,162,12,13,0,0,269
"40109103200",746,192,40,30,263,61,12,14,1358
"40109103300",526,396,129,49,269,168,567,266,2370
"40109103400",215,160,11,20,57,42,170,160,835
"40109103500",111,50,5,30,33,5,91,0,325
"40109103601",142,11,0,0,34,0,15,0,202
"40109103602",27,205,0,80,10,56,0,30,408
"40109103700",106,35,0,11,42,7,51,17,269
"40109103800",442,63,11,0,49,4,11,0,580
"40109103900",1378,1148,128,137,811,466,1538,1344,6950
"40109104000",203,62,24,4,0,3,183,54,533
"40109104100",1475,932,0,210,589,326,1465,977,5974
"40109104200",732,599,0,16,382,242,751,668,3390
"40109104300",1427,705,68,0,685,510,1590,873,5858
"40109104400",1094,1057,31,225,699,245,1369,1047,5767
"40109104500",1481,990,0,0,1219,193,1868,910,6661
"40109104600",623,72,0,0,46,126,439,115,1421
"40109104700",396,305,24,79,326,203,525,172,2030
"40109104800",1351,463,118,21,464,294,958,564,4233
"40109104900",1404,668,87,33,967,624,1613,701,6097
"40109105000",888,439,16,9,796,96,1319,320,3883
"40109105100",1240,344,139,89,173,40,13,0,2038
"40109105201",74,0,851,490,61,16,8,16,1516
"40109105202",6,0,505,416,50,106,11,0,1094
"40109105300",1084,877,25,380,539,340,751,655,4651
"40109105400",709,351,113,73,591,319,683,428,3267
"40109105500",1606,374,26,69,770,705,1576,914,6040
"40109105600",1781,1137,238,51,768,287,1674,1147,7083
"40109105700",270,201,11,33,260,77,404,168,1424
"40109105800",392,351,0,2,138,51,214,76,1224
"40109105903",1414,235,318,149,663,6,513,94,3392
"40109105904",1876,552,125,47,728,198,997,347,4870
"40109105905",1475,385,168,109,314,170,644,272,3537
"40109105906",1560,456,161,0,353,111,485,164,3290
"40109105907",2673,1122,82,24,852,267,1769,687,7476
"40109106000",519,47,1301,141,216,62,122,0,2408
"40109106100",272,342,1241,598,188,6,97,274,3018
"40109106200",117,18,1189,115,100,9,25,0,1573
"40109106301",653,267,1418,1131,280,265,98,212,4324
"40109106302",738,932,1533,1260,611,75,274,531,5954
"40109106303",2016,435,243,390,164,11,483,313,4055
"40109106401",1925,117,27,0,164,0,31,0,2264
"40109106402",1846,156,0,0,155,0,74,8,2239
"40109106403",3308,335,279,53,297,180,67,14,4533
"40109106501",2056,134,103,7,318,73,115,38,2844
"40109106502",2353,348,210,170,650,50,309,0,4090
"40109106503",1056,227,97,5,53,0,53,48,1539
"40109106601",1910,285,145,161,187,121,126,89,3024
"40109106602",2034,411,89,0,251,87,222,13,3107
"40109106604",997,272,446,67,248,143,90,85,2348
"40109106606",1464,579,14,25,195,4,107,159,2547
"40109106607",2209,321,346,235,441,144,314,203,4213
"40109106608",2248,118,38,0,389,13,33,8,2847
"40109106609",1023,54,6,0,268,0,125,0,1476
"40109106610",931,219,127,11,85,68,18,0,1459
"40109106702",2272,497,209,62,529,111,472,176,4328
"40109106704",1463,233,218,105,163,26,129,115,2452
"40109106705",1324,146,141,53,432,30,264,26,2416
"40109106706",2449,520,693,150,376,52,264,121,4625
"40109106707",2845,778,875,714,1101,165,530,141,7149
"40109106708",1525,13,5,0,636,16,20,0,2215
"40109106801",811,297,0,0,100,103,36,7,1354
"40109106802",1377,145,24,76,84,26,47,33,1812
"40109106803",1732,459,42,169,288,389,557,446,4082
"40109106804",2309,435,238,118,343,248,459,249,4399
"40109106902",1529,325,76,60,170,137,137,238,2672
"40109106903",3948,335,167,173,676,60,315,42,5716
"40109106906",1828,242,289,86,155,110,374,235,3319
"40109106907",1623,393,75,115,138,50,406,257,3057
"40109106909",1133,93,141,37,84,47,177,0,1712
"40109106910",1503,193,47,18,178,18,138,82,2177
"40109106911",1315,111,160,12,168,51,142,0,1959
"40109106912",1046,407,518,361,250,136,107,72,2897
"40109106913",1763,535,468,741,306,396,514,250,4973
"40109106914",1763,441,259,167,665,205,770,302,4572
"40109106915",2853,974,777,457,738,1006,1967,1286,10058
"40109107001",2556,515,112,40,1718,917,2456,876,9190
"40109107002",1541,415,6,32,346,115,721,319,3495
"40109107101",0,0,0,0,0,0,0,0,0
"40109107103",796,351,55,136,359,250,576,182,2705
"40109107104",1562,433,99,123,313,242,858,189,3819
"40109107206",2214,339,126,104,662,774,713,777,5709
"40109107207",1144,188,151,0,329,106,187,39,2144
"40109107209",2496,807,111,45,1370,714,1404,1023,7970
"40109107210",789,58,0,0,221,0,178,16,1262
"40109107211",1562,142,67,0,427,7,299,0,2504
"40109107212",3370,467,394,205,1010,344,419,196,6405
"40109107213",2858,438,266,115,1022,227,1568,281,6775
"40109107214",1634,438,29,7,707,77,752,284,3928
"40109107215",2188,259,144,17,976,398,1249,478,5709
"40109107216",1457,774,25,42,309,407,887,588,4489
"40109107217",911,286,17,177,471,94,637,208,2801
"40109107218",1679,427,216,263,296,339,1166,394,4780
"40109107219",1491,192,0,0,933,762,1242,825,5445
"40109107220",1810,712,63,50,466,635,1239,730,5705
"40109107221",1289,154,119,0,330,91,294,112,2389
"40109107222",750,338,49,40,390,218,369,284,2438
"40109107223",1454,209,120,99,409,190,726,226,3433
"40109107302",1180,714,24,152,333,354,409,434,3600
"40109107303",1103,233,9,15,169,110,102,28,1769
"40109107305",408,186,59,302,109,43,205,54,1366
"40109107306",1078,729,617,166,280,419,193,337,3819
"40109107401",1872,343,1418,1230,724,396,192,67,6242
"40109107403",3277,374,814,103,908,25,432,15,5948
"40109107404",1447,205,597,275,593,41,130,33,3321
"40109107405",2232,183,799,99,1137,36,475,27,4988
"40109107500",1268,71,149,10,146,0,283,22,1949
"40109107601",1173,353,266,220,271,101,180,0,2564
"40109107604",1317,259,57,0,185,25,56,21,1920
"40109107605",1396,316,78,65,150,107,18,14,2144
"40109107606",210,129,0,0,12,10,4,0,365
"40109107607",2620,195,501,0,171,56,135,0,3678
"40109107703",2869,289,281,0,354,0,259,9,4061
"40109107704",1010,190,79,54,172,0,99,37,1641
"40109107705",1534,149,140,106,243,13,144,0,2329
"40109107706",1681,269,152,27,681,222,288,182,3502
"40109107707",916,128,57,0,88,9,80,10,1288
"40109107801",1389,269,752,477,414,437,135,95,3968
"40109107804",1407,257,62,156,241,122,155,34,2434
"40109107805",1435,275,364,102,204,120,231,159,2890
"40109107806",2494,346,318,435,372,14,253,71,4303
"40109107807",1566,249,371,10,443,9,293,5,2946
"40109107808",1114,141,228,63,271,10,251,17,2095
"40109107809",1104,416,291,37,155,44,229,169,2445
"40109107810",1654,197,247,8,314,69,223,0,2712
"40109107900",82,20,984,647,71,86,5,38,1933
"40109108003",907,365,1510,552,344,385,87,74,4224
"40109108005",797,112,832,220,105,42,20,0,2128
"40109108006",2028,164,670,62,528,19,191,0,3662
"40109108007",2279,46,209,154,219,76,59,0,3042
"40109108008",1779,294,718,806,600,360,144,10,4711
"40109108009",1582,94,1027,13,326,103,201,100,3446
"40109108010",1070,537,776,209,193,136,83,19,3023
"40109108011",830,319,1234,706,206,134,149,0,3578
"40109108101",3199,12,188,33,194,0,183,0,3809
"40109108106",4444,15,41,0,376,0,102,0,4978
"40109108107",2589,0,47,0,206,0,18,0,2860
"40109108109",4700,69,40,0,562,0,155,0,5526
"40109108110",3198,236,87,14,360,0,142,0,4037
"40109108113",3951,397,108,27,448,60,286,61,5338
"40109108114",2649,541,91,216,281,381,76,42,4277
"40109108201",2849,505,218,113,153,109,177,9,4133
"40109108203",2192,332,186,59,278,74,238,7,3366
"40109108204",1413,409,319,45,373,26,565,68,3218
"40109108206",3927,125,185,36,404,17,147,0,4841
"40109108207",484,232,0,45,48,143,0,5,957
"40109108208",1623,682,285,223,265,237,54,51,3420
"40109108213",7683,50,0,0,720,0,168,0,8621
"40109108215",3723,171,630,0,373,7,285,7,5196
"40109108216",1993,246,193,0,184,0,93,0,2709
"40109108217",3009,348,800,29,336,50,157,0,4729
"40109108218",6521,0,1305,0,654,0,332,0,8812
"40109108219",4166,80,244,0,112,0,111,0,4713
"40109108220",3943,405,222,7,636,11,172,0,5396
"40109108221",5302,121,334,0,692,9,335,10,6803
"40109108301",522,22,738,291,116,0,48,21,1758
"40109108302",3203,244,595,167,393,123,222,51,4998
"40109108303",4069,1058,124,278,514,186,106,110,6445
"40109108304",3408,274,99,0,426,252,88,157,4704
"40109108307",1869,210,2531,457,443,339,481,38,6368
"40109108309",193,150,953,722,168,208,148,81,2623
"40109108310",738,51,779,346,181,79,52,0,2226
"40109108313",2229,326,1579,352,402,341,63,175,5467
"40109108314",1117,292,595,194,234,293,285,21,3031
"40109108315",3251,209,495,134,1072,27,402,0,5590
"40109108316",4458,117,824,81,717,10,127,0,6334
"40109108317",2188,243,341,147,331,114,63,0,3427
"40109108318",3732,170,896,51,821,43,305,0,6018
"40109108402",1157,8,18,0,241,5,0,0,1429
"40109108403",1321,96,209,75,190,37,130,32,2090
"40109108404",1813,134,509,25,324,0,228,0,3033
"40109108504",5375,350,630,83,687,353,225,0,7703
"40109108506",2640,262,180,0,308,56,139,33,3618
"40109108507",943,65,18,0,69,0,38,0,1133
"40109108508",1310,44,168,10,339,46,98,14,2029
"40109108511",4316,397,319,79,645,0,77,22,5855
"40109108512",3616,79,124,10,277,12,48,1,4167
"40109108513",2561,149,487,28,553,74,200,0,4052
"40109108514",2555,394,1152,485,489,200,339,0,5614
"40109108515",3619,154,103,350,364,40,65,12,4707
"40109108519",2668,118,199,17,247,57,57,39,3402
"40109108520",1730,68,51,36,136,9,38,0,2068
"40109108521",731,55,278,34,79,73,97,9,1356
"40109108523",3541,147,571,11,733,84,228,0,5315
"40109108524",2052,62,392,0,690,97,13,0,3306
"40109108525",1212,86,257,0,475,18,6,0,2054
"40109108526",2531,387,716,295,752,135,320,173,5309
"40109108527",3394,118,633,18,775,106,98,16,5158
"40109108528",1344,116,271,123,199,32,37,17,2139
"40109108529",2375,13,180,0,234,0,66,0,2868
"40109108530",2875,74,548,0,499,0,113,7,4116
"40109108601",1485,157,207,0,519,23,250,84,2725
"40109108602",723,168,0,10,24,13,88,18,1044
"40109108603",1879,77,124,16,231,18,228,0,2573
"40109108701",1910,155,215,0,242,0,94,0,2616
"40109108703",4397,352,99,171,493,39,176,0,5727
"40109108704",3938,236,31,0,535,34,112,0,4886
"40109108706",1833,163,358,0,312,0,53,0,2719
"40109108707",2617,56,331,0,394,40,112,19,3569
"40109108708",2727,222,0,0,206,12,0,32,3199
"40109108709",2511,138,0,0,296,45,20,13,3023
"40109108801",4617,720,666,130,274,58,149,29,6643
"40109108802",4183,451,39,0,579,23,123,0,5398
"40109108803",58,28,818,129,201,35,15,0,1284
"40109108804",1394,59,611,601,115,0,18,0,2798
"40109108900",2470,374,444,101,233,91,190,103,4006
"40109109001",1590,290,62,0,240,3,39,0,2224
"40109109003",3611,375,42,26,403,240,129,142,4968
"40109109004",2802,293,44,1,256,115,206,33,3750
"40109109100",36,49,4,36,4,60,0,0,189
"40109109201",4510,187,159,52,552,4,282,6,5752
"40109109202",1764,245,35,10,172,8,57,160,2451
"40111000100",464,141,821,199,850,89,45,0,2609
"40111000200",1501,293,483,128,568,291,149,0,3413
"40111000300",1594,450,72,0,333,89,19,33,2590
"40111000400",2213,315,336,280,793,745,86,58,4826
"40111000500",2416,185,191,74,827,123,17,0,3833
"40111000600",4654,639,324,64,922,264,266,43,7176
"40111000700",2127,520,66,14,798,256,248,27,4056
"40111000800",1787,386,169,71,772,239,85,14,3523
"40111000901",1979,312,39,3,506,220,113,28,3200
"40111000902",2693,792,0,0,664,309,14,53,4525
"40113940001",2425,536,180,22,885,331,68,20,4467
"40113940002",2034,496,29,43,1638,391,200,21,4852
"40113940003",2976,634,23,13,931,289,50,5,4921
"40113940004",1646,242,7,0,670,59,59,77,2760
"40113940005",2395,131,133,67,820,74,181,23,3824
"40113940006",769,208,3437,905,366,65,185,84,6019
"40113940007",3814,340,27,0,809,55,134,31,5210
"40113940008",2032,364,47,0,661,167,70,0,3341
"40113940009",2906,278,0,0,701,48,82,0,4015
"40113940010",4843,494,0,0,1197,268,20,0,6822
"40113940011",963,145,0,0,201,37,2,20,1368
"40115574100",2358,477,7,7,1016,396,117,31,4409
"40115574200",1333,620,9,1,711,319,268,322,3583
"40115574300",1479,346,14,8,567,175,40,28,2657
"40115574400",1461,406,3,0,456,324,89,116,2855
"40115574500",1140,556,22,9,396,260,59,76,2518
"40115574600",2259,416,8,8,845,274,71,40,3921
"40115574700",3019,232,0,10,1171,288,86,0,4806
"40115574800",2167,632,0,12,830,257,6,26,3930
"40115574900",2025,589,5,10,792,152,69,5,3647
"40117957100",2551,444,0,38,511,165,32,0,3741
"40117957200",3346,397,3,0,639,26,133,1,4545
"40117957300",2293,388,44,0,512,140,62,0,3439
"40117957400",1920,345,0,0,303,42,69,3,2682
"40117957500",1293,209,40,22,631,105,75,10,2385
"40119010101",3164,316,106,22,477,178,89,0,4352
"40119010102",2140,1502,91,78,363,478,166,62,4880
"40119010200",2961,1374,184,374,634,520,138,93,6278
"40119010300",698,921,5,0,21,71,41,45,1802
"40119010400",157,135,22,0,471,171,46,0,1002
"40119010500",1170,1136,0,44,223,502,41,122,3238
"40119010600",2496,1485,353,65,379,111,177,181,5247
"40119010700",1523,1189,25,46,207,85,92,49,3216
"40119010800",962,657,35,29,144,145,27,25,2024
"40119010900",6779,992,104,58,709,283,373,31,9329
"40119011000",4269,547,63,0,464,114,125,14,5596
"40119011101",3728,718,0,0,506,97,71,0,5120
"40119011102",4578,957,208,0,567,243,37,125,6715
"40119011200",1526,433,0,0,240,35,34,3,2271
"40119011301",2404,502,3,0,358,102,157,10,3536
"40119011302",3035,603,26,0,566,166,112,103,4611
"40119011400",2370,417,42,3,328,64,96,54,3374
"40121485600",1891,541,41,0,215,143,0,26,2857
"40121485700",1102,310,0,0,448,254,26,106,2246
"40121485800",3146,622,13,0,781,138,146,15,4861
"40121485900",1596,187,12,0,347,74,7,7,2230
"40121486000",3476,604,45,0,1071,301,75,22,5594
"40121486100",2490,365,286,90,737,519,61,199,4747
"40121486200",2183,341,48,92,593,314,147,200,3918
"40121486300",4,0,8,0,2,0,0,0,14
"40121486400",866,707,71,10,653,153,118,142,2720
"40121486500",3781,596,160,60,790,224,52,44,5707
"40121486600",2143,128,59,2,508,126,38,0,3004
"40121486700",2837,487,22,17,1119,221,194,25,4922
"40121486800",1096,204,0,0,288,106,5,37,1736
"40123088600",3277,340,47,8,1241,277,143,58,5391
"40123088700",1299,292,25,39,406,60,0,31,2152
"40123088800",4862,578,240,93,1153,369,91,92,7478
"40123088900",1692,785,21,53,657,406,208,50,3872
"40123089000",2089,329,32,52,833,227,40,47,3649
"40123089100",997,516,55,0,469,252,153,12,2454
"40123089200",588,397,44,38,139,211,29,171,1617
"40123089300",2275,414,29,5,908,127,134,36,3928
"40123089598",3495,401,22,2,876,194,120,6,5116
"40123089600",1389,297,0,0,364,86,26,30,2192
"40125500200",1111,831,165,158,611,473,100,29,3478
"40125500301",1956,309,75,51,385,216,59,34,3085
"40125500302",1395,287,80,53,669,466,380,143,3473
"40125500400",1895,596,0,47,547,378,60,0,3523
"40125500500",1799,482,61,105,561,276,239,111,3634
"40125500600",2275,494,23,21,323,114,91,56,3397
"40125500700",1812,257,86,6,703,228,178,0,3270
"40125500800",2702,186,0,0,365,120,15,0,3388
"40125500900",5146,477,101,8,1021,424,179,21,7377
"40125501001",4981,1120,16,8,832,314,236,69,7576
"40125501003",3276,754,6,9,540,78,166,0,4829
"40125501004",2861,446,35,38,460,115,93,41,4089
"40125501101",3260,445,67,32,1273,164,182,71,5494
"40125501102",5247,776,101,23,1406,242,287,15,8097
"40125501201",1240,219,0,0,211,52,24,0,1746
"40125501300",2086,414,13,0,271,66,44,16,2910
"40127097600",1785,396,15,15,706,266,70,19,3272
"40127097700",3092,1422,64,17,632,300,120,32,5679
"40127097800",1397,313,2,0,550,237,47,18,2564
"40129960000",2941,399,2,0,240,85,169,25,3861
"40131050101",2784,371,36,107,1082,260,277,111,5028
"40131050103",1605,32,31,15,600,85,126,35,2529
"40131050104",713,316,54,30,548,251,36,24,1972
"40131050105",3074,332,0,6,821,134,219,96,4682
"40131050201",1512,88,0,0,588,87,56,0,2331
"40131050202",1600,232,5,0,756,145,183,0,2921
"40131050203",903,62,22,0,451,88,35,12,1573
"40131050301",1559,215,0,0,384,113,26,0,2297
"40131050302",1432,259,24,35,537,103,49,4,2443
"40131050303",1598,173,0,0,491,109,38,0,2409
"40131050304",2586,130,0,0,500,40,72,0,3328
"40131050403",4167,159,29,0,1161,73,174,12,5775
"40131050404",5102,38,106,13,727,18,266,0,6270
"40131050405",3086,209,50,0,447,252,67,297,4408
"40131050406",1752,5,0,0,497,0,64,0,2318
"40131050407",1534,54,24,79,557,4,27,28,2307
"40131050408",2063,245,14,0,441,277,245,17,3302
"40131050409",1344,73,0,0,580,62,111,95,2265
"40131050501",2087,50,0,0,647,43,86,0,2913
"40131050502",2016,275,4,9,816,126,54,53,3353
"40131050601",2848,135,0,0,583,63,96,0,3725
"40131050602",2268,80,8,0,615,0,51,0,3022
"40131050603",1902,86,0,0,541,5,11,0,2545
"40131050604",2782,37,0,0,733,109,36,0,3697
"40131050701",968,340,0,3,447,272,19,15,2064
"40131050702",2022,261,0,2,503,193,19,17,3017
"40131050801",3189,226,5,0,542,153,106,0,4221
"40131050802",2159,126,0,0,795,29,16,0,3125
"40133583100",1042,182,48,39,426,92,41,34,1904
"40133583200",2171,318,4,0,529,346,90,95,3553
"40133583300",1645,374,51,21,427,71,106,27,2722
"40133583400",2511,616,161,88,708,315,107,32,4538
"40133583500",861,473,49,39,341,98,147,33,2041
"40133583600",1687,495,245,324,793,612,39,18,4213
"40133583700",1256,203,34,0,359,115,110,3,2080
"40133583800",1641,370,0,3,747,147,23,4,2935
"40133583900",881,240,87,8,431,107,41,26,1821
"40135030101",2118,504,0,3,1628,408,75,17,4753
"40135030103",1498,575,122,84,378,117,104,33,2911
"40135030104",3824,730,32,11,1531,426,134,72,6760
"40135030201",1781,107,0,2,618,305,36,0,2849
"40135030202",2577,703,105,57,1170,448,8,64,5132
"40135030301",945,325,16,28,667,412,132,153,2678
"40135030302",3848,840,34,49,1645,317,314,14,7061
"40135030401",1984,411,86,29,790,216,46,39,3601
"40135030402",3786,887,81,51,1123,797,122,115,6962
"40137000101",4520,367,50,29,542,189,324,116,6137
"40137000102",2605,401,7,32,139,150,87,34,3455
"40137000200",3164,391,19,0,295,7,135,35,4046
"40137000300",1490,153,30,18,119,73,67,26,1976
"40137000400",3229,926,297,16,651,318,548,322,6307
"40137000600",1519,285,254,147,336,345,448,87,3421
"40137000800",4370,203,0,0,424,39,53,56,5145
"40137000901",3362,696,17,37,383,131,28,7,4661
"40137000902",2717,287,0,0,430,224,119,0,3777
"40137001000",1747,236,0,0,178,23,85,0,2269
"40137001100",4336,684,8,11,463,48,280,12,5842
"40139950600",2661,384,29,12,702,298,963,492,5541
"40139950700",1822,293,9,53,595,133,646,156,3707
"40139950800",2364,232,73,26,1349,199,1796,291,6330
"40139950900",4236,505,49,0,2677,327,3741,538,12073
"40139951000",1096,100,0,0,317,83,422,83,2101
"40141070100",872,165,0,0,69,25,33,32,1196
"40141070200",599,179,83,12,100,92,78,104,1247
"40141070300",1613,261,120,6,241,48,420,143,2852
"40141070400",815,356,127,44,139,77,365,324,2247
"40141070500",954,103,130,79,172,82,220,55,1795
"40143000100",836,447,158,56,416,141,276,236,2566
"40143000200",45,27,816,277,195,30,35,45,1470
"40143000300",1128,695,504,495,795,279,832,403,5131
"40143000400",1308,571,443,351,711,432,956,562,5334
"40143000500",103,140,1222,494,59,158,93,41,2310
"40143000600",7,14,615,335,73,70,0,29,1143
"40143000700",102,199,821,463,116,266,0,33,2000
"40143000800",208,17,727,276,36,94,0,73,1431
"40143000900",249,185,509,228,75,166,7,37,1456
"40143001000",60,66,857,332,48,39,0,0,1402
"40143001200",703,208,78,104,329,261,516,356,2555
"40143001300",768,440,84,5,289,355,451,446,2838
"40143001400",1932,1111,598,230,741,652,1323,530,7117
"40143001500",1991,477,233,180,778,647,566,455,5327
"40143001600",2435,640,170,232,1186,259,1314,462,6698
"40143001700",1825,220,101,0,449,37,154,23,2809
"40143001800",1005,156,19,0,542,73,58,28,1881
"40143001900",970,261,51,71,252,24,106,145,1880
"40143002000",1082,233,26,94,234,72,325,58,2124
"40143002100",692,593,102,162,304,332,360,204,2749
"40143002301",1185,692,132,133,382,317,285,409,3535
"40143002500",994,198,81,177,168,78,86,6,1788
"40143002700",1160,734,183,138,548,125,249,233,3370
"40143002900",1720,402,81,235,263,70,94,0,2865
"40143003000",1138,474,34,26,200,92,155,9,2128
"40143003100",1930,371,184,42,180,41,8,0,2756
"40143003200",1238,87,8,7,143,21,55,6,1565
"40143003300",1671,120,0,9,222,17,11,0,2050
"40143003400",859,734,155,47,270,120,44,460,2689
"40143003500",1561,194,34,10,450,50,23,6,2328
"40143003600",1796,24,38,0,266,6,28,0,2158
"40143003700",2094,104,18,8,278,123,100,0,2725
"40143003800",1370,231,75,6,177,96,76,0,2031
"40143003900",2941,340,68,20,633,48,132,17,4199
"40143004000",3188,307,100,69,329,84,220,0,4297
"40143004101",1984,4,0,0,123,2,9,0,2122
"40143004200",2404,112,29,34,70,26,53,0,2728
"40143004301",2098,31,8,0,112,0,4,8,2261
"40143004302",3061,112,0,0,189,34,60,0,3456
"40143004400",2038,237,133,29,343,31,44,0,2855
"40143004500",2282,72,0,11,166,0,56,0,2587
"40143004600",857,801,344,253,245,352,259,497,3608
"40143004700",1010,259,14,40,518,90,34,0,1965
"40143004800",2393,501,91,0,768,180,200,185,4318
"40143004900",1036,175,120,155,356,39,196,5,2082
"40143005001",1374,173,0,13,280,72,79,38,2029
"40143005002",2401,502,133,33,425,136,102,46,3778
"40143005100",1718,21,35,0,158,33,23,0,1988
"40143005200",2188,284,61,10,464,26,46,0,3079
"40143005300",3423,258,360,48,508,36,365,0,4998
"40143005401",2130,49,0,0,446,37,65,19,2746
"40143005402",5239,472,142,0,1244,128,76,0,7301
"40143005500",2426,449,0,0,335,269,76,0,3555
"40143005600",1749,259,24,0,400,32,55,15,2534
"40143005700",393,120,1237,893,129,46,29,15,2862
"40143005801",2992,273,36,0,659,178,292,91,4521
"40143005805",4811,389,207,53,1247,444,268,331,7750
"40143005806",4002,203,135,0,682,31,157,32,5242
"40143005807",9104,654,105,231,1925,159,504,119,12801
"40143005808",2036,53,0,0,581,108,174,0,2952
"40143005900",1112,705,172,65,312,240,717,596,3919
"40143006000",2478,636,314,263,1126,219,1546,332,6914
"40143006200",87,67,1379,859,94,173,32,0,2691
"40143006506",1905,29,20,0,349,0,29,0,2332
"40143006507",1138,137,91,0,269,0,106,0,1741
"40143006600",1938,279,0,54,620,159,29,32,3111
"40143006701",1123,397,464,268,469,409,202,172,3504
"40143006703",2526,536,121,0,460,65,195,31,3934
"40143006705",4058,267,343,65,483,20,205,0,5441
"40143006707",6257,205,442,0,1201,61,418,0,8584
"40143006708",5460,117,64,30,359,12,215,13,6270
"40143006801",1311,691,133,134,186,320,152,252,3179
"40143006803",1521,284,381,200,239,87,50,77,2839
"40143006804",1262,299,169,166,246,187,370,140,2839
"40143006901",3551,57,189,0,239,113,197,0,4346
"40143006902",1545,40,30,0,78,0,48,0,1741
"40143006903",2901,265,143,50,424,70,142,0,3995
"40143006905",2229,541,527,285,468,294,794,278,5416
"40143006906",1215,249,110,98,209,78,262,81,2302
"40143006907",1681,256,333,97,549,43,344,59,3362
"40143007000",1629,277,165,365,248,78,63,73,2898
"40143007101",1618,694,373,127,393,254,512,313,4284
"40143007102",904,233,284,289,362,276,274,97,2719
"40143007200",2446,424,178,261,842,87,763,119,5120
"40143007304",2023,245,459,156,699,115,1128,247,5072
"40143007305",2852,877,762,188,1168,384,1053,606,7890
"40143007306",2457,530,321,440,1280,356,1365,492,7241
"40143007308",2058,117,39,85,526,186,228,104,3343
"40143007309",1017,24,88,38,151,15,184,33,1550
"40143007310",2021,268,216,37,859,296,1321,318,5336
"40143007311",1205,464,120,65,432,230,419,194,3129
"40143007312",2136,892,465,389,753,197,969,527,6328
"40143007402",2390,236,37,0,333,45,142,5,3188
"40143007407",2418,89,154,21,395,34,134,0,3245
"40143007408",684,77,95,0,247,34,41,0,1178
"40143007409",2582,214,338,53,755,41,321,170,4474
"40143007410",1594,198,332,43,271,57,283,98,2876
"40143007411",1513,141,124,107,328,31,400,42,2686
"40143007412",2543,194,175,0,566,31,348,0,3857
"40143007413",2810,34,402,27,641,0,367,0,4281
"40143007414",1755,312,108,11,346,9,204,93,2838
"40143007415",1221,101,76,24,315,0,154,0,1891
"40143007503",2069,129,0,0,330,75,197,24,2824
"40143007506",2295,206,317,0,381,64,265,0,3528
"40143007507",2477,181,197,19,751,10,250,10,3895
"40143007508",4858,106,284,122,843,71,264,0,6548
"40143007510",4059,488,127,50,626,70,553,211,6184
"40143007511",2196,137,152,44,366,25,160,29,3109
"40143007512",3126,181,7,0,643,56,257,0,4270
"40143007513",3293,254,5,0,611,50,114,14,4341
"40143007515",3539,204,19,0,497,177,132,0,4568
"40143007516",3096,477,73,98,477,252,67,31,4571
"40143007518",2479,28,222,0,842,0,120,5,3696
"40143007519",2622,30,125,0,191,37,273,0,3278
"40143007520",3225,41,27,0,463,30,171,0,3957
"40143007522",1458,151,23,5,182,12,52,5,1888
"40143007523",1909,161,60,0,248,7,167,88,2640
"40143007524",2061,115,89,0,361,86,86,16,2814
"40143007608",608,370,484,342,214,193,123,109,2443
"40143007609",1539,622,892,654,404,321,131,390,4953
"40143007611",812,60,48,44,136,90,44,5,1239
"40143007612",1329,19,38,0,288,51,72,0,1797
"40143007613",2497,88,160,0,418,16,182,43,3404
"40143007614",1992,141,87,22,345,27,78,0,2692
"40143007615",1331,137,215,33,166,125,7,24,2038
"40143007616",2417,144,199,0,334,76,40,7,3217
"40143007617",2321,450,447,37,583,222,322,262,4644
"40143007618",4126,591,316,50,1251,112,192,119,6757
"40143007619",3127,279,69,0,449,66,330,67,4387
"40143007620",3942,398,272,45,640,135,232,69,5733
"40143007624",2287,210,32,0,459,41,96,0,3125
"40143007625",3088,623,211,204,503,380,419,285,5713
"40143007629",2583,143,126,18,502,87,88,36,3583
"40143007630",3336,220,283,74,751,0,399,8,5071
"40143007631",2676,131,79,0,343,9,81,0,3319
"40143007632",2639,175,103,128,185,20,54,22,3326
"40143007633",2398,31,149,0,228,0,103,0,2909
"40143007634",2629,242,97,0,359,91,75,14,3507
"40143007635",5392,84,21,0,516,53,70,0,6136
"40143007636",3244,281,25,0,333,10,113,0,4006
"40143007637",4139,175,11,0,506,54,58,0,4943
"40143007638",3626,73,27,0,318,0,97,0,4141
"40143007639",3715,161,465,40,477,25,142,23,5048
"40143007641",1523,538,541,287,703,435,392,244,4663
"40143007642",838,329,143,128,313,113,218,33,2115
"40143007701",3626,356,48,11,1123,78,165,8,5415
"40143007702",5749,610,40,0,1357,135,212,79,8182
"40143007801",1766,498,67,9,404,47,120,6,2917
"40143007802",4289,235,121,8,758,36,222,0,5669
"40143007900",129,270,2141,1398,266,161,21,0,4386
"40143008001",239,475,172,703,253,251,141,106,2340
"40143008002",79,8,1258,767,128,222,58,17,2537
"40143008200",857,339,226,57,486,381,506,393,3245
"40143008300",844,340,49,22,167,32,165,153,1772
"40143008400",2315,271,266,48,453,62,225,35,3675
"40143008501",1658,338,165,18,527,80,636,272,3694
"40143008502",3129,465,393,165,838,105,578,133,5806
"40143008600",2844,909,243,141,414,157,812,380,5900
"40143008700",2483,279,63,16,298,47,192,35,3413
"40143008800",1012,746,69,63,213,377,53,31,2564
"40143008900",1451,588,275,212,924,188,686,302,4626
"40143009003",3732,436,508,0,1205,115,472,47,6515
"40143009004",1960,471,285,212,1106,387,1633,504,6558
"40143009006",3177,341,828,310,1022,316,1362,383,7739
"40143009007",3921,927,858,418,1242,459,1223,569,9617
"40143009008",1316,605,338,271,444,287,900,606,4767
"40143009009",5018,23,461,21,1672,185,446,116,7942
"40143009101",703,212,572,635,180,57,47,6,2412
"40143009104",1331,349,189,45,372,154,192,214,2846
"40143009200",2446,313,17,2,690,160,62,2,3692
"40143009300",2861,454,42,5,557,241,177,127,4464
"40143009401",3946,185,23,10,618,94,232,0,5108
"40143009402",3977,180,0,0,811,146,155,0,5269
"40143009500",3769,640,36,90,524,94,58,80,5291
"40143011100",207,4,79,33,146,77,82,53,681
"40145030101",2278,602,110,35,1069,354,203,0,4651
"40145030102",2811,650,177,181,634,237,211,0,4901
"40145030201",1647,148,0,0,557,341,35,61,2789
"40145030202",2107,205,38,29,823,170,2,38,3412
"40145030300",1037,140,26,16,487,178,114,0,1998
"40145030402",3626,228,41,0,514,15,98,0,4522
"40145030403",1400,126,53,4,375,91,61,29,2139
"40145030405",4350,115,166,0,1074,240,315,84,6344
"40145030406",3276,253,383,0,615,11,36,0,4574
"40145030502",1567,96,24,0,452,87,90,0,2316
"40145030505",1576,28,6,0,249,12,5,0,1876
"40145030506",1210,207,0,0,123,10,23,0,1573
"40145030507",1585,500,27,0,319,122,277,449,3279
"40145030508",1694,45,19,1,236,30,111,26,2162
"40145030509",3307,89,131,0,520,0,304,0,4351
"40145030510",1506,22,85,0,256,95,111,28,2103
"40145030511",1642,31,9,0,286,6,100,0,2074
"40145030512",2837,241,236,0,764,6,162,86,4332
"40145030601",3245,78,46,0,843,30,62,0,4304
"40145030602",4672,752,52,90,1141,400,242,136,7485
"40145030798",1648,251,242,271,474,138,125,27,3176
"40145030800",2081,216,20,0,579,56,25,0,2977
"40147000100",950,355,39,73,201,77,66,37,1798
"40147000200",750,446,29,81,262,194,180,19,1961
"40147000300",1479,406,186,20,164,180,167,19,2621
"40147000400",3100,522,0,39,633,96,61,110,4561
"40147000500",4223,485,119,270,1254,242,307,47,6947
"40147000600",5765,590,56,0,925,93,472,177,8078
"40147000700",4303,111,26,0,460,41,197,8,5146
"40147000800",2701,254,31,32,434,22,128,43,3645
"40147000900",1116,590,80,177,421,238,104,48,2774
"40147001000",1592,178,0,0,488,80,1,7,2346
"40147001100",3196,532,0,0,884,182,174,9,4977
"40147001200",1766,106,0,0,428,49,38,24,2411
"40147001300",3812,582,0,0,1148,104,81,113,5840
"40149964900",2776,701,91,9,373,115,394,79,4538
"40149965000",1847,372,0,0,112,46,146,178,2701
"40149965100",2762,448,0,0,130,47,121,17,3525
"40149965400",1375,121,0,0,108,7,52,0,1663
"40151954200",2968,483,40,30,205,50,119,62,3957
"40151954300",1630,382,0,62,122,18,10,33,2257
"40151954400",1543,158,5,0,83,16,102,22,1929
"40153953100",1997,273,0,0,43,0,91,26,2430
"40153953200",3162,289,17,1,111,7,81,0,3668
"40153953300",2929,762,76,3,185,4,331,351,4641
"40153953400",2361,663,0,0,385,114,379,139,4041
"40153953500",4752,846,0,0,524,11,548,162,6843
"41001950100",2354,290,20,0,59,0,65,0,2788
"41001950200",2448,473,0,13,109,117,121,103,3384
"41001950300",1960,388,0,0,34,8,24,13,2427
"41001950400",2278,583,0,0,71,9,14,11,2966
"41001950500",1896,552,4,0,35,82,23,134,2726
"41001950600",1491,268,0,0,35,18,26,0,1838
"41003000100",5241,1631,24,0,565,140,641,152,8394
"41003000202",3836,673,54,19,232,60,144,16,5034
"41003000400",5818,821,0,0,853,239,218,63,8012
"41003000500",2679,318,0,0,167,12,21,35,3232
"41003000600",3038,964,0,123,369,299,476,132,5401
"41003000900",3818,1096,0,50,610,81,118,11,5784
"41003001001",2427,1250,31,139,411,112,589,470,5429
"41003001002",1988,568,0,0,341,180,70,11,3158
"41003001101",717,1477,0,15,58,366,48,44,2725
"41003001102",1530,1880,0,25,103,490,240,47,4315
"41003010100",7508,190,7,0,458,39,200,0,8402
"41003010200",3547,344,11,0,263,32,74,9,4280
"41003010300",2739,315,0,0,101,7,80,0,3242
"41003010400",3254,806,57,0,201,77,197,277,4869
"41003010600",1301,1192,84,0,182,370,129,80,3338
"41003010702",793,506,63,56,226,225,95,0,1964
"41003010800",2887,500,21,0,152,13,538,10,4121
"41003010900",3553,485,40,35,286,15,57,91,4562
"41005020100",3088,285,25,0,127,176,95,167,3963
"41005020200",5405,359,0,0,375,0,83,0,6222
"41005020302",3101,228,0,0,418,0,158,2,3907
"41005020303",4286,376,32,0,405,42,104,14,5259
"41005020304",4423,533,47,0,893,83,184,19,6182
"41005020401",4044,302,7,0,425,3,621,2,5404
"41005020403",3170,68,0,0,226,5,47,1,3517
"41005020404",3398,135,29,0,240,0,196,0,3998
"41005020501",6017,287,17,0,491,53,337,18,7220
"41005020503",1912,96,18,0,99,0,41,0,2166
"41005020504",5292,259,77,0,617,80,130,96,6551
"41005020505",2543,145,0,0,84,0,24,0,2796
"41005020600",7030,239,0,2,755,24,520,22,8592
"41005020700",3231,168,0,0,260,111,170,56,3996
"41005020800",2665,800,84,17,499,79,206,92,4442
"41005020900",2836,388,95,1,241,14,134,25,3734
"41005021000",3343,542,162,51,273,90,244,99,4804
"41005021100",4519,639,210,0,477,29,48,28,5950
"41005021200",3044,522,0,0,158,160,348,76,4308
"41005021300",4881,556,210,5,539,57,459,15,6722
"41005021400",3847,454,51,0,401,37,585,67,5442
"41005021500",4169,292,0,0,319,0,167,0,4947
"41005021601",4010,994,57,1,331,108,299,265,6065
"41005021602",3797,595,25,15,457,131,539,141,5700
"41005021700",4939,394,94,0,516,149,580,78,6750
"41005021801",4589,294,0,12,337,0,77,33,5342
"41005021802",2758,756,18,0,666,47,394,75,4714
"41005021900",2848,610,0,0,148,129,133,230,4098
"41005022000",5291,503,0,158,520,103,284,142,7001
"41005022101",5673,955,118,5,384,87,578,173,7973
"41005022103",5000,85,8,63,1473,111,485,0,7225
"41005022105",4233,340,93,0,1259,71,269,0,6265
"41005022107",2875,404,102,23,211,94,338,71,4118
"41005022108",2008,854,0,0,106,0,802,48,3818
"41005022201",3169,711,13,0,586,223,1322,440,6464
"41005022205",2193,87,62,0,915,25,246,1,3529
"41005022206",4144,334,88,0,1730,162,294,0,6752
"41005022207",4056,17,16,0,1066,0,194,0,5349
"41005022208",4561,390,82,0,1414,23,166,1,6637
"41005022301",3010,416,27,0,224,59,89,34,3859
"41005022302",4506,460,0,0,329,8,419,0,5722
"41005022400",3156,408,24,19,415,68,184,0,4274
"41005022500",5992,1191,0,30,208,324,627,140,8512
"41005022602",3498,146,0,0,126,19,289,0,4078
"41005022603",2263,516,0,0,308,68,289,91,3535
"41005022605",6545,228,11,0,421,43,680,31,7959
"41005022606",3839,419,11,0,105,44,56,22,4496
"41005022702",6512,160,12,0,509,220,131,124,7668
"41005022707",3304,318,0,0,363,188,496,121,4790
"41005022708",3760,112,61,15,210,299,751,251,5459
"41005022710",1717,242,19,0,421,319,88,326,3132
"41005022800",3589,163,0,0,36,1,32,12,3833
"41005022901",2636,244,0,0,352,45,107,45,3429
"41005022904",2917,273,0,0,101,82,670,113,4156
"41005022905",3249,244,0,0,257,10,259,169,4188
"41005022906",2232,437,0,0,265,0,487,128,3549
"41005022907",3015,740,0,0,260,448,996,1094,6553
"41005023001",2469,298,0,0,236,0,0,75,3078
"41005023002",2580,312,13,0,120,0,66,21,3112
"41005023100",5405,486,56,0,368,13,54,98,6480
"41005023201",3994,236,26,6,175,0,35,0,4472
"41005023202",5483,343,0,0,847,19,324,71,7087
"41005023300",3939,217,0,0,180,74,165,74,4649
"41005023401",3434,487,0,0,205,65,349,126,4666
"41005023403",4278,128,0,0,88,0,131,0,4625
"41005023404",5027,477,7,0,435,80,262,65,6353
"41005023500",4760,456,0,9,123,33,164,21,5566
"41005023600",3820,309,7,0,76,8,107,0,4327
"41005023700",4139,668,5,2,151,33,85,24,5107
"41005023800",5997,579,0,0,328,50,720,323,7997
"41005023901",4690,416,71,229,82,1,384,229,6102
"41005023902",3836,423,0,0,167,0,247,0,4673
"41005024000",2582,93,0,0,51,0,9,0,2735
"41005024100",4194,226,12,0,244,8,104,0,4788
"41005024200",5365,792,119,21,207,117,546,98,7265
"41005024302",4146,447,22,0,98,0,120,185,5018
"41005024303",2563,235,0,0,98,0,32,0,2928
"41005024304",1980,97,0,0,37,0,42,20,2176
"41005024400",5339,389,85,17,657,91,540,94,7212
"41005980000",63,63,2,0,51,12,59,20,270
"41007950100",2275,186,13,1,310,197,414,140,3536
"41007950200",2441,678,22,21,128,141,62,58,3551
"41007950300",2008,574,11,0,131,151,269,219,3363
"41007950400",3280,356,18,0,101,29,136,53,3973
"41007950500",3314,1001,21,0,261,31,188,17,4833
"41007950600",1997,313,0,0,195,62,165,9,2741
"41007950700",1708,193,12,0,32,14,47,8,2014
"41007950900",3255,543,7,0,265,146,240,153,4609
"41007951100",3490,603,0,59,199,95,264,147,4857
"41007951200",2563,349,0,0,152,19,144,12,3239
"41007951300",1966,220,4,0,118,12,31,12,2363
"41007990000",0,0,0,0,0,0,0,0,0
"41009970200",5882,758,0,0,140,185,136,31,7132
"41009970300",3010,512,44,22,264,19,98,13,3982
"41009970400",1978,187,0,0,117,22,55,3,2362
"41009970500",5340,471,0,0,259,0,105,64,6239
"41009970600",5383,362,0,0,352,0,135,98,6330
"41009970700",2664,727,16,0,388,362,97,314,4568
"41009970800",4830,1034,0,0,376,199,324,56,6819
"41009970900",3658,821,0,0,352,37,116,258,5242
"41009971000",3812,550,27,0,165,41,97,14,4706
"41009971100",3031,341,0,0,79,9,73,2,3535
"41011000100",4664,594,5,0,358,85,120,65,5891
"41011000200",1979,483,0,0,121,123,19,42,2767
"41011000300",2474,398,9,0,230,91,108,9,3319
"41011000400",4567,889,0,13,858,61,264,18,6670
"41011000502",1651,739,3,0,88,43,42,1,2567
"41011000503",1709,671,0,140,127,42,177,253,3119
"41011000504",3739,1215,14,303,978,302,603,476,7630
"41011000600",2105,216,30,0,93,60,43,14,2561
"41011000700",5055,1042,0,0,467,157,307,52,7080
"41011000800",2321,429,0,0,152,0,29,31,2962
"41011000900",6019,618,0,0,375,129,233,18,7392
"41011001000",5764,849,0,41,219,13,205,14,7105
"41011001100",4050,1134,0,0,335,86,70,211,5886
"41011990101",0,0,0,0,0,0,0,0,0
"41013950100",5260,1223,22,0,370,172,627,230,7904
"41013950200",3259,861,0,0,208,18,202,11,4559
"41013950300",4119,1100,5,0,255,49,250,11,5789
"41013950400",3086,482,0,0,118,131,71,84,3972
"41015950100",2328,979,0,0,139,27,96,39,3608
"41015950200",3688,712,0,0,253,17,235,94,4999
"41015950301",3431,379,0,0,532,0,146,0,4488
"41015950302",4265,485,27,0,332,0,294,53,5456
"41015950400",3641,610,0,0,263,132,264,84,4994
"41015990101",0,0,0,0,0,0,0,0,0
"41017000100",1703,81,0,0,176,0,6,0,1966
"41017000200",3323,1158,0,12,141,88,157,59,4938
"41017000300",6864,1043,13,0,195,188,70,47,8420
"41017000401",4012,533,0,0,323,0,321,0,5189
"41017000402",2164,125,0,0,0,15,0,0,2304
"41017000500",4719,677,0,0,140,219,171,215,6141
"41017000600",6065,538,0,0,158,12,80,0,6853
"41017000700",6248,810,25,0,474,74,330,48,8009
"41017000800",5060,945,0,0,110,184,570,206,7075
"41017000900",4409,2250,0,41,303,393,430,852,8678
"41017001001",9455,2428,58,0,865,175,669,329,13979
"41017001002",1842,411,0,0,129,25,374,36,2817
"41017001100",8887,888,18,13,343,50,351,146,10696
"41017001200",5643,383,0,0,408,133,211,46,6824
"41017001300",9604,901,21,17,466,98,409,152,11668
"41017001400",4473,293,9,0,119,16,106,16,5032
"41017001500",4255,982,115,0,438,25,575,215,6605
"41017001600",3551,731,12,0,333,90,451,186,5354
"41017001700",5852,1843,0,0,183,50,474,440,8842
"41017001800",4873,1367,50,46,196,173,291,90,7086
"41017001901",1620,85,0,0,46,50,42,50,1893
"41017001902",7332,519,49,0,1009,153,780,105,9947
"41017002000",6737,263,0,0,492,123,640,0,8255
"41017002100",9350,1256,34,0,729,171,700,589,12829
"41019010000",1608,435,0,0,119,47,78,49,2336
"41019020000",2880,378,0,0,227,147,277,30,3939
"41019030000",3315,432,0,0,202,49,99,27,4124
"41019040000",1922,405,0,2,86,57,10,38,2520
"41019050001",3835,651,0,58,96,12,42,0,4694
"41019050002",4924,1261,0,0,299,37,228,60,6809
"41019060000",2944,359,0,0,168,9,127,0,3607
"41019070000",4592,338,0,22,160,25,78,0,5215
"41019080000",6791,593,29,11,274,9,89,0,7796
"41019090000",3711,1478,0,0,282,73,159,119,5822
"41019100000",2194,488,27,0,336,114,153,175,3487
"41019110000",2413,299,0,0,80,8,68,44,2912
"41019120000",4925,1954,0,38,451,173,325,78,7944
"41019130000",3767,1182,17,0,372,52,175,79,5644
"41019140000",4064,801,5,0,188,193,116,189,5556
"41019150000",6188,1121,0,0,259,0,402,108,8078
"41019160000",5014,1815,0,0,325,92,182,93,7521
"41019170000",2753,376,32,0,157,95,15,131,3559
"41019180000",3362,657,0,0,284,224,195,170,4892
"41019190000",3094,943,0,0,163,389,172,252,5013
"41019200000",3254,1060,0,0,466,226,199,26,5231
"41019210000",3299,624,12,0,219,75,210,10,4449
"41019990000",0,0,0,0,0,0,0,0,0
"41021960100",1611,203,7,3,57,18,128,29,2056
"41023960100",1825,382,13,0,62,18,34,9,2343
"41023960200",3913,816,5,0,192,39,130,55,5150
"41025960100",3849,673,29,1,269,94,211,32,5158
"41025960200",1621,514,4,0,81,52,66,0,2338
"41027950100",3077,292,65,0,295,205,696,242,4872
"41027950200",6037,424,37,0,200,39,1164,19,7920
"41027950300",4294,880,0,0,604,24,1145,496,7443
"41027950400",4521,628,18,0,522,88,2506,379,8662
"41029000100",795,913,17,18,159,68,304,395,2669
"41029000201",1958,725,0,0,209,122,365,219,3598
"41029000202",1990,1024,0,100,358,313,665,479,4929
"41029000203",3183,892,0,0,210,18,1088,186,5577
"41029000300",3948,1017,9,11,484,94,1554,10,7127
"41029000403",3565,217,0,7,116,0,105,0,4010
"41029000404",4073,404,0,0,246,0,138,0,4861
"41029000405",3247,378,0,27,171,50,270,50,4193
"41029000406",3098,571,0,0,245,213,458,159,4744
"41029000501",2049,650,0,7,29,22,145,88,2990
"41029000502",3037,1308,65,28,352,153,211,163,5317
"41029000601",5678,837,0,0,284,29,451,70,7349
"41029000602",4155,1143,0,0,358,0,169,64,5889
"41029000700",7269,1051,12,77,458,447,755,242,10311
"41029000800",4020,1105,126,0,231,342,284,595,6703
"41029000900",7068,919,57,0,415,53,842,358,9712
"41029001001",5670,911,23,0,177,32,211,58,7082
"41029001002",3669,312,0,0,115,64,327,53,4540
"41029001100",4355,424,0,0,414,0,493,53,5739
"41029001200",2728,734,33,15,281,66,294,309,4460
"41029001301",3565,765,0,15,518,241,784,103,5991
"41029001302",7552,988,89,22,714,324,2644,594,12927
"41029001400",7334,1471,0,0,876,148,390,36,10255
"41029001500",4120,331,22,0,185,107,0,19,4784
"41029001601",2484,765,0,8,262,99,683,190,4491
"41029001602",5230,932,0,14,380,64,1015,445,8080
"41029001700",5312,1150,82,12,280,392,307,20,7555
"41029001800",6098,936,297,18,473,58,287,45,8212
"41029001900",1264,820,14,0,86,78,97,39,2398
"41029002000",1774,279,34,0,3,8,0,6,2104
"41029002100",2372,526,0,0,341,102,134,43,3518
"41029002200",3676,639,38,0,95,135,52,16,4651
"41029002300",1296,241,22,0,99,15,109,0,1782
"41029002400",1728,188,0,0,116,78,243,36,2389
"41029002500",2255,238,27,0,121,32,45,0,2718
"41029002600",2089,379,0,0,87,38,34,7,2634
"41029002700",4705,1283,0,0,226,22,201,164,6601
"41029002800",3965,279,20,0,281,61,385,21,5012
"41029002900",6071,970,7,0,119,81,467,53,7768
"41029003001",3351,376,0,0,216,0,177,0,4120
"41029003002",3928,1301,12,0,119,0,0,14,5374
"41031940000",187,39,0,14,2055,892,231,114,3532
"41031960100",1291,181,0,4,42,30,67,75,1690
"41031960201",1714,479,12,0,1002,452,1294,361,5314
"41031960202",3316,372,21,0,759,306,439,323,5536
"41031960301",2574,202,0,14,152,1,63,0,3006
"41031960302",2897,712,30,4,501,372,518,591,5625
"41033360100",1866,505,0,4,147,6,46,7,2581
"41033360300",4669,642,0,1,301,103,97,4,5817
"41033360400",3355,288,11,0,222,136,303,56,4371
"41033360500",3521,1441,0,0,425,67,433,174,6061
"41033360600",4888,1287,0,16,365,34,337,148,7075
"41033360701",3021,1355,21,17,86,170,305,51,5026
"41033360702",4089,924,0,0,125,166,580,25,5909
"41033360800",3993,784,10,32,102,153,356,50,5480
"41033360900",1859,509,0,0,28,16,78,40,2530
"41033361000",3561,553,0,0,145,41,102,0,4402
"41033361100",7206,1535,0,0,327,14,631,138,9851
"41033361200",5219,1224,46,0,229,395,419,126,7658
"41033361300",5930,931,3,0,252,10,101,11,7238
"41033361400",2053,465,0,13,148,0,40,0,2719
"41033361500",1679,315,11,0,144,34,27,105,2315
"41033361600",4848,2268,85,7,188,79,432,146,8053
"41035970100",2497,457,0,7,117,150,29,118,3375
"41035970200",2871,463,55,0,408,308,113,30,4248
"41035970300",2444,397,13,0,144,64,54,75,3191
"41035970400",1170,239,0,0,82,10,150,0,1651
"41035970500",958,426,0,0,49,62,31,33,1559
"41035970600",989,214,0,0,201,58,409,199,2070
"41035970700",1738,334,3,0,213,5,564,207,3064
"41035970800",2199,276,0,16,46,9,63,95,2704
"41035970900",2842,670,12,28,433,53,179,114,4331
"41035971000",2237,219,0,0,123,0,73,0,2652
"41035971100",3920,475,13,0,522,67,359,6,5362
"41035971200",1625,504,0,39,206,125,122,197,2818
"41035971300",4689,640,0,99,340,125,544,89,6526
"41035971400",4164,425,33,17,286,209,296,154,5584
"41035971500",2762,745,10,12,552,112,335,166,4694
"41035971600",1382,1174,14,27,471,138,553,476,4235
"41035971700",1737,611,6,0,424,205,302,190,3475
"41035971800",997,793,0,27,409,112,190,28,2556
"41035971900",2359,609,29,0,238,33,286,20,3574
"41035972000",3367,492,10,0,316,35,235,27,4482
"41037960100",1843,465,17,6,120,48,59,34,2592
"41037960200",3570,885,0,24,398,69,405,55,5406
"41039000100",3767,649,7,0,338,55,275,23,5114
"41039000200",4105,682,0,0,464,54,283,9,5597
"41039000300",1828,149,0,26,216,21,92,0,2332
"41039000402",2874,404,5,0,224,18,199,18,3742
"41039000403",4114,730,0,0,99,72,174,101,5290
"41039000404",2443,586,8,8,286,110,206,167,3814
"41039000500",1391,341,3,0,65,76,37,10,1923
"41039000702",2055,370,14,0,107,153,79,0,2778
"41039000705",2965,460,0,1,86,13,94,2,3621
"41039000706",2215,369,12,0,11,65,14,31,2717
"41039000707",3066,625,37,0,292,2,108,2,4132
"41039000708",1523,533,0,0,59,9,10,20,2154
"41039000800",1257,70,7,0,66,16,22,0,1438
"41039000902",3601,436,0,0,273,89,109,0,4508
"41039000903",4141,652,10,1,326,19,331,26,5506
"41039000904",1913,522,0,8,173,6,43,22,2687
"41039001001",1473,473,8,0,130,23,29,22,2158
"41039001002",3435,379,8,6,382,24,223,64,4521
"41039001101",4691,459,0,0,357,31,195,0,5733
"41039001102",2885,324,27,8,159,92,143,54,3692
"41039001201",3123,329,0,0,157,187,363,223,4382
"41039001202",3176,366,4,0,178,104,227,23,4078
"41039001301",2425,510,15,0,168,104,20,0,3242
"41039001302",3572,1122,11,0,171,93,222,149,5340
"41039001400",1612,347,0,0,218,57,104,2,2340
"41039001500",3289,964,0,0,122,3,2,3,4383
"41039001600",4006,712,0,0,166,93,72,21,5070
"41039001700",4599,605,0,0,202,17,74,12,5509
"41039001801",4851,397,48,33,204,110,567,120,6330
"41039001803",3410,487,18,0,199,78,55,55,4302
"41039001804",3117,425,0,0,165,26,90,7,3830
"41039001902",5066,1267,104,30,507,147,795,289,8205
"41039001903",2030,449,0,0,109,95,156,113,2952
"41039001904",3280,922,8,24,375,149,512,244,5514
"41039002001",3019,492,0,0,135,0,485,155,4286
"41039002002",3765,385,0,0,413,137,204,17,4921
"41039002101",1747,746,0,19,327,36,322,75,3272
"41039002102",4277,1567,0,0,651,286,629,286,7696
"41039002201",3024,191,0,0,289,5,111,8,3628
"41039002202",4382,825,0,0,480,144,152,0,5983
"41039002301",2509,785,16,33,344,70,215,85,4057
"41039002302",3458,612,58,6,477,137,597,111,5456
"41039002401",2890,699,58,0,430,14,125,0,4216
"41039002403",3703,210,136,0,240,15,115,5,4424
"41039002404",3518,430,15,20,375,15,260,93,4726
"41039002501",3708,917,59,12,196,165,334,401,5792
"41039002503",5719,1085,116,0,673,73,632,324,8622
"41039002504",2047,308,0,0,475,70,421,82,3403
"41039002600",4644,722,0,0,740,67,918,40,7131
"41039002700",2428,756,76,0,478,51,384,51,4224
"41039002800",3307,321,6,1,561,30,621,2,4849
"41039002902",2945,546,54,38,315,119,81,102,4200
"41039002903",2323,30,14,0,337,14,186,0,2904
"41039002904",2500,304,122,0,187,96,81,0,3290
"41039003000",3729,137,8,8,258,0,83,9,4232
"41039003101",3869,1011,0,0,715,160,52,124,5931
"41039003102",3410,2110,86,30,530,1065,301,121,7653
"41039003201",1675,815,20,0,65,237,163,285,3260
"41039003202",2745,626,0,38,307,28,223,0,3967
"41039003301",1838,1098,0,29,362,220,316,148,4011
"41039003302",1691,798,0,0,130,475,13,326,3433
"41039003400",3190,768,31,3,749,87,915,154,5897
"41039003500",3517,155,0,0,460,65,189,69,4455
"41039003600",2345,679,8,10,292,67,157,0,3558
"41039003700",586,582,0,57,39,132,15,54,1465
"41039003800",848,3684,57,0,143,813,19,221,5785
"41039003900",1109,724,29,5,147,213,6,59,2292
"41039004000",1571,764,42,84,53,109,140,275,3038
"41039004100",3008,448,4,2,291,214,186,161,4314
"41039004200",1669,1413,52,8,313,270,375,142,4242
"41039004300",4987,1484,36,0,494,312,964,229,8506
"41039004401",3241,1007,323,128,572,83,511,80,5945
"41039004403",2107,1308,61,91,508,176,209,64,4524
"41039004404",2608,211,0,0,233,26,108,0,3186
"41039004405",4007,301,9,0,435,10,128,0,4890
"41039004501",1635,703,0,0,232,147,241,50,3008
"41039004502",2092,911,38,16,74,130,151,222,3634
"41039004600",2002,253,8,0,282,2,67,23,2637
"41039004700",2431,950,41,9,135,190,56,85,3897
"41039004800",1556,2579,47,105,86,568,139,58,5138
"41039004900",2631,774,37,66,423,115,163,39,4248
"41039005000",4055,540,0,0,432,85,293,11,5416
"41039005100",2380,582,0,66,374,121,148,38,3709
"41039005200",1587,123,0,0,135,43,62,10,1960
"41039005300",1954,166,31,0,178,118,150,19,2616
"41039005400",4359,308,47,28,472,32,223,27,5496
"41039990000",0,0,0,0,0,0,0,0,0
"41041950100",2668,485,0,0,122,36,92,0,3403
"41041950303",1063,203,0,0,55,81,41,14,1457
"41041950304",2022,376,0,8,341,136,304,131,3318
"41041950400",3166,746,0,0,425,92,383,290,5102
"41041950601",1837,306,0,2,333,2,66,2,2548
"41041950602",1754,278,0,0,424,46,356,55,2913
"41041950800",2698,651,10,0,240,37,281,115,4032
"41041950900",2440,318,0,0,376,247,328,0,3709
"41041951000",1244,311,15,30,131,84,160,34,2009
"41041951100",1365,132,0,0,108,0,176,24,1805
"41041951200",1413,162,11,0,158,0,167,0,1911
"41041951300",2077,245,0,0,161,24,104,16,2627
"41041951400",2157,386,0,0,199,15,128,28,2913
"41041951500",1678,258,0,0,28,0,0,0,1964
"41041951600",2647,455,9,0,207,21,123,25,3487
"41041951700",1540,329,0,21,163,91,55,64,2263
"41041951800",2394,465,29,0,595,228,49,69,3829
"41041990100",0,0,0,0,0,0,0,0,0
"41043020100",6788,1488,0,0,522,151,379,529,9857
"41043020200",1531,158,0,0,125,20,106,4,1944
"41043020300",5709,440,32,0,390,189,388,261,7409
"41043020400",2374,1090,42,0,475,293,578,470,5322
"41043020500",2786,916,0,0,129,156,503,106,4596
"41043020600",7166,688,109,15,598,150,949,161,9836
"41043020700",3937,1112,0,0,424,205,352,91,6121
"41043020801",1499,650,0,0,127,304,391,159,3130
"41043020802",3524,1657,15,74,357,501,692,709,7529
"41043030100",4706,478,13,0,222,60,233,4,5716
"41043030200",5647,565,37,0,333,36,265,16,6899
"41043030300",1949,269,0,0,78,0,40,0,2336
"41043030401",4537,1450,0,13,233,57,161,0,6451
"41043030402",5405,1342,0,0,146,16,63,0,6972
"41043030500",3739,393,26,0,65,9,78,8,4318
"41043030600",5693,926,0,0,348,50,338,53,7408
"41043030700",3056,354,32,0,125,47,145,51,3810
"41043030800",5800,927,0,0,370,412,192,158,7859
"41043030902",6128,793,32,0,364,23,118,123,7581
"41043030903",4416,1359,0,42,320,87,153,101,6478
"41043030904",2841,715,35,0,152,44,167,7,3961
"41045940000",0,0,0,0,0,0,0,0,0
"41045970200",2718,602,15,0,352,452,591,717,5447
"41045970300",2609,894,25,4,372,301,614,629,5448
"41045970400",1772,1520,0,35,469,939,1017,1557,7309
"41045970500",3618,677,35,21,785,184,1979,618,7917
"41045970600",3001,829,4,0,314,25,558,132,4863
"41045970700",1446,119,0,0,86,21,155,9,1836
"41045970900",2501,912,0,7,112,105,375,191,4203
"41047000200",1341,646,0,0,104,91,74,60,2316
"41047000300",2914,889,11,14,729,427,885,479,6348
"41047000400",2433,1030,38,47,498,847,927,951,6771
"41047000501",1824,460,198,0,689,189,587,295,4242
"41047000502",1559,1131,23,0,909,1628,875,1555,7680
"41047000600",3663,742,20,0,372,307,638,386,6128
"41047000701",2765,1409,91,18,666,825,1333,1001,8108
"41047000900",3173,924,10,14,1304,297,1459,212,7393
"41047001000",2077,1042,0,0,381,212,518,554,4784
"41047001100",3540,410,65,0,305,79,334,25,4758
"41047001200",2626,424,28,0,227,42,141,77,3565
"41047001300",3147,358,10,0,365,38,178,44,4140
"41047001401",4251,1098,18,11,758,32,947,105,7220
"41047001402",4712,349,86,0,501,21,1212,115,6996
"41047001501",3183,495,43,0,305,112,316,172,4626
"41047001502",3375,754,26,0,785,336,1167,415,6858
"41047001503",3394,726,0,77,607,100,1334,212,6450
"41047001601",4689,495,172,0,985,938,967,903,9149
"41047001602",3167,1557,13,0,2175,1618,2578,2166,13274
"41047001603",4557,812,94,0,1197,46,1808,227,8741
"41047001604",4695,1138,34,0,1416,482,1869,1076,10710
"41047001701",3563,987,56,0,1319,748,2233,770,9676
"41047001702",2800,926,35,13,1333,558,1597,784,8046
"41047001703",3433,348,8,0,773,176,1205,128,6071
"41047001801",3835,1073,114,19,1110,814,1936,726,9627
"41047001802",4735,1444,108,51,1600,499,2630,640,11707
"41047001803",1952,532,0,0,71,65,292,262,3174
"41047002000",7741,542,137,72,752,166,822,50,10282
"41047002101",1722,349,0,0,95,44,199,19,2428
"41047002102",4888,410,37,0,550,152,760,0,6797
"41047002201",1979,254,6,0,216,4,376,0,2835
"41047002202",5180,697,33,119,677,67,391,42,7206
"41047002301",2301,258,13,0,319,0,137,11,3039
"41047002303",5739,691,214,36,651,32,481,51,7895
"41047002304",4524,147,23,0,600,98,322,16,5730
"41047002400",2937,358,0,27,157,0,85,0,3564
"41047002501",7242,688,0,0,567,148,477,3,9125
"41047002502",3502,846,24,0,540,183,881,305,6281
"41047002600",1791,249,0,0,0,3,274,43,2360
"41047002700",7345,447,0,0,516,8,540,53,8909
"41047002800",2973,724,26,0,207,30,270,70,4300
"41047010100",1155,130,0,0,183,48,193,60,1769
"41047010201",2034,231,13,0,188,79,270,165,2980
"41047010202",5699,489,0,23,692,384,1267,521,9075
"41047010303",3129,774,0,2,926,251,1914,488,7484
"41047010304",2917,1335,25,0,1819,458,3048,1547,11149
"41047010305",1650,780,12,0,934,721,1594,1263,6954
"41047010306",4265,1663,84,0,2066,845,3506,1796,14225
"41047010307",4024,385,0,0,451,135,1090,135,6220
"41047010400",3699,478,0,6,772,111,1383,137,6586
"41047010501",4832,263,0,0,275,49,269,40,5728
"41047010502",5228,819,0,0,302,221,262,354,7186
"41047010503",2783,541,0,0,81,51,154,35,3645
"41047010600",1782,225,0,0,203,50,237,13,2510
"41047010701",5830,1315,45,0,644,264,1521,127,9746
"41047010702",5262,608,1,0,728,0,581,4,7184
"41047010801",4602,733,0,0,388,108,276,120,6227
"41047010802",4426,801,0,0,829,178,771,126,7131
"41049970100",5589,1244,19,0,911,208,2496,1031,11498
"41049970200",2554,545,0,0,111,14,83,8,3315
"41051000100",5089,560,0,0,415,40,215,40,6359
"41051000200",4515,782,55,10,424,146,328,287,6547
"41051000301",3246,643,51,40,264,125,102,59,4530
"41051000302",5700,537,0,0,524,0,179,2,6942
"41051000401",2927,212,32,0,324,9,51,8,3563
"41051000402",2607,301,0,0,405,33,192,34,3572
"41051000501",2721,352,0,0,515,96,218,40,3942
"41051000502",3121,564,199,10,629,141,139,59,4862
"41051000601",2941,768,365,17,811,496,540,445,6383
"41051000602",3426,523,140,31,1207,179,602,88,6196
"41051000701",3075,267,13,211,548,358,72,212,4756
"41051000702",2869,663,12,91,901,193,388,222,5339
"41051000801",3314,489,64,0,346,144,110,43,4510
"41051000802",2921,582,59,202,672,115,334,78,4963
"41051000901",2653,500,11,0,422,109,51,30,3776
"41051000902",2763,534,76,367,342,217,127,67,4493
"41051001000",3821,1094,40,72,261,50,171,75,5584
"41051001101",1063,471,6,49,147,140,30,37,1943
"41051001102",1188,233,0,11,71,11,94,17,1625
"41051001201",4202,800,24,4,70,52,176,27,5355
"41051001202",2663,170,14,14,471,0,132,0,3464
"41051001301",2615,621,9,0,361,24,225,44,3899
"41051001302",2526,219,1,0,245,8,81,16,3096
"41051001400",3581,442,15,137,452,32,172,28,4859
"41051001500",2603,208,16,0,193,0,32,8,3060
"41051001601",3750,418,136,41,747,154,203,98,5547
"41051001602",2513,449,193,144,771,311,353,135,4869
"41051001701",3975,651,352,172,890,253,247,83,6623
"41051001702",2186,390,147,179,500,255,166,112,3935
"41051001801",2851,733,59,145,369,158,208,85,4608
"41051001802",2812,305,32,0,140,88,61,11,3449
"41051001900",4129,176,189,0,391,14,112,0,5011
"41051002000",4066,1344,89,21,378,87,174,91,6250
"41051002100",1390,445,31,29,114,46,106,0,2161
"41051002203",1813,423,295,329,128,67,173,106,3334
"41051002303",1061,309,37,112,300,69,35,37,1960
"41051002401",2268,151,189,20,184,0,115,25,2952
"41051002402",2668,260,73,236,235,39,102,9,3622
"41051002501",4043,152,64,0,321,2,102,12,4696
"41051002502",3014,375,170,31,356,2,321,11,4280
"41051002600",2424,190,0,0,89,83,105,11,2902
"41051002701",2835,158,8,0,360,0,62,0,3423
"41051002702",1948,326,80,98,391,73,121,91,3128
"41051002801",2223,257,73,0,347,21,56,0,2977
"41051002802",2050,229,147,0,308,0,77,8,2819
"41051002901",3591,148,56,12,355,8,315,1,4486
"41051002902",3997,534,402,0,349,122,282,34,5720
"41051002903",3127,494,228,163,615,421,416,116,5580
"41051003000",3318,227,440,0,365,47,131,11,4539
"41051003100",3806,254,158,57,257,59,138,53,4782
"41051003200",2862,332,301,82,455,158,54,31,4275
"41051003301",1615,137,380,181,247,425,279,260,3524
"41051003302",2007,346,350,38,173,75,244,23,3256
"41051003401",1399,578,450,552,301,48,85,56,3469
"41051003402",2068,331,478,212,287,75,302,140,3893
"41051003501",2402,414,134,190,293,150,103,119,3805
"41051003502",1418,247,211,10,250,21,181,6,2344
"41051003601",2467,513,1007,243,98,59,354,8,4749
"41051003602",3429,505,1201,257,487,188,289,79,6435
"41051003603",1053,60,202,102,132,9,61,0,1619
"41051003701",2241,169,688,270,492,29,335,23,4247
"41051003702",1773,338,366,50,219,29,85,35,2895
"41051003801",2087,237,48,1,249,235,75,16,2948
"41051003802",1750,393,153,0,432,258,134,234,3354
"41051003803",2668,337,250,139,465,98,352,58,4367
"41051003901",4132,647,1022,291,1145,57,939,154,8387
"41051003902",2162,173,74,53,413,87,127,31,3120
"41051004001",3708,1346,681,1107,812,767,1011,669,10101
"41051004002",2509,960,46,40,489,124,356,69,4593
"41051004101",3893,602,298,114,1151,1015,818,901,8792
"41051004102",3684,403,76,55,647,519,349,465,6198
"41051004200",2237,355,18,151,373,57,309,84,3584
"41051004300",800,36,6,9,81,18,35,0,985
"41051004500",1773,165,0,18,213,131,163,37,2500
"41051004601",2698,114,29,0,370,13,107,40,3371
"41051004602",1835,80,0,0,61,28,82,0,2086
"41051004700",3301,406,47,30,682,29,417,30,4942
"41051004800",1784,575,27,0,487,57,236,57,3223
"41051004900",2122,475,76,186,179,258,221,43,3560
"41051005000",2164,150,0,0,111,0,117,0,2542
"41051005100",4581,1430,122,193,794,133,233,67,7553
"41051005200",2671,679,187,114,506,138,214,45,4554
"41051005500",1230,681,66,38,326,149,147,31,2668
"41051005600",1832,637,11,39,314,221,111,29,3194
"41051005700",2501,613,0,0,522,122,144,116,4018
"41051005800",3811,637,38,0,757,135,214,15,5607
"41051005900",4631,826,56,66,798,90,262,69,6798
"41051006001",1071,214,17,19,113,53,30,0,1517
"41051006002",1735,152,88,7,174,22,158,0,2336
"41051006100",2198,125,13,0,78,4,105,43,2566
"41051006200",2637,239,8,0,68,86,98,29,3165
"41051006300",3486,252,0,0,193,15,98,12,4056
"41051006402",4870,275,0,0,535,4,113,0,5797
"41051006403",2527,321,293,8,466,134,13,26,3788
"41051006404",2727,132,16,0,404,21,123,0,3423
"41051006501",4932,511,37,55,499,40,152,55,6281
"41051006502",3578,336,22,2,191,155,287,26,4597
"41051006601",2117,79,115,0,160,74,53,0,2598
"41051006602",3872,732,42,0,453,0,295,0,5394
"41051006701",2704,201,8,28,233,7,65,7,3253
"41051006702",2548,129,13,14,472,56,320,11,3563
"41051006801",1575,253,10,21,403,55,146,19,2482
"41051006802",2868,232,61,18,313,0,278,10,3780
"41051006900",2300,86,95,4,223,15,96,0,2819
"41051007000",6225,326,176,0,1329,48,339,0,8443
"41051007100",2376,43,0,0,191,29,224,0,2863
"41051007201",1629,244,48,0,107,12,59,0,2099
"41051007202",1678,216,220,116,498,141,240,20,3129
"41051007300",223,174,6,9,109,10,99,73,703
"41051007400",1515,432,650,363,536,175,513,266,4450
"41051007500",2554,483,775,391,920,459,466,418,6466
"41051007600",1860,494,129,228,537,304,553,509,4614
"41051007700",1117,181,20,8,340,208,150,183,2207
"41051007800",1030,155,208,166,300,103,81,104,2147
"41051007900",1947,440,499,54,1029,114,458,12,4553
"41051008001",2460,292,13,19,648,57,290,101,3880
"41051008002",2228,80,28,30,602,59,260,47,3334
"41051008100",3966,758,697,51,950,567,767,554,8310
"41051008201",1788,177,30,0,590,177,218,37,3017
"41051008202",4583,1450,103,569,1660,1150,1027,1145,11687
"41051008301",1443,595,152,458,1163,520,429,45,4805
"41051008302",1987,590,105,148,911,404,304,337,4786
"41051008400",2544,731,165,141,553,475,474,237,5320
"41051008500",2027,1024,22,24,555,119,114,156,4041
"41051008600",2859,579,0,84,509,434,779,74,5318
"41051008700",2685,741,0,0,961,89,307,71,4854
"41051008800",3118,639,13,1,372,112,277,144,4676
"41051008901",5747,909,378,842,1602,300,701,348,10827
"41051008902",2053,464,55,100,849,99,171,177,3968
"41051009000",4760,1250,236,276,1674,535,1350,456,10537
"41051009101",2821,872,231,193,291,1335,381,845,6969
"41051009102",4436,614,115,98,934,127,771,233,7328
"41051009201",3617,1613,396,96,1189,631,624,558,8724
"41051009202",2581,508,271,197,1526,358,829,96,6366
"41051009301",2804,891,494,161,1179,448,819,704,7500
"41051009302",2286,470,101,73,966,172,354,82,4504
"41051009400",4615,803,217,0,1359,64,619,394,8071
"41051009501",2180,775,570,202,659,339,123,196,5044
"41051009502",2125,529,530,398,694,45,275,222,4818
"41051009603",2481,344,32,23,496,134,716,46,4272
"41051009604",2155,937,178,275,1376,273,1382,342,6918
"41051009605",3097,1080,418,297,775,156,508,346,6677
"41051009606",2245,1320,114,135,850,895,670,1321,7550
"41051009701",2953,1032,146,93,811,249,695,360,6339
"41051009702",4315,1447,185,267,1630,342,1056,223,9465
"41051009801",2007,894,65,254,369,457,741,582,5369
"41051009803",3537,1564,117,28,1405,627,986,1163,9427
"41051009804",2323,571,49,26,238,42,366,309,3924
"41051009903",4808,172,47,0,991,10,84,16,6128
"41051009904",2423,459,20,0,159,70,66,379,3576
"41051009905",2778,121,41,0,248,20,436,0,3644
"41051009906",2818,247,80,60,209,0,125,30,3569
"41051009907",3766,745,49,32,410,50,391,42,5485
"41051010001",3488,1136,75,20,467,383,854,393,6816
"41051010002",3558,396,20,12,915,100,383,52,5436
"41051010100",6231,843,84,152,1081,392,1140,1030,10953
"41051010200",3850,687,209,9,785,98,576,292,6506
"41051010303",3736,1172,140,0,370,103,129,676,6326
"41051010304",2274,1020,130,151,661,556,617,759,6168
"41051010305",3291,323,28,0,294,36,70,40,4082
"41051010306",3359,473,33,83,781,0,136,0,4865
"41051010402",5176,394,233,37,137,8,507,0,6492
"41051010405",4344,666,233,26,678,51,916,221,7135
"41051010407",4382,408,27,98,517,102,752,165,6451
"41051010408",4216,994,0,0,327,240,584,402,6763
"41051010409",6515,781,118,0,596,60,703,444,9217
"41051010410",2790,1180,0,0,568,252,748,290,5828
"41051010411",2203,265,30,70,304,54,545,65,3536
"41051010500",3496,428,24,0,468,112,249,44,4821
"41051010600",932,855,97,56,259,186,38,176,2599
"41051980000",0,0,0,0,0,0,0,0,0
"41053005100",1137,424,0,0,125,372,163,386,2607
"41053005201",7259,524,46,0,678,86,748,15,9356
"41053005202",7413,835,30,0,1207,243,1048,157,10933
"41053005300",7455,365,53,0,554,371,477,267,9542
"41053020202",4536,704,0,0,256,0,243,20,5759
"41053020203",1976,633,0,0,137,81,22,42,2891
"41053020204",3869,570,0,9,509,24,358,0,5339
"41053020302",5919,1878,74,0,982,607,2309,1025,12794
"41053020303",1771,807,0,0,495,182,285,77,3617
"41053020304",4700,1340,0,0,355,261,750,269,7675
"41053020400",4018,803,26,0,681,182,190,30,5930
"41053020500",5477,787,0,0,210,116,218,116,6924
"41055950100",1369,358,0,2,70,48,33,51,1931
"41057960100",2522,770,35,0,140,27,99,437,4030
"41057960200",1801,293,6,15,34,26,25,8,2208
"41057960300",2247,260,0,0,127,28,191,8,2861
"41057960400",5193,1105,0,0,712,139,658,134,7941
"41057960500",1740,218,0,1,56,392,115,394,2916
"41057960600",1815,227,0,5,131,6,123,18,2325
"41057960700",2323,229,0,0,17,0,26,0,2595
"41057960800",1612,195,0,0,68,27,0,41,1943
"41057990100",0,0,0,0,0,0,0,0,0
"41059940000",1301,184,0,0,1047,405,90,25,3052
"41059950100",3867,304,32,0,284,58,586,8,5139
"41059950200",4534,1772,14,6,712,598,2241,1647,11524
"41059950300",2283,287,7,0,72,2,172,1,2824
"41059950400",4305,538,16,0,183,15,202,0,5259
"41059950500",4206,306,3,3,172,24,269,29,5012
"41059950600",4496,913,96,25,334,313,398,86,6661
"41059950700",1772,314,0,0,196,53,170,49,2554
"41059950800",4577,812,0,0,276,0,1875,394,7934
"41059950900",2592,544,0,27,666,39,1441,224,5533
"41059951000",4486,1005,12,0,506,30,1518,221,7778
"41059951100",4579,831,0,0,263,20,1284,190,7167
"41059951200",6322,1349,0,10,957,432,2863,1131,13064
"41059951300",2822,395,0,0,458,98,716,172,4661
"41059951400",1792,232,0,0,159,27,51,7,2268
"41061970100",2361,398,0,3,189,49,40,7,3047
"41061970200",2533,370,5,0,135,93,25,67,3228
"41061970300",2090,135,0,0,76,49,102,40,2492
"41061970400",2513,415,9,4,40,7,150,182,3320
"41061970500",2323,1007,0,0,121,11,37,32,3531
"41061970600",3011,547,37,30,177,17,69,90,3978
"41061970700",1550,700,45,0,250,119,57,35,2756
"41061970800",2915,672,0,0,72,46,44,21,3770
"41063960100",1328,314,14,0,102,0,36,29,1823
"41063960200",1642,159,0,0,91,1,28,2,1923
"41063960300",2738,405,0,16,14,22,69,5,3269
"41065970100",3343,419,0,14,291,45,483,115,4710
"41065970200",2185,306,0,12,124,44,169,48,2888
"41065970300",2291,288,11,0,141,343,249,388,3711
"41065970400",1945,479,22,0,447,13,556,246,3708
"41065970500",2282,631,0,0,79,10,241,3,3246
"41065970600",1869,350,26,0,110,19,253,46,2673
"41065970700",1710,555,31,8,141,160,467,266,3338
"41065970800",2461,434,9,0,730,372,210,125,4341
"41067030101",6088,252,89,0,932,29,467,15,7872
"41067030102",4029,180,37,0,994,70,265,57,5632
"41067030200",5677,312,54,26,629,215,141,142,7196
"41067030300",3999,153,179,12,330,50,151,6,4880
"41067030401",3537,581,59,171,670,109,540,376,6043
"41067030402",3176,422,79,0,700,28,108,1,4514
"41067030501",3849,422,30,0,466,74,224,128,5193
"41067030502",2876,403,48,77,470,56,286,121,4337
"41067030600",4507,324,17,0,456,13,369,19,5705
"41067030700",912,252,22,0,163,9,172,0,1530
"41067030801",4965,682,51,117,787,300,780,493,8175
"41067030803",4080,437,32,0,467,266,504,128,5914
"41067030805",3251,158,66,35,158,68,131,36,3903
"41067030806",1816,219,17,8,384,80,116,9,2649
"41067030900",3006,604,305,11,684,364,983,373,6330
"41067031003",5898,388,68,0,739,381,627,224,8325
"41067031004",5715,376,189,14,1050,0,593,0,7937
"41067031005",2998,220,28,0,1273,708,1379,631,7237
"41067031006",3894,939,159,14,539,689,458,519,7211
"41067031100",1281,289,164,34,503,219,722,221,3433
"41067031200",4043,606,63,18,1561,1242,1180,936,9649
"41067031300",4081,1210,24,62,1298,313,1192,789,8969
"41067031402",1278,369,50,93,691,203,281,167,3132
"41067031403",2681,329,102,0,1273,82,877,99,5443
"41067031404",3242,400,140,91,721,291,596,239,5720
"41067031504",4306,273,334,0,957,225,266,42,6403
"41067031506",3052,317,6,30,340,109,37,26,3917
"41067031507",4181,267,123,33,886,0,208,0,5698
"41067031508",5587,204,0,0,1632,55,194,0,7672
"41067031509",2276,200,0,0,790,118,398,57,3839
"41067031511",2200,218,37,0,567,11,175,145,3353
"41067031512",4913,107,160,12,2375,106,324,40,8037
"41067031513",5808,18,68,0,5832,59,586,2,12373
"41067031514",4440,200,72,0,1952,0,359,0,7023
"41067031606",3514,732,296,218,1602,178,1898,195,8633
"41067031609",5295,945,152,83,1670,780,1355,724,11004
"41067031610",4819,877,165,117,1401,564,1271,498,9712
"41067031611",3858,411,94,43,3079,47,452,0,7984
"41067031612",1750,418,108,12,782,83,378,48,3579
"41067031613",3484,989,31,115,1747,382,1135,545,8428
"41067031614",3225,440,225,0,1427,32,710,58,6117
"41067031615",3516,364,96,19,1475,166,1503,131,7270
"41067031616",2052,55,12,0,980,32,659,19,3809
"41067031617",2446,302,48,0,1894,117,628,124,5559
"41067031703",3518,316,0,0,1009,123,871,112,5949
"41067031704",6168,384,188,0,1667,437,1196,368,10408
"41067031705",2512,1070,187,0,955,329,973,596,6622
"41067031706",3015,716,123,0,1217,449,1316,280,7116
"41067031804",3699,161,311,0,1135,344,580,294,6524
"41067031805",5447,189,55,0,1297,0,625,33,7646
"41067031806",3673,160,218,0,1017,95,506,40,5709
"41067031807",2815,238,78,0,539,43,243,11,3967
"41067031812",3873,390,82,20,924,292,410,20,6011
"41067031813",4063,217,235,0,1103,13,106,88,5825
"41067031814",3251,159,0,0,669,0,303,0,4382
"41067031815",5040,356,100,0,1610,77,561,48,7792
"41067031904",2413,55,22,0,454,23,179,0,3146
"41067031907",4901,486,11,0,182,12,66,154,5812
"41067031908",5580,159,0,19,1392,312,807,1,8270
"41067031909",3512,57,11,0,896,63,84,0,4623
"41067031910",6298,602,125,0,1209,91,762,0,9087
"41067031911",3218,329,103,0,890,30,292,4,4866
"41067031912",3457,396,0,0,334,201,414,300,5102
"41067032001",4315,577,98,0,235,62,721,174,6182
"41067032003",2519,619,40,0,378,109,979,310,4954
"41067032004",1376,142,154,0,60,41,177,50,2000
"41067032005",1843,1219,0,47,444,157,490,902,5102
"41067032103",7990,903,31,0,866,176,441,122,10529
"41067032104",4512,88,0,0,225,1,213,0,5039
"41067032107",1759,147,0,0,241,32,351,2,2532
"41067032108",3334,278,193,10,570,42,374,205,5006
"41067032109",2811,61,15,0,186,0,230,18,3321
"41067032110",1535,97,8,0,232,5,57,23,1957
"41067032200",6207,267,28,0,720,92,456,109,7879
"41067032300",3363,343,89,131,770,356,305,373,5730
"41067032404",5771,351,62,43,839,202,916,266,8450
"41067032406",5913,233,49,0,1691,362,870,314,9432
"41067032407",4277,205,28,0,1025,20,733,106,6394
"41067032408",3913,493,233,0,1883,269,604,255,7650
"41067032409",1595,1727,0,0,1326,637,2016,1800,9101
"41067032410",2214,406,0,0,1077,427,1229,625,5978
"41067032501",1548,492,0,57,428,214,1107,212,4058
"41067032502",1673,405,82,0,542,140,389,187,3418
"41067032503",2355,317,7,23,722,199,452,378,4453
"41067032603",5290,98,25,1,1369,272,1014,272,8341
"41067032604",3974,620,30,49,955,206,1151,300,7285
"41067032606",4657,664,35,0,848,180,2104,345,8833
"41067032607",2469,166,101,10,581,70,77,1,3475
"41067032608",1716,56,0,0,282,60,188,0,2302
"41067032609",1628,74,0,0,639,0,300,5,2646
"41067032610",1791,64,39,0,739,129,580,17,3359
"41067032700",4073,480,0,0,360,26,369,75,5383
"41067032800",1112,67,22,0,26,24,47,24,1322
"41067032901",3345,646,19,0,1368,113,1745,326,7562
"41067032902",5045,638,25,0,1294,546,3076,711,11335
"41067033000",4282,341,0,0,333,47,371,52,5426
"41067033101",2319,667,3,0,253,0,317,110,3669
"41067033102",2099,220,0,0,378,147,871,154,3869
"41067033200",3930,567,82,0,619,620,1525,382,7725
"41067033301",4187,706,0,0,574,317,708,483,6975
"41067033302",4326,128,47,13,131,1,218,1,4865
"41067033400",2010,184,0,0,102,27,18,0,2341
"41067033500",3251,177,0,0,258,46,161,35,3928
"41067033600",1848,189,14,0,39,75,11,55,2231
"41069960100",1009,196,0,0,56,1,27,0,1289
"41071030101",4975,518,0,0,226,45,461,32,6257
"41071030102",6195,385,0,0,560,2,612,40,7794
"41071030201",3581,545,40,55,526,83,576,55,5461
"41071030202",3707,1526,0,3,1062,71,597,702,7668
"41071030301",7880,732,18,5,927,237,1156,293,11248
"41071030302",1814,203,9,0,74,0,52,0,2152
"41071030400",6773,384,0,0,256,6,344,0,7763
"41071030501",3590,546,4,0,204,90,292,73,4799
"41071030502",3313,725,25,0,478,38,238,29,4846
"41071030601",2310,331,19,0,572,14,596,90,3932
"41071030602",4460,834,7,0,524,0,299,351,6475
"41071030701",5943,633,55,30,608,260,396,333,8258
"41071030702",4304,1619,102,0,1229,333,1614,387,9588
"41071030801",3274,659,17,0,790,136,1126,228,6230
"41071030802",1508,1169,20,124,592,349,791,541,5094
"41071030900",3517,560,55,0,515,120,877,199,5843
"41071031000",3372,368,13,0,356,46,427,13,4595
"42001030101",2253,110,31,0,174,14,169,14,2765
"42001030102",5288,252,0,0,246,0,232,0,6018
"42001030200",4415,462,57,1,313,153,462,188,6051
"42001030300",3462,205,99,11,273,72,472,91,4685
"42001030400",4377,811,32,0,384,93,307,234,6238
"42001030500",3101,269,6,0,241,41,256,60,3974
"42001030600",3757,249,14,7,92,368,49,335,4871
"42001030700",5796,591,54,20,87,209,400,319,7476
"42001030800",6058,367,176,12,262,0,184,54,7113
"42001030900",6094,785,66,0,374,275,588,442,8624
"42001031000",1557,138,9,1,15,0,0,0,1720
"42001031101",4438,157,0,0,258,88,255,0,5196
"42001031102",3212,91,0,0,52,0,63,0,3418
"42001031201",3328,85,22,0,143,0,85,0,3663
"42001031202",2558,125,0,1,18,0,0,0,2702
"42001031203",3133,14,0,0,8,0,21,0,3176
"42001031300",3927,341,14,0,94,31,57,24,4488
"42001031401",3128,200,169,38,227,0,43,0,3805
"42001031402",1801,143,31,6,38,56,53,6,2134
"42001031501",758,257,44,7,60,36,28,13,1203
"42001031502",2412,554,131,95,271,268,166,267,4164
"42001031600",6422,160,79,5,113,8,116,15,6918
"42001031700",2413,188,11,20,84,0,41,0,2757
"42003010300",401,123,38,75,0,14,48,7,706
"42003020100",1504,413,195,100,267,81,100,6,2666
"42003020300",444,32,45,0,161,0,93,0,775
"42003030500",91,81,920,830,33,107,33,56,2151
"42003040200",187,201,617,313,73,90,4,10,1495
"42003040400",870,352,0,37,239,554,18,11,2081
"42003040500",498,1812,30,172,89,201,33,74,2909
"42003040600",505,1397,87,12,87,139,42,43,2312
"42003040900",975,882,392,43,124,182,60,29,2687
"42003050100",157,22,1071,361,80,0,0,0,1691
"42003050600",233,48,1117,320,107,141,0,0,1966
"42003050900",5,31,397,648,0,53,0,0,1134
"42003051000",84,113,513,280,11,17,0,27,1045
"42003051100",0,84,219,368,0,0,0,0,671
"42003060300",1382,582,275,67,78,166,72,4,2626
"42003060500",1040,160,163,0,56,5,44,21,1489
"42003070300",1433,172,120,0,105,36,19,0,1885
"42003070500",2127,467,70,4,316,109,59,30,3182
"42003070600",1411,171,17,26,229,63,37,0,1954
"42003070800",870,157,130,23,294,250,71,11,1806
"42003070900",1808,563,158,15,1475,456,105,97,4677
"42003080200",1396,158,80,48,19,3,70,0,1774
"42003080400",862,300,19,78,86,137,10,68,1560
"42003080600",1657,250,73,3,151,9,12,9,2164
"42003080700",733,213,246,18,148,57,20,0,1435
"42003080900",1124,222,119,129,48,47,13,0,1702
"42003090100",1215,217,143,110,76,8,51,17,1837
"42003090200",2114,278,138,31,92,25,91,0,2769
"42003090300",1065,449,80,22,35,48,0,11,1710
"42003100500",403,202,1160,379,41,93,0,15,2293
"42003101100",1524,397,787,103,77,55,20,30,2993
"42003101400",2633,167,481,53,85,47,40,47,3553
"42003101600",8,52,474,373,5,0,0,26,938
"42003101700",121,62,994,162,30,9,4,0,1382
"42003101800",2064,45,575,28,23,49,0,0,2784
"42003110200",2290,154,1034,93,283,163,72,24,4113
"42003110600",1818,152,277,85,85,25,25,26,2493
"42003111300",508,106,1216,388,110,50,35,16,2429
"42003111400",94,42,533,648,99,81,14,29,1540
"42003111500",520,205,1274,882,291,38,0,30,3240
"42003120300",48,16,1106,370,9,0,0,0,1549
"42003120400",0,9,346,292,85,0,33,0,765
"42003120700",83,4,589,163,0,12,83,10,944
"42003120800",86,16,465,108,26,12,10,0,723
"42003130100",3,18,964,854,27,94,0,18,1978
"42003130200",16,0,907,530,6,0,0,0,1459
"42003130300",34,16,575,462,13,29,28,0,1157
"42003130400",1,2,677,307,71,29,0,0,1087
"42003130600",146,29,1445,1249,39,119,0,8,3035
"42003140100",1739,331,55,89,206,155,60,46,2681
"42003140200",1612,242,55,0,382,58,102,0,2451
"42003140300",2765,235,217,0,174,44,177,20,3632
"42003140400",1997,125,70,0,108,14,49,9,2372
"42003140500",784,84,758,194,100,18,0,0,1938
"42003140600",2287,268,227,9,176,52,77,24,3120
"42003140800",3582,349,34,16,502,155,134,17,4789
"42003141000",817,32,20,0,28,18,13,0,928
"42003141100",1233,59,24,0,12,0,32,0,1360
"42003141300",3290,628,14,1,484,425,168,63,5073
"42003141400",3957,455,104,30,543,73,217,0,5379
"42003151600",2258,84,117,0,69,59,175,0,2762
"42003151700",3651,192,274,343,240,105,211,0,5016
"42003160800",1731,421,60,45,139,231,10,33,2670
"42003160900",2243,748,58,2,163,0,129,38,3381
"42003170200",2642,834,9,17,205,0,100,17,3824
"42003170600",1300,608,4,46,12,35,18,0,2023
"42003180300",1308,472,582,174,76,26,0,0,2638
"42003180700",1508,376,304,61,106,0,0,0,2355
"42003190300",1695,155,50,54,23,7,74,28,2086
"42003191100",1813,487,43,0,83,0,0,0,2426
"42003191400",2032,373,146,77,50,0,0,0,2678
"42003191500",1315,458,294,67,0,9,163,0,2306
"42003191600",2943,451,383,205,229,177,70,238,4696
"42003191700",2809,202,110,24,295,53,77,0,3570
"42003191800",4201,569,117,28,185,28,37,1,5166
"42003191900",1625,244,196,21,16,26,0,0,2128
"42003192000",2344,562,297,35,177,37,35,126,3613
"42003202200",1096,207,668,161,143,49,48,0,2372
"42003202300",3346,126,116,0,293,100,102,0,4083
"42003210700",431,102,994,360,35,41,23,59,2045
"42003220600",825,134,349,194,32,18,45,21,1618
"42003240600",1879,312,186,49,126,0,23,0,2575
"42003241200",491,76,161,33,39,5,29,3,837
"42003250300",446,85,308,405,57,17,0,0,1318
"42003250700",148,29,367,242,7,16,0,0,809
"42003250900",387,78,393,248,7,17,0,49,1179
"42003260200",1180,86,542,143,36,0,0,0,1987
"42003260700",891,33,616,314,107,0,156,0,2117
"42003260900",26,21,175,1257,10,20,0,14,1523
"42003261200",881,103,118,10,0,0,14,0,1126
"42003261400",399,196,723,518,20,10,43,0,1909
"42003261500",363,174,791,243,44,21,0,0,1636
"42003262000",1370,185,245,437,11,70,0,83,2401
"42003270100",1988,100,589,141,47,15,11,23,2914
"42003270300",1150,208,566,156,92,11,0,0,2183
"42003270400",351,166,208,136,24,25,14,6,930
"42003270800",1972,186,409,156,43,3,24,0,2793
"42003271500",1325,224,959,468,192,80,138,2,3388
"42003281400",1209,124,379,349,26,36,0,0,2123
"42003281500",1144,48,160,29,16,26,32,0,1455
"42003290100",1407,276,133,171,63,0,10,17,2077
"42003290200",2604,400,71,170,172,253,0,21,3691
"42003290400",2872,365,201,185,200,55,145,8,4031
"42003300100",1438,170,1660,1080,123,164,0,67,4702
"42003310200",3028,276,36,0,88,0,46,0,3474
"42003310300",880,7,42,19,22,17,14,0,1001
"42003320400",1704,211,58,57,19,0,0,0,2049
"42003320600",1832,120,59,93,83,241,31,17,2476
"42003320700",1401,128,10,15,73,0,30,0,1657
"42003401100",3783,424,87,0,150,14,0,0,4458
"42003401200",2068,675,399,104,35,66,0,0,3347
"42003401300",2361,121,24,1,80,0,34,3,2624
"42003402000",2512,470,74,0,50,56,0,0,3162
"42003403500",3284,792,265,73,60,26,0,0,4500
"42003404000",1109,147,24,4,42,16,0,8,1350
"42003405000",1040,64,0,0,20,0,0,0,1124
"42003406000",2238,100,16,0,61,7,33,0,2455
"42003407001",4639,75,2,6,33,23,55,0,4833
"42003407002",6246,493,0,81,94,0,0,0,6914
"42003408001",4399,288,9,0,41,0,73,0,4810
"42003408002",5641,274,56,0,365,0,165,0,6501
"42003409000",10786,222,162,0,499,1,179,17,11866
"42003410000",1154,36,0,0,24,3,6,5,1228
"42003411000",6097,99,176,0,733,0,85,0,7190
"42003412001",6975,175,119,0,1081,19,36,0,8405
"42003412002",4960,43,19,0,275,0,31,0,5328
"42003413100",5842,205,265,15,838,44,126,14,7349
"42003413201",3567,112,22,0,88,0,6,0,3795
"42003413202",2564,100,0,2,48,0,0,0,2714
"42003413300",4384,161,65,1,122,0,72,0,4805
"42003413400",3836,207,25,0,156,0,82,0,4306
"42003413500",4438,336,47,61,293,0,0,0,5175
"42003414101",5026,119,0,0,125,0,13,0,5283
"42003414102",6528,213,62,0,499,2,83,29,7416
"42003414200",5295,395,0,2,75,0,40,0,5807
"42003415001",3851,455,8,10,293,0,210,10,4837
"42003415002",2176,165,62,6,55,0,0,0,2464
"42003416000",1450,173,0,0,14,3,0,0,1640
"42003417100",1924,130,0,3,37,46,23,0,2163
"42003417200",1060,181,11,0,17,0,17,0,1286
"42003418000",1590,99,0,1,0,0,0,0,1690
"42003419000",2464,210,0,0,92,8,0,8,2782
"42003420000",1108,180,14,11,150,0,16,9,1488
"42003421100",3248,110,48,2,614,0,23,0,4045
"42003421200",3907,124,9,0,396,0,64,0,4500
"42003422000",4545,312,0,0,361,82,61,34,5395
"42003423000",2531,148,11,0,96,15,28,0,2829
"42003424000",2159,430,312,157,196,174,19,129,3576
"42003425000",2653,613,40,1,48,51,101,0,3507
"42003426300",5856,206,0,0,12,0,9,0,6083
"42003426400",4135,278,0,22,115,0,0,0,4550
"42003426700",1943,190,30,0,71,32,43,0,2309
"42003426800",5189,94,23,0,41,0,0,0,5347
"42003427000",2810,719,107,5,73,18,8,22,3762
"42003427100",5354,223,36,0,0,1,12,0,5626
"42003427200",4281,285,253,31,40,0,99,0,4989
"42003428100",1129,92,0,0,4,0,0,0,1225
"42003428200",1876,64,124,0,42,0,0,0,2106
"42003429100",2016,248,80,34,114,0,41,0,2533
"42003429201",3715,75,30,10,422,0,72,0,4324
"42003429202",4028,254,71,0,123,0,120,0,4596
"42003429300",4820,140,14,0,64,0,48,0,5086
"42003429400",3822,422,155,0,52,8,28,0,4487
"42003429500",3320,440,66,10,276,8,115,0,4235
"42003429600",2701,354,127,8,202,0,19,0,3411
"42003429700",2214,142,0,1,21,0,0,0,2378
"42003430100",1776,121,30,0,28,12,5,0,1972
"42003430200",4405,274,86,0,20,0,12,11,4808
"42003431100",2525,287,221,26,159,19,78,32,3347
"42003431400",1355,235,55,83,104,28,0,0,1860
"42003431500",2416,482,151,52,144,0,49,0,3294
"42003432300",1485,272,218,10,17,37,0,0,2039
"42003432400",1947,222,143,18,250,35,0,0,2615
"42003434000",1573,40,32,0,38,2,11,0,1696
"42003435000",2163,132,42,13,66,0,20,0,2436
"42003437000",4789,133,24,23,217,0,50,0,5236
"42003439000",1231,52,94,0,25,3,13,0,1418
"42003445500",3140,178,268,37,171,43,151,0,3988
"42003446000",1574,41,6,0,25,6,39,0,1691
"42003447000",1365,41,13,7,151,0,30,0,1607
"42003448000",1030,43,54,5,74,0,13,0,1219
"42003449000",2215,218,107,0,77,11,0,3,2631
"42003450700",2124,539,207,9,154,149,68,46,3296
"42003450800",1489,231,343,168,145,79,42,19,2516
"42003451101",3654,196,13,2,60,0,33,0,3958
"42003451102",3347,395,243,81,322,57,59,19,4523
"42003451104",3028,190,147,2,42,40,41,22,3512
"42003451105",3446,611,235,33,84,112,176,104,4801
"42003451300",6061,544,223,0,319,0,125,0,7272
"42003452000",4770,196,37,20,98,2,12,0,5135
"42003453003",1825,80,6,6,82,0,33,7,2039
"42003453004",6041,727,55,55,166,0,203,0,7247
"42003455000",1246,92,8,0,11,0,3,0,1360
"42003456001",3020,468,34,0,175,12,27,0,3736
"42003456003",5747,154,83,2,486,0,60,0,6532
"42003456004",3461,113,74,0,483,35,43,0,4209
"42003457100",996,196,98,0,83,9,0,9,1391
"42003457200",3376,215,17,0,96,0,23,0,3727
"42003458000",6398,480,51,0,323,15,135,0,7402
"42003459101",1345,48,27,0,25,12,18,0,1475
"42003459102",5124,259,144,8,299,0,13,9,5856
"42003459201",4960,255,123,5,636,62,178,0,6219
"42003459202",576,37,16,4,8,0,11,0,652
"42003460001",3787,302,19,204,130,0,33,0,4475
"42003460002",3067,138,15,2,8,12,1,0,3243
"42003461000",891,175,0,3,17,0,13,0,1099
"42003462100",1714,422,23,401,143,96,0,13,2812
"42003462600",2092,327,311,535,105,108,16,22,3516
"42003463900",1514,448,289,120,72,44,0,0,2487
"42003464300",2733,286,106,74,110,11,0,0,3320
"42003464400",1546,678,524,594,123,135,2,0,3602
"42003465600",2157,64,143,13,29,9,47,0,2462
"42003465800",3177,185,42,0,105,16,0,0,3525
"42003468700",1181,349,81,5,17,98,7,0,1738
"42003468800",1717,500,114,10,45,121,36,15,2558
"42003468900",2520,568,206,310,50,78,32,0,3764
"42003469000",3977,113,76,0,252,0,0,0,4418
"42003470300",3147,222,56,0,53,0,38,0,3516
"42003470400",2622,219,39,0,36,16,33,16,2981
"42003470501",1829,115,258,0,1858,0,12,0,4072
"42003470502",2475,133,0,14,136,12,16,0,2786
"42003470600",2435,489,331,16,31,35,42,0,3379
"42003471000",1170,87,8,0,10,0,41,10,1326
"42003472100",2179,128,13,46,91,7,115,45,2624
"42003472200",2305,125,0,2,35,0,83,0,2550
"42003472300",1425,196,3,2,73,0,31,0,1730
"42003472400",1760,87,8,0,65,0,13,6,1939
"42003473100",4106,167,4,1,86,27,35,27,4453
"42003473200",2680,146,0,12,192,138,67,0,3235
"42003473300",4890,518,145,38,113,30,0,0,5734
"42003473401",2975,239,0,30,242,15,15,0,3516
"42003473402",3448,109,15,0,200,0,15,0,3787
"42003473500",3355,44,6,0,246,5,90,0,3746
"42003473601",3364,155,68,0,236,0,103,0,3926
"42003473602",3716,205,52,0,557,17,273,13,4833
"42003474101",3297,87,1,0,294,0,48,0,3727
"42003474102",3450,130,0,0,134,0,147,24,3885
"42003474201",2528,5,4,0,143,0,0,0,2680
"42003474202",4144,101,12,0,408,9,117,9,4800
"42003474203",3887,127,17,1,364,40,133,0,4569
"42003475101",4015,241,92,0,42,0,53,11,4454
"42003475102",1487,33,0,0,52,0,19,0,1591
"42003475200",4565,159,1,1,200,0,43,0,4969
"42003475301",3750,122,287,0,167,25,25,0,4376
"42003475303",3874,107,10,0,103,0,14,0,4108
"42003475304",5305,33,108,1,208,21,26,0,5702
"42003475401",3613,243,0,0,123,24,14,24,4041
"42003475402",2950,107,0,0,12,0,42,10,3121
"42003476100",3844,482,77,36,229,310,38,43,5059
"42003476200",3061,182,13,1,46,19,28,89,3439
"42003477100",3332,261,0,0,72,0,0,7,3672
"42003477200",3823,190,10,0,157,8,41,0,4229
"42003477300",4249,267,284,97,510,388,88,16,5899
"42003478100",3545,438,146,70,140,102,20,73,4534
"42003478200",4050,813,88,10,210,11,51,0,5233
"42003479000",1901,78,0,0,25,15,13,0,2032
"42003480101",3447,154,111,557,440,450,0,36,5195
"42003480102",2768,132,85,13,43,4,27,0,3072
"42003480200",3106,150,66,0,21,0,39,0,3382
"42003480300",3175,215,11,0,7,9,41,0,3458
"42003480400",4345,200,85,107,0,12,0,0,4749
"42003481000",1447,395,624,605,58,268,6,32,3435
"42003482500",1471,52,105,92,26,14,0,0,1760
"42003483800",498,241,1865,456,39,46,0,0,3145
"42003484300",1792,461,660,89,180,23,44,0,3249
"42003484500",5544,360,0,0,68,0,78,16,6066
"42003484600",1751,146,79,14,160,0,22,0,2172
"42003485000",992,181,111,15,6,6,14,0,1325
"42003486700",740,220,459,726,218,242,11,0,2616
"42003486800",430,165,776,271,32,40,4,13,1731
"42003486900",344,71,460,333,13,35,0,2,1258
"42003487000",1593,202,5,0,23,0,26,0,1849
"42003488100",1621,260,258,38,34,0,0,0,2211
"42003488200",2337,251,529,474,9,47,10,13,3670
"42003488300",1867,134,44,0,78,0,95,0,2218
"42003488400",3647,373,236,79,12,0,36,34,4417
"42003488500",2638,117,86,32,65,35,18,0,2991
"42003488600",3982,504,150,0,61,214,6,14,4931
"42003489001",3965,331,0,37,59,0,0,0,4392
"42003489002",3509,75,88,0,108,8,18,0,3806
"42003490002",4287,395,168,60,82,41,35,0,5068
"42003490003",3034,266,36,0,172,0,6,1,3515
"42003490004",4497,179,10,136,35,0,22,8,4887
"42003491101",5855,174,139,13,28,0,52,0,6261
"42003491200",1797,125,6,0,23,12,8,0,1971
"42003492700",1233,418,299,116,36,0,38,10,2150
"42003492800",610,101,940,665,51,152,18,0,2537
"42003492900",1255,367,235,111,150,15,74,10,2217
"42003494000",1098,208,14,0,27,5,29,0,1381
"42003495000",2993,230,108,1,40,0,40,75,3487
"42003496101",2875,129,0,10,18,0,0,0,3032
"42003496102",4082,243,31,0,126,0,0,22,4504
"42003496200",5290,361,42,29,0,0,24,0,5746
"42003497000",872,82,23,2,8,1,22,0,1010
"42003498000",2223,197,53,0,37,0,9,0,2519
"42003499300",1512,149,0,0,0,0,0,0,1661
"42003499400",2259,336,26,57,105,27,21,23,2854
"42003500300",3302,431,2,1,55,3,10,18,3822
"42003501000",1189,230,69,17,34,14,14,4,1571
"42003503002",5523,182,184,0,14,0,11,0,5914
"42003504100",3286,357,499,1079,85,72,27,0,5405
"42003507000",1837,180,59,39,107,0,29,0,2251
"42003508000",1026,388,332,81,40,21,28,3,1919
"42003509400",3403,993,644,122,82,12,100,12,5368
"42003510000",572,120,631,349,72,56,0,19,1819
"42003512000",1484,181,527,32,92,68,0,0,2384
"42003512800",398,102,382,312,55,38,0,6,1293
"42003512900",211,66,670,228,0,13,0,36,1224
"42003513800",541,166,869,714,11,46,5,4,2356
"42003514000",349,128,807,808,25,0,5,24,2146
"42003515100",972,121,708,484,19,0,0,0,2304
"42003515200",1431,148,565,101,20,0,53,12,2330
"42003515300",885,128,426,251,64,193,48,22,2017
"42003515401",1773,257,255,38,84,0,66,0,2473
"42003516100",1209,45,9,40,25,22,52,0,1402
"42003516200",1345,142,125,30,80,24,29,0,1775
"42003517000",1133,174,314,96,17,34,0,0,1768
"42003518001",2807,167,394,1,70,0,17,44,3500
"42003519000",2283,88,356,2,207,0,43,0,2979
"42003520001",2351,308,510,71,80,32,0,22,3374
"42003520002",2252,291,319,77,65,0,57,0,3061
"42003521100",3352,164,833,43,218,12,23,42,4687
"42003521200",3349,156,378,325,209,0,23,0,4440
"42003521301",2330,359,623,127,449,75,87,0,4050
"42003521302",2725,169,339,114,676,0,40,0,4063
"42003521401",2096,154,207,117,81,0,124,17,2796
"42003521402",3183,101,228,0,471,0,26,0,4009
"42003521500",3722,150,46,23,214,106,27,10,4298
"42003522000",2309,349,481,44,102,10,13,14,3322
"42003523100",445,108,2988,491,97,8,26,7,4170
"42003523200",1395,114,1558,715,95,79,30,0,3986
"42003523300",2239,221,1328,97,36,8,79,13,4021
"42003523400",2961,163,1321,489,225,1,78,14,5252
"42003523501",2344,57,1517,574,145,0,0,0,4637
"42003523502",1016,83,148,114,149,0,11,0,1521
"42003523600",3125,154,1065,164,325,0,139,0,4972
"42003523701",3201,184,559,57,71,0,83,15,4170
"42003523702",3237,290,1200,84,252,32,112,17,5224
"42003523800",3943,141,424,27,163,0,9,0,4707
"42003524000",1762,308,103,79,12,12,28,20,2324
"42003525100",1987,66,5,0,36,0,17,0,2111
"42003525200",1780,91,6,1,0,0,29,0,1907
"42003525300",2006,141,0,0,0,0,54,0,2201
"42003526101",6349,167,207,20,168,1,158,0,7070
"42003526102",2034,146,0,0,0,0,23,0,2203
"42003526201",3309,155,133,0,18,4,72,0,3691
"42003526202",4029,222,123,80,242,187,107,36,5026
"42003526301",4011,156,151,18,75,0,49,0,4460
"42003526302",4723,123,254,0,40,0,10,0,5150
"42003550900",672,208,519,219,31,52,17,3,1721
"42003551200",1678,463,610,733,59,212,181,36,3972
"42003551300",2129,317,8,29,43,8,70,0,2604
"42003551900",428,230,260,304,108,45,21,0,1396
"42003552000",1330,324,467,239,197,88,97,124,2866
"42003552100",53,90,201,353,0,34,0,0,731
"42003552200",805,132,51,36,8,0,15,8,1055
"42003552300",450,218,906,388,49,107,120,62,2300
"42003552400",2145,532,157,231,30,35,72,35,3237
"42003560400",316,151,701,160,33,84,14,0,1459
"42003560500",1654,166,318,177,103,0,20,0,2438
"42003560600",220,17,322,200,77,0,6,0,842
"42003561000",291,26,1049,260,30,30,81,10,1777
"42003561100",12,10,411,345,8,73,0,21,880
"42003561200",47,7,662,530,111,12,55,0,1424
"42003561400",904,73,1959,669,212,76,12,34,3939
"42003561500",872,49,1686,408,127,110,0,0,3252
"42003561600",1230,404,253,252,52,0,93,0,2284
"42003561700",426,63,219,347,4,14,11,0,1084
"42003561900",22,73,1719,495,145,34,0,0,2488
"42003562000",1199,957,176,143,454,238,145,132,3444
"42003562300",888,373,1264,588,79,57,60,15,3324
"42003562400",840,109,1150,442,165,51,45,0,2802
"42003562500",906,388,983,353,104,72,103,64,2973
"42003562600",1387,363,269,152,144,143,9,0,2467
"42003562700",599,138,156,213,87,109,1,0,1303
"42003562800",1246,164,159,26,44,46,0,4,1689
"42003562900",1038,130,275,64,95,35,24,0,1661
"42003563000",1473,245,865,185,98,31,62,4,2963
"42003563100",2726,363,91,8,292,251,6,0,3737
"42003563200",1372,299,319,399,145,23,53,10,2620
"42003563300",1408,31,29,0,43,0,68,0,1579
"42003563800",3130,143,36,9,130,5,18,5,3476
"42003563900",3219,298,268,78,81,11,0,10,3965
"42003564000",4731,360,88,0,154,20,16,0,5369
"42003564100",974,14,4,0,16,0,15,0,1023
"42003564200",1994,150,30,0,82,0,9,0,2265
"42003564400",4763,369,211,68,70,5,15,3,5504
"42003564500",2883,323,16,3,107,8,0,0,3340
"42003980000",107,0,17,0,0,0,0,0,124
"42003980100",0,14,0,0,0,0,0,0,14
"42003980300",10,0,0,0,0,0,0,0,10
"42003980400",9,2,0,0,0,0,5,0,16
"42003980500",23,0,0,0,0,0,0,0,23
"42003980600",0,0,0,0,0,0,0,0,0
"42003980700",9,0,0,0,0,0,0,0,9
"42003980800",0,0,0,0,0,0,0,0,0
"42003980900",0,0,0,0,0,0,0,0,0
"42003981000",0,0,0,0,0,0,0,0,0
"42003981100",5,0,0,0,0,0,0,0,5
"42003981200",0,0,0,0,0,0,0,0,0
"42003981800",22,28,7,95,0,22,2,20,196
"42003982200",55,100,0,5,0,0,0,0,160
"42005950100",3796,713,6,0,64,7,8,3,4597
"42005950200",1958,254,2,0,14,3,18,2,2251
"42005950300",2986,452,27,8,16,9,11,12,3521
"42005950400",2222,285,4,24,20,6,0,6,2567
"42005950500",5200,460,6,0,29,1,0,0,5696
"42005950600",2728,311,58,4,40,39,20,32,3232
"42005950700",3383,523,5,0,31,22,44,0,4008
"42005950800",3534,447,0,0,41,0,11,0,4033
"42005950900",4343,648,64,0,3,4,5,0,5067
"42005951000",2163,609,65,1,24,114,0,114,3090
"42005951100",2847,870,0,24,47,27,0,0,3815
"42005951200",5491,400,4,0,35,0,8,0,5938
"42005951300",2112,286,0,0,33,4,8,0,2443
"42005951400",2347,260,92,3,8,1,12,1,2724
"42005951500",2421,481,36,10,27,0,1,0,2976
"42005951600",4125,553,11,48,5,0,16,0,4758
"42005951700",3094,400,35,3,25,1,42,0,3600
"42005951800",1678,345,27,1,66,11,0,11,2139
"42005951900",1560,153,1,0,10,3,0,0,1727
"42007600601",1914,333,3,6,22,4,68,0,2350
"42007600602",2419,94,22,0,23,0,38,0,2596
"42007600700",6978,540,0,6,133,0,77,0,7734
"42007601000",3302,186,61,1,70,0,0,0,3620
"42007601100",1559,574,71,108,73,88,10,17,2500
"42007601200",1436,561,546,221,32,77,7,0,2880
"42007601300",1420,539,147,61,192,30,19,0,2408
"42007601400",2565,294,52,42,155,25,22,14,3169
"42007601600",1084,210,50,3,36,80,29,21,1513
"42007601700",2937,362,0,7,59,0,1,7,3373
"42007601800",6557,647,109,0,93,0,0,0,7406
"42007602100",2344,534,364,159,44,78,30,49,3602
"42007602300",2229,218,0,2,20,55,0,36,2560
"42007602400",1692,44,30,0,9,0,56,0,1831
"42007602500",1225,93,47,0,0,0,5,0,1370
"42007602601",4474,89,17,0,85,0,54,1,4720
"42007602602",3164,69,28,0,0,0,9,0,3270
"42007602701",1688,162,25,5,19,0,39,0,1938
"42007602702",3121,264,93,0,73,4,0,0,3555
"42007602800",1355,523,335,110,196,92,138,0,2749
"42007602900",2546,355,34,1,134,12,37,12,3131
"42007603000",2990,36,0,0,31,1,0,2,3060
"42007603202",6387,500,203,10,64,0,128,0,7292
"42007603300",3002,440,0,136,54,133,0,13,3778
"42007603400",1783,140,11,8,11,0,0,0,1953
"42007603500",1037,343,23,91,44,7,1,9,1555
"42007603600",1830,144,14,0,86,0,18,0,2092
"42007603700",3249,481,74,44,168,0,0,0,4016
"42007603801",2397,473,16,0,84,0,69,0,3039
"42007603802",2703,105,43,0,67,0,17,0,2935
"42007603803",2817,277,69,0,0,18,56,0,3237
"42007603900",2807,266,54,35,7,0,27,0,3196
"42007604000",1347,453,218,230,236,109,82,25,2700
"42007604100",1545,282,228,221,183,153,93,121,2826
"42007604200",804,726,154,1,63,70,24,0,1842
"42007604500",244,37,1484,570,37,0,0,0,2372
"42007604600",2057,207,316,277,84,25,8,7,2981
"42007604700",1040,188,158,36,66,11,15,0,1514
"42007604800",3663,308,164,0,24,0,101,0,4260
"42007604901",3484,150,97,11,85,23,159,0,4009
"42007604902",4402,204,10,0,29,0,32,0,4677
"42007605001",2197,169,14,17,35,0,15,0,2447
"42007605002",3392,266,31,1,91,8,50,0,3839
"42007605100",4566,335,14,1,32,20,0,0,4968
"42007605200",2062,382,71,23,60,45,11,24,2678
"42007605300",2850,219,31,48,31,0,31,0,3210
"42007605400",2336,814,292,143,103,72,6,9,3775
"42007605500",4223,376,292,37,51,15,44,0,5038
"42007605600",2987,226,64,15,53,0,28,2,3375
"42007605700",1124,288,654,257,30,77,20,30,2480
"42007605800",5338,540,27,0,118,0,12,1,6036
"42009960100",3168,483,0,19,45,32,22,3,3772
"42009960200",2998,525,5,0,21,13,9,7,3578
"42009960300",4737,396,67,13,26,12,0,0,5251
"42009960400",4545,662,14,0,15,12,0,48,5296
"42009960500",3006,527,4,0,84,9,22,9,3661
"42009960600",3907,874,17,0,64,9,9,17,4897
"42009960700",2499,331,0,1,0,0,21,2,2854
"42009960800",4003,737,25,0,48,59,27,8,4907
"42009960900",4250,429,4,1,35,33,67,0,4819
"42009961000",5169,509,7,5,52,0,38,5,5785
"42009961100",3645,450,0,0,49,5,37,0,4186
"42011000100",1095,991,258,468,987,1092,1287,1500,7678
"42011000200",1680,714,270,29,332,933,1029,1348,6335
"42011000300",785,293,305,11,568,155,576,353,3046
"42011000400",1397,456,579,214,707,524,1482,884,6243
"42011000500",1646,447,387,107,574,355,912,657,5085
"42011000600",1647,137,252,1,174,83,534,143,2971
"42011000700",1437,365,150,106,1678,666,2137,777,7316
"42011000800",1352,412,512,115,694,780,1488,1138,6491
"42011000900",1241,255,301,17,678,181,1155,322,4150
"42011001000",710,827,343,161,556,626,981,1443,5647
"42011001100",1148,1469,410,310,332,903,1131,2205,7908
"42011001200",128,244,213,135,378,478,458,693,2727
"42011001300",791,426,145,151,718,778,1090,1080,5179
"42011001400",1427,1107,88,137,818,806,1484,1644,7511
"42011001500",1145,892,324,253,537,587,1244,1234,6216
"42011001600",827,524,133,161,777,382,994,706,4504
"42011001700",672,633,119,115,938,714,1259,1142,5592
"42011001800",1617,736,292,270,180,37,417,382,3931
"42011001900",604,573,267,101,352,412,452,681,3442
"42011002000",1445,1105,372,59,715,298,914,1002,5910
"42011002100",790,663,252,155,257,624,577,910,4228
"42011002200",596,297,161,68,526,279,1033,511,3471
"42011002300",747,390,106,143,618,135,1063,400,3602
"42011002500",1294,697,268,92,498,722,1407,1239,6217
"42011002600",713,757,289,268,456,995,907,1508,5893
"42011002700",1318,198,81,14,426,3,430,72,2542
"42011002900",1230,302,269,32,311,0,452,11,2607
"42011010100",5397,469,88,0,29,20,19,29,6051
"42011010201",4109,274,0,4,33,0,72,65,4557
"42011010202",4310,207,0,341,158,5,146,10,5177
"42011010302",2555,178,6,3,71,5,131,17,2966
"42011010303",1838,86,64,0,48,0,137,25,2198
"42011010304",4340,151,0,5,27,17,175,0,4715
"42011010400",7170,723,63,30,125,48,236,106,8501
"42011010500",5220,448,252,50,496,0,302,31,6799
"42011010600",7023,412,128,16,287,82,336,85,8369
"42011010700",5851,460,270,95,270,171,207,209,7533
"42011010801",1731,98,0,0,40,33,39,74,2015
"42011010802",7445,356,395,94,711,53,453,116,9623
"42011010902",3481,220,56,16,161,41,323,37,4335
"42011010903",4690,312,89,0,78,0,114,150,5433
"42011010904",3367,107,148,13,206,98,211,1,4151
"42011010905",3972,256,109,11,156,26,381,36,4947
"42011011000",3719,128,168,0,425,89,474,64,5067
"42011011101",1536,269,76,0,116,0,141,9,2147
"42011011102",4945,87,32,1,315,0,123,0,5503
"42011011200",2329,285,359,15,682,25,721,23,4439
"42011011300",2173,180,120,0,297,39,166,4,2979
"42011011400",4173,379,131,69,353,111,544,191,5951
"42011011500",2683,115,40,13,119,54,124,95,3243
"42011011601",3944,344,43,3,803,0,802,47,5986
"42011011602",3310,202,68,5,425,119,279,108,4516
"42011011603",4857,273,144,9,259,0,260,9,5811
"42011011701",6741,320,13,1,182,1,110,0,7368
"42011011702",4116,76,11,0,302,10,73,14,4602
"42011011703",3660,134,13,0,192,0,60,0,4059
"42011011800",4407,355,73,0,221,45,101,0,5202
"42011011902",3221,97,112,54,18,0,38,1,3541
"42011011903",4323,75,208,0,328,0,146,0,5080
"42011011904",6666,420,323,0,129,0,22,131,7691
"42011012001",2120,187,50,0,87,0,19,0,2463
"42011012002",7372,482,509,81,650,0,363,0,9457
"42011012101",1570,103,17,0,70,37,141,56,1994
"42011012103",2011,146,14,4,140,4,19,0,2338
"42011012104",2899,190,154,1,59,52,51,0,3406
"42011012105",7456,36,377,2,185,0,146,0,8202
"42011012200",2502,270,30,128,176,53,331,103,3593
"42011012300",3303,643,109,78,298,0,155,216,4802
"42011012400",5137,451,130,12,391,24,1172,65,7382
"42011012500",1549,54,16,0,247,66,336,82,2350
"42011012600",1565,486,48,2,353,24,487,166,3131
"42011012700",7610,243,301,1,535,132,710,62,9594
"42011012800",3198,398,31,0,249,34,540,92,4542
"42011012900",6870,440,48,2,12,0,50,20,7442
"42011013000",5822,371,83,0,105,11,23,6,6421
"42011013100",4874,215,0,0,9,0,57,11,5166
"42011013200",3661,311,27,0,30,0,87,19,4135
"42011013301",2635,139,0,0,171,0,181,11,3137
"42011013302",5267,460,44,95,190,0,107,14,6177
"42011013401",7426,251,54,0,87,0,128,0,7946
"42011013402",2926,210,16,0,28,0,22,6,3208
"42011013500",9619,624,71,0,475,118,460,235,11602
"42011013600",3876,88,16,15,19,70,254,70,4408
"42011013701",2811,555,17,22,0,7,11,0,3423
"42011013702",3385,305,0,0,125,14,154,29,4012
"42011013800",3768,401,11,44,13,0,39,75,4351
"42011013900",7077,396,41,11,172,0,175,20,7892
"42011014000",3128,1000,77,34,268,53,256,106,4922
"42011014100",4147,556,0,77,97,3,83,23,4986
"42011014200",7116,439,57,0,74,0,264,6,7956
"42013010101",3621,364,5,6,13,42,12,0,4063
"42013010102",2275,448,27,0,63,0,5,0,2818
"42013010103",2283,159,0,0,0,0,85,3,2530
"42013010401",1717,189,0,7,20,0,38,0,1971
"42013010402",5670,554,116,0,66,0,0,0,6406
"42013010500",3273,253,0,0,63,0,0,0,3589
"42013010600",2464,68,0,0,64,0,0,0,2596
"42013010700",5034,1503,35,65,3,0,26,69,6735
"42013010800",3180,582,13,7,22,3,34,3,3844
"42013010900",6589,528,13,0,112,0,7,0,7249
"42013011001",3324,266,0,0,82,3,0,0,3675
"42013011002",3241,522,0,0,17,6,0,0,3786
"42013011100",5188,547,64,0,166,78,30,0,6073
"42013011200",4880,442,1,12,73,0,79,16,5503
"42013011300",5133,476,22,0,22,4,14,0,5671
"42013011400",2258,220,1,0,80,3,0,39,2601
"42013011500",5016,470,24,166,33,0,85,8,5802
"42013011600",3344,714,23,8,48,0,63,8,4208
"42013100200",1932,194,0,0,0,0,0,0,2126
"42013100300",2198,566,24,105,54,32,37,32,3048
"42013100400",1528,257,54,80,4,10,14,10,1957
"42013100500",2388,667,318,78,44,76,0,43,3614
"42013100600",2152,355,3,14,36,0,4,0,2564
"42013100700",1219,883,11,128,9,87,0,39,2376
"42013100800",1108,210,13,27,0,3,0,3,1364
"42013100900",3731,597,7,17,57,0,172,0,4581
"42013101100",1176,172,139,0,18,38,15,0,1558
"42013101200",3437,265,0,2,114,5,115,15,3953
"42013101400",3166,660,30,17,80,10,0,0,3963
"42013101500",2847,237,29,5,33,24,8,0,3183
"42013101600",2127,1068,26,8,243,15,0,0,3487
"42013101700",2650,622,63,120,128,35,37,0,3655
"42013101800",2382,238,0,114,30,0,0,0,2764
"42013101900",690,645,0,46,69,32,0,0,1482
"42015950100",3586,690,0,2,75,28,49,0,4430
"42015950200",4428,415,1,0,71,12,41,0,4968
"42015950300",4901,459,51,0,52,3,35,0,5501
"42015950400",2370,696,0,0,27,20,116,6,3235
"42015950500",5483,763,101,0,93,4,0,0,6444
"42015950600",3299,460,3,0,39,18,22,3,3844
"42015950700",3725,897,3,30,58,59,34,0,4806
"42015950800",3443,301,12,0,59,20,23,21,3879
"42015950900",4886,487,16,11,107,0,108,4,5619
"42015951000",2135,557,0,0,145,6,65,0,2908
"42015951100",2662,164,0,8,59,28,79,5,3005
"42015951200",4222,759,6,3,92,20,63,39,5204
"42015951300",3694,447,7,23,20,0,57,2,4250
"42015951400",3463,774,7,0,3,2,14,0,4263
"42017100102",1944,107,91,0,429,0,217,0,2788
"42017100103",1988,74,139,37,143,0,152,0,2533
"42017100104",2513,432,342,171,1204,36,377,184,5259
"42017100105",2994,223,19,0,117,0,72,46,3471
"42017100201",2916,291,732,9,310,21,25,21,4325
"42017100206",3743,155,207,71,705,60,339,70,5350
"42017100207",3175,411,179,174,628,0,89,5,4661
"42017100208",4228,345,464,139,663,90,1153,90,7172
"42017100209",5327,295,1047,59,2591,25,645,25,10014
"42017100210",5694,325,120,11,1395,0,279,16,7840
"42017100211",5612,192,256,12,508,0,38,0,6618
"42017100212",3659,111,0,0,316,0,159,0,4245
"42017100302",4619,277,57,0,161,108,272,85,5579
"42017100303",2359,94,1301,622,340,105,368,159,5348
"42017100304",1359,142,412,25,193,0,130,0,2261
"42017100306",2700,39,613,152,288,0,298,0,4090
"42017100307",3667,552,268,13,351,0,429,0,5280
"42017100401",5121,529,315,83,559,0,628,0,7235
"42017100402",5816,415,449,18,356,18,636,18,7726
"42017100403",1111,58,787,354,20,0,45,0,2375
"42017100404",5061,226,211,46,99,132,134,132,6041
"42017100406",3290,113,54,118,170,0,65,0,3810
"42017100407",1173,121,0,0,73,0,85,1,1453
"42017100408",5691,250,153,0,411,14,467,0,6986
"42017100500",2438,204,44,15,111,0,68,26,2906
"42017100600",2637,241,479,20,170,41,377,69,4034
"42017100700",2368,178,238,166,210,121,827,68,4176
"42017100803",4144,399,141,0,160,9,254,130,5237
"42017100804",3519,35,32,64,114,0,139,0,3903
"42017100805",5652,141,79,136,182,0,245,0,6435
"42017100807",3283,301,383,27,84,0,162,15,4255
"42017100808",4572,68,82,0,90,5,278,5,5100
"42017100809",5415,77,261,0,208,0,279,0,6240
"42017100811",2775,331,563,122,728,12,173,37,4741
"42017100900",6504,172,159,5,379,3,175,0,7397
"42017101100",1540,149,181,100,144,40,80,14,2248
"42017101401",4047,64,11,1,263,0,302,0,4688
"42017101403",5408,63,0,0,164,0,38,0,5673
"42017101404",1999,65,81,0,41,25,32,36,2279
"42017101405",5788,393,318,0,217,0,214,0,6930
"42017101503",3129,261,58,0,274,9,241,0,3972
"42017101504",2562,66,97,0,64,0,36,0,2825
"42017101505",3037,59,8,0,205,30,0,0,3339
"42017101506",4864,203,0,3,116,0,145,0,5331
"42017101603",2489,460,3,1,73,26,172,212,3436
"42017101605",2286,603,289,113,650,289,859,269,5358
"42017101607",2762,148,0,0,8,0,184,0,3102
"42017101609",3798,221,65,0,273,25,158,25,4565
"42017101610",4565,142,15,0,74,20,62,0,4878
"42017101611",6557,84,60,1,106,41,202,23,7074
"42017101802",5745,259,96,0,830,13,53,50,7046
"42017101803",6626,457,56,0,587,12,45,0,7783
"42017101805",2054,45,67,0,37,0,9,0,2212
"42017101807",2987,246,344,0,260,127,243,84,4291
"42017101808",1954,172,90,0,301,0,174,0,2691
"42017101900",3699,125,78,0,127,0,40,0,4069
"42017102002",2447,177,27,2,78,10,20,0,2761
"42017102003",3335,147,59,0,237,0,45,0,3823
"42017102004",4267,52,23,0,160,0,34,0,4536
"42017102102",3195,78,0,0,45,20,0,0,3338
"42017102104",4922,224,55,2,282,19,238,67,5809
"42017102300",5426,101,99,2,82,2,43,0,5755
"42017102401",3568,95,20,0,0,0,46,0,3729
"42017102402",4466,289,13,0,36,17,138,7,4966
"42017102500",3617,382,30,0,271,0,42,27,4369
"42017102600",1725,95,0,71,204,0,173,0,2268
"42017102700",4400,378,83,8,199,0,42,26,5136
"42017102801",3057,171,110,0,73,0,62,0,3473
"42017103101",2095,474,0,9,0,9,30,0,2617
"42017103102",1709,117,5,0,73,0,208,6,2118
"42017103103",3637,465,120,8,87,0,119,95,4531
"42017103300",1955,65,0,0,23,0,77,1,2121
"42017103400",4501,380,0,19,94,0,0,76,5070
"42017103700",3172,211,26,0,18,0,19,0,3446
"42017103800",1182,119,8,4,36,0,40,0,1389
"42017103900",3481,306,103,17,54,0,18,15,3994
"42017104000",6074,312,41,0,226,49,16,91,6809
"42017104100",1988,172,0,0,91,23,272,66,2612
"42017104201",2492,70,99,0,128,0,139,0,2928
"42017104203",5084,229,54,0,70,0,233,117,5787
"42017104204",3958,72,23,0,267,0,6,0,4326
"42017104301",2396,113,12,0,31,0,67,0,2619
"42017104303",4422,110,9,0,351,0,219,0,5111
"42017104304",1133,49,0,0,40,0,0,0,1222
"42017104400",2306,76,11,1,120,0,78,0,2592
"42017104502",6460,188,13,0,426,0,107,0,7194
"42017104503",3869,219,10,24,185,67,205,19,4598
"42017104505",5167,410,0,0,627,88,38,78,6408
"42017104506",1978,119,0,0,169,5,64,0,2335
"42017104601",4419,156,0,0,88,0,120,0,4783
"42017104603",4577,172,0,0,77,1,59,1,4887
"42017104604",5360,138,64,3,91,0,54,0,5710
"42017104701",2962,220,89,21,44,10,0,0,3346
"42017104702",2232,68,59,0,46,19,50,19,2493
"42017104703",1994,61,17,0,124,11,68,0,2275
"42017104800",2179,89,30,8,70,0,20,27,2423
"42017104901",6772,192,0,0,482,0,33,1,7480
"42017104902",6486,154,15,0,350,0,250,0,7255
"42017105003",4552,63,49,0,193,12,104,0,4973
"42017105004",5089,43,15,0,308,19,23,19,5516
"42017105006",5431,149,0,1,339,1,179,0,6100
"42017105008",3354,36,0,0,164,0,203,0,3757
"42017105009",3127,171,23,0,91,0,10,0,3422
"42017105010",3947,26,43,0,119,0,88,0,4223
"42017105011",2865,106,0,0,540,0,67,0,3578
"42017105012",2762,6,6,0,83,0,29,0,2886
"42017105013",5363,23,65,0,368,0,0,0,5819
"42017105100",2833,30,9,3,165,0,9,0,3049
"42017105202",4566,335,82,0,282,0,231,27,5523
"42017105203",1706,58,0,0,130,0,58,0,1952
"42017105206",3980,160,8,0,518,0,12,0,4678
"42017105207",4312,85,0,0,518,8,138,0,5061
"42017105208",1873,31,24,0,573,0,118,0,2619
"42017105300",2098,74,0,0,10,0,0,0,2182
"42017105400",7497,253,90,0,286,78,254,31,8489
"42017105505",3666,17,7,1,160,0,64,0,3915
"42017105506",3313,57,95,14,740,0,56,0,4275
"42017105507",6780,250,82,0,246,0,86,0,7444
"42017105508",3372,62,46,5,200,0,93,23,3801
"42017105509",3925,101,81,0,500,0,58,0,4665
"42017105510",3697,125,94,19,496,80,150,0,4661
"42017105511",3461,169,197,0,424,28,51,0,4330
"42017105600",2006,58,87,21,177,0,76,0,2425
"42017105702",1820,126,211,39,282,62,250,62,2852
"42017105704",4134,235,1465,129,638,71,990,129,7791
"42017105801",4396,149,580,69,1058,65,441,150,6908
"42017105805",4386,321,380,0,318,0,342,0,5747
"42017105807",3084,298,149,64,192,0,283,0,4070
"42017105808",2804,316,68,42,264,0,129,0,3623
"42017105809",4037,309,7,0,232,0,130,0,4715
"42017105810",2277,117,7,0,19,3,182,14,2619
"42017105811",5276,287,79,19,78,14,42,0,5795
"42017105812",1707,87,0,0,9,0,65,0,1868
"42017105900",1547,167,15,2,45,13,21,2,1812
"42017106000",3684,266,154,2,153,43,138,0,4440
"42017106100",2020,146,28,24,56,28,7,9,2318
"42017106200",5575,341,28,1,1062,0,759,23,7789
"42017106300",6359,406,74,12,290,10,356,10,7517
"42017106401",6489,423,25,2,695,74,464,54,8226
"42017106402",6631,319,86,181,255,0,24,91,7587
"42017106500",5934,394,0,6,111,0,181,16,6642
"42017106600",1720,137,0,4,70,14,14,12,1971
"42017980000",0,0,0,0,0,0,0,0,0
"42019902100",1855,320,0,0,113,0,10,0,2298
"42019902200",1382,218,90,6,18,14,0,7,1735
"42019902300",2146,1152,42,40,0,139,19,162,3700
"42019902400",1180,668,45,55,0,0,43,16,2007
"42019902500",2564,948,6,44,122,30,67,0,3781
"42019902600",2440,199,113,0,90,4,8,0,2854
"42019902700",1854,300,24,0,11,9,0,0,2198
"42019902800",2449,208,47,12,64,37,12,27,2856
"42019902900",1771,28,0,0,11,21,27,0,1858
"42019903000",4383,202,7,0,50,4,92,0,4738
"42019903100",2202,322,16,0,34,41,0,0,2615
"42019910100",3690,619,15,3,12,32,1,0,4372
"42019910200",4343,543,5,0,84,22,39,3,5039
"42019910301",3271,1479,14,128,98,2,39,31,5062
"42019910302",3379,409,51,0,64,24,53,10,3990
"42019910400",1496,860,39,22,216,82,6,4,2725
"42019910500",10,0,0,0,0,0,0,0,10
"42019910600",3963,399,5,0,26,0,146,0,4539
"42019910700",2760,163,29,0,14,9,0,0,2975
"42019910800",2534,190,10,0,3,0,0,0,2737
"42019910900",4784,293,24,0,14,0,24,0,5139
"42019911000",5801,585,0,0,76,15,78,1,6556
"42019911100",4021,292,49,0,129,182,52,102,4827
"42019911200",4423,720,18,0,10,0,4,0,5175
"42019911300",4748,564,7,13,20,0,25,5,5382
"42019911400",3169,251,0,0,41,0,0,0,3461
"42019911501",5126,147,0,30,48,0,24,0,5375
"42019911502",3894,297,0,4,78,6,84,0,4363
"42019911600",4701,229,0,9,89,12,27,12,5079
"42019911700",4085,285,13,0,27,0,7,0,4417
"42019911800",5790,255,15,0,25,5,40,0,6130
"42019911900",4143,314,0,0,50,15,23,0,4545
"42019912001",4594,122,58,0,98,15,0,0,4887
"42019912002",4107,21,61,0,133,10,21,10,4363
"42019912101",3890,59,14,0,9,0,71,0,4043
"42019912102",2261,156,7,0,83,116,0,0,2623
"42019912200",2689,80,110,0,247,0,111,0,3237
"42019912301",5544,211,0,0,245,10,41,0,6051
"42019912303",2625,81,63,0,118,2,14,0,2903
"42019912304",3360,61,0,0,9,0,43,0,3473
"42019912401",7719,196,0,0,281,0,132,26,8354
"42019912402",5448,381,17,0,314,0,71,0,6231
"42019912700",6738,460,21,0,34,0,54,66,7373
"42019912800",5178,240,2,5,0,0,36,0,5461
"42021000100",494,400,38,124,0,21,0,24,1101
"42021000200",407,164,163,43,24,31,4,8,844
"42021000300",1008,317,99,314,104,201,30,144,2217
"42021000500",1229,379,29,83,40,74,23,9,1866
"42021000600",1079,491,38,81,39,175,0,0,1903
"42021000700",1849,369,114,38,49,172,20,67,2678
"42021001200",2258,873,159,41,33,79,0,77,3520
"42021010100",3607,304,49,7,139,10,28,7,4151
"42021010200",1130,188,115,2,15,3,2,0,1455
"42021010300",2161,199,34,0,6,0,8,0,2408
"42021010500",2889,470,35,16,125,33,0,32,3600
"42021010600",2205,126,5,23,39,25,20,0,2443
"42021010700",2783,266,24,0,9,0,12,0,3094
"42021010801",4631,650,0,6,235,44,38,60,5664
"42021011000",1359,227,35,0,32,2,35,9,1699
"42021011100",4765,117,0,2,78,39,17,3,5021
"42021011200",2054,126,10,0,84,0,29,6,2309
"42021011300",4407,386,147,0,71,71,53,70,5205
"42021011400",3012,362,8,3,46,0,18,36,3485
"42021011500",4108,221,0,1,0,6,8,7,4351
"42021011600",2368,328,0,0,12,0,6,0,2714
"42021011700",2226,432,1,2,0,0,28,0,2689
"42021011800",3396,535,0,1,18,3,0,0,3953
"42021011900",3210,558,0,14,0,0,14,0,3796
"42021012000",5258,519,4,22,51,0,25,13,5892
"42021012100",2094,368,2,0,8,15,21,8,2516
"42021012200",3222,480,4,11,26,25,20,0,3788
"42021012300",1647,243,1,0,41,7,0,27,1966
"42021012400",3130,331,7,7,14,10,26,43,3568
"42021012500",4589,662,54,0,25,19,7,0,5356
"42021012600",2918,378,0,0,11,0,0,0,3307
"42021012700",2388,157,0,0,21,0,0,0,2566
"42021012800",3947,795,16,0,53,12,15,0,4838
"42021012900",3098,435,0,0,3,0,15,6,3557
"42021013000",2040,538,19,0,4,0,7,0,2608
"42021013100",2530,218,0,0,0,0,0,0,2748
"42021013200",3531,318,0,0,12,0,8,27,3896
"42021013300",5205,559,0,0,7,135,11,135,6052
"42021013400",1188,577,297,243,123,78,36,11,2553
"42021013500",1336,762,82,271,49,159,3,75,2737
"42021013600",1926,457,91,339,83,83,12,26,3017
"42021013700",2491,479,0,1,52,2,104,9,3138
"42023960100",1543,372,2,20,14,2,12,4,1969
"42023960200",2700,229,0,2,18,21,7,5,2982
"42025020102",3886,724,56,0,47,18,88,51,4870
"42025020103",3916,521,71,0,175,15,285,0,4983
"42025020105",4037,157,214,0,478,0,509,0,5395
"42025020106",1950,163,0,0,13,33,75,0,2234
"42025020200",5273,563,24,4,74,90,45,72,6145
"42025020300",4822,1197,0,55,58,47,35,107,6321
"42025020400",2884,612,76,63,152,57,178,113,4135
"42025020500",5946,695,12,153,129,0,84,39,7058
"42025020600",4608,641,0,0,124,0,25,98,5496
"42025020700",4802,384,53,10,7,45,13,45,5359
"42025020800",7758,746,17,0,35,20,102,46,8724
"42025020900",4851,427,33,0,86,0,168,85,5650
"42027010100",3947,223,7,0,34,2,18,0,4231
"42027010200",2654,295,0,0,4,7,7,0,2967
"42027010300",2573,571,9,1,59,0,11,14,3238
"42027010400",2982,378,0,0,19,0,35,8,3422
"42027010500",4995,442,8,1,75,4,34,0,5559
"42027010600",3453,545,10,0,24,0,126,0,4158
"42027010700",5156,422,0,0,100,2,164,27,5871
"42027010800",4424,803,0,6,64,8,21,0,5326
"42027010900",6396,850,0,6,65,1,60,1,7379
"42027011000",6607,557,212,46,15,71,84,0,7592
"42027011100",4809,962,87,59,56,0,33,78,6084
"42027011201",4172,235,14,0,27,49,61,0,4558
"42027011300",4750,1521,531,420,668,391,240,160,8681
"42027011400",5442,753,111,0,487,213,54,40,7100
"42027011501",2396,126,64,121,393,60,92,0,3252
"42027011502",4195,1911,157,30,799,735,204,70,8101
"42027011600",2952,165,103,0,235,0,85,0,3540
"42027011702",4880,223,24,0,151,0,11,0,5289
"42027011800",4364,456,21,0,137,0,98,0,5076
"42027011901",2520,68,23,0,63,0,29,0,2703
"42027011902",5725,161,67,0,729,0,113,25,6820
"42027012000",1590,3324,0,38,291,354,43,95,5735
"42027012100",10,208,56,39,15,42,0,16,386
"42027012200",95,69,13,0,169,44,35,59,484
"42027012300",1417,303,0,0,134,11,17,27,1909
"42027012400",2029,1643,26,60,338,440,65,75,4676
"42027012500",801,2822,8,63,118,243,59,120,4234
"42027012600",956,2267,49,155,120,370,92,100,4109
"42027012700",2141,248,88,1,185,6,3,0,2672
"42027012800",2527,937,64,153,889,401,45,19,5035
"42027981202",0,0,0,0,0,0,0,0,0
"42029300101",2569,35,0,0,308,16,52,0,2980
"42029300103",1616,138,186,0,314,46,14,0,2314
"42029300104",4487,97,14,0,385,0,74,0,5057
"42029300106",3580,140,15,0,916,0,100,0,4751
"42029300107",3823,10,20,0,448,7,44,0,4352
"42029300108",4592,579,92,4,1114,102,67,2,6552
"42029300109",3185,205,19,4,330,0,21,6,3770
"42029300201",4189,196,293,0,356,17,221,0,5272
"42029300202",4662,248,36,0,432,0,180,0,5558
"42029300301",3520,75,147,18,201,18,89,0,4068
"42029300302",3475,59,0,5,64,0,5,6,3614
"42029300303",2428,48,123,4,185,19,33,0,2840
"42029300400",2629,217,55,16,154,14,254,49,3388
"42029300501",3972,130,28,0,296,4,94,4,4528
"42029300502",3400,111,50,13,177,0,131,0,3882
"42029300600",3884,171,247,272,749,13,120,63,5519
"42029300700",3564,310,478,49,357,65,594,88,5505
"42029300800",3161,383,196,0,257,23,183,125,4328
"42029300900",1650,213,149,18,146,0,34,41,2251
"42029301000",6729,170,41,0,247,0,162,0,7349
"42029301100",2969,162,63,13,105,21,72,0,3405
"42029301300",5953,210,181,0,186,0,192,19,6741
"42029301401",2160,89,138,0,101,47,41,0,2576
"42029301402",4742,162,124,52,240,0,58,0,5378
"42029301500",2322,170,43,0,15,0,6,0,2556
"42029301600",2379,77,0,0,45,12,0,13,2526
"42029301700",1547,102,9,0,68,0,15,0,1741
"42029301800",4261,211,72,8,98,7,179,12,4848
"42029301900",3869,43,13,0,110,0,131,0,4166
"42029302000",4299,85,98,0,659,0,86,0,5227
"42029302101",5048,172,70,1,1103,157,780,109,7440
"42029302102",2644,104,202,83,371,0,37,0,3441
"42029302202",5282,127,328,0,1009,95,75,42,6958
"42029302203",4064,61,375,28,795,0,98,0,5421
"42029302204",4733,327,167,31,795,0,114,125,6292
"42029302300",2101,298,85,22,59,71,79,50,2765
"42029302400",2564,725,566,57,209,20,791,369,5301
"42029302500",2944,647,177,109,56,30,82,30,4075
"42029302600",1797,2137,421,145,219,14,743,510,5986
"42029302702",3582,141,306,24,502,231,632,22,5440
"42029302703",3527,92,30,0,126,1,17,1,3794
"42029302704",4379,159,111,1,339,0,90,0,5079
"42029302705",3292,204,124,30,623,0,129,29,4431
"42029302706",3267,953,37,8,95,0,78,7,4445
"42029302802",4880,68,11,20,15,0,41,0,5035
"42029302803",1808,63,1,0,80,0,17,1,1970
"42029302804",3675,218,0,0,65,0,92,0,4050
"42029302805",6082,247,505,16,344,0,303,0,7497
"42029302901",4293,83,113,17,181,1,78,3,4769
"42029302902",5632,96,157,31,234,24,59,0,6233
"42029303000",2501,53,115,11,330,0,52,0,3062
"42029303100",3795,62,69,0,302,0,96,0,4324
"42029303301",2624,32,42,0,146,24,375,30,3273
"42029303302",4528,91,42,0,61,4,32,4,4762
"42029303401",3147,503,172,0,191,2,1812,425,6252
"42029303402",1617,35,148,0,195,43,833,30,2901
"42029303501",3670,93,19,8,249,0,136,12,4187
"42029303502",2593,14,31,17,211,0,128,0,2994
"42029303801",3725,220,4,0,65,0,121,36,4171
"42029303802",6680,136,378,0,1018,0,65,0,8277
"42029303901",3197,347,31,0,101,33,89,28,3826
"42029303902",4811,156,141,2,191,26,0,85,5412
"42029304000",3708,190,237,0,675,1,164,1,4976
"42029304101",3257,186,509,69,433,4,158,4,4620
"42029304102",2694,77,307,28,153,0,118,0,3377
"42029304201",5491,278,794,112,338,12,394,12,7431
"42029304300",6769,147,0,0,142,0,173,0,7231
"42029304403",3348,81,122,0,140,33,77,0,3801
"42029304404",4290,307,146,62,348,0,219,0,5372
"42029304405",5548,50,180,0,320,0,27,26,6151
"42029304406",2893,31,113,0,205,0,24,0,3266
"42029304501",5858,112,0,0,2276,0,172,0,8418
"42029304502",2834,28,30,2,126,17,64,17,3118
"42029304600",3135,201,63,10,42,0,16,0,3467
"42029304900",6191,1022,126,0,111,0,27,0,7477
"42029305000",1402,112,15,0,39,22,20,13,1623
"42029305101",3650,287,172,0,237,0,90,11,4447
"42029305102",3985,184,327,53,80,46,274,92,5041
"42029305300",4623,236,1382,141,509,90,359,42,7382
"42029305400",1738,570,715,413,228,128,427,555,4774
"42029305500",653,625,1145,841,222,138,372,579,4575
"42029305600",602,160,1282,944,94,123,224,124,3553
"42029305700",1344,241,546,193,140,0,433,116,3013
"42029306000",6219,190,645,63,196,137,75,99,7624
"42029306300",2392,14,127,22,252,22,773,22,3624
"42029306501",3843,315,128,0,93,13,144,192,4728
"42029306503",1679,512,83,10,201,62,739,481,3767
"42029306504",4384,176,48,31,365,56,1081,137,6278
"42029306600",2899,91,49,0,113,9,100,9,3270
"42029306700",4108,130,29,6,108,5,198,5,4589
"42029306800",1419,163,25,0,79,0,15,64,1765
"42029306900",5239,179,49,0,218,25,498,13,6221
"42029307000",4550,293,232,0,234,51,158,80,5598
"42029307100",2095,94,20,0,27,0,167,11,2414
"42029307200",977,98,42,47,42,28,38,77,1349
"42029307300",2814,254,351,0,205,0,91,0,3715
"42029307400",2787,248,372,1,180,0,361,56,4005
"42029307700",2170,271,0,98,13,0,137,53,2742
"42029307800",2239,263,50,0,25,1,105,1,2684
"42029307900",2748,233,95,4,153,115,499,118,3965
"42029308000",3474,1002,94,18,188,138,1340,536,6790
"42029308101",4107,184,89,14,83,0,152,0,4629
"42029308102",3441,487,99,0,171,14,693,345,5250
"42029308200",2373,168,98,0,75,0,90,0,2804
"42029310400",2,1,0,0,0,0,0,0,3
"42029311000",5484,186,408,103,318,0,116,27,6642
"42029311100",3242,65,16,0,221,0,15,0,3559
"42029311200",2032,61,3,2,24,2,135,2,2261
"42029311300",2845,145,0,0,158,0,77,0,3225
"42029311401",4687,312,1127,345,198,12,390,0,7071
"42029311403",2938,95,119,0,144,0,37,0,3333
"42029311404",3420,404,113,0,87,0,57,0,4081
"42029311500",2933,174,37,1,177,17,53,11,3403
"42029311600",840,194,462,229,90,78,144,89,2126
"42029311700",8258,330,352,20,390,93,2260,373,12076
"42029311800",3124,111,185,24,39,75,105,10,3673
"42031160101",1671,225,18,2,0,0,0,0,1916
"42031160102",3196,1685,26,74,20,35,8,34,5078
"42031160200",2874,516,8,0,33,0,12,0,3443
"42031160300",3957,558,32,0,57,8,4,0,4616
"42031160400",3259,462,2,4,11,0,24,0,3762
"42031160500",3261,427,0,0,50,4,13,0,3755
"42031160600",2262,1129,67,0,168,71,0,0,3697
"42031160700",3581,745,4,13,39,76,10,68,4536
"42031160800",3073,403,0,30,23,0,20,0,3549
"42031160900",3185,478,7,0,26,0,4,0,3700
"42033330100",3610,513,0,9,89,53,16,0,4290
"42033330200",2502,616,0,0,7,32,53,119,3329
"42033330300",3469,908,24,29,85,31,40,183,4769
"42033330400",5630,278,0,0,0,29,143,0,6080
"42033330500",3745,531,0,0,56,52,38,0,4422
"42033330600",2591,203,0,0,70,1,0,1,2866
"42033330700",1677,241,0,1,0,2,0,0,1921
"42033330800",5943,998,0,7,37,1,78,0,7064
"42033330900",4796,1023,3,0,136,35,32,43,6068
"42033331000",4353,572,1,0,4,9,0,0,4939
"42033331100",2548,696,9,1,53,16,49,105,3477
"42033331200",2340,350,96,0,39,0,0,41,2866
"42033331300",3593,591,2,0,59,0,0,0,4245
"42033331401",3019,359,8,6,15,0,21,0,3428
"42033331402",2843,566,2,0,33,0,27,15,3486
"42033331500",1541,300,0,0,2,2,0,0,1845
"42033331600",2020,324,0,0,7,2,0,0,2353
"42033331700",3824,739,2,1,16,8,0,0,4590
"42033331800",2474,589,0,0,2,0,0,8,3073
"42033331900",1973,352,0,0,37,2,5,0,2369
"42035030100",2275,563,0,2,4,3,2,15,2864
"42035030200",4585,561,22,2,127,11,30,8,5346
"42035030300",3499,315,0,0,62,0,25,0,3901
"42035030400",4682,343,8,0,94,0,52,0,5179
"42035030500",3325,382,14,6,48,46,42,22,3885
"42035030600",1349,543,3,22,75,75,12,13,2092
"42035030700",3100,2309,11,84,48,52,5,12,5621
"42035030800",3831,278,6,0,26,0,35,6,4182
"42035030900",3633,291,23,0,31,26,25,3,4032
"42037050100",4304,494,89,7,21,19,15,0,4949
"42037050200",4729,580,0,0,8,0,75,0,5392
"42037050300",4522,593,45,2,58,0,83,11,5314
"42037050400",3739,255,0,0,74,26,11,0,4105
"42037050500",3235,538,0,4,15,95,1,0,3888
"42037050600",4096,637,0,9,96,70,99,43,5050
"42037050700",4193,784,27,0,92,73,223,69,5461
"42037050800",3224,388,1,0,11,1,27,0,3652
"42037050900",2605,270,12,90,72,4,0,4,3057
"42037051000",1895,403,48,224,35,49,121,0,2775
"42037051100",1641,1547,0,39,35,152,139,35,3588
"42037051200",2987,1898,15,73,87,60,85,0,5205
"42037051300",2563,370,26,59,47,11,28,14,3118
"42037051400",2483,128,0,0,48,0,122,0,2781
"42037051500",5103,485,14,1,55,0,73,17,5748
"42039110100",4878,1353,24,0,96,4,20,8,6383
"42039110201",3301,290,17,3,53,3,8,0,3675
"42039110202",2986,441,16,0,14,12,28,1,3498
"42039110300",4086,783,35,0,45,11,12,3,4975
"42039110400",2312,394,0,0,11,3,4,0,2724
"42039110501",1436,124,0,0,22,9,26,14,1631
"42039110502",3251,364,31,10,87,8,7,0,3758
"42039110600",2523,293,15,0,14,77,0,69,2991
"42039110700",3189,421,5,0,11,0,12,2,3640
"42039110800",4499,601,29,7,77,45,13,0,5271
"42039110900",2586,531,0,0,27,3,14,0,3161
"42039111000",2149,260,0,0,19,7,3,0,2438
"42039111100",1604,1039,13,46,59,20,38,20,2839
"42039111200",1757,581,0,10,71,0,52,43,2514
"42039111300",4787,632,26,1,111,1,33,8,5599
"42039111400",4272,483,62,24,40,45,20,0,4946
"42039111500",3664,1029,74,108,174,124,8,20,5201
"42039111600",2107,1133,175,124,43,79,20,9,3690
"42039111700",2747,226,13,5,58,8,5,0,3062
"42039111800",4865,517,122,24,59,0,119,19,5725
"42039111900",3001,465,4,3,50,21,0,6,3550
"42039112001",2091,369,0,0,16,0,11,1,2488
"42039112002",1049,202,0,0,9,0,0,0,1260
"42041010100",3967,519,92,0,245,249,288,26,5386
"42041010201",4851,123,12,0,352,0,91,0,5429
"42041010203",2187,156,104,1,596,49,18,0,3111
"42041010204",4456,305,53,0,491,0,145,0,5450
"42041010300",3250,502,195,0,353,49,252,13,4614
"42041010400",3301,163,55,21,71,73,42,26,3752
"42041010500",3453,123,95,0,326,17,87,0,4101
"42041010600",3485,580,32,3,382,80,160,30,4752
"42041010700",3435,95,77,0,115,0,68,0,3790
"42041010800",2856,351,71,1,219,45,177,9,3729
"42041010900",4391,138,72,0,193,22,137,22,4975
"42041011002",1716,128,42,81,78,0,17,105,2167
"42041011101",2967,86,0,0,269,71,0,9,3402
"42041011102",3549,167,71,228,246,0,59,0,4320
"42041011200",1355,86,24,0,91,4,77,4,1641
"42041011301",3766,78,92,0,425,39,112,0,4512
"42041011302",6475,167,10,0,727,0,132,0,7511
"42041011303",5807,80,0,0,438,12,61,0,6398
"42041011304",4374,149,91,1,236,11,67,70,4999
"42041011305",4035,155,105,0,631,21,142,0,5089
"42041011400",3741,432,284,0,234,21,145,0,4857
"42041011500",3874,86,82,0,192,7,61,0,4302
"42041011601",6210,401,243,197,556,29,133,13,7782
"42041011602",3615,0,59,0,145,0,27,0,3846
"42041011605",3869,134,47,0,248,17,0,0,4315
"42041011700",5659,102,0,3,72,0,117,0,5953
"42041011801",6702,449,76,0,588,230,356,266,8667
"42041011802",5430,234,153,2,219,16,129,15,6198
"42041011803",6010,366,15,0,219,0,113,0,6723
"42041011901",4516,342,37,0,187,215,109,205,5611
"42041011902",5235,297,66,0,95,35,36,14,5778
"42041012000",3377,434,396,195,309,191,56,127,5085
"42041012100",1595,188,48,43,66,28,42,17,2027
"42041012200",1144,211,122,174,67,32,29,22,1801
"42041012300",821,274,148,176,111,106,9,22,1667
"42041012400",4543,439,87,288,255,29,139,0,5780
"42041012501",3251,217,53,0,223,0,336,0,4080
"42041012502",6266,173,0,0,261,8,186,0,6894
"42041012600",5538,225,209,0,41,0,110,0,6123
"42041012701",4826,273,1,0,139,0,32,0,5271
"42041012702",3874,442,38,1,163,23,91,3,4635
"42041012800",6815,631,0,1,385,34,111,8,7985
"42041012900",1156,208,16,0,38,10,10,7,1445
"42041013000",6184,565,12,24,104,3,53,24,6969
"42041013101",7980,910,160,36,110,55,69,0,9320
"42041013102",1391,1490,0,52,19,23,20,0,2995
"42041013200",2662,1271,25,15,210,191,210,68,4652
"42041981001",0,0,0,0,0,0,0,0,0
"42041981606",0,0,0,0,0,0,0,0,0
"42043020100",1565,320,347,442,131,69,172,58,3104
"42043020300",585,148,556,295,42,65,96,33,1820
"42043020400",1008,249,189,107,46,70,92,142,1903
"42043020500",1887,277,662,371,142,46,318,126,3829
"42043020600",115,21,649,230,75,22,24,23,1159
"42043020700",444,91,1259,627,132,108,307,129,3097
"42043020800",852,151,845,465,229,24,44,24,2634
"42043020900",1248,154,1218,504,256,239,328,129,4076
"42043021100",51,257,1839,282,271,507,169,515,3891
"42043021200",109,108,949,561,132,99,170,145,2273
"42043021300",1127,1066,905,1740,955,482,1226,850,8351
"42043021400",391,852,1044,1905,943,525,711,1365,7736
"42043021500",700,140,1852,246,167,95,263,172,3635
"42043021600",454,172,1317,293,205,245,456,185,3327
"42043021700",2213,213,2224,520,880,208,702,199,7159
"42043021800",1614,89,591,13,103,0,39,5,2454
"42043021901",3339,101,591,0,324,0,76,0,4431
"42043021903",2118,96,1141,25,170,81,218,91,3940
"42043021904",2872,97,975,42,557,7,62,7,4619
"42043022000",2923,150,1393,136,501,0,274,0,5377
"42043022100",2870,156,537,57,300,51,254,14,4239
"42043022200",1426,254,840,85,171,217,191,30,3214
"42043022300",4168,171,863,209,205,26,598,0,6240
"42043022401",3050,91,110,47,235,4,69,0,3606
"42043022403",4176,323,637,244,458,0,414,15,6267
"42043022501",5019,82,250,2,239,115,70,0,5777
"42043022502",5076,485,121,0,141,0,92,0,5915
"42043022601",5313,311,514,10,375,0,140,0,6663
"42043022604",4795,182,492,14,989,6,165,0,6643
"42043022605",2527,141,574,114,600,330,245,88,4619
"42043022606",1549,48,894,30,177,106,217,69,3090
"42043022701",2339,115,679,134,325,169,198,110,4069
"42043022702",3053,90,428,232,501,231,159,74,4768
"42043022800",3451,137,585,2,841,158,670,86,5930
"42043022900",3607,556,1397,174,871,121,632,403,7761
"42043023000",1273,140,174,70,105,27,21,15,1825
"42043023100",1065,95,100,0,194,6,185,3,1648
"42043023300",1465,202,1409,618,295,203,223,255,4670
"42043023400",740,95,562,107,15,231,138,56,1944
"42043023500",1564,298,42,114,246,102,112,144,2622
"42043023601",2463,134,0,46,79,0,105,0,2827
"42043023602",3831,288,379,106,317,58,59,40,5078
"42043023700",777,286,154,223,129,95,93,97,1854
"42043023800",2617,268,359,66,165,143,191,10,3819
"42043023900",2622,353,22,0,223,10,154,0,3384
"42043024001",5242,602,22,15,338,37,207,17,6480
"42043024002",2630,275,24,8,28,0,84,0,3049
"42043024101",1073,316,26,21,204,109,89,87,1925
"42043024102",3075,432,0,274,393,218,84,278,4754
"42043024104",5066,167,52,2,873,0,88,2,6250
"42043024105",4438,339,224,0,370,44,94,17,5526
"42043024200",2350,134,164,30,163,24,118,9,2992
"42043024300",3023,506,23,0,234,28,197,22,4033
"42043024400",4098,285,0,0,127,0,129,0,4639
"42043024502",5342,152,89,2,140,0,61,0,5786
"42043024503",5417,317,133,77,414,19,243,31,6651
"42043024600",8495,231,234,1,242,12,79,13,9307
"42043024700",5175,344,7,1,258,15,185,10,5995
"42043024800",7446,785,37,4,61,68,54,11,8466
"42043024900",1961,306,4,19,17,40,7,0,2354
"42043025000",2572,320,0,0,24,20,68,24,3028
"42043025100",3181,465,26,0,36,7,11,26,3752
"42043025200",3157,493,33,10,66,12,64,0,3835
"42043025300",3610,316,1,1,41,1,36,0,4006
"42043025400",2289,196,29,1,24,2,71,0,2612
"42045400301",778,334,3204,1350,460,125,137,50,6438
"42045400302",844,259,2235,325,337,44,345,3,4392
"42045400401",955,239,1638,655,1403,502,566,128,6086
"42045400402",944,81,2448,314,617,164,461,53,5082
"42045400500",1426,155,1183,341,800,94,305,0,4304
"42045400600",3039,501,1540,13,438,117,165,30,5843
"42045400700",1706,229,1392,420,1201,659,191,12,5810
"42045400801",289,124,1512,98,92,35,26,97,2273
"42045400802",1975,88,467,154,467,58,28,10,3247
"42045400900",1389,18,78,6,156,32,59,0,1738
"42045401000",1634,43,133,12,111,0,9,0,1942
"42045401101",2481,289,242,52,34,0,14,4,3116
"42045401103",2990,69,108,19,148,0,28,0,3362
"42045401104",3265,228,289,0,323,0,218,97,4420
"42045401200",3028,164,249,0,68,33,0,33,3575
"42045401301",960,164,233,13,602,19,73,0,2064
"42045401302",2168,46,200,98,258,12,45,0,2827
"42045401401",1471,22,338,26,154,2,36,0,2049
"42045401402",2476,110,725,161,281,11,77,134,3975
"42045401501",3247,240,21,0,43,41,0,0,3592
"42045401502",2783,142,471,349,446,25,6,0,4222
"42045401600",1148,23,455,5,79,0,0,0,1710
"42045401700",758,195,1223,99,377,0,133,7,2792
"42045401800",1248,163,2162,115,156,43,43,76,4006
"42045401900",2002,85,1914,202,392,45,55,0,4695
"42045402000",882,125,925,83,51,26,28,10,2130
"42045402100",418,57,4546,450,53,0,75,16,5615
"42045402200",130,15,1676,149,64,88,32,9,2163
"42045402300",71,6,2538,804,60,0,44,0,3523
"42045402400",331,104,1985,567,34,102,24,80,3227
"42045402500",299,142,2073,985,77,4,124,71,3775
"42045402600",577,359,1625,831,0,49,87,265,3793
"42045402700",324,70,1672,387,76,14,39,0,2582
"42045402800",1579,188,2689,666,439,125,43,57,5786
"42045402900",69,115,2452,684,221,36,20,16,3613
"42045403001",2885,110,0,0,7,0,14,0,3016
"42045403002",1974,467,129,7,65,14,19,14,2689
"42045403101",1916,338,894,40,97,29,49,0,3363
"42045403103",1532,208,1007,52,157,0,95,0,3051
"42045403104",714,338,981,279,178,12,33,12,2547
"42045403200",2858,337,915,32,0,8,28,0,4178
"42045403300",4377,677,745,91,723,26,156,0,6795
"42045403401",1798,148,592,184,29,67,0,103,2921
"42045403402",2260,559,422,280,158,83,172,121,4055
"42045403501",3369,140,175,64,354,0,207,0,4309
"42045403502",2105,316,363,0,270,0,13,0,3067
"42045403601",3381,219,109,0,160,19,17,0,3905
"42045403602",1833,38,45,0,39,12,32,0,1999
"42045403701",1520,266,9,0,0,0,0,45,1840
"42045403702",2027,173,0,1,33,11,126,0,2371
"42045403800",5210,643,78,15,267,32,57,66,6368
"42045403901",2595,333,0,82,189,0,61,9,3269
"42045403902",3488,186,0,0,69,0,0,0,3743
"42045404003",1369,173,138,0,287,63,62,35,2127
"42045404004",5706,332,79,0,122,0,132,46,6417
"42045404101",5087,663,322,221,166,12,44,0,6515
"42045404102",3686,510,443,77,242,80,148,46,5232
"42045404103",2800,363,81,0,31,60,12,23,3370
"42045404300",1679,244,256,44,105,117,65,7,2517
"42045404400",404,173,608,347,14,27,20,39,1632
"42045404500",785,231,2433,1045,195,172,404,251,5516
"42045404600",506,19,987,549,80,54,50,70,2315
"42045404700",222,425,682,811,58,44,30,0,2272
"42045404800",84,98,1176,556,78,103,108,154,2357
"42045404900",64,54,993,101,22,73,72,88,1467
"42045405000",8,59,1203,507,32,0,20,14,1843
"42045405100",26,3,1626,430,0,10,0,26,2121
"42045405200",41,29,1929,997,78,50,103,139,3366
"42045405300",173,199,1477,388,103,191,173,130,2834
"42045405400",120,204,1186,862,79,97,107,266,2921
"42045406100",1485,258,206,37,183,15,108,15,2307
"42045406201",2736,238,111,8,130,0,120,0,3343
"42045406202",4341,247,66,42,79,34,142,0,4951
"42045406300",1623,240,702,583,48,16,181,18,3411
"42045406401",317,4,1648,504,148,147,64,130,2962
"42045406402",255,69,488,380,64,0,18,4,1278
"42045406500",1280,222,288,65,31,19,101,9,2015
"42045406600",1641,351,310,60,29,49,0,46,2486
"42045406700",2607,217,168,348,62,56,36,19,3513
"42045406801",3018,192,752,51,216,25,244,54,4552
"42045406802",3092,298,582,117,73,70,10,0,4242
"42045406803",6731,285,711,155,393,0,194,144,8613
"42045406902",5595,165,0,6,0,0,155,0,5921
"42045406903",4795,179,0,0,149,9,78,0,5210
"42045406904",4282,269,348,0,193,5,19,5,5121
"42045407000",2118,92,99,17,192,13,39,0,2570
"42045407101",3396,73,26,15,376,12,183,0,4081
"42045407102",3182,43,6,0,52,0,37,0,3320
"42045407201",3680,207,166,0,508,0,193,0,4754
"42045407202",2543,242,17,0,104,0,28,20,2954
"42045407401",3341,49,318,15,400,24,37,9,4193
"42045407404",2677,102,33,6,84,11,78,0,2991
"42045407501",2002,146,133,104,124,0,0,0,2509
"42045407502",1865,183,303,10,168,65,51,0,2645
"42045407600",4262,226,169,10,303,0,391,0,5361
"42045407700",1605,115,703,84,161,5,10,0,2683
"42045407801",3936,277,0,0,68,0,9,13,4303
"42045407802",6033,235,0,0,400,0,11,0,6679
"42045407803",5006,234,53,0,136,0,34,0,5463
"42045407804",4188,111,10,0,216,0,31,0,4556
"42045407805",1450,18,34,70,117,0,25,22,1736
"42045407806",1143,44,108,16,107,0,0,0,1418
"42045407901",3543,93,103,24,349,23,110,10,4255
"42045407902",2334,38,79,2,214,0,23,0,2690
"42045407903",2955,102,81,29,226,0,18,1,3412
"42045408001",5692,682,17,1,223,0,77,511,7203
"42045408002",3300,123,105,0,303,83,0,0,3914
"42045408101",4268,136,14,16,186,0,107,0,4727
"42045408102",2813,71,0,7,461,0,0,0,3352
"42045408103",3277,145,310,58,527,11,46,26,4400
"42045408300",2837,38,179,0,158,10,37,0,3259
"42045408400",1570,62,43,3,44,0,5,0,1727
"42045408500",3383,230,72,0,346,0,23,0,4054
"42045408600",3091,57,66,3,160,64,27,64,3532
"42045408700",4446,113,95,0,264,59,62,71,5110
"42045408800",4107,247,224,0,308,0,104,0,4990
"42045408900",2536,62,135,0,221,0,59,0,3013
"42045409000",3048,125,18,0,361,0,7,0,3559
"42045409100",3855,294,17,0,129,20,160,0,4475
"42045409200",3746,82,129,1,195,0,86,0,4239
"42045409300",2120,101,14,0,66,0,46,0,2347
"42045409400",2666,13,13,0,202,0,0,2,2896
"42045409500",4191,126,21,1,206,31,18,0,4594
"42045409601",3767,72,188,14,637,88,109,0,4875
"42045409602",2082,413,158,10,292,0,43,41,3039
"42045409701",4827,303,76,2,706,8,80,16,6018
"42045409702",288,15,29,0,65,0,61,0,458
"42045409802",3285,97,64,9,169,0,100,9,3733
"42045409803",5939,331,323,5,312,0,190,0,7100
"42045409902",4553,92,1,0,150,0,22,0,4818
"42045409903",3281,137,32,1,260,0,19,0,3730
"42045409904",3278,160,34,11,102,16,42,8,3651
"42045410000",3574,25,22,0,245,0,13,0,3879
"42045410100",5506,202,79,4,537,0,171,0,6499
"42045410200",3052,30,62,1,515,18,90,0,3768
"42045410301",5793,86,100,2,411,46,212,0,6650
"42045410302",7623,448,257,44,478,104,43,0,8997
"42045410400",7889,117,178,12,633,35,120,0,8984
"42045410500",679,145,750,140,2301,1006,89,260,5370
"42045410601",3221,77,0,0,218,0,178,0,3694
"42045410602",4311,195,125,122,244,67,39,7,5110
"42045410700",186,182,2967,1071,11,177,59,211,4864
"42045410800",6207,116,315,0,631,8,83,0,7360
"42045980000",0,0,0,0,0,0,0,0,0
"42047950100",1477,96,10,0,0,0,21,0,1604
"42047950200",2588,284,2,0,9,0,10,19,2912
"42047950400",3402,474,0,0,52,61,0,10,3999
"42047950500",2237,469,0,0,27,0,29,0,2762
"42047950900",2019,300,4,25,22,7,16,0,2393
"42047951000",4752,301,17,1,57,5,1,0,5134
"42047951100",4786,383,0,0,16,0,71,0,5256
"42047951200",1883,456,0,0,0,0,0,0,2339
"42047951300",4622,390,78,8,102,0,23,0,5223
"42049000100",559,634,93,175,62,139,0,48,1710
"42049000200",3603,278,68,22,38,10,90,0,4109
"42049000300",2168,750,306,167,25,71,73,212,3772
"42049000400",818,468,255,359,99,185,42,7,2233
"42049000500",1122,820,312,305,217,92,220,314,3402
"42049000600",1572,708,220,496,123,230,255,375,3979
"42049000700",884,422,479,508,149,86,127,125,2780
"42049000800",600,637,310,448,163,493,21,212,2884
"42049000900",2224,1298,371,437,235,42,97,80,4784
"42049001000",2305,906,165,103,215,83,117,129,4023
"42049001100",1690,724,0,56,281,205,257,290,3503
"42049001200",773,495,233,348,141,294,143,266,2693
"42049001300",284,193,286,584,48,167,38,55,1655
"42049001400",253,418,106,114,30,78,19,28,1046
"42049001500",398,371,592,811,88,387,100,468,3215
"42049001600",2775,458,589,82,352,93,114,85,4548
"42049001700",1054,373,832,266,223,91,365,193,3397
"42049001800",464,276,693,318,158,286,151,41,2387
"42049001900",523,805,32,226,44,187,13,65,1895
"42049002000",1882,1049,189,53,56,55,95,58,3437
"42049002100",3244,582,9,101,198,6,98,0,4238
"42049002200",3142,496,49,28,306,0,231,0,4252
"42049002300",2142,457,108,0,45,68,164,32,3016
"42049002400",2398,384,90,66,5,1,68,13,3025
"42049002500",1638,158,261,206,216,84,30,6,2599
"42049002600",2807,450,493,49,234,48,91,51,4223
"42049002700",5204,549,874,60,143,21,124,0,6975
"42049002800",3959,751,565,92,148,0,11,46,5572
"42049002900",2760,128,35,0,63,0,0,0,2986
"42049003000",3341,587,103,66,139,154,37,234,4661
"42049010101",2782,525,0,0,78,22,6,22,3435
"42049010103",1800,311,12,0,34,0,37,0,2194
"42049010104",2061,135,7,0,41,14,12,6,2276
"42049010107",1281,198,9,15,36,15,28,10,1592
"42049010201",5350,549,28,10,101,24,87,67,6216
"42049010202",5120,378,0,1,10,0,12,1,5522
"42049010301",4339,388,5,25,53,5,27,0,4842
"42049010303",4821,377,33,0,108,1,178,0,5518
"42049010304",4054,203,32,6,43,0,57,28,4423
"42049010400",4210,290,0,0,48,69,39,46,4702
"42049010500",3146,730,87,193,42,64,36,0,4298
"42049010700",2924,314,56,18,270,117,90,25,3814
"42049010800",3229,277,0,0,22,8,35,3,3574
"42049010902",3681,316,26,10,117,0,84,24,4258
"42049010903",6017,295,60,0,250,16,69,0,6707
"42049010904",4835,119,181,10,118,0,83,0,5346
"42049011001",5362,723,46,203,418,78,136,23,6989
"42049011002",3473,386,142,2,183,104,38,9,4337
"42049011101",4172,767,25,8,90,0,63,16,5141
"42049011102",2807,206,183,12,146,0,107,6,3467
"42049011201",4380,257,39,1,34,0,0,0,4711
"42049011202",6097,252,80,0,163,0,63,0,6655
"42049011300",2737,340,99,0,100,21,26,0,3323
"42049011400",3414,220,0,0,125,0,203,0,3962
"42049011503",3299,213,68,0,144,5,95,0,3824
"42049011505",2478,169,0,0,11,0,58,0,2716
"42049011507",2865,133,20,0,22,0,90,0,3130
"42049011600",3122,1073,0,0,0,0,74,29,4298
"42049011701",2429,273,42,8,33,0,22,0,2807
"42049011702",4553,532,3,9,149,0,33,5,5284
"42049011801",2435,206,6,0,46,5,34,0,2732
"42049011802",2781,395,6,0,65,16,0,10,3273
"42049011900",4481,1591,51,3,246,62,11,0,6445
"42049012001",2448,199,8,8,30,6,21,2,2722
"42049012002",2542,565,21,0,143,6,43,0,3320
"42049012100",6846,605,92,3,67,4,16,18,7651
"42049012201",5299,620,13,1,42,13,208,0,6196
"42049012202",3775,1248,48,18,117,81,50,0,5337
"42049012300",5075,698,141,5,61,0,64,0,6044
"42049012400",1143,165,12,0,12,15,10,0,1357
"42049980109",0,0,0,0,0,0,0,0,0
"42049990000",0,0,0,0,0,0,0,0,0
"42051260100",4354,477,94,45,372,57,10,41,5450
"42051260200",3633,632,63,20,54,71,5,0,4478
"42051260300",3129,556,25,1,95,0,0,0,3806
"42051260401",2148,451,0,0,14,6,0,0,2619
"42051260402",3615,692,0,0,9,10,15,27,4368
"42051260500",5305,1042,0,0,50,14,18,9,6438
"42051260600",3317,739,12,5,32,4,8,15,4132
"42051260700",2802,709,21,3,77,73,22,10,3717
"42051260800",2995,870,55,0,10,12,60,0,4002
"42051260900",3906,767,0,15,0,0,30,0,4718
"42051261000",2318,204,35,1,20,0,0,0,2578
"42051261100",2216,353,3,1,22,9,17,10,2631
"42051261200",1297,527,189,138,79,279,0,0,2509
"42051261300",4350,220,85,89,23,54,11,9,4841
"42051261401",1729,596,167,95,35,106,28,0,2756
"42051261402",2145,284,248,67,16,68,20,22,2870
"42051261500",3196,727,117,0,127,0,11,1,4179
"42051261600",2398,168,0,0,0,0,19,0,2585
"42051261700",2152,328,61,51,6,101,12,0,2711
"42051261800",2695,629,88,54,142,114,0,18,3740
"42051261900",2006,694,182,192,22,111,4,26,3237
"42051262000",3990,507,81,0,79,0,47,8,4712
"42051262100",1713,416,58,0,0,58,0,0,2245
"42051262200",2759,637,86,94,61,11,0,0,3648
"42051262300",1079,888,731,298,41,85,55,30,3207
"42051262400",2943,382,31,0,88,0,60,0,3504
"42051262500",2961,347,97,0,15,0,0,35,3455
"42051262600",2245,495,53,0,43,0,7,0,2843
"42051262701",2862,501,0,0,54,0,19,0,3436
"42051262702",2327,305,0,0,6,4,27,0,2669
"42051262800",5357,1276,58,62,150,22,35,0,6960
"42051262900",3742,955,135,139,32,0,0,0,5003
"42051263000",2285,670,117,49,123,127,17,75,3463
"42051263100",3899,1577,32,8,67,5,61,8,5657
"42051263200",1902,478,6,0,0,0,0,0,2386
"42051263300",1199,278,9,53,15,2,0,0,1556
"42053530100",1421,219,0,20,0,45,0,11,1716
"42053530201",1143,160,0,5,20,3,20,3,1354
"42053530300",1437,330,0,0,0,0,0,0,1767
"42055010100",3704,683,18,1,27,0,29,0,4462
"42055010200",4157,419,14,0,66,12,73,0,4741
"42055010300",7490,1426,145,147,27,19,105,70,9429
"42055010400",7365,541,174,245,123,212,182,105,8947
"42055010500",6531,1112,115,17,185,19,262,92,8333
"42055010600",5357,150,519,59,205,0,141,39,6470
"42055010700",6972,737,66,0,206,24,64,213,8282
"42055010800",3328,276,115,36,150,41,406,18,4370
"42055010900",2759,672,244,97,288,22,456,193,4731
"42055011000",2718,763,275,324,598,119,721,500,6018
"42055011100",2775,690,191,20,85,0,119,325,4205
"42055011200",1688,835,101,49,149,200,419,570,4011
"42055011301",4503,163,69,0,126,0,116,0,4977
"42055011302",5445,261,40,0,222,10,195,34,6207
"42055011400",5080,559,38,33,172,56,188,0,6126
"42055011500",5332,299,163,44,62,6,34,0,5940
"42055011600",5962,318,35,52,55,26,15,12,6475
"42055011700",7557,497,123,16,104,27,197,8,8529
"42055011800",3429,280,198,25,32,39,28,0,4031
"42055011900",5873,322,139,0,109,39,61,1,6544
"42055012000",5601,572,110,13,66,0,0,0,6362
"42055012100",3518,245,22,76,24,0,22,0,3907
"42055012200",2903,350,2,119,114,33,0,66,3587
"42055012300",3039,731,183,31,81,0,28,64,4157
"42055012400",2258,366,149,49,74,0,70,16,2982
"42055012501",5693,358,50,0,204,1,265,2,6573
"42055012502",3509,204,123,1,97,0,11,0,3945
"42057960100",3933,534,116,44,18,32,32,35,4744
"42057960200",4681,670,2,0,45,8,32,0,5438
"42057960300",4161,316,12,3,57,17,22,0,4588
"42059970100",5684,999,37,0,105,48,23,0,6896
"42059970200",2660,365,213,0,42,0,26,0,3306
"42059970300",3982,508,0,0,49,14,18,0,4571
"42059970400",3431,750,0,1,23,3,3,0,4211
"42059970501",1590,234,1,0,16,0,11,0,1852
"42059970502",2880,451,5,0,7,3,1,0,3347
"42059970600",2493,744,20,8,54,0,0,0,3319
"42059970700",2488,269,0,0,25,0,8,1,2791
"42059970800",3201,585,5,0,79,17,7,0,3894
"42061950100",1491,91,14,0,13,0,13,0,1622
"42061950200",3241,277,7,3,74,5,56,1,3664
"42061950300",4008,560,9,5,40,4,35,27,4688
"42061950400",4612,853,16,32,100,12,13,0,5638
"42061950500",3034,381,0,0,65,26,0,0,3506
"42061950600",3940,182,0,0,27,10,12,0,4171
"42061950800",3167,518,2,0,3,12,27,0,3729
"42061950900",1860,505,46,111,7,34,16,26,2605
"42061951000",2112,428,6,3,53,29,1,12,2644
"42061951100",1659,258,0,0,15,2,14,2,1950
"42061951200",4027,440,6,0,6,2,41,0,4522
"42061951300",1839,400,0,0,11,0,3,0,2253
"42063960100",3259,777,14,0,41,0,40,0,4131
"42063960200",3822,1172,0,0,17,18,0,0,5029
"42063960300",2327,347,2,0,8,8,5,0,2697
"42063960400",3364,275,1,45,42,48,0,62,3837
"42063960500",2983,277,9,5,20,0,9,0,3303
"42063960600",4582,469,0,0,279,10,0,0,5340
"42063960700",5564,993,16,10,141,121,12,0,6857
"42063960800",3369,367,67,29,139,32,49,0,4052
"42063960900",2876,392,156,56,61,23,0,0,3564
"42063961000",1570,580,39,46,38,47,48,8,2376
"42063961101",2059,2053,31,318,13,135,14,0,4623
"42063961102",76,764,2,47,0,22,0,16,927
"42063961200",2171,389,4,81,109,0,25,13,2792
"42063961300",3410,448,17,0,62,11,19,0,3967
"42063961400",2490,507,3,7,15,0,2,1,3025
"42063961500",3542,619,5,0,75,3,3,0,4247
"42063961600",3984,719,0,0,25,0,38,66,4832
"42063961700",1600,116,3,0,0,0,14,0,1733
"42063961800",1548,191,0,6,11,0,0,0,1756
"42063961900",3913,509,0,0,12,0,76,69,4579
"42063962000",3253,787,16,116,145,11,55,33,4416
"42063962100",2802,344,20,28,163,31,62,27,3477
"42063962200",2125,286,0,0,23,0,23,0,2457
"42065950100",1607,372,0,14,28,8,12,8,2049
"42065950200",2675,385,0,9,25,2,13,0,3109
"42065950300",4768,541,6,4,45,0,42,0,5406
"42065950400",1709,238,0,0,20,9,19,0,1995
"42065950500",1633,229,0,0,23,0,6,8,1899
"42065950600",4774,764,3,2,60,12,16,2,5633
"42065950700",1949,757,15,0,0,17,24,0,2762
"42065950800",3133,570,0,0,39,24,0,0,3766
"42065950900",3485,432,4,0,57,18,22,5,4023
"42065951000",3368,814,0,10,16,33,20,5,4266
"42065951100",3391,369,0,0,67,27,26,0,3880
"42065951200",2496,553,12,0,49,14,51,7,3182
"42065951300",1955,517,0,3,33,15,0,12,2535
"42067070100",5941,1045,45,0,118,30,261,141,7581
"42067070201",1459,326,0,0,6,0,8,0,1799
"42067070202",5355,651,23,52,160,32,155,14,6442
"42067070300",4520,461,3,0,67,4,41,9,5105
"42067070400",3742,274,38,0,30,0,20,7,4111
"42069100200",746,427,65,5,660,209,87,45,2244
"42069100300",891,1014,251,14,191,61,205,120,2747
"42069100400",1064,219,55,258,216,29,150,44,2035
"42069100500",1428,324,0,0,24,67,113,26,1982
"42069100600",2367,559,296,68,453,431,434,25,4633
"42069100800",1772,307,18,23,99,0,318,0,2537
"42069100900",1056,165,37,21,0,70,50,70,1469
"42069101000",2877,446,20,25,11,0,0,0,3379
"42069101100",1863,630,18,23,67,59,116,14,2790
"42069101200",2070,338,371,95,63,0,395,67,3399
"42069101300",1865,331,135,2,34,0,0,33,2400
"42069101400",1597,484,239,184,116,17,290,180,3107
"42069101600",1749,421,132,0,24,0,38,0,2364
"42069101700",2629,143,37,29,86,6,448,0,3378
"42069101800",3564,541,86,0,208,0,193,129,4721
"42069101900",1302,144,0,0,24,6,26,19,1521
"42069102000",1458,533,260,28,83,16,175,186,2739
"42069102100",2217,504,14,39,37,9,33,0,2853
"42069102200",1956,271,32,0,61,14,33,40,2407
"42069102300",2382,389,130,89,99,57,309,144,3599
"42069102500",2092,416,190,335,82,56,135,138,3444
"42069102600",1852,582,58,7,117,131,414,180,3341
"42069102700",2257,153,90,0,36,112,136,142,2926
"42069102800",2581,126,0,0,108,0,38,0,2853
"42069102900",1637,982,265,417,61,457,155,584,4558
"42069103000",1597,180,16,9,176,78,266,99,2421
"42069103100",1316,307,13,0,0,0,42,107,1785
"42069110100",2419,278,0,0,15,16,35,3,2766
"42069110201",3670,484,11,0,17,0,3,0,4185
"42069110202",4548,224,0,0,87,47,20,40,4966
"42069110300",3635,323,9,0,75,4,118,3,4167
"42069110401",6124,106,28,0,204,19,42,0,6523
"42069110402",2096,93,0,0,326,0,63,0,2578
"42069110403",2261,26,44,0,102,6,50,0,2489
"42069110500",4858,185,0,0,91,10,35,0,5179
"42069110600",2566,204,5,2,12,6,96,24,2915
"42069110700",1494,523,0,6,0,10,0,94,2127
"42069110800",2544,930,0,103,149,11,65,0,3802
"42069110900",2363,449,0,0,71,0,157,96,3136
"42069111000",1763,375,40,4,51,0,21,17,2271
"42069111100",6154,744,10,2,82,43,145,41,7221
"42069111200",5171,799,14,25,239,60,162,159,6629
"42069111300",4086,512,0,0,58,0,133,0,4789
"42069111400",4642,393,8,110,10,0,0,145,5308
"42069111500",3161,342,27,1,31,9,11,0,3582
"42069111600",2043,284,7,3,120,19,84,33,2593
"42069111700",3347,554,26,90,18,55,92,0,4182
"42069111800",8449,439,20,0,132,18,186,11,9255
"42069112000",3204,508,0,0,57,0,30,0,3799
"42069112100",3856,399,26,0,274,1,373,1,4930
"42069112200",2056,304,0,16,19,0,8,0,2403
"42069112300",2263,117,25,23,80,51,90,16,2665
"42069112400",3850,255,0,2,39,21,25,0,4192
"42069112500",5227,555,53,26,138,124,326,216,6665
"42069112600",4527,575,49,1,49,0,63,0,5264
"42069112700",2750,244,0,0,71,0,159,89,3313
"42069112800",5101,545,0,0,56,0,6,0,5708
"42069112901",3807,168,29,0,20,35,18,36,4113
"42069112902",5006,594,22,5,67,0,114,63,5871
"42071000100",1144,255,365,133,113,194,386,215,2805
"42071000200",1603,101,323,13,551,140,812,199,3742
"42071000300",2475,753,640,89,813,537,1098,782,7187
"42071000400",2560,435,282,100,205,336,763,244,4925
"42071000500",2123,562,39,192,224,364,245,463,4212
"42071000600",2096,312,168,49,224,129,444,187,3609
"42071000700",1392,776,117,30,444,333,548,656,4296
"42071000800",1487,592,446,194,556,650,1798,1204,6927
"42071000900",950,682,637,605,473,280,817,940,5384
"42071001000",1397,452,288,447,503,352,1148,401,4988
"42071001100",1739,309,264,181,480,184,558,311,4026
"42071001200",2928,164,468,438,764,312,1274,526,6874
"42071001400",1468,963,536,492,762,575,1277,930,7003
"42071010101",6815,347,41,0,91,0,158,0,7452
"42071010102",3447,139,21,0,156,5,131,0,3899
"42071010201",4311,359,17,0,124,19,0,0,4830
"42071010202",4847,494,0,0,144,6,152,31,5674
"42071010300",8046,229,0,1,469,0,533,0,9278
"42071010400",4079,501,13,12,184,71,207,0,5067
"42071010501",4064,167,100,1,86,6,166,6,4596
"42071010502",5697,284,61,37,55,17,120,17,6288
"42071010600",8096,1478,0,0,419,34,346,34,10407
"42071010701",4976,336,95,0,251,0,213,0,5871
"42071010702",3360,333,36,14,65,45,12,32,3897
"42071010801",7322,265,29,0,134,0,104,0,7854
"42071010802",3155,110,0,0,12,0,0,0,3277
"42071010900",5984,600,369,65,279,274,477,223,8271
"42071011000",2235,178,105,25,30,0,39,7,2619
"42071011100",7294,287,64,0,119,40,100,0,7904
"42071011200",1157,447,93,13,88,69,121,219,2207
"42071011300",3458,524,119,0,102,122,235,87,4647
"42071011400",2882,625,126,50,154,118,183,57,4195
"42071011502",4955,429,80,14,347,204,512,257,6798
"42071011503",4166,420,236,3,402,0,387,180,5794
"42071011504",6732,192,183,3,495,18,777,18,8418
"42071011600",4978,641,62,0,239,3,522,23,6468
"42071011701",3722,384,96,0,561,59,626,173,5621
"42071011703",7509,204,125,0,105,0,102,0,8045
"42071011704",3615,196,14,0,231,41,42,61,4200
"42071011705",4234,302,228,14,390,13,501,14,5696
"42071011801",2819,47,71,0,60,37,0,37,3071
"42071011802",4823,244,160,0,275,0,361,39,5902
"42071011803",4999,203,69,0,272,95,561,87,6286
"42071011804",6673,281,34,70,1059,88,621,63,8889
"42071011805",1520,186,93,0,330,36,708,109,2982
"42071011901",4921,59,185,83,427,0,275,83,6033
"42071011902",6274,321,44,10,438,0,129,34,7250
"42071012001",4582,90,62,16,406,18,180,0,5354
"42071012002",3214,313,16,10,170,159,115,189,4186
"42071012102",7360,102,148,1,123,0,175,0,7909
"42071012103",3676,230,0,0,48,2,0,0,3956
"42071012104",5502,244,201,0,64,0,220,0,6231
"42071012200",6197,536,73,0,677,0,413,14,7910
"42071012301",2674,195,0,0,97,0,49,19,3034
"42071012302",2538,210,29,2,187,16,10,0,2992
"42071012402",3491,273,0,5,141,1,76,0,3987
"42071012403",3614,278,0,0,308,12,102,0,4314
"42071012404",4521,360,143,15,90,0,65,0,5194
"42071012501",6619,287,71,33,421,21,348,21,7821
"42071012502",3868,653,0,0,32,0,64,165,4782
"42071012601",6739,356,0,0,73,42,159,0,7369
"42071012602",4076,475,7,13,76,0,38,0,4685
"42071012700",6843,564,0,77,452,27,308,74,8345
"42071012800",4337,199,301,339,224,0,224,17,5641
"42071012900",5617,1104,0,0,219,0,81,0,7021
"42071013000",6129,808,58,0,768,9,134,0,7906
"42071013101",4088,835,122,0,204,31,235,70,5585
"42071013102",2960,387,1,0,84,0,142,0,3574
"42071013202",4221,612,571,57,594,22,768,60,6905
"42071013203",3954,347,128,133,426,13,304,0,5305
"42071013204",5191,311,311,45,360,92,282,136,6728
"42071013301",3905,147,214,0,288,0,432,0,4986
"42071013303",4213,195,42,1,66,1,0,0,4518
"42071013304",6498,353,0,0,313,0,192,0,7356
"42071013400",1498,155,110,0,408,116,675,187,3149
"42071013501",5133,1302,958,405,1089,310,1911,991,12099
"42071013502",3331,426,140,11,268,19,322,68,4585
"42071013503",2472,36,17,0,87,0,59,0,2671
"42071013601",1241,165,0,1,86,0,49,0,1542
"42071013602",3341,772,292,0,177,34,80,76,4772
"42071013701",3796,401,170,0,175,78,211,37,4868
"42071013702",7775,662,508,53,297,59,643,238,10235
"42071013800",3594,24,30,0,82,29,0,13,3772
"42071013901",4058,329,105,0,98,31,123,3,4747
"42071013902",3453,128,0,0,110,78,156,7,3932
"42071014000",6355,484,23,0,52,71,32,4,7021
"42071014101",4937,291,0,0,13,21,41,49,5352
"42071014102",4530,571,11,4,41,21,14,0,5192
"42071014201",5349,297,18,0,5,0,8,0,5677
"42071014202",4694,473,66,15,137,22,111,70,5588
"42071014300",6582,673,48,15,28,73,43,12,7474
"42071014401",5886,729,0,0,273,0,228,0,7116
"42071014402",4087,566,26,0,178,0,207,12,5076
"42071014501",4694,429,9,0,69,0,158,0,5359
"42071014502",4601,997,0,0,16,0,101,16,5731
"42071014601",3339,251,42,0,37,0,151,40,3860
"42071014602",7305,368,52,0,27,5,82,5,7844
"42071014700",1377,1059,521,350,338,739,1317,1606,7307
"42073000100",3476,269,104,1,83,33,32,0,3998
"42073000200",1114,473,37,87,155,17,46,4,1933
"42073000300",2132,755,220,466,302,59,34,121,4089
"42073000400",391,538,306,502,44,60,0,0,1841
"42073000600",808,122,116,4,0,0,0,4,1054
"42073000700",817,613,111,56,84,89,24,24,1818
"42073000800",3414,492,404,146,70,37,31,0,4594
"42073000900",837,364,125,163,18,26,6,12,1551
"42073001000",1280,377,0,0,43,0,0,0,1700
"42073010100",3451,500,13,3,42,64,54,3,4130
"42073010201",3110,139,18,0,40,0,0,0,3307
"42073010202",4543,462,20,0,24,13,54,0,5116
"42073010300",1130,144,0,0,11,4,14,0,1303
"42073010400",3069,254,0,27,25,19,0,0,3394
"42073010500",2401,577,0,0,52,0,41,0,3071
"42073010600",1933,240,16,77,19,0,0,36,2321
"42073010700",2442,274,131,1,16,9,32,0,2905
"42073010800",5402,482,13,88,189,11,44,46,6275
"42073010900",2935,307,0,0,0,0,5,0,3247
"42073011000",4901,299,0,0,0,0,10,0,5210
"42073011100",3058,820,8,0,29,0,31,15,3961
"42073011200",2291,197,0,0,8,0,19,0,2515
"42073011300",4157,139,0,2,46,1,48,0,4393
"42073011400",1822,378,13,2,25,0,25,0,2265
"42073011500",3661,302,3,0,91,10,6,0,4073
"42073011600",3372,365,0,0,179,6,78,0,4000
"42073011700",1829,268,0,0,15,4,15,4,2135
"42073011800",2038,430,75,0,90,0,0,0,2633
"42075000100",2392,534,65,67,436,331,623,214,4662
"42075000200",2899,866,134,67,489,112,633,190,5390
"42075000300",1855,633,128,59,1461,688,1833,924,7581
"42075000401",1838,811,86,164,625,1196,632,1209,6561
"42075000402",1823,668,18,138,763,328,903,429,5070
"42075000500",2441,498,8,102,309,319,403,697,4777
"42075002000",2886,155,0,0,89,0,47,0,3177
"42075002100",4228,529,110,0,150,15,135,15,5182
"42075002200",5215,454,88,0,250,109,264,119,6499
"42075002300",2612,74,14,0,29,0,66,0,2795
"42075002400",2339,99,0,0,4,0,9,8,2459
"42075002500",2746,352,99,2,101,84,46,44,3474
"42075002600",2009,82,10,0,113,6,183,13,2416
"42075002701",5243,214,0,1,433,48,265,31,6235
"42075002702",4870,269,82,1,343,0,364,0,5929
"42075002800",7405,256,38,20,251,55,215,0,8240
"42075002900",2469,275,7,0,182,0,255,66,3254
"42075003000",4794,602,0,0,143,49,154,49,5791
"42075003100",3821,237,46,0,9,0,26,0,4139
"42075003200",4018,213,73,11,175,0,209,63,4762
"42075003300",1698,63,16,0,190,11,207,11,2196
"42075003400",2291,72,23,0,29,0,44,0,2459
"42075003500",3930,180,162,26,490,25,267,25,5105
"42075003600",2427,285,231,56,374,129,484,153,4139
"42075003700",2540,200,19,0,43,11,28,0,2841
"42075003800",7570,201,0,0,246,0,68,0,8085
"42075003901",2914,280,68,0,128,30,14,0,3434
"42075003902",3472,160,13,0,222,33,210,33,4143
"42075004000",6507,210,20,8,242,0,82,0,7069
"42075004100",1820,125,0,0,49,0,44,0,2038
"42075004200",3803,52,0,0,130,0,26,0,4011
"42077000101",2086,240,196,98,727,44,883,1,4275
"42077000102",2686,544,543,13,472,19,1248,184,5709
"42077000400",1626,903,137,243,274,235,589,823,4830
"42077000500",732,384,219,305,440,403,848,684,4015
"42077000600",3647,615,735,0,1010,919,2196,1429,10551
"42077000700",1457,419,218,208,1085,788,1745,1184,7104
"42077000800",1027,604,464,293,562,698,1397,1160,6205
"42077000900",401,173,131,111,169,232,386,332,1935
"42077001000",1006,441,263,113,595,431,1205,750,4804
"42077001200",555,362,264,71,108,246,444,513,2563
"42077001401",3943,1823,309,187,798,891,1541,2132,11624
"42077001402",1578,112,142,0,147,115,287,139,2520
"42077001501",3634,920,578,263,940,656,1848,1483,10322
"42077001502",4705,655,874,147,629,171,1986,294,9461
"42077001600",904,258,359,331,563,910,722,1192,5239
"42077001700",1571,421,384,440,1347,871,2572,1237,8843
"42077001800",1226,1138,704,608,1112,570,1537,1443,8338
"42077001900",2827,880,174,46,598,86,1322,767,6700
"42077002000",2537,1269,263,76,445,238,1522,974,7324
"42077002100",2915,797,623,410,1038,853,1537,1150,9323
"42077002201",3588,137,191,13,241,28,476,80,4754
"42077002202",994,381,204,31,124,0,172,259,2165
"42077002301",5676,338,264,0,515,0,524,19,7336
"42077002302",2243,36,17,0,74,0,201,0,2571
"42077005100",3407,587,30,77,55,30,229,30,4445
"42077005200",6087,511,28,2,15,0,140,10,6793
"42077005301",3190,42,95,0,97,0,125,0,3549
"42077005302",3974,270,0,5,0,1,45,3,4298
"42077005401",1963,150,59,0,90,0,75,0,2337
"42077005402",4457,286,0,0,185,39,32,13,5012
"42077005503",4342,182,0,0,48,0,282,53,4907
"42077005504",3914,317,57,102,79,38,198,53,4758
"42077005505",3070,55,0,2,100,0,6,25,3258
"42077005506",2983,203,0,0,104,16,106,0,3412
"42077005601",4017,165,363,42,185,0,428,41,5241
"42077005602",4330,162,140,0,388,18,273,0,5311
"42077005702",3395,363,201,28,114,119,205,119,4544
"42077005703",2461,539,248,61,493,72,917,254,5045
"42077005704",1843,137,222,0,857,257,439,178,3933
"42077005705",3480,48,678,0,1018,134,685,36,6079
"42077005800",2665,382,33,0,101,11,148,64,3404
"42077005901",5296,550,239,57,309,15,832,63,7361
"42077005902",1206,141,91,3,138,0,94,18,1691
"42077006001",4110,50,97,0,250,0,259,0,4766
"42077006002",4540,315,66,1,589,93,123,72,5799
"42077006101",2748,307,248,2,176,2,479,14,3976
"42077006102",4265,117,175,98,489,1,185,121,5451
"42077006202",7137,237,280,0,1133,178,648,96,9709
"42077006203",6164,192,226,0,938,155,271,24,7970
"42077006204",3452,11,76,10,614,3,17,3,4186
"42077006302",5695,116,401,90,557,22,298,53,7232
"42077006303",2702,127,58,0,183,14,268,88,3440
"42077006304",3377,163,22,0,276,6,172,8,4024
"42077006305",5420,373,189,0,491,83,404,12,6972
"42077006307",6898,519,57,0,634,162,387,0,8657
"42077006308",6245,71,320,0,702,0,514,1,7853
"42077006401",2544,408,0,0,34,21,234,21,3262
"42077006402",4238,251,8,0,101,0,149,0,4747
"42077006500",4672,567,48,5,264,14,236,14,5820
"42077006600",4881,224,0,0,261,0,178,0,5544
"42077006701",3645,161,156,0,533,2,585,9,5091
"42077006702",2595,124,11,47,17,0,146,17,2957
"42077006703",4989,238,401,0,347,0,311,0,6286
"42077006800",3196,285,270,53,425,139,876,199,5443
"42077006902",1974,78,45,0,46,0,28,6,2177
"42077006903",4822,330,2,6,491,118,177,109,6055
"42077006905",4076,62,0,0,91,0,232,0,4461
"42077006906",3496,50,24,0,466,15,36,0,4087
"42077007000",3631,130,0,0,11,0,68,0,3840
"42077009100",2468,362,121,0,157,21,183,51,3363
"42077009200",3208,110,98,12,244,33,284,0,3989
"42077009300",2672,224,175,35,186,0,347,0,3639
"42077009400",2400,653,243,44,443,169,854,384,5190
"42077009500",3132,513,376,21,240,275,436,368,5361
"42077009600",2851,815,597,561,624,1250,2167,1217,10082
"42077009700",828,647,465,406,354,539,716,1009,4964
"42079200100",599,427,30,3,0,18,5,23,1105
"42079200200",2262,669,235,218,162,31,291,41,3909
"42079200300",1141,207,109,133,61,114,16,81,1862
"42079200400",1709,228,203,160,32,52,118,22,2524
"42079200500",1324,767,146,191,234,84,377,274,3397
"42079200600",1441,374,194,50,43,81,64,63,2310
"42079200700",2018,623,333,188,268,43,168,302,3943
"42079200800",1878,398,268,278,573,202,567,210,4374
"42079200900",1236,683,371,296,179,169,75,263,3272
"42079201000",1060,366,261,614,14,131,79,380,2905
"42079201100",736,429,98,22,111,0,180,110,1686
"42079201200",943,272,111,34,109,50,103,81,1703
"42079201300",1212,413,121,0,216,14,323,152,2451
"42079201400",1228,341,137,60,305,68,307,32,2478
"42079201500",1314,457,16,210,159,30,190,61,2437
"42079201600",2193,292,0,27,66,0,84,26,2688
"42079210100",2936,358,6,0,22,0,0,0,3322
"42079210200",2409,178,0,0,30,96,0,0,2713
"42079210300",2469,161,0,0,18,0,30,0,2678
"42079210400",1232,137,0,0,23,28,15,0,1435
"42079210500",4062,639,18,0,0,201,82,19,5021
"42079210600",981,129,0,0,0,1,6,0,1117
"42079210700",1331,267,0,24,45,5,0,17,1689
"42079210800",2601,543,3,20,170,0,198,22,3557
"42079210900",1161,366,1,0,46,17,26,0,1617
"42079211000",4332,474,1,1,0,0,75,0,4883
"42079211101",4324,983,54,98,62,0,78,307,5906
"42079211102",2130,45,0,0,24,7,22,9,2237
"42079211201",2303,252,0,0,196,0,36,0,2787
"42079211203",1457,190,0,0,27,0,12,7,1693
"42079211204",4828,286,0,0,88,0,80,0,5282
"42079211205",2587,161,0,0,17,0,0,0,2765
"42079211301",2407,71,0,0,28,0,8,0,2514
"42079211302",3066,383,0,0,42,0,0,0,3491
"42079211303",2382,175,0,1,102,99,68,0,2827
"42079211304",1897,254,7,0,11,18,8,18,2213
"42079211400",6374,401,13,32,109,24,121,0,7074
"42079211500",2507,213,0,0,3,0,9,50,2782
"42079211600",2526,440,5,8,77,0,0,0,3056
"42079211701",4531,321,16,0,3,0,66,0,4937
"42079211702",1277,23,0,2,128,1,23,4,1458
"42079211800",1224,136,10,0,105,66,25,48,1614
"42079211900",5238,908,38,32,33,24,0,1,6274
"42079212000",1513,214,0,0,59,0,12,0,1798
"42079212100",3816,316,41,0,30,0,0,0,4203
"42079212200",4461,566,0,0,10,0,1,0,5038
"42079212300",2023,626,30,106,64,0,1,110,2960
"42079212700",3296,536,223,371,159,104,0,175,4864
"42079212800",3099,284,20,15,214,0,198,7,3837
"42079212900",1249,114,0,0,47,0,33,0,1443
"42079213000",1216,82,0,23,52,8,34,0,1415
"42079213100",1072,300,52,14,50,39,8,20,1555
"42079213200",2995,1364,182,124,77,61,0,14,4817
"42079213300",1422,190,0,13,0,6,6,6,1643
"42079213400",3868,506,49,2,42,0,40,11,4518
"42079213600",1293,561,0,30,33,69,39,38,2063
"42079213700",1774,295,9,0,17,9,21,0,2125
"42079213800",1160,452,49,0,36,144,0,12,1853
"42079213900",1675,150,0,0,6,0,0,0,1831
"42079214000",809,126,0,0,9,30,79,0,1053
"42079214100",1784,519,80,22,83,53,57,17,2615
"42079214200",2012,664,55,0,60,0,35,0,2826
"42079214300",1554,417,13,0,27,0,15,0,2026
"42079214400",1424,510,23,7,14,0,10,35,2023
"42079214500",1325,206,0,9,23,0,0,0,1563
"42079214600",3387,444,32,9,19,18,69,71,4049
"42079214900",1110,127,0,0,47,13,11,0,1308
"42079215000",1393,151,2,0,7,0,2,2,1557
"42079215100",2233,451,23,10,42,0,11,0,2770
"42079215200",2071,431,20,92,243,84,49,34,3024
"42079215300",3608,322,7,0,42,6,26,2,4013
"42079215400",2205,258,0,0,66,0,52,10,2591
"42079215501",4075,235,33,0,136,0,38,26,4543
"42079215502",5247,90,14,8,96,31,87,0,5573
"42079215503",3219,28,31,0,127,0,0,6,3411
"42079215504",3814,194,0,1,15,0,0,0,4024
"42079215600",3173,1017,11,9,32,14,0,84,4340
"42079215701",2359,193,0,0,28,28,0,0,2608
"42079215702",1969,140,26,3,0,5,10,6,2159
"42079215800",2559,345,0,0,26,0,0,0,2930
"42079215900",3056,474,17,0,32,3,57,0,3639
"42079216000",674,71,0,1,3,0,43,0,792
"42079216100",3716,292,74,0,55,0,150,0,4287
"42079216200",4665,529,16,3,98,43,118,79,5551
"42079216400",1928,181,0,0,24,0,24,0,2157
"42079216501",1718,92,0,0,52,0,0,0,1862
"42079216502",3554,83,10,0,8,0,97,0,3752
"42079216600",7866,574,113,148,392,33,246,41,9413
"42079216700",3074,298,0,2,115,16,136,16,3657
"42079216800",2953,421,27,3,63,0,10,0,3477
"42079216900",3928,466,5,0,6,0,12,0,4417
"42079217001",1790,227,0,0,46,0,185,9,2257
"42079217002",1888,663,3,53,140,145,232,370,3494
"42079217100",2071,455,30,61,367,77,593,428,4082
"42079217200",1768,495,108,169,504,214,1409,493,5160
"42079217300",2707,273,44,12,107,85,361,116,3705
"42079217400",766,450,28,166,259,261,469,733,3132
"42079217500",1346,493,44,19,500,226,914,572,4114
"42079217600",1618,716,26,1,487,169,950,535,4502
"42079217700",2541,425,181,0,586,685,883,747,6048
"42079217800",2198,582,55,0,281,233,1016,476,4841
"42079217900",2370,841,139,354,715,111,1381,809,6720
"42079218000",3166,817,73,84,29,22,127,0,4318
"42079980100",26,0,0,0,0,0,0,0,26
"42081000100",2604,511,155,184,13,36,183,11,3697
"42081000200",1748,107,202,6,92,42,28,42,2267
"42081000300",3277,979,222,265,136,91,38,41,5049
"42081000400",1582,859,879,672,211,208,42,172,4625
"42081000500",1058,379,181,56,55,29,22,34,1814
"42081000600",1567,362,71,45,53,73,0,101,2272
"42081000800",273,646,44,144,0,70,0,71,1248
"42081000900",1832,478,196,369,119,23,25,51,3093
"42081001000",2287,493,356,193,9,53,96,0,3487
"42081010100",1995,300,0,0,12,6,4,0,2317
"42081010200",908,107,0,0,3,0,1,0,1019
"42081010300",3024,196,19,0,10,7,25,0,3281
"42081010400",4769,378,41,2,153,4,79,0,5426
"42081010500",5334,358,61,2,62,0,12,6,5835
"42081010600",3959,324,0,0,13,7,12,0,4315
"42081010700",4846,833,56,5,55,3,36,0,5834
"42081010800",6222,469,40,14,228,0,45,10,7028
"42081010900",2509,228,16,13,31,0,24,0,2821
"42081011000",3941,389,36,1,150,49,53,1,4620
"42081011100",4564,444,129,0,266,29,95,0,5527
"42081011200",4459,215,34,40,206,0,0,0,4954
"42081011301",1531,407,35,69,54,0,6,0,2102
"42081011302",4645,245,58,0,35,15,17,0,5015
"42081011400",1474,154,15,5,9,19,5,0,1681
"42081011601",1153,67,1,1,0,8,2,0,1232
"42081011602",5507,750,0,0,71,21,41,10,6400
"42081011700",5243,873,12,0,86,32,12,34,6292
"42081011800",2984,141,0,0,20,0,7,3,3155
"42081011900",5055,1106,17,14,49,8,38,14,6301
"42083420100",3161,212,0,1,71,1,73,1,3520
"42083420200",1779,1211,13,59,16,39,0,5,3122
"42083420300",1616,1149,0,14,46,0,50,9,2884
"42083420400",2107,397,0,12,0,0,0,0,2516
"42083420500",3115,102,5,7,16,0,7,0,3252
"42083420600",4659,702,17,0,67,16,41,21,5523
"42083420700",3561,749,4,0,26,7,25,4,4376
"42083420800",2975,426,0,7,20,12,4,0,3444
"42083420900",1839,357,0,0,21,3,0,0,2220
"42083421000",3210,367,0,0,19,46,16,86,3744
"42083421100",2609,619,0,0,137,30,0,42,3437
"42083421200",2260,121,0,1,42,0,50,0,2474
"42085030100",1310,412,88,16,20,71,0,13,1930
"42085030300",2403,594,125,103,228,66,9,0,3528
"42085030400",2231,179,45,0,146,0,0,0,2601
"42085030500",1544,408,341,36,70,88,12,88,2587
"42085030900",1456,176,1182,291,121,10,42,0,3278
"42085031100",905,198,142,254,33,66,3,7,1608
"42085031200",5044,123,21,0,67,0,66,0,5321
"42085031300",2460,28,8,0,58,30,0,11,2595
"42085031400",5039,364,142,2,86,0,120,0,5753
"42085031700",2301,133,0,28,53,0,36,10,2561
"42085031800",4361,461,0,1,46,7,18,0,4894
"42085031900",3958,424,152,0,97,4,89,4,4728
"42085032000",4722,402,0,0,82,0,14,0,5220
"42085032100",1472,840,0,16,4,7,0,0,2339
"42085032200",2398,205,67,0,33,19,59,19,2800
"42085032300",3013,236,0,0,49,3,2,0,3303
"42085032400",4858,997,0,0,74,50,76,28,6083
"42085032501",4950,1064,13,3,53,17,18,11,6129
"42085032502",2068,232,12,0,15,3,0,0,2330
"42085032601",4990,442,8,11,44,4,11,0,5510
"42085032602",2972,299,33,0,63,4,4,0,3375
"42085032701",4313,361,0,0,34,16,22,0,4746
"42085032702",2123,517,0,0,8,0,46,16,2710
"42085032800",4527,381,0,0,221,1,0,11,5141
"42085032900",2674,118,0,1,44,0,13,0,2850
"42085033000",2505,207,51,0,48,0,29,0,2840
"42085033100",4233,477,9,0,42,4,51,0,4816
"42085033200",1225,792,401,552,89,148,11,4,3222
"42085033300",2161,528,0,37,11,0,0,0,2737
"42085033400",677,249,543,714,65,125,11,27,2411
"42087960100",3274,537,7,0,37,0,9,0,3864
"42087960200",3211,816,0,0,33,0,0,0,4060
"42087960300",4102,1060,18,4,16,1,36,1,5238
"42087960400",2669,380,15,31,27,10,59,39,3230
"42087960500",3243,363,0,10,55,6,7,21,3705
"42087960600",5197,422,32,0,90,0,7,21,5769
"42087960700",1545,732,36,20,26,0,9,29,2397
"42087960800",2346,1209,0,45,206,39,77,68,3990
"42087960900",1513,406,41,0,72,0,0,19,2051
"42087961000",1786,189,0,1,7,0,41,0,2024
"42087961100",6539,389,49,8,86,0,68,0,7139
"42087961200",2722,350,0,0,39,4,32,0,3147
"42089300101",2224,221,624,184,217,85,183,86,3824
"42089300102",5051,256,1031,192,541,29,872,125,8097
"42089300201",3459,350,61,30,272,0,294,16,4482
"42089300202",4926,380,381,86,477,0,1158,69,7477
"42089300301",2450,272,552,93,53,23,133,96,3672
"42089300304",3847,615,1496,0,493,248,1167,285,8151
"42089300305",2838,843,1901,286,610,232,1278,351,8339
"42089300307",2631,499,2617,530,798,60,1089,239,8463
"42089300308",1919,276,492,83,296,32,706,68,3872
"42089300309",3070,323,432,0,410,0,717,272,5224
"42089300311",1831,174,66,43,79,12,32,0,2237
"42089300312",1494,242,23,0,78,198,253,16,2304
"42089300401",3254,670,350,27,402,32,223,246,5204
"42089300402",4335,591,830,159,254,21,530,59,6779
"42089300403",5154,637,767,0,316,79,776,0,7729
"42089300501",1667,523,411,120,160,13,274,73,3241
"42089300502",3779,191,471,0,428,218,615,55,5757
"42089300600",2733,650,530,47,251,0,358,229,4798
"42089300700",1958,572,375,126,578,19,539,55,4222
"42089300800",3365,989,454,296,215,210,319,394,6242
"42089300900",3896,609,624,81,650,211,627,193,6891
"42089301001",6834,1148,1937,1,1035,70,1342,496,12863
"42089301002",1671,224,23,10,28,0,26,0,1982
"42089301101",5512,384,149,0,37,0,320,36,6438
"42089301102",2078,40,41,0,145,0,58,0,2362
"42089301202",3476,546,268,0,100,0,416,71,4877
"42089301203",5103,315,164,0,145,110,12,110,5959
"42089301204",3524,217,123,41,281,39,955,50,5230
"42089301205",6487,447,881,0,395,0,1064,43,9317
"42089301301",6799,829,123,0,32,19,337,107,8246
"42089301302",2520,202,78,0,74,16,87,0,2977
"42089301401",2517,102,800,101,227,0,751,98,4596
"42089301402",3226,836,447,37,377,68,771,198,5960
"42091200103",3297,114,71,0,544,12,58,1,4097
"42091200104",3904,69,0,0,236,0,23,0,4232
"42091200105",2389,53,6,0,291,250,14,0,3003
"42091200106",1424,153,15,1,41,45,33,0,1712
"42091200200",1105,58,0,0,51,0,21,0,1235
"42091200301",3857,305,734,0,661,0,310,65,5932
"42091200305",2149,134,27,0,4,0,104,38,2456
"42091200306",3072,188,102,0,121,0,91,24,3598
"42091200307",2439,52,173,183,149,25,134,25,3180
"42091200308",3016,96,147,18,483,172,55,0,3987
"42091200309",2474,133,57,1,59,0,30,111,2865
"42091200310",2643,49,0,3,48,0,0,0,2743
"42091200401",2718,95,51,0,84,38,362,0,3348
"42091200402",3731,264,92,0,251,56,233,45,4672
"42091200501",3360,52,0,0,261,0,67,0,3740
"42091200502",4255,421,470,127,146,52,197,0,5668
"42091200505",5665,274,43,11,634,0,245,0,6872
"42091200506",3553,76,156,0,545,13,72,0,4415
"42091200507",5061,118,18,0,435,49,194,0,5875
"42091200602",5411,65,567,0,2097,29,65,0,8234
"42091200603",2750,73,61,24,319,0,52,10,3289
"42091200605",4162,164,335,33,902,43,169,0,5808
"42091200606",2603,23,82,1,457,25,41,0,3232
"42091200607",3562,49,218,0,792,0,122,0,4743
"42091200703",2845,103,237,0,804,80,150,16,4235
"42091200704",2782,114,260,11,306,0,207,0,3680
"42091200707",2557,233,138,0,1389,84,141,9,4551
"42091200708",4270,71,200,0,828,31,135,0,5535
"42091200800",2314,117,123,44,624,48,275,44,3589
"42091200901",2517,193,199,64,618,236,159,0,3986
"42091200902",890,60,124,7,152,14,87,24,1358
"42091200903",3049,161,230,218,809,47,226,0,4740
"42091200906",1109,88,167,0,181,46,40,0,1631
"42091200907",2330,70,101,16,149,0,21,0,2687
"42091200908",1307,79,174,6,522,32,202,12,2334
"42091201003",3568,300,295,0,1014,35,63,0,5275
"42091201004",3739,96,120,2,704,0,276,33,4970
"42091201005",3122,2,83,0,62,10,8,10,3297
"42091201006",2139,7,14,0,119,0,49,0,2328
"42091201100",2768,170,91,3,168,22,63,0,3285
"42091201201",4254,339,54,0,837,0,102,0,5586
"42091201203",2624,78,23,0,260,0,29,0,3014
"42091201204",1457,23,797,65,60,111,13,0,2526
"42091201301",2492,104,428,7,290,110,209,124,3764
"42091201302",2195,149,243,91,139,3,276,36,3132
"42091201404",3576,79,84,0,628,51,171,0,4589
"42091201406",3687,53,254,11,415,0,98,0,4518
"42091201407",1782,82,695,78,86,52,35,79,2889
"42091201408",3845,13,44,1,551,0,75,0,4529
"42091201409",3788,151,229,31,332,0,156,162,4849
"42091201410",1956,178,28,1,195,14,17,0,2389
"42091201411",2302,34,104,1,251,0,26,0,2718
"42091201501",2446,159,16,0,416,0,112,0,3149
"42091201502",1660,53,43,0,107,0,44,0,1907
"42091201603",2348,163,1531,163,111,13,284,33,4646
"42091201604",1872,152,958,97,156,0,27,0,3262
"42091201605",2050,3,386,29,382,29,99,1,2979
"42091201606",1250,68,589,189,97,14,70,0,2277
"42091201607",2674,190,327,0,128,0,77,0,3396
"42091201608",4108,154,237,7,376,8,397,11,5298
"42091201703",2623,23,249,37,167,0,70,0,3169
"42091201704",2562,108,436,24,82,0,58,0,3270
"42091201705",4015,177,281,8,225,60,50,0,4816
"42091201706",3324,416,393,9,272,44,76,218,4752
"42091201800",2184,207,122,13,198,16,145,0,2885
"42091201901",3819,387,28,0,430,32,86,43,4825
"42091201902",3946,218,701,107,694,149,150,0,5965
"42091202000",2299,105,5,0,117,21,87,7,2641
"42091202100",3809,300,153,1,123,40,139,8,4573
"42091202201",3349,140,663,174,487,69,135,0,5017
"42091202202",1106,114,916,25,963,28,263,28,3443
"42091202301",3433,150,838,30,447,50,68,0,5016
"42091202302",1296,63,588,15,88,0,138,0,2188
"42091202401",145,71,2343,222,304,156,87,11,3339
"42091202402",2376,71,1633,119,525,104,339,10,5177
"42091202500",1041,107,2665,579,469,81,176,7,5125
"42091202602",1918,152,63,30,81,26,144,0,2414
"42091202603",2040,218,316,0,169,33,159,0,2935
"42091202604",1737,92,323,24,131,39,117,0,2463
"42091203000",2743,114,117,0,127,11,175,0,3287
"42091203103",2435,147,48,0,247,20,26,20,2943
"42091203104",3834,39,38,0,140,0,75,0,4126
"42091203105",4396,173,330,0,307,56,164,24,5450
"42091203106",1384,247,53,21,120,38,88,0,1951
"42091203203",3262,68,145,1,565,24,298,8,4371
"42091203204",4927,66,313,1,1094,156,121,0,6678
"42091203205",2126,60,30,11,105,27,185,0,2544
"42091203207",2932,61,0,1,240,8,1,0,3243
"42091203208",2168,67,154,0,251,0,61,0,2701
"42091203302",5090,303,505,1,219,4,217,4,6343
"42091203303",2931,260,135,0,589,34,125,0,4074
"42091203304",2682,86,339,3,322,0,79,0,3511
"42091203401",5109,134,648,78,67,20,179,19,6254
"42091203402",5229,85,302,25,518,62,135,16,6372
"42091203403",2529,88,417,94,126,32,21,0,3307
"42091203500",3388,76,1559,631,516,73,575,21,6839
"42091203601",1141,288,1054,422,141,24,806,318,4194
"42091203602",1957,86,1544,154,345,6,484,43,4619
"42091203700",783,344,462,63,72,10,249,138,2121
"42091203801",1757,278,838,303,433,104,297,176,4186
"42091203803",2972,469,1329,263,453,92,1802,190,7570
"42091203804",1488,103,1155,119,40,73,670,46,3694
"42091203901",1391,638,798,306,174,100,1225,535,5167
"42091203902",1101,830,395,152,438,179,233,602,3930
"42091204002",2618,106,429,69,320,0,269,0,3811
"42091204007",1735,109,94,9,228,5,42,0,2222
"42091204008",2391,0,84,0,383,28,197,0,3083
"42091204009",1079,82,15,1,165,0,74,0,1416
"42091204010",2235,61,205,0,111,0,35,0,2647
"42091204101",3831,267,104,12,53,48,104,10,4429
"42091204102",2805,257,280,19,160,1,60,89,3671
"42091204200",1039,149,22,0,55,6,32,23,1326
"42091204300",2271,77,196,7,207,9,52,0,2819
"42091204400",2696,169,74,0,228,7,69,0,3243
"42091204500",3643,96,184,0,267,0,161,0,4351
"42091204600",3903,171,35,0,272,0,64,0,4445
"42091204701",1630,98,54,0,449,0,85,0,2316
"42091204702",2924,153,18,0,172,0,64,0,3331
"42091204800",4097,92,0,44,543,14,75,16,4881
"42091204900",4144,115,16,0,230,35,161,59,4760
"42091205000",1120,196,173,11,11,33,129,4,1677
"42091205100",973,116,8,12,43,18,0,17,1187
"42091205200",2524,139,11,9,132,19,102,11,2947
"42091205300",993,198,586,154,141,51,207,41,2371
"42091205400",5037,334,244,0,578,69,256,36,6554
"42091205501",2509,228,552,35,246,0,213,0,3783
"42091205502",2706,69,198,0,489,0,131,0,3593
"42091205503",3510,109,228,12,777,29,115,7,4787
"42091205600",3817,129,78,0,230,24,103,0,4381
"42091205700",3354,652,264,70,174,17,118,83,4732
"42091205801",1241,190,304,9,1060,74,81,10,2969
"42091205805",2106,327,115,0,603,40,330,0,3521
"42091205806",1515,136,41,8,235,150,188,155,2428
"42091205807",1083,95,419,133,347,27,11,0,2115
"42091205808",3649,136,149,29,1127,179,76,10,5355
"42091205809",2380,50,82,0,271,0,39,10,2832
"42091205903",2103,64,142,0,291,0,24,0,2624
"42091205904",1822,45,239,0,120,0,51,0,2277
"42091205905",2275,84,279,9,769,8,35,8,3467
"42091205906",1368,73,139,6,160,0,101,24,1871
"42091206004",3197,215,195,6,551,73,91,0,4328
"42091206005",3787,184,151,1,262,108,199,0,4692
"42091206006",2550,63,55,0,327,0,26,0,3021
"42091206007",4445,58,212,139,1350,2,46,1,6253
"42091206102",6414,231,484,2,967,0,116,24,8238
"42091206104",2683,178,20,0,252,5,336,0,3474
"42091206105",4592,46,47,0,486,0,66,0,5237
"42091206106",4211,76,115,41,185,0,178,0,4806
"42091206201",1831,243,84,26,362,0,113,0,2659
"42091206202",1936,101,68,0,22,5,74,0,2206
"42091206300",2939,167,97,0,189,20,43,0,3455
"42091206400",2945,213,88,65,218,0,140,0,3669
"42091206501",3098,89,422,0,553,21,80,13,4276
"42091206502",4097,321,295,0,241,0,62,0,5016
"42091206600",1273,77,14,3,25,0,21,0,1413
"42091206702",0,0,0,0,0,0,0,0,0
"42091206703",3310,175,36,0,189,0,83,0,3793
"42091206704",6168,159,165,0,395,0,54,16,6957
"42091206801",5387,27,327,2,1023,0,367,0,7133
"42091206802",2857,49,0,2,168,0,11,1,3088
"42091206901",3624,184,136,26,318,178,245,20,4731
"42091206904",4288,219,387,14,366,20,178,40,5512
"42091206905",3995,50,178,36,743,69,74,0,5145
"42091206906",2337,76,169,0,228,30,95,19,2954
"42091207001",6992,87,115,69,414,144,183,48,8052
"42091207003",2661,40,159,6,109,0,0,0,2975
"42091207004",3760,30,212,3,224,8,54,0,4291
"42091207101",5754,199,106,1,0,70,92,0,6222
"42091207103",3654,48,63,0,145,79,62,0,4051
"42091207104",2566,78,0,13,130,0,0,0,2787
"42091207201",2257,95,74,9,134,16,9,0,2594
"42091207202",3289,327,32,0,326,14,266,88,4342
"42091207300",1847,116,94,171,387,34,185,5,2839
"42091207400",2432,101,0,0,29,16,0,1,2579
"42091207500",3196,42,5,0,12,22,4,0,3281
"42091207600",3376,169,0,3,21,16,72,46,3703
"42091207800",6241,248,14,23,52,0,0,0,6578
"42091207900",2210,152,55,0,87,0,101,0,2605
"42091208000",3122,321,90,5,91,0,78,8,3715
"42091208100",2686,168,42,0,65,8,63,3,3035
"42091208201",2264,81,0,0,8,0,26,0,2379
"42091208203",3901,150,66,1,53,0,86,0,4257
"42091208204",3351,106,145,30,66,0,114,0,3812
"42091208301",2527,26,0,1,48,0,0,0,2602
"42091208302",7874,199,76,1,610,0,308,0,9068
"42091208400",3190,34,105,0,88,22,76,0,3515
"42091208500",4482,189,104,1,88,0,149,0,5013
"42091208601",5325,403,126,1,353,36,291,35,6570
"42091208603",6036,242,328,0,125,0,166,0,6897
"42091208604",4243,241,161,0,623,0,74,62,5404
"42091208702",3252,136,45,0,39,0,26,0,3498
"42091208703",3436,227,74,0,71,0,33,85,3926
"42091208704",3321,169,333,435,376,47,331,22,5034
"42091208801",664,222,122,233,0,11,0,0,1252
"42091208802",2628,446,29,263,66,7,27,21,3487
"42091208901",2936,333,170,20,110,14,46,39,3668
"42091208903",1807,271,539,237,50,47,240,0,3191
"42091208904",1339,311,445,571,201,160,151,109,3287
"42091208905",2120,188,122,0,114,0,113,14,2671
"42091208906",2377,256,722,122,164,71,247,29,3988
"42091209000",807,210,239,351,0,82,10,56,1755
"42091209100",4947,82,93,14,161,0,123,0,5420
"42091209201",1437,193,45,0,33,0,0,0,1708
"42091209202",1444,203,343,98,17,56,46,0,2207
"42091210100",3106,139,233,0,392,40,210,0,4120
"42091210200",2328,26,315,31,81,0,82,0,2863
"42091210300",3124,144,45,14,128,1,183,1,3640
"42091210400",3013,419,748,8,246,0,113,0,4547
"42091210500",2944,105,446,0,352,91,111,67,4116
"42091210600",3056,74,290,1,393,0,121,7,3942
"42091210700",4677,91,32,0,804,0,69,0,5673
"42093050100",3411,429,24,1,24,3,0,0,3892
"42093050200",3086,287,65,2,274,9,0,70,3793
"42093050300",3642,806,15,5,157,0,194,0,4819
"42093050400",5073,227,76,0,141,0,32,7,5556
"42095010100",3056,67,214,28,358,55,680,37,4495
"42095010200",2979,172,193,0,237,25,63,0,3669
"42095010300",2589,245,16,130,142,31,188,63,3404
"42095010400",4248,187,194,1,160,32,377,71,5270
"42095010500",1085,1081,145,358,787,685,1033,1759,6933
"42095010600",5787,520,333,67,601,43,1175,199,8725
"42095010700",3029,599,136,158,666,145,1032,202,5967
"42095010800",1556,411,129,64,126,51,169,169,2675
"42095010900",1785,389,461,106,354,278,1037,440,4850
"42095011000",990,1214,77,57,500,280,706,529,4353
"42095011100",158,73,0,0,0,0,35,13,279
"42095011200",1951,1249,350,360,754,657,1577,1665,8563
"42095011300",2147,570,193,103,823,641,800,949,6226
"42095014100",2623,213,53,24,278,0,177,40,3408
"42095014200",2689,735,463,298,655,387,560,573,6360
"42095014300",1451,805,346,506,675,335,744,741,5603
"42095014400",1149,229,94,222,158,139,311,274,2576
"42095014500",1444,218,552,186,355,102,409,116,3382
"42095014600",1529,204,583,213,384,283,466,229,3891
"42095014700",1888,61,324,70,221,208,503,190,3465
"42095015201",6105,705,4,1,23,24,48,0,6910
"42095015300",4780,171,16,0,23,10,55,0,5055
"42095015400",2880,188,0,0,29,0,176,18,3291
"42095015500",5661,285,52,41,98,0,58,0,6195
"42095015600",3056,434,9,0,59,0,73,0,3631
"42095015700",2415,242,0,0,45,0,101,30,2833
"42095015801",4896,122,0,0,148,0,10,0,5176
"42095015802",2580,254,20,2,151,0,56,1,3064
"42095015901",5197,342,193,0,66,14,91,0,5903
"42095015902",3290,194,0,0,106,11,138,11,3750
"42095016001",5437,283,0,7,237,0,97,7,6068
"42095016002",4005,320,118,1,39,1,35,1,4520
"42095016100",1810,106,17,1,85,0,104,0,2123
"42095016201",4774,451,19,51,332,0,233,0,5860
"42095016202",3683,269,16,19,214,15,217,26,4459
"42095016300",2556,136,25,8,125,0,53,0,2903
"42095016400",4034,56,108,0,119,0,232,0,4549
"42095016500",4522,96,55,1,205,0,93,0,4972
"42095016600",2219,280,55,60,30,0,142,83,2869
"42095016700",5243,174,191,0,26,0,312,45,5991
"42095016800",4849,314,214,16,144,96,65,16,5714
"42095016901",2878,200,25,0,0,0,58,21,3182
"42095016902",2426,21,0,0,156,9,55,1,2668
"42095017000",1769,51,9,41,82,3,61,0,2016
"42095017101",5498,174,428,21,220,0,841,0,7182
"42095017102",7110,202,552,0,595,24,699,29,9211
"42095017200",4968,411,314,3,668,16,958,149,7487
"42095017300",2107,292,72,33,55,74,126,76,2835
"42095017401",5505,301,877,24,1251,0,538,0,8496
"42095017402",3386,56,91,72,134,15,297,11,4062
"42095017501",3110,111,109,0,450,15,224,0,4019
"42095017502",4191,263,194,0,288,16,105,0,5057
"42095017603",3162,185,75,32,184,24,368,29,4059
"42095017604",3809,99,215,32,112,69,361,127,4824
"42095017605",3041,76,46,0,560,0,399,0,4122
"42095017606",4330,66,242,0,311,23,400,12,5384
"42095017607",5361,188,363,36,653,0,377,0,6978
"42095017702",2023,44,120,2,152,0,162,3,2506
"42095017703",2187,128,94,1,190,35,346,31,3012
"42095017704",4901,208,216,1,556,82,213,2,6179
"42095017800",1879,155,290,9,276,14,560,58,3241
"42095017901",3407,243,22,0,61,0,324,0,4057
"42095017902",1867,219,0,0,7,9,10,0,2112
"42095018001",3894,197,0,0,26,0,133,0,4250
"42095018002",6277,160,15,3,165,0,366,1,6987
"42095018100",5528,194,219,14,283,7,42,0,6287
"42095018200",3300,113,0,0,75,15,81,0,3584
"42095018300",4447,348,86,18,113,8,199,19,5238
"42097080100",4003,451,3,7,20,3,60,0,4547
"42097080200",6133,693,135,19,38,27,44,23,7112
"42097080300",5072,1466,63,69,197,25,234,240,7366
"42097080400",3118,345,3,1,38,0,48,0,3553
"42097080500",2960,558,0,0,41,0,0,27,3586
"42097080600",3191,489,0,0,58,13,52,63,3866
"42097080700",2855,245,11,0,63,0,16,10,3200
"42097080800",6644,445,0,0,20,0,37,0,7146
"42097080900",3145,445,0,3,3,19,0,0,3615
"42097081000",2650,740,35,0,66,0,0,0,3491
"42097081100",2025,344,0,0,2,0,49,12,2432
"42097081200",2777,332,3,4,11,0,0,4,3131
"42097081300",1503,462,8,0,79,55,5,8,2120
"42097081400",1712,229,4,3,5,0,9,0,1962
"42097081500",1917,352,0,2,0,11,0,8,2290
"42097081600",2145,656,14,0,123,0,62,0,3000
"42097081700",1581,460,0,0,16,0,0,17,2074
"42097081800",2943,287,6,10,45,3,14,2,3310
"42097081900",5448,177,16,0,40,0,85,0,5766
"42097082000",2849,669,0,25,24,14,77,67,3725
"42097082100",1618,764,22,10,31,112,61,112,2730
"42097082200",2496,591,33,35,90,55,146,12,3458
"42097082300",4420,600,0,5,49,14,17,6,5111
"42097082400",2471,413,2,4,23,0,33,297,3243
"42099030100",4178,295,8,3,88,5,60,3,4640
"42099030201",2198,242,6,0,22,0,22,24,2514
"42099030202",3863,919,68,7,81,40,144,19,5141
"42099030301",4392,306,21,0,25,38,13,0,4795
"42099030302",4285,407,7,2,88,3,46,3,4841
"42099030400",4386,226,38,0,219,11,114,0,4994
"42099030501",4788,339,0,0,96,12,26,0,5261
"42099030502",5280,399,22,7,25,7,37,0,5777
"42099030601",3908,584,31,0,42,13,28,13,4619
"42099030602",2524,476,8,11,32,10,22,7,3090
"42101000100",2511,263,262,69,282,12,107,20,3526
"42101000200",542,70,26,34,1155,261,27,0,2115
"42101000300",2139,247,135,43,415,100,257,59,3395
"42101000401",1276,123,170,123,480,286,65,15,2538
"42101000402",2355,255,26,13,170,73,40,0,2932
"42101000500",417,154,102,167,338,90,12,44,1324
"42101000600",494,165,30,12,204,30,62,0,997
"42101000700",1435,368,207,126,228,323,74,28,2789
"42101000801",1125,196,122,0,268,18,28,19,1776
"42101000803",2581,544,0,16,404,11,45,0,3601
"42101000804",2763,241,64,16,410,66,400,0,3960
"42101000901",1177,238,94,53,309,105,65,0,2041
"42101000902",1159,304,86,66,231,159,29,14,2048
"42101001001",2043,253,51,18,229,0,63,0,2657
"42101001002",2976,149,9,21,262,19,226,9,3671
"42101001101",2192,529,76,96,177,29,110,15,3224
"42101001102",1996,358,22,9,112,31,65,0,2593
"42101001201",3234,148,18,47,296,99,194,2,4038
"42101001202",3459,421,238,20,400,92,207,57,4894
"42101001300",2757,374,1140,341,587,33,106,1,5339
"42101001400",2399,270,566,165,642,124,141,45,4352
"42101001500",1918,163,205,108,357,19,255,0,3025
"42101001600",1587,163,71,0,54,43,68,0,1986
"42101001700",2245,139,270,20,323,0,236,0,3233
"42101001800",2022,79,300,167,311,0,236,1,3116
"42101001900",1412,171,879,303,143,11,84,28,3031
"42101002000",228,13,1544,407,38,22,24,2,2278
"42101002100",337,73,1058,340,89,0,38,0,1935
"42101002200",459,44,757,591,174,142,48,42,2257
"42101002300",1851,182,37,0,322,170,373,35,2970
"42101002400",3277,311,165,64,645,66,830,66,5424
"42101002500",1897,189,674,460,318,38,338,46,3960
"42101002701",1649,74,614,306,1000,229,424,17,4313
"42101002702",2928,176,169,11,266,12,186,9,3757
"42101002801",1689,316,171,118,1625,437,971,193,5520
"42101002802",2714,803,0,17,1110,198,238,52,5132
"42101002900",3243,356,73,10,522,183,227,137,4751
"42101003001",862,262,663,88,2094,469,367,60,4865
"42101003002",435,173,1424,628,268,256,90,1,3275
"42101003100",217,66,2292,894,124,209,0,65,3867
"42101003200",130,262,2973,945,0,54,0,0,4364
"42101003300",966,378,2031,1869,348,331,106,84,6113
"42101003600",910,401,1965,2584,666,892,99,652,8169
"42101003701",332,189,3108,1618,710,381,557,199,7094
"42101003702",972,352,1297,245,486,247,153,113,3865
"42101003800",3484,217,0,1,32,0,56,0,3790
"42101003901",3938,1043,525,17,1350,115,274,84,7346
"42101003902",5185,415,19,0,260,41,51,26,5997
"42101004001",2876,485,117,27,335,214,230,8,4292
"42101004002",3897,291,0,0,372,0,326,0,4886
"42101004101",1490,961,1152,220,1259,1257,636,640,7615
"42101004102",2504,1140,830,648,2664,965,634,76,9461
"42101004201",3914,495,402,81,136,717,112,0,5857
"42101004202",3302,783,203,52,428,247,225,198,5438
"42101005000",0,0,0,0,0,0,0,0,0
"42101005400",163,53,685,74,150,16,32,17,1190
"42101005500",761,19,4621,677,215,535,47,0,6875
"42101005600",115,1,831,166,26,49,8,0,1196
"42101006000",1060,59,3184,977,309,123,181,13,5906
"42101006100",276,36,2026,624,406,235,53,0,3656
"42101006200",450,108,2718,1217,195,21,132,0,4841
"42101006300",174,232,1599,1332,362,212,32,135,4078
"42101006400",185,160,2409,508,227,208,25,11,3733
"42101006500",79,0,2496,1500,207,57,170,0,4509
"42101006600",84,18,2117,797,143,362,0,0,3521
"42101006700",555,559,3329,1630,304,813,240,219,7649
"42101006900",18,107,1202,1286,0,6,0,30,2649
"42101007000",43,72,2915,1368,12,182,20,12,4624
"42101007101",7,85,2154,771,34,8,18,58,3135
"42101007102",6,0,2860,1808,0,32,6,0,4712
"42101007200",86,19,2526,1867,52,16,31,0,4597
"42101007300",94,9,2286,755,53,0,13,0,3210
"42101007400",237,132,2584,1235,39,56,44,21,4348
"42101007700",353,314,492,84,124,370,12,22,1771
"42101007800",2119,392,612,233,361,126,150,21,4014
"42101007900",2030,316,1030,477,409,98,96,17,4473
"42101008000",450,145,2039,1020,98,64,82,80,3978
"42101008101",0,7,1161,922,15,36,0,7,2148
"42101008102",1,2,4255,1367,96,39,69,0,5829
"42101008200",21,5,5946,1452,109,15,16,0,7564
"42101008301",0,103,2731,1041,59,69,30,2,4035
"42101008302",15,1,2692,1273,82,42,86,49,4240
"42101008400",95,73,2735,2009,129,77,0,75,5193
"42101008500",201,40,4453,2036,25,0,72,122,6949
"42101008601",1258,160,805,551,295,32,19,18,3138
"42101008602",339,227,1594,789,139,120,55,120,3383
"42101008701",1650,1241,538,63,798,954,268,482,5994
"42101008702",693,978,307,462,536,363,81,107,3527
"42101008801",133,137,0,0,58,98,0,22,448
"42101008802",187,2479,252,312,235,954,42,208,4669
"42101009000",662,1113,108,96,171,513,55,73,2791
"42101009100",626,239,341,665,205,343,120,0,2539
"42101009200",163,95,1382,1006,332,185,9,43,3215
"42101009300",85,7,2238,1477,29,10,93,0,3939
"42101009400",8,54,2250,1725,73,29,27,35,4201
"42101009500",17,13,1910,1415,97,11,57,11,3531
"42101009600",50,0,2964,1333,85,40,51,27,4550
"42101009801",522,0,1559,379,37,84,0,18,2599
"42101009802",489,40,4632,854,117,0,31,11,6174
"42101010000",465,73,3222,1028,61,21,31,10,4911
"42101010100",45,0,3396,1337,193,34,126,57,5188
"42101010200",13,0,1248,1587,23,16,36,52,2975
"42101010300",7,0,1615,742,0,106,7,106,2583
"42101010400",12,40,2171,802,24,9,11,3,3072
"42101010500",107,26,1711,1224,49,41,152,57,3367
"42101010600",7,28,696,653,57,27,41,28,1537
"42101010700",95,53,1991,1424,131,50,163,38,3945
"42101010800",117,74,1261,2086,23,10,21,0,3592
"42101010900",75,47,890,922,19,25,18,0,1996
"42101011000",186,26,1829,1341,95,0,143,0,3620
"42101011100",33,30,1537,1544,8,43,0,93,3288
"42101011200",29,15,3051,1601,20,0,57,1,4774
"42101011300",0,0,2340,763,0,8,0,1,3112
"42101011400",29,61,4940,2398,202,36,260,39,7965
"42101011500",367,174,3249,518,76,89,73,34,4580
"42101011700",231,247,462,17,86,0,16,5,1064
"42101011800",62,0,4514,671,437,150,199,0,6033
"42101011900",24,20,3703,1138,213,96,76,118,5388
"42101012000",269,79,994,138,139,4,13,0,1636
"42101012100",228,314,1400,318,274,51,209,42,2836
"42101012201",437,648,890,298,198,543,58,83,3155
"42101012203",228,353,203,196,215,77,21,0,1293
"42101012204",802,161,967,493,121,137,22,25,2728
"42101012500",2966,607,225,30,701,177,181,32,4919
"42101013100",245,47,855,290,139,20,149,11,1756
"42101013200",121,147,1466,872,80,33,74,35,2828
"42101013300",1146,402,890,555,95,81,212,21,3402
"42101013401",2185,94,38,20,114,0,30,0,2481
"42101013402",1810,265,186,118,315,29,118,167,3008
"42101013500",1565,203,849,409,101,91,123,114,3455
"42101013601",2037,32,286,0,273,66,21,13,2728
"42101013602",2951,209,305,306,187,27,100,0,4085
"42101013700",909,253,1776,1321,42,61,118,0,4480
"42101013800",320,11,1112,493,47,21,105,18,2127
"42101013900",146,42,845,1587,118,68,100,37,2943
"42101014000",226,483,1340,781,62,41,59,78,3070
"42101014100",81,253,898,524,277,51,7,127,2218
"42101014200",2541,229,235,114,323,125,489,82,4138
"42101014300",1219,157,37,2,185,22,131,42,1795
"42101014400",1349,341,438,158,334,432,525,474,4051
"42101014500",86,90,692,399,338,44,385,75,2109
"42101014600",137,20,1422,463,20,132,43,0,2237
"42101014700",69,1248,749,689,33,122,10,120,3040
"42101014800",0,91,478,191,36,9,33,0,838
"42101014900",50,74,1747,681,188,282,78,282,3382
"42101015101",45,3,1156,774,0,63,0,23,2064
"42101015102",1,27,1813,2068,85,39,54,45,4132
"42101015200",20,364,2009,3450,152,120,158,182,6455
"42101015300",272,1728,914,701,65,158,18,67,3923
"42101015600",246,415,191,131,585,357,734,627,3286
"42101015700",822,437,58,22,1133,256,1195,366,4289
"42101015800",3942,1324,115,10,143,0,70,57,5661
"42101016000",5612,771,36,19,349,166,281,60,7294
"42101016100",1917,927,352,129,803,832,643,843,6446
"42101016200",400,388,201,362,338,360,771,843,3663
"42101016300",407,745,306,336,660,1522,613,2253,6842
"42101016400",220,444,807,1411,714,809,978,1346,6729
"42101016500",50,8,726,943,245,198,260,207,2637
"42101016600",90,182,731,421,26,15,43,12,1520
"42101016701",0,23,1627,962,9,11,0,0,2632
"42101016702",0,251,1739,1127,27,21,0,21,3186
"42101016800",116,1,2538,1656,137,0,39,15,4502
"42101016901",16,59,2135,1302,57,26,0,0,3595
"42101016902",0,100,3564,1498,129,209,28,132,5660
"42101017000",508,97,1656,551,205,29,148,33,3227
"42101017100",42,120,2335,1240,33,92,0,131,3993
"42101017201",0,23,1613,1628,38,92,20,19,3433
"42101017202",8,151,1935,1256,0,13,0,132,3495
"42101017300",14,10,1687,1388,10,28,39,49,3225
"42101017400",0,5,1010,811,0,122,0,127,2075
"42101017500",537,642,1181,1526,1247,2240,1992,3504,12869
"42101017601",752,766,331,638,1011,2090,1880,3246,10714
"42101017602",566,593,394,266,723,1224,1270,1934,6970
"42101017701",417,521,315,723,805,1050,1027,1187,6045
"42101017702",670,1245,435,848,706,2212,1058,3479,10653
"42101017800",1128,1171,855,938,1182,1778,1466,2378,10896
"42101017900",2337,708,1245,1035,243,784,858,944,8154
"42101018001",1924,524,0,3,158,1,158,1,2769
"42101018002",4035,1000,0,0,0,306,0,448,5789
"42101018300",3511,553,9,3,0,10,9,0,4095
"42101018400",2001,228,0,1,91,58,91,32,2502
"42101018800",2036,1547,1107,1952,853,1332,1773,2471,13071
"42101019000",1471,1296,951,919,1967,1376,2327,2186,12493
"42101019100",2301,1095,568,344,2848,1173,3287,1383,12999
"42101019200",1142,1826,1204,1138,1538,1244,2187,3129,13408
"42101019501",568,486,162,521,1006,1611,1527,2078,7959
"42101019502",683,1169,410,206,498,621,1105,1481,6173
"42101019700",791,539,1170,1477,1300,1293,2053,2114,10737
"42101019800",553,629,1759,642,1425,1607,2160,2264,11039
"42101019900",400,435,1024,704,760,1143,1183,1594,7243
"42101020000",64,33,697,348,118,71,138,50,1519
"42101020101",24,24,2491,1608,0,0,24,0,4171
"42101020102",16,130,2308,955,0,35,26,34,3504
"42101020200",102,106,3708,1240,0,0,0,7,5163
"42101020300",11,51,1853,826,12,28,2,22,2805
"42101020400",20,7,1961,602,0,143,0,105,2838
"42101020500",163,36,1541,744,49,23,126,26,2708
"42101020600",631,125,666,121,142,113,92,0,1890
"42101020700",3993,362,502,53,297,0,102,89,5398
"42101020800",728,242,608,106,116,182,8,41,2031
"42101020900",2377,452,62,44,116,14,76,0,3141
"42101021000",3702,912,274,87,107,34,219,1,5336
"42101021100",1888,141,69,18,149,0,43,0,2308
"42101021200",1638,369,125,4,181,40,154,0,2511
"42101021300",2704,267,162,20,95,13,89,0,3350
"42101021400",2641,468,429,62,10,8,58,27,3703
"42101021500",2871,304,57,5,224,156,92,0,3709
"42101021600",1428,328,122,27,152,0,56,0,2113
"42101021700",4790,374,381,18,335,0,66,0,5964
"42101021800",2530,699,410,63,93,191,130,103,4219
"42101021900",1253,57,90,55,64,0,0,0,1519
"42101022000",1218,43,132,2,240,15,117,16,1783
"42101023100",1111,5,14,0,49,0,57,0,1236
"42101023500",651,11,405,43,172,40,0,0,1322
"42101023600",1549,20,687,316,133,19,89,19,2832
"42101023700",1306,167,2063,680,519,22,108,22,4887
"42101023800",1016,30,2373,409,186,152,265,59,4490
"42101023900",298,96,847,184,55,4,64,15,1563
"42101024000",991,338,1537,620,237,109,173,36,4041
"42101024100",141,102,447,354,0,10,0,31,1085
"42101024200",384,166,2219,1210,127,24,59,0,4189
"42101024300",425,79,2292,1261,58,37,46,5,4203
"42101024400",103,83,2450,498,9,0,0,0,3143
"42101024500",106,66,2272,901,41,0,41,20,3447
"42101024600",142,84,1540,1240,39,21,23,29,3118
"42101024700",212,99,2048,1861,16,28,19,67,4350
"42101024800",6,12,1668,449,38,0,11,10,2194
"42101024900",0,24,2040,1088,8,50,0,53,3263
"42101025200",308,84,5210,2120,20,43,47,23,7855
"42101025300",217,52,2567,900,216,0,41,0,3993
"42101025400",266,5,3515,504,237,51,68,54,4700
"42101025500",762,91,1846,109,276,0,99,0,3183
"42101025600",1315,142,1129,138,156,14,11,0,2905
"42101025700",2171,127,800,127,180,2,228,0,3635
"42101025800",30,0,1458,94,4,0,18,0,1604
"42101025900",46,12,3741,1067,49,16,0,0,4931
"42101026000",58,59,2155,460,15,25,8,25,2805
"42101026100",44,29,2688,339,0,11,15,26,3152
"42101026200",70,0,3943,552,106,0,79,0,4750
"42101026301",42,0,3474,548,40,20,0,0,4124
"42101026302",231,98,4095,830,70,15,127,139,5605
"42101026400",132,3,4438,908,113,2,135,1,5732
"42101026500",82,3,3784,1000,72,16,59,3,5019
"42101026600",41,1,5744,781,111,10,47,1,6736
"42101026700",176,0,5881,1197,11,0,89,0,7354
"42101026800",130,46,3528,716,228,92,29,8,4777
"42101026900",320,19,925,246,298,0,173,0,1981
"42101027000",276,55,1351,219,124,42,18,0,2085
"42101027100",120,129,1231,599,685,141,175,88,3168
"42101027200",257,101,3552,489,293,81,116,42,4931
"42101027300",820,282,3384,452,2080,545,1115,229,8907
"42101027401",320,52,899,362,756,530,236,26,3181
"42101027402",490,84,3007,805,2124,614,1554,174,8852
"42101027500",425,125,2344,496,711,517,342,247,5207
"42101027600",78,16,2639,954,125,49,0,0,3861
"42101027700",195,8,3414,810,152,120,22,28,4749
"42101027800",148,96,3288,1028,0,0,71,65,4696
"42101027901",33,4,2676,1351,72,731,148,15,5030
"42101027902",71,410,1354,548,103,156,65,183,2890
"42101028000",22,34,2384,1675,11,0,65,22,4213
"42101028100",102,97,2307,785,9,38,80,21,3439
"42101028200",350,42,2983,1141,241,209,303,196,5465
"42101028300",172,58,2890,2081,217,448,67,191,6124
"42101028400",353,299,1890,1437,386,470,694,942,6471
"42101028500",240,54,880,458,464,602,503,231,3432
"42101028600",641,70,2786,2180,1168,1255,1690,1099,10889
"42101028700",262,211,269,185,735,808,1025,954,4449
"42101028800",768,577,692,94,1758,825,1744,952,7410
"42101028901",385,241,421,894,1428,855,1441,1041,6706
"42101028902",773,780,934,1045,2436,1221,2428,1763,11380
"42101029000",785,263,1951,758,1975,987,1460,796,8975
"42101029100",735,33,1256,539,862,630,393,336,4784
"42101029200",867,320,1252,212,696,224,846,358,4775
"42101029300",795,231,490,556,519,407,738,411,4147
"42101029400",520,559,915,608,194,316,338,585,4035
"42101029800",1723,742,804,648,728,226,927,350,6148
"42101029900",665,686,1395,851,242,219,341,731,5130
"42101030000",1129,706,2857,1747,948,250,836,552,9025
"42101030100",1480,433,2128,525,494,49,751,89,5949
"42101030200",1498,699,2584,567,1410,390,1470,810,9428
"42101030501",484,684,2203,944,970,235,865,525,6910
"42101030502",1018,314,2816,682,775,736,492,514,7347
"42101030600",2767,455,1610,407,1426,683,1197,368,8913
"42101030700",1694,357,1145,130,401,15,331,0,4073
"42101030800",3048,153,582,48,961,345,713,108,5958
"42101030900",917,601,1140,395,1192,471,861,418,5995
"42101031000",2588,701,1332,426,2172,477,1381,90,9167
"42101031101",1058,535,1639,692,1105,386,690,355,6460
"42101031102",1155,135,1469,436,486,278,660,320,4939
"42101031200",887,564,1794,321,898,216,1137,326,6143
"42101031300",2055,727,1076,511,902,551,607,362,6791
"42101031401",1848,633,1789,100,2023,724,1196,268,8581
"42101031402",2505,448,740,341,1085,711,263,203,6296
"42101031501",4504,498,114,48,646,377,410,134,6731
"42101031502",2512,346,241,8,273,71,357,45,3853
"42101031600",3897,515,591,438,304,298,536,252,6831
"42101031700",3227,186,1190,294,861,201,992,158,7109
"42101031800",1228,218,1164,302,865,109,779,81,4746
"42101031900",2420,466,717,49,551,287,961,401,5852
"42101032000",4090,501,935,220,1054,188,806,108,7902
"42101032100",1568,473,1060,70,301,301,350,431,4554
"42101032300",1928,418,637,106,250,41,387,65,3832
"42101032500",3146,635,534,360,490,591,568,534,6858
"42101032600",3974,867,623,368,783,161,1078,42,7896
"42101032900",1547,544,578,104,527,296,367,79,4042
"42101033000",4353,1680,871,531,580,107,848,473,9443
"42101033101",3981,226,137,15,190,96,255,16,4916
"42101033102",2976,285,158,43,56,93,44,5,3660
"42101033200",2282,215,0,5,65,103,71,5,2746
"42101033300",2496,270,350,121,319,35,197,38,3826
"42101033400",2992,225,509,110,887,334,471,6,5534
"42101033500",2155,341,403,31,419,434,550,178,4511
"42101033600",4387,704,361,106,1350,125,509,70,7612
"42101033701",3195,719,130,25,541,90,140,0,4840
"42101033702",3726,116,278,0,1043,162,443,0,5768
"42101033800",3958,452,696,38,888,144,439,16,6631
"42101033900",1924,229,317,95,285,53,135,36,3074
"42101034000",2134,172,212,19,417,56,266,44,3320
"42101034100",5410,765,257,61,152,86,434,123,7288
"42101034200",2592,178,331,34,198,84,103,0,3520
"42101034400",6139,381,240,28,1091,68,232,0,8179
"42101034501",1711,966,305,73,628,0,197,376,4256
"42101034502",2720,349,604,46,1306,287,266,0,5578
"42101034600",1340,104,569,64,539,0,277,0,2893
"42101034701",3931,512,329,86,1440,116,357,163,6934
"42101034702",3185,30,270,6,453,0,172,0,4116
"42101034801",3231,295,275,201,172,83,99,0,4356
"42101034802",3508,363,1012,296,166,42,390,0,5777
"42101034803",3648,319,260,11,305,0,290,7,4840
"42101034900",3410,758,637,174,245,398,437,298,6357
"42101035100",3016,135,113,0,142,0,93,0,3499
"42101035200",3525,198,71,7,309,26,323,26,4485
"42101035301",4625,372,66,72,80,162,110,240,5727
"42101035302",3480,390,281,68,208,19,300,0,4746
"42101035500",5384,998,98,30,1025,0,320,180,8035
"42101035601",4080,392,54,1,462,65,274,65,5393
"42101035602",2006,228,108,39,942,52,155,10,3540
"42101035701",2683,608,226,83,774,211,221,116,4922
"42101035702",2868,573,0,40,282,0,155,0,3918
"42101035800",4614,634,162,0,695,37,131,0,6273
"42101035900",3552,473,260,0,697,0,130,0,5112
"42101036000",1558,186,181,60,712,0,51,0,2748
"42101036100",2821,321,662,145,157,58,52,25,4241
"42101036201",3925,269,571,48,167,0,83,0,5063
"42101036202",4901,183,509,90,412,161,584,0,6840
"42101036203",3995,460,47,31,168,89,245,104,5139
"42101036301",2829,280,103,0,628,0,337,11,4188
"42101036302",2141,640,363,91,130,7,296,275,3943
"42101036303",5521,186,0,0,298,0,103,0,6108
"42101036400",137,105,26,78,31,24,4,26,431
"42101036501",3590,686,538,195,300,74,180,138,5701
"42101036502",3467,215,0,3,234,0,87,0,4006
"42101036600",1189,57,73,0,224,8,43,24,1618
"42101036700",1777,87,472,0,91,20,137,24,2608
"42101036900",542,186,62,5,108,295,69,12,1279
"42101037200",3238,208,208,13,390,297,186,12,4552
"42101037300",3927,182,347,35,564,36,186,30,5307
"42101037500",1352,425,1271,276,199,105,125,105,3858
"42101037600",945,272,329,262,518,170,222,86,2804
"42101037700",178,433,1316,997,91,755,196,792,4758
"42101037800",1390,354,60,39,203,14,218,10,2288
"42101037900",4066,663,11,183,37,52,99,153,5264
"42101038000",1473,429,42,43,344,18,337,21,2707
"42101038100",253,205,132,73,9,10,54,49,785
"42101038200",1094,341,182,131,386,176,548,153,3011
"42101038300",385,411,481,479,938,850,1333,1208,6085
"42101038400",2008,102,150,75,155,0,116,4,2610
"42101038500",1528,114,60,0,109,14,36,0,1861
"42101038600",1079,57,180,0,54,0,37,0,1407
"42101038700",1394,104,61,0,156,0,55,0,1770
"42101038800",1765,107,1098,170,275,131,71,133,3750
"42101038900",140,117,2168,744,6,33,40,55,3303
"42101039000",1285,411,2965,1298,902,488,1024,685,9058
"42101980000",97,37,8,92,32,112,11,0,389
"42101980100",59,0,0,0,0,0,4,0,63
"42101980200",113,18,0,0,11,0,0,0,142
"42101980300",0,0,0,0,0,0,0,0,0
"42101980400",0,0,0,0,0,0,0,0,0
"42101980500",0,0,0,0,0,0,0,0,0
"42101980600",0,0,0,0,0,0,0,0,0
"42101980700",0,0,0,0,0,0,0,0,0
"42101980800",0,0,0,0,0,0,0,0,0
"42101980900",4,0,0,0,0,0,0,0,4
"42101989100",40,23,20,51,9,11,9,0,163
"42103950102",2163,192,13,0,29,7,67,0,2471
"42103950103",1999,193,22,28,115,5,149,31,2542
"42103950104",2099,206,12,0,60,0,73,28,2478
"42103950201",3115,121,145,1,182,0,84,2,3650
"42103950202",1298,48,93,0,0,0,37,0,1476
"42103950301",2320,238,0,0,15,0,32,54,2659
"42103950302",684,29,0,0,35,0,0,0,748
"42103950501",982,51,182,0,175,0,51,0,1441
"42103950502",2705,111,80,0,177,11,158,0,3242
"42103950601",1344,54,18,0,127,0,90,4,1637
"42103950603",868,106,0,0,3,0,66,6,1049
"42103950605",5211,368,132,56,40,98,582,37,6524
"42103950606",5429,127,25,0,297,0,511,0,6389
"42103950701",2753,508,32,0,371,10,333,26,4033
"42103950702",2993,341,94,0,141,58,168,0,3795
"42103950801",3557,609,768,85,132,100,782,40,6073
"42103950802",3148,528,931,142,482,90,1329,277,6927
"42103950900",3624,479,27,0,83,119,87,102,4521
"42105950100",4043,753,0,0,51,46,30,41,4964
"42105950200",2550,555,13,0,15,0,0,0,3133
"42105950300",3503,436,14,9,69,4,27,10,4072
"42105950400",2525,453,0,0,44,0,57,0,3079
"42105950500",1730,324,5,0,26,14,0,0,2099
"42107000100",4116,454,18,3,78,60,47,91,4867
"42107000200",2429,377,20,4,61,38,155,53,3137
"42107000300",4973,219,4,0,108,0,122,19,5445
"42107000400",2013,118,0,0,4,0,18,6,2159
"42107000500",2984,903,23,163,33,21,90,106,4323
"42107000601",2106,1089,94,0,152,100,544,296,4381
"42107000602",669,176,150,0,131,188,193,130,1637
"42107000700",2912,566,0,0,57,9,48,4,3596
"42107000800",2982,608,22,0,25,9,8,0,3654
"42107000900",5533,414,0,6,0,11,84,17,6065
"42107001000",2373,430,0,0,0,0,0,0,2803
"42107001100",2033,151,8,0,5,0,4,0,2201
"42107001200",4070,240,0,0,10,0,13,0,4333
"42107001300",2570,404,0,0,2,0,28,0,3004
"42107001400",2075,154,0,1,16,9,9,0,2264
"42107001500",3541,663,1,0,121,29,72,0,4427
"42107001600",3490,255,14,21,30,0,28,21,3859
"42107001700",2606,215,34,1,47,0,8,0,2911
"42107001800",1868,306,8,0,111,38,0,0,2331
"42107001900",3056,1426,218,18,196,57,50,279,5300
"42107002000",2472,373,76,156,125,71,41,52,3366
"42107002100",1337,158,0,1,63,0,37,5,1601
"42107002200",2393,363,4,21,52,7,5,46,2891
"42107002300",2447,387,6,53,28,0,23,0,2944
"42107002400",2053,235,0,0,35,0,22,0,2345
"42107002500",1939,331,2,0,20,0,23,2,2317
"42107002600",2646,1178,22,0,0,1,18,44,3909
"42107002700",2560,586,0,0,34,0,92,115,3387
"42107002800",1665,622,0,0,41,0,24,86,2438
"42107002900",4883,260,3,0,22,39,4,0,5211
"42107003000",5003,411,26,16,88,0,48,0,5592
"42107003100",2463,67,26,0,157,94,8,15,2830
"42107003200",5114,219,3,14,132,0,88,0,5570
"42107003300",4471,826,0,0,19,0,29,0,5345
"42107003400",3124,173,4,0,19,5,39,11,3375
"42107003500",4791,273,0,0,20,15,89,38,5226
"42107003600",2690,241,9,0,16,28,64,0,3048
"42107003700",3055,391,1,0,36,4,28,0,3515
"42107003800",1959,75,16,1,16,121,28,0,2216
"42107003900",3933,176,0,0,13,0,0,0,4122
"42109070100",5142,264,20,0,123,7,70,0,5626
"42109070200",7243,702,19,2,123,97,180,9,8375
"42109070300",4626,714,55,36,63,4,17,0,5515
"42109070400",4670,741,0,0,16,3,18,3,5451
"42109070500",3082,587,0,0,34,5,0,0,3708
"42109070600",4792,548,0,0,50,0,74,0,5464
"42109070701",2559,539,30,1,70,63,105,56,3423
"42109980705",152,36,17,75,0,14,0,38,332
"42111020101",1662,335,0,0,0,0,35,9,2041
"42111020102",4886,371,48,0,51,0,0,0,5356
"42111020200",4008,246,0,0,58,0,52,0,4364
"42111020300",3490,522,0,12,95,0,15,11,4145
"42111020400",3211,464,8,0,72,0,15,13,3783
"42111020500",2486,352,0,0,15,0,1,0,2854
"42111020600",5532,591,2,19,66,10,20,13,6253
"42111020700",2480,244,6,0,3,5,17,0,2755
"42111020800",3619,421,7,41,36,0,38,0,4162
"42111020900",3839,636,0,1,63,2,28,9,4578
"42111021000",3182,633,12,0,177,36,9,34,4083
"42111021100",1321,600,8,0,21,0,43,17,2010
"42111021200",2559,388,0,0,15,0,1,0,2963
"42111021300",3026,471,8,0,15,0,13,0,3533
"42111021400",3643,402,0,0,45,21,49,0,4160
"42111021500",2396,308,1,6,5,0,30,0,2746
"42111021600",1748,333,0,0,18,0,0,0,2099
"42111021700",2468,466,0,4,9,0,9,30,2986
"42111021800",3037,407,0,0,63,6,22,0,3535
"42111021901",2403,296,0,4,32,12,4,0,2751
"42111021902",2011,415,3,0,13,2,21,17,2482
"42113960100",3284,488,10,65,15,43,54,36,3995
"42113960200",2046,251,0,20,31,3,1,0,2352
"42115032000",2934,332,8,0,51,0,31,0,3356
"42115032100",3397,380,0,0,85,0,64,0,3926
"42115032200",3674,504,0,29,7,0,17,29,4260
"42115032300",2760,806,16,0,56,45,81,23,3787
"42115032400",3831,425,31,12,54,37,19,0,4409
"42115032500",3840,395,54,10,27,14,12,0,4352
"42115032600",3689,597,14,0,23,0,26,40,4389
"42115032700",2958,397,2,9,32,3,96,9,3506
"42115032800",4426,618,21,0,67,12,82,0,5226
"42115032901",3545,461,0,0,13,9,4,10,4042
"42115032902",1268,381,0,1,33,7,11,56,1757
"42117950100",3475,557,18,2,37,0,9,0,4098
"42117950200",2950,654,17,8,27,25,5,10,3696
"42117950300",3013,633,1,5,24,34,12,0,3722
"42117950400",3424,495,0,0,57,8,46,13,4043
"42117950500",3773,689,0,0,25,4,27,11,4529
"42117950600",3938,1101,0,103,93,0,123,10,5368
"42117950700",4646,439,0,8,76,22,5,4,5200
"42117950800",2580,440,5,0,81,28,57,69,3260
"42117950900",3517,463,0,0,59,28,31,4,4102
"42117951000",2440,438,3,0,37,15,6,13,2952
"42119090102",5284,773,0,37,13,6,22,6,6141
"42119090200",5376,859,11,0,16,19,85,10,6376
"42119090300",3248,280,92,0,21,14,0,47,3702
"42119090400",3768,313,38,67,38,15,128,0,4367
"42119090502",5826,728,288,0,234,59,162,1,7298
"42119090600",4259,376,0,0,177,0,79,74,4965
"42119090700",2431,741,46,35,99,68,0,247,3667
"42119980101",4,0,0,0,0,0,0,0,4
"42119980501",53,0,0,0,0,0,0,0,53
"42119980800",34,10,0,0,0,0,0,0,44
"42121200000",3066,383,0,0,42,22,16,10,3539
"42121200100",3525,328,8,0,58,6,8,30,3963
"42121200200",5052,718,5,13,96,8,29,0,5921
"42121200300",1191,369,6,5,76,0,4,41,1692
"42121200400",1665,409,42,3,84,39,72,26,2340
"42121200500",1949,346,28,3,4,7,16,0,2353
"42121200600",4169,807,14,0,5,135,0,0,5130
"42121200700",1431,525,3,10,23,35,13,21,2061
"42121200800",1796,456,43,0,68,23,24,23,2433
"42121200900",1337,960,13,12,22,57,24,30,2455
"42121201000",2675,557,5,5,45,11,0,0,3298
"42121201100",3887,516,1,6,78,16,21,7,4532
"42121201200",2437,328,0,0,22,41,16,0,2844
"42121201300",3245,428,0,0,52,0,0,0,3725
"42121201400",3397,412,1,9,41,38,32,11,3941
"42121201500",3071,453,2,1,61,26,2,5,3621
"42123970100",2033,308,11,14,35,10,20,0,2431
"42123970200",3476,303,4,0,47,0,26,0,3856
"42123970300",4772,885,5,0,47,49,13,61,5832
"42123970400",2366,308,11,1,42,27,4,1,2760
"42123970500",2884,441,4,2,84,22,16,6,3459
"42123970600",3159,192,21,2,40,0,9,2,3425
"42123970700",2505,174,11,0,7,0,23,0,2720
"42123970800",2640,413,0,0,38,66,7,0,3164
"42123970900",2704,691,0,0,7,44,19,50,3515
"42123971000",1976,231,0,0,10,0,5,0,2222
"42123971100",2729,191,0,2,26,16,5,16,2985
"42123971200",2078,440,0,5,2,0,2,0,2527
"42123971400",1559,267,0,5,19,3,7,0,1860
"42125704100",436,249,121,87,30,109,43,4,1079
"42125711000",3764,204,0,6,18,36,53,0,4081
"42125712700",1225,128,17,4,8,0,26,0,1408
"42125713700",3943,445,0,0,20,0,12,0,4420
"42125714000",2572,269,17,0,48,10,2,10,2928
"42125715700",1467,110,22,0,20,0,52,2,1673
"42125721000",3708,373,13,2,56,13,14,9,4188
"42125722700",3329,163,5,0,21,0,21,0,3539
"42125731000",5545,544,0,0,78,0,71,0,6238
"42125732000",3253,88,0,0,36,0,44,0,3421
"42125741100",4001,96,18,1,133,1,64,1,4315
"42125741300",3113,134,0,0,64,0,54,0,3365
"42125742100",5076,202,224,0,44,26,0,0,5572
"42125742200",1791,82,0,0,0,112,135,112,2232
"42125743700",1099,107,85,11,2,7,24,0,1335
"42125744100",4639,331,151,69,163,147,34,0,5534
"42125744200",2885,177,151,40,185,8,96,0,3542
"42125745100",7305,419,414,0,309,21,118,0,8586
"42125745200",4545,92,50,12,119,47,79,0,4944
"42125746100",5676,145,34,0,20,0,14,0,5889
"42125746200",4065,220,0,0,169,0,47,10,4511
"42125746301",4954,109,13,0,88,0,109,0,5273
"42125746302",5063,190,0,0,361,0,150,0,5764
"42125751100",4509,458,125,0,0,101,27,0,5220
"42125751200",2531,453,40,14,7,0,31,14,3090
"42125752700",4050,315,22,4,9,17,0,65,4482
"42125753700",1500,84,26,10,0,30,36,15,1701
"42125754200",1415,426,236,56,17,12,56,0,2218
"42125754300",1843,480,604,286,43,63,35,0,3354
"42125754400",1003,355,118,69,138,68,5,10,1766
"42125754500",1721,313,181,49,119,58,2,0,2443
"42125754600",1395,273,62,51,42,9,0,15,1847
"42125755100",3743,286,33,75,19,6,10,0,4172
"42125755200",4701,256,66,0,65,0,47,8,5143
"42125755700",3485,156,0,0,42,0,18,0,3701
"42125761000",4791,382,0,0,66,12,33,2,5286
"42125762000",2359,251,26,34,23,14,0,19,2726
"42125763700",1506,149,58,52,49,9,1,0,1824
"42125764000",2528,693,48,21,90,69,25,16,3490
"42125771100",5135,489,0,0,41,27,0,39,5731
"42125771200",2919,499,8,3,30,0,10,4,3473
"42125772700",1838,299,13,13,34,104,33,1,2335
"42125773100",2051,670,104,18,36,66,21,18,2984
"42125773200",1038,138,114,14,7,0,2,0,1313
"42125774700",5193,244,46,0,40,0,129,0,5652
"42125775200",1320,493,284,6,75,11,33,16,2238
"42125775300",1328,465,427,165,82,50,33,0,2550
"42125781700",3657,400,141,0,37,60,32,0,4327
"42125782700",970,166,74,10,24,6,13,10,1273
"42125783200",1751,600,62,111,17,0,39,0,2580
"42125783300",1109,386,22,0,0,8,0,0,1525
"42125784000",2275,299,9,3,45,19,13,4,2667
"42125791000",1280,194,6,0,26,8,4,0,1518
"42125792100",2450,810,62,56,87,42,0,0,3507
"42125792200",987,727,102,68,141,102,19,83,2229
"42125795700",1852,319,11,78,18,18,0,13,2309
"42125795800",3549,130,56,0,136,0,18,0,3889
"42125795900",3566,445,18,4,36,32,17,4,4122
"42125796000",2816,390,5,0,36,7,0,0,3254
"42127960100",1113,205,0,0,5,0,13,0,1336
"42127960200",2404,359,11,1,46,26,31,28,2906
"42127960300",2247,187,0,0,4,0,28,0,2466
"42127960400",2954,252,9,0,31,10,82,17,3355
"42127960500",3337,262,0,0,35,0,136,9,3779
"42127960600",4040,678,9,0,94,3,254,30,5108
"42127960700",3019,1251,0,16,25,0,54,0,4365
"42127960800",3998,431,60,2,51,9,91,82,4724
"42127960900",3173,518,24,0,63,74,31,78,3961
"42127961000",4381,276,287,60,75,13,111,0,5203
"42127961100",3280,437,0,0,70,6,24,11,3828
"42127961200",3763,345,27,0,67,0,241,8,4451
"42127961300",2414,277,86,0,38,0,33,0,2848
"42127961400",1340,220,21,27,44,0,16,0,1668
"42129800100",311,270,96,344,17,92,9,45,1184
"42129800200",724,76,100,312,102,8,7,0,1329
"42129800300",1742,241,60,364,49,60,12,126,2654
"42129800400",1190,121,0,0,31,0,11,0,1353
"42129800500",2050,102,198,0,99,1,8,0,2458
"42129800600",1233,380,248,526,238,199,0,0,2824
"42129800700",962,824,121,161,64,106,13,0,2251
"42129800800",1353,103,64,42,137,12,48,0,1759
"42129800900",1968,277,28,42,42,62,6,0,2425
"42129801001",3441,219,0,0,29,0,10,0,3699
"42129801002",2366,183,0,0,11,34,21,21,2636
"42129801100",4345,799,0,1,112,27,38,0,5322
"42129801200",5132,364,157,1,97,0,68,0,5819
"42129801300",3768,531,36,8,31,10,0,0,4384
"42129801400",1446,248,156,0,40,0,0,0,1890
"42129801500",2144,379,40,39,12,0,22,0,2636
"42129801600",942,225,77,46,32,0,19,0,1341
"42129801701",2114,61,64,11,0,0,7,0,2257
"42129801702",4414,172,0,0,9,0,8,0,4603
"42129801703",2502,103,0,0,6,0,11,5,2627
"42129801800",5344,609,71,4,71,4,53,16,6172
"42129801900",6166,225,1,0,115,83,0,22,6612
"42129802001",2481,34,0,0,21,10,12,1,2559
"42129802002",6731,497,69,6,347,57,103,24,7834
"42129802101",4532,277,0,0,186,0,0,0,4995
"42129802102",5530,166,0,0,279,68,35,68,6146
"42129802103",2150,16,0,1,175,0,59,0,2401
"42129802200",2754,259,54,0,8,0,0,0,3075
"42129802301",5257,195,106,0,11,37,0,2,5608
"42129802303",3005,169,0,0,21,0,55,0,3250
"42129802304",6430,470,0,0,11,0,0,0,6911
"42129802400",3913,310,28,0,15,11,0,0,4277
"42129802500",1883,205,73,67,55,115,22,0,2420
"42129802600",2658,375,38,97,162,76,0,0,3406
"42129802700",1801,136,10,0,41,0,15,0,2003
"42129802800",1564,333,143,89,93,58,41,0,2321
"42129802900",5024,242,0,0,99,0,7,0,5372
"42129803000",4183,474,11,25,83,0,24,0,4800
"42129803100",3761,134,0,0,173,13,49,0,4130
"42129803200",2114,71,0,0,0,0,0,0,2185
"42129803301",5569,85,29,24,133,0,77,0,5917
"42129803302",3978,116,27,0,47,0,81,0,4249
"42129803400",2997,103,6,0,8,0,45,0,3159
"42129803501",4601,136,63,0,56,0,0,0,4856
"42129803502",3819,184,0,0,46,0,34,0,4083
"42129803600",1691,117,0,1,20,0,28,0,1857
"42129803700",4152,374,16,0,14,0,58,81,4695
"42129803800",5299,165,13,0,122,0,52,0,5651
"42129803901",3073,180,13,19,69,0,72,16,3442
"42129803902",2307,509,0,5,126,142,21,71,3181
"42129804000",689,266,75,23,36,66,10,12,1177
"42129804100",1691,478,147,20,29,114,0,0,2479
"42129804200",3008,492,162,41,47,48,15,25,3838
"42129804300",1770,450,21,5,0,0,5,0,2251
"42129804400",1732,191,10,14,74,21,3,0,2045
"42129804501",4373,206,9,0,86,0,50,6,4730
"42129804502",4802,202,14,0,195,34,96,0,5343
"42129804600",2473,452,13,0,30,0,41,0,3009
"42129804701",2839,69,79,2,35,0,0,0,3024
"42129804702",4094,167,0,0,44,0,50,0,4355
"42129804801",2070,249,32,23,57,6,28,0,2465
"42129804802",6039,378,0,2,73,76,150,0,6718
"42129804900",4704,530,0,58,152,42,29,7,5522
"42129805000",3344,637,1,0,12,0,18,0,4012
"42129805100",2266,264,15,0,24,4,0,0,2573
"42129805200",1229,366,261,291,22,14,0,5,2188
"42129805400",628,488,300,208,101,0,19,79,1823
"42129805500",3136,226,98,0,162,0,54,0,3676
"42129805600",1480,383,5,0,16,0,37,17,1938
"42129805800",2391,436,58,125,97,23,0,0,3130
"42129805901",1397,56,65,0,38,0,0,0,1556
"42129805902",6012,316,34,47,173,35,39,0,6656
"42129806000",2123,470,0,0,5,15,0,26,2639
"42129806100",3190,169,26,19,22,10,18,6,3460
"42129806200",2375,378,0,0,0,0,0,0,2753
"42129806300",1657,209,110,0,1,0,13,0,1990
"42129806400",2064,217,45,5,27,0,0,0,2358
"42129806500",4067,421,5,0,21,158,42,0,4714
"42129806600",2470,619,23,1,55,0,9,0,3177
"42129806700",2283,336,19,0,21,1,7,0,2667
"42129806800",1280,271,15,0,78,0,4,0,1648
"42129806900",3340,411,0,0,84,0,19,0,3854
"42129807000",3065,298,0,0,7,84,7,0,3461
"42129807100",3332,202,0,0,0,0,21,0,3555
"42129807200",6624,464,0,0,96,0,19,0,7203
"42129807300",4589,531,0,2,14,70,12,71,5289
"42129807401",2256,179,0,12,0,6,5,0,2458
"42129807402",5874,486,37,13,82,33,85,0,6610
"42129807500",1913,247,0,0,34,0,11,16,2221
"42129807600",2121,332,0,0,27,12,0,11,2503
"42129807700",3203,261,22,31,56,0,0,0,3573
"42129807800",3429,541,20,3,74,28,8,0,4103
"42129807900",5482,871,13,0,49,0,0,0,6415
"42129808100",3376,655,121,29,13,19,57,0,4270
"42129808200",2162,433,0,2,30,21,21,4,2673
"42129808300",4577,654,9,11,52,11,20,0,5334
"42129808401",1841,123,0,0,3,0,3,0,1970
"42129808402",4305,326,0,0,36,0,36,4,4707
"42129808500",1323,98,0,1,0,11,0,11,1444
"42129808600",3930,565,0,0,86,0,85,0,4666
"42131400100",2554,502,2,1,70,12,59,58,3258
"42131400200",3558,532,2,0,8,23,51,32,4206
"42131400300",3959,375,15,21,39,11,16,67,4503
"42131400400",3692,422,21,0,34,0,15,13,4197
"42131400500",3415,535,7,0,83,0,16,0,4056
"42131400600",2963,363,5,0,84,8,31,0,3454
"42131400700",3487,489,17,1,72,17,24,8,4115
"42133000100",475,234,154,151,87,157,92,422,1772
"42133000200",880,517,268,669,307,110,276,40,3067
"42133000300",684,274,477,378,320,262,356,311,3062
"42133000400",968,310,273,47,202,251,239,259,2549
"42133000500",951,512,238,185,397,337,344,562,3526
"42133000600",1335,285,493,110,134,294,404,370,3425
"42133000700",895,741,190,438,299,595,675,950,4783
"42133000800",1163,193,450,162,190,75,335,161,2729
"42133000900",597,710,585,338,163,263,217,350,3223
"42133001000",364,126,663,373,272,78,357,137,2370
"42133001100",858,615,773,443,784,331,804,606,5214
"42133001200",582,653,198,335,530,637,510,820,4265
"42133001300",1506,333,833,97,107,113,201,123,3313
"42133001400",2563,428,497,396,300,75,534,186,4979
"42133001500",945,803,560,411,307,682,468,928,5104
"42133001600",856,175,131,106,94,88,346,192,1988
"42133010110",5443,283,440,58,554,21,59,50,6908
"42133010120",3738,117,172,20,293,0,0,1,4341
"42133010130",2964,126,47,0,315,10,115,0,3577
"42133010210",2964,115,0,7,133,42,17,0,3278
"42133010220",4769,198,265,0,349,0,416,59,6056
"42133010300",1299,62,175,45,75,0,23,28,1707
"42133010400",3150,233,185,29,288,57,206,0,4148
"42133010510",2533,88,44,0,274,9,126,0,3074
"42133010520",2063,72,12,20,38,23,46,0,2274
"42133020100",2827,147,28,0,75,0,223,32,3332
"42133020220",3968,201,21,0,90,34,25,0,4339
"42133020221",4175,196,22,0,200,26,236,0,4855
"42133020222",4367,225,30,1,41,0,81,0,4745
"42133020310",2440,94,15,0,64,0,80,0,2693
"42133020320",6934,425,0,0,94,29,45,0,7527
"42133020410",4989,251,0,0,86,0,288,22,5636
"42133020420",7594,470,84,0,393,0,170,16,8727
"42133020510",3463,305,0,1,7,0,17,0,3793
"42133020521",4997,293,115,0,229,73,178,63,5948
"42133020522",3941,78,127,40,57,10,53,0,4306
"42133020600",6254,470,2,0,280,28,123,0,7157
"42133020710",5633,417,314,7,293,32,52,0,6748
"42133020720",7634,560,464,16,549,0,411,12,9646
"42133020800",6428,242,359,333,225,0,540,299,8426
"42133020910",5217,284,9,26,130,23,54,45,5788
"42133020921",6372,647,110,0,147,86,307,56,7725
"42133020922",3703,272,0,0,38,0,15,0,4028
"42133021010",4453,184,330,20,217,95,300,80,5679
"42133021020",5420,390,38,3,240,107,146,32,6376
"42133021100",3780,201,173,45,225,0,317,0,4741
"42133021210",6196,554,497,251,391,20,260,41,8210
"42133021220",6000,66,859,0,341,0,89,0,7355
"42133021300",2761,434,322,103,653,318,406,185,5182
"42133021410",3844,268,327,112,275,12,255,128,5221
"42133021420",6406,239,266,15,286,0,206,0,7418
"42133021500",3197,212,67,0,214,37,69,5,3801
"42133021600",2184,163,221,2,223,17,102,12,2924
"42133021711",2794,195,5,0,9,0,0,10,3013
"42133021712",5827,331,9,0,84,8,37,0,6296
"42133021720",3539,672,232,7,137,0,173,3,4763
"42133021801",3807,217,131,0,92,104,160,104,4615
"42133021802",3837,76,78,0,85,0,69,0,4145
"42133021900",5999,631,0,0,273,178,252,176,7509
"42133022000",2980,460,19,19,45,263,42,263,4091
"42133022100",2152,394,41,57,356,200,304,189,3693
"42133022200",4150,254,0,0,51,0,149,0,4604
"42133022300",3181,255,25,0,189,26,81,36,3793
"42133022401",3292,108,0,0,0,0,0,0,3400
"42133022402",7331,160,1,20,297,1,27,1,7838
"42133022500",3483,218,32,0,68,0,26,0,3827
"42133022600",7329,173,351,20,370,28,202,0,8473
"42133022700",5395,527,102,13,183,82,153,30,6485
"42133022800",6794,639,179,18,63,0,141,0,7834
"42133022910",7847,513,368,0,497,35,350,42,9652
"42133022920",3622,157,113,15,308,0,124,0,4339
"42133023000",3770,782,15,16,83,146,52,136,5000
"42133023100",5494,724,16,15,70,18,77,0,6414
"42133023200",5951,303,312,0,117,0,145,8,6836
"42133023301",5009,364,265,0,362,43,119,26,6188
"42133023302",5378,545,104,0,129,0,95,0,6251
"42133023400",5301,282,50,6,57,33,128,0,5857
"42133023500",4639,308,67,70,126,15,83,98,5406
"42133023601",3217,367,0,0,152,85,64,7,3892
"42133023602",4244,619,61,8,35,51,53,58,5129
"42133023710",3635,273,5,5,53,0,15,2,3988
"42133023721",5017,947,33,0,105,0,67,0,6169
"42133023722",2572,363,0,0,97,8,5,0,3045
"42133023810",4576,138,7,1,70,0,48,7,4847
"42133023821",4822,209,41,0,134,0,256,0,5462
"42133023822",6110,120,153,0,229,44,38,60,6754
"42133023901",6729,463,37,81,52,0,76,0,7438
"42133023902",2868,87,51,0,42,0,107,0,3155
"42133024001",4740,471,110,0,148,2,33,0,5504
"42133024002",3066,231,20,17,68,86,12,19,3519
"44001030100",4325,49,110,0,356,2,63,3,4908
"44001030200",2876,104,0,0,147,0,48,0,3175
"44001030300",3999,47,0,0,405,0,140,0,4591
"44001030400",3599,27,0,2,94,9,84,0,3815
"44001030500",2565,350,0,0,101,35,50,20,3121
"44001030601",3250,243,0,0,7,0,161,0,3661
"44001030602",3392,371,10,0,27,12,19,19,3850
"44001030700",3139,642,0,0,36,29,71,5,3922
"44001030800",3125,232,43,0,102,28,31,5,3566
"44001030901",5700,267,0,0,147,17,152,17,6300
"44001030902",5878,420,48,0,85,75,20,58,6584
"44003020101",5433,349,224,8,60,29,103,0,6206
"44003020102",3788,559,225,0,288,27,292,145,5324
"44003020200",3512,590,122,0,731,50,380,28,5413
"44003020300",3923,1455,134,22,210,262,247,109,6362
"44003020400",1892,314,32,32,69,0,17,0,2356
"44003020500",3435,634,75,48,300,0,78,60,4630
"44003020601",5445,466,0,1,306,136,261,0,6615
"44003020602",3151,485,0,0,22,0,61,0,3719
"44003020603",5959,340,0,0,21,0,39,0,6359
"44003020604",4227,644,0,1,33,1,20,138,5064
"44003020701",1547,191,0,0,72,3,0,0,1813
"44003020702",4474,190,7,2,0,0,54,0,4727
"44003020703",6204,428,0,19,115,1,53,20,6840
"44003020800",5231,365,73,21,398,0,43,0,6131
"44003020901",3063,252,213,0,69,0,78,0,3675
"44003020903",5420,290,0,3,203,0,79,3,5998
"44003020904",3176,94,54,1,199,16,81,3,3624
"44003021001",2315,166,15,0,203,7,275,16,2997
"44003021002",3571,449,43,3,666,82,430,52,5296
"44003021100",4465,164,32,0,500,13,396,33,5603
"44003021200",3009,188,121,0,140,12,165,22,3657
"44003021300",3896,303,133,11,137,0,143,0,4623
"44003021401",3738,93,11,6,182,0,152,9,4191
"44003021402",3141,132,221,14,138,79,133,14,3872
"44003021501",2657,213,20,0,61,0,63,0,3014
"44003021502",3452,510,15,0,159,7,116,0,4259
"44003021600",1481,28,16,1,54,1,0,2,1583
"44003021700",4131,498,176,0,54,36,81,0,4976
"44003021800",3482,272,15,5,250,33,48,33,4138
"44003021901",3163,68,13,0,294,0,160,0,3698
"44003021902",2157,318,35,3,82,84,120,116,2915
"44003021903",3482,227,57,1,78,35,80,18,3978
"44003022000",3030,236,0,27,109,1,46,1,3450
"44003022100",4651,310,0,0,368,32,20,94,5475
"44003022201",5751,302,44,1,612,0,244,0,6954
"44003022202",3312,280,21,0,388,0,147,0,4148
"44003022300",2809,456,0,0,303,129,41,33,3771
"44003022400",2051,33,3,0,50,30,48,0,2215
"44003980000",0,0,0,0,0,0,0,0,0
"44005040101",4248,403,51,1,85,1,44,0,4833
"44005040102",5192,490,0,0,144,58,75,46,6005
"44005040103",5629,327,137,5,319,46,130,37,6630
"44005040200",760,212,282,7,184,6,32,0,1483
"44005040302",1895,87,101,0,433,0,158,27,2701
"44005040303",1677,200,288,145,465,104,367,2,3248
"44005040304",1953,306,178,81,187,52,84,40,2881
"44005040400",5590,301,25,2,345,18,229,2,6512
"44005040500",3255,480,637,75,257,51,484,84,5323
"44005040600",3342,161,253,0,434,225,719,100,5234
"44005040700",2561,319,74,0,51,0,51,0,3056
"44005040800",1887,168,32,14,360,57,162,57,2737
"44005040900",2991,119,14,15,162,4,110,0,3415
"44005041000",1434,260,39,5,32,16,17,0,1803
"44005041100",1066,238,18,23,52,32,115,70,1614
"44005041200",207,38,91,12,77,22,34,10,491
"44005041300",4791,372,23,0,237,0,110,30,5563
"44005041400",3139,261,31,0,51,8,6,0,3496
"44005041601",2648,231,0,0,45,0,0,1,2925
"44005041602",4076,159,76,9,24,0,43,9,4396
"44005041701",3063,136,0,0,138,0,0,0,3337
"44005041702",4890,233,0,0,0,0,37,0,5160
"44005990000",0,0,0,0,0,0,0,0,0
"44007000101",792,531,464,113,1473,384,1462,553,5772
"44007000102",992,502,750,262,1682,578,1592,966,7324
"44007000200",646,1201,627,355,2234,929,2283,1609,9884
"44007000300",1860,573,1084,114,2764,752,3561,1033,11741
"44007000400",640,330,1007,299,708,747,1374,1131,6236
"44007000500",226,237,379,514,551,1296,547,1718,5468
"44007000600",256,268,406,239,585,108,695,241,2798
"44007000700",172,334,322,607,430,554,410,684,3513
"44007000800",1073,386,109,122,148,513,239,262,2852
"44007000900",806,650,88,46,300,119,353,292,2654
"44007001000",875,441,75,344,641,353,763,489,3981
"44007001100",1213,426,60,53,456,270,344,218,3040
"44007001200",787,178,200,483,554,601,1027,752,4582
"44007001300",1202,391,328,148,1865,758,1584,883,7159
"44007001400",1301,353,778,465,1939,1809,1844,1633,10122
"44007001500",1127,256,405,91,1164,21,1244,220,4528
"44007001600",1900,320,867,231,3941,1859,4885,1992,15995
"44007001700",1203,358,190,116,955,674,1243,792,5531
"44007001800",2190,813,313,177,2282,772,2753,1363,10663
"44007001900",916,632,515,307,1499,1278,1913,1599,8659
"44007002000",2272,798,738,207,1149,1224,1604,1563,9555
"44007002101",1383,53,515,51,429,198,787,169,3585
"44007002102",1766,288,1040,355,1431,283,2377,478,8018
"44007002200",1424,560,590,586,1441,605,1815,1008,8029
"44007002300",2318,934,621,4,289,65,208,187,4626
"44007002400",3564,242,614,7,503,10,475,28,5443
"44007002500",733,452,398,100,699,258,353,362,3355
"44007002600",911,436,596,364,643,90,1047,367,4454
"44007002700",834,627,972,269,564,883,753,1101,6003
"44007002800",2408,366,778,478,1468,839,1601,729,8667
"44007002900",2378,752,1341,875,997,336,941,795,8415
"44007003100",1842,291,517,376,383,988,166,648,5211
"44007003200",2200,65,438,26,440,0,262,2,3433
"44007003300",3208,158,197,5,312,21,135,30,4066
"44007003400",4446,332,87,2,276,0,50,2,5195
"44007003500",3478,584,144,0,525,149,238,140,5258
"44007003601",858,550,8,12,127,274,13,127,1969
"44007003602",1071,241,49,1,61,56,15,1,1495
"44007003700",2316,928,78,33,234,172,35,327,4123
"44007010101",3637,183,182,1,81,33,75,1,4193
"44007010102",3134,142,63,1,148,60,64,26,3638
"44007010200",3987,604,206,404,1138,126,411,0,6876
"44007010300",2783,274,462,0,489,70,305,9,4392
"44007010400",5051,813,418,64,344,213,273,246,7422
"44007010501",3084,338,196,63,396,344,83,311,4815
"44007010502",3742,293,255,34,408,0,68,0,4800
"44007010600",4742,447,0,13,345,59,230,0,5836
"44007010701",2078,134,30,0,45,0,22,0,2309
"44007010702",3598,286,32,0,125,79,17,0,4137
"44007010800",1812,871,522,238,785,192,1873,747,7040
"44007010900",2155,965,399,198,601,183,1979,964,7444
"44007011000",2363,942,648,163,728,615,2516,1174,9149
"44007011100",1728,487,1105,234,342,755,2117,1276,8044
"44007011200",4523,384,212,126,270,191,345,233,6284
"44007011301",3548,349,138,0,184,26,231,10,4486
"44007011302",3905,170,0,0,80,0,5,0,4160
"44007011401",7101,108,30,2,526,41,257,0,8065
"44007011402",4171,74,0,1,81,0,0,0,4327
"44007011403",6581,342,0,5,301,6,86,99,7420
"44007011500",5009,484,488,0,163,7,378,175,6704
"44007011600",5115,128,129,0,501,2,17,4,5896
"44007011701",4142,237,11,133,169,0,226,2,4920
"44007011702",3862,103,8,3,325,0,89,1,4391
"44007011800",4605,689,658,106,340,75,428,0,6901
"44007011901",2276,313,247,33,145,28,194,106,3342
"44007011902",4457,288,20,0,122,0,191,0,5078
"44007012000",5018,314,317,19,414,26,500,13,6621
"44007012102",3058,580,282,65,131,0,333,0,4449
"44007012103",2130,162,261,7,97,30,55,0,2742
"44007012104",3341,485,358,103,99,18,87,8,4499
"44007012200",6302,388,139,0,420,158,351,0,7758
"44007012300",5554,342,102,6,249,38,195,41,6527
"44007012401",5218,361,131,2,1217,0,481,0,7410
"44007012402",2086,85,129,0,295,0,255,1,2851
"44007012500",3415,1205,0,0,374,158,140,121,5413
"44007012601",1457,25,0,8,117,24,85,8,1724
"44007012602",6526,285,0,0,141,9,201,34,7196
"44007012701",4749,91,0,0,87,9,0,0,4936
"44007012702",4186,223,111,1,78,0,53,38,4690
"44007012801",4198,205,0,0,100,1,64,1,4569
"44007012802",2135,191,14,0,4,0,9,40,2393
"44007012803",4324,158,19,0,236,0,0,0,4737
"44007012900",4003,530,13,11,265,56,48,51,4977
"44007013001",3410,207,11,0,30,0,87,0,3745
"44007013002",6507,366,25,0,50,15,148,8,7119
"44007013101",4511,231,10,0,73,8,42,8,4883
"44007013102",4776,116,0,0,76,0,53,0,5021
"44007013201",4454,256,0,2,77,0,52,1,4842
"44007013202",5039,367,0,0,136,0,24,0,5566
"44007013300",4205,206,58,0,140,0,42,0,4651
"44007013400",3000,350,62,72,259,16,195,17,3971
"44007013500",2605,556,264,1,609,348,767,486,5636
"44007013600",2223,240,185,6,214,119,324,52,3363
"44007013701",2384,469,246,0,561,109,457,10,4236
"44007013702",1817,165,97,20,439,10,59,0,2607
"44007013800",3672,497,179,1,252,0,229,1,4831
"44007013900",2307,256,39,0,81,47,203,44,2977
"44007014000",3993,360,88,178,979,8,717,0,6323
"44007014100",2939,553,166,138,1019,445,1166,431,6857
"44007014200",1760,241,42,0,110,36,51,11,2251
"44007014300",4151,44,169,0,456,185,39,0,5044
"44007014400",3274,222,90,0,188,0,117,79,3970
"44007014501",4905,37,56,7,155,0,82,0,5242
"44007014502",3569,388,32,79,233,0,265,76,4642
"44007014600",6442,58,38,2,649,17,198,0,7404
"44007014700",4928,913,454,0,994,120,1727,422,9558
"44007014800",4557,330,44,0,99,97,317,53,5497
"44007015000",2575,628,542,324,905,0,777,287,6038
"44007015100",959,436,1311,509,798,443,595,549,5600
"44007015200",594,701,25,214,415,243,351,484,3027
"44007015300",940,335,206,92,244,117,295,150,2379
"44007015400",927,235,259,191,565,74,826,128,3205
"44007015500",2513,487,418,35,797,328,669,261,5508
"44007015600",1821,216,120,34,385,32,607,35,3250
"44007015700",3052,142,104,0,265,2,300,0,3865
"44007015800",3305,192,38,0,279,35,436,41,4326
"44007015900",2177,124,306,94,253,30,285,2,3271
"44007016000",1479,276,298,594,378,108,334,218,3685
"44007016100",1378,590,754,940,849,171,790,659,6131
"44007016300",1821,133,446,0,327,14,225,0,2966
"44007016400",1091,253,1124,530,772,355,417,365,4907
"44007016500",2545,329,127,83,607,33,217,52,3993
"44007016600",683,149,217,166,138,277,211,290,2131
"44007016700",1491,261,343,179,346,250,511,105,3486
"44007016800",2343,146,169,16,307,21,401,0,3403
"44007016900",1672,152,58,2,203,0,73,0,2160
"44007017000",3099,209,583,129,355,52,334,0,4761
"44007017100",2491,582,689,121,469,185,672,532,5741
"44007017300",2449,268,82,153,232,120,100,48,3452
"44007017400",1790,1144,246,213,299,334,268,999,5293
"44007017500",2546,348,68,46,121,69,61,167,3426
"44007017600",1400,440,251,42,314,39,265,189,2940
"44007017700",2805,237,136,25,387,67,106,0,3763
"44007017800",1509,634,47,71,279,105,245,101,2991
"44007017900",1599,936,56,28,271,106,321,172,3489
"44007018000",1058,1242,39,18,260,51,22,275,2965
"44007018100",1979,544,151,72,45,1,318,236,3346
"44007018200",1392,427,127,79,462,35,190,98,2810
"44007018300",760,680,165,81,66,23,14,67,1856
"44007018400",3526,600,18,421,823,197,566,629,6780
"44007018500",2000,456,8,1,101,29,54,144,2793
"44009041500",742,76,2,4,4,4,24,4,860
"44009050102",1880,82,0,0,74,10,68,0,2114
"44009050103",4289,661,108,184,483,61,147,59,5992
"44009050104",3662,154,0,0,189,9,139,9,4162
"44009050301",3833,180,0,0,158,30,0,0,4201
"44009050302",2282,193,26,36,68,42,44,32,2723
"44009050401",4517,208,14,0,70,0,80,0,4889
"44009050402",2487,22,10,2,152,9,87,0,2769
"44009050500",5712,485,39,41,208,74,164,60,6783
"44009050600",6949,284,24,0,240,69,109,4,7679
"44009050700",7531,272,116,11,185,0,253,0,8368
"44009050801",4731,1060,61,58,84,167,50,54,6265
"44009050802",3142,201,11,0,195,29,106,0,3684
"44009050901",4931,471,29,11,380,0,60,0,5882
"44009050902",4708,296,47,68,130,46,104,0,5399
"44009051000",1479,72,0,0,39,1,14,0,1605
"44009051101",4252,405,0,0,178,11,104,0,4950
"44009051102",2484,334,0,0,137,20,88,0,3063
"44009051201",3563,152,172,5,152,192,100,32,4368
"44009051202",4113,273,68,2,209,22,17,0,4704
"44009051302",4044,137,31,0,57,0,52,0,4321
"44009051304",1812,62,14,0,49,0,18,0,1955
"44009051305",3342,223,28,16,326,64,0,16,4015
"44009051306",4960,204,46,22,609,3,304,3,6151
"44009051400",327,215,0,88,17,0,0,0,647
"44009051502",5834,709,69,11,236,27,117,30,7033
"44009051503",3450,799,0,0,82,25,99,5,4460
"44009051504",3518,982,0,10,12,15,16,0,4553
"44009990100",0,0,0,0,0,0,0,0,0
"44009990200",0,0,0,0,0,0,0,0,0
"45001950100",2368,381,336,58,16,12,59,0,3230
"45001950200",2265,312,909,68,58,32,0,13,3657
"45001950300",2384,644,110,57,10,13,35,0,3253
"45001950400",3919,578,839,640,18,25,33,0,6052
"45001950500",2057,437,1428,1090,129,12,0,0,5153
"45001950600",1318,234,952,669,25,10,0,0,3208
"45003020100",2983,375,565,482,144,192,283,175,5199
"45003020200",3512,672,812,439,42,236,60,140,5913
"45003020301",1277,466,261,87,11,388,35,378,2903
"45003020302",2414,223,2003,554,19,41,196,20,5470
"45003020400",3577,707,1071,466,17,152,194,114,6298
"45003020500",5581,208,828,265,134,61,168,0,7245
"45003020601",2520,83,835,0,193,0,27,0,3658
"45003020602",3092,582,1435,1026,297,550,219,492,7693
"45003020701",3892,543,1236,129,132,72,63,0,6067
"45003020702",1635,340,1070,394,532,159,442,246,4818
"45003020801",2485,103,66,0,58,0,57,0,2769
"45003020802",3450,428,1000,15,331,12,226,148,5610
"45003020901",1475,252,548,155,124,7,39,0,2600
"45003020902",3589,802,1366,463,21,0,18,10,6269
"45003021001",2803,705,730,170,256,298,165,191,5318
"45003021002",3078,1809,571,23,97,484,22,434,6518
"45003021101",1731,572,50,53,279,0,233,0,2918
"45003021102",2328,818,320,213,0,104,0,104,3887
"45003021201",4764,262,250,128,159,0,18,0,5581
"45003021202",3048,354,110,84,162,7,54,0,3819
"45003021203",6830,169,725,34,337,19,471,19,8604
"45003021300",3006,233,458,144,179,48,60,11,4139
"45003021400",531,66,2711,1819,70,148,40,148,5533
"45003021500",3372,163,829,369,190,0,163,0,5086
"45003021601",1853,389,1779,1457,54,8,0,102,5642
"45003021602",5642,406,1347,266,307,183,337,168,8656
"45003021700",1786,795,894,548,16,42,0,129,4210
"45003021800",1125,147,827,400,54,0,0,0,2553
"45003021900",3727,697,854,176,328,636,307,621,7346
"45003022001",2487,483,791,131,220,131,154,143,4540
"45003022002",4397,574,1064,512,101,0,60,0,6708
"45003022100",1939,480,526,201,89,2,49,0,3286
"45003980100",0,0,0,0,0,0,0,0,0
"45005970200",856,82,2195,1850,152,21,182,21,5359
"45005970300",533,172,239,168,2,0,0,44,1158
"45005970400",423,50,1393,915,10,0,0,0,2791
"45007000200",2612,288,528,84,68,3,202,6,3791
"45007000300",2736,641,1060,107,297,10,60,125,5036
"45007000500",806,220,1405,742,100,0,26,24,3323
"45007000600",395,314,987,1143,29,123,7,108,3106
"45007000700",959,687,1510,1068,101,122,111,143,4701
"45007000800",1035,471,446,275,8,34,182,0,2451
"45007000900",1426,376,450,511,47,35,0,96,2941
"45007001000",1650,350,255,135,180,35,551,44,3200
"45007001100",3815,162,408,434,170,0,57,0,5046
"45007010102",6076,169,174,62,27,0,68,0,6576
"45007010103",5887,526,44,204,375,0,607,0,7643
"45007010104",6591,971,376,25,40,12,104,100,8219
"45007010200",4316,336,114,0,0,0,14,0,4780
"45007010300",2755,1018,193,41,15,118,56,98,4294
"45007010401",4758,579,374,56,341,0,361,26,6495
"45007010402",4539,773,277,0,80,47,75,31,5822
"45007010500",4811,560,686,0,281,0,359,0,6697
"45007010600",5889,705,432,15,250,10,12,0,7313
"45007010700",3029,1026,642,338,201,18,64,23,5341
"45007010800",4066,368,372,15,89,0,83,0,4993
"45007010900",3585,428,157,22,84,0,8,0,4284
"45007011001",3654,778,86,63,76,0,34,16,4707
"45007011002",3242,334,219,0,228,73,14,23,4133
"45007011100",1819,306,294,109,188,26,80,53,2875
"45007011201",3003,249,302,0,267,25,14,0,3860
"45007011202",6431,394,648,12,190,0,78,0,7753
"45007011300",5190,655,878,268,122,98,105,98,7414
"45007011401",2592,454,813,183,103,0,148,0,4293
"45007011402",2097,475,463,31,64,0,60,52,3242
"45007011500",4899,672,363,517,72,32,74,0,6629
"45007011600",1625,262,38,55,14,39,0,0,2033
"45007011700",3703,1218,340,481,75,50,0,34,5901
"45007011800",2854,554,346,78,56,28,140,28,4084
"45007011901",2704,644,835,842,159,15,235,0,5434
"45007011902",1176,398,903,381,10,0,2,34,2904
"45007012001",3494,183,879,30,249,28,171,0,5034
"45007012002",2573,770,918,234,121,0,190,102,4908
"45007012200",4551,769,743,240,102,14,0,0,6419
"45007012300",1293,544,965,631,85,47,52,47,3664
"45009960100",595,26,2738,1830,78,0,51,0,5318
"45009960200",2819,206,2440,1240,61,43,48,37,6894
"45009960300",769,300,315,76,7,13,7,13,1500
"45009960400",653,205,249,149,23,0,0,0,1279
"45011970100",2498,515,1376,1065,17,18,0,0,5489
"45011970200",997,304,1917,855,37,59,36,105,4310
"45011970300",1395,412,1125,1223,44,0,18,0,4217
"45011970400",3030,715,407,229,121,92,77,139,4810
"45011970500",1547,161,1067,756,82,8,73,8,3702
"45011980100",0,0,0,0,0,0,0,0,0
"45013000100",1226,402,1829,921,11,36,33,56,4514
"45013000200",1618,197,1958,1145,45,13,206,20,5202
"45013000300",3605,573,473,0,370,42,341,112,5516
"45013000400",265,10,69,0,4,0,3,0,351
"45013000501",3481,49,1675,590,552,12,391,0,6750
"45013000502",2723,19,1303,501,230,132,224,97,5229
"45013000503",2626,397,1082,207,81,80,139,259,4871
"45013000600",1382,314,487,121,117,35,91,14,2561
"45013000700",3533,337,573,470,912,61,840,28,6754
"45013000800",1944,475,1171,531,248,0,116,20,4505
"45013000901",2128,120,229,89,86,0,67,8,2727
"45013000902",6151,457,879,111,127,121,309,153,8308
"45013000903",921,107,119,49,78,136,39,201,1650
"45013001000",459,27,403,0,29,0,7,27,952
"45013001101",1982,137,1196,174,72,18,1,1,3581
"45013001102",914,140,2431,1128,372,171,252,89,5497
"45013001200",840,11,32,0,1,1,1,0,886
"45013002101",325,268,0,0,10,0,0,0,603
"45013002102",1236,331,81,15,190,4,214,284,2355
"45013002103",2191,120,404,0,278,0,170,18,3181
"45013002104",10675,479,129,0,249,0,398,29,11959
"45013002105",2152,55,391,0,162,0,619,0,3379
"45013002106",6087,651,1117,107,845,173,1370,696,11046
"45013002107",6555,1194,630,901,1010,471,2675,1313,14749
"45013002108",3280,682,530,107,346,13,583,316,5857
"45013002201",5970,174,294,88,44,0,35,0,6605
"45013002202",2883,100,207,0,98,0,63,0,3351
"45013010100",1549,97,0,0,37,0,13,10,1706
"45013010200",2816,122,53,0,302,28,365,28,3714
"45013010300",3655,216,0,0,231,12,166,0,4280
"45013010400",4566,69,811,71,212,0,516,0,6245
"45013010500",2147,279,547,149,640,41,1161,233,5197
"45013010600",3872,96,0,0,94,0,33,0,4095
"45013010700",4149,197,100,6,13,0,43,14,4522
"45013010800",1255,235,642,348,855,478,1464,549,5826
"45013010900",1224,168,48,85,16,11,31,29,1612
"45013011000",1252,83,192,51,84,33,440,0,2135
"45013011100",1962,55,19,0,21,91,190,91,2429
"45013011200",590,65,0,0,12,0,11,0,678
"45013011300",1159,155,0,0,109,0,124,0,1547
"45013990100",0,0,0,0,0,0,0,0,0
"45015020101",1021,168,1490,345,11,26,26,7,3094
"45015020102",2353,141,818,315,15,0,15,0,3657
"45015020201",1798,51,1321,1059,26,0,0,3,4258
"45015020202",114,70,1938,746,0,0,0,18,2886
"45015020301",2078,414,261,9,22,0,66,0,2850
"45015020302",3207,924,1830,788,142,4,0,4,6899
"45015020401",1583,446,1390,205,98,4,25,3,3754
"45015020403",5542,277,354,7,219,42,72,42,6555
"45015020404",3366,21,604,0,90,0,112,0,4193
"45015020405",856,180,1397,214,26,0,0,0,2673
"45015020503",2528,584,1272,439,170,20,18,216,5247
"45015020504",1708,79,1071,469,348,0,0,0,3675
"45015020505",1556,274,821,351,11,0,10,218,3241
"45015020506",2559,575,1306,445,135,200,41,200,5461
"45015020600",4023,488,680,308,454,0,285,122,6360
"45015020707",3963,452,975,98,386,64,86,12,6036
"45015020710",3329,161,1060,216,419,73,325,29,5612
"45015020711",2512,255,501,0,9,30,78,0,3385
"45015020712",2751,352,161,22,95,22,4,0,3407
"45015020713",1823,134,162,17,110,52,96,0,2394
"45015020714",3916,226,736,635,217,0,430,88,6248
"45015020715",3389,185,544,247,392,191,164,0,5112
"45015020716",4929,685,1480,190,398,282,154,268,8386
"45015020717",3294,360,916,219,304,107,343,70,5613
"45015020718",2523,305,657,319,190,10,266,212,4482
"45015020719",4754,270,969,87,507,113,556,0,7256
"45015020720",2793,109,367,11,205,0,22,32,3539
"45015020721",2527,180,618,13,406,0,345,166,4255
"45015020722",2817,292,156,0,177,0,56,0,3498
"45015020723",1864,176,378,44,281,57,203,0,3003
"45015020724",793,62,35,0,39,0,16,0,945
"45015020725",666,71,230,2,137,79,241,55,1481
"45015020804",1165,38,634,233,643,187,306,203,3409
"45015020806",2248,300,495,191,137,84,316,0,3771
"45015020807",3389,253,1535,520,853,146,397,0,7093
"45015020808",1867,107,823,155,376,96,153,0,3577
"45015020809",1886,271,727,100,350,111,116,102,3663
"45015020810",1640,596,699,158,499,249,445,654,4940
"45015020811",1977,473,1241,364,425,308,466,157,5411
"45015020812",3891,20,513,64,695,0,109,0,5292
"45015020901",949,157,193,39,25,131,0,109,1603
"45015020903",2285,377,222,302,125,29,109,187,3636
"45015020904",2234,289,720,0,402,0,168,0,3813
"45015021000",2458,1056,568,207,239,205,587,372,5692
"45015980100",0,0,0,0,0,0,0,0,0
"45017950100",3452,278,1461,363,72,114,32,0,5772
"45017950200",2374,271,2119,988,62,65,225,125,6229
"45017950400",1863,64,812,533,53,51,35,51,3462
"45019000100",2176,204,40,208,35,36,57,8,2764
"45019000200",1342,65,0,0,0,0,0,0,1407
"45019000400",845,739,65,328,14,57,11,1,2060
"45019000500",1249,639,0,40,55,0,21,0,2004
"45019000600",548,508,40,36,129,24,23,43,1351
"45019000700",553,884,331,198,23,69,17,6,2081
"45019000900",161,96,772,347,23,24,23,5,1451
"45019001000",782,661,360,354,45,89,16,0,2307
"45019001100",418,246,733,738,56,77,25,39,2332
"45019001500",345,50,733,275,50,0,28,5,1486
"45019001600",743,65,517,40,42,0,38,0,1445
"45019001901",2748,416,297,177,48,1,16,51,3754
"45019001902",2892,406,200,673,124,13,25,52,4385
"45019002002",4301,585,391,84,83,0,63,0,5507
"45019002003",4981,445,2150,472,162,11,396,11,8628
"45019002004",1737,207,0,0,218,0,84,0,2246
"45019002005",5304,221,275,6,140,0,78,0,6024
"45019002006",3211,346,481,187,91,98,68,0,4482
"45019002007",3235,106,45,6,145,0,67,14,3618
"45019002101",7383,1635,2327,629,149,215,391,1394,14123
"45019002103",1964,375,1219,176,49,2,316,110,4211
"45019002104",1259,106,0,0,0,0,0,0,1365
"45019002105",1741,87,4,4,8,0,11,0,1855
"45019002200",1223,79,995,520,40,58,41,0,2956
"45019002300",689,78,603,46,72,12,17,12,1529
"45019002400",1325,341,1810,377,113,14,63,6,4049
"45019002502",3465,400,2768,712,91,7,18,0,7461
"45019002604",2700,181,504,328,44,0,30,0,3787
"45019002605",1764,111,951,665,269,52,31,0,3843
"45019002606",1718,15,265,14,49,0,50,0,2111
"45019002611",1976,426,523,102,53,8,53,76,3217
"45019002612",3175,572,1518,601,375,302,117,75,6735
"45019002613",3650,428,486,256,132,16,0,60,5028
"45019002614",1840,404,1047,357,43,11,194,98,3994
"45019002701",651,83,903,419,29,93,9,0,2187
"45019002702",863,289,2990,976,140,31,149,0,5438
"45019002801",3408,216,528,222,97,62,75,0,4608
"45019002802",2566,193,0,0,122,0,10,0,2891
"45019002900",1752,127,648,135,39,1,0,1,2703
"45019003000",2844,245,57,1,11,1,19,0,3178
"45019003104",1662,1035,1011,484,393,322,965,883,6755
"45019003105",1308,963,847,469,277,0,733,687,5284
"45019003106",3023,356,2389,431,271,52,310,75,6907
"45019003107",1376,44,1964,476,716,295,610,264,5745
"45019003108",990,104,1457,274,186,9,295,31,3346
"45019003109",1398,104,1231,64,144,12,90,0,3043
"45019003110",1766,1070,2043,953,378,108,308,434,7060
"45019003111",1494,229,3233,673,460,34,1098,0,7221
"45019003113",994,334,730,270,204,23,401,279,3235
"45019003114",4153,374,1637,213,1029,27,394,120,7947
"45019003115",2082,844,1648,919,249,72,150,105,6069
"45019003200",219,22,19,0,0,0,0,0,260
"45019003300",904,419,1295,1366,64,0,619,145,4812
"45019003400",1124,325,1500,1249,344,163,541,231,5477
"45019003500",1895,278,201,168,40,1,115,0,2698
"45019003600",1303,385,486,408,0,35,26,78,2721
"45019003700",283,218,994,1629,78,40,66,42,3350
"45019003800",476,40,1840,861,58,8,60,1,3344
"45019003900",1144,191,488,229,127,0,76,40,2295
"45019004000",231,53,1252,1081,25,34,0,21,2697
"45019004300",232,36,1166,1269,45,0,19,0,2767
"45019004400",121,76,1182,670,46,7,43,7,2152
"45019004606",6648,511,733,169,275,72,56,0,8464
"45019004607",4880,613,44,15,69,36,128,0,5785
"45019004608",18624,1099,716,47,651,19,561,0,21717
"45019004609",4036,635,1232,193,90,35,43,0,6264
"45019004610",2130,152,310,34,14,0,27,88,2755
"45019004611",7078,473,759,8,106,0,123,0,8547
"45019004612",5420,367,162,16,264,72,547,0,6848
"45019004613",1478,185,0,0,50,0,15,0,1728
"45019004614",5089,437,767,194,229,14,10,13,6753
"45019004701",4331,241,195,152,72,0,53,0,5044
"45019004702",1561,268,233,22,59,1,61,10,2215
"45019004800",1800,133,7,0,29,0,4,0,1973
"45019004901",1540,405,0,0,0,0,14,0,1959
"45019004902",1868,314,0,77,13,0,48,11,2331
"45019005000",1455,293,1770,1130,68,30,0,32,4778
"45019005100",1027,288,197,179,6,43,87,0,1827
"45019005200",1131,216,640,54,93,0,38,3,2175
"45019005300",684,209,1279,1853,6,9,46,3,4089
"45019005400",176,23,785,1077,6,48,6,0,2121
"45019005500",173,56,415,472,39,9,21,0,1185
"45019005600",6296,213,1873,792,390,0,387,233,10184
"45019005700",7114,297,901,48,274,0,54,11,8699
"45019005800",4100,257,903,188,343,0,129,0,5920
"45019990100",0,0,0,0,0,0,0,0,0
"45021970100",6317,1489,180,231,165,73,468,281,9204
"45021970201",1743,178,329,378,126,6,28,0,2788
"45021970202",4691,518,742,186,516,99,337,27,7116
"45021970301",1325,158,1469,693,190,50,92,0,3977
"45021970302",1275,1083,1045,390,94,67,138,202,4294
"45021970401",2417,874,183,159,11,77,0,16,3737
"45021970402",4356,1116,186,165,64,107,25,0,6019
"45021970501",1482,388,322,85,10,75,85,109,2556
"45021970502",1318,462,1931,1239,50,51,37,66,5154
"45021970503",1016,189,26,0,22,0,0,0,1253
"45021970601",3279,558,499,220,22,90,12,70,4750
"45021970602",1779,539,38,0,2,3,0,0,2361
"45021970700",2681,485,164,0,56,69,90,0,3545
"45023020100",790,158,777,641,24,0,9,16,2415
"45023020200",820,345,727,1155,44,5,0,0,3096
"45023020300",621,153,1766,776,85,15,18,28,3462
"45023020400",1507,427,558,77,28,30,103,41,2771
"45023020500",1608,366,613,114,27,0,0,0,2728
"45023020601",1311,306,551,155,42,0,0,0,2365
"45023020602",1868,477,1086,241,72,0,84,0,3828
"45023020700",1258,135,297,237,113,0,52,0,2092
"45023020800",3033,783,744,282,148,8,26,22,5046
"45023020900",1701,323,476,118,63,0,37,0,2718
"45023021000",1092,376,557,231,72,16,4,0,2348
"45025950101",3142,1141,791,208,63,147,229,315,6036
"45025950102",1651,812,996,411,73,11,200,299,4453
"45025950200",2330,420,990,255,132,41,48,0,4216
"45025950300",1264,171,281,458,87,33,58,10,2362
"45025950400",4152,560,1231,1043,38,12,37,6,7079
"45025950501",716,155,904,119,24,3,0,0,1921
"45025950502",2732,1403,1275,1059,77,98,64,0,6708
"45025950600",2407,199,2004,1273,174,13,82,0,6152
"45025950700",3291,1247,438,183,18,62,42,64,5345
"45025950800",1460,251,689,431,36,18,150,37,3072
"45027960100",2204,410,441,251,42,140,46,152,3686
"45027960201",904,100,486,135,26,0,26,0,1677
"45027960202",0,0,0,0,0,0,0,0,0
"45027960300",957,142,590,153,96,80,100,45,2163
"45027960400",759,175,865,404,45,59,14,0,2321
"45027960500",1049,128,1915,1919,191,10,89,0,5301
"45027960600",1262,179,979,337,44,27,0,0,2828
"45027960701",1777,53,1355,518,169,0,169,0,4041
"45027960702",696,163,230,272,37,82,14,82,1576
"45027960703",2092,281,938,209,19,0,43,0,3582
"45027960801",791,175,1352,1141,2,0,2,22,3485
"45027960802",1233,249,1149,411,22,0,113,0,3177
"45029970100",838,43,664,515,0,6,0,0,2066
"45029970200",967,108,412,101,29,0,71,0,1688
"45029970300",2854,310,1612,1167,116,162,63,0,6284
"45029970401",2118,530,899,233,16,15,267,0,4078
"45029970402",2299,152,589,325,40,0,111,0,3516
"45029970500",1959,293,1671,1228,0,0,15,0,5166
"45029970600",3191,981,2770,626,139,28,427,28,8190
"45029970700",3564,489,1152,298,129,19,78,26,5755
"45029970800",1161,59,916,122,6,0,0,0,2264
"45029990100",0,0,0,0,0,0,0,0,0
"45031010100",1120,246,1956,541,111,11,116,38,4139
"45031010200",4508,780,325,8,60,0,90,0,5771
"45031010300",2661,874,1306,177,48,93,122,55,5336
"45031010400",5000,533,389,45,40,0,143,8,6158
"45031010500",1767,183,394,195,30,0,5,0,2574
"45031010600",1521,244,1360,946,325,61,9,19,4485
"45031010700",93,0,1691,628,15,0,70,0,2497
"45031010800",1219,144,1074,244,76,117,127,79,3080
"45031010900",3536,713,1577,1237,47,0,33,45,7188
"45031011000",1818,213,393,661,191,0,0,0,3276
"45031011100",795,122,219,242,82,0,0,0,1460
"45031011200",1627,336,1406,737,37,102,13,103,4361
"45031011300",1785,893,2033,677,21,162,0,0,5571
"45031011400",901,48,1673,1433,80,4,46,0,4185
"45031011500",2090,269,1284,1140,29,0,0,0,4812
"45031011600",1416,413,848,613,26,45,0,34,3395
"45033970100",942,142,1185,490,90,198,11,134,3192
"45033970200",1985,699,1529,690,455,100,158,64,5680
"45033970300",2417,391,1090,796,123,15,152,23,5007
"45033970400",929,214,1808,2357,77,157,18,88,5648
"45033970500",2112,508,722,702,95,0,23,78,4240
"45033970600",3370,1039,2027,1124,235,135,19,19,7968
"45035010100",1282,20,872,218,12,0,0,0,2404
"45035010200",1919,174,1122,1218,84,3,64,0,4584
"45035010300",2875,451,1136,510,44,52,151,0,5219
"45035010400",2232,177,1507,292,378,66,140,55,4847
"45035010501",3100,279,638,405,293,81,96,62,4954
"45035010503",2255,155,183,79,44,0,33,0,2749
"45035010504",4122,283,919,188,857,140,657,211,7377
"45035010505",3758,534,479,296,611,99,264,107,6148
"45035010603",4754,510,532,0,415,119,239,107,6676
"45035010604",2666,359,540,205,126,0,68,0,3964
"45035010605",5437,548,1289,418,264,94,312,38,8400
"45035010606",1397,79,251,57,29,0,14,0,1827
"45035010700",2768,291,1512,559,70,0,120,0,5320
"45035010801",4293,160,503,270,58,0,142,0,5426
"45035010807",4258,204,468,0,72,54,205,0,5261
"45035010808",5041,281,1031,68,193,14,36,0,6664
"45035010809",2578,155,238,183,227,0,36,49,3466
"45035010813",5315,1203,2346,761,277,76,304,119,10401
"45035010814",4417,353,1622,72,267,0,137,0,6868
"45035010815",1801,183,962,313,348,16,181,0,3804
"45035010816",6914,164,2673,318,1093,0,401,24,11587
"45035010817",2757,164,571,85,238,36,259,0,4110
"45035010818",3614,819,3222,1043,592,8,836,411,10545
"45035010819",3046,102,773,8,244,6,19,6,4204
"45035010820",4056,134,1310,307,813,78,401,0,7099
"45037970201",1156,370,525,52,11,14,5,0,2133
"45037970202",2166,362,1948,755,72,14,17,206,5540
"45037970300",1792,214,1442,832,39,19,39,29,4406
"45037970400",971,291,1109,125,4,58,13,74,2645
"45037970501",2423,430,896,342,140,5,157,5,4398
"45037970502",4059,499,249,294,222,97,64,208,5692
"45039960100",219,26,1083,556,32,1,1,1,1919
"45039960200",1312,314,1656,362,164,0,0,16,3824
"45039960300",2669,250,2356,585,39,1,12,0,5912
"45039960400",1976,283,1856,1260,294,5,330,47,6051
"45039960500",1751,137,2541,1461,0,30,0,0,5920
"45041000101",1674,160,360,71,39,0,24,0,2328
"45041000102",4345,141,822,0,327,19,60,0,5714
"45041000201",1608,29,515,285,211,1,0,1,2650
"45041000202",4739,540,1259,497,394,56,360,0,7845
"45041000300",620,135,2659,590,105,0,10,0,4119
"45041000400",2082,404,1540,486,165,0,200,0,4877
"45041000500",1609,384,1187,735,113,177,113,26,4344
"45041000600",2839,231,1645,77,162,0,180,0,5134
"45041000700",39,74,1300,1443,0,0,0,0,2856
"45041000800",25,60,2815,1179,0,0,16,0,4095
"45041000900",10,220,1352,1666,26,0,0,0,3274
"45041001000",748,144,265,299,52,21,18,0,1547
"45041001100",2520,501,890,608,10,18,72,0,4619
"45041001200",3221,198,199,34,91,0,161,0,3904
"45041001300",2934,131,523,301,34,0,122,0,4045
"45041001400",5528,332,1726,247,244,43,19,0,8139
"45041001503",2062,319,917,169,58,0,85,185,3795
"45041001504",2853,227,1760,390,51,0,105,0,5386
"45041001505",2386,320,755,780,59,8,61,0,4369
"45041001506",959,81,201,242,0,0,0,0,1483
"45041001601",2436,302,3027,860,452,0,38,0,7115
"45041001602",3156,520,768,252,132,0,148,0,4976
"45041001700",1227,158,626,532,45,0,48,45,2681
"45041001800",1983,279,1137,306,284,27,366,0,4382
"45041001900",3217,738,1373,758,225,35,0,128,6474
"45041002000",1705,446,919,372,47,129,0,0,3618
"45041002201",1108,76,2000,1409,271,0,0,0,4864
"45041002202",1147,275,1704,713,12,0,0,0,3851
"45041002300",2323,439,450,116,8,0,43,13,3392
"45041002400",2260,453,894,205,83,3,108,16,4022
"45041002500",1565,286,666,558,51,0,121,180,3427
"45041002600",1015,202,1524,970,25,72,21,44,3873
"45041980100",0,0,0,0,0,0,0,0,0
"45043920100",1607,137,1069,746,50,0,28,0,3637
"45043920201",1910,822,1217,1304,103,189,80,189,5814
"45043920202",1113,516,312,592,26,0,18,4,2581
"45043920301",2219,187,1421,545,111,261,97,213,5054
"45043920302",1953,111,470,260,61,41,0,24,2920
"45043920400",514,44,1379,835,104,0,11,0,2887
"45043920501",4258,513,143,0,26,0,0,0,4940
"45043920502",3064,158,177,24,32,0,11,0,3466
"45043920503",3878,574,613,194,53,0,76,0,5388
"45043920504",4265,172,320,135,80,0,98,0,5070
"45043920505",3173,204,83,48,20,0,0,0,3528
"45043920600",1489,465,3277,949,132,8,106,0,6426
"45043920700",2583,458,1074,906,208,372,306,512,6419
"45043920800",1133,374,1304,519,0,0,32,0,3362
"45043990100",0,0,0,0,0,0,0,0,0
"45045000100",799,227,116,23,7,0,71,31,1274
"45045000200",839,73,25,8,19,0,36,0,1000
"45045000400",621,61,175,129,44,11,1,1,1043
"45045000500",110,38,735,320,17,17,0,0,1237
"45045000700",95,167,690,632,0,58,0,62,1704
"45045000800",103,115,388,677,0,0,20,23,1326
"45045000900",200,131,516,314,62,9,2,27,1261
"45045001000",1446,212,213,124,101,8,41,8,2153
"45045001101",3246,168,114,11,74,17,243,10,3883
"45045001102",1582,77,100,5,88,0,99,0,1951
"45045001203",457,85,10,0,71,9,31,0,663
"45045001204",1464,280,479,143,91,88,62,12,2619
"45045001205",770,162,151,171,41,35,143,32,1505
"45045001302",1005,144,47,134,88,29,14,12,1473
"45045001400",2826,162,292,93,32,0,0,0,3405
"45045001501",3313,197,53,68,35,26,241,33,3966
"45045001502",233,92,1441,696,28,58,0,0,2548
"45045001600",3885,395,168,48,188,9,170,180,5043
"45045001700",2726,873,254,107,99,183,600,461,5303
"45045001803",2587,461,413,113,294,55,323,84,4330
"45045001804",3180,298,480,0,94,10,133,44,4239
"45045001805",3336,191,178,89,103,0,100,51,4048
"45045001807",3527,346,523,288,514,0,80,0,5278
"45045001808",2284,246,573,615,187,102,121,86,4214
"45045001809",1977,204,421,63,135,42,122,0,2964
"45045001810",1584,300,761,503,394,10,506,115,4173
"45045001900",3805,214,502,409,104,0,9,0,5043
"45045002001",228,130,1521,999,16,23,77,83,3077
"45045002003",1282,413,1837,823,119,365,588,549,5976
"45045002005",863,186,1635,934,43,107,112,34,3914
"45045002103",1647,73,1130,142,37,23,145,28,3225
"45045002104",525,55,401,125,58,31,44,0,1239
"45045002105",442,421,772,521,49,65,102,198,2570
"45045002106",1681,467,423,359,41,45,351,217,3584
"45045002107",1514,333,736,382,47,50,428,243,3733
"45045002108",750,102,420,474,19,0,23,11,1799
"45045002201",2775,2453,494,360,335,363,1219,1146,9145
"45045002202",765,489,311,85,118,95,218,289,2370
"45045002301",2324,685,493,123,70,158,407,454,4714
"45045002302",1971,638,174,432,199,35,477,251,4177
"45045002303",472,824,381,283,95,23,86,180,2344
"45045002304",740,454,444,722,36,17,95,324,2832
"45045002402",5887,767,125,12,198,109,122,111,7331
"45045002403",3174,970,26,12,52,7,30,6,4277
"45045002404",3473,183,24,0,39,0,0,30,3749
"45045002503",6500,1364,859,108,524,85,618,446,10504
"45045002504",843,372,339,47,98,39,68,189,1995
"45045002505",2112,685,336,229,131,87,544,205,4329
"45045002506",2813,523,125,144,76,32,6,66,3785
"45045002507",3700,454,458,119,107,80,284,122,5324
"45045002602",2862,356,154,36,248,0,187,147,3990
"45045002604",3243,765,728,286,84,37,181,159,5483
"45045002606",5033,332,153,1,85,13,121,0,5738
"45045002608",7938,190,422,12,682,123,561,36,9964
"45045002609",5239,325,435,0,363,14,154,101,6631
"45045002610",1759,226,686,90,193,11,135,30,3130
"45045002611",3561,402,1015,99,242,0,291,145,5755
"45045002701",3982,166,16,43,35,0,208,0,4450
"45045002702",5424,1738,460,165,327,0,57,91,8262
"45045002803",6091,370,359,71,781,24,481,170,8347
"45045002804",2261,12,23,0,66,0,288,0,2650
"45045002805",3629,260,329,48,110,44,406,0,4826
"45045002808",4506,295,410,315,622,147,275,143,6713
"45045002811",5421,257,891,0,655,210,348,155,7937
"45045002812",6147,221,559,0,428,43,286,14,7698
"45045002813",3715,28,120,35,500,11,269,0,4678
"45045002814",4668,236,423,23,416,0,153,0,5919
"45045002815",5016,50,442,0,377,0,108,0,5993
"45045002816",7402,32,897,18,463,117,243,106,9278
"45045002901",2017,406,1509,281,412,129,156,204,5114
"45045002903",3990,516,1095,322,411,116,490,0,6940
"45045002904",3175,17,1864,55,105,65,296,20,5597
"45045002905",3132,51,1096,19,244,0,402,13,4957
"45045003005",1453,435,319,44,80,0,67,45,2443
"45045003008",5770,105,512,0,571,0,347,0,7305
"45045003009",4563,269,354,26,101,0,440,74,5827
"45045003010",4363,423,657,82,247,273,228,446,6719
"45045003011",3945,164,605,256,161,11,841,0,5983
"45045003012",3812,278,1028,21,125,22,627,0,5913
"45045003013",3889,367,1696,4,264,18,295,54,6587
"45045003014",3339,175,635,101,113,9,198,9,4579
"45045003015",6900,217,867,39,116,0,560,48,8747
"45045003101",4132,474,1292,601,60,36,128,0,6723
"45045003103",2618,292,24,78,85,34,325,176,3632
"45045003104",1789,241,53,0,24,0,46,0,2153
"45045003201",3047,310,194,169,213,100,127,0,4160
"45045003202",2811,425,150,54,79,25,21,0,3565
"45045003301",3426,573,648,592,88,0,115,0,5442
"45045003303",2962,515,1078,111,134,53,182,48,5083
"45045003304",3322,790,1578,215,257,29,877,29,7097
"45045003401",240,214,430,132,5,0,40,14,1075
"45045003500",994,410,707,226,45,0,27,144,2553
"45045003601",2747,1006,1129,464,188,149,536,463,6682
"45045003602",633,530,761,688,42,19,288,405,3366
"45045003701",3599,748,378,163,265,43,523,114,5833
"45045003704",1438,1209,381,356,92,130,385,803,4794
"45045003705",912,248,216,81,56,65,135,143,1856
"45045003706",1204,708,291,350,529,171,490,246,3989
"45045003707",2285,515,439,275,19,123,355,454,4465
"45045003801",3843,684,180,0,107,22,317,387,5540
"45045003802",3303,427,345,426,203,9,250,35,4998
"45045003902",2598,318,106,36,112,44,113,0,3327
"45045003903",3342,441,184,4,62,0,40,12,4085
"45045003904",4244,909,531,445,293,0,54,203,6679
"45045004001",2786,138,41,66,0,8,18,0,3057
"45045004002",3117,441,0,0,51,26,20,26,3681
"45045004101",2425,712,97,11,96,71,433,50,3895
"45045004102",1131,68,5,0,27,0,61,0,1292
"45045004200",1839,341,288,53,58,12,7,0,2598
"45045004300",343,20,1587,1276,220,8,182,8,3644
"45045004400",923,160,782,172,61,95,191,34,2418
"45047970101",2249,257,903,231,104,0,78,0,3822
"45047970102",2346,760,478,451,68,196,0,191,4490
"45047970201",2362,387,501,89,19,0,88,0,3446
"45047970202",5843,294,1735,470,318,25,151,0,8836
"45047970301",2510,285,489,49,93,0,113,174,3713
"45047970302",4129,372,529,174,434,0,23,152,5813
"45047970400",3919,1055,953,329,89,15,130,0,6490
"45047970500",397,692,1218,1597,584,217,488,725,5918
"45047970600",3378,338,1837,758,222,107,210,60,6910
"45047970701",1641,108,425,3,0,0,0,35,2212
"45047970702",2960,240,992,974,101,88,104,0,5459
"45047970800",2647,888,2041,2511,205,168,214,476,9150
"45047970900",1005,448,327,62,109,282,3,347,2583
"45047971000",1156,562,177,17,10,0,0,0,1922
"45049920100",1370,450,416,164,72,60,23,0,2555
"45049920200",2621,287,2985,1401,0,0,27,0,7321
"45049920300",518,265,807,402,26,9,9,8,2044
"45049920400",2462,164,1797,971,312,43,331,43,6123
"45049920500",296,38,762,616,11,1,0,0,1724
"45051010100",1562,636,220,262,0,0,8,25,2713
"45051020100",1927,479,247,611,41,13,69,38,3425
"45051020200",2478,332,1320,858,57,13,139,6,5203
"45051020300",4781,723,603,717,292,54,168,14,7352
"45051030101",109,201,497,258,98,0,5,0,1168
"45051030102",1967,409,312,98,173,35,103,210,3307
"45051030103",1921,196,571,559,44,0,0,0,3291
"45051040101",3135,448,713,192,96,27,121,0,4732
"45051040102",3160,376,722,384,96,134,65,0,4937
"45051040103",3868,493,659,103,101,0,142,52,5418
"45051040104",2060,628,67,0,34,123,24,0,2936
"45051040105",2096,155,12,0,213,0,294,0,2770
"45051040200",2875,206,326,0,0,16,53,18,3494
"45051040300",3191,445,69,0,159,42,102,232,4240
"45051040400",3528,332,118,7,86,13,247,99,4430
"45051040500",2608,401,140,40,227,79,74,95,3664
"45051050102",2949,210,82,0,65,63,18,0,3387
"45051050200",1294,74,14,0,36,0,8,0,1426
"45051050303",2137,105,16,0,38,0,10,0,2306
"45051050401",1817,289,74,15,130,0,197,145,2667
"45051050402",1632,202,0,7,0,0,18,0,1859
"45051050500",3581,408,0,116,63,205,219,199,4791
"45051050600",987,572,1077,1102,385,341,618,389,5471
"45051050700",608,722,122,101,99,64,240,201,2157
"45051050900",2911,1523,467,385,786,561,862,662,8157
"45051051000",2286,162,40,0,199,19,29,19,2754
"45051051201",1392,139,0,0,17,0,0,20,1568
"45051051202",1881,204,31,0,109,70,112,56,2463
"45051051301",900,50,10,0,7,0,0,0,967
"45051051302",2780,295,0,0,0,0,45,0,3120
"45051051403",3922,249,227,20,138,0,130,0,4686
"45051051404",2825,404,0,9,148,26,55,35,3502
"45051051405",2552,641,0,0,45,71,0,53,3362
"45051051406",2441,344,33,21,100,0,14,0,2953
"45051051501",2288,353,170,25,595,23,494,15,3963
"45051051502",6012,1022,203,185,310,36,369,33,8170
"45051051503",1772,680,262,57,672,131,849,493,4916
"45051051601",5742,890,796,90,671,453,648,203,9493
"45051051603",3056,465,63,147,107,60,50,0,3948
"45051051604",6915,600,85,0,40,54,45,0,7739
"45051051605",4366,317,188,88,213,138,176,0,5486
"45051051700",1506,238,79,209,60,78,77,0,2247
"45051060101",1429,1142,218,381,79,109,8,32,3398
"45051060102",1659,572,112,342,130,239,103,250,3407
"45051060203",3821,544,238,149,645,0,735,7,6139
"45051060204",5561,1095,284,340,377,119,291,354,8421
"45051060206",5323,503,209,27,85,128,275,56,6606
"45051060207",3920,321,90,25,95,79,136,20,4686
"45051060208",1810,340,83,36,123,0,0,23,2415
"45051060209",4244,727,326,131,407,143,240,178,6396
"45051060301",2737,280,413,234,38,0,39,2,3743
"45051060303",1633,125,117,0,35,0,30,0,1940
"45051060308",3141,305,1173,249,484,0,306,0,5658
"45051060403",1853,281,125,0,158,173,505,173,3268
"45051060404",1054,290,15,93,39,0,28,0,1519
"45051060405",3029,904,398,441,170,45,419,47,5453
"45051060406",4845,694,104,1,283,163,117,40,6247
"45051070101",2953,771,322,30,175,147,182,147,4727
"45051070102",2481,299,572,28,8,0,0,2,3390
"45051070200",2181,238,130,470,57,74,40,97,3287
"45051070300",1333,362,690,831,151,68,22,88,3545
"45051070400",1098,337,1848,1490,121,110,165,43,5212
"45051070500",1535,176,1219,472,49,0,12,0,3463
"45051070601",3265,610,405,150,45,302,193,168,5138
"45051070602",2212,553,1469,247,101,39,58,39,4718
"45051070701",3387,295,534,116,57,66,7,0,4462
"45051070702",2571,869,853,498,124,88,299,72,5374
"45051080101",2364,546,244,88,50,127,69,0,3488
"45051080102",1669,438,197,86,57,0,2,0,2449
"45051080200",3400,701,66,111,120,3,130,0,4531
"45051980100",30,12,0,0,0,0,0,0,42
"45051990100",0,0,0,0,0,0,0,0,0
"45053950100",2437,266,1928,673,225,116,267,116,6028
"45053950201",1724,414,1001,375,191,156,129,198,4188
"45053950202",2124,560,2348,1387,936,141,978,158,8632
"45053950300",2556,1065,2779,554,457,99,1191,609,9310
"45053990100",0,0,0,0,0,0,0,0,0
"45055970100",1355,316,569,252,42,4,98,10,2646
"45055970200",1978,466,399,365,28,0,26,26,3288
"45055970300",1295,177,510,228,105,0,0,0,2315
"45055970401",2955,806,341,78,200,11,134,103,4628
"45055970402",1487,190,345,291,0,20,192,14,2539
"45055970403",1876,0,309,84,36,6,148,6,2465
"45055970500",3204,231,1143,398,316,62,302,100,5756
"45055970601",3447,381,910,335,116,51,77,56,5373
"45055970602",2703,572,867,425,87,0,70,0,4724
"45055970700",1643,229,793,161,31,0,7,64,2928
"45055970800",2936,460,1632,1393,191,0,140,30,6782
"45055970902",1719,368,472,60,354,8,123,0,3104
"45055970903",4508,806,642,46,14,45,191,29,6281
"45055970904",5027,373,1486,475,464,17,416,17,8275
"45055970905",2273,40,380,4,11,0,0,0,2708
"45057010100",2961,735,129,59,52,0,71,0,4007
"45057010200",4354,1019,607,794,121,32,31,31,6989
"45057010300",2908,1013,1083,432,38,14,71,14,5573
"45057010400",1469,99,725,409,134,10,95,0,2941
"45057010500",2137,1275,967,1489,191,0,376,273,6708
"45057010600",3049,693,456,752,130,154,271,284,5789
"45057010700",616,59,1648,1508,28,7,28,6,3900
"45057010800",1039,471,644,629,0,52,138,67,3040
"45057010900",2233,476,628,139,139,53,39,113,3820
"45057011001",3937,284,709,70,35,14,7,0,5056
"45057011002",3111,489,422,274,15,10,0,0,4321
"45057011100",3216,652,1481,375,27,36,57,29,5873
"45057011201",7682,680,403,0,578,57,791,0,10191
"45057011202",9560,502,533,198,131,0,703,36,11663
"45059920101",4038,715,764,275,152,631,21,537,7133
"45059920102",1448,211,84,0,71,0,57,0,1871
"45059920103",3018,571,596,115,244,81,171,86,4882
"45059920104",2277,407,447,0,82,0,80,11,3304
"45059920201",2510,325,405,49,14,0,58,0,3361
"45059920202",3349,533,0,0,12,18,0,0,3912
"45059920301",2353,495,631,211,70,151,16,214,4141
"45059920302",1675,534,1292,396,71,10,68,0,4046
"45059920400",2990,264,1099,761,0,8,231,0,5353
"45059920501",1102,107,427,23,0,0,9,0,1668
"45059920502",2677,864,1484,349,243,213,353,320,6503
"45059920600",2121,455,834,662,88,35,62,30,4287
"45059920700",1416,487,1638,840,19,18,24,51,4493
"45059920800",2702,333,188,662,38,44,66,169,4202
"45059920900",1239,473,333,15,166,27,45,20,2318
"45059921001",1381,318,736,167,32,0,2,7,2643
"45059921002",1850,355,447,40,85,1,19,8,2805
"45061920100",826,243,472,172,29,24,0,0,1766
"45061920200",1700,315,938,1212,44,111,0,48,4368
"45061920301",0,0,0,0,0,0,0,0,0
"45061920302",535,38,1841,924,209,48,43,0,3638
"45061920400",1103,375,2067,611,214,21,267,0,4658
"45061920500",359,17,878,372,17,0,0,0,1643
"45061920600",272,5,885,321,0,0,0,0,1483
"45063020100",1444,449,330,162,78,0,54,0,2517
"45063020201",1663,720,197,177,70,39,37,198,3101
"45063020202",1303,122,628,111,23,0,38,0,2225
"45063020300",2589,863,417,285,281,10,765,10,5220
"45063020505",2288,769,607,104,19,56,829,318,4990
"45063020506",2648,364,284,164,69,32,187,157,3905
"45063020507",4687,454,910,105,335,0,315,0,6806
"45063020508",2069,95,23,0,70,0,4,0,2261
"45063020509",1931,84,476,390,155,155,139,76,3406
"45063020510",2567,79,1282,457,457,72,359,43,5316
"45063020511",1392,155,1259,113,341,28,80,0,3368
"45063020601",2643,282,476,393,233,44,290,17,4378
"45063020602",2971,401,493,49,37,22,153,208,4334
"45063020604",2518,388,367,91,55,0,156,170,3745
"45063020605",1429,71,163,13,81,18,113,0,1888
"45063020703",2990,679,148,100,148,0,85,0,4150
"45063020705",1904,530,1053,143,164,13,205,0,4012
"45063020706",1275,174,1322,290,67,0,639,0,3767
"45063020707",2459,116,484,353,385,0,282,0,4079
"45063020708",2098,440,44,26,16,79,0,0,2703
"45063020801",1292,27,155,38,0,0,19,0,1531
"45063020802",1605,288,409,121,140,0,48,0,2611
"45063020803",1790,298,1110,57,57,105,220,6,3643
"45063020804",1418,633,383,306,9,13,249,27,3038
"45063020805",3174,1101,580,173,65,389,144,353,5979
"45063020903",3399,1131,88,51,91,19,121,498,5398
"45063020904",2249,409,365,0,130,11,517,165,3846
"45063020905",2305,676,415,187,38,0,9,173,3803
"45063020906",3398,396,17,11,68,24,50,0,3964
"45063020907",4225,339,855,291,327,0,268,28,6333
"45063020908",2144,347,212,54,240,0,208,0,3205
"45063021009",6165,1100,904,66,174,208,116,249,8982
"45063021014",4055,418,325,0,519,130,296,121,5864
"45063021017",6471,463,452,287,144,14,304,14,8149
"45063021018",3573,983,118,103,37,0,123,72,5009
"45063021019",1253,125,83,0,0,104,111,0,1676
"45063021020",2659,276,463,1,115,65,116,76,3771
"45063021021",1412,45,0,2,71,0,112,0,1642
"45063021022",3309,37,224,7,54,140,51,0,3822
"45063021023",2355,32,213,1,19,0,148,0,2768
"45063021024",3628,50,63,1,117,141,118,144,4262
"45063021025",3142,118,15,0,19,0,0,0,3294
"45063021026",4229,39,86,0,18,0,129,0,4501
"45063021027",3161,56,44,0,465,42,51,0,3819
"45063021028",2378,177,394,258,257,18,106,14,3602
"45063021029",1986,68,285,82,299,48,93,0,2861
"45063021030",3345,485,289,1,370,0,92,0,4582
"45063021031",3259,287,173,257,0,0,292,0,4268
"45063021032",3179,308,36,13,74,8,5,0,3623
"45063021033",3186,213,706,18,358,0,41,82,4604
"45063021034",3397,121,759,19,140,66,212,67,4781
"45063021106",2383,223,350,0,11,0,13,16,2996
"45063021109",2179,130,296,550,138,84,54,0,3431
"45063021110",2340,234,474,12,136,0,70,25,3291
"45063021111",1367,144,650,87,185,0,20,23,2476
"45063021112",2521,219,302,23,159,0,73,0,3297
"45063021113",1792,128,946,159,76,23,0,0,3124
"45063021114",3004,36,324,187,214,0,168,0,3933
"45063021115",1816,141,146,0,13,0,35,0,2151
"45063021116",2319,20,234,344,225,109,73,14,3338
"45063021203",4643,111,89,0,150,55,64,55,5167
"45063021204",2939,87,182,49,118,0,122,0,3497
"45063021205",2700,208,0,2,4,143,42,0,3099
"45063021206",2413,71,115,221,63,13,94,0,2990
"45063021303",2692,166,0,1,0,0,11,0,2870
"45063021304",3645,207,74,14,211,12,182,0,4345
"45063021305",2070,313,34,186,137,11,128,99,2978
"45063021306",3197,235,139,10,225,55,301,64,4226
"45063021307",1450,105,159,28,27,20,0,53,1842
"45063021308",2785,564,917,135,78,0,75,14,4568
"45063021402",1418,288,909,1048,141,70,49,0,3923
"45063021403",1251,626,111,295,45,112,149,274,2863
"45063021404",2044,76,264,145,96,0,55,0,2680
"45063980100",0,0,0,0,0,0,0,0,0
"45065920100",1480,58,557,259,116,0,16,0,2486
"45065920200",1689,192,1762,663,1,0,26,1,4334
"45065920300",1029,169,588,168,30,1,10,0,1995
"45067950100",1593,228,1734,1234,4,0,3,0,4796
"45067950200",2446,204,2663,1112,352,0,0,16,6793
"45067950300",559,117,1080,951,0,51,0,51,2809
"45067950400",1785,379,1070,707,108,56,41,0,4146
"45067950500",2125,239,1776,252,0,0,0,0,4392
"45067950600",1379,199,1816,2138,234,60,239,0,6065
"45067950700",655,152,593,117,0,0,91,83,1691
"45067950800",960,236,518,428,75,9,207,91,2524
"45069960100",1237,523,864,363,116,53,21,0,3177
"45069960200",874,433,2314,1568,74,91,23,0,5377
"45069960301",1842,310,1937,939,99,21,14,21,5183
"45069960302",859,114,624,411,59,34,2,0,2103
"45069960400",1942,846,793,757,638,326,155,71,5528
"45069960500",517,114,605,379,168,44,0,2,1829
"45069960600",1053,331,649,66,206,11,0,21,2337
"45071950100",2609,124,655,96,169,25,0,25,3703
"45071950201",1021,142,708,109,657,138,616,229,3620
"45071950202",3652,433,868,645,391,360,397,351,7097
"45071950300",2114,316,477,218,106,29,75,0,3335
"45071950502",1469,157,1757,1302,340,437,253,276,5991
"45071950601",2859,302,941,475,14,8,14,27,4640
"45071950602",4509,341,744,198,14,0,0,63,5869
"45071950700",2272,135,1220,250,471,11,334,0,4693
"45073030100",3425,442,0,0,43,63,20,3,3996
"45073030200",5112,670,0,23,10,0,10,45,5870
"45073030300",5843,1014,29,0,46,44,208,261,7445
"45073030401",3978,1358,440,56,490,260,691,573,7846
"45073030402",1332,225,7,0,9,17,40,39,1669
"45073030500",3753,507,78,8,201,13,114,64,4738
"45073030601",2998,977,207,22,138,0,118,81,4541
"45073030602",2802,1070,316,126,71,0,8,28,4421
"45073030701",1762,504,746,219,127,0,137,82,3577
"45073030702",3393,1182,775,258,349,0,73,61,6091
"45073030800",4154,689,1198,414,171,174,267,132,7199
"45073030901",2246,554,0,0,59,0,71,0,2930
"45073030902",6399,1355,39,12,124,156,65,11,8161
"45073031000",3641,653,203,150,136,8,117,0,4908
"45073031100",2649,820,65,12,40,12,22,32,3652
"45075010100",1352,574,1859,1190,3,3,10,3,4994
"45075010200",908,383,2039,1149,147,345,105,313,5389
"45075010300",1477,161,3042,1187,453,31,144,1,6496
"45075010400",1341,168,1451,649,189,24,80,4,3906
"45075010500",1378,35,1932,461,151,0,139,0,4096
"45075010600",907,79,2250,1279,71,31,51,31,4699
"45075010700",945,50,1390,370,6,1,9,18,2789
"45075010800",541,66,2499,1205,44,0,58,0,4413
"45075010900",3336,148,3915,769,287,0,113,0,8568
"45075011000",1373,29,2977,824,136,36,37,0,5412
"45075011100",187,0,1815,1202,112,0,0,0,3316
"45075011200",3,0,376,154,0,0,0,0,533
"45075011300",93,195,1164,1455,61,0,110,35,3113
"45075011400",669,155,1958,923,56,32,24,0,3817
"45075011500",1096,377,1592,928,0,0,0,173,4166
"45075011600",2623,529,2255,636,0,122,128,0,6293
"45075011700",2991,482,1134,344,38,104,0,89,5182
"45075011800",1838,182,2488,653,40,3,0,0,5204
"45075011900",2453,313,987,112,93,13,27,0,3998
"45075012000",1602,194,1201,603,99,34,13,0,3746
"45077010100",2454,249,36,40,116,16,11,0,2922
"45077010200",3010,950,70,0,81,47,57,41,4256
"45077010300",4749,322,67,43,175,6,86,0,5448
"45077010401",1318,517,0,0,21,29,35,30,1950
"45077010402",3967,712,103,42,1,25,1,25,4876
"45077010403",1688,144,27,0,29,0,0,6,1894
"45077010501",2409,360,22,0,70,10,70,10,2951
"45077010502",2621,264,132,131,0,0,0,0,3148
"45077010601",2865,518,35,0,53,0,175,0,3646
"45077010602",6075,433,20,44,82,48,0,17,6719
"45077010700",3290,802,37,30,300,52,129,0,4640
"45077010801",3373,486,553,168,122,108,122,24,4956
"45077010802",2467,353,214,48,80,0,64,90,3316
"45077010803",2709,701,534,54,371,332,258,396,5355
"45077010804",2486,413,177,56,191,7,270,0,3600
"45077010901",4063,523,261,90,100,0,153,0,5190
"45077010902",5598,148,537,59,203,0,125,0,6670
"45077010903",4128,736,295,31,160,27,179,21,5577
"45077011001",2202,816,103,10,35,56,142,0,3364
"45077011002",4629,1054,466,90,181,0,130,182,6732
"45077011003",1828,504,24,0,25,28,42,0,2451
"45077011101",1853,226,129,11,103,111,28,93,2554
"45077011102",3085,2568,509,323,513,126,158,89,7371
"45077011103",902,275,13,0,0,0,0,4,1194
"45077011202",88,127,4,29,0,0,0,0,248
"45077011203",4557,739,437,177,253,24,94,69,6350
"45077011204",1716,1599,216,92,354,318,38,84,4417
"45077011205",1201,1245,178,68,251,243,126,11,3323
"45079000100",178,53,983,573,4,31,29,33,1884
"45079000200",172,41,1062,552,42,0,0,0,1869
"45079000300",190,64,2225,948,46,8,23,0,3504
"45079000400",680,45,865,276,83,8,165,7,2129
"45079000500",41,37,1154,962,72,98,65,98,2527
"45079000600",1439,151,264,585,156,0,18,0,2613
"45079000700",1153,90,344,60,91,0,0,0,1738
"45079000900",49,49,1126,1019,7,3,0,3,2256
"45079001000",5,0,1015,810,5,6,5,6,1852
"45079001100",1657,306,1351,472,10,24,34,25,3879
"45079001200",1488,192,127,5,0,0,9,0,1821
"45079001300",137,63,699,1293,10,0,0,5,2207
"45079001600",740,213,140,130,66,0,33,24,1346
"45079002100",1667,638,239,66,20,22,18,8,2678
"45079002200",1021,243,196,66,5,26,52,25,1634
"45079002300",1971,164,88,0,17,4,0,0,2244
"45079002400",3656,132,117,9,420,46,248,33,4661
"45079002500",2703,331,100,18,264,15,43,15,3489
"45079002602",1679,487,513,138,56,60,66,0,2999
"45079002603",1727,468,521,1282,353,549,297,468,5665
"45079002604",525,122,609,320,104,60,73,25,1838
"45079002700",2376,619,132,52,208,68,66,27,3548
"45079002800",1201,1847,488,214,225,114,237,152,4478
"45079002900",347,184,63,19,81,33,0,0,727
"45079003000",1170,550,68,46,126,242,107,44,2353
"45079003100",286,98,146,189,82,42,0,12,855
"45079010102",2978,112,2443,541,149,12,115,0,6350
"45079010103",6636,112,7205,607,1420,0,728,0,16708
"45079010104",1925,125,1697,93,23,11,20,52,3946
"45079010200",2614,132,1891,351,47,0,87,0,5122
"45079010304",2288,297,2597,459,305,223,279,14,6462
"45079010305",3649,1117,1740,222,313,56,264,492,7853
"45079010306",7003,244,279,0,527,0,289,19,8361
"45079010307",7210,95,1009,0,304,0,226,0,8844
"45079010308",3599,110,1038,183,505,0,178,0,5613
"45079010309",5573,382,3165,59,105,0,98,0,9382
"45079010403",1339,122,1448,713,141,20,28,0,3811
"45079010407",640,44,3192,943,60,0,70,0,4949
"45079010408",4,18,0,37,0,0,0,0,59
"45079010409",300,24,796,433,74,0,80,0,1707
"45079010410",515,60,1754,449,319,274,31,82,3484
"45079010411",330,154,1057,1567,104,85,7,24,3328
"45079010412",1147,126,1450,761,107,116,120,54,3881
"45079010413",535,106,959,311,52,26,13,0,2002
"45079010501",576,152,461,284,144,130,35,0,1782
"45079010502",0,0,369,203,0,18,0,0,590
"45079010600",229,161,2901,1293,36,16,39,105,4780
"45079010701",67,3,2221,782,0,29,0,0,3102
"45079010702",73,34,2509,878,9,41,10,27,3581
"45079010703",129,5,2641,529,16,123,138,123,3704
"45079010803",254,99,1160,544,152,9,65,7,2290
"45079010804",264,57,1599,325,38,0,15,0,2298
"45079010805",243,13,966,405,90,13,84,13,1827
"45079010806",37,33,7,43,0,0,0,0,120
"45079010900",14,13,881,1607,150,7,0,13,2685
"45079011000",121,5,1089,569,20,0,16,0,1820
"45079011101",2467,140,795,185,90,0,100,0,3777
"45079011102",2588,53,390,105,265,64,168,64,3697
"45079011201",1723,100,79,17,33,8,28,21,2009
"45079011202",2657,210,307,158,63,116,32,116,3659
"45079011301",3879,70,992,769,308,15,73,0,6106
"45079011303",951,67,2989,450,564,116,279,106,5522
"45079011304",1698,294,2412,162,824,158,936,266,6750
"45079011305",1584,59,2021,826,346,351,594,399,6180
"45079011404",1867,237,4449,1095,619,28,197,141,8633
"45079011407",1994,127,819,283,258,17,97,94,3689
"45079011411",2082,107,923,33,335,9,59,34,3582
"45079011412",2119,124,1423,236,468,539,292,565,5766
"45079011413",4562,333,2803,119,820,36,181,0,8854
"45079011414",2670,235,1575,460,585,59,459,0,6043
"45079011415",4462,183,4678,358,799,0,237,13,10730
"45079011416",5560,558,3548,323,1166,130,815,18,12118
"45079011417",2561,81,5198,459,572,11,412,0,9294
"45079011418",2294,56,1191,79,267,94,39,91,4111
"45079011419",1681,60,2084,158,354,4,220,16,4577
"45079011501",45,0,26,0,0,0,11,0,82
"45079011502",867,45,752,0,349,0,419,0,2432
"45079011603",3457,369,928,79,292,0,78,142,5345
"45079011604",4535,207,311,100,242,0,155,0,5550
"45079011606",1872,55,2310,247,234,12,69,22,4821
"45079011607",1093,74,2086,332,153,46,421,44,4249
"45079011608",2526,476,2222,1106,456,86,369,88,7329
"45079011701",954,2900,676,570,30,195,20,68,5413
"45079011702",76,0,2091,711,0,0,9,0,2887
"45079011800",544,366,4104,1400,251,0,145,0,6810
"45079011901",1270,81,5554,706,351,218,281,33,8494
"45079011902",2789,136,1610,361,95,26,86,0,5103
"45079012000",1394,133,2660,634,304,43,216,57,5441
"45079980100",13,0,36,0,5,0,5,0,59
"45081960100",1571,324,308,18,153,424,276,424,3498
"45081960201",2298,431,1388,522,501,311,703,408,6562
"45081960202",1429,254,763,786,180,7,631,224,4274
"45081960300",3819,381,395,108,57,0,14,34,4808
"45081960400",1785,326,672,283,127,51,113,51,3408
"45083020301",55,155,457,571,4,30,8,0,1280
"45083020400",234,40,330,356,0,9,152,0,1121
"45083020500",52,31,789,498,0,71,30,0,1471
"45083020601",894,86,1284,180,244,22,148,0,2858
"45083020602",913,48,605,198,136,61,44,17,2022
"45083020603",1291,18,625,317,53,44,104,0,2452
"45083020701",322,282,1600,796,15,289,0,90,3394
"45083020702",639,74,426,462,99,27,0,0,1727
"45083020800",10,27,521,948,0,54,0,19,1579
"45083020900",457,61,675,171,13,0,5,0,1382
"45083021001",200,120,1423,712,23,5,13,0,2496
"45083021100",1394,168,1266,561,87,5,32,40,3553
"45083021200",2224,304,149,114,63,8,51,68,2981
"45083021301",1134,194,659,133,175,3,230,30,2558
"45083021302",2227,201,96,7,10,1,10,0,2552
"45083021303",4357,289,579,291,0,79,15,0,5610
"45083021401",1178,145,159,6,38,8,24,0,1558
"45083021402",2826,270,280,5,149,0,61,0,3591
"45083021403",1739,500,664,424,465,155,660,63,4670
"45083021500",1450,609,601,359,42,13,24,0,3098
"45083021600",867,119,676,398,56,12,32,30,2190
"45083021700",1146,432,1313,942,20,109,281,90,4333
"45083021802",1313,1795,684,180,337,426,456,1152,6343
"45083021803",4062,448,973,51,586,106,139,69,6434
"45083021804",742,723,650,38,299,230,428,459,3569
"45083021901",3323,1228,252,20,580,149,1012,829,7393
"45083021902",4637,316,798,2,510,37,71,109,6480
"45083022003",2011,563,534,322,100,43,55,0,3628
"45083022004",1141,122,666,421,374,148,0,11,2883
"45083022005",3500,288,884,292,634,0,692,0,6290
"45083022006",1199,106,1849,959,81,14,301,0,4509
"45083022007",1778,176,827,29,258,22,407,0,3497
"45083022101",2386,124,829,182,144,10,21,0,3696
"45083022102",1926,268,54,32,13,0,27,10,2330
"45083022201",3649,391,392,88,28,0,166,0,4714
"45083022202",2699,473,252,256,27,21,50,7,3785
"45083022302",3761,1002,179,92,193,0,262,0,5489
"45083022303",936,546,171,126,141,7,146,215,2288
"45083022304",2581,1430,243,31,57,20,137,197,4696
"45083022401",4206,413,340,673,269,24,54,159,6138
"45083022403",6300,612,728,188,282,21,222,0,8353
"45083022404",4067,563,495,0,97,0,31,0,5253
"45083022405",3469,209,25,13,207,5,191,0,4119
"45083022406",4932,278,194,374,449,0,288,0,6515
"45083022500",3283,561,51,1,98,17,1,13,4025
"45083022600",2377,434,141,124,114,5,161,5,3361
"45083022700",5432,1010,248,36,260,0,333,48,7367
"45083022801",4412,188,667,0,356,203,190,0,6016
"45083022802",4699,739,640,301,430,65,80,76,7030
"45083022900",3785,1308,836,288,374,98,97,344,7130
"45083023001",5408,775,313,33,752,0,574,66,7921
"45083023002",1970,225,202,131,205,352,34,115,3234
"45083023101",2626,590,1316,269,569,337,297,296,6300
"45083023102",3360,744,1110,279,114,37,106,151,5901
"45083023201",3358,197,316,0,45,18,50,0,3984
"45083023202",2522,787,405,111,57,24,21,224,4151
"45083023301",1465,64,127,0,85,0,17,0,1758
"45083023302",1919,563,1186,752,509,243,1039,658,6869
"45083023401",1327,198,501,91,83,20,13,0,2233
"45083023402",3596,124,278,0,188,0,89,0,4275
"45083023403",4520,166,939,175,521,375,157,63,6916
"45083023404",4324,722,762,0,99,0,51,0,5958
"45083023405",3826,233,247,8,217,0,83,21,4635
"45083023500",3634,451,186,25,66,151,73,0,4586
"45083023600",3536,848,785,480,194,119,147,0,6109
"45083023700",3217,556,156,178,119,50,94,8,4378
"45083023801",3955,401,666,0,140,0,179,0,5341
"45083023802",3844,315,47,0,26,10,14,28,4284
"45083023900",3267,703,782,210,58,142,45,127,5334
"45085000100",316,40,1401,326,58,36,31,36,2244
"45085000201",2003,126,1479,248,84,19,65,0,4024
"45085000202",2399,164,2347,761,334,27,137,31,6200
"45085000300",1677,165,669,139,169,43,0,13,2875
"45085000400",3943,258,3095,874,358,69,649,0,9246
"45085000500",580,111,925,510,0,26,0,81,2233
"45085000600",1714,286,1213,340,89,86,0,62,3790
"45085000700",1373,278,1946,786,6,0,110,103,4602
"45085000800",219,152,1707,1134,57,49,42,71,3431
"45085000901",1356,179,1215,213,417,130,53,0,3563
"45085000902",3981,95,436,0,170,0,67,21,4770
"45085001100",909,222,1981,1364,483,85,534,96,5674
"45085001300",435,94,1035,722,8,97,22,0,2413
"45085001500",0,0,997,788,31,116,0,70,2002
"45085001600",147,16,2293,1202,126,67,59,0,3910
"45085001701",4916,558,1195,69,126,0,55,0,6919
"45085001703",3159,238,1435,25,289,33,282,0,5461
"45085001704",2388,39,2337,655,286,105,116,100,6026
"45085001801",2326,296,1082,477,134,0,20,0,4335
"45085001802",3209,689,2595,887,226,114,149,44,7913
"45085001901",4189,467,1076,132,275,62,13,62,6276
"45085001902",3135,424,2012,218,18,0,0,167,5974
"45085002000",2093,207,1252,571,91,32,187,14,4447
"45087030100",1242,132,451,314,8,4,24,0,2175
"45087030200",885,229,805,436,2,64,0,28,2449
"45087030300",2705,263,1012,341,157,48,59,48,4633
"45087030400",3180,584,923,651,52,127,0,0,5517
"45087030500",1439,271,462,33,68,5,0,19,2297
"45087030600",507,51,1143,257,2,1,0,0,1961
"45087030700",2375,352,488,157,33,25,32,0,3462
"45087030800",1799,665,427,256,18,121,17,52,3355
"45087030900",1960,197,301,59,82,14,15,0,2628
"45089970100",912,184,604,108,0,6,0,0,1814
"45089970200",348,16,876,395,0,0,54,0,1689
"45089970300",1974,288,1367,1269,69,0,69,0,5036
"45089970400",954,113,1022,619,0,35,0,0,2743
"45089970501",689,144,1573,1245,77,0,92,6,3826
"45089970502",283,20,2479,1311,0,0,0,0,4093
"45089970600",2060,261,1790,1039,76,14,20,48,5308
"45089970700",323,158,1278,879,0,11,0,4,2653
"45089970801",119,31,1355,1046,0,0,0,0,2551
"45089970802",0,0,0,0,0,0,0,0,0
"45089970900",1146,224,698,437,35,0,35,12,2587
"45091060102",1817,434,262,35,22,3,35,10,2618
"45091060200",1745,508,851,381,278,103,319,49,4234
"45091060300",647,421,1879,922,121,16,59,20,4085
"45091060401",115,158,1223,562,8,18,0,18,2102
"45091060402",207,4,924,633,27,0,73,25,1893
"45091060501",700,323,1294,641,23,18,35,74,3108
"45091060502",185,29,1977,298,10,0,0,0,2499
"45091060600",0,6,0,0,0,0,0,0,6
"45091060700",3350,248,431,300,101,60,50,0,4540
"45091060802",1443,177,94,29,117,0,92,0,1952
"45091060803",3078,295,1246,138,95,221,137,181,5391
"45091060804",2704,459,610,52,282,14,421,51,4593
"45091060901",2055,588,1254,608,223,15,189,142,5074
"45091060904",4540,492,862,0,213,92,136,95,6430
"45091060905",5871,680,1096,672,500,0,168,0,8987
"45091060906",6835,755,610,30,399,0,141,149,8919
"45091060907",6401,514,1159,218,748,110,730,344,10224
"45091061003",8434,347,399,21,488,0,275,0,9964
"45091061004",5788,351,786,0,368,0,418,0,7711
"45091061005",7455,272,215,514,453,44,366,0,9319
"45091061006",2548,20,129,0,252,0,156,0,3105
"45091061007",5011,471,906,0,473,0,734,146,7741
"45091061008",3059,127,354,0,195,0,87,24,3846
"45091061101",2733,392,427,51,165,23,73,52,3916
"45091061103",4518,272,144,317,267,8,139,0,5665
"45091061104",3448,57,247,0,13,0,193,0,3958
"45091061201",4150,1064,1063,303,673,90,339,52,7734
"45091061202",2842,610,158,0,710,179,16,4,4519
"45091061203",4155,898,547,211,195,30,18,104,6158
"45091061301",1781,111,2522,472,239,0,27,94,5246
"45091061302",3392,118,531,694,288,0,181,0,5204
"45091061401",2990,398,417,13,42,152,37,38,4087
"45091061403",4043,149,559,0,83,20,19,11,4884
"45091061404",2414,114,784,136,64,18,85,36,3651
"45091061501",5565,1054,705,0,182,0,394,192,8092
"45091061502",5738,1096,642,94,15,0,279,188,8052
"45091061601",1119,169,846,419,104,0,165,13,2835
"45091061602",2507,732,1042,964,272,154,361,123,6155
"45091061701",3177,633,131,0,87,83,49,71,4231
"45091061705",4183,402,13,0,157,9,49,0,4813
"45091061706",3590,292,277,48,70,26,63,0,4366
"45091061707",6646,453,376,192,321,28,206,121,8343
"45091061708",3840,119,145,0,164,25,435,25,4753
"45091061801",1119,471,1066,15,134,1,201,0,3007
"45091061802",3318,626,208,242,97,54,33,0,4578
"45091061900",3344,383,476,36,33,141,75,0,4488
"46003973600",2319,165,64,0,56,4,102,0,2710
"46005956600",1514,183,0,21,20,0,12,0,1750
"46005956700",1682,240,0,0,0,11,9,11,1953
"46005956800",1470,195,23,0,129,0,33,16,1866
"46005956900",1940,724,40,0,158,37,197,313,3409
"46005957000",3893,1303,0,6,369,400,112,561,6644
"46005957100",2450,161,0,0,74,244,105,29,3063
"46007941000",362,24,5,0,486,433,0,0,1310
"46007941200",488,42,0,26,693,792,75,0,2116
"46009967600",2656,412,0,4,122,13,38,0,3245
"46009967700",2079,254,9,0,35,164,1,0,2542
"46011958600",3271,277,2,0,103,95,82,60,3890
"46011958700",4399,307,10,39,116,26,88,36,5021
"46011958802",3423,1092,0,0,174,88,66,0,4843
"46011958803",4079,345,0,0,294,0,101,28,4847
"46011958900",2936,1795,30,17,129,298,59,88,5352
"46011959000",4180,695,211,0,310,57,8,0,5461
"46013951300",4622,239,24,0,207,18,135,0,5245
"46013951400",5497,479,139,0,459,0,48,0,6622
"46013951500",1594,420,0,0,133,144,91,33,2415
"46013951600",3012,356,0,8,472,61,0,0,3909
"46013951700",3839,514,28,0,165,68,0,153,4767
"46013951800",4394,423,110,0,64,12,0,0,5003
"46013951900",3328,181,40,0,64,1,101,26,3741
"46013952000",4196,217,24,0,78,0,10,3,4528
"46015973100",1796,294,0,0,108,13,31,11,2253
"46015973200",2288,200,0,0,202,163,55,0,2908
"46017940200",287,48,10,0,967,651,27,0,1990
"46019967600",2752,327,14,0,158,28,105,11,3395
"46019967700",5829,631,1,3,308,39,193,20,7024
"46021964100",1174,169,0,0,51,33,0,0,1427
"46023940200",1201,45,0,0,656,1081,18,19,3020
"46023940300",1730,356,11,0,914,489,77,32,3609
"46023970100",2219,114,1,0,40,10,18,9,2411
"46025955800",2908,476,7,27,118,28,109,86,3759
"46027965700",3512,943,54,18,352,268,106,40,5293
"46027965800",2744,109,1,0,57,0,21,0,2932
"46027965900",1887,1323,12,60,108,115,67,26,3598
"46029954100",3076,150,9,7,18,16,9,22,3307
"46029954301",3737,405,0,10,331,18,20,29,4550
"46029954302",4553,112,0,0,0,0,41,0,4706
"46029954400",3486,1038,0,13,208,159,204,24,5132
"46029954501",1777,230,9,0,181,0,59,0,2256
"46029954502",4140,503,0,0,80,170,39,0,4932
"46029954600",2414,145,0,0,21,13,3,0,2596
"46031941000",723,91,0,0,296,582,11,19,1722
"46031941100",371,48,2,4,856,1057,77,16,2431
"46033965100",4634,354,3,0,189,68,87,54,5389
"46033965200",2236,336,0,0,64,58,40,0,2734
"46035962600",2695,217,0,0,9,34,2,0,2957
"46035962700",4848,590,0,0,39,2,25,0,5504
"46035962800",4370,827,53,0,366,43,29,0,5688
"46035962900",3680,519,18,0,316,50,238,17,4838
"46037952700",1458,266,0,0,12,5,20,5,1766
"46037952800",1483,386,0,0,13,13,0,0,1895
"46037952900",1114,161,0,0,247,303,0,10,1835
"46039953600",2692,144,36,0,3,0,71,29,2975
"46039953700",1349,56,0,0,16,3,0,3,1427
"46041941500",114,16,22,0,1287,1116,5,60,2620
"46041941700",974,58,0,0,1139,573,0,59,2803
"46043969600",2466,325,0,0,88,24,21,0,2924
"46045962100",1978,239,0,0,14,44,0,11,2286
"46045962200",1449,206,0,0,3,2,13,11,1684
"46047964100",2535,261,0,0,101,52,3,0,2952
"46047964200",2601,576,35,3,263,271,97,32,3878
"46049961100",1976,307,0,0,26,0,13,50,2372
"46051953100",4480,603,19,20,87,32,92,8,5341
"46051953300",1758,150,0,0,9,16,7,0,1940
"46053971100",1563,308,2,0,39,74,11,0,1997
"46053971200",1618,267,0,4,171,151,1,33,2245
"46055960100",1538,214,4,0,69,67,4,0,1896
"46057955100",2340,166,12,1,55,31,76,20,2701
"46057955200",2932,184,1,6,9,28,58,9,3227
"46059975600",1247,205,0,0,5,0,18,0,1475
"46059975700",1688,215,0,0,18,0,2,0,1923
"46061964100",2749,462,56,21,34,51,19,12,3404
"46063968700",1012,225,4,0,35,0,0,0,1276
"46065977700",4962,218,72,0,90,52,26,25,5445
"46065977800",4075,209,0,0,335,460,70,0,5149
"46065977900",1740,199,0,60,272,297,73,107,2748
"46065978000",2569,128,16,0,298,232,20,18,3281
"46067968600",2444,450,16,0,31,18,33,65,3057
"46067968700",1949,217,0,0,17,0,0,0,2183
"46067968800",1583,225,0,0,14,13,20,4,1859
"46069976700",1077,98,0,0,164,12,21,0,1372
"46071941200",344,8,5,0,786,604,58,0,1805
"46071961100",1128,73,0,0,126,0,0,0,1327
"46073974100",1711,244,0,0,42,0,29,66,2092
"46075091600",824,128,10,0,6,13,2,0,983
"46077958100",2570,304,0,14,48,18,32,46,3032
"46077958200",1890,126,0,0,59,3,14,0,2092
"46079960100",2109,134,0,0,17,5,31,7,2303
"46079960200",4829,1356,128,17,159,31,50,98,6668
"46079960300",1855,230,0,0,21,3,4,14,2127
"46081966100",5460,475,10,6,201,56,172,16,6396
"46081966200",2739,684,0,0,189,27,70,15,3724
"46081966301",3077,528,0,0,240,107,200,55,4207
"46081966302",3491,692,0,0,226,76,0,0,4485
"46081966600",4269,613,12,27,90,86,76,26,5199
"46083010101",3876,367,66,0,276,38,13,38,4674
"46083010102",6885,290,30,52,227,0,183,0,7667
"46083010103",5092,234,0,0,190,0,48,0,5564
"46083010104",8845,179,0,0,309,0,103,0,9436
"46083010105",590,12,38,0,18,0,0,0,658
"46083010106",1082,0,0,0,0,0,0,0,1082
"46083010107",4347,261,15,77,115,20,129,0,4964
"46083010108",2165,11,0,0,7,0,8,0,2191
"46083010200",3089,199,51,0,164,27,30,0,3560
"46083010300",4017,228,34,11,80,8,43,0,4421
"46083010400",2448,73,0,0,64,0,55,0,2640
"46085940100",110,6,0,0,943,503,11,0,1573
"46085972600",1951,114,0,0,111,16,0,0,2192
"46087964600",2966,169,0,10,33,13,17,10,3218
"46087964700",1977,210,4,2,42,22,70,31,2358
"46089963100",1856,401,0,0,28,67,25,27,2404
"46091950800",3469,449,0,2,252,402,68,226,4868
"46093020200",440,53,109,0,6,3,0,0,611
"46093020301",6407,720,99,0,571,77,190,69,8133
"46093020302",5031,166,0,0,295,22,113,0,5627
"46093020400",5347,955,0,0,160,258,57,32,6809
"46093020500",3273,501,123,0,374,5,338,36,4650
"46095940300",752,50,0,0,540,695,34,22,2093
"46097961600",1996,216,2,0,71,0,27,0,2312
"46099000100",1822,223,35,211,426,222,186,46,3171
"46099000201",2626,469,350,24,147,786,385,90,4877
"46099000202",1717,319,167,0,269,36,0,0,2508
"46099000300",2232,392,156,107,526,78,408,56,3955
"46099000401",2040,141,197,0,204,207,171,181,3141
"46099000405",3360,314,719,30,755,480,36,39,5733
"46099000406",2251,168,119,308,337,82,179,116,3560
"46099000407",2188,312,25,116,66,33,88,0,2828
"46099000408",2490,149,142,150,789,209,793,250,4972
"46099000500",1995,200,28,183,370,268,332,127,3503
"46099000600",1889,327,163,14,232,57,66,6,2754
"46099000700",2677,739,252,75,400,289,423,14,4869
"46099000900",1883,599,209,85,276,90,250,142,3534
"46099001001",2571,373,7,0,186,26,232,48,3443
"46099001002",3437,396,72,11,635,146,616,8,5321
"46099001101",3410,834,21,20,239,29,55,41,4649
"46099001105",5331,402,184,0,67,52,60,21,6117
"46099001106",9253,613,0,0,352,4,131,0,10353
"46099001107",3062,175,0,0,218,36,20,0,3511
"46099001108",3859,390,20,0,386,301,387,25,5368
"46099001200",3370,188,352,230,337,18,55,0,4550
"46099001500",3067,358,674,122,296,290,38,0,4845
"46099001600",2938,103,12,0,45,25,15,0,3138
"46099001700",1940,62,27,0,7,10,7,0,2053
"46099001801",5685,253,151,197,276,152,244,28,6986
"46099001803",6520,111,69,162,247,0,11,0,7120
"46099001804",3909,242,0,0,165,0,259,0,4575
"46099001901",1894,52,0,0,66,59,31,0,2102
"46099001902",5011,131,15,0,46,0,63,0,5266
"46099010101",4273,224,26,0,213,61,63,23,4883
"46099010102",3603,390,16,0,16,0,56,0,4081
"46099010200",2490,144,5,0,12,9,7,4,2671
"46099010300",5529,243,12,0,69,0,11,0,5864
"46099010401",1483,27,0,0,4,0,54,0,1568
"46099010402",2349,44,0,0,2,0,0,0,2395
"46099010403",1541,21,36,0,66,0,22,0,1686
"46099010404",4464,94,7,4,230,5,24,7,4835
"46099010405",2837,371,108,84,260,14,204,10,3888
"46099010406",1793,57,0,0,28,10,6,0,1894
"46099010501",4483,324,0,0,52,0,9,17,4885
"46099010502",3309,485,0,0,20,19,7,0,3840
"46099010600",3799,312,44,59,88,396,11,0,4709
"46101959600",2916,268,47,0,73,43,24,0,3371
"46101959700",1775,207,0,0,823,246,73,38,3162
"46103010200",2355,646,0,3,352,868,265,13,4502
"46103010300",1596,508,23,7,414,539,189,153,3429
"46103010400",2377,292,56,34,706,827,166,0,4458
"46103010500",1244,459,26,32,431,358,179,200,2929
"46103010600",2485,579,47,0,357,466,66,43,4043
"46103010700",2840,133,6,36,558,495,175,202,4445
"46103010800",3270,547,2,12,257,87,47,13,4235
"46103010903",6310,550,119,0,709,0,117,0,7805
"46103010904",3580,522,103,0,394,41,198,62,4900
"46103010905",3556,489,109,30,472,354,54,0,5064
"46103010906",4760,285,78,0,251,74,47,17,5512
"46103010907",1481,174,0,0,412,110,102,0,2279
"46103011001",1995,208,0,0,186,7,107,58,2561
"46103011002",5468,229,0,0,316,145,327,0,6485
"46103011004",6257,136,0,0,452,44,344,17,7250
"46103011005",2090,87,11,0,85,42,0,33,2348
"46103011100",2474,212,55,0,400,17,14,30,3202
"46103011200",2447,113,14,4,103,67,25,18,2791
"46103011300",5083,382,88,0,429,114,73,0,6169
"46103011400",5145,449,10,0,987,405,262,65,7323
"46103011500",189,177,66,0,69,136,16,142,795
"46103011600",5895,342,133,6,660,161,119,23,7339
"46103011700",3082,217,10,16,440,167,204,142,4278
"46105968300",2421,408,1,0,61,0,47,0,2938
"46107000100",1903,279,0,0,41,14,0,0,2237
"46109940400",1119,126,0,0,1034,564,27,3,2873
"46109940700",1998,146,10,26,326,205,50,7,2768
"46109940800",1059,103,5,4,1054,670,32,34,2961
"46109950400",1409,111,0,0,14,4,1,0,1539
"46111962100",2015,277,0,0,14,0,45,0,2351
"46113940500",159,13,0,0,2564,2061,45,0,4842
"46113940800",74,41,20,0,1405,3166,40,0,4746
"46113940900",79,101,0,0,2084,1865,25,23,4177
"46115000100",1713,121,0,0,6,3,4,0,1847
"46115000200",2142,382,3,0,11,45,16,0,2599
"46115000300",1543,257,9,0,46,22,70,0,1947
"46117960100",2434,185,0,0,197,114,55,4,2989
"46119979100",1271,77,0,0,51,4,23,0,1426
"46121940100",313,50,0,0,1916,2244,98,58,4679
"46121940200",643,4,0,0,2429,1972,53,66,5167
"46123971600",1801,352,0,0,33,55,0,0,2241
"46123971700",2082,257,0,0,378,452,35,0,3204
"46125965100",3530,306,32,0,101,28,66,19,4082
"46125965200",3718,391,3,4,45,19,37,13,4230
"46127020100",3802,182,7,0,142,21,103,0,4257
"46127020200",2495,169,36,0,28,14,11,0,2753
"46127020300",6761,245,63,0,433,0,233,27,7762
"46129965100",1519,164,0,0,0,5,41,0,1729
"46129965200",2463,250,0,0,744,157,121,0,3735
"46135966100",2109,423,0,16,167,117,140,0,2972
"46135966200",4736,598,20,119,209,99,139,0,5920
"46135966301",2673,188,0,0,8,6,0,0,2875
"46135966302",4154,842,37,0,152,41,106,0,5332
"46135966400",3584,265,17,0,19,58,22,15,3980
"46137941600",581,83,11,0,1008,1089,40,39,2851
"47001020100",1263,702,400,359,277,54,0,0,3055
"47001020201",3051,178,348,0,372,0,37,0,3986
"47001020202",3207,437,306,0,271,0,117,211,4549
"47001020300",2754,387,330,19,208,33,204,181,4116
"47001020400",2784,1288,43,17,91,113,241,202,4779
"47001020500",2159,969,426,209,173,48,14,98,4096
"47001020600",2083,215,83,4,134,5,80,5,2609
"47001020700",1134,350,0,0,5,0,0,0,1489
"47001020800",3928,965,9,0,11,26,59,4,5002
"47001020901",4589,1104,0,0,64,0,4,0,5761
"47001020902",4730,914,0,0,54,85,81,0,5864
"47001021000",4123,1875,39,10,95,41,10,0,6193
"47001021100",2968,263,89,30,106,0,10,9,3475
"47001021201",3833,608,66,26,91,25,0,0,4649
"47001021202",4411,861,65,0,71,54,36,54,5552
"47001021301",2885,349,0,24,9,0,42,0,3309
"47001021302",6311,853,93,0,91,0,82,0,7430
"47001980100",0,0,0,0,0,0,0,0,0
"47003950100",2969,385,204,13,204,5,68,5,3853
"47003950200",5874,516,140,29,198,0,182,0,6939
"47003950300",3274,524,40,0,76,6,30,0,3950
"47003950401",3683,884,217,82,8,182,458,480,5994
"47003950402",3899,539,321,104,722,402,902,479,7368
"47003950500",2846,1405,353,270,288,513,339,272,6286
"47003950600",4360,1779,893,65,209,582,907,866,9661
"47003950700",2241,359,58,8,97,3,40,95,2901
"47003950800",2565,256,53,47,5,0,0,0,2926
"47005963000",2547,749,0,0,48,67,7,4,3422
"47005963100",2548,347,134,0,31,0,22,0,3082
"47005963200",1745,616,0,14,28,0,85,31,2519
"47005963300",2403,917,24,93,4,96,99,31,3667
"47005963400",2990,665,118,5,0,10,4,30,3822
"47007953000",2579,554,0,0,92,0,20,0,3245
"47007953100",3871,1244,136,2,44,9,144,33,5483
"47007953200",2277,795,0,0,20,0,16,0,3108
"47009010100",1387,634,934,399,0,0,121,0,3475
"47009010200",4583,949,30,37,96,3,287,0,5985
"47009010301",3706,792,235,35,205,28,184,26,5211
"47009010302",2238,711,142,0,81,24,15,34,3245
"47009010400",2188,252,92,0,12,25,50,3,2622
"47009010500",1749,411,96,24,70,9,47,47,2453
"47009010600",2296,556,0,17,149,35,0,0,3053
"47009010700",3681,503,93,15,104,203,88,57,4744
"47009010800",1952,440,155,29,10,103,53,68,2810
"47009010900",5128,391,3,2,48,43,293,12,5920
"47009011001",4315,828,0,1,123,21,89,210,5587
"47009011002",3634,155,0,0,83,54,27,25,3978
"47009011101",3886,926,312,0,89,0,70,0,5283
"47009011102",7727,404,64,6,160,0,0,0,8361
"47009011200",5693,1177,154,104,474,0,271,28,7901
"47009011301",5596,521,152,1,56,0,235,0,6561
"47009011302",5113,417,0,0,106,34,17,0,5687
"47009011401",1310,211,0,0,118,0,41,3,1683
"47009011402",3507,964,0,0,12,0,0,0,4483
"47009011501",1291,253,0,0,97,17,0,0,1658
"47009011502",3651,1134,0,0,27,74,10,0,4896
"47009011503",6206,513,0,0,34,0,280,0,7033
"47009011602",8021,1162,0,0,102,32,274,124,9715
"47009011603",4363,441,125,0,70,0,129,103,5231
"47009011604",3395,179,20,0,429,52,38,0,4113
"47009011605",2681,274,0,8,44,0,61,0,3068
"47009980100",0,0,0,0,0,0,0,0,0
"47009980200",4,0,0,0,6,0,6,0,16
"47011010100",2948,1025,205,44,244,90,288,0,4844
"47011010200",4148,1039,0,102,30,0,498,367,6184
"47011010300",1819,927,106,28,69,25,31,77,3082
"47011010400",886,738,175,177,277,63,44,154,2514
"47011010500",1261,679,29,48,46,0,26,115,2204
"47011010600",2188,393,80,32,47,163,111,332,3346
"47011010700",2711,1479,51,239,120,154,200,224,5178
"47011010800",1278,1108,528,42,6,180,16,119,3277
"47011010900",2993,368,0,0,0,12,76,12,3461
"47011011000",4487,622,215,0,108,0,338,54,5824
"47011011100",7684,1343,213,0,185,16,92,205,9738
"47011011201",4477,998,214,51,100,55,147,107,6149
"47011011202",6385,1519,204,204,227,116,294,198,9147
"47011011300",5974,921,39,0,377,34,163,7,7515
"47011011401",6452,1122,417,0,238,0,27,0,8256
"47011011402",1795,575,48,36,120,0,250,35,2859
"47011011500",6266,846,0,330,273,17,128,0,7860
"47011011601",4241,509,157,0,50,0,6,112,5075
"47011011602",4362,640,35,0,6,9,21,0,5073
"47013950100",2355,737,0,0,95,0,5,32,3224
"47013950200",1597,629,41,68,33,10,22,5,2405
"47013950300",1199,461,0,0,40,0,0,0,1700
"47013950400",3853,837,8,0,113,114,38,14,4977
"47013950500",4169,766,13,0,66,7,81,16,5118
"47013950600",2688,1397,20,0,6,0,67,0,4178
"47013950700",2866,1899,0,2,27,0,0,0,4794
"47013950800",1599,545,0,0,15,0,0,0,2159
"47013950900",2437,736,0,0,7,0,7,0,3187
"47013951000",2312,395,0,0,0,0,62,25,2794
"47013951100",4661,826,47,0,145,49,116,0,5844
"47015960100",3034,557,7,2,17,2,19,1,3639
"47015960200",4933,1162,58,17,74,83,0,76,6403
"47015960300",2907,557,72,21,82,17,107,17,3780
"47017962000",2588,1008,233,24,107,184,6,188,4338
"47017962100",4556,1015,723,227,102,51,137,114,6925
"47017962201",1990,458,72,239,141,141,0,0,3041
"47017962202",3400,442,60,82,7,31,93,0,4115
"47017962300",3299,720,360,89,35,6,31,1,4541
"47017962400",2320,255,131,12,0,0,0,11,2729
"47017962500",1742,330,117,154,24,66,25,4,2462
"47017980100",0,0,0,0,0,0,0,0,0
"47019070100",1308,538,12,6,6,0,0,0,1870
"47019070200",3454,572,143,0,14,0,32,0,4215
"47019070300",3558,1270,88,108,129,153,70,63,5439
"47019070400",1371,781,5,3,9,0,0,3,2172
"47019070500",3335,940,0,0,28,0,26,90,4419
"47019070600",2214,516,9,0,181,0,75,0,2995
"47019070700",2839,260,22,0,35,8,9,0,3173
"47019070800",2184,501,9,3,64,56,25,45,2887
"47019070900",2280,386,58,73,192,0,236,3,3228
"47019071000",2256,689,37,22,29,0,0,19,3052
"47019071100",1307,322,0,0,74,2,53,0,1758
"47019071200",2603,929,26,29,32,27,9,0,3655
"47019071300",5559,1652,0,0,27,31,9,57,7335
"47019071400",2238,905,0,0,70,29,11,0,3253
"47019071500",1552,449,13,0,11,33,0,0,2058
"47019071600",816,459,0,0,19,11,0,6,1311
"47019071700",2647,970,0,3,120,0,60,0,3800
"47021070102",3399,255,47,0,68,68,143,0,3980
"47021070103",3376,351,0,0,172,17,163,0,4079
"47021070104",4113,639,65,42,172,23,72,51,5177
"47021070201",3720,344,8,2,57,6,127,6,4270
"47021070202",3921,716,67,0,128,32,81,0,4945
"47021070203",3048,500,0,0,52,0,0,0,3600
"47021070300",2157,1092,261,40,72,0,62,131,3815
"47021070401",2071,375,55,37,0,0,6,0,2544
"47021070402",6268,794,0,13,119,24,79,6,7303
"47023970100",4227,1118,255,47,121,34,147,43,5992
"47023970200",2334,766,671,582,95,100,41,32,4621
"47023970300",4918,538,159,0,0,0,105,17,5737
"47025970100",2213,487,8,0,10,20,0,20,2758
"47025970200",2244,227,2,3,54,3,0,0,2533
"47025970300",2763,718,0,0,42,128,0,0,3651
"47025970400",407,257,0,0,3,0,0,0,667
"47025970500",2076,534,0,0,56,0,14,0,2680
"47025970600",3753,863,0,0,0,0,126,0,4742
"47025970700",4041,1447,16,0,242,0,43,0,5789
"47025970800",2354,1273,13,37,15,5,0,59,3756
"47025970900",3387,1037,10,0,56,39,0,23,4552
"47027955000",3437,1073,84,110,44,9,64,22,4843
"47027955100",2571,398,0,0,0,0,44,0,3013
"47029920100",2910,770,0,0,33,0,103,0,3816
"47029920200",3510,1789,100,2,145,0,0,0,5546
"47029920300",2928,524,109,64,156,44,89,3,3917
"47029920400",1203,475,0,0,0,14,0,0,1692
"47029920501",3883,1952,35,1,171,52,136,157,6387
"47029920502",4320,1128,0,1,51,38,30,47,5615
"47029920600",3157,913,100,93,149,39,30,1,4482
"47029920700",2751,1229,0,0,249,48,23,61,4361
"47029980100",0,0,0,0,0,0,0,0,0
"47031970100",2693,1086,0,5,17,53,4,101,3959
"47031970200",4644,1314,0,0,52,372,37,203,6622
"47031970300",1599,233,0,14,43,6,4,3,1902
"47031970400",4184,1064,85,0,485,88,432,125,6463
"47031970500",4017,1239,159,5,223,56,70,82,5851
"47031970600",3026,642,48,0,141,34,92,17,4000
"47031970700",3061,491,20,0,141,40,114,12,3879
"47031970801",3483,733,43,49,131,125,156,23,4743
"47031970802",5179,561,69,122,161,138,24,23,6277
"47031970900",1913,1239,110,265,273,285,85,136,4306
"47031971000",4852,569,73,52,453,48,255,16,6318
"47031980100",0,0,0,0,0,0,0,0,0
"47033961000",1420,314,318,58,17,25,121,27,2300
"47033961100",2590,619,401,109,203,97,152,106,4277
"47033961200",1482,210,0,74,120,26,106,48,2066
"47033961300",1710,271,117,89,81,30,96,28,2422
"47033961400",2546,517,512,179,89,79,421,211,4554
"47035970101",2927,177,102,1,59,0,36,0,3302
"47035970102",4979,820,60,0,142,30,42,28,6101
"47035970200",5279,519,0,2,92,48,113,48,6101
"47035970301",2828,491,0,0,0,0,36,0,3355
"47035970302",3366,968,18,0,116,7,0,0,4475
"47035970400",3659,2105,0,0,64,170,0,155,6153
"47035970501",1860,263,0,0,36,12,36,0,2207
"47035970502",2484,1244,2,0,93,37,232,132,4224
"47035970601",4407,421,0,0,70,121,108,115,5242
"47035970602",2733,386,0,0,154,0,178,0,3451
"47035970603",1915,170,27,0,25,0,38,0,2175
"47035970701",1657,416,0,0,5,0,22,0,2100
"47035970702",3772,827,0,0,93,9,39,0,4740
"47035970800",2926,552,0,0,44,34,18,29,3603
"47037010103",2103,65,240,0,23,0,53,0,2484
"47037010104",2889,171,127,0,49,0,10,0,3246
"47037010105",732,90,2646,562,126,23,33,0,4212
"47037010106",683,105,1877,151,62,139,14,0,3031
"47037010201",2435,147,1469,224,225,0,720,0,5220
"47037010202",3104,255,34,0,88,2,42,0,3525
"47037010301",2490,311,741,25,158,28,150,16,3919
"47037010302",1213,321,173,202,91,31,68,31,2130
"47037010303",2741,324,991,245,282,18,441,123,5165
"47037010401",2442,635,898,157,80,19,150,263,4644
"47037010402",2569,891,913,584,500,447,964,455,7323
"47037010501",3950,1075,116,60,185,25,176,18,5605
"47037010502",3651,413,518,99,201,8,160,33,5083
"47037010601",2628,187,1206,207,97,180,420,163,5088
"47037010602",1035,382,1237,263,314,93,222,277,3823
"47037010701",1514,745,825,347,338,299,360,281,4709
"47037010702",1298,404,747,323,219,43,300,48,3382
"47037010801",2573,149,1309,495,75,415,415,437,5868
"47037010802",1869,291,786,58,170,103,167,126,3570
"47037010901",1533,126,980,125,215,31,196,22,3228
"47037010903",400,283,2890,1602,57,111,57,296,5696
"47037010904",271,64,1438,857,0,0,0,0,2630
"47037011001",1075,690,2332,656,346,222,404,362,6087
"47037011002",1068,122,970,263,67,90,50,63,2693
"47037011100",2566,282,376,198,447,261,255,256,4641
"47037011200",2381,369,846,190,213,0,122,8,4129
"47037011300",1423,635,1055,921,522,254,771,363,5944
"47037011400",1137,208,2409,910,184,34,58,11,4951
"47037011500",2551,130,902,48,113,7,17,0,3768
"47037011600",2699,433,1421,288,39,0,79,14,4973
"47037011700",2703,599,724,965,38,74,94,73,5270
"47037011800",468,24,950,1141,99,90,89,0,2861
"47037011900",368,148,857,577,101,33,37,121,2242
"47037012100",1872,309,121,0,112,15,151,0,2580
"47037012200",1592,66,349,40,86,85,96,85,2399
"47037012600",282,216,949,433,78,74,25,74,2131
"47037012701",192,6,2982,1870,120,0,0,0,5170
"47037012702",97,112,1597,323,76,0,3,0,2208
"47037012801",465,279,2853,1570,10,0,154,0,5331
"47037012802",250,112,2055,521,113,0,0,0,3051
"47037013000",12,1,4,7,0,0,0,0,24
"47037013100",1378,316,518,57,81,16,0,0,2366
"47037013201",1796,253,153,54,976,189,176,111,3708
"47037013202",2284,419,193,272,286,7,506,167,4134
"47037013300",2209,625,563,267,278,162,649,183,4936
"47037013400",3206,243,0,0,149,0,77,0,3675
"47037013500",924,187,288,340,37,34,43,5,1858
"47037013601",121,60,1803,1163,0,60,0,60,3267
"47037013602",14,0,207,114,28,5,19,0,387
"47037013700",259,284,2319,2905,175,112,21,0,6075
"47037013800",40,18,689,989,16,3,14,0,1769
"47037013900",55,7,713,698,44,0,0,0,1517
"47037014200",21,22,832,860,13,0,0,0,1748
"47037014300",117,23,1093,465,60,5,28,0,1791
"47037014400",72,32,452,377,82,77,13,3,1108
"47037014800",93,84,459,1840,0,115,28,28,2647
"47037015100",2994,521,253,10,406,137,203,32,4556
"47037015200",2258,193,27,2,39,91,224,147,2981
"47037015300",4514,301,668,105,272,11,305,34,6210
"47037015401",4168,491,349,48,400,0,249,68,5773
"47037015402",3686,189,463,107,58,1,260,2,4766
"47037015404",2187,471,220,23,87,162,174,231,3555
"47037015405",3329,512,551,45,187,122,19,137,4902
"47037015501",2301,238,126,151,191,0,168,0,3175
"47037015502",2837,382,208,90,189,12,65,159,3942
"47037015609",2442,106,478,12,429,12,287,0,3766
"47037015610",5934,332,1156,310,633,105,424,0,8894
"47037015612",2950,409,1860,166,769,76,614,63,6907
"47037015613",1428,411,576,264,478,349,484,500,4490
"47037015614",1634,475,1478,102,458,175,448,240,5010
"47037015615",1326,502,907,136,1219,525,1304,602,6521
"47037015617",1622,126,637,17,157,30,67,0,2656
"47037015618",2171,244,2207,54,556,0,464,54,5750
"47037015619",2467,218,1404,191,168,0,256,93,4797
"47037015620",2647,455,3049,370,406,0,847,0,7774
"47037015622",2803,92,612,71,119,43,100,0,3840
"47037015623",3524,272,1116,1262,206,134,614,0,7128
"47037015624",2836,445,767,433,523,27,381,27,5439
"47037015625",3516,554,556,118,256,0,128,174,5302
"47037015626",1928,228,2618,517,788,317,613,239,7248
"47037015627",948,90,1267,115,364,36,469,36,3325
"47037015628",935,267,928,561,545,237,639,383,4495
"47037015629",1923,372,1914,172,753,43,604,72,5853
"47037015630",1226,107,1701,98,388,0,279,0,3799
"47037015631",3514,342,2939,466,1475,23,596,91,9446
"47037015700",1198,194,190,4,107,23,566,32,2314
"47037015802",2163,1258,1066,642,793,393,966,595,7876
"47037015803",912,874,394,371,152,142,429,506,3780
"47037015804",1550,592,852,222,593,483,618,369,5279
"47037015900",1069,494,129,287,65,13,8,177,2242
"47037016000",29,5,339,335,16,14,4,0,742
"47037016100",447,143,1073,329,16,12,69,8,2097
"47037016200",571,267,1012,1233,66,151,0,0,3300
"47037016300",560,279,539,763,55,12,31,19,2258
"47037016400",871,401,75,20,71,8,34,26,1506
"47037016500",176,185,0,27,63,25,0,3,479
"47037016600",1331,210,118,101,563,47,41,10,2421
"47037016700",3975,341,210,15,430,19,53,0,5043
"47037016800",2754,929,20,14,463,107,38,11,4336
"47037016900",4095,224,168,0,303,39,82,0,4911
"47037017000",1384,339,687,104,27,12,0,13,2566
"47037017100",1218,137,524,3,41,9,33,0,1965
"47037017200",741,244,90,5,81,3,53,90,1307
"47037017300",1227,671,292,89,843,273,730,728,4853
"47037017401",1157,97,357,87,257,252,435,295,2937
"47037017402",2742,1294,975,124,679,446,693,987,7940
"47037017500",1859,557,189,40,283,0,730,180,3838
"47037017701",1798,3,69,0,127,0,28,0,2025
"47037017702",2907,67,79,0,85,18,48,0,3204
"47037017800",4159,705,186,15,262,47,61,0,5435
"47037017901",4047,280,59,0,173,16,89,0,4664
"47037017902",4185,220,37,17,192,32,247,13,4943
"47037018000",4131,207,75,16,215,64,15,13,4736
"47037018101",2076,462,467,450,588,267,509,284,5103
"47037018102",3260,214,22,0,119,0,72,0,3687
"47037018201",2531,91,87,35,88,77,33,0,2942
"47037018202",5006,499,1087,153,375,48,420,12,7600
"47037018203",1460,27,0,0,27,5,49,5,1573
"47037018301",5291,486,470,131,978,37,262,0,7655
"47037018302",2604,19,184,0,104,0,23,0,2934
"47037018401",4731,301,901,342,725,11,633,0,7644
"47037018404",3383,171,366,98,107,16,100,15,4256
"47037018405",4279,97,152,12,327,16,133,27,5043
"47037018407",3588,80,195,47,431,6,159,0,4506
"47037018408",2901,39,110,0,233,0,50,0,3333
"47037018409",3521,176,119,0,105,0,14,0,3935
"47037018410",2063,363,273,0,149,167,0,190,3205
"47037018500",4976,32,27,12,77,0,48,0,5172
"47037018601",1984,70,38,0,58,12,0,0,2162
"47037018602",3922,41,0,0,259,16,81,0,4319
"47037018700",3177,35,16,0,79,0,30,0,3337
"47037018801",4829,59,187,0,323,0,58,0,5456
"47037018803",3050,65,111,0,150,0,90,0,3466
"47037018804",4202,270,606,0,366,6,353,0,5803
"47037018901",1548,587,199,27,107,294,38,206,3006
"47037018902",2250,315,158,22,254,17,454,194,3664
"47037018904",1665,744,297,198,578,261,431,282,4456
"47037018905",1459,343,455,46,342,495,457,582,4179
"47037019003",2010,419,586,185,1013,695,1491,812,7211
"47037019004",1811,398,722,42,567,840,964,431,5775
"47037019005",959,593,950,500,221,181,518,412,4334
"47037019006",1616,1191,948,203,512,749,575,1343,7137
"47037019105",2464,1368,565,163,837,320,351,424,6492
"47037019106",2989,237,433,81,168,20,203,42,4173
"47037019108",1310,638,210,92,794,362,951,807,5164
"47037019109",2093,111,1158,56,1124,166,1023,104,5835
"47037019110",1860,663,513,115,511,438,996,612,5708
"47037019111",1542,286,1265,156,430,241,379,327,4626
"47037019112",1703,334,1568,29,433,295,450,344,5156
"47037019114",7651,382,1558,0,817,101,571,67,11147
"47037019115",2790,34,710,29,262,0,205,18,4048
"47037019116",3721,571,920,220,444,169,440,128,6613
"47037019117",1761,104,2017,252,364,53,123,0,4674
"47037019118",1740,501,2162,259,385,0,312,18,5377
"47037019200",1657,514,350,490,125,55,101,0,3292
"47037019300",220,290,309,1977,80,133,16,26,3051
"47037019400",1421,255,751,937,56,22,38,10,3490
"47037019500",2767,481,329,213,284,100,253,82,4509
"47037019600",2127,654,530,305,94,47,188,239,4184
"47037980100",0,0,0,0,0,0,0,0,0
"47037980200",0,0,0,1,0,0,0,0,1
"47039955001",1258,541,11,7,113,0,73,0,2003
"47039955002",3256,929,179,27,40,57,81,175,4744
"47039955101",1197,455,63,32,3,20,0,1,1771
"47039955102",2695,518,0,0,48,3,0,0,3264
"47041920101",1754,241,0,6,11,21,0,31,2064
"47041920102",3734,714,0,1,93,0,139,27,4708
"47041920200",4541,1477,117,129,107,0,296,79,6746
"47041920300",4508,710,40,9,79,213,513,205,6277
"47043060100",3099,1048,0,27,13,15,67,12,4281
"47043060200",5188,1079,121,0,68,135,30,44,6665
"47043060300",5253,880,0,0,112,0,90,0,6335
"47043060401",2535,206,12,2,54,4,125,0,2938
"47043060402",4799,735,108,0,160,13,21,186,6022
"47043060501",5022,505,15,19,111,43,12,0,5727
"47043060502",2379,237,28,109,82,0,9,0,2844
"47043060601",2657,579,309,31,87,17,51,90,3821
"47043060602",4011,804,802,218,642,133,513,40,7163
"47043060700",3919,629,99,16,75,89,241,0,5068
"47045964000",5570,621,226,64,303,26,57,14,6881
"47045964200",4449,509,657,110,206,15,139,109,6194
"47045964300",3435,813,568,268,237,179,48,123,5671
"47045964400",2221,916,1224,1099,207,274,165,103,6209
"47045964500",2168,157,81,17,15,0,32,4,2474
"47045964600",1812,336,92,156,195,34,110,34,2769
"47045964800",2436,443,50,19,107,0,46,0,3101
"47045964900",4331,647,310,15,55,0,72,0,5430
"47047060300",1258,198,756,619,32,3,30,0,2896
"47047060401",1922,174,318,166,125,358,34,358,3455
"47047060402",2348,142,939,0,18,0,60,0,3507
"47047060403",3213,193,523,59,53,11,0,0,4052
"47047060404",3665,402,730,36,162,0,14,0,5009
"47047060501",2088,391,1192,722,51,0,41,0,4485
"47047060502",2594,213,719,350,79,0,27,0,3982
"47047060600",2183,291,899,351,144,0,141,0,4009
"47047060701",1571,64,566,115,3,0,73,0,2392
"47047060702",1641,91,540,170,61,2,114,20,2639
"47047060800",1537,68,754,124,42,8,0,0,2533
"47049965000",2232,813,0,0,40,43,10,0,3138
"47049965100",2134,1600,0,2,47,24,69,79,3955
"47049965200",5045,883,0,0,38,18,21,0,6005
"47049965300",3562,1149,12,0,54,30,0,19,4826
"47051960100",2516,560,91,45,50,84,39,53,3438
"47051960201",5696,411,34,0,222,96,0,62,6521
"47051960202",4871,468,68,0,81,13,47,0,5548
"47051960300",2311,400,79,7,16,19,11,0,2843
"47051960400",5196,1062,319,30,598,97,461,63,7826
"47051960500",2033,462,409,77,78,142,38,76,3315
"47051960600",3339,832,121,64,181,68,0,0,4605
"47051960700",2225,529,0,0,42,8,38,16,2858
"47051960800",2172,385,97,4,71,1,10,46,2786
"47053966100",1770,278,285,43,94,19,8,15,2512
"47053966200",2423,264,344,139,154,53,66,0,3443
"47053966300",1614,375,336,8,34,0,34,0,2401
"47053966400",3662,1051,156,176,64,33,125,38,5305
"47053966500",2927,576,696,805,82,27,123,27,5263
"47053966600",1359,71,136,16,33,3,19,3,1640
"47053966700",3278,781,853,792,129,0,156,0,5989
"47053966800",908,234,27,5,35,0,27,0,1236
"47053966900",535,99,1493,739,5,0,0,0,2871
"47053967000",4806,904,1056,458,122,100,33,204,7683
"47053967100",5097,292,337,0,104,1,63,0,5894
"47053967300",749,198,0,0,94,5,81,5,1132
"47053967400",3635,513,54,20,63,19,41,0,4345
"47053980100",0,0,0,0,0,0,0,0,0
"47055920100",2899,285,89,38,31,43,15,0,3400
"47055920200",2101,761,172,351,95,60,95,8,3643
"47055920300",4983,507,589,356,246,0,86,10,6777
"47055920400",1799,748,142,110,20,24,32,0,2875
"47055920500",3390,832,437,127,82,0,114,0,4982
"47055920600",1971,395,67,99,2,14,55,1,2604
"47055920700",1215,357,91,13,32,13,14,0,1735
"47055920800",2161,349,252,36,61,36,21,12,2928
"47057500100",2809,1052,0,0,84,0,96,0,4041
"47057500200",3940,675,26,0,37,0,0,7,4685
"47057500300",4868,1150,89,35,19,43,268,16,6488
"47057500401",2121,565,0,19,0,1,72,12,2790
"47057500402",3742,878,4,0,30,144,34,52,4884
"47059090100",2981,2840,522,155,78,264,37,768,7645
"47059090200",1935,133,0,0,43,8,0,0,2119
"47059090300",3769,874,40,31,208,25,61,43,5051
"47059090400",3878,678,74,5,13,172,23,188,5031
"47059090500",5748,1114,91,58,29,12,155,107,7314
"47059090600",3317,276,0,14,72,26,35,15,3755
"47059090700",2167,398,15,90,22,15,16,0,2723
"47059090800",3526,1135,95,0,14,28,62,0,4860
"47059090900",3936,590,31,3,28,0,85,1,4674
"47059091000",5690,1775,99,0,8,0,58,0,7630
"47059091100",3145,655,0,0,11,52,0,20,3883
"47059091200",2537,620,11,0,63,173,30,0,3434
"47059091300",3370,937,0,15,0,32,23,39,4416
"47059091400",2341,660,5,19,12,48,0,0,3085
"47059091500",2267,820,0,0,0,0,0,0,3087
"47061955000",1614,927,0,5,287,267,18,16,3134
"47061955100",1093,240,4,0,82,35,14,0,1468
"47061955200",2138,848,0,0,364,232,2,27,3611
"47061955300",3187,1047,0,14,640,357,34,5,5284
"47063100100",4004,1747,339,63,185,0,1159,489,7986
"47063100200",3450,1084,250,259,522,369,612,700,7246
"47063100300",1201,1329,69,0,270,195,421,735,4220
"47063100400",3535,848,429,131,104,19,377,149,5592
"47063100500",2192,401,177,15,28,18,96,0,2927
"47063100600",5876,1225,0,5,108,4,239,51,7508
"47063100700",4926,827,77,0,128,25,364,0,6347
"47063100800",1777,1098,266,0,193,0,168,297,3799
"47063100900",4207,535,12,70,397,0,619,60,5900
"47063101000",4548,743,77,46,15,0,15,12,5456
"47063101100",4486,309,0,0,28,0,48,0,4871
"47063101200",5585,465,133,12,203,19,128,0,6545
"47065000400",192,85,2042,670,42,123,77,0,3231
"47065000600",2414,425,2,24,58,71,51,33,3078
"47065000700",2947,489,92,40,142,0,76,0,3786
"47065000800",873,140,152,210,30,0,15,0,1420
"47065001100",445,38,556,718,5,81,33,75,1951
"47065001200",118,125,1533,1221,0,42,0,0,3039
"47065001300",337,206,591,469,0,96,6,176,1881
"47065001400",554,244,508,483,30,12,124,92,2047
"47065001600",153,254,302,1367,33,10,0,14,2133
"47065001800",1542,330,536,107,74,13,78,0,2680
"47065001900",101,90,1381,2728,44,106,26,4,4480
"47065002000",313,110,231,455,25,12,17,12,1175
"47065002300",556,208,170,89,144,135,154,247,1703
"47065002400",1613,1039,471,842,418,512,342,669,5906
"47065002500",1152,320,1013,1686,184,242,353,267,5217
"47065002600",593,383,411,614,127,164,178,177,2647
"47065002800",2524,279,632,96,82,78,42,92,3825
"47065002900",975,126,760,418,43,0,114,0,2436
"47065003000",955,286,498,290,256,37,265,80,2667
"47065003100",633,168,64,151,26,14,5,14,1075
"47065003200",645,65,1913,425,58,267,0,45,3418
"47065003300",1129,67,4676,1016,343,189,263,56,7739
"47065003400",2235,669,1124,217,68,73,500,202,5088
"47065010101",4990,504,121,0,82,47,48,39,5831
"47065010103",3066,316,176,1,23,12,28,12,3634
"47065010104",3954,311,21,12,29,0,29,0,4356
"47065010201",3233,48,0,0,0,0,0,0,3281
"47065010202",3504,585,85,12,12,0,32,0,4230
"47065010303",2821,145,14,0,0,0,0,0,2980
"47065010304",4399,492,34,0,152,0,57,0,5134
"47065010305",3091,52,0,0,9,0,0,0,3152
"47065010306",3325,577,58,0,45,0,0,219,4224
"47065010307",4437,882,0,0,16,0,0,0,5335
"47065010411",5633,586,302,0,294,14,22,125,6976
"47065010412",4484,598,209,0,182,0,15,0,5488
"47065010413",4016,289,0,4,117,64,29,0,4519
"47065010431",5720,485,481,0,421,95,128,70,7400
"47065010432",6176,152,78,58,142,0,0,0,6606
"47065010433",3218,920,427,165,25,0,23,358,5136
"47065010434",1784,399,47,0,0,0,0,0,2230
"47065010435",4625,870,142,14,0,0,0,3,5654
"47065010501",5016,617,537,29,68,216,44,21,6548
"47065010502",2543,363,78,43,422,74,347,105,3975
"47065010600",2360,283,37,1,165,17,91,0,2954
"47065010700",1593,465,249,10,58,22,0,188,2585
"47065010800",2793,648,227,198,81,207,264,318,4736
"47065010901",1188,290,9,5,38,15,17,0,1562
"47065010902",512,270,0,0,0,0,0,0,782
"47065010903",4088,1063,278,102,204,0,20,0,5755
"47065011001",1512,231,0,0,25,0,38,0,1806
"47065011002",6738,365,0,7,223,37,63,30,7463
"47065011100",6465,72,0,12,59,0,0,0,6608
"47065011201",7524,540,21,240,286,17,165,67,8860
"47065011203",3575,346,364,43,327,0,265,19,4939
"47065011204",4539,346,46,13,374,0,427,61,5806
"47065011311",4340,815,626,54,125,0,581,92,6633
"47065011314",3961,435,704,29,102,30,139,53,5453
"47065011321",3963,806,681,65,980,33,157,241,6926
"47065011323",3721,394,369,307,389,0,7,28,5215
"47065011324",2917,114,432,0,310,26,44,0,3843
"47065011325",4487,64,854,30,452,11,296,26,6220
"47065011326",3334,565,432,261,461,176,292,393,5914
"47065011402",1245,306,3934,536,350,108,193,91,6763
"47065011411",1784,372,1309,289,157,36,24,48,4019
"47065011413",5506,375,1720,113,177,118,180,0,8189
"47065011442",1814,241,296,90,309,12,121,22,2905
"47065011443",3540,530,1314,165,241,66,258,9,6123
"47065011444",506,26,2223,983,149,17,150,17,4071
"47065011445",2093,189,633,242,133,96,219,104,3709
"47065011446",2414,147,334,79,140,0,261,0,3375
"47065011447",7034,254,470,45,214,0,327,0,8344
"47065011600",3755,637,457,12,416,26,111,0,5414
"47065011700",3690,240,39,42,242,3,610,6,4872
"47065011800",4793,609,401,97,100,367,270,367,7004
"47065011900",1148,118,280,125,85,161,58,0,1975
"47065012000",1722,34,26,14,44,1,38,0,1879
"47065012100",5321,521,20,2,17,0,233,130,6244
"47065012200",39,10,1196,1436,0,33,0,0,2714
"47065012300",883,488,2059,789,124,112,0,0,4455
"47065012400",917,492,298,157,0,212,31,9,2116
"47065980100",0,0,0,0,0,0,0,0,0
"47065980200",0,0,0,0,0,0,0,0,0
"47067960500",1943,541,0,0,35,8,0,0,2527
"47067960600",2520,1431,0,2,44,43,0,10,4050
"47069950100",2509,443,289,145,20,88,24,27,3545
"47069950200",1179,332,1316,608,46,0,73,0,3554
"47069950300",1280,184,1351,756,0,0,0,0,3571
"47069950400",2258,309,1501,1206,159,95,65,0,5593
"47069950500",3435,802,232,46,152,30,31,90,4818
"47069950600",805,146,1169,566,26,15,0,0,2727
"47071920100",2761,904,0,66,78,41,44,0,3894
"47071920200",3230,937,65,19,77,32,65,67,4492
"47071920300",3032,439,248,164,81,7,76,0,4047
"47071920400",2906,1362,274,23,36,0,46,0,4647
"47071920500",4499,1084,0,2,121,25,191,0,5922
"47071920600",2261,659,79,15,105,16,0,15,3150
"47073050100",3260,757,0,0,23,0,13,0,4053
"47073050200",3392,1394,0,0,10,14,10,0,4820
"47073050301",3294,850,0,45,26,16,0,0,4231
"47073050302",3319,422,42,57,186,0,28,0,4054
"47073050400",4811,1027,10,0,113,79,113,72,6225
"47073050501",3356,556,15,0,0,0,9,0,3936
"47073050502",2332,349,32,6,91,69,39,0,2918
"47073050503",3835,421,89,0,21,55,69,112,4602
"47073050601",4822,671,211,0,186,107,7,18,6022
"47073050602",3705,303,0,0,18,0,52,10,4088
"47073050700",2884,427,0,0,40,28,0,0,3379
"47073050800",4057,968,114,33,176,0,149,0,5497
"47073050900",2447,449,0,0,43,3,0,0,2942
"47075930100",1336,383,482,103,247,0,333,18,2902
"47075930200",763,215,334,121,3,0,21,0,1457
"47075930301",1410,138,1836,924,137,110,73,69,4697
"47075930302",696,94,1615,490,28,16,0,16,2955
"47075930400",1500,352,1675,479,107,12,65,12,4202
"47075930500",1403,185,856,233,21,14,57,77,2846
"47077975000",2477,502,61,12,29,0,0,76,3157
"47077975100",2704,425,286,33,9,33,0,0,3490
"47077975200",4598,848,180,26,27,0,50,0,5729
"47077975300",5652,709,498,145,155,33,70,64,7326
"47077975400",2230,984,463,529,181,173,171,84,4815
"47077975500",2774,713,9,0,29,4,33,17,3579
"47079969000",3554,717,25,0,27,17,49,27,4416
"47079969100",2456,376,20,0,16,0,62,36,2966
"47079969200",1419,336,28,18,3,0,35,0,1839
"47079969300",1691,705,506,498,152,88,2,99,3741
"47079969400",1037,409,249,350,76,104,0,0,2225
"47079969500",3547,812,59,112,156,0,26,0,4712
"47079969600",6574,687,255,4,0,0,47,19,7586
"47079969700",1723,362,174,25,0,0,0,0,2284
"47079969800",1642,437,140,18,32,0,205,0,2474
"47081950100",3861,630,33,0,128,0,15,0,4667
"47081950200",5454,1523,71,0,76,0,0,0,7124
"47081950301",2076,451,219,105,0,24,0,0,2875
"47081950302",3993,706,0,6,143,21,327,0,5196
"47081950400",1818,262,0,0,47,0,0,0,2127
"47081950500",929,116,0,21,26,111,0,0,1203
"47083120100",2509,726,0,26,25,0,5,63,3354
"47083120200",1442,465,82,41,50,70,30,0,2180
"47083120300",2045,583,0,2,82,0,26,26,2764
"47085130100",4884,706,4,0,42,7,14,40,5697
"47085130200",1539,359,19,0,14,0,24,16,1971
"47085130300",3959,833,244,174,19,0,151,9,5389
"47085130400",2177,168,105,23,12,17,30,0,2532
"47085130500",2549,210,17,0,58,24,41,0,2899
"47087960100",1346,373,0,0,19,8,0,0,1746
"47087960200",1625,345,1,0,51,0,0,0,2022
"47087960300",4135,1087,0,0,110,74,30,68,5504
"47087960400",1535,622,0,0,0,0,46,37,2240
"47089070100",4806,1497,114,0,287,96,367,136,7303
"47089070200",3993,813,0,33,166,0,21,8,5034
"47089070300",4974,960,117,268,72,22,147,230,6790
"47089070400",2715,732,55,6,11,10,27,13,3569
"47089070500",4352,1045,121,68,0,11,67,23,5687
"47089070600",3937,832,17,9,98,0,112,54,5059
"47089070700",5323,679,97,76,185,8,139,22,6529
"47089070800",5992,1194,11,1,96,0,0,126,7420
"47089070900",3053,757,76,0,69,0,130,24,4109
"47091956000",800,161,0,0,12,6,0,0,979
"47091956100",1919,710,10,0,19,0,17,18,2693
"47091956200",1554,687,0,0,12,0,0,0,2253
"47091956300",3660,1626,4,48,35,160,21,169,5723
"47091956400",3798,916,141,0,57,2,0,16,4930
"47093000100",1096,396,83,113,67,29,18,18,1820
"47093000800",1587,1090,278,174,104,0,109,64,3406
"47093000901",0,0,0,0,0,11,0,0,11
"47093000902",48,147,1,0,69,17,0,0,282
"47093001400",637,533,182,1230,0,29,13,149,2773
"47093001500",2342,383,460,161,124,25,13,8,3516
"47093001600",1961,320,266,100,62,0,0,0,2709
"47093001700",1669,528,116,23,24,22,0,20,2402
"47093001800",1631,226,276,72,20,0,26,0,2251
"47093001900",360,279,444,651,80,75,0,147,2036
"47093002000",212,168,1838,855,13,66,19,43,3214
"47093002100",761,545,1190,261,148,30,22,190,3147
"47093002200",2734,635,168,76,16,26,16,27,3698
"47093002300",2067,502,110,205,67,30,107,65,3153
"47093002400",2270,678,193,217,107,137,147,13,3762
"47093002600",1031,780,363,295,112,47,136,276,3040
"47093002700",1797,431,25,163,360,45,298,0,3119
"47093002800",2183,522,544,768,52,161,115,0,4345
"47093002900",1642,837,648,532,49,102,188,9,4007
"47093003000",3119,515,496,67,260,0,67,0,4524
"47093003100",1963,184,375,62,36,24,15,26,2685
"47093003200",870,158,1414,474,74,162,13,45,3210
"47093003300",1507,77,406,92,87,0,42,0,2211
"47093003400",3247,317,140,0,106,9,62,0,3881
"47093003500",3183,690,0,298,169,16,27,20,4403
"47093003700",1800,726,87,99,146,65,189,124,3236
"47093003801",3067,1139,434,15,262,92,351,230,5590
"47093003802",2502,259,243,85,75,44,136,33,3377
"47093003901",2802,301,286,193,252,55,32,107,4028
"47093003902",2249,268,142,55,0,97,161,80,3052
"47093004000",3024,288,175,47,9,17,56,17,3633
"47093004100",3502,492,407,36,91,33,66,43,4670
"47093004200",2980,283,35,52,88,52,38,0,3528
"47093004300",2083,408,73,62,18,12,160,0,2816
"47093004401",4394,260,0,0,160,0,0,0,4814
"47093004403",3744,749,163,45,495,0,40,353,5589
"47093004404",2767,219,38,100,151,0,88,0,3363
"47093004500",4007,281,238,52,653,278,576,91,6176
"47093004606",5405,466,794,0,401,0,274,0,7340
"47093004607",4887,68,276,4,261,29,76,0,5601
"47093004608",2696,92,358,8,123,0,29,0,3306
"47093004609",3827,532,693,29,290,27,296,22,5716
"47093004610",2622,1035,877,39,127,116,361,308,5485
"47093004611",3296,188,488,51,108,0,97,0,4228
"47093004612",2275,69,50,58,39,0,55,66,2612
"47093004613",3907,1042,321,0,51,14,108,405,5848
"47093004614",2456,74,138,0,246,302,34,287,3537
"47093004615",2475,587,381,230,149,150,40,16,4028
"47093004700",3276,255,182,154,144,18,82,0,4111
"47093004800",4405,430,52,114,276,0,43,247,5567
"47093004900",4559,529,159,75,280,0,96,0,5698
"47093005000",3454,328,139,10,94,39,0,0,4064
"47093005100",4639,297,70,70,92,152,63,0,5383
"47093005201",4094,431,311,23,0,20,69,0,4948
"47093005202",2780,433,348,25,132,36,44,17,3815
"47093005301",3508,308,70,0,109,0,0,0,3995
"47093005302",2982,278,0,0,34,0,0,0,3294
"47093005401",3028,235,115,11,160,38,193,0,3780
"47093005402",2509,731,0,8,11,34,15,34,3342
"47093005501",2239,288,0,0,17,31,45,0,2620
"47093005502",2195,275,66,0,0,0,0,0,2536
"47093005602",3714,253,0,0,76,60,97,0,4200
"47093005603",3027,373,92,0,38,0,118,0,3648
"47093005604",2305,163,35,0,69,0,63,0,2635
"47093005701",4028,280,21,0,264,0,199,176,4968
"47093005704",4830,320,280,0,348,51,241,0,6070
"47093005706",3344,213,80,35,336,18,112,0,4138
"47093005707",2917,91,133,0,160,0,24,0,3325
"47093005708",2358,7,422,0,107,0,221,0,3115
"47093005709",1725,30,9,0,106,24,21,0,1915
"47093005710",1726,344,109,0,53,0,43,0,2275
"47093005711",4902,108,279,0,441,0,86,0,5816
"47093005712",6794,648,268,0,607,0,126,429,8872
"47093005803",2141,151,10,0,25,43,72,13,2455
"47093005807",2441,145,70,0,148,25,90,0,2919
"47093005808",4513,443,281,66,340,0,306,0,5949
"47093005809",4331,351,80,0,333,129,194,0,5418
"47093005810",3408,50,14,0,174,0,13,0,3659
"47093005811",2483,22,81,0,160,0,48,0,2794
"47093005812",4147,104,69,0,378,0,33,0,4731
"47093005813",4790,175,220,0,545,48,0,0,5778
"47093005903",3137,148,73,208,130,18,88,45,3847
"47093005904",4068,361,47,0,97,9,81,0,4663
"47093005905",1697,64,5,0,46,0,7,0,1819
"47093005906",1523,85,0,0,15,0,0,0,1623
"47093005907",2365,132,61,0,369,0,177,85,3189
"47093005908",4019,381,84,0,153,0,28,28,4693
"47093006001",2033,330,173,0,60,26,46,0,2668
"47093006002",4729,583,129,74,121,0,57,0,5693
"47093006003",3766,245,19,2,299,0,107,0,4438
"47093006102",4812,382,131,23,35,0,18,0,5401
"47093006103",4723,367,119,0,54,19,132,19,5433
"47093006104",4430,757,0,0,118,102,0,411,5818
"47093006202",4397,434,26,13,66,0,150,96,5182
"47093006203",4768,436,25,0,81,0,213,0,5523
"47093006205",3687,203,58,10,45,58,17,70,4148
"47093006206",4668,162,0,0,133,0,24,0,4987
"47093006207",2930,231,55,0,6,0,12,0,3234
"47093006208",4067,919,0,0,406,72,412,0,5876
"47093006301",2876,225,0,0,73,0,8,0,3182
"47093006302",2359,348,0,41,48,0,71,0,2867
"47093006401",3538,355,114,0,167,0,52,0,4226
"47093006402",4425,234,0,0,0,0,57,0,4716
"47093006403",2499,230,42,0,48,25,0,0,2844
"47093006501",2852,226,33,0,86,29,42,0,3268
"47093006502",2076,652,151,0,35,0,0,0,2914
"47093006600",1901,1002,204,206,124,6,221,0,3664
"47093006700",696,352,800,747,148,80,98,10,2931
"47093006800",695,485,1217,2745,260,58,339,0,5799
"47093006900",1167,3775,242,158,179,38,68,28,5655
"47093007000",913,433,697,281,0,201,53,73,2651
"47093007100",3175,388,47,10,56,0,61,0,3737
"47095960100",1657,633,274,307,0,25,0,24,2920
"47095960200",1491,505,146,98,56,115,75,44,2530
"47097050100",915,336,151,10,0,0,15,16,1443
"47097050200",2424,463,451,547,7,43,63,0,3998
"47097050300",2087,219,265,340,0,0,16,13,2940
"47097050400",2423,423,220,31,43,0,0,0,3140
"47097050503",1504,176,187,61,8,0,14,0,1950
"47097050504",939,324,743,588,148,0,47,0,2789
"47097050505",885,427,1203,1199,60,157,69,0,4000
"47097050506",1181,195,645,270,25,0,64,0,2380
"47097050600",810,254,925,343,159,57,125,38,2711
"47099960100",4346,497,0,1,21,12,5,0,4882
"47099960200",1898,488,12,0,7,0,11,11,2427
"47099960300",4014,1653,0,0,38,36,4,13,5758
"47099960401",4163,602,132,36,132,174,35,182,5456
"47099960402",3088,308,9,0,192,26,72,12,3707
"47099960501",2565,987,108,319,194,190,210,112,4685
"47099960502",3362,494,38,0,61,20,0,20,3995
"47099960600",1648,477,12,0,77,0,0,2,2216
"47099960700",3121,428,0,4,27,61,32,0,3673
"47099960800",3018,449,0,0,0,0,0,0,3467
"47099960900",1556,217,0,0,0,11,0,0,1784
"47101970100",4034,659,56,0,15,0,15,0,4779
"47101970200",5200,1307,43,31,117,355,95,119,7267
"47103975000",1324,208,48,12,63,11,0,0,1666
"47103975100",2064,245,8,9,18,96,13,96,2549
"47103975200",1832,391,14,0,23,13,8,7,2288
"47103975300",3545,583,710,594,252,270,249,192,6395
"47103975400",2358,467,360,108,37,13,0,0,3343
"47103975500",3999,897,0,0,90,17,3,5,5011
"47103975601",3890,507,183,0,132,107,75,91,4985
"47103975602",3315,496,17,0,145,56,134,3,4166
"47103975700",3094,280,18,0,57,0,63,0,3512
"47105060100",4149,445,17,15,159,0,49,0,4834
"47105060201",2688,950,76,0,52,0,0,597,4363
"47105060202",4425,2567,90,176,458,12,1042,932,9702
"47105060301",2790,275,0,46,160,67,62,67,3467
"47105060302",5323,319,18,0,65,0,0,0,5725
"47105060400",3711,498,42,0,153,0,0,0,4404
"47105060501",8237,618,0,0,67,6,37,0,8965
"47105060502",2092,431,12,0,16,11,56,0,2618
"47105060600",3446,688,116,27,239,64,344,285,5209
"47105060700",2186,637,37,0,0,0,0,28,2888
"47107970101",4933,958,304,29,89,0,87,36,6436
"47107970102",3918,431,183,0,89,34,156,2,4813
"47107970200",3590,1864,417,217,132,153,107,173,6653
"47107970300",2015,345,178,19,164,23,83,10,2837
"47107970401",2870,580,0,0,65,0,119,64,3698
"47107970402",3947,605,238,38,102,0,0,189,5119
"47107970500",2939,1004,98,0,94,27,0,244,4406
"47107970600",5003,1415,210,12,171,0,32,17,6860
"47107970700",3482,496,79,14,18,13,0,0,4102
"47107970800",6259,941,82,30,146,145,39,124,7766
"47109930100",3133,749,0,20,73,16,0,0,3991
"47109930200",1625,469,7,6,16,0,37,20,2180
"47109930300",2529,830,139,16,48,4,8,0,3574
"47109930400",1635,314,27,3,27,30,22,10,2068
"47109930500",4485,1419,542,286,0,168,104,83,7087
"47109930600",2978,552,160,32,111,49,3,61,3946
"47109930700",2213,680,56,86,59,57,0,49,3200
"47111970100",3166,830,8,44,119,87,246,148,4648
"47111970200",4826,490,0,0,193,0,0,0,5509
"47111970300",6001,1718,0,0,224,188,194,109,8434
"47111970400",2821,1264,29,0,15,56,148,167,4500
"47113000100",1243,199,1428,391,86,0,138,26,3511
"47113000200",1722,346,2169,1223,64,0,208,0,5732
"47113000300",2402,271,976,698,78,0,92,0,4517
"47113000400",622,285,1795,936,17,0,0,0,3655
"47113000500",119,122,1504,2522,0,29,0,0,4296
"47113000600",605,114,769,426,0,0,47,0,1961
"47113000700",635,258,794,461,0,66,41,19,2274
"47113000800",153,87,127,381,0,43,5,15,811
"47113000900",51,64,1253,1029,0,36,0,0,2433
"47113001000",184,44,1414,489,0,17,0,17,2165
"47113001100",0,0,559,326,0,31,0,24,940
"47113001300",4158,1021,416,111,107,20,97,70,6000
"47113001401",931,300,343,50,63,49,0,71,1807
"47113001402",1688,130,315,140,36,0,22,0,2331
"47113001501",2841,84,1379,321,104,41,51,0,4821
"47113001502",4813,933,325,59,19,28,0,28,6205
"47113001603",1765,86,532,139,82,0,109,0,2713
"47113001604",2237,190,377,74,78,0,76,181,3213
"47113001605",932,298,405,58,139,6,0,24,1862
"47113001606",5009,754,2728,238,318,443,419,63,9972
"47113001607",4220,453,1170,49,293,113,859,314,7471
"47113001608",1714,109,255,0,28,3,4,0,2113
"47113001609",1423,61,65,162,50,0,0,0,1761
"47113001610",4927,83,390,51,117,0,114,0,5682
"47113001700",718,134,684,102,4,0,0,0,1642
"47113001800",1814,229,901,362,28,4,56,47,3441
"47113001900",3431,477,288,13,18,0,0,0,4227
"47115050101",2695,591,1,0,150,8,8,0,3453
"47115050102",5355,1073,8,0,175,60,56,50,6777
"47115050201",3341,635,17,14,265,27,207,0,4506
"47115050202",4038,1139,42,31,154,75,0,0,5479
"47115050301",3975,778,209,119,85,87,22,41,5316
"47115050302",2242,356,0,0,46,63,0,0,2707
"47117955000",5839,941,76,5,11,12,49,0,6933
"47117955100",4591,446,88,14,88,0,279,14,5520
"47117955200",4183,657,288,14,136,65,10,0,5353
"47117955300",1791,1146,933,194,263,40,293,168,4828
"47117955400",3016,389,119,181,262,70,294,183,4514
"47117955500",3613,752,189,9,62,8,71,52,4756
"47119010100",2621,345,127,0,79,13,0,18,3203
"47119010201",4919,315,75,0,136,0,438,0,5883
"47119010202",6495,233,438,169,236,14,165,42,7792
"47119010301",5305,185,449,19,206,55,59,0,6278
"47119010302",2688,120,88,4,180,7,130,66,3283
"47119010400",3924,892,500,234,115,83,79,349,6176
"47119010500",1562,688,1723,769,42,39,90,24,4937
"47119010600",2657,509,764,170,173,378,576,499,5726
"47119010700",3048,1132,259,209,37,0,10,97,4792
"47119010801",2582,315,114,41,59,39,67,142,3359
"47119010802",3182,1371,576,528,261,45,442,141,6546
"47119010900",2395,546,224,162,104,0,26,0,3457
"47119011001",2216,167,219,54,76,0,0,0,2732
"47119011002",4499,884,831,167,104,364,133,14,6996
"47119011101",3771,131,200,73,278,39,42,22,4556
"47119011102",2085,424,182,32,10,0,16,191,2940
"47119011200",4872,417,198,4,186,38,123,0,5838
"47121960100",2603,766,25,0,0,0,0,0,3394
"47121960200",3194,816,24,0,9,0,24,10,4077
"47121960300",3043,607,137,0,92,191,0,0,4070
"47123925000",5764,744,28,16,185,11,65,90,6903
"47123925100",7076,1409,54,0,292,14,746,0,9591
"47123925200",2665,731,402,62,92,149,0,77,4178
"47123925300",5980,1361,54,26,36,85,55,138,7735
"47123925400",5767,2121,53,18,121,93,50,217,8440
"47123925501",2310,537,0,0,34,1,0,0,2882
"47123925502",4390,1276,0,0,198,23,61,46,5994
"47125100100",308,276,46,56,39,51,130,8,914
"47125100200",1084,342,193,40,76,41,62,0,1838
"47125100300",3102,1223,788,153,129,73,215,0,5683
"47125100400",1022,264,811,694,320,44,114,70,3339
"47125100500",2919,1000,170,106,322,81,504,200,5302
"47125100601",1853,210,5,12,66,0,53,29,2228
"47125100602",2406,308,45,19,58,0,139,9,2984
"47125100700",617,66,467,84,16,16,6,0,1272
"47125100800",312,307,522,558,27,27,0,20,1773
"47125100900",538,506,350,554,190,102,188,97,2525
"47125101001",2387,662,501,480,248,244,257,220,4999
"47125101002",1764,246,769,144,472,81,306,27,3809
"47125101101",1313,183,600,202,115,48,75,72,2608
"47125101102",4296,998,1420,614,553,50,560,204,8695
"47125101103",1757,533,285,62,83,33,229,13,2995
"47125101201",715,99,864,254,270,95,327,50,2674
"47125101202",2148,427,557,34,173,21,263,31,3654
"47125101303",3865,504,2460,210,1239,107,914,33,9332
"47125101304",2543,320,1473,529,632,6,423,66,5992
"47125101305",1712,173,971,416,228,27,287,97,3911
"47125101306",2495,717,883,451,478,0,965,0,5989
"47125101307",771,151,560,842,278,25,62,6,2695
"47125101400",3292,571,439,194,626,165,702,169,6158
"47125101500",5967,418,369,8,659,97,670,113,8301
"47125101600",3697,1277,128,199,59,12,103,0,5475
"47125101700",6811,618,234,20,145,16,42,32,7918
"47125101802",8611,619,340,86,130,101,290,37,10214
"47125101803",5417,880,352,50,522,0,223,0,7444
"47125101804",5060,427,272,0,720,144,157,57,6837
"47125101902",2313,276,63,0,224,39,115,0,3030
"47125101903",5417,760,1282,166,668,258,613,173,9337
"47125101904",2194,32,245,15,44,107,295,107,3039
"47125102001",3201,283,550,139,308,156,260,130,5027
"47125102002",4791,597,1134,30,819,91,832,80,8374
"47125102003",2522,262,1739,131,487,150,754,86,6131
"47125102004",2676,521,1058,93,398,0,406,112,5264
"47125102005",2744,235,513,437,477,86,339,67,4898
"47125102006",3389,355,1278,162,364,33,501,33,6115
"47125980100",0,0,0,0,0,0,0,0,0
"47127930100",3117,483,50,3,69,20,0,0,3742
"47127930200",1926,220,99,17,52,67,7,0,2388
"47129110100",1872,548,4,0,65,19,0,3,2511
"47129110200",2603,709,0,4,81,0,18,0,3415
"47129110300",2980,645,0,0,47,2,50,108,3832
"47129110400",3737,573,0,0,0,46,0,9,4365
"47129110500",3495,1390,1,0,98,0,14,0,4998
"47131965000",3412,338,457,58,21,14,0,0,4300
"47131965100",2396,233,123,34,24,0,27,26,2863
"47131965200",1942,216,11,1,19,0,10,0,2199
"47131965300",2688,712,0,5,94,46,24,109,3678
"47131965400",3601,708,10,20,75,3,82,20,4519
"47131965500",1637,459,93,147,11,64,7,24,2442
"47131965600",1625,525,962,591,38,72,111,123,4047
"47131965700",3413,420,261,441,17,25,339,0,4916
"47131965800",1440,237,29,0,4,0,62,7,1779
"47131965900",992,179,21,0,45,5,55,0,1297
"47133950100",1272,492,0,0,0,0,0,0,1764
"47133950200",1357,244,0,0,4,11,31,0,1647
"47133950301",3367,912,52,38,7,43,0,0,4419
"47133950302",2437,670,0,0,15,6,0,187,3315
"47133950400",1656,403,0,0,33,9,16,0,2117
"47133950500",4527,1337,0,0,72,112,0,0,6048
"47133950600",2098,619,0,0,19,0,0,0,2736
"47135930100",2155,626,0,0,59,44,6,14,2904
"47135930200",3698,868,85,82,73,0,124,0,4930
"47137925100",3978,926,4,0,23,23,0,0,4954
"47139950100",957,341,0,0,10,0,0,0,1308
"47139950201",1652,135,1,10,1,3,18,13,1833
"47139950202",5074,1018,0,0,76,15,0,70,6253
"47139950300",2708,695,0,0,37,27,127,0,3594
"47139950400",2943,568,0,0,155,26,1,26,3719
"47141000100",3454,1577,7,13,0,45,340,585,6021
"47141000200",6909,1158,108,301,134,0,22,0,8632
"47141000301",2541,229,0,0,133,0,34,0,2937
"47141000302",3387,3500,0,245,0,85,171,645,8033
"47141000303",1575,794,25,40,181,0,232,181,3028
"47141000400",2690,539,15,2,245,0,6,9,3506
"47141000500",1210,860,23,18,0,117,8,376,2612
"47141000600",2452,529,0,106,313,0,14,0,3414
"47141000700",1817,1494,0,26,82,66,271,134,3890
"47141000800",1554,1775,86,112,95,159,55,53,3889
"47141000900",4668,1331,159,14,100,2,47,87,6408
"47141001000",2720,484,0,0,69,0,33,17,3323
"47141001100",5080,1169,14,0,254,19,331,19,6886
"47141001200",6926,1367,47,16,154,0,97,0,8607
"47141001300",1902,162,41,0,92,146,17,137,2497
"47143975000",3805,886,79,112,44,69,9,38,5042
"47143975100",3738,457,27,0,16,8,69,0,4315
"47143975200",4316,1049,20,0,107,213,107,42,5854
"47143975300",3814,1720,98,14,33,107,40,108,5934
"47143975401",4394,1791,230,85,202,30,289,375,7396
"47143975402",2972,451,21,1,37,0,58,74,3614
"47145030100",2925,127,187,0,53,0,30,0,3322
"47145030201",5655,628,74,0,114,0,145,0,6616
"47145030202",5907,431,162,40,179,0,167,0,6886
"47145030300",4956,1340,13,0,68,14,17,83,6491
"47145030400",6038,583,78,6,107,12,70,0,6894
"47145030500",2090,934,104,199,123,0,0,0,3450
"47145030600",2918,694,68,5,182,39,45,0,3951
"47145030700",3952,517,40,1,29,221,29,122,4911
"47145030800",3959,1067,240,42,71,42,22,34,5477
"47145030900",4581,922,125,10,137,74,0,0,5849
"47145980100",0,0,0,0,0,0,0,0,0
"47147080101",3025,427,171,3,45,49,58,20,3798
"47147080103",5280,475,45,0,58,201,304,154,6517
"47147080104",6210,740,77,46,57,12,436,0,7578
"47147080200",4614,928,195,20,229,163,125,259,6533
"47147080301",1577,164,432,370,135,186,355,174,3393
"47147080302",1247,308,420,547,106,0,381,162,3171
"47147080401",2245,661,889,562,319,91,411,159,5337
"47147080402",3363,335,463,70,184,73,290,128,4906
"47147080500",3685,249,278,7,100,14,8,0,4341
"47147080603",3484,272,26,0,80,0,60,30,3952
"47147080604",3427,526,0,5,47,0,0,0,4005
"47147080605",2744,188,0,0,139,0,63,0,3134
"47147080606",4526,376,276,0,130,0,206,6,5520
"47147080700",6585,503,105,0,302,8,90,0,7593
"47149040101",1702,778,664,0,61,66,495,406,4172
"47149040102",2729,119,686,10,87,8,670,98,4407
"47149040103",4232,677,1894,360,158,227,1902,612,10062
"47149040104",3082,356,890,97,542,41,986,48,6042
"47149040105",3314,257,834,65,154,25,118,139,4906
"47149040200",2569,358,328,89,327,10,191,7,3879
"47149040302",7072,484,423,0,406,321,1020,184,9910
"47149040303",1569,503,16,0,23,55,23,27,2216
"47149040304",1589,111,237,89,62,0,117,0,2205
"47149040305",1109,423,256,4,134,0,70,0,1996
"47149040306",3122,90,464,111,114,0,681,0,4582
"47149040307",2458,87,211,0,127,0,13,18,2914
"47149040308",4219,488,821,0,426,0,411,158,6523
"47149040403",5027,1162,95,476,655,0,694,484,8593
"47149040501",6266,205,244,49,301,0,231,0,7296
"47149040502",6288,247,265,65,59,18,42,0,6984
"47149040600",3906,323,225,8,9,20,0,0,4491
"47149040701",6855,420,723,108,357,449,216,232,9360
"47149040702",4358,252,443,22,32,0,118,0,5225
"47149040805",6257,393,1286,0,612,0,93,0,8641
"47149040806",6568,650,156,0,361,20,610,18,8383
"47149040807",3960,109,356,0,637,8,131,0,5201
"47149040808",5751,490,446,49,471,41,281,0,7529
"47149040809",3453,229,87,0,57,0,168,0,3994
"47149040810",2038,221,27,3,109,0,0,3,2401
"47149040901",1915,103,342,0,113,0,0,0,2473
"47149040902",7183,451,783,190,334,0,410,0,9351
"47149040903",8064,581,1572,0,384,69,395,124,11189
"47149040904",3490,284,464,0,380,97,5,110,4830
"47149040905",5565,532,944,18,474,164,94,24,7815
"47149041000",5610,437,567,165,47,76,28,108,7038
"47149041101",5708,352,739,45,61,101,161,42,7209
"47149041102",1971,540,379,63,130,22,9,22,3136
"47149041201",3999,654,562,23,172,70,21,0,5501
"47149041202",2854,197,271,88,266,130,131,0,3937
"47149041301",4547,174,276,0,325,0,169,0,5491
"47149041302",4268,255,312,266,261,0,55,48,5465
"47149041401",2925,723,347,204,378,60,59,147,4843
"47149041402",3231,1315,622,321,157,126,344,158,6274
"47149041403",3932,1395,1091,699,375,121,173,55,7841
"47149041500",0,15,0,0,0,0,0,0,15
"47149041600",2849,1229,742,838,241,258,188,306,6651
"47149041700",3149,917,458,47,502,0,109,92,5274
"47149041800",1497,799,420,208,294,146,66,176,3606
"47149041900",1085,704,1055,417,177,56,274,84,3852
"47149042000",2947,372,429,257,413,285,334,169,5206
"47149042100",3532,1647,1143,625,550,138,371,290,8296
"47149042200",3582,695,308,157,277,132,284,299,5734
"47149042300",4482,616,1288,40,709,213,399,77,7824
"47151975000",2756,1182,0,0,51,55,0,0,4044
"47151975100",5077,1665,0,0,48,0,0,0,6790
"47151975200",3839,1921,4,0,63,10,147,0,5984
"47151975300",1701,580,0,0,5,7,0,0,2293
"47151975400",2003,702,1,1,0,5,0,39,2751
"47153060101",6099,1152,0,0,552,493,86,209,8591
"47153060102",1768,367,0,0,18,40,0,34,2227
"47153060200",3084,373,0,0,129,23,110,29,3748
"47155080101",2814,714,19,0,58,97,61,97,3860
"47155080102",5462,688,92,0,218,69,59,69,6657
"47155080201",6937,237,37,0,334,0,465,0,8010
"47155080202",4826,547,0,72,149,27,153,130,5904
"47155080300",4378,567,0,0,122,0,18,0,5085
"47155080400",6377,598,0,0,49,43,219,0,7286
"47155080500",3331,1325,0,0,165,476,130,503,5930
"47155080601",3181,490,1,56,274,35,377,173,4587
"47155080602",8208,1068,1,0,123,17,29,1,9447
"47155080700",6305,918,0,0,248,115,93,80,7759
"47155080801",1493,727,201,0,177,80,452,301,3431
"47155080802",5362,732,9,0,244,0,692,202,7241
"47155080901",2638,462,0,0,10,0,23,0,3133
"47155080902",4111,887,16,0,112,10,170,0,5306
"47155081000",3991,1260,106,1,120,0,240,93,5811
"47155081101",1175,176,7,0,171,16,0,12,1557
"47155081102",3374,541,0,0,159,0,0,0,4074
"47155980100",0,0,0,0,0,0,0,0,0
"47157000100",3419,841,837,185,625,107,282,18,6314
"47157000200",5,0,654,427,0,8,0,0,1094
"47157000300",0,0,554,490,0,0,0,0,1044
"47157000400",2,5,876,706,0,14,0,0,1603
"47157000600",10,0,1103,1090,0,0,0,0,2203
"47157000700",193,148,2580,1532,142,0,0,0,4595
"47157000800",7,46,1159,1111,0,0,0,0,2323
"47157000900",79,1,1788,1277,12,0,12,0,3169
"47157001100",590,586,1203,643,510,54,534,306,4426
"47157001200",1654,754,421,264,43,103,60,214,3513
"47157001300",380,60,1096,1269,133,156,79,149,3322
"47157001400",143,37,834,207,10,10,30,33,1304
"47157001500",163,87,730,534,15,9,21,0,1559
"47157001600",1567,145,376,11,49,4,17,0,2169
"47157001700",1305,33,1581,514,191,12,10,0,3646
"47157001900",0,6,829,554,0,0,0,0,1389
"47157002000",36,109,795,647,54,36,0,16,1693
"47157002100",116,44,649,382,5,0,0,0,1196
"47157002400",63,95,1061,639,123,72,103,141,2297
"47157002500",878,146,891,685,330,196,18,153,3297
"47157002600",1994,140,190,2,196,20,65,8,2615
"47157002700",547,327,223,1239,97,6,82,180,2701
"47157002800",541,22,1630,1440,28,5,0,0,3666
"47157002900",3823,335,193,35,107,126,175,0,4794
"47157003000",1308,59,696,606,97,27,25,37,2855
"47157003100",2142,313,276,158,121,48,118,48,3224
"47157003200",1639,523,289,107,56,62,73,20,2769
"47157003300",2270,161,0,0,77,0,62,0,2570
"47157003400",1319,173,230,178,51,5,119,0,2075
"47157003500",2434,157,589,181,136,21,19,0,3537
"47157003600",516,518,267,234,163,49,67,148,1962
"47157003700",216,108,484,399,5,25,0,15,1252
"47157003800",86,125,358,186,243,75,0,13,1086
"47157003900",59,129,422,593,65,11,12,76,1367
"47157004200",1542,212,380,53,125,92,112,71,2587
"47157004300",834,70,317,20,73,28,10,0,1352
"47157004500",21,0,235,517,6,3,0,0,782
"47157004600",104,41,576,463,14,21,0,0,1219
"47157005000",0,10,412,607,0,0,0,0,1029
"47157005300",19,19,2056,1688,0,0,0,12,3794
"47157005500",27,27,1228,1172,11,49,0,0,2514
"47157005600",0,0,2622,1187,44,0,0,0,3853
"47157005700",24,0,1642,577,7,6,0,0,2256
"47157005800",0,0,402,594,0,0,0,0,996
"47157005900",9,10,1626,1308,69,10,23,0,3055
"47157006000",0,8,1064,907,18,19,0,8,2024
"47157006200",27,13,1588,754,11,0,0,14,2407
"47157006300",1514,127,255,254,33,0,48,0,2231
"47157006400",0,21,924,413,42,14,0,0,1414
"47157006500",0,7,2200,1049,0,9,0,0,3265
"47157006600",886,190,605,282,143,5,27,18,2156
"47157006700",43,20,1885,1701,0,0,0,39,3688
"47157006800",0,50,915,1726,128,0,42,0,2861
"47157006900",123,47,2062,1013,19,27,0,0,3291
"47157007000",690,241,1237,1243,141,94,146,91,3883
"47157007100",1660,115,391,193,70,0,21,0,2450
"47157007200",1888,183,84,12,193,0,24,0,2384
"47157007300",1236,312,174,275,30,145,10,0,2182
"47157007400",1611,421,259,66,211,261,148,7,2984
"47157007500",18,60,807,510,0,0,0,0,1395
"47157007810",24,107,1664,972,84,0,84,14,2949
"47157007821",8,7,3127,2178,2,0,8,0,5330
"47157007822",52,0,750,470,191,167,208,167,2005
"47157007900",116,0,3420,2434,0,13,0,0,5983
"47157008000",1020,74,2482,1286,111,98,37,26,5134
"47157008110",268,272,1167,898,99,252,207,367,3530
"47157008120",86,163,2959,1255,0,20,0,69,4552
"47157008200",177,386,1472,1701,947,849,899,877,7308
"47157008500",3619,186,48,24,140,16,10,0,4043
"47157008600",4418,137,248,949,366,16,120,0,6254
"47157008700",2875,211,315,44,231,526,407,255,4864
"47157008800",3078,1983,321,162,1029,169,1762,1548,10052
"47157008900",1025,989,747,473,518,198,649,775,5374
"47157009100",1408,644,26,0,206,193,432,399,3308
"47157009200",6319,448,53,2,499,332,13,90,7756
"47157009300",2712,347,162,946,124,178,0,214,4683
"47157009400",2777,158,183,1,84,0,120,0,3323
"47157009500",5243,204,512,0,143,0,31,0,6133
"47157009600",4567,150,96,32,91,20,21,9,4986
"47157009700",980,53,1090,218,181,255,302,0,3079
"47157009800",2185,655,354,88,73,84,717,265,4421
"47157009901",1110,417,669,814,657,254,666,408,4995
"47157009902",246,358,1106,968,55,174,0,0,2907
"47157010000",435,329,4069,2585,89,154,0,64,7725
"47157010110",532,17,2762,3765,143,0,0,0,7219
"47157010120",474,210,2149,2199,0,41,64,73,5210
"47157010210",214,102,2499,2592,157,45,0,0,5609
"47157010220",789,203,3516,1833,24,72,27,49,6513
"47157010300",0,4,780,591,35,15,0,0,1425
"47157010500",269,0,497,871,102,29,167,13,1948
"47157010610",497,115,3999,1685,697,156,690,271,8110
"47157010620",238,55,1809,1413,125,119,173,156,4088
"47157010630",358,118,1905,1094,427,500,704,618,5724
"47157010710",853,171,3072,780,156,282,364,347,6025
"47157010720",361,154,1792,1239,103,13,87,123,3872
"47157010810",242,48,3988,1474,485,218,197,168,6820
"47157010820",567,22,3457,486,371,179,213,192,5487
"47157011010",847,667,2130,500,10,376,131,618,5279
"47157011020",19,52,750,432,53,58,0,43,1407
"47157011100",0,9,1079,723,13,10,0,0,1834
"47157011200",0,9,605,904,24,12,0,0,1554
"47157011300",167,31,422,1044,98,0,13,0,1775
"47157011400",255,147,782,1658,5,128,34,14,3023
"47157011500",149,0,1193,1142,13,0,0,0,2497
"47157011600",0,75,1235,1369,6,38,0,95,2818
"47157011700",0,0,1025,614,0,0,0,0,1639
"47157011800",1825,343,1611,830,481,150,595,482,6317
"47157020101",1193,303,1551,1525,121,66,0,0,4759
"47157020102",2237,202,385,48,58,0,16,0,2946
"47157020210",3465,407,1314,414,180,34,127,5,5946
"47157020221",1818,105,692,55,68,137,199,134,3208
"47157020222",1425,227,1006,336,219,0,145,119,3477
"47157020300",3555,404,273,669,139,54,76,164,5334
"47157020400",766,5,316,4,81,5,204,0,1381
"47157020511",292,78,1488,354,141,36,45,21,2455
"47157020512",644,263,2803,1697,0,19,0,96,5522
"47157020521",135,83,2093,1507,54,93,0,59,4024
"47157020523",94,62,1740,1306,64,218,51,86,3621
"47157020524",624,116,2870,629,0,0,150,153,4542
"47157020531",1020,627,3072,949,146,386,257,744,7201
"47157020532",906,70,3958,480,191,0,208,14,5827
"47157020541",1062,86,3281,713,87,0,74,0,5303
"47157020542",1100,73,2243,1093,383,0,129,0,5021
"47157020610",1099,201,2035,373,351,22,227,22,4330
"47157020621",2281,267,3471,513,398,26,341,64,7361
"47157020622",3282,189,528,26,134,11,0,0,4170
"47157020632",4432,73,538,25,243,0,118,0,5429
"47157020633",2628,74,260,9,248,11,29,3,3262
"47157020634",2547,11,33,0,337,73,164,0,3165
"47157020635",2417,272,164,0,157,0,79,4,3093
"47157020642",5405,115,2118,14,456,0,73,0,8181
"47157020643",5681,280,1839,48,346,0,259,35,8488
"47157020644",3644,190,3821,298,783,113,1128,59,10036
"47157020651",4226,134,1557,484,703,13,329,0,7446
"47157020652",4522,334,446,152,110,0,45,32,5641
"47157020700",2071,136,301,37,29,0,32,12,2618
"47157020810",2498,34,489,318,60,5,60,0,3464
"47157020820",6707,431,826,0,353,40,162,0,8519
"47157020831",3428,146,485,21,284,0,14,0,4378
"47157020832",6897,69,1224,124,335,0,142,0,8791
"47157020900",7724,69,631,53,705,0,97,0,9279
"47157021010",7859,167,5170,755,1402,241,621,151,16366
"47157021020",3902,95,1156,297,615,142,440,212,6859
"47157021111",1775,257,1371,303,523,126,637,192,5184
"47157021112",3300,417,943,504,884,120,1223,257,7648
"47157021113",2032,215,1020,284,224,47,39,50,3911
"47157021121",2336,121,1543,272,110,1,48,8,4439
"47157021122",2345,455,1551,140,572,0,8,158,5229
"47157021124",2855,322,3339,438,1593,54,1177,54,9832
"47157021125",2551,185,594,81,395,0,173,0,3979
"47157021126",2407,68,886,49,364,70,247,22,4113
"47157021135",3666,296,1618,69,400,47,55,77,6228
"47157021136",2974,28,1430,240,421,16,71,0,5180
"47157021137",4424,735,1515,56,986,17,431,0,8164
"47157021138",1762,98,976,0,167,0,36,33,3072
"47157021139",3312,143,495,11,234,0,147,0,4342
"47157021140",3482,122,580,308,277,142,214,37,5162
"47157021141",3640,142,2222,236,523,29,273,3,7068
"47157021142",2191,142,887,3,203,0,48,0,3474
"47157021200",0,0,0,0,0,0,0,0,0
"47157021311",3985,148,545,0,23,0,112,42,4855
"47157021312",1835,118,114,79,148,10,69,0,2373
"47157021320",4257,63,1307,59,93,21,110,0,5910
"47157021331",2292,137,479,196,214,0,261,0,3579
"47157021333",2252,35,1246,439,429,9,398,0,4808
"47157021334",1193,10,1838,264,283,0,186,0,3774
"47157021341",4521,250,327,13,152,18,103,0,5384
"47157021342",4528,170,2618,553,780,119,313,193,9274
"47157021351",3333,126,251,17,627,0,93,0,4447
"47157021352",6339,160,175,0,347,0,156,0,7177
"47157021353",7557,539,664,1,1069,19,203,406,10458
"47157021410",2417,56,23,0,226,0,9,0,2731
"47157021420",2861,58,37,0,276,15,190,0,3437
"47157021430",3520,76,218,37,108,0,225,0,4184
"47157021510",1908,159,5165,582,645,0,264,56,8779
"47157021520",5575,434,2904,62,1696,157,309,0,11137
"47157021530",4345,225,223,0,357,89,27,89,5355
"47157021540",9595,118,551,21,1313,0,522,0,12120
"47157021611",5197,393,138,11,186,37,26,0,5988
"47157021612",4512,66,120,7,89,0,95,0,4889
"47157021613",4090,32,230,0,297,14,82,0,4745
"47157021620",1174,44,1014,441,162,0,222,0,3057
"47157021710",179,197,1435,624,89,0,102,167,2793
"47157021721",175,35,2684,1501,233,295,174,295,5392
"47157021724",110,66,1352,412,307,10,339,49,2645
"47157021725",469,21,3059,459,487,146,782,146,5569
"47157021726",764,178,1948,1174,14,359,21,196,4654
"47157021731",153,155,1465,637,294,432,235,532,3903
"47157021732",428,12,3821,1634,498,300,596,300,7589
"47157021741",899,19,4520,1177,514,130,892,88,8239
"47157021744",515,76,4996,245,529,210,384,210,7165
"47157021745",1319,63,5744,314,634,0,551,62,8687
"47157021746",473,10,3012,515,286,0,194,0,4490
"47157021747",305,50,3529,473,28,63,19,63,4530
"47157021751",380,9,5598,705,72,0,0,0,6764
"47157021752",292,181,3835,334,236,0,184,60,5122
"47157021753",184,105,2380,145,298,37,314,37,3500
"47157021754",574,117,3512,268,232,103,148,103,5057
"47157021900",89,46,3727,1328,0,0,10,0,5200
"47157022022",29,152,2972,965,0,8,3,148,4277
"47157022023",0,0,1701,517,3,0,0,0,2221
"47157022024",147,20,2785,651,0,0,0,0,3603
"47157022111",103,12,3756,2154,26,0,72,0,6123
"47157022112",61,84,4414,1666,13,0,0,0,6238
"47157022121",199,10,3434,905,6,0,6,0,4560
"47157022122",97,27,2699,1117,19,0,15,0,3974
"47157022130",256,17,3493,1981,151,22,0,0,5920
"47157022210",28,0,3111,1339,46,12,0,0,4536
"47157022220",59,8,2349,1599,21,70,43,38,4187
"47157022310",33,0,3573,2104,19,0,0,0,5729
"47157022321",0,37,2458,813,0,0,0,37,3345
"47157022322",24,0,3373,797,34,0,0,0,4228
"47157022330",148,140,3743,796,91,81,240,221,5460
"47157022410",238,247,5392,1050,73,75,12,308,7395
"47157022500",299,453,3466,294,174,132,421,528,5767
"47157022600",234,61,1972,1171,426,397,415,433,5109
"47157022700",104,26,5078,2546,67,160,0,0,7981
"47157980100",14,14,0,43,0,0,0,0,71
"47157980200",0,0,0,0,0,0,0,0,0
"47157980300",0,0,0,0,0,0,0,0,0
"47157980400",0,0,0,0,0,0,0,0,0
"47159975000",3023,738,19,0,21,1,42,160,4004
"47159975100",1716,531,89,55,30,42,22,0,2485
"47159975200",4482,887,109,10,321,133,88,135,6165
"47159975300",1563,486,4,0,44,0,0,0,2097
"47159975400",3671,748,33,0,25,19,11,0,4507
"47161110200",4302,975,56,0,159,100,54,100,5746
"47161110600",1968,626,95,48,91,20,5,0,2853
"47161110700",3766,701,0,18,109,150,71,47,4862
"47161980100",0,0,0,0,0,0,0,0,0
"47161980200",0,0,0,0,0,0,0,0,0
"47163040200",713,818,474,193,28,113,12,71,2422
"47163040300",1823,398,55,46,93,16,65,0,2496
"47163040500",2242,1550,100,25,93,224,27,228,4489
"47163040600",1577,1089,60,0,94,0,80,0,2900
"47163040700",2125,153,103,24,11,60,26,17,2519
"47163040800",1925,740,30,8,312,26,201,0,3242
"47163040900",2645,545,45,0,94,68,63,35,3495
"47163041000",3521,326,12,0,0,66,29,77,4031
"47163041100",1946,331,20,33,34,15,7,0,2386
"47163041200",5578,605,129,0,90,89,13,20,6524
"47163041300",3451,490,10,12,42,55,0,0,4060
"47163041400",4372,624,0,2,131,0,85,0,5214
"47163041500",2356,51,8,0,97,0,13,25,2550
"47163041600",2093,168,51,12,45,13,89,13,2484
"47163041700",2413,895,0,0,125,0,0,45,3478
"47163041800",2715,1416,0,203,356,290,156,0,5136
"47163041900",2795,519,0,0,20,0,0,0,3334
"47163042000",2931,644,0,0,5,0,0,0,3580
"47163042100",4325,759,71,4,187,203,30,37,5616
"47163042200",3025,644,28,0,14,0,56,175,3942
"47163042300",6030,335,33,0,46,0,0,0,6444
"47163042400",2320,810,0,0,63,13,0,0,3206
"47163042500",3013,393,17,0,54,0,24,0,3501
"47163042600",3304,372,109,127,238,85,212,77,4524
"47163042701",3493,1381,57,31,116,100,8,89,5275
"47163042702",1762,326,17,0,36,19,16,19,2195
"47163042801",1948,355,82,0,0,0,15,0,2400
"47163042802",2649,780,88,162,0,55,0,65,3799
"47163042900",3704,171,49,3,86,13,7,1,4034
"47163043000",3395,773,55,0,68,14,0,23,4328
"47163043100",2559,378,9,4,35,23,2,23,3033
"47163043201",4252,224,18,0,66,0,0,0,4560
"47163043202",4197,857,0,0,21,0,12,0,5087
"47163043301",5068,368,0,0,33,0,0,0,5469
"47163043302",4468,1466,51,1,126,73,7,0,6192
"47163043401",3653,1579,0,1,141,31,0,0,5405
"47163043402",2906,989,21,2,166,0,0,0,4084
"47163043500",3179,362,10,0,23,9,22,9,3614
"47163043600",4032,773,29,24,106,44,38,3,5049
"47165020101",2696,571,0,0,0,18,0,0,3285
"47165020102",4130,786,0,0,23,56,46,0,5041
"47165020203",2013,164,0,0,46,0,50,0,2273
"47165020204",2659,235,3,0,77,31,12,0,3017
"47165020205",2270,222,321,0,371,0,100,62,3346
"47165020206",889,113,60,0,32,0,114,5,1213
"47165020207",1321,85,3,0,10,0,21,0,1440
"47165020208",1733,320,81,0,28,0,74,9,2245
"47165020209",1832,157,0,0,0,4,0,0,1993
"47165020300",3788,743,32,87,117,221,54,133,5175
"47165020403",1486,244,0,0,0,0,0,0,1730
"47165020404",1781,233,0,0,6,0,0,49,2069
"47165020405",1668,290,13,0,26,0,0,0,1997
"47165020406",2987,362,0,0,24,0,27,52,3452
"47165020407",3706,140,47,0,160,0,103,0,4156
"47165020501",4633,220,144,0,108,0,101,0,5206
"47165020502",3053,151,507,0,12,0,12,0,3735
"47165020503",1792,110,0,0,0,0,30,0,1932
"47165020601",2999,374,59,0,8,20,0,0,3460
"47165020602",3910,122,39,0,56,66,32,35,4260
"47165020603",3267,488,14,0,41,0,0,0,3810
"47165020700",2576,475,403,230,77,30,193,37,4021
"47165020800",2416,1008,2051,501,142,196,633,611,7558
"47165020901",1196,188,5,42,0,0,99,13,1543
"47165020902",5277,768,617,38,161,84,663,7,7615
"47165020903",2891,386,83,136,228,0,128,29,3881
"47165021002",5947,73,913,0,143,103,174,0,7353
"47165021004",3244,381,297,0,94,0,261,161,4438
"47165021005",5008,299,433,0,531,12,266,12,6561
"47165021006",2761,85,107,0,11,0,11,0,2975
"47165021007",1755,212,173,0,129,0,72,0,2341
"47165021008",3098,175,131,0,235,0,11,37,3687
"47165021009",3703,453,93,173,142,15,280,44,4903
"47165021103",4560,630,418,13,91,62,296,52,6122
"47165021104",1800,130,30,0,137,0,65,0,2162
"47165021105",5312,346,553,59,318,137,283,256,7264
"47165021106",3030,343,436,18,81,72,85,76,4141
"47165021107",3546,196,184,0,119,51,228,2,4326
"47165021201",5771,434,461,0,191,0,0,0,6857
"47165021203",4480,224,71,0,107,0,203,0,5085
"47165021204",5852,781,601,228,404,218,73,0,8157
"47165021205",2211,157,12,0,54,0,0,0,2434
"47167040100",3885,626,330,105,49,13,0,0,5008
"47167040200",1604,394,54,0,30,15,23,0,2120
"47167040302",7619,276,1225,0,681,0,360,0,10161
"47167040303",5141,249,505,115,132,0,30,0,6172
"47167040304",4887,557,141,49,385,31,280,0,6330
"47167040400",2664,598,0,0,53,11,31,0,3357
"47167040500",5164,666,607,97,240,16,288,0,7078
"47167040601",2248,391,1261,715,101,28,41,0,4785
"47167040602",2203,299,364,77,124,0,131,38,3236
"47167040700",1690,231,1534,1555,12,11,30,19,5082
"47167040800",3575,166,226,37,38,50,21,0,4113
"47167040900",1012,85,302,126,0,0,0,0,1525
"47167041000",1058,194,980,307,8,5,16,30,2598
"47169090100",3928,499,308,0,108,53,0,0,4896
"47169090200",1870,313,370,182,65,0,0,0,2800
"47171080100",1942,749,0,0,30,6,22,6,2755
"47171080200",4691,1433,67,0,121,25,248,134,6719
"47171080300",4179,897,20,0,78,39,102,107,5422
"47171080400",2891,701,0,3,11,38,0,68,3712
"47173040100",5718,1386,2,0,27,0,86,0,7219
"47173040201",2532,1086,0,0,87,20,86,0,3811
"47173040202",4148,1491,0,0,156,45,3,2,5845
"47173040300",1781,423,0,0,0,10,9,63,2286
"47175925000",1781,569,0,0,34,2,7,0,2393
"47175925200",2337,604,31,0,53,57,10,0,3092
"47177930100",2812,821,84,0,80,31,74,177,4079
"47177930200",5303,927,96,0,83,49,74,403,6935
"47177930300",2318,363,144,1,6,2,20,3,2857
"47177930400",4172,800,94,0,367,201,655,65,6354
"47177930500",3002,1021,154,105,177,246,276,498,5479
"47177930600",2276,1094,140,29,38,165,40,254,4036
"47177930700",3555,770,9,28,156,108,252,128,5006
"47177930800",4420,1185,67,74,142,63,70,208,6229
"47177930900",1131,334,0,2,32,20,35,27,1581
"47179060100",1507,947,467,248,82,78,168,232,3729
"47179060400",5093,320,103,17,167,0,88,0,5788
"47179060501",3282,1119,173,1,128,0,131,129,4963
"47179060502",4734,907,150,0,73,19,159,141,6183
"47179060600",3874,1730,157,420,118,157,177,107,6740
"47179060700",0,0,0,0,0,0,0,0,0
"47179060800",1608,740,15,70,229,54,53,47,2816
"47179060900",3446,2173,376,240,130,298,0,22,6685
"47179061000",1011,679,149,244,76,121,64,81,2425
"47179061100",3747,658,167,30,115,0,197,0,4914
"47179061200",2676,576,50,2,40,17,18,0,3379
"47179061300",6046,742,422,70,563,166,228,0,8237
"47179061401",3867,1024,19,0,114,24,131,0,5179
"47179061402",5434,653,0,18,268,25,14,0,6412
"47179061500",5733,812,21,0,204,31,0,1,6802
"47179061601",3400,252,0,17,11,0,177,0,3857
"47179061602",8694,430,0,1,216,0,90,70,9501
"47179061701",5018,444,53,3,206,65,191,95,6075
"47179061702",5827,1196,0,1,78,21,183,0,7306
"47179061800",5380,928,18,0,105,0,38,0,6469
"47179061901",5360,1272,38,0,82,153,56,203,7164
"47179061902",3993,389,0,0,0,0,0,8,4390
"47179062000",2322,1064,280,175,42,111,153,111,4258
"47181950100",2362,424,10,62,3,12,2,0,2875
"47181950200",3934,1113,0,15,105,9,6,44,5226
"47181950300",3170,735,0,0,73,26,32,26,4062
"47181950400",2171,608,17,0,7,0,45,0,2848
"47183968000",923,230,0,0,7,0,2,0,1162
"47183968101",1928,404,482,551,60,26,0,43,3494
"47183968102",1654,74,112,0,22,0,90,0,1952
"47183968201",3639,382,260,4,63,0,19,0,4367
"47183968202",129,398,0,27,28,0,22,0,604
"47183968203",1478,988,112,250,48,37,78,19,3010
"47183968300",1784,477,98,23,30,10,0,3,2425
"47183968400",4050,1065,306,0,51,111,78,148,5809
"47183968500",4078,675,20,91,63,0,92,29,5048
"47183968600",2568,568,93,137,86,40,26,11,3529
"47183968700",1310,158,0,0,36,27,11,14,1556
"47185935000",3601,477,0,25,0,0,9,0,4112
"47185935100",4240,1098,0,5,33,0,241,50,5667
"47185935200",3059,992,0,8,22,0,40,0,4121
"47185935300",4022,659,62,91,254,0,89,0,5177
"47185935400",2408,832,82,98,44,37,0,0,3501
"47185935500",2428,732,0,0,148,11,24,23,3366
"47187050101",6038,190,361,199,882,0,318,0,7988
"47187050102",2936,161,93,0,333,0,37,0,3560
"47187050103",3194,296,241,0,68,0,0,0,3799
"47187050203",4832,167,69,0,256,88,162,0,5574
"47187050204",4703,35,270,0,410,0,175,0,5593
"47187050205",3265,129,0,0,145,0,35,24,3598
"47187050206",2873,12,20,0,128,0,0,0,3033
"47187050207",3166,60,215,0,347,15,49,0,3852
"47187050208",4860,94,329,0,943,12,241,23,6502
"47187050303",2679,9,112,0,60,0,6,0,2866
"47187050304",1652,70,0,0,177,0,0,0,1899
"47187050305",2164,27,75,0,200,0,95,0,2561
"47187050306",1535,59,33,0,112,0,97,0,1836
"47187050307",2904,206,42,0,166,0,198,0,3516
"47187050403",1699,42,10,0,60,0,0,0,1811
"47187050404",6176,184,294,0,239,0,62,0,6955
"47187050405",2516,79,0,0,24,0,0,0,2619
"47187050406",4875,92,122,8,94,0,46,0,5237
"47187050502",3249,571,0,0,50,0,87,0,3957
"47187050503",4190,368,20,0,237,0,51,8,4874
"47187050504",3093,356,0,0,262,0,74,37,3822
"47187050601",4494,760,557,107,195,13,418,220,6764
"47187050602",7481,233,664,2,297,41,116,0,8834
"47187050701",4043,101,70,0,282,0,354,0,4850
"47187050702",3620,305,52,0,18,72,112,29,4208
"47187050800",3380,1066,451,294,105,259,474,582,6611
"47187050904",2842,576,668,67,215,556,286,770,5980
"47187050905",4745,163,300,16,335,15,50,15,5639
"47187050906",4953,103,388,0,39,0,57,0,5540
"47187050907",4072,269,42,0,723,0,219,0,5325
"47187050908",3564,0,52,0,134,0,115,0,3865
"47187050909",3731,0,66,0,100,0,138,0,4035
"47187051001",5407,60,164,0,579,14,244,0,6468
"47187051002",5256,383,87,36,249,1,601,0,6613
"47187051100",5416,458,247,11,108,0,24,117,6381
"47187051201",5292,515,16,0,110,0,196,0,6129
"47187051202",19222,472,1263,0,1076,307,1198,371,23909
"47189030101",6521,634,137,39,189,114,163,114,7911
"47189030102",5594,381,203,22,16,30,126,0,6372
"47189030202",5798,69,174,1,200,0,19,0,6261
"47189030203",3914,119,634,51,43,0,17,0,4778
"47189030204",5583,493,155,2,199,0,89,0,6521
"47189030303",4125,114,64,0,64,1,43,1,4412
"47189030304",5568,358,249,356,142,13,184,17,6887
"47189030305",4869,169,163,37,59,0,158,0,5455
"47189030307",6256,524,241,81,250,25,469,0,7846
"47189030308",3421,71,468,150,365,8,155,0,4638
"47189030309",3800,400,195,28,327,62,71,24,4907
"47189030401",1597,482,96,139,58,7,64,2,2445
"47189030402",1756,643,322,270,863,63,702,206,4825
"47189030500",3942,601,705,327,426,104,357,125,6587
"47189030600",3051,418,158,31,83,8,108,0,3857
"47189030700",1422,539,637,471,46,38,152,104,3409
"47189030800",4316,959,140,0,87,78,50,0,5630
"47189030901",7611,837,338,0,320,0,199,0,9305
"47189030903",6290,234,237,0,133,0,136,0,7030
"47189030904",3578,162,108,0,131,0,15,0,3994
"47189031000",4961,993,28,40,156,0,8,0,6186
"48001950100",3678,559,612,119,204,44,187,287,5690
"48001950401",223,11,11,89,0,24,23,24,405
"48001950402",125,22,68,0,0,11,0,11,237
"48001950500",2138,789,525,658,177,68,768,556,5679
"48001950600",3430,649,1240,589,257,70,924,288,7447
"48001950700",849,607,513,703,122,5,558,97,3454
"48001950800",3218,206,420,337,380,76,283,27,4947
"48001950901",3566,836,205,197,263,14,593,436,6110
"48001950902",3997,898,225,134,99,0,212,373,5938
"48001951000",5822,652,185,181,210,59,343,200,7652
"48001951100",3807,817,484,35,179,7,271,281,5881
"48003950100",1786,99,28,0,36,0,310,68,2327
"48003950200",5192,420,168,0,604,200,2638,336,9558
"48003950300",2685,833,9,32,436,76,2120,679,6870
"48003950400",2461,239,0,0,48,27,1499,108,4382
"48005000101",4314,1089,92,177,277,0,450,297,6696
"48005000102",4034,413,216,66,381,0,886,235,6231
"48005000200",3756,1352,420,1,472,343,621,614,7579
"48005000301",3421,510,303,176,105,10,312,173,5010
"48005000302",3497,335,333,11,160,189,486,359,5370
"48005000400",2775,592,1079,691,137,37,560,357,6228
"48005000500",691,261,1751,1010,75,8,388,88,4272
"48005000600",2420,1089,1301,455,463,267,1925,1059,8979
"48005000700",1538,743,567,383,398,274,1361,861,6125
"48005000800",3762,860,847,185,263,268,444,477,7106
"48005000901",4875,369,876,3,312,103,693,195,7426
"48005000902",1903,194,185,95,375,0,227,0,2979
"48005001001",2826,1121,607,116,274,96,1278,642,6960
"48005001002",3711,315,204,62,259,2,1053,267,5873
"48005001100",5214,597,191,109,21,21,123,183,6459
"48005001200",2245,311,17,9,34,58,25,0,2699
"48005001300",3887,744,16,0,8,167,177,167,5166
"48007950100",4056,1179,36,0,376,36,425,130,6238
"48007950200",1053,16,0,0,48,0,97,0,1214
"48007950300",5183,1157,185,0,305,94,895,932,8751
"48007950400",2103,657,49,28,267,224,771,494,4593
"48007950500",4580,1107,32,0,295,15,1460,465,7954
"48007990000",0,0,0,0,0,0,0,0,0
"48009020100",2567,147,4,3,64,5,67,4,2861
"48009020200",2265,260,17,9,4,22,206,40,2823
"48009020300",2695,470,19,13,132,59,295,94,3777
"48011950100",1394,186,11,0,107,2,122,63,1885
"48013960100",5202,684,12,35,677,99,2646,653,10008
"48013960201",4905,462,58,3,875,487,3327,808,10925
"48013960202",6249,1022,107,7,1781,743,5546,1355,16810
"48013960300",2052,929,0,0,583,174,2338,991,7067
"48013960401",1314,470,0,0,290,135,1334,491,4034
"48013960402",5298,647,78,0,892,358,2892,779,10944
"48013960500",2010,512,0,0,125,65,1549,478,4739
"48013960600",4755,548,11,1,527,38,2496,444,8820
"48015760100",1675,174,296,27,122,35,401,124,2854
"48015760200",4620,599,885,188,429,114,2102,379,9316
"48015760300",5703,228,174,166,268,46,1542,118,8245
"48015760400",3243,140,75,42,0,67,174,66,3807
"48015760501",3357,235,217,6,93,28,599,81,4616
"48015760502",3890,314,345,229,72,230,931,351,6362
"48017950100",5424,744,113,0,567,171,3372,734,11125
"48019000101",3686,416,0,2,88,3,574,63,4832
"48019000102",3727,543,0,0,143,76,458,313,5260
"48019000200",2103,492,0,9,14,36,265,185,3104
"48019000300",5186,828,0,0,283,64,876,199,7436
"48019000400",1612,564,0,0,148,33,384,101,2842
"48021950100",6625,1188,209,121,653,186,1847,1029,11858
"48021950200",3721,1374,595,660,1351,198,2316,1521,11736
"48021950300",9814,997,983,350,609,83,2167,320,15323
"48021950400",6163,587,417,163,366,22,1417,409,9544
"48021950501",4941,1021,300,96,261,8,1862,684,9173
"48021950502",4600,890,231,0,133,11,441,210,6516
"48021950600",3687,516,31,42,408,152,912,266,6014
"48021950700",2481,441,605,208,97,28,355,184,4399
"48021950801",4288,919,102,85,565,179,3111,960,10209
"48021950802",5726,957,153,21,22,414,2576,1221,11090
"48023950300",2873,491,20,12,132,49,246,59,3882
"48025950100",1396,278,6,0,272,79,591,165,2787
"48025950201",753,174,39,0,132,9,355,153,1615
"48025950202",2818,842,59,2,910,316,1771,946,7664
"48025950300",3517,632,45,63,468,213,2010,614,7562
"48025950400",1504,218,67,34,132,180,1078,237,3450
"48025950500",3506,928,17,32,1120,959,3400,1789,11751
"48025950600",1606,310,67,0,484,120,1321,257,4165
"48027020100",5546,466,75,7,472,0,813,10,7389
"48027020201",5973,391,195,0,394,66,607,67,7693
"48027020202",4632,789,54,0,308,60,823,87,6753
"48027020300",6753,457,610,345,710,0,1934,32,10841
"48027020401",1615,281,554,68,188,12,329,154,3201
"48027020402",1234,112,610,24,68,28,425,96,2597
"48027020500",2580,907,521,40,163,113,831,578,5733
"48027020600",1822,260,370,25,220,45,547,162,3451
"48027020701",526,338,160,92,21,15,191,175,1518
"48027020702",1311,427,222,198,156,101,1159,234,3808
"48027020800",649,619,878,982,154,88,583,519,4472
"48027020900",1061,232,497,160,72,37,604,166,2829
"48027021000",2465,497,290,77,471,174,1179,367,5520
"48027021100",3508,899,700,117,239,31,914,378,6786
"48027021201",1887,325,349,83,426,27,475,25,3597
"48027021202",2496,370,455,61,322,37,592,266,4599
"48027021203",3240,332,602,7,201,17,657,67,5123
"48027021301",3975,233,456,42,125,13,433,25,5302
"48027021302",2604,79,203,1,170,0,116,29,3202
"48027021303",3805,533,940,341,441,146,785,209,7200
"48027021400",3121,419,13,0,83,0,481,26,4143
"48027021500",3885,805,527,317,264,256,956,409,7419
"48027021601",3323,823,94,172,534,69,1943,583,7541
"48027021602",697,427,155,96,43,18,329,34,1799
"48027021700",6022,1109,89,0,410,13,450,289,8382
"48027021800",4596,722,498,224,731,201,1263,225,8460
"48027021901",1789,409,281,224,569,66,493,124,3955
"48027021903",5362,526,1434,28,2098,49,1520,404,11421
"48027021904",5670,953,742,138,868,124,1258,629,10382
"48027022000",4465,1084,1491,414,424,191,942,522,9533
"48027022101",1989,433,830,177,511,402,767,146,5255
"48027022103",2289,80,1565,311,851,274,953,115,6438
"48027022104",1093,262,1284,427,666,358,578,155,4823
"48027022105",1020,289,311,55,129,53,305,53,2215
"48027022200",1261,333,1073,80,300,58,524,188,3817
"48027022300",1662,413,1185,205,358,286,573,234,4916
"48027022401",2371,382,2000,419,451,196,1215,385,7419
"48027022402",1968,229,1343,0,892,336,945,286,5999
"48027022403",1923,140,1032,275,524,20,545,140,4599
"48027022404",3703,196,2959,0,1169,168,2088,254,10537
"48027022405",734,50,326,87,245,59,275,23,1799
"48027022501",1541,225,471,32,448,16,714,30,3477
"48027022502",4092,772,2809,77,1554,205,1411,403,11323
"48027022600",1229,850,548,160,653,367,871,441,5119
"48027022801",1019,300,480,598,234,103,540,96,3370
"48027022900",1816,511,515,299,609,351,981,419,5501
"48027023000",3970,559,1708,149,752,140,1648,206,9132
"48027023103",1977,274,1159,594,636,16,846,124,5626
"48027023104",2221,276,1096,161,508,122,1020,206,5610
"48027023105",4265,563,3378,312,821,131,2000,111,11581
"48027023106",4757,525,2540,805,1596,51,2330,252,12856
"48027023107",2949,189,2190,875,1002,174,2027,149,9555
"48027023108",4541,565,3602,2058,3240,233,3587,330,18156
"48027023201",1670,159,276,8,223,41,429,11,2817
"48027023202",3338,584,903,246,159,118,1338,267,6953
"48027023203",1704,101,599,0,453,40,641,31,3569
"48027023204",1207,284,557,0,74,45,289,85,2541
"48027023300",4931,606,851,16,839,147,902,164,8456
"48027023402",3558,398,142,42,170,5,763,75,5153
"48027023403",4836,229,82,2,163,34,489,60,5895
"48027023404",2085,214,6,14,73,13,338,20,2763
"48027023500",855,389,422,318,235,95,591,319,3224
"48027980001",60,0,0,0,34,0,94,0,188
"48027980002",0,0,0,0,0,0,0,0,0
"48027980003",0,0,0,0,0,0,0,0,0
"48029110100",1350,480,34,41,568,101,1042,402,4018
"48029110300",836,646,212,21,833,262,1287,883,4980
"48029110500",436,1042,0,68,61,208,493,1205,3513
"48029110600",1206,1074,11,6,217,161,1331,1159,5165
"48029110700",1149,599,51,69,98,10,1150,568,3694
"48029110800",723,342,140,0,234,95,825,347,2706
"48029110900",294,121,3,16,116,3,231,57,841
"48029111000",757,427,43,53,319,195,871,537,3202
"48029120100",2360,94,645,10,424,104,595,91,4323
"48029120300",5957,332,35,2,639,206,1244,231,8646
"48029120400",5144,389,62,0,234,2,633,132,6596
"48029120501",4781,483,853,538,1007,191,3692,536,12081
"48029120502",3087,551,240,488,413,402,2358,718,8257
"48029120600",4289,619,98,1,677,121,1424,134,7363
"48029120701",3413,597,64,177,549,222,1894,584,7500
"48029120702",3429,478,222,0,394,92,482,106,5203
"48029120800",5844,132,17,5,399,23,1685,42,8147
"48029120901",1282,448,88,185,115,63,454,451,3086
"48029120902",4428,339,847,94,586,311,2161,372,9138
"48029121000",5013,1128,323,73,493,196,2025,826,10077
"48029121108",5630,500,130,99,566,199,2019,223,9366
"48029121110",4183,147,210,74,417,0,2010,10,7051
"48029121111",4852,378,252,238,356,99,2322,336,8833
"48029121112",3158,245,132,10,479,24,1238,163,5449
"48029121115",4602,290,222,0,253,42,1193,225,6827
"48029121116",3429,808,80,0,460,91,1012,518,6398
"48029121117",3484,194,293,42,378,0,1401,89,5881
"48029121118",4481,226,347,5,970,56,2135,164,8384
"48029121119",4235,447,190,63,588,0,2015,89,7627
"48029121120",4088,622,65,0,658,23,1821,322,7599
"48029121121",2405,67,148,0,432,0,823,2,3877
"48029121122",4185,113,221,75,607,6,1966,13,7186
"48029121203",2548,776,229,127,405,177,1943,722,6927
"48029121204",4659,758,1190,226,504,152,2345,652,10486
"48029121205",1749,834,307,417,374,185,1360,776,6002
"48029121206",6404,629,191,228,404,129,3723,608,12316
"48029121300",4652,446,530,193,265,0,1736,402,8224
"48029121402",2832,450,888,52,914,181,2782,533,8632
"48029121403",2053,539,1131,769,564,157,1356,369,6938
"48029121404",1990,591,688,691,701,82,1939,429,7111
"48029121501",4890,311,1145,15,952,9,2501,164,9987
"48029121504",4368,774,977,36,829,123,2225,545,9877
"48029121505",2570,323,500,4,961,106,1502,146,6112
"48029121506",3047,530,659,204,374,121,2069,505,7509
"48029121507",2735,206,748,90,492,60,1217,119,5667
"48029121508",2036,714,795,515,422,370,1575,664,7091
"48029121601",3541,422,264,25,419,124,1774,307,6876
"48029121604",4802,376,1280,226,1547,24,2710,244,11209
"48029121605",1352,270,7,94,483,32,568,294,3100
"48029121606",3272,472,560,172,367,376,1416,193,6828
"48029121701",2911,269,108,111,301,145,933,231,5009
"48029121702",4663,721,305,42,693,100,1609,191,8324
"48029121802",5890,548,548,225,1143,117,3490,563,12524
"48029121803",3481,168,528,0,790,15,2461,104,7547
"48029121804",3737,923,615,406,838,211,2485,839,10054
"48029121808",2151,246,155,14,446,2,1167,143,4324
"48029121809",3827,338,202,131,331,7,1738,97,6671
"48029121810",3604,141,200,41,485,54,1857,87,6469
"48029121811",3572,261,256,0,589,17,1764,263,6722
"48029121812",4764,82,264,2,671,1,2370,23,8177
"48029121813",1089,196,142,0,51,17,381,93,1969
"48029121903",4623,53,74,0,367,0,1081,22,6220
"48029121904",2641,64,100,366,564,0,848,0,4583
"48029121905",4333,52,198,0,830,8,1585,39,7045
"48029121906",4676,125,156,0,226,13,1420,34,6650
"48029121907",7699,80,683,38,1334,0,3679,29,13542
"48029121908",1873,34,112,0,266,20,715,41,3061
"48029121909",3659,137,449,9,491,107,1796,154,6802
"48029121910",3107,79,625,35,678,45,1348,159,6076
"48029130200",446,224,153,192,381,542,735,738,3411
"48029130300",859,694,391,62,662,373,1460,974,5475
"48029130401",1327,668,345,70,714,583,1896,1136,6739
"48029130402",930,1014,371,990,636,289,1519,1251,7000
"48029130500",920,733,588,588,991,524,1808,1118,7270
"48029130600",589,911,1163,809,686,843,1203,1559,7763
"48029130700",797,239,33,50,238,234,979,455,3025
"48029130800",936,805,2373,931,384,310,1310,1048,8097
"48029130900",1457,780,1073,677,328,273,1399,1058,7045
"48029131000",1021,653,1781,519,522,150,1240,750,6636
"48029131100",293,358,915,392,289,358,590,717,3912
"48029131200",1186,267,828,246,126,89,909,265,3916
"48029131300",2440,1717,1452,189,384,1,1518,1716,9417
"48029131401",3374,978,997,120,1015,539,3272,1107,11402
"48029131402",1444,362,594,32,296,136,1257,429,4550
"48029131503",1700,166,293,190,654,334,846,221,4404
"48029131504",2048,341,554,70,715,49,1659,224,5660
"48029131505",1636,368,737,120,645,156,1521,447,5630
"48029131506",1567,253,514,205,550,92,1511,306,4998
"48029131507",2369,587,808,428,1596,991,3080,1379,11238
"48029131601",1111,605,80,3,337,66,578,354,3134
"48029131606",2413,174,895,141,1228,175,1776,185,6987
"48029131608",2603,349,842,305,1022,58,1981,250,7410
"48029131609",3454,393,2991,171,1283,308,3027,488,12115
"48029131610",2224,247,1730,399,1042,68,1816,62,7588
"48029131611",599,64,386,6,480,13,385,52,1985
"48029131612",416,206,763,62,362,8,470,163,2450
"48029131613",2440,30,1210,228,669,388,1584,378,6927
"48029131614",1737,119,1108,25,742,0,1433,131,5295
"48029131615",3778,482,1563,53,1076,357,2755,609,10673
"48029131700",793,88,95,2,89,6,80,6,1159
"48029131801",2458,109,40,0,275,19,524,75,3500
"48029131802",3953,434,296,98,997,166,1541,555,8040
"48029140100",599,144,0,22,830,160,1309,276,3340
"48029140200",1507,577,64,1,348,25,1694,493,4709
"48029140300",1309,722,110,0,786,497,2056,1199,6679
"48029140400",2192,442,0,0,456,656,2396,1013,7155
"48029140500",2281,453,114,0,1048,172,3051,607,7726
"48029140600",1168,709,74,0,520,122,1571,774,4938
"48029140700",2508,700,86,23,1007,306,2799,815,8244
"48029140800",2760,790,76,22,910,404,3259,1134,9355
"48029140900",1120,306,7,0,336,158,1261,456,3644
"48029141000",1252,1175,81,0,466,369,1449,1481,6273
"48029141101",2173,476,124,245,628,162,2170,541,6519
"48029141102",1547,1022,81,132,1019,194,1945,993,6933
"48029141200",3477,1104,393,305,954,300,3466,1302,11301
"48029141300",3371,255,499,137,1080,59,3626,228,9255
"48029141402",1818,490,112,0,1282,163,2768,606,7239
"48029141403",2342,542,171,10,1007,0,2424,506,7002
"48029141404",3302,640,64,25,729,85,2890,590,8325
"48029141600",3185,210,26,0,954,288,3645,475,8783
"48029141700",3525,713,10,0,569,120,2741,595,8273
"48029141800",2395,652,46,11,572,747,1793,1122,7338
"48029141900",4414,391,207,0,942,12,2096,161,8223
"48029150100",2477,1021,0,0,1352,383,3570,1361,10164
"48029150300",1523,1247,34,26,568,995,1873,2095,8361
"48029150400",2250,1565,0,0,463,110,2656,1624,8668
"48029150501",2494,1494,14,0,545,258,2986,1732,9523
"48029150502",2343,793,13,3,879,332,3065,1124,8552
"48029150600",2550,838,0,0,687,387,3065,1180,8707
"48029150700",3314,1700,0,0,879,254,3794,1783,11724
"48029150800",820,1281,11,192,265,521,957,1663,5710
"48029150900",2756,951,5,26,1262,588,3799,1411,10798
"48029151000",1209,698,0,145,553,761,1644,1471,6481
"48029151100",4515,681,0,29,1145,568,5436,1154,13528
"48029151200",5684,1372,65,0,1977,507,7472,1827,18904
"48029151301",3801,935,41,0,1062,206,4672,1060,11777
"48029151302",1726,345,34,0,1202,0,2735,290,6332
"48029151400",2359,1064,0,48,704,319,2881,1305,8680
"48029151500",1631,403,0,6,278,139,1687,424,4568
"48029151600",4010,1249,54,0,1648,543,4603,1683,13790
"48029151700",4234,776,18,22,1361,314,5031,1003,12759
"48029151900",3349,1119,25,2,1200,699,4431,1778,12603
"48029152000",773,216,111,0,441,264,1206,397,3408
"48029152100",3136,813,27,10,947,146,2895,795,8769
"48029152201",4624,1653,133,0,1755,272,5142,1626,15205
"48029152202",3084,612,222,0,254,204,2395,550,7321
"48029160100",3168,1598,12,0,686,542,3831,2138,11975
"48029160200",1667,209,0,0,485,186,2068,384,4999
"48029160300",3896,526,0,0,644,436,4313,929,10744
"48029160400",2880,548,36,0,436,283,3224,826,8233
"48029160501",1166,2004,1,188,158,354,1224,2200,7295
"48029160502",2463,675,0,1,710,55,3105,727,7736
"48029160600",2725,1884,0,0,414,122,3072,1990,10207
"48029160701",1939,534,71,4,308,237,2172,670,5935
"48029160702",2533,1318,73,9,705,184,2965,1437,9224
"48029160901",2071,798,0,0,360,265,2336,1018,6848
"48029160902",3041,1145,0,0,390,263,3342,1386,9567
"48029161000",1781,1235,64,0,468,235,2239,1342,7364
"48029161100",6668,613,0,6,2077,551,8530,1137,19582
"48029161200",1472,1034,29,0,200,171,1421,1047,5374
"48029161302",3532,1972,38,0,585,224,3691,2170,12212
"48029161303",2278,1983,0,0,578,229,2651,2178,9897
"48029161304",2441,1217,102,0,159,388,2546,1436,8289
"48029161400",782,120,91,16,218,3,377,0,1607
"48029161501",4919,1133,152,61,1039,240,4873,1266,13683
"48029161503",2019,1156,142,7,647,99,2283,1230,7583
"48029161504",2525,1018,119,241,284,224,2409,1144,7964
"48029161600",2468,1524,151,107,519,117,2359,1521,8766
"48029161801",2406,484,172,0,308,13,1925,331,5639
"48029161802",4308,1176,759,81,618,83,4117,1107,12249
"48029161901",1157,42,0,0,146,0,1018,0,2363
"48029161902",5013,742,178,0,653,107,4635,440,11768
"48029162001",1154,393,0,4,574,176,1225,548,4074
"48029162003",3547,754,37,3,696,178,2832,787,8834
"48029162004",2156,1046,0,1,736,120,2465,1003,7527
"48029170101",2019,1407,44,26,229,151,2208,1558,7642
"48029170102",2456,1148,28,1,608,232,3092,1348,8913
"48029170200",2276,1734,0,7,989,576,3205,2288,11075
"48029170300",2429,2118,0,1,759,581,3181,2632,11701
"48029170401",1428,1866,38,68,438,354,1813,2134,8139
"48029170402",2186,1203,4,1,691,157,2780,1347,8369
"48029170500",2134,515,66,0,1068,580,2876,1014,8253
"48029170600",2446,1202,54,25,478,168,2472,1244,8089
"48029170700",2831,1176,1,1,260,241,2791,1366,8667
"48029170800",802,527,0,7,39,37,813,571,2796
"48029170900",2032,1604,0,0,196,104,2158,1592,7686
"48029171000",3351,1446,8,0,741,369,3747,1801,11463
"48029171100",2245,1112,7,0,314,50,2202,1065,6995
"48029171200",2285,1003,12,23,628,205,2794,1211,8161
"48029171301",1806,617,0,0,241,148,2003,702,5517
"48029171302",2179,1034,8,0,299,135,2317,803,6775
"48029171401",2189,1844,117,80,212,136,2290,1966,8834
"48029171402",2865,1388,0,2,677,190,3263,1568,9953
"48029171501",1523,524,65,13,180,119,1562,611,4597
"48029171502",2889,1737,458,19,330,123,3043,1838,10437
"48029171601",2651,960,64,167,245,300,2584,1086,8057
"48029171602",1977,693,290,55,76,177,2032,795,6095
"48029171700",4009,1870,329,106,822,283,3650,2043,13112
"48029171801",3185,1388,59,61,401,243,3064,1543,9944
"48029171802",3681,1567,202,292,451,112,3523,1591,11419
"48029171902",6381,1131,991,510,1036,487,6207,1405,18148
"48029171903",4511,1163,273,145,694,128,4321,912,12147
"48029171912",4717,71,457,15,754,8,3910,67,9999
"48029171913",3149,871,624,27,315,127,2805,975,8893
"48029171914",3992,542,321,87,575,33,3381,406,9337
"48029171915",1734,182,177,2,155,16,1132,192,3590
"48029171916",5142,501,796,96,1015,517,3785,766,12618
"48029171917",5318,548,1497,180,943,39,4094,484,13103
"48029171918",4292,285,392,0,426,31,2741,261,8428
"48029171919",2201,612,302,48,296,0,2002,614,6075
"48029171920",7142,1171,532,0,726,103,6014,954,16642
"48029171921",3733,383,444,92,851,135,3686,430,9754
"48029171922",2677,91,210,0,419,58,2480,149,6084
"48029171923",6057,257,891,20,1156,1,4455,194,13031
"48029171924",3258,193,341,34,661,9,1833,98,6427
"48029171925",5730,470,1028,3,1761,105,4552,491,14140
"48029172002",6396,448,625,15,854,109,3975,453,12875
"48029172003",4307,225,653,0,1068,88,2517,253,9111
"48029172004",2436,78,133,0,664,26,663,75,4075
"48029172005",2938,218,352,20,671,0,1925,212,6336
"48029172006",4876,245,588,304,848,51,2458,111,9481
"48029172007",7291,364,944,16,1078,91,3919,379,14082
"48029180101",3300,697,0,33,839,169,3545,786,9369
"48029180102",1416,222,0,0,209,31,1255,201,3334
"48029180201",2000,364,129,37,1474,753,2901,968,8626
"48029180202",3193,758,126,58,1058,297,3771,733,9994
"48029180300",2707,900,0,41,239,28,2520,913,7348
"48029180400",1913,1759,41,31,223,234,1915,1836,7952
"48029180501",2658,1349,208,134,296,36,2718,1248,8647
"48029180503",3297,522,190,9,380,54,3394,557,8403
"48029180504",2196,1716,51,331,323,140,2382,1814,8953
"48029180602",1921,262,0,1,89,372,1383,565,4593
"48029180603",861,561,39,0,127,199,588,746,3121
"48029180604",3527,1232,51,33,1044,255,3402,1129,10673
"48029180701",2536,561,232,68,213,133,1513,362,5618
"48029180702",5002,827,533,236,217,85,3452,382,10734
"48029180800",967,502,116,33,822,220,1461,464,4585
"48029180901",2900,989,33,59,1735,35,3501,870,10122
"48029180902",3601,881,31,61,2842,559,5573,1301,14849
"48029181001",2429,575,115,92,274,114,1899,642,6140
"48029181003",3065,1096,608,360,304,290,1890,647,8260
"48029181004",2945,570,202,359,742,64,1707,286,6875
"48029181005",1877,925,295,220,164,270,1247,847,5845
"48029181100",4740,244,28,82,748,179,2953,279,9253
"48029181200",3927,309,92,0,197,73,1385,316,6299
"48029181301",3021,225,151,62,788,57,1848,246,6398
"48029181302",3648,821,154,6,934,321,2494,833,9211
"48029181303",986,702,250,226,540,805,762,352,4623
"48029181402",1132,419,95,44,65,43,715,151,2664
"48029181403",3823,665,536,123,1048,152,2738,427,9512
"48029181404",1766,504,208,96,1894,92,988,159,5707
"48029181503",4417,948,560,143,335,267,2478,669,9817
"48029181504",4388,498,530,126,567,63,2854,331,9357
"48029181505",3971,301,22,21,212,14,2359,213,7113
"48029181506",3578,335,172,21,228,133,2359,305,7131
"48029181601",2326,424,40,23,311,58,2024,364,5570
"48029181602",3965,1151,87,309,337,289,3770,1175,11083
"48029181703",5074,610,443,0,688,42,2468,372,9697
"48029181704",4269,603,100,22,589,105,3178,546,9412
"48029181705",3433,249,444,47,735,58,2786,222,7974
"48029181711",5178,683,298,1,1811,75,3346,417,11809
"48029181712",3254,180,109,0,39,90,1929,180,5781
"48029181713",4869,404,769,2,1485,144,4217,449,12339
"48029181715",4474,746,344,47,732,65,3779,626,10813
"48029181716",4446,628,371,0,1560,162,4606,547,12320
"48029181718",4058,197,21,0,694,103,1858,189,7120
"48029181720",3456,36,86,0,768,37,1938,46,6367
"48029181721",2766,365,87,32,486,61,1731,331,5859
"48029181722",3736,194,135,4,413,128,2265,205,7080
"48029181723",2912,294,851,59,913,0,2518,168,7715
"48029181724",4167,101,134,0,529,49,2343,118,7441
"48029181725",3282,669,563,150,392,178,2928,467,8629
"48029181726",6966,361,575,0,1713,46,4801,331,14793
"48029181727",2120,467,306,26,458,123,1950,514,5964
"48029181728",7387,308,726,98,2258,261,5940,520,17498
"48029181729",3054,206,167,10,574,0,1977,195,6183
"48029181730",2687,148,345,0,893,34,2568,133,6808
"48029181731",4985,335,131,14,959,145,3406,442,10417
"48029181808",692,478,59,36,132,9,186,348,1940
"48029181809",4109,1165,115,84,1025,76,3610,994,11178
"48029181811",2992,262,35,0,687,68,1479,180,5703
"48029181813",3465,1222,163,0,862,254,2297,972,9235
"48029181814",2351,592,196,32,327,39,1208,324,5069
"48029181815",2229,183,69,0,796,252,1266,252,5047
"48029181816",3815,190,141,0,355,0,2164,161,6826
"48029181817",2756,251,210,0,295,0,2059,123,5694
"48029181818",3670,685,298,15,255,0,2266,555,7744
"48029181819",3727,213,148,102,1543,172,2962,325,9192
"48029181820",1406,1196,32,315,158,998,531,932,5568
"48029181821",2391,149,30,19,477,14,1421,38,4539
"48029181822",3944,341,313,2,376,34,2317,266,7593
"48029181823",1482,346,103,74,410,291,798,340,3844
"48029181824",3949,403,13,68,799,177,2236,419,8064
"48029181825",2255,403,116,0,396,31,1054,264,4519
"48029181826",4216,433,365,2,1275,81,2573,454,9399
"48029181901",1502,769,94,158,731,364,730,599,4947
"48029181902",4941,180,44,14,696,84,1647,28,7634
"48029182001",3790,115,150,56,852,58,1690,107,6818
"48029182002",7749,224,362,0,895,2,3262,3,12497
"48029182003",2621,87,42,0,752,0,1039,26,4567
"48029182101",6303,95,24,38,444,0,1285,0,8189
"48029182102",6065,96,74,0,685,12,1947,42,8921
"48029182103",1952,186,0,0,263,0,897,80,3378
"48029182105",2104,0,40,0,253,9,1130,0,3536
"48029182106",4835,199,253,0,860,21,2194,96,8458
"48029190100",1439,606,54,48,958,250,2056,695,6106
"48029190200",3393,681,2,0,254,91,1703,497,6621
"48029190400",1866,167,9,0,96,46,499,11,2694
"48029190501",1477,158,18,50,948,133,1932,263,4979
"48029190503",2511,576,29,45,161,57,2049,444,5872
"48029190504",1490,278,13,22,674,181,1873,374,4905
"48029190601",1852,595,0,1,1020,338,2642,898,7346
"48029190603",1336,676,36,0,1099,0,2121,537,5805
"48029190604",1659,309,91,0,1778,630,3223,925,8615
"48029190700",1775,553,40,35,313,53,1338,512,4619
"48029190800",1945,54,23,60,28,0,369,0,2479
"48029190901",3757,1012,444,16,403,129,2572,778,9111
"48029190902",3336,273,139,39,140,126,2362,172,6587
"48029191003",3847,1019,90,536,2270,391,4542,1233,13928
"48029191004",1739,979,20,57,720,420,2031,1288,7254
"48029191005",1511,379,0,0,233,72,1528,405,4128
"48029191006",2873,749,34,0,1983,497,4094,1138,11368
"48029191101",1340,68,0,0,162,6,562,41,2179
"48029191102",2105,169,83,1,236,0,1009,47,3650
"48029191201",2362,384,0,5,99,30,1099,218,4197
"48029191202",3928,559,18,60,440,0,2342,389,7736
"48029191303",1320,142,4,0,19,0,596,25,2106
"48029191304",1792,216,99,35,319,37,1651,115,4264
"48029191405",5964,424,197,1,751,44,2459,192,10032
"48029191406",5866,268,93,0,880,0,1307,208,8622
"48029191408",1570,387,118,17,590,142,1327,393,4544
"48029191409",3243,739,317,27,1572,638,3218,1002,10756
"48029191410",3711,499,471,83,527,311,2224,501,8327
"48029191411",3312,339,88,0,360,0,1208,244,5551
"48029191412",1979,8,0,0,125,0,477,8,2597
"48029191413",4579,498,93,83,735,61,1898,441,8388
"48029191503",3814,181,161,0,634,93,1421,148,6452
"48029191504",2114,62,0,0,319,28,622,0,3145
"48029191505",2104,87,0,0,64,0,553,78,2886
"48029191506",3456,569,72,3,590,32,1955,419,7096
"48029191701",1369,14,0,0,127,0,344,8,1862
"48029191702",6773,237,122,0,523,15,1475,133,9278
"48029191804",5636,50,143,0,338,0,1519,0,7686
"48029191806",6639,214,487,0,1012,38,1854,156,10400
"48029191807",3197,316,127,19,280,66,890,223,5118
"48029191808",2773,22,178,0,461,0,910,14,4358
"48029191809",4622,477,234,52,506,0,1565,459,7915
"48029191810",3862,168,293,0,1045,26,1553,98,7045
"48029191811",3090,142,269,0,859,31,1275,39,5705
"48029191812",3842,191,106,0,599,0,988,85,5811
"48029191813",5032,429,345,0,848,0,2247,310,9211
"48029191814",3182,309,43,0,572,10,1015,276,5407
"48029191815",3468,170,339,57,1245,129,1331,293,7032
"48029191816",2168,18,48,0,260,161,715,0,3370
"48029191817",9080,378,259,0,1328,60,3372,287,14764
"48029191900",1801,1326,605,254,1030,484,2436,1720,9656
"48029192000",1994,1097,113,182,177,177,1021,611,5372
"48029192100",1649,287,60,0,279,37,1000,243,3555
"48029192200",754,149,41,0,259,139,745,241,2328
"48029192300",4156,87,25,1,91,18,1461,25,5864
"48029980001",0,0,0,0,0,0,0,0,0
"48029980002",21,0,0,0,0,0,21,0,42
"48029980003",751,81,114,0,95,0,313,81,1435
"48029980004",0,0,0,0,0,0,0,0,0
"48029980005",4,0,0,0,10,0,0,0,14
"48029980100",22,0,0,0,33,0,0,0,55
"48031950100",4104,435,0,0,160,0,610,163,5472
"48031950200",4757,377,5,58,398,93,1103,129,6920
"48033950100",632,6,0,0,11,0,52,0,701
"48035950100",3269,678,0,0,125,41,617,150,4880
"48035950200",1130,315,32,13,54,57,282,152,2035
"48035950300",1263,320,33,13,55,0,40,70,1794
"48035950400",3311,185,40,0,72,7,337,40,3992
"48035950500",1773,500,31,7,205,41,479,324,3360
"48035950600",1317,129,0,0,30,0,58,8,1542
"48035950700",2216,208,18,59,77,26,330,23,2957
"48037010100",2321,573,951,1069,292,0,141,0,5347
"48037010400",1111,386,1221,1125,323,189,66,61,4482
"48037010500",293,364,842,570,59,0,131,145,2404
"48037010600",224,50,1153,441,77,54,135,0,2134
"48037010700",2601,215,1128,759,84,37,485,58,5367
"48037010800",1346,356,1767,703,421,79,257,330,5259
"48037010901",5485,479,760,56,140,0,88,0,7008
"48037010902",4194,711,1034,170,655,78,560,108,7510
"48037011000",5238,534,1064,941,322,25,254,193,8571
"48037011100",3022,817,885,295,139,1,179,4,5342
"48037011200",5342,385,118,41,141,27,200,27,6281
"48037011300",3684,665,432,246,352,155,244,209,5987
"48037011401",5699,838,548,212,226,0,350,0,7873
"48037011402",1777,340,47,13,44,0,35,6,2262
"48037011501",4147,488,242,117,225,19,114,9,5361
"48037011502",1657,733,381,171,76,0,206,0,3224
"48037011600",3139,829,783,318,182,112,159,169,5691
"48037011700",2099,503,0,0,161,7,128,26,2924
"48039660100",4124,34,68,16,260,22,940,7,5471
"48039660200",4520,113,408,21,589,0,1498,23,7172
"48039660300",7473,241,937,114,586,124,2086,128,11689
"48039660400",6889,291,851,40,1095,190,2025,443,11824
"48039660500",5786,975,644,49,1119,33,2123,563,11292
"48039660601",7032,91,2555,0,2720,61,1653,0,14112
"48039660602",12187,1342,8075,336,8561,335,6264,929,38029
"48039660701",8447,156,3499,187,3267,48,1839,48,17491
"48039660702",7117,1219,2014,45,2018,55,1706,806,14980
"48039660801",6100,85,1033,0,879,460,2308,398,11263
"48039660802",4144,45,1130,368,1526,186,1715,261,9375
"48039660900",3905,1304,101,19,1169,162,2377,1005,10042
"48039661000",5413,1199,0,0,291,14,2112,755,9784
"48039661100",2162,638,157,30,156,0,773,484,4400
"48039661200",2872,544,80,0,328,15,983,173,4995
"48039661300",1725,580,86,6,65,0,864,259,3585
"48039661400",4717,759,130,102,492,71,1692,426,8389
"48039661501",4698,278,17,0,259,0,1878,103,7233
"48039661502",3540,411,157,0,169,74,755,235,5341
"48039661601",4811,831,27,271,426,12,2320,117,8815
"48039661602",2559,418,40,0,263,37,1028,318,4663
"48039661700",2251,253,37,1,11,4,654,78,3289
"48039661800",3910,403,162,44,1816,238,2037,238,8848
"48039661900",4010,631,1021,251,654,45,2181,469,9262
"48039662000",4532,720,282,440,102,10,801,369,7256
"48039662100",3263,703,1049,137,134,73,1633,362,7354
"48039662200",3933,341,757,28,371,12,1355,294,7091
"48039662300",3550,211,172,503,151,166,848,233,5834
"48039662400",4528,584,105,12,469,7,1218,239,7162
"48039662500",1993,245,213,20,121,42,651,196,3481
"48039662600",2716,214,228,20,36,40,352,27,3633
"48039662700",1782,369,131,56,181,0,326,78,2923
"48039662800",4202,507,487,323,351,11,593,242,6716
"48039662900",3697,366,373,163,305,77,746,188,5915
"48039663000",2094,346,411,213,95,0,472,71,3702
"48039663100",4071,243,52,13,309,82,702,27,5499
"48039663200",3833,121,238,9,366,9,684,55,5315
"48039663300",1669,180,36,0,262,0,627,76,2850
"48039663400",4839,457,290,200,872,350,1120,518,8646
"48039663500",4715,317,268,99,514,100,1703,100,7816
"48039663600",4805,94,92,0,259,0,730,11,5991
"48039663700",2702,208,338,166,130,10,1177,77,4808
"48039663800",4191,650,604,19,80,183,1914,451,8092
"48039663900",1407,305,83,60,131,153,1010,367,3516
"48039664000",2572,700,333,188,125,16,1238,535,5707
"48039664100",3441,728,353,16,446,340,1518,585,7427
"48039664200",1389,346,62,0,50,11,252,142,2252
"48039664300",2755,1588,287,336,402,348,2198,1479,9393
"48039664400",3795,962,468,71,637,75,2102,574,8684
"48039664501",3636,658,206,127,196,17,839,260,5939
"48039990000",0,0,0,0,0,0,0,0,0
"48041000101",5058,799,600,303,917,228,1488,358,9751
"48041000102",5163,329,112,3,734,10,866,105,7322
"48041000103",1420,7,88,0,90,0,81,0,1686
"48041000201",2834,1209,396,564,586,348,675,572,7184
"48041000202",3504,936,422,149,599,370,1641,721,8342
"48041000300",3997,892,1625,58,1086,205,2999,809,11671
"48041000400",1828,656,995,407,414,18,1304,388,6010
"48041000500",1410,1136,1185,1082,668,430,1823,1432,9166
"48041000603",1803,894,473,356,663,526,1985,1194,7894
"48041000604",2030,1771,162,670,807,575,2247,1993,10255
"48041000700",1516,239,333,231,373,79,1186,196,4153
"48041000800",2663,626,389,69,510,44,1114,265,5680
"48041000900",1103,407,220,121,435,154,1025,419,3884
"48041001000",2640,2445,264,788,952,857,1214,824,9984
"48041001100",2879,933,144,315,312,145,607,208,5543
"48041001301",1537,1039,108,70,171,56,242,214,3437
"48041001302",2216,1166,214,8,163,232,276,307,4582
"48041001303",1642,1816,395,119,577,474,742,300,6065
"48041001400",381,740,11,10,537,991,69,169,2908
"48041001601",1502,2146,336,263,502,363,292,134,5538
"48041001604",2219,1673,229,82,621,548,238,317,5927
"48041001605",1014,1302,700,292,297,314,404,462,4785
"48041001606",1359,1092,105,15,101,202,315,150,3339
"48041001701",1424,2307,114,117,450,426,287,568,5693
"48041001702",830,1202,106,285,79,109,143,326,3080
"48041001801",3284,330,579,67,80,103,561,149,5153
"48041001803",3342,1686,158,14,897,284,461,146,6988
"48041001804",424,363,273,0,185,29,85,39,1398
"48041001900",3992,303,351,141,248,181,448,169,5833
"48041002001",3981,318,113,6,282,1,462,50,5213
"48041002002",4679,333,568,0,549,51,425,27,6632
"48041002006",1032,151,0,9,468,0,223,42,1925
"48041002007",4622,1239,348,0,431,91,680,229,7640
"48041002008",4965,90,280,3,586,0,557,25,6506
"48041002009",3537,66,322,0,299,0,342,5,4571
"48041002010",2319,71,26,0,295,0,412,20,3143
"48041002011",2519,208,47,22,75,0,356,72,3299
"48041002012",1022,4086,0,186,163,568,115,878,7018
"48041002013",3675,1107,28,51,150,11,998,67,6087
"48041002014",770,486,35,52,61,37,24,136,1601
"48041002015",21,0,0,0,0,0,0,0,21
"48041980000",0,0,0,0,0,0,0,0,0
"48043950300",3481,248,37,29,120,31,1174,155,5275
"48043950400",1330,377,0,0,100,0,1215,348,3370
"48043950500",2680,429,0,0,213,12,841,209,4384
"48045950200",1205,276,30,12,75,12,252,200,2062
"48047950100",1229,722,0,0,244,14,1350,706,4265
"48047950200",2271,1822,0,1,610,142,2541,1828,9215
"48049950100",1982,136,0,0,76,45,94,10,2343
"48049950200",3308,573,32,27,47,25,678,83,4773
"48049950300",2648,440,20,6,44,5,161,73,3397
"48049950500",2715,304,55,20,61,0,562,10,3727
"48049950600",1207,891,0,85,217,63,560,318,3341
"48049950700",294,332,98,58,58,72,100,337,1349
"48049950800",1718,565,155,0,107,55,571,240,3411
"48049950900",2935,846,180,170,109,91,637,183,5151
"48049951000",1567,409,35,3,152,47,425,74,2712
"48049951100",3171,626,78,23,94,97,511,296,4896
"48049951200",3569,400,11,16,101,6,538,33,4674
"48049951300",2371,176,0,0,96,0,644,25,3312
"48051970100",730,125,117,10,177,0,10,0,1169
"48051970200",3446,457,230,22,215,116,610,152,5248
"48051970300",2693,386,292,176,286,0,848,19,4700
"48051970400",2372,291,544,80,24,0,693,26,4030
"48051970500",2878,717,271,154,116,13,613,251,5013
"48053960100",4804,891,39,0,384,9,516,480,7123
"48053960200",2581,251,0,0,0,0,198,176,3206
"48053960300",4699,1092,179,13,195,43,527,665,7413
"48053960400",4450,814,3,4,56,22,486,674,6509
"48053960500",4109,1418,59,0,159,226,1160,948,8079
"48053960600",3350,211,53,0,33,0,171,8,3826
"48053960700",4807,1114,233,80,199,25,1487,736,8681
"48053960800",4964,724,125,0,197,22,409,112,6553
"48055960101",3630,995,87,0,819,58,2602,558,8749
"48055960102",2488,245,60,18,347,344,621,391,4514
"48055960200",2055,151,230,83,779,92,1987,167,5544
"48055960300",2882,512,196,57,513,288,1413,553,6414
"48055960400",1977,304,73,52,888,162,1892,373,5721
"48055960500",3438,1493,203,371,2132,475,3261,1217,12590
"48055960600",1614,157,91,27,160,0,202,0,2251
"48055960700",3214,620,414,214,997,0,1916,431,7806
"48057000100",3733,789,92,0,596,110,1960,561,7841
"48057000200",3098,562,360,21,446,34,2577,542,7640
"48057000300",1231,57,28,1,95,3,359,0,1774
"48057000400",4231,1562,66,0,361,60,1751,1421,9452
"48057000500",3018,510,0,0,158,22,551,260,4519
"48057990000",0,0,0,0,0,0,0,0,0
"48059030101",3870,555,15,18,166,136,311,81,5152
"48059030102",3685,485,54,6,124,60,241,80,4735
"48059030200",3313,729,25,0,126,43,293,112,4641
"48061010100",4754,2744,13,0,298,106,3744,2669,14328
"48061010201",1181,745,0,0,137,0,1128,745,3936
"48061010203",4870,1931,261,24,241,167,3836,1945,13275
"48061010301",2975,2140,0,13,225,126,2801,2264,10544
"48061010302",6262,1905,0,0,250,76,4151,1944,14588
"48061010401",3981,1036,12,0,189,193,3752,1154,10317
"48061010402",4314,1697,76,0,171,20,2883,1547,10708
"48061010500",1208,835,4,0,117,52,1219,884,4319
"48061010601",5683,2595,44,0,251,94,4883,2440,15990
"48061010602",1328,460,14,0,39,0,775,368,2984
"48061010700",2172,918,7,0,55,55,1742,833,5782
"48061010800",4250,2136,155,9,162,89,3048,1967,11816
"48061010900",671,728,0,0,129,18,648,684,2878
"48061011000",1406,1707,0,0,71,137,1466,1837,6624
"48061011100",1398,924,0,2,72,70,1424,978,4868
"48061011200",1022,873,0,0,137,0,815,873,3720
"48061011301",1080,496,40,0,37,0,672,388,2713
"48061011302",3404,181,64,0,225,49,2382,79,6384
"48061011400",5034,1657,0,1,521,64,4806,1705,13788
"48061011500",2951,1944,0,6,152,520,2933,2402,10908
"48061011600",3843,1912,0,0,343,255,4128,2100,12581
"48061011700",3196,2211,0,75,504,396,3547,2573,12502
"48061011801",3071,1261,138,57,478,144,2932,1342,9423
"48061011802",1507,2077,57,43,261,105,1476,2104,7630
"48061011901",2959,1750,0,0,530,485,2708,2064,10496
"48061011902",2658,971,37,0,570,336,2406,1186,8164
"48061011903",1199,1150,0,0,218,144,1368,1262,5341
"48061012001",3438,2268,59,0,145,20,1944,2120,9994
"48061012002",4749,1125,1,0,321,62,3787,1128,11173
"48061012101",3208,1050,0,0,480,135,2581,959,8413
"48061012102",2750,2489,0,0,719,222,3259,2667,12106
"48061012200",7402,3080,23,0,1317,550,7869,3113,23354
"48061012301",2813,889,0,3,211,0,1309,688,5913
"48061012304",2901,1081,34,1,273,288,2472,1194,8244
"48061012305",2360,589,78,0,80,118,377,266,3868
"48061012401",3785,1880,52,0,597,719,4056,2578,13667
"48061012402",2902,1563,54,26,180,194,2525,1389,8833
"48061012504",10933,4281,49,0,829,241,11100,4336,31769
"48061012505",5104,3949,16,0,531,381,5361,4291,19633
"48061012506",2773,618,0,0,196,76,2247,578,6488
"48061012507",3653,2070,93,8,347,155,3890,2206,12422
"48061012508",2170,923,0,0,105,0,1830,908,5936
"48061012607",1204,1453,0,0,116,48,1314,1501,5636
"48061012608",2933,1024,12,0,96,39,2630,918,7652
"48061012609",3799,4828,0,0,96,217,3679,5045,17664
"48061012612",5475,376,0,0,246,35,5211,323,11666
"48061012613",2913,1066,0,0,740,54,3042,1069,8884
"48061012700",3517,1762,0,0,203,135,3556,1621,10794
"48061012800",2871,1607,47,0,153,215,2904,1822,9619
"48061012900",2590,926,25,23,428,174,2488,1059,7713
"48061013002",2823,775,8,0,375,54,2770,806,7611
"48061013003",1007,678,0,0,54,40,1005,718,3502
"48061013004",1993,678,0,1,124,78,1933,693,5500
"48061013102",2129,1418,0,0,230,62,2080,1458,7377
"48061013104",2769,868,0,2,242,28,2741,860,7510
"48061013106",1730,1886,0,0,287,168,1912,2047,8030
"48061013203",656,1434,6,0,100,58,683,1492,4429
"48061013204",1343,784,0,28,83,43,1334,840,4455
"48061013205",1828,1610,38,0,211,41,2006,1626,7360
"48061013206",1251,1684,0,0,116,293,1303,1954,6601
"48061013207",2154,1716,0,0,468,173,2392,1875,8778
"48061013303",2709,1160,0,15,222,0,2640,1084,7830
"48061013305",2528,1481,0,0,112,157,2615,1605,8498
"48061013306",1664,1149,0,0,99,100,1763,1249,6024
"48061013307",918,780,0,0,28,55,910,835,3526
"48061013308",1884,943,0,131,150,32,1964,1087,6191
"48061013309",1209,1772,0,0,219,46,1389,1818,6453
"48061013401",934,956,3,2,149,198,1021,1154,4417
"48061013402",1008,698,0,12,58,57,1054,767,3654
"48061013500",2075,304,0,0,154,1,1930,296,4760
"48061013600",1672,1181,0,0,112,45,1601,1209,5820
"48061013700",1133,2342,0,1,208,215,1247,2557,7703
"48061013801",966,1329,10,0,68,64,1004,1341,4782
"48061013802",1465,2000,0,0,347,18,1711,1996,7537
"48061013901",1886,1148,0,0,35,71,1891,1219,6250
"48061013902",1278,2314,0,0,194,126,1472,2415,7799
"48061013903",2466,1664,0,26,196,275,2562,1965,9154
"48061014001",903,906,0,6,28,116,719,978,3656
"48061014002",739,1639,27,0,53,78,774,1717,5027
"48061014100",6254,4288,0,0,662,288,6648,4446,22586
"48061014200",2956,1256,11,0,336,475,2872,1689,9595
"48061014300",2709,1689,16,0,293,132,2819,1803,9461
"48061014400",9972,3236,83,0,1554,39,9701,3238,27823
"48061014500",6429,1692,8,0,827,56,6217,1666,16895
"48061980001",0,0,0,0,0,0,0,0,0
"48061980100",0,0,0,0,0,0,0,0,0
"48061990000",0,0,0,0,0,0,0,0,0
"48063950101",1829,455,399,146,177,13,325,181,3525
"48063950102",3447,543,210,225,48,33,305,155,4966
"48063950200",2486,785,873,381,109,84,1064,678,6460
"48065950100",2045,211,0,3,118,4,106,0,2487
"48065950200",3248,219,50,1,151,0,446,0,4115
"48067950100",4697,736,447,75,195,122,178,102,6552
"48067950200",1868,169,612,169,61,13,21,0,2913
"48067950300",1261,276,146,265,28,46,9,20,2051
"48067950400",2927,600,930,581,51,11,21,84,5205
"48067950500",2131,350,129,0,46,10,41,30,2737
"48067950600",3590,852,421,266,149,144,177,94,5693
"48067950700",3213,1037,465,438,140,55,70,176,5594
"48069950100",1032,138,0,0,65,0,187,97,1519
"48069950200",2566,1007,27,73,474,172,2034,943,7296
"48069950300",1559,304,65,27,235,187,1162,419,3958
"48071710100",5873,659,428,49,182,173,628,186,8178
"48071710200",13239,916,1109,0,1439,255,3394,434,20786
"48071710300",1379,141,299,281,229,35,203,26,2593
"48071710401",3810,425,307,10,441,176,779,214,6162
"48071710500",2507,244,275,13,250,33,856,152,4330
"48071710600",0,0,0,0,0,0,0,0,0
"48071990000",0,0,0,0,0,0,0,0,0
"48073950100",2974,763,273,79,151,49,859,429,5577
"48073950200",4652,674,61,56,81,0,446,20,5990
"48073950300",4895,1343,756,86,64,177,564,1095,8980
"48073950400",447,316,646,268,44,31,258,331,2341
"48073950500",1396,1132,606,609,141,90,940,820,5734
"48073950600",3996,666,90,472,264,0,985,262,6735
"48073950700",1659,1052,199,226,299,8,838,860,5141
"48073950801",3321,1179,175,34,154,48,182,295,5388
"48073950802",2544,482,359,0,42,16,247,185,3875
"48073950900",1642,330,128,315,71,41,171,177,2875
"48073951000",2260,307,649,335,192,47,115,76,3981
"48073951100",968,371,89,138,20,26,70,81,1763
"48075950100",729,43,5,4,13,3,13,0,810
"48075950200",3254,760,211,39,489,41,688,223,5705
"48077030200",2640,461,52,0,71,16,26,0,3266
"48077030301",4091,270,0,2,120,2,245,25,4755
"48077030302",2354,187,0,7,67,129,80,105,2929
"48079950100",2009,341,80,23,451,89,1305,344,4642
"48081950100",1361,132,3,0,21,11,135,80,1743
"48081950200",1291,195,0,0,71,1,323,33,1914
"48083950300",2849,1326,171,7,166,17,379,610,5525
"48083950600",1187,143,0,0,12,9,81,29,1461
"48083950700",1790,791,23,23,53,66,144,181,3071
"48085030100",5697,425,0,95,110,8,396,136,6867
"48085030201",2258,39,12,2,47,0,277,19,2654
"48085030202",1861,190,2,0,50,0,127,35,2265
"48085030203",10931,1277,1427,0,493,75,1993,836,17032
"48085030301",2559,77,283,0,118,0,500,0,3537
"48085030302",1677,5,198,0,92,0,0,0,1972
"48085030303",4580,372,333,0,276,38,515,0,6114
"48085030304",2084,443,164,0,69,18,388,79,3245
"48085030305",7120,443,34,125,460,422,999,497,10100
"48085030403",3783,376,139,40,698,0,618,109,5763
"48085030404",4074,217,523,20,634,194,448,286,6396
"48085030405",3349,172,453,33,852,70,667,0,5596
"48085030406",1927,187,110,32,394,0,670,89,3409
"48085030407",3089,31,229,0,356,0,428,0,4133
"48085030408",4756,864,245,0,803,62,2159,398,9287
"48085030504",1909,153,63,23,233,158,291,0,2830
"48085030505",2349,44,293,31,474,0,171,0,3362
"48085030506",2296,65,133,0,357,0,162,0,3013
"48085030507",1447,56,0,0,348,0,122,19,1992
"48085030508",5209,263,31,18,494,14,574,38,6641
"48085030509",1446,16,233,0,644,0,336,0,2675
"48085030510",1822,95,394,0,707,22,394,0,3434
"48085030511",3573,127,266,0,838,68,672,0,5544
"48085030512",3307,14,36,29,1077,0,345,0,4808
"48085030513",3183,345,707,0,883,19,931,0,6068
"48085030514",5279,80,748,120,692,0,1028,0,7947
"48085030515",4719,452,706,80,610,0,718,287,7572
"48085030516",3437,609,741,0,770,117,583,586,6843
"48085030517",4382,44,544,0,874,74,664,0,6582
"48085030518",1421,0,179,12,448,0,418,0,2478
"48085030519",1133,6,493,0,119,6,220,0,1977
"48085030520",3042,130,753,90,797,142,581,142,5677
"48085030521",2212,11,300,0,974,3,580,0,4080
"48085030522",3046,99,696,0,770,0,849,76,5536
"48085030523",5373,548,823,0,1490,161,949,474,9818
"48085030524",1666,17,469,0,109,0,456,0,2717
"48085030525",5114,216,442,0,436,91,374,0,6673
"48085030526",6445,311,671,29,425,24,1109,46,9060
"48085030527",3173,202,387,0,348,16,632,100,4858
"48085030528",6572,147,356,0,294,432,606,44,8451
"48085030529",2143,21,812,0,268,0,200,0,3444
"48085030530",5938,237,162,0,192,0,230,0,6759
"48085030531",4443,313,236,0,395,78,261,90,5816
"48085030601",7767,495,475,0,532,33,679,283,10264
"48085030603",6196,270,630,63,235,11,1270,0,8675
"48085030604",1505,16,337,0,181,0,64,0,2103
"48085030605",4387,90,1423,84,539,25,1286,23,7857
"48085030701",1926,707,25,357,179,62,843,445,4544
"48085030702",2893,1032,220,150,175,0,1001,790,6261
"48085030801",2483,484,425,16,196,16,662,439,4721
"48085030802",3560,1005,427,367,575,124,1653,986,8697
"48085030900",5433,1470,835,575,712,47,3996,1219,14287
"48085031001",5534,993,3,0,464,14,1718,307,9033
"48085031003",3266,552,189,106,165,19,704,141,5142
"48085031004",4409,547,268,54,234,49,1024,134,6719
"48085031100",7054,1154,20,370,786,36,1373,117,10910
"48085031201",4278,455,138,0,320,8,674,179,6052
"48085031202",3108,428,552,8,293,0,382,299,5070
"48085031308",5235,259,176,44,479,15,543,121,6872
"48085031309",6893,163,1320,48,913,37,1478,0,10852
"48085031310",7945,216,391,166,930,0,1496,0,11144
"48085031311",6752,437,650,75,1469,41,1148,86,10658
"48085031312",5077,126,300,23,750,268,553,0,7097
"48085031313",7748,401,867,37,3107,312,851,81,13404
"48085031314",2071,99,24,0,146,0,117,0,2457
"48085031315",9800,1117,3186,0,3267,211,1983,722,20286
"48085031316",2648,88,514,0,2935,158,659,0,7002
"48085031317",5172,110,1010,0,1502,296,684,0,8774
"48085031405",13049,100,415,17,4500,16,1220,0,19317
"48085031406",11539,704,1828,423,2341,10,1980,27,18852
"48085031407",7041,265,0,0,259,28,406,25,8024
"48085031408",1846,246,689,0,433,0,330,0,3544
"48085031409",6951,118,676,187,2367,165,1262,88,11814
"48085031410",6273,301,881,78,1010,72,632,15,9262
"48085031411",3014,48,1281,42,1146,36,640,0,6207
"48085031504",5493,215,343,0,477,53,610,21,7212
"48085031505",5608,170,234,0,1839,243,282,0,8376
"48085031506",4966,899,821,252,692,333,1391,711,10065
"48085031507",3377,133,59,0,657,52,456,0,4734
"48085031508",4126,263,664,95,681,12,813,76,6730
"48085031611",2456,118,479,29,284,0,632,0,3998
"48085031612",5100,242,113,0,1069,17,618,136,7295
"48085031613",4372,70,245,5,310,144,460,0,5606
"48085031621",4035,297,271,43,665,81,329,11,5732
"48085031622",3787,97,418,0,1021,164,555,0,6042
"48085031623",2353,93,185,25,350,6,772,66,3850
"48085031624",1898,607,295,172,454,236,763,521,4946
"48085031625",3879,73,40,12,344,39,295,1,4683
"48085031626",1850,49,88,0,443,45,196,0,2671
"48085031627",4341,174,289,0,290,77,690,100,5961
"48085031628",2701,92,269,0,367,8,633,0,4070
"48085031629",2183,419,163,79,494,117,392,330,4177
"48085031630",3142,288,96,0,587,45,291,0,4449
"48085031631",2614,536,774,43,678,138,329,329,5441
"48085031632",3278,397,349,45,1701,31,454,36,6291
"48085031633",2731,70,420,62,505,0,445,0,4233
"48085031634",2426,345,50,30,371,55,643,73,3993
"48085031635",2316,268,737,41,838,20,644,124,4988
"48085031636",4755,159,136,63,1774,21,678,86,7672
"48085031637",4449,18,419,0,1701,37,387,0,7011
"48085031638",3476,40,46,185,3642,38,287,0,7714
"48085031639",3983,107,678,26,1520,0,539,27,6880
"48085031640",4285,427,583,294,1782,175,418,148,8112
"48085031641",2827,62,379,0,3461,74,355,9,7167
"48085031642",3108,71,225,0,1189,67,195,0,4855
"48085031643",2739,216,250,28,978,42,463,122,4838
"48085031645",1682,26,57,0,242,43,44,0,2094
"48085031646",4044,10,141,0,1132,77,350,0,5754
"48085031647",2305,30,157,0,754,65,376,0,3687
"48085031648",4766,259,231,270,1795,30,478,74,7903
"48085031649",3639,195,160,50,580,0,151,0,4775
"48085031652",4134,225,437,25,2722,0,308,0,7851
"48085031653",4129,127,228,34,1533,266,593,80,6990
"48085031654",2413,175,58,0,1150,21,158,0,3975
"48085031655",3256,341,324,0,855,168,566,0,5510
"48085031656",1728,5,187,0,588,0,347,0,2855
"48085031657",894,133,218,0,274,23,65,38,1645
"48085031658",2593,409,332,0,679,34,373,290,4710
"48085031659",943,56,96,0,689,143,91,7,2025
"48085031660",1719,76,605,21,1754,94,318,46,4633
"48085031661",1137,5,12,0,1504,63,142,0,2863
"48085031662",2189,127,549,0,2362,0,245,17,5489
"48085031663",2006,9,22,0,1302,100,192,9,3640
"48085031664",2568,92,165,0,1294,94,513,0,4726
"48085031704",2714,35,339,108,429,123,507,116,4371
"48085031706",2003,30,0,0,274,9,147,0,2463
"48085031708",2333,79,602,103,366,266,219,119,4087
"48085031709",2584,182,450,154,1168,71,261,17,4887
"48085031711",2384,42,242,24,289,41,161,0,3183
"48085031712",2549,331,736,42,1378,62,509,0,5607
"48085031713",1601,95,702,149,973,340,508,327,4695
"48085031714",2269,126,1771,395,855,180,521,180,6297
"48085031715",1791,61,151,0,323,87,70,9,2492
"48085031716",1474,110,196,0,156,44,223,25,2228
"48085031717",781,616,417,62,732,60,376,11,3055
"48085031718",1948,81,143,0,167,76,237,0,2652
"48085031719",908,68,23,5,682,44,121,0,1851
"48085031720",1134,263,362,142,1640,883,1686,677,6787
"48085031802",4059,366,670,1,586,99,641,174,6596
"48085031804",2085,947,50,33,293,235,82,170,3895
"48085031805",4293,280,49,0,703,64,271,109,5769
"48085031806",480,45,71,34,1074,105,271,16,2096
"48085031807",4120,281,66,0,388,236,415,25,5531
"48085031900",1966,1218,318,157,291,144,1320,1221,6635
"48085032003",3569,1142,317,197,461,93,1925,1049,8753
"48085032004",4963,906,709,320,1004,13,2175,585,10675
"48085032008",3009,328,208,19,381,134,827,284,5190
"48085032009",3910,172,561,1,1844,89,546,44,7167
"48085032010",2611,363,438,96,1041,26,1264,274,6113
"48085032011",3658,39,407,0,1632,25,546,0,6307
"48085032012",2894,525,313,72,541,35,2120,348,6848
"48085032013",3098,496,791,116,1782,385,1652,631,8951
"48087950300",2085,434,93,28,190,144,582,350,3906
"48089750100",2538,815,786,371,254,39,1580,684,7067
"48089750200",1494,305,84,12,30,32,216,166,2339
"48089750300",3527,346,500,178,77,24,554,177,5383
"48089750400",3950,583,187,11,281,42,563,352,5969
"48089750500",2860,339,361,261,93,18,930,216,5078
"48091310100",2583,464,76,15,227,0,1053,126,4544
"48091310200",2141,312,0,10,404,0,1279,278,4424
"48091310300",5525,438,31,65,32,70,844,90,7095
"48091310401",3236,1088,84,43,475,65,2632,1128,8751
"48091310403",4262,818,150,47,411,0,1862,334,7884
"48091310404",3282,563,65,0,180,63,1263,380,5796
"48091310501",2618,635,67,27,249,98,1109,502,5305
"48091310502",3801,801,128,57,430,364,1443,910,7934
"48091310503",3326,117,0,0,112,2,963,24,4544
"48091310603",2383,310,0,0,202,17,472,172,3556
"48091310604",2308,43,18,0,117,0,206,11,2703
"48091310605",4308,504,79,0,325,0,680,111,6007
"48091310606",3332,303,32,0,150,83,224,16,4140
"48091310607",4564,218,65,0,325,0,487,0,5659
"48091310608",2869,321,8,0,19,7,426,34,3684
"48091310701",5625,382,0,4,338,28,764,37,7178
"48091310702",4518,231,63,0,228,0,677,29,5746
"48091310703",4174,565,66,0,274,213,773,489,6554
"48091310704",3993,520,78,1,1122,0,1612,24,7350
"48091310801",4361,147,199,10,401,0,634,27,5779
"48091310802",4829,758,338,1,171,15,1090,532,7734
"48091310901",3781,138,1,1,23,0,374,27,4345
"48091310902",5863,236,71,0,145,0,1398,68,7781
"48091310903",3671,93,82,0,141,0,546,0,4533
"48093950100",3133,819,20,13,242,44,488,372,5131
"48093950200",2545,634,7,0,91,119,181,356,3933
"48093950300",2521,1313,7,0,127,62,720,770,5520
"48093950400",1245,594,0,1,70,0,228,472,2610
"48095950300",2306,456,0,2,42,7,708,305,3826
"48097000100",4480,497,5,0,190,33,165,89,5459
"48097000200",4416,327,3,1,113,12,171,15,5058
"48097000400",931,312,47,119,195,74,292,91,2061
"48097000500",2294,591,77,18,202,172,1101,247,4702
"48097000600",3309,754,205,63,588,20,1106,392,6437
"48097000700",6296,381,0,0,309,34,439,0,7459
"48097000900",4226,435,2,0,79,10,361,87,5200
"48097001100",3452,1573,271,143,426,0,715,755,7335
"48099010101",2966,458,37,0,169,7,479,31,4147
"48099010102",2521,189,13,3,74,23,212,32,3067
"48099010201",268,53,0,0,26,0,66,39,452
"48099010202",4660,730,232,145,154,185,909,162,7177
"48099010300",1854,490,7,75,327,176,444,422,3795
"48099010400",3108,272,45,35,150,0,401,25,4036
"48099010501",2737,648,803,17,710,295,1158,183,6551
"48099010502",1343,398,831,0,301,173,406,0,3452
"48099010503",0,0,0,0,0,0,0,0,0
"48099010504",1176,225,1166,34,84,20,400,0,3105
"48099010601",1741,331,938,345,519,424,542,284,5124
"48099010603",3494,295,777,149,405,108,435,141,5804
"48099010604",3228,268,620,43,523,52,756,13,5503
"48099010701",3192,154,458,54,385,27,895,0,5165
"48099010702",2446,314,190,110,109,8,241,0,3418
"48099010802",3590,543,751,72,315,19,456,117,5863
"48099010803",1951,7,534,35,352,0,326,0,3205
"48099010804",2343,447,485,83,824,120,668,213,5183
"48099980000",20,0,0,0,0,0,0,0,20
"48101950100",1062,153,168,58,63,25,206,62,1797
"48103950100",2449,538,142,0,1173,67,2134,340,6843
"48105950100",2542,523,0,0,583,102,1829,510,6089
"48107950100",1418,486,65,51,42,52,663,334,3111
"48107950200",1602,603,36,31,108,126,860,630,3996
"48107950300",997,187,31,5,74,36,494,208,2032
"48109950300",1680,579,0,5,56,0,1264,545,4129
"48111950100",987,316,0,0,41,87,139,160,1730
"48111950300",3692,636,51,24,783,168,1856,651,7861
"48113000100",3472,176,129,31,173,0,250,134,4365
"48113000201",2639,103,8,0,49,26,285,26,3136
"48113000202",3040,94,111,14,281,42,349,33,3964
"48113000300",3584,299,0,32,194,101,549,92,4851
"48113000401",1127,786,229,541,2005,660,1878,849,8075
"48113000404",1750,273,66,0,1046,512,1240,584,5471
"48113000405",577,271,172,417,955,324,681,415,3812
"48113000406",2481,636,90,0,2740,1758,4168,2162,14035
"48113000500",2158,226,138,172,1078,385,1019,579,5755
"48113000601",2491,371,114,54,1585,1432,1955,1569,9571
"48113000603",3020,180,162,0,694,75,533,51,4715
"48113000605",1395,109,158,16,394,102,252,80,2506
"48113000606",2458,103,47,27,281,34,121,39,3110
"48113000701",3438,201,154,0,349,122,407,81,4752
"48113000702",1921,282,0,0,553,43,404,11,3214
"48113000800",3119,321,597,376,1239,688,2602,907,9849
"48113000900",1969,1184,77,2,628,493,1336,1258,6947
"48113001001",1548,63,0,0,140,0,312,43,2106
"48113001002",1710,128,75,0,194,79,846,129,3161
"48113001101",2938,345,14,1,213,17,804,135,4467
"48113001102",2135,61,30,0,204,0,256,0,2686
"48113001202",1896,200,396,286,370,83,923,262,4416
"48113001203",1382,170,19,0,81,4,876,170,2702
"48113001204",1754,806,0,0,196,232,1733,1038,5759
"48113001301",1487,313,87,16,363,119,427,167,2979
"48113001302",1666,186,121,151,211,32,1035,152,3554
"48113001400",2272,777,197,109,439,135,1428,654,6011
"48113001502",1596,432,259,394,230,68,1347,395,4721
"48113001503",859,1367,223,163,519,414,835,1585,5965
"48113001504",1007,202,283,242,448,188,594,218,3182
"48113001600",1645,429,593,1041,483,133,579,175,5078
"48113001701",233,0,12,0,49,0,27,0,321
"48113001703",2584,74,76,42,171,42,210,0,3199
"48113001704",1130,53,28,0,163,0,201,13,1588
"48113001800",2700,99,252,20,448,43,429,0,3991
"48113001900",3152,311,154,158,657,299,315,190,5236
"48113002000",2301,1234,901,127,523,332,2278,1495,9191
"48113002100",842,52,322,56,277,76,145,39,1809
"48113002200",1035,192,311,141,232,68,162,36,2177
"48113002400",1687,636,120,37,333,313,1809,900,5835
"48113002500",2044,607,948,417,387,55,2285,573,7316
"48113002701",169,355,897,1287,0,13,169,365,3255
"48113002702",72,47,802,542,0,24,89,45,1621
"48113003101",1687,165,254,0,577,26,306,0,3015
"48113003400",172,38,544,384,0,139,39,136,1452
"48113003700",0,4,2182,917,16,5,0,0,3124
"48113003800",64,33,1094,776,9,0,0,33,2009
"48113003901",11,0,959,630,0,0,0,0,1600
"48113003902",204,226,935,511,36,0,205,81,2198
"48113004000",5,139,464,282,0,0,0,71,961
"48113004100",222,213,164,461,38,30,218,243,1589
"48113004201",2770,663,53,69,702,55,1782,525,6619
"48113004202",1539,485,6,0,266,86,992,504,3878
"48113004300",982,451,161,21,346,95,1200,518,3774
"48113004400",2801,240,96,11,281,0,1041,90,4560
"48113004500",3483,485,276,45,1229,245,3554,495,9812
"48113004600",1169,129,101,54,53,0,623,46,2175
"48113004700",1935,1111,74,108,140,227,1836,1188,6619
"48113004800",1569,807,11,0,236,98,1688,901,5310
"48113004900",852,618,1643,710,210,148,997,687,5865
"48113005000",2743,861,209,162,265,274,2808,1038,8360
"48113005100",2113,763,0,49,151,26,1853,722,5677
"48113005200",3427,914,27,11,415,86,3262,926,9068
"48113005300",3729,1464,35,0,1225,872,4265,2288,13878
"48113005400",1945,740,1321,1104,136,161,1934,825,8166
"48113005500",790,783,1287,552,149,45,997,754,5357
"48113005600",3343,2001,1054,620,1057,344,4360,1974,14753
"48113005700",1304,570,1546,910,318,90,1494,630,6862
"48113005901",578,194,2575,1022,119,26,691,217,5422
"48113005902",442,437,1657,950,52,46,438,453,4475
"48113006001",865,1439,825,182,283,74,1104,1484,6256
"48113006002",878,322,1605,1220,81,258,507,240,5111
"48113006100",1766,848,1341,386,161,15,1524,844,6885
"48113006200",2416,888,1010,394,669,358,2262,1177,9174
"48113006301",3190,1114,603,90,777,409,3574,1302,11059
"48113006302",2511,559,103,23,833,118,2774,534,7455
"48113006401",1351,179,24,0,814,83,2060,171,4682
"48113006402",2848,1253,126,0,1599,93,4301,1234,11454
"48113006501",2640,1034,70,52,1682,433,4069,1452,11432
"48113006502",2257,530,39,0,833,255,2754,769,7437
"48113006700",3673,1607,44,0,1738,429,4707,1794,13992
"48113006800",2151,1002,267,197,1210,412,2889,1273,9401
"48113006900",1220,1132,121,173,462,144,1264,1196,5712
"48113007101",1713,89,0,0,250,0,163,0,2215
"48113007102",2359,186,1821,448,1161,743,1876,814,9408
"48113007201",2959,1113,350,0,3225,1284,5494,2068,16493
"48113007202",2898,896,102,68,2710,1457,4760,1946,14837
"48113007301",1925,32,1,1,56,0,60,0,2075
"48113007302",3634,167,103,0,538,473,1226,503,6644
"48113007601",1743,45,72,0,74,0,182,0,2116
"48113007604",2850,68,190,0,251,0,12,0,3371
"48113007605",1727,22,0,36,94,0,66,6,1951
"48113007700",4034,296,0,2,413,17,183,16,4961
"48113007801",1991,132,0,0,78,0,99,0,2300
"48113007804",1188,662,2425,525,286,30,721,440,6277
"48113007805",1533,99,757,161,133,54,364,9,3110
"48113007809",1498,145,114,123,21,96,302,81,2380
"48113007810",2479,240,726,212,213,17,382,195,4464
"48113007811",1104,204,1788,1271,227,329,442,322,5687
"48113007812",2855,10,53,0,138,11,135,0,3202
"48113007815",1152,1724,551,246,307,711,868,1493,7052
"48113007818",2104,1141,769,391,456,320,1778,1166,8125
"48113007819",795,549,266,121,168,53,371,481,2804
"48113007820",1727,1511,989,617,297,544,1065,1752,8502
"48113007821",1428,418,391,141,740,189,1524,443,5274
"48113007822",732,150,103,0,58,16,115,31,1205
"48113007823",207,101,70,6,32,148,142,249,955
"48113007824",1448,0,126,0,61,0,68,0,1703
"48113007825",2761,700,994,793,138,0,939,503,6828
"48113007826",90,21,128,8,3,10,0,0,260
"48113007827",679,154,768,545,204,16,255,14,2635
"48113007902",3664,633,324,13,159,0,240,322,5355
"48113007903",1644,137,16,37,55,23,86,38,2036
"48113007906",2049,136,10,0,107,15,93,30,2440
"48113007909",1276,154,304,23,380,9,362,16,2524
"48113007910",1705,258,133,18,769,164,454,13,3514
"48113007911",2185,440,151,37,104,0,283,127,3327
"48113007912",1441,81,37,30,185,5,228,9,2016
"48113007913",1611,77,139,237,130,21,559,5,2779
"48113007914",1202,656,249,45,362,131,177,95,2917
"48113008000",5843,12,0,0,331,0,228,0,6414
"48113008100",5710,480,221,1,151,0,1004,76,7643
"48113008200",2875,336,291,253,168,114,741,148,4926
"48113008400",3995,1709,355,74,1575,977,4714,2472,15871
"48113008500",2326,709,187,118,1153,499,3102,1137,9231
"48113008603",259,113,366,468,34,11,380,121,1752
"48113008604",451,207,983,1310,11,13,437,160,3572
"48113008701",104,71,1640,1875,106,0,144,80,4020
"48113008703",362,545,970,514,327,36,600,527,3881
"48113008704",188,237,1875,1102,0,0,102,189,3693
"48113008705",212,59,671,143,164,0,370,47,1666
"48113008801",268,148,1246,682,57,0,292,153,2846
"48113008802",1015,906,2217,1755,133,147,1163,1038,8374
"48113008900",236,484,1186,893,206,23,402,427,3857
"48113009000",3077,927,1602,1097,1226,552,3703,1345,13529
"48113009101",1725,619,616,489,1918,320,3054,932,9673
"48113009103",1482,706,834,155,212,144,1555,789,5877
"48113009104",1427,880,402,295,366,223,1607,1144,6344
"48113009105",1497,474,179,198,1208,687,2232,1115,7590
"48113009201",3851,790,750,383,730,146,3866,910,11426
"48113009202",2943,1080,351,325,904,373,3468,1309,10753
"48113009301",2787,1323,231,128,973,185,3397,1389,10413
"48113009303",1675,1013,335,92,625,239,2236,1213,7428
"48113009304",761,595,1631,2404,117,358,775,845,7486
"48113009401",2031,227,223,0,867,45,1715,231,5339
"48113009402",2095,100,8,13,210,0,360,43,2829
"48113009500",1806,76,72,0,274,0,360,0,2588
"48113009603",3521,98,168,77,579,49,520,10,5022
"48113009604",2831,461,295,49,511,136,796,396,5475
"48113009605",2042,465,228,0,446,387,1660,671,5899
"48113009607",2727,150,212,3,955,53,1454,146,5700
"48113009608",2896,256,216,150,512,399,1368,476,6273
"48113009609",2812,66,45,14,34,0,310,0,3281
"48113009610",2073,898,98,144,1161,1158,2718,1733,9983
"48113009611",2165,264,105,0,873,82,1947,271,5707
"48113009701",3118,417,284,73,945,410,2463,660,8370
"48113009702",2487,214,0,0,67,0,259,0,3027
"48113009802",2342,923,106,0,1686,898,3613,1591,11159
"48113009803",958,311,180,62,647,46,1054,245,3503
"48113009804",2220,1715,48,287,2033,1734,3739,2810,14586
"48113009900",1143,269,404,7,682,198,829,234,3766
"48113010000",1062,143,855,612,379,531,381,78,4041
"48113010101",977,625,1269,623,749,34,1276,607,6160
"48113010102",1570,531,125,0,724,437,2015,933,6335
"48113010500",1156,241,918,151,558,228,1387,412,5051
"48113010601",2729,819,64,43,1833,679,4292,1481,11940
"48113010602",1320,298,130,187,219,485,1252,550,4441
"48113010701",1708,1347,312,18,1072,255,2543,1415,8670
"48113010703",1388,288,40,180,583,531,1611,784,5405
"48113010704",2134,455,564,429,756,426,2415,874,8053
"48113010801",5453,1287,921,446,1256,433,6278,1620,17694
"48113010803",2326,242,2420,394,734,145,1961,179,8401
"48113010804",1363,341,521,828,979,253,2163,581,7029
"48113010805",2358,935,980,569,632,680,2864,1497,10515
"48113010902",489,69,4018,1127,63,37,403,159,6365
"48113010903",766,232,1285,361,489,1,1109,215,4458
"48113010904",320,106,1751,873,166,57,406,120,3799
"48113011001",496,22,4568,1163,299,122,353,142,7165
"48113011002",489,63,1910,386,66,0,380,62,3356
"48113011101",206,2,3485,166,27,0,139,1,4026
"48113011103",868,336,1551,163,125,400,798,684,4925
"48113011104",187,205,2100,623,185,138,316,320,4074
"48113011105",420,395,1606,1120,115,143,503,527,4829
"48113011200",494,472,3708,1211,240,106,742,495,7468
"48113011300",0,165,3774,741,44,0,0,140,4864
"48113011401",186,172,2647,2066,95,5,280,129,5580
"48113011500",509,682,343,467,5,44,491,711,3252
"48113011601",1490,589,1554,714,69,135,1392,654,6597
"48113011602",2768,1419,779,196,1259,250,3616,1297,11584
"48113011701",3287,1385,1296,769,440,233,3398,1551,12359
"48113011702",2535,952,261,35,871,237,2639,1052,8582
"48113011800",2891,1919,2190,1175,633,791,3027,2397,15023
"48113011900",3732,1333,2793,387,608,500,4045,1769,15167
"48113012000",2439,498,2443,1138,860,159,3006,567,11110
"48113012100",1605,273,1771,985,1035,250,2228,498,8645
"48113012204",2919,413,942,836,643,507,1231,566,8057
"48113012206",1721,95,1981,476,319,31,1042,87,5752
"48113012207",1264,1253,2938,479,1122,360,1974,1422,10812
"48113012208",494,336,442,504,612,501,870,798,4557
"48113012209",1768,328,167,159,587,227,886,577,4699
"48113012210",792,317,899,840,684,359,778,583,5252
"48113012211",942,288,1241,593,928,321,1294,569,6176
"48113012301",1833,762,328,165,1369,542,2283,1103,8385
"48113012302",874,777,672,2269,2022,591,2236,879,10320
"48113012400",3407,152,349,0,978,122,1841,56,6905
"48113012500",3604,597,236,203,2299,697,3785,638,12059
"48113012601",1254,111,674,211,2579,1460,2440,1161,9890
"48113012603",1024,305,84,9,527,174,802,388,3313
"48113012604",1699,673,1501,396,1305,800,1572,1076,9022
"48113012701",2718,388,390,11,1767,1329,3286,1374,11263
"48113012702",1039,314,88,78,1362,361,1661,534,5437
"48113012800",6260,611,268,77,398,105,2523,478,10720
"48113012900",3725,207,82,138,10,28,590,33,4813
"48113013004",5217,113,240,70,291,42,366,8,6347
"48113013005",3151,169,9,0,125,0,176,103,3733
"48113013007",1752,331,361,130,550,147,414,322,4007
"48113013008",2472,292,307,0,455,42,186,268,4022
"48113013009",2444,193,1226,256,328,0,808,46,5301
"48113013010",2621,936,606,339,434,98,2194,869,8097
"48113013011",2172,876,800,212,370,187,2238,1021,7876
"48113013101",2235,93,9,0,203,0,114,10,2664
"48113013102",1456,8,22,0,117,6,140,6,1755
"48113013104",934,49,0,0,59,39,100,28,1209
"48113013105",2698,733,1039,555,872,382,1726,728,8733
"48113013200",4962,662,223,2,600,188,455,204,7296
"48113013300",1959,4,68,0,266,0,222,0,2519
"48113013400",1913,31,0,13,124,0,85,0,2166
"48113013500",2316,29,6,0,53,0,108,0,2512
"48113013605",4567,41,80,0,534,0,363,16,5601
"48113013606",2903,287,918,92,1514,304,1514,330,7862
"48113013607",2763,100,74,66,299,308,311,344,4265
"48113013608",2338,29,47,0,42,0,124,0,2580
"48113013609",2422,140,373,35,556,319,802,231,4878
"48113013610",2482,67,346,21,964,339,1191,297,5707
"48113013611",2004,89,28,36,226,0,173,0,2556
"48113013615",1127,241,612,532,1658,810,1814,930,7724
"48113013616",2842,390,635,112,1408,177,1139,268,6971
"48113013617",2191,92,0,59,396,158,319,73,3288
"48113013618",1937,71,9,20,344,27,184,29,2621
"48113013619",4019,32,110,46,547,101,313,83,5251
"48113013620",2647,184,862,0,575,12,481,28,4789
"48113013621",1725,88,967,228,644,240,725,189,4806
"48113013622",1457,85,297,115,799,276,487,333,3849
"48113013623",1888,455,1386,236,1862,337,1724,570,8458
"48113013624",1396,81,604,130,984,211,670,138,4214
"48113013625",441,89,553,170,1156,632,1103,662,4806
"48113013626",1535,256,304,9,655,482,1092,562,4895
"48113013711",1611,546,235,11,509,145,1481,552,5090
"48113013712",1649,335,0,35,283,89,1147,250,3788
"48113013713",973,641,0,0,112,310,882,884,3802
"48113013714",4246,1010,37,0,824,198,3799,1141,11255
"48113013715",1842,106,27,0,406,0,1531,74,3986
"48113013716",3044,442,147,59,786,166,1294,540,6478
"48113013717",1810,378,27,1,361,52,1543,301,4473
"48113013718",2471,883,411,97,533,354,2351,1098,8198
"48113013719",2138,87,195,13,1119,199,823,22,4596
"48113013720",3569,702,399,32,689,284,2168,875,8718
"48113013721",4267,49,284,0,1265,69,992,35,6961
"48113013722",1966,244,580,32,708,0,555,102,4187
"48113013725",2309,593,757,14,416,188,1155,694,6126
"48113013726",2492,308,296,0,372,10,1018,295,4791
"48113013727",1850,93,670,0,414,40,466,40,3573
"48113013803",4771,219,157,0,461,17,1362,125,7112
"48113013804",2390,117,89,24,389,0,847,102,3958
"48113013805",1467,632,226,158,265,208,897,556,4409
"48113013806",1907,72,208,68,708,13,436,0,3412
"48113013901",2066,506,57,0,575,21,1821,440,5486
"48113013902",2843,837,0,0,296,85,1108,639,5808
"48113014001",2897,464,145,0,458,149,1107,282,5502
"48113014002",114,0,0,0,0,15,0,15,144
"48113014103",843,374,849,270,686,261,748,443,4474
"48113014113",2015,78,1494,112,857,69,1300,70,5995
"48113014114",1166,207,639,123,644,227,890,326,4222
"48113014115",4496,421,580,229,1847,51,3452,277,11353
"48113014116",1202,274,1268,131,904,120,607,158,4664
"48113014119",3270,114,32,0,606,54,284,9,4369
"48113014120",4116,10,80,12,740,0,430,0,5388
"48113014121",3301,161,709,90,897,269,519,52,5998
"48113014123",4175,59,155,0,1540,130,671,30,6760
"48113014124",2431,93,215,14,1368,17,609,8,4755
"48113014126",4236,364,115,19,1222,0,531,241,6728
"48113014127",1974,162,935,265,4613,103,306,87,8445
"48113014128",1676,34,373,67,1175,71,339,16,3751
"48113014129",1702,27,425,14,2954,195,180,0,5497
"48113014130",1774,61,184,107,1830,170,610,36,4772
"48113014131",1494,226,1206,280,956,83,283,0,4528
"48113014132",884,89,286,197,725,132,158,0,2471
"48113014133",1655,226,1069,481,702,51,493,206,4883
"48113014134",2696,25,104,0,1180,0,386,0,4391
"48113014135",3133,107,124,0,1037,71,546,114,5132
"48113014136",2027,121,1662,44,1732,73,544,51,6254
"48113014137",1720,95,305,32,1482,0,450,18,4102
"48113014138",1857,220,181,19,1406,91,316,0,4090
"48113014203",1794,533,228,294,590,0,946,291,4676
"48113014204",599,347,163,96,277,128,151,172,1933
"48113014205",1064,19,52,0,357,0,125,4,1621
"48113014206",2062,194,585,37,875,51,598,76,4478
"48113014302",5463,535,266,13,607,149,3109,350,10492
"48113014306",3371,644,291,116,787,235,2637,800,8881
"48113014307",2656,310,513,0,554,101,532,143,4809
"48113014308",2114,646,260,298,865,42,2037,562,6824
"48113014309",1457,909,922,438,897,566,1430,1042,7661
"48113014310",2032,277,810,401,660,267,1196,238,5881
"48113014311",773,48,305,190,3173,286,336,149,5260
"48113014312",2403,188,719,82,1910,29,867,0,6198
"48113014403",1562,249,1131,85,624,226,1197,284,5358
"48113014405",1901,528,145,0,967,0,2062,413,6016
"48113014406",3027,699,169,10,462,307,1967,984,7625
"48113014407",2204,255,791,199,1170,105,2321,201,7246
"48113014408",1952,100,1065,57,907,169,1635,165,6050
"48113014501",2270,243,132,37,812,10,1895,42,5441
"48113014502",2448,695,34,31,1030,215,2126,578,7157
"48113014601",1467,254,7,2,295,16,943,256,3240
"48113014602",2290,852,188,70,1300,163,2594,953,8410
"48113014603",665,412,31,6,372,102,712,436,2736
"48113014701",1974,711,193,238,860,394,2226,1073,7669
"48113014702",1610,1201,49,3,779,553,1531,1684,7410
"48113014703",929,118,14,28,450,108,1014,158,2819
"48113014901",864,134,0,3,394,219,976,349,2939
"48113014902",798,610,99,60,692,30,1022,532,3843
"48113015000",4586,1789,252,126,1119,232,3870,1747,13721
"48113015100",3139,812,371,22,2127,395,3049,815,10730
"48113015202",1756,979,99,0,713,563,1936,1461,7507
"48113015204",5237,1432,0,0,802,120,2810,1008,11409
"48113015205",1770,620,28,31,789,300,1905,822,6265
"48113015206",2389,279,337,59,474,174,1630,247,5589
"48113015303",1576,304,81,0,219,8,1193,280,3661
"48113015304",2154,406,86,0,711,89,1577,376,5399
"48113015305",2763,478,460,44,488,74,1840,273,6420
"48113015306",2796,253,295,221,1535,49,1099,139,6387
"48113015401",4244,484,979,73,548,24,1315,130,7797
"48113015403",1628,802,277,76,351,35,1140,772,5081
"48113015404",1901,1122,383,210,448,249,1771,1167,7251
"48113015500",2429,640,82,138,287,219,1843,752,6390
"48113015600",2923,597,19,250,1174,204,3595,889,9651
"48113015700",1497,502,110,0,249,86,1282,503,4229
"48113015800",1444,636,0,0,88,180,1204,775,4327
"48113015900",1978,669,658,132,515,104,1712,672,6440
"48113016001",3007,840,48,94,490,156,2337,797,7769
"48113016002",1353,910,99,50,288,146,1367,996,5209
"48113016100",1312,445,1080,660,290,53,785,317,4942
"48113016201",2846,664,422,305,496,56,2285,570,7644
"48113016202",4332,1392,128,355,1145,177,2840,1338,11707
"48113016301",3317,788,701,174,1510,127,3611,728,10956
"48113016302",1220,210,245,60,230,26,1007,213,3211
"48113016401",5341,449,2067,155,1576,80,3811,420,13899
"48113016406",2639,524,480,464,565,39,1911,651,7273
"48113016407",3508,1254,595,258,1350,273,3309,1462,12009
"48113016408",3998,529,1170,1,779,57,2906,396,9836
"48113016409",1883,56,701,0,548,61,782,92,4123
"48113016410",3055,346,1089,84,686,25,1356,202,6843
"48113016411",5150,552,1815,239,1031,116,2730,505,12138
"48113016412",2259,65,976,19,750,0,895,11,4975
"48113016413",3408,347,1552,156,1360,47,2108,105,9083
"48113016502",3766,925,1102,4,1005,126,2771,801,10500
"48113016509",2824,301,1847,306,361,61,1102,170,6972
"48113016510",4368,406,5065,462,1544,565,3942,859,17211
"48113016511",999,78,1314,302,606,204,785,262,4550
"48113016513",2499,154,1684,121,724,4,850,11,6047
"48113016514",2875,0,3658,362,474,0,1313,0,8682
"48113016516",2343,458,742,316,1415,228,2573,520,8595
"48113016517",2147,317,1238,180,360,140,1256,368,6006
"48113016518",2499,314,1032,281,889,236,1853,356,7460
"48113016519",1609,48,381,0,208,4,773,0,3023
"48113016520",2600,299,1593,635,1394,274,2901,424,10120
"48113016521",1026,578,1966,405,295,55,615,221,5161
"48113016522",2012,309,522,66,79,0,584,251,3823
"48113016523",2397,27,1216,26,543,27,549,26,4811
"48113016605",1321,903,2459,1925,377,57,888,849,8779
"48113016606",2428,287,3005,481,553,7,1740,179,8680
"48113016607",183,101,1733,731,268,94,128,154,3392
"48113016610",513,185,2754,715,128,90,194,81,4660
"48113016611",1475,154,3695,545,102,25,592,20,6608
"48113016612",2843,2,9798,88,307,60,1468,54,14620
"48113016615",1159,124,2306,309,110,58,470,43,4579
"48113016616",2245,53,2520,299,421,20,1060,30,6648
"48113016617",1428,20,3208,184,352,0,478,0,5670
"48113016618",1394,56,1957,579,190,55,390,16,4637
"48113016619",1058,64,2075,361,140,169,534,43,4444
"48113016620",1555,145,3086,173,154,0,396,0,5509
"48113016621",1127,483,2880,503,344,14,747,360,6458
"48113016622",715,86,2702,339,66,14,351,33,4306
"48113016623",1846,96,2892,332,472,33,1189,125,6985
"48113016624",1155,30,1918,56,92,58,665,21,3995
"48113016625",1754,0,5890,531,701,123,958,0,9957
"48113016626",1435,352,1815,438,400,497,629,578,6144
"48113016701",36,67,4315,1537,35,34,22,89,6135
"48113016703",2644,858,5033,1035,502,277,2065,818,13232
"48113016704",739,285,2227,473,159,0,489,251,4623
"48113016705",1219,420,3791,757,322,0,1014,168,7691
"48113016802",1270,163,1516,88,22,7,597,82,3745
"48113016803",2442,273,2618,841,276,82,1432,235,8199
"48113016804",1153,14,5859,607,310,0,968,0,8911
"48113016902",1636,611,1470,319,269,125,1152,595,6177
"48113016903",1994,1042,703,209,196,194,1167,1032,6537
"48113017001",4582,581,1424,228,162,161,1874,256,9268
"48113017003",6816,968,1088,124,292,220,3073,899,13480
"48113017004",5210,1820,551,46,267,517,3857,1699,13967
"48113017101",2910,775,628,113,228,19,1893,479,7045
"48113017102",1947,948,821,280,577,235,1692,1003,7503
"48113017201",2280,1547,1017,228,320,314,1625,1567,8898
"48113017202",3801,1956,1901,763,518,184,2867,1483,13473
"48113017301",3540,544,929,243,321,127,1890,574,8168
"48113017303",4092,809,2133,87,680,22,1732,611,10166
"48113017304",4792,939,2526,216,1385,0,2179,871,12908
"48113017305",4452,176,3000,968,1301,0,2087,0,11984
"48113017306",3385,765,2559,150,350,74,1644,674,9601
"48113017400",4024,490,751,231,77,0,1655,196,7424
"48113017500",2636,279,934,8,92,125,781,44,4899
"48113017602",2843,406,845,151,150,36,1932,290,6653
"48113017604",2686,69,379,219,192,74,1883,113,5615
"48113017605",1021,207,1013,439,1047,429,1921,636,6713
"48113017606",2713,471,772,228,246,0,1774,371,6575
"48113017702",4700,579,1661,784,595,72,1871,214,10476
"48113017703",2807,722,438,450,69,16,1944,577,7023
"48113017704",3165,699,675,433,461,31,1593,490,7547
"48113017804",3153,856,864,445,815,286,1472,956,8847
"48113017805",3401,604,1785,389,307,9,1695,516,8706
"48113017806",2278,757,437,255,807,37,1338,659,6568
"48113017807",3878,589,403,120,567,51,2247,246,8101
"48113017808",2964,291,530,65,411,38,651,72,5022
"48113017811",3090,221,339,22,522,82,1292,49,5617
"48113017812",1614,41,242,17,267,46,338,0,2565
"48113017813",2680,344,1155,234,1217,94,1395,336,7455
"48113017814",3334,82,766,145,1167,65,1058,0,6617
"48113017900",3244,679,130,301,828,220,2281,745,8428
"48113018001",3602,251,597,213,628,157,1789,283,7520
"48113018002",2235,655,187,88,403,27,1396,279,5270
"48113018104",4820,246,756,0,1268,255,1037,0,8382
"48113018105",1934,208,521,378,2543,807,3095,833,10319
"48113018110",3237,344,253,110,542,28,288,151,4953
"48113018111",3093,99,992,494,1866,340,2140,460,9484
"48113018118",2537,235,1990,400,2266,57,998,147,8630
"48113018120",1533,143,575,9,2250,187,1481,95,6273
"48113018121",1828,162,664,364,2391,170,2282,109,7970
"48113018122",9324,420,1198,47,1681,344,2318,314,15646
"48113018123",3684,186,858,29,2256,284,1623,70,8990
"48113018124",11167,80,3283,0,2151,44,2751,69,19545
"48113018126",3174,246,1134,50,1414,48,1809,149,8024
"48113018127",1415,141,642,44,1169,106,1487,181,5185
"48113018128",1751,319,1303,414,1731,320,2015,505,8358
"48113018129",2453,41,950,10,675,33,819,30,5011
"48113018130",1760,292,863,513,377,60,658,135,4658
"48113018132",2811,138,733,686,1294,109,1094,83,6948
"48113018133",3145,119,136,0,314,17,1039,39,4809
"48113018134",3901,205,984,0,231,203,590,292,6406
"48113018135",2666,47,1333,16,158,0,872,2,5094
"48113018136",6001,201,722,0,1103,155,1074,27,9283
"48113018137",1639,157,990,85,1001,0,902,11,4785
"48113018138",1505,99,1250,275,1136,322,772,171,5530
"48113018139",3953,859,827,55,656,142,1098,552,8142
"48113018140",3513,19,741,0,645,385,814,303,6420
"48113018141",1564,381,673,129,378,109,606,224,4064
"48113018142",1886,17,391,20,625,149,774,151,4013
"48113018203",1690,407,1193,278,2419,501,2829,604,9921
"48113018204",591,516,487,174,2199,771,2614,1141,8493
"48113018205",1380,177,150,102,1807,947,1917,1013,7493
"48113018206",1831,367,86,59,1555,919,2360,1038,8215
"48113018300",2318,368,430,18,3331,635,3590,679,11369
"48113018401",1712,281,179,41,1428,1161,1452,1289,7543
"48113018402",2328,245,124,41,656,275,1061,393,5123
"48113018403",267,73,208,0,207,56,267,104,1182
"48113018501",1552,401,212,105,1036,483,1148,750,5687
"48113018503",1039,515,1845,1395,355,24,938,295,6406
"48113018505",1391,439,930,241,281,173,1346,209,5010
"48113018506",625,541,1553,148,51,130,516,649,4213
"48113018600",2084,133,83,42,874,274,1138,321,4949
"48113018700",2419,146,92,31,2500,1574,3289,1665,11716
"48113018801",1581,175,280,8,1621,744,1706,481,6596
"48113018802",319,85,14,138,237,153,230,200,1376
"48113018900",2485,373,439,185,2377,696,2786,402,9743
"48113019004",3817,196,634,373,1636,47,2401,48,9152
"48113019013",477,349,209,411,2339,2160,2418,2283,10646
"48113019014",1428,268,563,75,3806,2114,3329,1465,13048
"48113019016",920,622,553,432,530,166,311,448,3982
"48113019018",2059,535,731,397,860,71,634,329,5616
"48113019019",1935,720,2059,764,1034,474,1320,755,9061
"48113019020",2210,149,302,21,2172,211,584,95,5744
"48113019021",3210,419,201,236,2557,682,2030,569,9904
"48113019023",3622,113,236,15,791,23,334,10,5144
"48113019024",2130,404,443,39,1123,155,632,234,5160
"48113019025",2714,27,356,73,1859,0,834,12,5875
"48113019026",2654,216,397,78,1847,255,1225,95,6767
"48113019027",1665,191,754,23,1901,225,674,22,5455
"48113019028",1486,180,379,59,1540,159,1137,78,5018
"48113019029",2641,139,859,188,1630,610,1212,275,7554
"48113019031",4093,89,682,2,1140,89,858,82,7035
"48113019032",1119,42,183,69,1951,1000,1944,795,7103
"48113019033",1283,184,311,14,1265,1385,1506,1263,7211
"48113019034",1404,166,1342,527,476,251,523,45,4734
"48113019035",1894,783,1022,394,325,197,1174,835,6624
"48113019036",2234,101,23,0,308,0,176,0,2842
"48113019037",2627,118,293,3,495,142,543,19,4240
"48113019038",561,7,92,0,143,46,29,0,878
"48113019039",3050,282,328,503,1492,253,927,288,7123
"48113019040",1822,132,1285,90,2139,191,394,18,6071
"48113019041",1674,58,371,6,515,13,107,1,2745
"48113019042",2816,91,489,11,1561,141,747,20,5876
"48113019043",5167,167,335,0,1429,0,355,0,7453
"48113019100",3356,390,417,58,1522,115,968,12,6838
"48113019202",2375,457,119,79,811,701,1048,861,6451
"48113019203",3022,350,16,0,210,92,248,118,4056
"48113019204",4906,762,495,461,2603,406,4423,1063,15119
"48113019205",2985,40,0,0,220,5,138,0,3388
"48113019206",2717,1124,83,55,677,1040,468,128,6292
"48113019208",1508,258,862,219,2315,2073,3133,2102,12470
"48113019210",3445,151,0,0,162,0,147,0,3905
"48113019211",2926,520,354,0,698,76,526,273,5373
"48113019212",232,416,29,36,1702,1331,1894,1722,7362
"48113019213",545,493,253,306,909,1018,1003,1027,5554
"48113019301",2845,10,0,0,37,0,57,0,2949
"48113019302",2016,284,0,0,186,0,188,8,2682
"48113019400",3074,394,0,0,226,142,98,0,3934
"48113019501",7053,27,0,0,196,0,115,0,7391
"48113019502",3855,86,0,0,254,21,93,21,4330
"48113019600",2175,51,0,0,219,10,142,10,2607
"48113019700",1718,64,0,0,27,0,97,12,1918
"48113019800",3967,257,0,0,209,0,281,10,4724
"48113019900",1554,1102,93,0,1183,314,2482,1144,7872
"48113020000",2602,154,273,20,1151,0,478,35,4713
"48113020100",1057,427,62,20,584,139,1037,421,3747
"48113020200",369,38,2017,1414,9,154,364,158,4523
"48113020300",132,69,1164,805,9,0,70,39,2288
"48113020400",2322,514,794,674,788,83,883,64,6122
"48113020500",504,511,1096,1837,584,645,754,755,6686
"48113020600",2212,23,1,0,112,1,221,0,2570
"48113020700",3672,23,438,8,436,0,796,0,5373
"48113980000",0,0,0,0,0,0,0,0,0
"48113980100",0,0,0,0,0,0,0,0,0
"48115950401",3370,301,25,47,662,363,2086,547,7401
"48115950402",904,379,2,22,169,2,603,348,2429
"48115950500",2290,609,126,49,246,248,1349,793,5710
"48115950600",1170,446,1,46,115,38,391,306,2513
"48117950300",4680,780,76,0,446,119,3039,765,9905
"48117950400",3839,814,0,0,590,330,3050,1135,9758
"48117950500",1874,961,12,23,386,250,1977,1045,6528
"48117950600",3350,283,33,11,125,29,1717,287,5835
"48119950100",2237,413,82,25,180,29,111,46,3123
"48119950200",1531,238,126,189,71,27,126,30,2338
"48121020103",8283,646,14,11,940,104,2180,366,12544
"48121020104",2640,113,43,0,259,84,463,116,3718
"48121020105",5832,269,358,64,529,0,1328,0,8380
"48121020106",5148,203,352,17,251,13,693,13,6690
"48121020107",3993,277,415,9,243,0,847,37,5821
"48121020108",6665,511,2337,23,1096,49,1357,276,12314
"48121020109",1607,36,431,0,556,36,202,5,2873
"48121020110",3480,129,552,0,1070,0,498,0,5729
"48121020111",3534,54,235,0,96,0,680,6,4605
"48121020112",2259,19,267,0,503,28,302,9,3387
"48121020113",6595,142,2004,137,1217,9,2393,78,12575
"48121020114",6219,463,612,74,448,664,2603,272,11355
"48121020115",3748,515,246,0,339,170,977,459,6454
"48121020202",9148,227,52,67,419,39,1925,129,12006
"48121020203",3453,1000,292,26,219,0,356,440,5786
"48121020204",3444,272,77,17,76,16,257,14,4173
"48121020205",1548,82,8,0,114,114,378,44,2288
"48121020303",9027,751,0,17,420,0,1169,356,11740
"48121020305",6237,128,169,0,335,0,308,0,7177
"48121020306",5334,95,203,0,764,97,719,4,7216
"48121020307",7341,282,184,0,563,0,883,40,9293
"48121020308",8234,374,531,0,613,79,1812,49,11692
"48121020309",7653,683,91,6,425,4,576,177,9615
"48121020310",2488,67,8,0,88,0,249,0,2900
"48121020401",4415,589,481,0,649,148,1336,177,7795
"48121020402",3133,432,379,192,422,22,571,22,5173
"48121020403",2474,735,107,54,183,46,293,207,4099
"48121020503",4321,653,581,88,314,275,1122,226,7580
"48121020504",2273,226,159,219,147,65,939,74,4102
"48121020505",6436,204,169,3,78,12,857,0,7759
"48121020506",1571,188,0,0,95,0,364,163,2381
"48121020601",1563,936,276,150,206,377,507,655,4670
"48121020602",5251,753,612,425,1250,69,2477,477,11314
"48121020700",1355,1225,30,158,368,408,138,269,3951
"48121020800",2247,1165,406,548,309,149,369,318,5511
"48121020900",1129,865,17,38,346,366,544,579,3884
"48121021000",1042,915,114,38,86,374,167,332,3068
"48121021100",868,846,164,125,215,228,153,89,2688
"48121021201",2546,749,829,539,577,512,827,244,6823
"48121021202",1443,275,635,452,242,49,917,158,4171
"48121021301",1047,1277,297,178,110,248,293,177,3627
"48121021303",4762,130,614,1,394,322,671,16,6910
"48121021304",3822,525,370,151,679,60,1270,236,7113
"48121021305",2744,501,259,105,232,11,396,187,4435
"48121021403",8743,313,262,3,850,75,1463,142,11851
"48121021404",7387,148,139,0,417,58,698,58,8905
"48121021405",6259,1437,379,1,1278,231,2210,1037,12832
"48121021406",5785,102,605,0,887,0,1593,0,8972
"48121021407",4449,1107,606,24,291,161,858,961,8457
"48121021408",5173,107,344,59,401,0,756,0,6840
"48121021409",6510,304,121,327,422,284,797,96,8861
"48121021502",3139,570,206,26,430,125,1463,552,6511
"48121021505",4332,373,547,88,706,0,882,271,7199
"48121021512",4233,174,66,0,218,46,268,0,5005
"48121021513",3386,27,0,0,53,0,236,0,3702
"48121021514",3999,14,28,0,267,0,270,0,4578
"48121021515",5086,337,430,2,621,226,1290,436,8428
"48121021516",5440,94,239,131,860,107,1068,177,8116
"48121021517",931,25,161,0,1124,46,224,0,2511
"48121021518",2665,0,125,0,425,11,135,0,3361
"48121021519",8025,558,890,301,2036,213,1817,178,14018
"48121021520",3011,127,191,16,337,0,424,10,4116
"48121021521",3314,179,198,0,703,27,966,0,5387
"48121021522",853,6,53,0,312,89,151,0,1464
"48121021523",2683,282,64,30,562,0,1146,161,4928
"48121021524",1357,0,136,0,183,0,80,0,1756
"48121021525",5936,128,507,1,1634,0,788,37,9031
"48121021526",4756,46,507,38,821,12,320,0,6500
"48121021527",4555,251,162,124,657,0,210,187,6146
"48121021611",2672,167,433,0,786,116,654,158,4986
"48121021612",2358,46,176,8,942,22,504,15,4071
"48121021613",2910,746,537,260,924,249,1712,541,7879
"48121021614",2100,294,353,22,806,17,1530,276,5398
"48121021615",3418,88,83,155,545,54,1868,45,6256
"48121021616",1940,252,753,321,717,12,748,128,4871
"48121021618",2966,821,119,148,399,86,1357,785,6681
"48121021619",1469,334,260,0,775,53,1300,294,4485
"48121021620",1040,72,213,47,364,39,249,0,2024
"48121021621",2689,23,182,0,914,11,329,0,4148
"48121021622",3079,61,322,182,1486,184,477,0,5791
"48121021623",2109,124,840,0,2789,207,438,43,6550
"48121021624",3988,169,1401,0,2252,355,1890,130,10185
"48121021625",2866,13,273,9,1215,7,295,0,4678
"48121021626",1878,142,0,0,88,0,50,0,2158
"48121021627",5169,276,322,0,727,55,395,49,6993
"48121021628",3952,162,620,13,2087,1,1767,1,8603
"48121021629",3968,136,238,11,1328,48,520,0,6249
"48121021630",3290,21,985,129,823,0,845,0,6093
"48121021631",3613,192,238,52,1096,42,744,50,6027
"48121021632",2600,165,180,188,229,0,247,51,3660
"48121021633",3439,84,323,0,673,87,581,51,5238
"48121021634",2492,516,1223,287,268,174,1023,196,6179
"48121021635",1832,495,846,109,498,226,702,292,5000
"48121021636",3657,333,1800,579,773,10,1401,115,8668
"48121021637",2389,449,603,177,531,88,984,458,5679
"48121021638",2546,127,650,132,562,0,1223,48,5288
"48121021715",3512,64,300,0,412,65,688,9,5050
"48121021716",3494,432,706,0,482,195,605,323,6237
"48121021717",4947,27,543,0,592,0,678,15,6802
"48121021718",7310,119,298,0,781,0,1066,0,9574
"48121021719",3686,90,214,0,357,22,103,14,4486
"48121021720",2501,12,86,23,616,0,218,0,3456
"48121021721",3574,46,24,0,97,0,344,0,4085
"48121021722",3324,181,83,0,322,101,304,67,4382
"48121021723",856,12,177,14,454,0,383,0,1896
"48121021724",3698,70,189,0,282,0,242,0,4481
"48121021725",3401,0,81,0,212,32,388,32,4146
"48121021726",2739,66,58,0,292,0,305,0,3460
"48121021727",3593,67,154,138,684,33,309,24,5002
"48121021728",1411,193,43,0,95,159,992,285,3178
"48121021729",2505,82,303,11,158,27,309,12,3407
"48121021730",2903,48,74,3,442,4,408,0,3882
"48121021731",3186,107,354,21,289,15,834,11,4817
"48121021732",1312,68,358,0,268,36,467,47,2556
"48121021733",2020,557,265,0,402,24,868,529,4665
"48121021734",1785,267,400,147,261,162,442,362,3826
"48121021735",2065,19,986,46,309,27,637,12,4101
"48121021736",1711,53,216,15,512,42,303,0,2852
"48121021737",2364,52,428,0,1217,42,436,0,4539
"48121021738",1498,123,178,0,653,44,604,57,3157
"48121021739",1988,480,619,15,366,164,990,456,5078
"48121021740",3688,225,408,36,613,25,1432,142,6569
"48121021741",1267,75,25,170,237,106,328,109,2317
"48121021742",3137,191,445,17,1544,92,1123,240,6789
"48121021743",1935,105,338,0,771,45,1289,50,4533
"48121021744",1841,979,88,10,416,39,1440,900,5713
"48121021745",3590,413,65,0,876,291,2002,247,7484
"48121021746",3027,219,87,0,237,3,211,1,3785
"48121021747",2897,188,165,0,721,15,139,101,4226
"48121021748",3603,38,285,0,188,0,204,0,4318
"48121021749",3084,110,8,0,121,25,236,25,3609
"48121021750",3368,13,91,0,420,24,354,0,4270
"48121021751",3578,28,100,0,1268,0,307,0,5281
"48121021752",4396,0,72,0,551,0,520,0,5539
"48121021753",4664,39,174,0,431,27,284,0,5619
"48121021800",3188,81,241,0,705,0,158,0,4373
"48121021900",4053,0,294,0,359,0,221,0,4927
"48123970100",2424,135,190,39,464,138,712,193,4295
"48123970200",1294,334,756,135,969,349,1183,470,5490
"48123970300",2710,113,135,51,905,220,1135,269,5538
"48123970400",2820,430,59,0,398,61,927,135,4830
"48123970500",2187,357,81,28,531,105,801,159,4249
"48125950300",1613,300,17,5,66,88,234,246,2569
"48127950200",5240,1729,69,0,369,86,5014,1706,14213
"48127950400",1771,864,0,1,17,11,1564,452,4680
"48129950200",1346,199,33,101,19,6,71,0,1775
"48129950300",1334,245,26,0,12,6,140,66,1829
"48131950100",3249,690,24,0,248,14,3102,672,7999
"48131950200",2110,550,0,1,249,23,1991,543,5467
"48131950500",2770,837,0,2,176,52,2639,882,7358
"48133950100",2488,450,38,26,140,19,705,175,4041
"48133950200",4091,1053,16,13,239,31,214,493,6150
"48133950300",3837,695,46,67,133,0,207,61,5046
"48133950400",1446,452,0,0,11,3,220,8,2140
"48133950500",1553,491,0,0,60,0,261,177,2542
"48135000100",2374,249,0,0,193,28,875,138,3857
"48135000300",1369,328,10,0,215,0,548,70,2540
"48135000400",3576,208,121,33,163,14,1500,112,5727
"48135000500",2872,665,179,55,270,12,1534,394,5981
"48135000600",3951,1179,217,1,508,98,2460,989,9403
"48135000700",3580,533,263,75,280,176,2567,326,7800
"48135000800",2654,622,342,8,158,73,1593,412,5862
"48135001000",3696,389,77,2,344,30,2238,229,7005
"48135001100",5583,1249,97,0,437,206,4740,1376,13688
"48135001300",4170,241,0,17,537,94,2915,229,8203
"48135001500",2991,858,69,66,434,226,2738,871,8253
"48135001600",4088,474,122,0,771,194,2148,382,8179
"48135001700",4860,391,659,266,108,205,1711,389,8589
"48135001800",744,639,910,308,587,152,1297,780,5417
"48135001900",2528,1151,299,41,545,701,2993,1871,10129
"48135002000",1977,705,145,336,273,111,2108,751,6406
"48135002200",2201,857,0,0,199,52,1752,776,5837
"48135002300",2857,259,150,36,270,24,715,23,4334
"48135002400",4091,205,107,61,295,11,1409,128,6307
"48135002501",3356,141,67,10,361,15,1528,53,5531
"48135002502",5244,551,156,0,342,21,1524,399,8237
"48135002503",4168,557,78,44,600,207,1324,362,7340
"48135002700",7514,1041,0,14,665,226,4606,744,14810
"48135002801",2838,611,0,0,236,184,1943,624,6436
"48135002802",6403,1392,0,35,713,98,4631,1083,14355
"48135002900",3478,67,39,0,112,8,913,26,4643
"48135003000",6563,1342,75,0,626,43,3839,827,13315
"48135003100",2373,409,63,15,301,135,2288,396,5980
"48137950300",1661,356,0,0,15,23,742,348,3145
"48139060101",4935,778,670,154,890,209,1782,546,9964
"48139060102",5332,819,168,5,1037,452,2574,892,11279
"48139060204",6631,249,1271,51,354,69,1648,150,10423
"48139060206",3853,724,1267,0,232,151,1278,394,7899
"48139060207",4599,327,313,84,436,128,988,141,7016
"48139060208",3394,108,441,0,233,0,529,29,4734
"48139060209",2784,248,176,0,276,83,463,0,4030
"48139060210",1269,70,0,0,181,15,351,15,1901
"48139060211",2656,138,73,15,190,7,535,10,3624
"48139060212",3841,77,246,0,317,44,864,60,5449
"48139060213",5385,362,89,3,541,104,1019,340,7843
"48139060214",6634,63,332,0,229,26,670,43,7997
"48139060300",2794,343,286,82,474,174,744,358,5255
"48139060400",1725,297,1156,709,231,71,505,274,4968
"48139060500",2426,595,145,29,167,60,936,469,4827
"48139060600",5321,646,706,202,142,188,885,515,8605
"48139060701",1634,247,11,0,91,21,564,182,2750
"48139060702",2709,182,286,10,335,84,609,84,4299
"48139060703",1651,158,158,0,52,30,185,60,2294
"48139060801",6118,104,28,7,90,1,504,0,6852
"48139060802",5488,460,123,61,223,0,236,133,6724
"48139060803",854,195,333,0,0,0,94,141,1617
"48139060900",4494,542,282,0,369,5,613,219,6524
"48139061000",2922,408,394,62,242,15,472,115,4630
"48139061100",3812,679,63,1,285,42,971,501,6354
"48139061200",1218,197,133,3,245,56,640,168,2660
"48139061300",1675,399,39,0,203,29,432,326,3103
"48139061400",6353,520,96,16,646,112,1963,332,10038
"48139061500",1981,802,628,443,672,241,1428,897,7092
"48139061600",2500,1084,1003,364,690,320,1440,894,8295
"48139061700",3969,892,36,17,118,0,824,673,6529
"48141000101",4714,1086,450,29,567,85,3402,1096,11429
"48141000106",4348,284,1043,38,549,65,3237,211,9775
"48141000107",4431,668,338,50,400,129,3896,619,10531
"48141000108",1545,704,243,67,281,63,1043,753,4699
"48141000109",2411,811,19,10,258,87,2168,870,6634
"48141000110",2341,839,249,73,217,87,1889,784,6479
"48141000111",2155,207,315,15,257,13,1060,182,4204
"48141000112",3154,708,107,26,590,108,2746,539,7978
"48141000204",3354,711,434,0,522,155,2520,598,8294
"48141000205",2205,1312,148,129,307,43,1779,1367,7290
"48141000206",3533,615,75,0,219,96,2990,682,8210
"48141000207",3109,1007,207,65,192,61,2555,986,8182
"48141000208",1965,880,92,8,154,12,1541,754,5406
"48141000301",3400,1937,255,214,485,181,2915,2087,11474
"48141000302",2843,1596,146,13,426,225,2782,1680,9711
"48141000401",4468,211,474,72,645,127,3027,307,9331
"48141000403",1609,706,228,58,378,56,1558,747,5340
"48141000404",1454,2147,88,53,197,212,1433,2301,7885
"48141000600",2606,991,94,41,452,236,2629,1151,8200
"48141000800",3038,2287,77,96,233,211,3143,2363,11448
"48141000900",5722,1998,217,59,763,466,5259,2402,16886
"48141001001",2067,814,99,0,214,43,2127,857,6221
"48141001002",2591,1260,18,0,568,107,3025,1367,8936
"48141001104",5144,973,101,1,1218,202,4251,762,12652
"48141001107",5359,405,9,0,814,309,3892,689,11477
"48141001109",3613,244,148,0,474,209,2033,418,7139
"48141001110",3239,382,134,36,786,240,2192,503,7512
"48141001111",2744,672,130,6,850,269,2116,798,7585
"48141001112",3834,325,55,35,449,133,2570,439,7840
"48141001113",5095,509,26,0,1286,476,4765,857,13014
"48141001114",2733,813,92,13,751,633,2528,1367,8930
"48141001115",1761,534,61,0,602,829,2210,1334,7331
"48141001201",2201,1289,66,127,939,1029,2955,2242,10848
"48141001202",2900,367,109,0,1199,333,3161,682,8751
"48141001203",459,173,0,0,45,56,486,220,1439
"48141001301",2799,137,23,10,538,68,1819,182,5576
"48141001302",5828,436,0,0,790,21,3946,257,11278
"48141001400",1007,559,19,22,250,247,903,713,3720
"48141001501",4082,595,37,0,687,337,3117,611,9466
"48141001502",1770,116,0,10,380,138,673,159,3246
"48141001600",1572,867,31,33,325,1092,1516,1590,7026
"48141001700",139,206,6,0,51,38,177,230,847
"48141001800",508,560,0,0,56,127,564,632,2447
"48141001900",692,1372,0,0,70,215,754,1568,4671
"48141002000",902,1110,16,4,37,118,918,1232,4337
"48141002100",793,1480,19,45,156,247,918,1662,5320
"48141002201",1390,802,60,64,473,267,1514,1051,5621
"48141002202",1669,1353,44,34,634,499,2123,1813,8169
"48141002300",3006,1178,15,0,194,199,2755,1340,8687
"48141002400",2081,1033,0,28,283,162,1952,1184,6723
"48141002500",3710,1333,75,35,438,207,3573,1471,10842
"48141002600",2088,1387,0,0,142,15,2174,1402,7208
"48141002800",1533,2606,44,6,365,608,1833,3182,10177
"48141002900",621,340,1,2,4,3,617,342,1930
"48141003000",2284,1209,178,4,188,176,2471,1365,7875
"48141003100",2380,1266,24,0,149,87,2541,1162,7609
"48141003200",1227,1003,0,4,127,123,1332,1073,4889
"48141003300",3809,804,52,0,289,63,3767,810,9594
"48141003402",3674,1929,83,24,363,278,3779,2132,12262
"48141003403",4408,260,193,0,566,143,3921,292,9783
"48141003404",4519,514,352,21,926,40,4007,392,10771
"48141003501",1626,599,29,1,205,14,1641,613,4728
"48141003502",2296,1219,0,59,398,899,2484,2077,9432
"48141003601",2092,1691,188,0,228,159,2216,1836,8410
"48141003602",1390,770,0,55,134,93,1495,886,4823
"48141003701",2587,847,10,10,443,675,3025,1532,9129
"48141003702",2508,1030,0,12,451,479,2857,1427,8764
"48141003801",3553,1065,10,0,844,135,4293,1168,11068
"48141003803",1635,599,19,0,598,77,2211,661,5800
"48141003804",2289,1387,0,0,368,188,2527,1564,8323
"48141003901",2210,572,0,4,540,26,2686,595,6633
"48141003902",1360,504,0,4,515,209,1689,697,4978
"48141003903",2551,3211,0,0,414,1008,2897,4193,14274
"48141004002",5474,1528,0,0,1629,49,7071,1494,17245
"48141004003",5015,1775,20,0,911,200,5836,1974,15731
"48141004004",3775,1718,0,0,327,100,3986,1691,11597
"48141004103",4053,1988,78,31,384,211,4113,2173,13031
"48141004104",3848,1464,34,81,662,311,4365,1813,12578
"48141004105",2138,847,0,73,362,263,2410,1153,7246
"48141004106",2910,1673,28,21,533,245,3192,1890,10492
"48141004107",994,203,0,0,277,110,1134,308,3026
"48141004201",3472,1717,124,63,346,389,3741,2046,11898
"48141004202",3610,1153,138,94,587,256,4026,1288,11152
"48141004303",4507,458,39,18,762,229,3837,589,10439
"48141004307",4361,1050,43,2,318,18,3501,1016,10309
"48141004309",4237,781,123,0,505,275,4063,891,10875
"48141004310",2944,921,81,23,597,260,2862,1111,8799
"48141004311",3149,559,28,16,529,211,2963,684,8139
"48141004312",3766,1092,66,34,513,11,3452,1083,10017
"48141004313",1599,635,302,17,338,372,1608,888,5759
"48141004314",4663,122,0,0,672,85,4735,180,10457
"48141004316",4752,998,169,0,462,32,4777,1030,12220
"48141004317",3199,237,179,129,382,549,2293,772,7740
"48141004318",3434,103,59,90,478,171,3194,272,7801
"48141004319",4438,604,24,0,699,133,4407,639,10944
"48141004320",2715,220,37,0,217,35,2713,235,6172
"48141010101",1131,23,664,7,132,12,211,0,2180
"48141010102",1491,203,269,286,172,0,255,29,2705
"48141010103",990,166,373,0,74,90,223,95,2011
"48141010203",1393,485,11,0,447,434,1744,874,5388
"48141010207",3833,491,510,20,404,148,2573,486,8465
"48141010210",4976,98,932,214,631,77,2937,106,9971
"48141010211",2542,23,327,76,292,0,1622,10,4892
"48141010212",4402,227,862,103,551,70,3087,223,9525
"48141010213",4833,239,281,0,992,89,3317,304,10055
"48141010214",4551,311,42,0,1692,35,3179,151,9961
"48141010215",5255,390,40,24,1198,173,4712,373,12165
"48141010216",3941,1201,8,107,1967,357,5393,1478,14452
"48141010217",4717,126,92,71,555,249,3642,415,9867
"48141010218",2203,234,50,0,662,0,2045,193,5387
"48141010219",5607,582,219,0,1405,153,5149,585,13700
"48141010220",1501,1033,0,0,894,669,2328,1636,8061
"48141010221",3067,1250,437,12,928,797,3793,1946,12230
"48141010222",1353,220,0,0,202,191,1304,339,3609
"48141010303",2430,408,123,1,463,57,2343,422,6247
"48141010307",3758,1397,296,81,575,294,3644,1471,11516
"48141010311",5335,693,251,1,932,64,5142,719,13137
"48141010312",2876,869,65,0,317,51,2524,788,7490
"48141010316",3257,895,159,0,177,18,2939,875,8320
"48141010317",3235,597,106,16,438,69,3209,594,8264
"48141010319",428,284,14,0,31,0,382,284,1423
"48141010322",3687,945,89,0,283,255,3468,1146,9873
"48141010323",3704,377,45,0,240,26,3535,186,8113
"48141010324",6500,682,168,0,1584,243,7932,847,17956
"48141010325",5668,1388,97,0,1009,106,6091,1351,15710
"48141010326",3492,849,15,0,317,102,2823,902,8500
"48141010327",3034,182,45,0,290,167,2861,349,6928
"48141010328",3564,60,173,0,250,49,3276,109,7481
"48141010329",3658,875,15,0,347,134,3487,1000,9516
"48141010330",7733,1673,371,73,1421,249,7490,1995,21005
"48141010331",7953,1137,494,0,1121,209,7609,975,19498
"48141010332",4261,2829,145,97,544,100,3699,2843,14518
"48141010333",3185,1524,0,0,217,74,3359,1536,9895
"48141010334",2575,923,0,51,208,112,2748,1022,7639
"48141010335",1747,1562,0,0,487,0,2142,1551,7489
"48141010336",4592,617,0,0,1137,266,5390,868,12870
"48141010337",5436,685,34,0,676,37,5889,722,13479
"48141010338",6343,322,135,0,739,20,6037,301,13897
"48141010339",3939,1711,39,0,172,104,3697,1697,11359
"48141010340",1436,524,0,0,75,86,1362,610,4093
"48141010341",14305,3591,917,27,1739,99,14513,3674,38865
"48141010342",9238,964,525,17,1262,364,9412,963,22745
"48141010343",5674,329,109,0,732,180,4872,420,12316
"48141010344",2482,401,0,0,411,148,2884,549,6875
"48141010345",3787,1441,9,0,1091,485,4371,1896,13080
"48141010346",2526,878,0,11,677,370,2895,1235,8592
"48141010347",1602,807,0,38,514,1614,2049,2446,9070
"48141010401",3382,1176,0,0,1066,354,4237,1530,11745
"48141010404",2246,858,10,0,940,338,3030,1156,8578
"48141010405",2359,1294,0,0,1728,742,4001,1948,12072
"48141010406",1700,1108,0,0,809,918,2509,2026,9070
"48141010407",2764,2224,0,0,995,1334,3759,3542,14618
"48141010408",2419,678,0,0,438,401,2813,1071,7820
"48141010409",2902,1777,27,0,1001,281,3854,2045,11887
"48141010501",1413,1535,2,39,669,483,1987,2052,8180
"48141010502",1177,712,0,48,0,45,798,805,3585
"48141010504",844,585,0,0,93,119,933,695,3269
"48141010505",977,1186,0,0,1087,340,2051,1430,7071
"48141010506",1850,1333,0,7,77,358,1927,1698,7250
"48141010600",3260,412,1271,196,784,234,883,288,7328
"48141980000",0,0,0,0,0,0,0,0,0
"48143950100",2744,181,0,0,280,18,277,0,3500
"48143950201",2101,453,0,0,450,485,687,522,4698
"48143950202",5310,1076,0,0,220,208,621,506,7941
"48143950300",4443,751,25,1,136,63,1197,345,6961
"48143950400",2895,1481,43,0,254,40,256,393,5362
"48143950500",4839,1670,108,94,482,78,885,268,8424
"48143950600",1628,1132,65,57,385,115,565,174,4121
"48143950700",2122,365,0,0,244,0,513,171,3415
"48145000200",1892,246,171,115,174,9,502,86,3195
"48145000300",1095,617,685,439,289,71,557,479,4232
"48145000400",340,38,1011,433,33,91,298,84,2328
"48145000500",2004,336,124,141,116,3,402,41,3167
"48145000700",1998,336,235,223,114,16,395,183,3500
"48145000800",2157,173,102,39,60,0,240,22,2793
"48147950100",2131,433,153,189,67,65,252,107,3397
"48147950300",2309,340,13,2,250,18,138,25,3095
"48147950401",1377,529,61,79,146,0,243,133,2568
"48147950402",4346,1057,315,301,46,123,714,7,6909
"48147950500",1742,324,128,96,120,54,57,10,2531
"48147950600",1988,249,31,11,88,31,97,37,2532
"48147950701",3694,341,72,32,193,147,160,193,4832
"48147950702",2708,390,138,18,139,28,248,126,3795
"48147950800",3354,487,68,0,106,9,89,62,4175
"48149970100",1619,112,100,8,30,0,111,4,1984
"48149970200",1826,227,327,56,46,0,91,18,2591
"48149970300",4102,794,320,95,84,53,1255,410,7113
"48149970400",2940,351,136,0,9,35,474,29,3974
"48149970500",3063,356,155,33,117,32,1058,161,4975
"48149970600",3977,407,278,107,65,12,732,124,5702
"48149970700",2044,102,70,6,0,0,150,10,2382
"48151950300",1378,186,0,0,101,39,256,171,2131
"48151950400",1446,315,61,47,217,73,521,198,2878
"48153950500",2034,375,37,1,88,47,1040,268,3890
"48153950600",2566,774,65,21,201,51,1466,654,5798
"48155950100",868,169,9,0,51,0,67,76,1240
"48157670101",2270,1274,2116,441,1345,385,3271,1659,12761
"48157670102",364,174,1773,354,593,51,929,194,4432
"48157670200",1873,359,4497,276,1144,58,2804,404,11415
"48157670300",553,2,2738,155,109,86,566,82,4291
"48157670400",396,97,3850,367,263,0,396,94,5463
"48157670500",632,140,2697,193,408,322,586,479,5457
"48157670601",791,55,6918,495,1068,0,1403,55,10785
"48157670602",294,86,1023,351,271,15,513,100,2653
"48157670700",818,40,1715,104,564,112,627,34,4014
"48157670800",2211,740,9210,459,1419,262,2877,914,18092
"48157670901",3367,0,3908,36,3212,21,1041,0,11585
"48157670902",845,134,3051,190,686,353,1229,469,6957
"48157671001",3341,386,960,243,374,0,654,115,6073
"48157671002",2303,266,3314,212,664,15,1180,76,8030
"48157671100",2737,1055,2621,422,1076,382,2392,1336,12021
"48157671200",1461,656,2653,638,752,187,1339,801,8487
"48157671300",1556,164,981,217,629,40,1031,141,4759
"48157671400",2480,621,1227,62,3985,578,1515,355,10823
"48157671501",3020,22,1471,194,2757,43,814,18,8339
"48157671502",463,25,274,0,1025,0,356,11,2154
"48157671601",3018,146,599,68,2379,147,686,102,7145
"48157671602",1892,103,51,0,1179,104,156,0,3485
"48157671700",3326,231,370,25,1008,22,342,0,5324
"48157671800",1579,39,740,0,680,16,660,0,3714
"48157671900",2821,164,130,25,700,19,770,73,4702
"48157672001",2538,538,400,234,3787,299,767,143,8706
"48157672002",2246,363,1325,229,1509,251,781,252,6956
"48157672100",2413,57,217,0,799,88,104,0,3678
"48157672200",2318,214,185,96,380,0,598,101,3892
"48157672301",2047,104,1570,101,4044,237,1910,0,10013
"48157672302",5341,205,844,0,2983,75,1343,150,10941
"48157672400",3109,1025,1684,337,2497,1090,2508,1476,13726
"48157672500",2181,482,1807,137,2322,405,1915,623,9872
"48157672601",3038,630,2590,131,3220,403,4192,850,15054
"48157672602",1773,84,1842,318,1987,528,2169,9,8710
"48157672701",3290,598,2954,299,6355,1112,3494,1313,19415
"48157672702",4004,167,1054,0,1742,225,1206,0,8398
"48157672800",2026,243,1008,348,3422,542,1008,39,8636
"48157672900",12287,588,8924,566,8580,975,7107,455,39482
"48157673001",6042,197,401,0,1268,34,497,88,8527
"48157673002",5223,66,478,116,2597,25,1781,2,10288
"48157673003",9835,360,275,0,2015,87,2064,147,14783
"48157673101",26752,540,4324,240,7492,475,6055,275,46153
"48157673102",12040,128,990,0,4009,42,3182,87,20478
"48157673200",5446,220,427,200,571,0,1181,45,8090
"48157673300",3902,47,232,13,290,92,392,108,5076
"48157673400",11929,166,2071,34,1302,117,2597,73,18289
"48157673500",6650,338,871,84,872,0,912,0,9727
"48157673600",6863,88,26,12,142,0,1192,71,8394
"48157673700",6,3,0,1,0,1,0,0,11
"48157673800",3635,272,628,17,5093,193,1652,199,11689
"48157673901",4328,429,369,11,3674,0,499,0,9310
"48157673902",1904,54,775,0,5829,61,369,2,8994
"48157674000",4242,70,179,0,2913,150,984,1,8539
"48157674100",4190,68,381,1,2334,35,765,0,7774
"48157674200",2908,181,63,0,2532,5,282,10,5981
"48157674300",3581,0,838,0,4012,117,945,0,9493
"48157674400",4105,155,384,0,5770,96,907,0,11417
"48157674501",2701,54,2114,75,2257,0,756,2,7959
"48157674502",10641,658,2956,660,2802,214,1904,820,20655
"48157674601",2963,34,144,0,649,0,273,7,4070
"48157674602",6020,48,331,0,1334,85,1095,67,8980
"48157674603",3887,498,801,46,425,74,1572,207,7510
"48157674604",2220,57,1416,157,1348,42,1255,71,6566
"48157674700",4248,334,2725,18,2434,298,1491,424,11972
"48157674800",3265,1031,558,548,219,57,2261,969,8908
"48157674900",2552,1368,496,253,384,148,2727,1439,9367
"48157675000",1855,584,189,225,98,84,1736,598,5369
"48157675100",6097,1298,1012,493,1031,173,3771,1174,15049
"48157675200",4188,878,138,195,322,29,3492,779,10021
"48157675300",4638,402,150,281,847,221,4092,475,11106
"48157675400",4273,958,290,71,227,138,2568,763,9288
"48157675500",7448,320,2010,20,1602,240,4290,259,16189
"48157675600",4430,553,0,0,204,45,1239,413,6884
"48157675700",5038,512,502,98,102,4,911,329,7496
"48157675800",2401,166,362,329,17,78,1353,154,4860
"48159950100",4763,327,24,0,93,0,283,0,5490
"48159950200",1409,515,212,216,114,13,274,206,2959
"48159950300",2324,429,0,0,13,0,301,260,3327
"48161000100",3421,1084,583,89,116,55,261,699,6308
"48161000200",1081,50,87,8,22,15,132,32,1427
"48161000300",730,60,255,75,40,0,153,41,1354
"48161000400",1827,189,297,111,107,4,98,26,2659
"48161000600",2529,160,140,0,125,2,184,2,3142
"48161000700",1982,457,512,8,155,43,606,102,3865
"48161000900",929,92,328,311,16,7,22,29,1734
"48163950100",4343,1008,0,2,268,406,3287,1166,10480
"48163950200",3846,1173,0,0,561,173,3895,1254,10902
"48163950300",2092,716,0,0,182,92,1585,793,5460
"48165950100",2544,639,59,1,312,95,1804,672,6126
"48165950200",6864,1247,132,0,103,314,945,494,10099
"48165950300",4394,645,50,0,449,59,2396,431,8424
"48167720100",4714,237,317,0,400,34,570,10,6282
"48167720200",3531,138,35,0,503,55,358,13,4633
"48167720301",1844,69,117,1,68,72,168,18,2357
"48167720302",6788,431,31,0,338,18,896,174,8676
"48167720400",5166,84,88,0,445,24,586,0,6393
"48167720501",3220,216,194,20,307,0,550,0,4507
"48167720502",8127,912,651,52,1104,190,1985,26,13047
"48167720503",10602,299,877,0,1887,210,2389,44,16308
"48167720600",9178,685,1480,244,976,177,2729,479,15948
"48167720700",7290,243,466,217,1630,17,1720,71,11654
"48167720800",2029,474,784,20,279,80,232,533,4431
"48167720900",3550,939,249,179,510,27,1179,784,7417
"48167721000",1338,253,77,0,73,13,158,135,2047
"48167721100",7720,1257,838,180,507,193,3644,1127,15466
"48167721201",13618,593,1881,8,1286,42,3395,63,20886
"48167721202",2853,25,331,24,204,99,176,6,3718
"48167721300",3638,346,197,42,337,23,937,263,5783
"48167721400",6372,236,528,56,236,98,589,19,8134
"48167721500",5623,194,79,41,340,0,763,2,7042
"48167721600",1325,141,0,0,218,11,516,64,2275
"48167721700",4860,1405,98,12,451,301,1474,898,9499
"48167721800",2712,792,45,41,505,126,695,435,5351
"48167721900",4609,564,1791,592,504,37,1724,248,10069
"48167722001",4600,105,121,383,263,37,1572,102,7183
"48167722002",2511,642,386,182,63,13,1168,422,5387
"48167722100",5048,341,664,53,421,73,1692,253,8545
"48167722200",1371,395,683,265,68,160,589,363,3894
"48167722300",3716,1335,617,607,518,56,1964,711,9524
"48167722600",550,253,617,309,217,17,266,113,2342
"48167722700",409,23,2873,685,0,1,124,0,4115
"48167722800",791,365,791,235,77,62,308,309,2938
"48167722900",1456,473,249,236,267,16,785,393,3875
"48167723000",928,283,1555,177,200,40,458,0,3641
"48167723100",1524,413,1051,259,166,0,473,305,4191
"48167723200",1803,364,1386,414,66,160,622,85,4900
"48167723300",4821,312,244,0,76,1,715,25,6194
"48167723400",6174,311,0,0,205,16,817,29,7552
"48167723501",692,204,0,0,32,0,101,110,1139
"48167723502",7648,1065,0,0,361,13,1118,147,10352
"48167723600",3269,481,484,20,76,0,842,139,5311
"48167723700",816,168,424,724,35,0,431,123,2721
"48167723800",3579,265,211,0,102,0,359,14,4530
"48167723900",1660,355,0,0,162,51,324,69,2621
"48167724000",289,272,3,18,20,3,122,99,826
"48167724101",740,185,97,275,51,13,233,127,1721
"48167724200",1150,542,85,245,633,131,141,100,3027
"48167724300",1290,638,399,80,230,126,278,386,3427
"48167724400",1382,677,479,96,191,69,569,407,3870
"48167724500",461,106,38,35,101,23,133,45,942
"48167724600",224,40,402,1033,5,44,179,96,2023
"48167724700",445,439,605,388,97,22,261,369,2626
"48167724800",840,226,110,168,94,26,273,132,1869
"48167724900",1280,305,331,81,20,9,474,133,2633
"48167725000",1518,279,172,214,98,9,771,201,3262
"48167725100",738,284,374,160,70,30,480,227,2363
"48167725200",650,410,272,180,71,15,537,362,2497
"48167725300",1582,116,240,57,208,22,1053,58,3336
"48167725400",2614,140,188,152,408,52,2041,136,5731
"48167725500",950,0,35,0,156,0,172,0,1313
"48167725600",1735,567,572,169,329,130,413,146,4061
"48167725700",1809,138,27,47,138,0,455,116,2730
"48167725800",2339,458,154,128,443,27,1463,244,5256
"48167725900",1788,166,148,0,125,61,390,48,2726
"48167726000",1427,14,53,0,77,0,170,8,1749
"48167726100",2199,237,19,0,25,0,208,8,2696
"48167726200",1545,571,724,135,63,46,856,400,4340
"48167990000",0,0,0,0,0,0,0,0,0
"48169950100",3005,531,171,1,237,94,997,391,5427
"48171950100",3298,213,0,0,82,0,478,140,4211
"48171950200",3038,386,0,0,105,26,82,48,3685
"48171950300",5815,1118,63,2,304,0,1123,292,8717
"48171950400",5587,910,0,0,216,0,1305,602,8620
"48171950500",2941,287,0,0,118,9,728,195,4278
"48173950100",1066,49,36,0,25,0,303,0,1479
"48175960100",2700,273,158,14,526,320,803,298,5092
"48175960200",1967,376,33,4,686,59,1231,129,4485
"48177000100",1142,126,249,238,1062,142,1156,157,4272
"48177000200",3169,235,267,13,664,308,1162,355,6173
"48177000300",1100,271,249,233,922,751,1295,831,5652
"48177000400",1320,393,54,7,253,196,773,330,3326
"48177000500",1812,486,53,12,1274,294,1836,598,6365
"48177000600",1247,203,7,17,422,358,461,463,3178
"48179950100",2412,202,6,8,137,33,204,11,3013
"48179950300",3888,307,58,0,207,3,342,171,4976
"48179950400",4207,473,55,0,380,9,760,256,6140
"48179950500",2066,287,89,0,155,138,718,317,3770
"48179950600",1258,300,12,47,264,160,664,248,2953
"48179950700",1342,474,15,0,133,149,385,317,2815
"48179950800",804,389,67,56,305,26,469,231,2347
"48181000101",3870,472,18,79,178,82,197,3,4899
"48181000102",2326,334,139,86,73,0,35,69,3062
"48181000200",1449,660,124,97,203,73,152,30,2788
"48181000302",3661,381,5,0,253,62,194,20,4576
"48181000303",4138,286,17,47,154,71,311,11,5035
"48181000304",2685,285,0,0,39,15,128,93,3245
"48181000400",1974,712,130,12,350,41,252,103,3574
"48181000501",1789,730,532,197,124,126,91,244,3833
"48181000502",764,167,57,26,266,19,274,64,1637
"48181000600",2743,488,0,2,200,79,76,49,3637
"48181000700",2579,575,237,72,280,206,222,137,4308
"48181000800",4651,666,118,32,204,45,161,92,5969
"48181000901",2490,387,86,6,143,21,62,22,3217
"48181000902",4390,1131,339,323,137,212,181,241,6954
"48181001101",2991,362,39,42,173,40,196,219,4062
"48181001102",5309,979,49,0,153,60,400,146,7096
"48181001200",4483,363,418,168,885,19,1087,0,7423
"48181001300",2283,392,246,128,565,0,409,22,4045
"48181001400",2472,556,498,101,330,81,961,242,5241
"48181001500",3093,1259,452,623,817,170,1404,476,8294
"48181001700",3218,460,285,134,444,65,897,86,5589
"48181001801",5513,516,5,0,359,209,445,22,7069
"48181001802",4307,335,18,0,116,11,168,57,5012
"48181001803",4677,405,17,9,250,0,357,45,5760
"48181001900",8493,769,43,0,634,114,1085,333,11471
"48181002000",1305,454,391,212,503,304,938,374,4481
"48183000200",3659,648,467,185,173,97,724,420,6373
"48183000300",3826,299,408,28,255,9,493,27,5345
"48183000401",2450,357,114,13,157,16,237,88,3432
"48183000402",2156,179,198,548,163,5,136,14,3399
"48183000501",4243,110,369,45,358,0,222,0,5347
"48183000502",2673,310,905,292,419,6,324,44,4973
"48183000600",6233,203,622,107,253,46,303,28,7795
"48183000700",3528,702,398,75,577,19,527,302,6128
"48183000800",4874,1282,708,76,377,51,1725,722,9815
"48183000900",2035,316,226,334,153,40,792,77,3973
"48183001000",1322,397,354,142,196,17,776,270,3474
"48183001100",1356,363,696,466,189,15,555,73,3713
"48183001200",643,219,1085,452,121,154,638,400,3712
"48183001300",1190,589,1230,876,386,213,1333,589,6406
"48183001400",996,351,1904,576,254,67,856,354,5358
"48183001500",974,382,2071,469,60,0,742,298,4996
"48183010100",5842,229,668,72,121,0,686,28,7646
"48183010200",4300,1384,532,444,277,36,276,129,7378
"48183010301",3620,528,364,517,319,37,306,170,5861
"48183010302",4505,799,127,49,31,147,211,482,6351
"48183010400",5614,845,523,407,278,126,694,530,9017
"48183010500",2377,505,1596,526,144,3,386,196,5733
"48183010600",4625,394,275,404,219,27,301,19,6264
"48183010700",2402,659,357,424,381,157,1289,374,6043
"48183980000",0,0,0,0,0,0,0,0,0
"48185180101",1155,284,968,836,754,67,1346,185,5595
"48185180102",2697,986,106,0,459,75,543,283,5149
"48185180200",3421,387,635,237,374,171,1320,301,6846
"48185180301",4468,334,140,325,558,11,593,16,6445
"48185180302",2927,515,93,190,59,13,356,40,4193
"48185180400",170,29,19,15,2,0,0,16,251
"48187210100",2773,437,157,86,541,51,2235,410,6690
"48187210200",2271,1303,257,144,167,140,2009,1281,7572
"48187210300",2828,1695,566,114,396,256,1888,1621,9364
"48187210400",3189,240,436,147,119,111,1352,258,5852
"48187210504",4264,517,72,26,708,1,1674,300,7562
"48187210505",2606,585,163,46,1096,134,3377,590,8597
"48187210506",2353,457,84,55,162,12,980,127,4230
"48187210507",4338,259,45,0,124,60,1315,158,6299
"48187210508",1784,73,62,0,571,0,1232,68,3790
"48187210603",1804,143,43,0,62,10,653,76,2791
"48187210604",7631,423,640,0,455,66,2202,175,11592
"48187210606",2995,296,0,17,128,69,805,294,4604
"48187210607",7041,296,281,23,551,100,2947,137,11376
"48187210608",3018,454,74,0,64,11,1160,402,5183
"48187210705",2189,199,269,53,175,0,647,20,3552
"48187210706",4159,516,72,29,349,119,1487,328,7059
"48187210707",3765,62,344,2,266,102,1256,36,5833
"48187210708",4349,110,704,0,711,0,1555,47,7476
"48187210709",3578,167,340,0,742,0,1074,102,6003
"48187210710",2961,132,222,1,279,12,763,2,4372
"48187210711",2050,17,294,40,664,40,839,18,3962
"48187210712",3727,60,514,34,431,17,1190,4,5977
"48187210713",3362,43,461,52,463,0,1296,52,5729
"48187210714",5093,263,750,0,345,20,2234,57,8762
"48187210801",4918,216,143,20,220,0,1811,31,7359
"48187210803",3151,215,192,158,291,22,944,97,5070
"48187210804",3309,377,16,0,270,0,980,0,4952
"48187210901",4281,544,196,77,115,101,684,229,6227
"48187210902",2835,252,89,0,209,106,836,151,4478
"48189950100",2603,1418,118,77,743,137,2543,1476,9115
"48189950200",2084,1001,58,81,311,260,2099,1143,7037
"48189950300",4814,696,16,0,455,128,1870,462,8441
"48189950400",2841,582,250,76,434,83,1768,491,6525
"48189950500",2298,785,13,0,210,27,1721,665,5719
"48189950600",1880,261,0,0,295,14,584,231,3265
"48189950700",2543,793,23,45,233,29,1599,552,5817
"48189950800",1068,307,6,31,70,35,577,250,2344
"48189950900",2089,253,8,87,213,168,884,373,4075
"48191950500",2139,618,154,14,180,142,722,377,4346
"48193950100",2291,464,8,4,3,0,224,114,3108
"48193950200",1876,172,0,9,7,0,87,8,2159
"48193950300",2927,376,0,0,12,0,300,124,3739
"48195950100",1351,233,0,0,53,0,462,154,2253
"48195950300",2882,652,0,0,268,49,1287,545,5683
"48197950100",2630,819,178,186,163,69,384,493,4922
"48199030100",3107,542,0,0,178,0,169,2,3998
"48199030200",4295,265,92,38,178,2,140,16,5026
"48199030300",7240,1161,201,0,311,0,192,95,9200
"48199030400",1461,343,409,165,85,38,267,10,2778
"48199030501",4093,368,45,11,68,42,112,0,4739
"48199030502",8497,613,0,0,138,20,498,17,9783
"48199030600",3370,180,0,0,39,38,180,31,3838
"48199030700",2304,389,835,198,143,47,131,60,4107
"48199030800",2706,312,947,139,357,10,276,24,4771
"48199030900",3629,598,0,0,94,41,137,30,4529
"48199031000",3585,362,35,18,59,0,159,0,4218
"48201100000",1971,315,186,220,177,19,255,72,3215
"48201210100",54,0,46,0,0,0,0,0,100
"48201210400",2772,1472,120,727,399,197,2947,1581,10215
"48201210500",1945,1128,336,830,571,316,2394,1384,8904
"48201210600",4129,770,36,12,718,20,3957,667,10309
"48201210700",1131,596,211,125,198,48,1187,644,4140
"48201210800",735,554,416,290,191,127,818,664,3795
"48201210900",122,346,746,214,56,51,72,385,1992
"48201211000",196,118,897,462,128,0,319,105,2225
"48201211100",1101,1289,1276,1956,330,126,1352,1306,8736
"48201211200",321,327,864,945,44,47,364,374,3286
"48201211300",967,648,1734,1926,102,3,1072,554,7006
"48201211400",924,93,1095,1220,340,14,919,102,4707
"48201211500",3369,1762,460,121,1209,254,4460,2015,13650
"48201211600",1574,1024,311,179,257,52,1534,1072,6003
"48201211700",285,305,1461,1039,97,63,331,454,4035
"48201211900",2989,1317,0,46,423,199,3118,1467,9559
"48201212300",2039,2730,45,95,546,137,2413,2741,10746
"48201212400",1771,882,165,80,434,99,2002,940,6373
"48201212500",598,400,2217,630,88,16,698,400,5047
"48201220100",875,228,723,423,285,85,1158,341,4118
"48201220200",1836,535,0,0,236,69,1911,596,5183
"48201220300",2777,1136,21,17,242,355,2786,1406,8740
"48201220400",2462,1310,71,7,376,196,2611,1487,8520
"48201220500",2417,1057,296,226,222,89,2259,1001,7567
"48201220600",2274,535,122,523,421,0,2516,488,6879
"48201220700",2650,967,694,766,547,522,3136,1447,10729
"48201220800",930,544,562,734,58,227,988,744,4787
"48201220900",1050,241,0,118,110,62,1139,271,2991
"48201221000",1202,637,190,330,659,205,1687,728,5638
"48201221100",1898,609,1,49,767,306,2395,775,6800
"48201221200",4346,1312,167,0,613,119,4347,1341,12245
"48201221300",4937,2356,430,0,697,663,5263,2621,16967
"48201221400",3016,3470,44,0,308,44,2911,3387,13180
"48201221500",3906,2641,341,1038,331,229,3900,2694,15080
"48201221600",5560,2877,198,0,608,250,4892,3024,17409
"48201221700",5422,2452,0,45,441,141,5143,2410,16054
"48201221800",1835,1411,38,0,138,410,1857,1442,7131
"48201221900",1563,733,34,28,919,503,2292,1207,7279
"48201222000",1458,745,32,38,283,53,1481,712,4802
"48201222100",2209,979,75,6,1031,755,2646,1641,9342
"48201222200",1639,899,287,18,341,309,1800,1145,6438
"48201222300",2361,1078,106,54,778,159,2695,1139,8370
"48201222401",1424,1366,0,13,182,23,1447,1240,5695
"48201222402",3682,1655,586,112,196,56,3523,1711,11521
"48201222501",1729,1339,163,72,19,23,1673,1362,6380
"48201222502",2696,486,206,73,328,63,2626,478,6956
"48201222503",4035,3500,310,0,158,0,3864,3095,14962
"48201222600",1332,2407,255,400,300,109,1520,2523,8846
"48201222700",1148,235,1327,2191,92,106,932,377,6408
"48201222800",2522,384,0,0,538,57,2442,380,6323
"48201222900",4563,1786,424,511,1307,366,5257,2118,16332
"48201223001",1595,885,327,30,228,200,1615,1063,5943
"48201223002",1904,1243,233,184,144,240,1887,1412,7247
"48201223100",1022,533,192,30,132,172,967,610,3658
"48201230100",3,280,744,631,0,13,0,279,1950
"48201230200",264,207,3390,1242,115,198,300,332,6048
"48201230300",205,412,713,543,51,70,119,303,2416
"48201230400",710,342,1046,789,359,76,1000,403,4725
"48201230500",1827,441,501,103,606,224,2218,607,6527
"48201230600",436,177,1365,594,24,126,443,279,3444
"48201230700",330,49,941,733,269,34,542,79,2977
"48201230800",597,148,1569,286,75,11,732,147,3565
"48201230900",595,26,2044,1088,9,45,552,69,4428
"48201231000",1135,330,1765,638,173,6,1272,258,5577
"48201231100",2005,871,861,576,547,0,2240,775,7875
"48201231200",905,330,3593,1830,244,781,942,1041,9666
"48201231300",441,94,2569,1062,95,228,424,288,5201
"48201231400",90,6,2316,402,22,0,91,0,2927
"48201231500",65,5,1790,564,128,12,135,1,2700
"48201231600",512,79,1751,358,51,4,555,75,3385
"48201231700",1855,604,99,6,669,211,2368,787,6599
"48201231800",694,571,1001,41,255,84,904,553,4103
"48201231900",937,846,3515,697,14,25,510,802,7346
"48201232000",967,362,1477,65,515,268,1371,583,5608
"48201232100",1212,593,459,254,179,42,1170,530,4439
"48201232200",6567,976,1790,260,1693,505,3410,1107,16308
"48201232301",3610,1505,1550,1099,991,520,3676,1696,14647
"48201232302",4678,568,2660,838,946,0,4760,510,14960
"48201232401",3882,972,1902,176,1201,156,3475,901,12665
"48201232402",973,160,847,716,860,42,1222,379,5199
"48201232403",1912,476,647,332,551,0,2370,466,6754
"48201232500",1639,378,29,128,556,112,1937,323,5102
"48201232600",2260,144,176,4,358,45,2237,174,5398
"48201232701",3538,1433,905,915,842,95,4059,1367,13154
"48201232702",1888,1222,1011,176,627,481,2250,1589,9244
"48201232800",2264,364,1573,144,574,426,2286,549,8180
"48201232900",2604,308,2448,756,1583,229,2479,447,10854
"48201233001",908,122,706,502,483,123,777,138,3759
"48201233002",2193,399,838,0,735,247,1962,589,6963
"48201233003",1829,71,271,10,364,0,1235,36,3816
"48201233101",2081,624,38,76,737,263,2306,818,6943
"48201233102",2827,2486,0,6,1345,628,3525,2878,13695
"48201233103",2796,1441,0,0,547,602,2998,1985,10369
"48201233200",3283,979,117,58,1408,187,3344,1012,10388
"48201233300",3324,849,0,0,1039,357,3830,1028,10427
"48201233400",1273,336,214,148,301,148,1375,372,4167
"48201233500",4596,2382,14,0,1024,110,4911,2325,15362
"48201233600",392,171,793,641,92,0,465,171,2725
"48201233701",3282,654,731,133,440,0,2911,642,8793
"48201233702",2323,670,0,1,135,170,2116,823,6238
"48201233703",1568,415,0,0,351,41,1669,431,4475
"48201240100",1250,1044,638,555,429,7,1350,1009,6282
"48201240400",3269,1046,843,631,731,399,2381,1066,10366
"48201240501",1738,1596,2145,579,256,86,1915,1562,9877
"48201240502",1438,572,1401,1224,184,139,1428,660,7046
"48201240600",627,826,730,356,68,65,656,837,4165
"48201240701",5163,550,5706,426,3117,240,6788,600,22590
"48201240702",3146,721,2776,826,3269,490,4961,1024,17213
"48201240801",2249,1362,1043,232,1001,815,1875,1927,10504
"48201240802",1548,299,850,227,349,253,1049,434,5009
"48201240901",3116,201,3101,42,1627,426,2575,505,11593
"48201240902",5098,719,3155,635,2381,222,4294,656,17160
"48201241000",5114,725,1196,71,1123,154,2585,375,11343
"48201241101",3146,131,397,235,411,116,1431,139,6006
"48201241102",6210,925,2307,631,1392,436,3555,570,16026
"48201241103",2005,214,1232,162,625,123,319,288,4968
"48201241200",3788,178,1541,469,975,58,1869,171,9049
"48201241300",6619,359,2614,95,1752,36,2301,189,13965
"48201241400",5917,169,918,17,1084,53,2002,53,10213
"48201241500",2718,907,2716,1306,1597,40,2915,628,12827
"48201250100",3608,274,1951,675,1760,53,3691,269,12281
"48201250200",3302,1242,3077,223,883,0,3238,1142,13107
"48201250301",1280,397,2587,92,1175,41,1419,416,7407
"48201250302",5981,160,2559,63,772,69,3436,53,13093
"48201250401",8273,349,1111,26,1870,24,3636,0,15289
"48201250402",9938,248,2737,103,1350,0,2102,78,16556
"48201250500",3040,204,1291,86,782,61,1045,167,6676
"48201250600",2991,1183,1042,430,1124,523,1502,976,9771
"48201250701",3737,544,948,135,361,97,1109,260,7191
"48201250702",3635,253,416,0,285,7,819,0,5415
"48201250800",6800,218,301,0,765,22,1312,22,9440
"48201250900",8840,285,119,0,490,12,504,0,10250
"48201251000",2173,92,139,0,372,164,176,160,3276
"48201251100",6760,158,368,3,180,204,688,206,8567
"48201251200",4860,880,162,60,591,0,953,188,7694
"48201251300",6256,296,190,1,216,369,476,111,7915
"48201251401",2303,20,52,0,193,0,480,0,3048
"48201251402",5059,594,258,0,253,63,761,104,7092
"48201251501",4763,122,54,0,454,177,710,0,6280
"48201251502",8595,127,578,0,342,67,868,39,10616
"48201251503",1954,44,13,0,133,0,61,30,2235
"48201251600",5144,248,14,47,196,0,513,22,6184
"48201251700",6434,840,382,23,217,22,907,0,8825
"48201251800",1772,27,7,0,28,0,266,0,2100
"48201251901",7502,297,440,236,1052,0,1411,15,10953
"48201251902",3370,275,470,23,730,39,860,39,5806
"48201252000",8085,442,2313,53,1901,0,3368,11,16173
"48201252100",1623,20,159,0,111,0,730,6,2649
"48201252200",3988,1103,975,82,1305,117,3599,942,12111
"48201252301",4071,1049,2377,119,825,428,3784,1035,13688
"48201252302",6358,629,2571,245,1951,456,6443,1004,19657
"48201252400",4496,1111,128,81,1096,101,2871,869,10753
"48201252500",2285,1805,126,0,566,149,1498,1658,8087
"48201252600",2740,1974,8,42,1345,891,2149,2405,11554
"48201252700",2721,694,381,1,248,161,992,470,5668
"48201252800",2347,321,2168,760,264,415,822,644,7741
"48201252900",5848,1036,313,5,904,89,1895,185,10275
"48201253000",1721,190,1260,158,30,0,765,62,4186
"48201253100",5678,348,1831,205,1267,42,3368,75,12814
"48201253200",5478,1978,757,148,468,187,1496,1328,11840
"48201253300",3071,51,0,28,373,146,1095,146,4910
"48201253400",260,89,40,0,185,10,286,19,889
"48201253500",3522,926,2623,320,801,48,2225,542,11007
"48201253600",2286,784,1118,608,287,19,838,549,6489
"48201253700",2702,767,1087,188,508,115,1620,689,7676
"48201253800",3853,1399,996,223,835,401,2205,1214,11126
"48201253900",2279,570,226,90,722,68,885,399,5239
"48201254000",1831,481,526,262,902,132,1410,287,5831
"48201254100",2674,716,230,380,1084,196,1934,488,7702
"48201254200",1736,263,83,0,562,62,1765,245,4716
"48201254300",2694,667,217,252,463,418,1991,916,7618
"48201254400",991,792,167,186,762,111,1650,897,5556
"48201254500",1037,241,323,141,679,207,1522,354,4504
"48201254600",1855,515,284,363,1145,417,2456,906,7941
"48201254700",2210,157,186,10,217,4,916,37,3737
"48201310100",2262,1222,324,1038,526,444,1672,1029,8517
"48201310200",767,205,431,31,288,3,350,145,2220
"48201310300",3194,609,98,57,910,74,2908,432,8282
"48201310400",1971,898,0,58,423,377,2259,1217,7203
"48201310500",2694,1306,14,122,692,112,3128,1292,9360
"48201310600",2960,959,181,15,1316,298,3809,1124,10662
"48201310700",2323,1028,73,17,474,215,2379,1180,7689
"48201310800",1651,691,19,82,254,199,1759,803,5458
"48201310900",3134,1304,6,24,365,458,3301,1612,10204
"48201311000",3766,2518,0,33,823,337,4334,2804,14615
"48201311100",2819,730,84,0,2006,360,4776,1058,11833
"48201311200",2481,1668,16,44,987,338,3167,1941,10642
"48201311300",3068,859,125,0,848,211,3744,1031,9886
"48201311400",716,809,163,122,572,96,1280,883,4641
"48201311500",3194,1402,81,0,2636,297,5380,1487,14477
"48201311600",1431,940,70,33,940,554,2244,1452,7664
"48201311700",2901,1170,373,269,390,416,2920,1485,9924
"48201311800",2363,949,0,48,922,704,3050,1620,9656
"48201311900",1292,326,0,0,391,241,1560,544,4354
"48201312000",392,309,783,121,189,141,71,83,2089
"48201312100",0,0,0,0,0,0,0,0,0
"48201312200",77,210,715,990,57,66,128,210,2453
"48201312300",114,192,684,539,116,127,135,282,2189
"48201312400",288,89,1065,505,84,29,270,114,2444
"48201312500",1673,459,397,496,710,27,383,191,4336
"48201312600",3643,336,619,26,876,209,1027,107,6843
"48201312700",101,17,1163,402,22,12,30,16,1763
"48201312800",38,102,463,632,0,6,0,112,1353
"48201312900",178,1,1870,1100,211,120,26,14,3520
"48201313000",85,4,1914,477,33,3,0,0,2516
"48201313100",1392,243,379,50,623,8,282,30,3007
"48201313200",552,21,2523,620,106,18,340,0,4180
"48201313300",49,27,1521,730,144,13,102,20,2606
"48201313400",481,84,1394,692,76,32,595,64,3418
"48201313500",286,173,1199,753,102,44,351,218,3126
"48201313600",340,664,1714,1423,393,39,739,827,6139
"48201313700",91,19,2038,393,4,1,81,6,2633
"48201313800",386,183,2259,1579,113,59,453,211,5243
"48201313900",1323,461,1110,373,882,251,409,77,4886
"48201314001",1116,254,291,68,810,220,538,0,3297
"48201314002",1234,574,1703,762,1718,852,274,156,7273
"48201314300",237,90,2486,888,260,45,204,46,4256
"48201314400",934,444,220,22,1395,234,240,70,3559
"48201320100",1045,580,70,27,767,112,1632,684,4917
"48201320200",2605,1454,123,130,2055,917,3070,2332,12686
"48201320500",2851,668,9,2,1385,240,3818,799,9772
"48201320601",1249,982,12,0,403,13,1462,924,5045
"48201320602",2085,825,34,47,1016,329,2722,1103,8161
"48201320700",1818,473,388,29,807,147,1974,500,6136
"48201320800",3137,1225,0,32,996,546,3727,1772,11435
"48201320900",4161,889,427,291,819,551,4035,1330,12503
"48201321000",4274,702,302,190,1835,694,4653,1308,13958
"48201321100",4711,490,813,172,1596,249,4849,514,13394
"48201321200",1506,1068,216,8,423,659,1782,1552,7214
"48201321300",2897,932,114,244,893,461,3102,1184,9827
"48201321401",1999,756,21,0,733,698,2234,1333,7774
"48201321402",2170,781,78,17,1071,279,2634,1043,8073
"48201321500",916,530,55,87,490,535,1235,1000,4848
"48201321600",4700,1086,0,2,907,289,3947,1150,12081
"48201321700",2482,397,14,2,368,19,2193,352,5827
"48201321800",2249,964,47,0,780,54,2646,955,7695
"48201321900",3314,783,43,105,1450,365,4051,1153,11264
"48201322000",1892,1607,6,76,848,645,2446,2013,9533
"48201322100",2140,1117,134,22,528,247,1950,1190,7328
"48201322200",1063,155,1,1,298,26,1071,148,2763
"48201322600",3701,354,31,15,1380,290,3597,481,9849
"48201322700",3928,985,44,0,1930,397,4662,1286,13232
"48201322800",3551,1337,59,0,1111,161,3818,1357,11394
"48201322900",2514,570,0,0,673,301,2719,807,7584
"48201323000",2224,1916,0,113,969,557,2629,2010,10418
"48201323100",1270,1086,140,85,650,386,1419,1293,6329
"48201323200",3314,402,202,265,575,318,2780,762,8618
"48201323300",1444,623,212,119,547,197,1500,705,5347
"48201323400",4018,1876,31,4,890,546,3503,1829,12697
"48201323500",1973,1435,290,317,484,467,1951,1733,8650
"48201323600",5855,501,66,38,1382,595,3604,737,12778
"48201323701",3355,358,108,66,425,46,1484,265,6107
"48201323702",2287,209,114,14,347,181,1107,274,4533
"48201323801",2583,61,29,0,650,0,2041,0,5364
"48201323802",3202,851,17,5,611,365,2544,923,8518
"48201323900",2151,700,6,86,376,452,1066,735,5572
"48201324000",4341,421,26,0,642,28,2123,396,7977
"48201324100",2392,1161,151,44,1197,534,3263,1568,10310
"48201324200",676,266,0,0,496,361,1155,597,3551
"48201330100",3212,751,2429,1501,552,513,3378,1248,13584
"48201330200",1099,764,1306,582,488,168,1478,897,6782
"48201330301",2861,434,2195,334,1445,137,3789,540,11735
"48201330302",1909,457,1725,274,842,248,2476,701,8632
"48201330303",1304,420,1706,161,462,140,1509,528,6230
"48201330400",1742,690,1609,360,512,50,1969,714,7646
"48201330500",1687,533,1104,597,163,184,1692,717,6677
"48201330600",1688,393,2976,867,601,57,1911,437,8930
"48201330700",3381,773,2110,443,1269,848,3940,1614,14378
"48201330800",3068,439,3807,847,2125,113,3440,494,14333
"48201330900",2497,330,3266,596,1165,222,2610,633,11319
"48201331100",107,180,1837,543,122,41,102,216,3148
"48201331200",82,100,1952,895,45,105,89,160,3428
"48201331300",69,98,3524,1659,144,12,224,106,5836
"48201331400",0,11,1012,1502,17,54,17,112,2725
"48201331500",409,260,5651,818,462,66,434,236,8336
"48201331601",229,0,4928,863,152,60,276,46,6554
"48201331602",13,55,974,513,268,0,275,60,2158
"48201331700",399,198,1825,1541,142,11,568,180,4864
"48201331800",423,300,2040,929,130,0,478,270,4570
"48201331900",78,8,2054,635,33,10,97,0,2915
"48201332000",412,391,2555,1447,287,215,607,484,6398
"48201332100",633,345,947,742,236,181,869,514,4467
"48201332200",1134,634,2084,761,373,124,1493,754,7357
"48201332300",170,325,1852,469,39,35,171,349,3410
"48201332400",438,98,2668,886,37,123,419,217,4886
"48201332500",881,332,1251,184,391,14,1170,320,4543
"48201332600",2283,589,1742,731,721,1077,2885,1457,11485
"48201332700",1269,676,98,0,782,364,1887,1003,6079
"48201332800",2462,613,224,422,892,349,2929,936,8827
"48201332900",2972,1275,28,153,642,68,3130,1300,9568
"48201333000",2402,169,0,3,804,294,2882,457,7011
"48201333100",1020,583,631,226,794,428,1149,806,5637
"48201333201",2169,450,381,333,848,380,2704,772,8037
"48201333202",1711,884,1342,553,398,292,1628,1111,7919
"48201333300",4737,1921,1199,875,1159,417,5305,2247,17860
"48201333500",3376,1460,770,272,653,644,3626,2088,12889
"48201333600",2372,374,75,9,459,15,1997,347,5648
"48201333700",1829,521,219,23,543,286,2102,584,6107
"48201333800",3606,1880,1486,232,1865,452,4786,1922,16229
"48201333901",4555,340,1385,37,1633,254,4718,378,13300
"48201333902",4299,499,1574,655,1428,0,4264,441,13160
"48201334001",1552,518,946,330,376,9,1604,580,5915
"48201334002",1603,93,665,43,358,40,933,33,3768
"48201334003",3458,460,956,52,1454,266,2654,278,9578
"48201334100",1397,986,4561,1499,1696,222,1708,956,13025
"48201340100",2667,454,676,250,1215,412,2235,504,8413
"48201340201",1221,5,19,0,528,80,268,0,2121
"48201340202",3222,6,158,0,1833,0,574,6,5799
"48201340203",3631,34,34,0,727,7,426,0,4859
"48201340301",2807,84,33,0,1167,0,291,0,4382
"48201340302",5504,74,230,0,1370,92,720,69,8059
"48201340400",1178,51,17,0,208,0,89,44,1587
"48201340500",3808,674,70,251,1724,344,1508,401,8780
"48201340600",2333,69,91,7,70,0,235,48,2853
"48201340700",3923,605,787,95,1792,125,1361,264,8952
"48201340800",3918,252,87,102,1439,7,604,0,6409
"48201340900",2632,781,545,108,690,260,1426,253,6695
"48201341000",4184,349,1144,91,615,220,1259,254,8116
"48201341100",2311,553,162,43,332,188,1087,550,5226
"48201341201",2538,243,490,294,645,71,1138,85,5504
"48201341202",3983,352,19,0,321,0,869,92,5636
"48201341301",3285,565,227,93,719,274,636,425,6224
"48201341302",1794,210,388,14,298,248,784,129,3865
"48201341400",4151,72,118,0,689,69,632,47,5778
"48201341501",5432,341,134,1,786,0,776,151,7621
"48201341502",3186,503,30,18,731,8,411,115,5002
"48201341600",4268,372,210,1,702,37,637,0,6227
"48201341700",1852,288,31,26,104,9,378,98,2786
"48201341800",1396,151,17,12,147,36,271,23,2053
"48201342001",5613,53,46,0,1068,0,1417,0,8197
"48201342002",2615,140,153,0,313,104,1263,104,4692
"48201342100",2884,748,22,82,352,42,1292,710,6132
"48201342200",1876,793,143,0,758,154,1732,582,6038
"48201342300",4660,890,365,15,736,429,2814,737,10646
"48201342400",2311,295,51,0,661,262,1590,441,5611
"48201342500",4896,213,42,4,218,0,954,60,6387
"48201342700",4366,517,50,0,302,26,1084,170,6515
"48201342800",7498,78,149,25,1095,0,2075,0,10920
"48201342900",4927,367,34,1,353,59,721,126,6588
"48201343000",4729,771,160,112,1689,95,2252,417,10225
"48201343100",3546,261,263,63,447,32,966,39,5617
"48201343200",3866,185,480,16,365,0,968,0,5880
"48201343301",3297,365,132,0,659,52,1381,127,6013
"48201343302",4403,154,201,1,403,0,1719,51,6932
"48201343600",2485,469,109,37,206,23,1072,117,4518
"48201343700",1723,285,396,175,414,255,674,403,4325
"48201350100",7546,122,2411,695,4469,502,4414,57,20216
"48201350200",5686,335,1024,45,1273,216,4185,176,12940
"48201350300",3858,303,590,47,1067,64,1876,144,7949
"48201350400",3017,520,710,361,1054,348,2608,753,9371
"48201350500",3841,944,866,280,1039,262,3544,1005,11781
"48201350601",3308,88,444,17,756,0,857,9,5479
"48201350602",6143,178,1193,0,1110,44,1753,51,10472
"48201350700",2157,80,46,8,51,0,444,11,2797
"48201350801",3524,569,318,0,349,47,1072,365,6244
"48201350802",5100,112,503,136,1483,20,1726,15,9095
"48201410100",1523,79,698,698,618,147,543,57,4363
"48201410200",4059,374,169,1,249,0,715,1,5568
"48201410300",1538,237,121,48,249,55,284,39,2571
"48201410401",3322,246,206,0,314,34,710,76,4908
"48201410402",1950,266,17,0,779,18,779,93,3902
"48201410500",3405,193,58,14,387,37,601,36,4731
"48201410600",2809,202,172,90,124,50,293,54,3794
"48201410701",2827,313,159,56,468,31,554,71,4479
"48201410702",1416,383,93,73,239,73,249,75,2601
"48201410800",2358,554,106,14,151,102,193,285,3763
"48201410900",1984,464,0,5,120,22,384,291,3270
"48201411000",3799,145,175,46,434,72,145,14,4830
"48201411100",2969,136,38,15,497,25,372,92,4144
"48201411200",1736,43,9,0,110,0,136,0,2034
"48201411300",2444,234,291,3,569,126,577,152,4396
"48201411400",2642,35,97,0,54,0,34,0,2862
"48201411501",4528,194,38,0,569,77,1025,32,6463
"48201411502",3033,155,236,11,712,17,742,0,4906
"48201411600",2262,52,19,0,108,9,284,26,2760
"48201411700",1947,350,151,28,444,47,463,74,3504
"48201411800",3278,171,477,0,705,76,557,56,5320
"48201411900",2962,221,0,0,303,92,328,80,3986
"48201412000",2506,75,0,1,175,20,93,11,2881
"48201412100",0,0,0,0,0,0,0,0,0
"48201412200",4234,270,0,0,1120,49,360,48,6081
"48201412300",5732,204,0,0,761,0,230,0,6927
"48201412400",3743,40,12,11,631,0,174,0,4611
"48201412500",1369,52,10,10,276,19,176,2,1914
"48201412600",3350,88,20,0,457,0,361,0,4276
"48201412700",2353,146,30,0,587,47,385,0,3548
"48201412800",4284,61,0,0,918,138,446,126,5973
"48201412900",2335,236,336,50,1207,94,245,19,4522
"48201413000",2936,184,53,0,571,0,567,49,4360
"48201413100",2836,227,0,0,367,6,293,71,3800
"48201413201",1240,305,233,42,672,38,402,51,2983
"48201413202",1446,276,239,67,837,59,309,74,3307
"48201413300",4422,117,1087,71,1192,132,733,118,7872
"48201420100",455,375,800,448,695,227,603,583,4186
"48201420200",1089,78,380,57,870,41,612,38,3165
"48201420300",2224,133,609,61,358,19,450,2,3856
"48201420400",2624,225,49,25,297,36,439,154,3849
"48201420500",900,908,327,186,751,231,1455,1024,5782
"48201420600",1496,70,49,0,337,183,405,177,2717
"48201420700",2822,30,90,0,503,0,339,0,3784
"48201420800",1929,8,21,0,699,0,106,0,2763
"48201420900",4962,31,97,0,1091,0,260,0,6441
"48201421000",1929,23,28,0,466,3,287,10,2746
"48201421101",1071,950,268,72,394,492,812,1141,5200
"48201421102",1383,1018,509,53,1014,238,2180,1174,7569
"48201421201",1347,962,295,209,508,228,1472,1119,6140
"48201421202",1464,1096,17,31,556,305,1790,1241,6500
"48201421300",1483,1352,748,1087,1206,552,1301,1407,9136
"48201421401",1487,857,218,106,377,251,1766,1043,6105
"48201421402",936,1980,126,186,502,485,1438,2465,8118
"48201421403",2020,729,74,73,647,313,2530,1032,7418
"48201421500",1648,756,748,762,1440,164,1877,625,8020
"48201421600",2084,2143,450,11,1276,584,2513,2554,11615
"48201421700",2517,386,75,9,1468,101,1218,330,6104
"48201421800",2463,410,905,211,1019,119,727,376,6230
"48201421900",2172,117,53,0,122,93,216,58,2831
"48201422000",2030,232,132,0,265,0,351,195,3205
"48201422100",3089,252,799,196,638,3,1737,139,6853
"48201422200",677,422,2486,994,389,168,828,419,6383
"48201422301",1197,937,2196,1615,427,1207,1156,1063,9798
"48201422302",540,86,1273,282,189,68,359,110,2907
"48201422401",792,196,1501,781,545,209,807,85,4916
"48201422402",2721,824,423,108,855,645,2316,1238,9130
"48201422500",2243,748,511,921,1605,375,1982,894,9279
"48201422600",3562,630,643,200,586,16,1624,458,7719
"48201422701",2779,768,264,84,515,274,2574,953,8211
"48201422702",1870,109,47,273,1166,77,2103,123,5768
"48201422800",2327,775,57,195,851,147,1817,844,7013
"48201422900",1974,1221,690,199,593,245,1685,1366,7973
"48201423000",1986,1162,871,345,736,368,1858,1362,8688
"48201423100",752,744,501,443,201,125,888,860,4514
"48201423201",1536,282,863,179,299,222,856,464,4701
"48201423202",1986,1531,2179,1198,974,493,2741,1964,13066
"48201423301",1774,233,811,719,704,72,611,153,5077
"48201423302",1344,52,2205,980,95,154,588,58,5476
"48201423401",1189,72,2183,674,820,138,840,156,6072
"48201423402",716,32,2297,178,1041,20,941,0,5225
"48201423500",966,110,595,0,343,5,468,43,2530
"48201423600",2207,423,3072,425,798,285,1814,581,9605
"48201430100",5006,148,118,58,480,0,683,0,6493
"48201430200",1120,38,7,0,217,37,243,20,1682
"48201430300",3943,9,123,0,362,30,238,0,4705
"48201430400",2713,71,0,0,382,0,178,13,3357
"48201430500",1835,43,16,0,512,180,455,0,3041
"48201430600",3062,71,1,17,550,13,313,1,4028
"48201430700",2278,132,8,0,651,84,267,11,3431
"48201430800",3486,25,36,0,885,0,209,0,4641
"48201430900",4547,128,74,0,1064,72,510,17,6412
"48201431000",4441,35,528,3,518,0,960,3,6488
"48201431101",1988,335,254,42,109,299,440,120,3587
"48201431102",1682,250,500,205,304,421,545,22,3929
"48201431201",1835,631,352,153,886,287,763,414,5321
"48201431202",3151,110,700,14,831,98,660,52,5616
"48201431301",2448,486,755,0,833,618,929,712,6781
"48201431302",3444,181,37,28,131,27,182,65,4095
"48201431401",1492,195,196,0,408,93,440,112,2936
"48201431402",2424,181,139,0,506,53,398,24,3725
"48201431501",2777,201,37,0,289,149,203,151,3807
"48201431502",3116,85,65,41,392,25,483,69,4276
"48201431600",2701,94,22,31,280,0,353,0,3481
"48201431700",3898,175,60,2,438,0,235,13,4821
"48201431801",1992,35,161,30,685,98,359,0,3360
"48201431802",2110,156,138,0,918,0,894,30,4246
"48201431900",2184,60,250,0,599,36,325,26,3480
"48201432001",1979,149,383,48,762,108,882,1,4312
"48201432002",1959,777,472,412,561,280,1796,779,7036
"48201432100",1717,236,976,51,1693,319,1407,171,6570
"48201432200",2098,491,637,50,485,361,913,608,5643
"48201432300",2051,630,2165,443,1310,126,1752,667,9144
"48201432400",1399,461,1611,483,1127,485,1215,392,7173
"48201432500",2007,878,1200,363,1109,635,2261,1317,9770
"48201432600",1236,36,202,188,562,38,647,32,2941
"48201432701",2041,1766,66,112,1630,1383,3327,2984,13309
"48201432702",2073,255,253,33,167,89,961,282,4113
"48201432801",1359,412,1089,290,1051,495,1483,879,7058
"48201432802",2069,1291,850,132,795,493,2219,1574,9423
"48201432901",1787,407,117,109,708,119,1811,546,5604
"48201432902",2417,842,347,69,1329,491,2305,1119,8919
"48201433001",1260,1149,120,259,1334,1175,1704,1459,8460
"48201433002",1235,914,273,110,754,512,1365,1086,6249
"48201433003",1517,811,338,355,1260,892,1521,657,7351
"48201433100",1050,819,585,290,61,79,1078,970,4932
"48201433201",1676,313,941,160,1206,415,1368,289,6368
"48201433202",1660,437,199,61,971,533,1240,788,5889
"48201433300",2465,345,219,25,1203,283,1284,317,6141
"48201433400",1871,600,810,243,725,157,1741,688,6835
"48201433501",1789,2502,554,494,287,713,2016,3107,11462
"48201433502",1782,1639,913,861,534,693,2132,2318,10872
"48201433600",372,893,877,896,311,156,497,831,4833
"48201440100",3702,604,1707,80,824,27,2824,430,10198
"48201450100",1340,26,18,0,326,0,45,0,1755
"48201450200",3912,100,10,0,743,3,387,0,5155
"48201450300",3916,399,822,347,862,131,1456,235,8168
"48201450400",3206,134,1067,0,578,41,1326,36,6388
"48201450500",2243,23,207,0,153,48,135,0,2809
"48201450600",3174,235,215,76,328,46,854,56,4984
"48201450700",6045,41,0,0,494,98,323,0,7001
"48201450801",1056,91,265,0,463,15,325,15,2230
"48201450802",3024,488,1146,215,1269,630,1900,907,9579
"48201450900",2007,28,268,30,249,0,339,1,2922
"48201451001",1427,578,1498,708,447,350,431,670,6109
"48201451002",1598,197,1987,596,820,51,1477,181,6907
"48201451100",2368,137,541,15,985,81,758,81,4966
"48201451200",2346,81,16,0,268,0,162,0,2873
"48201451300",4124,353,1173,180,837,74,896,142,7779
"48201451401",2051,249,557,0,572,0,534,52,4015
"48201451402",1228,355,1747,687,535,255,928,282,6017
"48201451403",2055,590,777,308,817,74,992,430,6043
"48201451500",2402,248,479,0,1477,56,790,40,5492
"48201451601",4067,65,482,0,1210,213,639,65,6741
"48201451602",3700,255,561,47,1448,199,1015,148,7373
"48201451700",1993,60,744,64,445,60,1101,79,4546
"48201451800",1886,155,1171,73,1428,456,1603,390,7162
"48201451901",2522,181,2316,881,1080,239,1788,311,9318
"48201451902",1214,17,34,144,1150,128,200,17,2904
"48201452000",2739,577,2006,700,1465,81,1436,377,9381
"48201452100",3313,889,1816,350,1470,367,1083,818,10106
"48201452201",906,565,1979,216,534,234,617,599,5650
"48201452202",652,60,611,165,555,89,393,0,2525
"48201452300",827,53,368,19,1155,167,1239,136,3964
"48201452400",2603,367,850,17,3258,520,3200,427,11242
"48201452500",1520,763,1099,507,2485,1871,2081,1585,11911
"48201452600",1421,757,1779,927,2200,443,1866,842,10235
"48201452700",2527,556,1995,467,4446,694,2802,719,14206
"48201452801",1387,246,1465,429,1857,445,1906,376,8111
"48201452802",885,291,1088,492,1500,875,1347,775,7253
"48201452900",1270,345,660,114,937,764,1351,572,6013
"48201453000",2889,558,312,202,2449,225,4244,529,11408
"48201453100",986,603,570,391,1141,482,1382,937,6492
"48201453200",1697,1199,1539,921,1318,597,2065,1749,11085
"48201453300",361,122,828,568,437,279,388,193,3176
"48201453401",1204,44,337,401,764,145,1281,37,4213
"48201453402",2642,479,1266,347,1759,1480,2254,890,11117
"48201453403",272,302,840,740,685,514,477,593,4423
"48201453501",1691,559,1447,360,2054,208,2051,527,8897
"48201453502",1636,101,803,49,692,14,1303,35,4633
"48201453601",651,86,498,69,517,5,773,78,2677
"48201453602",2775,622,1046,1039,2040,854,3197,393,11966
"48201453700",2039,537,2064,389,2254,656,2708,691,11338
"48201453800",1876,464,573,141,550,154,1329,411,5498
"48201453900",1765,418,1755,488,3875,1132,2100,642,12175
"48201454000",1829,99,1437,360,1201,94,1649,150,6819
"48201454100",1013,297,1183,120,791,21,784,240,4449
"48201454200",1975,451,855,6,883,71,2152,506,6899
"48201454301",4204,462,2937,513,1735,816,3876,614,15157
"48201454302",3175,298,1189,8,1735,211,2220,413,9249
"48201454400",242,4,0,0,120,52,101,35,554
"48201454501",6092,124,152,0,1906,0,772,0,9046
"48201454502",1461,28,94,0,838,0,217,8,2646
"48201454600",3652,206,166,0,502,107,802,94,5529
"48201454700",5577,315,376,28,345,17,716,73,7447
"48201454800",5284,438,368,71,717,94,1262,71,8305
"48201454900",6985,326,1088,0,2475,277,1847,0,12998
"48201455000",1948,54,241,0,378,0,490,44,3155
"48201455101",5370,656,301,0,418,0,1168,388,8301
"48201455102",3053,186,32,0,219,80,522,0,4092
"48201455200",3128,468,318,2,269,0,827,222,5234
"48201455300",1945,89,416,135,456,11,452,14,3518
"48201510100",1195,142,67,52,299,126,721,247,2849
"48201510200",4009,555,217,118,510,41,895,303,6648
"48201510300",4647,215,50,0,590,69,1129,220,6920
"48201510400",3191,148,50,38,495,13,644,14,4593
"48201510500",2200,318,136,1,417,19,618,242,3951
"48201510600",3126,250,231,71,523,195,873,251,5520
"48201510700",2414,103,62,0,507,54,499,40,3679
"48201510800",5556,194,53,15,1016,80,934,22,7870
"48201510900",4153,966,94,0,1419,44,2387,642,9705
"48201511001",2254,93,86,0,128,23,676,23,3283
"48201511002",3607,184,142,0,541,0,1644,0,6118
"48201511100",1823,122,216,129,281,134,669,109,3483
"48201511200",3325,60,312,41,823,274,2047,275,7157
"48201511301",3042,303,0,0,306,0,755,101,4507
"48201511302",2909,427,65,1,299,2,666,70,4439
"48201511400",2805,246,0,89,291,22,1370,106,4929
"48201511500",4426,642,219,33,656,97,2333,375,8781
"48201511600",2917,852,19,13,355,32,2394,822,7404
"48201520100",1660,210,40,0,409,79,741,238,3377
"48201520200",2432,574,135,97,451,115,717,501,5022
"48201520300",2667,582,287,53,588,442,2042,817,7478
"48201520400",1350,1200,29,53,466,338,1205,1506,6147
"48201520500",4487,2034,572,47,627,386,3888,2384,14425
"48201520601",1277,545,0,0,204,245,1236,733,4240
"48201520602",2270,2158,123,0,875,801,2404,2592,11223
"48201520700",2257,602,64,75,534,355,969,811,5667
"48201521000",1042,710,78,0,182,132,628,814,3586
"48201521100",1058,601,5,0,219,279,1012,846,4020
"48201521200",2245,1378,399,1,2258,966,3521,2216,12984
"48201521300",3237,592,276,114,1003,610,2819,1116,9767
"48201521400",2377,2007,0,32,2109,1082,4089,3066,14762
"48201521500",2601,928,121,227,1850,232,2899,1074,9932
"48201521600",1821,502,550,3,307,375,1844,850,6252
"48201521700",2596,829,1421,590,922,682,2605,1273,10918
"48201521800",2730,605,273,83,1604,162,2273,521,8251
"48201521900",5106,327,233,40,859,323,2713,522,10123
"48201522000",2421,980,209,91,817,194,1772,943,7427
"48201522100",4232,1105,285,87,2185,611,3761,1599,13865
"48201522201",1501,1006,352,0,1241,173,1788,1117,7178
"48201522202",2059,444,17,31,271,899,1086,1250,6057
"48201522301",2578,1052,31,0,865,227,2466,886,8105
"48201522302",2224,372,257,2,1001,30,1974,371,6231
"48201522401",3467,584,107,0,509,521,1611,814,7613
"48201522402",1718,1030,84,57,436,207,601,1190,5323
"48201522500",4006,61,0,0,493,9,178,13,4760
"48201530100",2700,1829,527,343,919,309,2904,2036,11567
"48201530200",3201,371,61,51,156,213,988,339,5380
"48201530300",364,246,1150,657,37,3,482,239,3178
"48201530400",632,322,1091,327,98,330,696,581,4077
"48201530500",1223,778,1428,351,269,344,1347,922,6662
"48201530600",963,990,652,352,268,163,935,992,5315
"48201530700",2502,1108,657,1189,291,20,2326,1202,9295
"48201530800",258,268,1935,557,440,157,513,301,4429
"48201530900",3406,130,271,168,237,88,1407,91,5798
"48201531000",2828,484,15,30,360,9,1065,387,5178
"48201531100",2082,275,9,0,279,8,801,160,3614
"48201531200",1703,619,123,67,579,61,793,555,4500
"48201531300",3031,1132,706,69,620,131,2619,990,9298
"48201531400",1611,215,7,1,201,27,725,174,2961
"48201531500",2201,137,73,27,414,73,1097,122,4144
"48201531600",2317,317,45,16,172,0,803,299,3969
"48201531700",2669,82,0,49,79,26,499,0,3404
"48201531800",361,62,1003,307,104,44,419,56,2356
"48201531900",544,163,2281,1114,256,0,741,163,5262
"48201532001",1526,545,1191,1771,458,160,1373,617,7641
"48201532002",730,65,237,0,4,0,188,52,1276
"48201532100",2033,1084,1489,780,843,633,1592,1480,9934
"48201532200",699,711,649,153,232,88,580,653,3765
"48201532300",2317,374,1452,166,663,93,1770,262,7097
"48201532400",3527,278,930,0,810,306,2384,445,8680
"48201532501",4831,390,353,266,2714,374,5247,677,14852
"48201532502",2603,1378,105,48,1234,112,3078,1419,9977
"48201532600",1991,332,1706,924,1055,303,2275,383,8969
"48201532700",2301,123,1461,674,467,367,1193,350,6936
"48201532800",631,41,419,95,288,147,465,162,2248
"48201532900",1450,125,2121,347,587,227,1163,305,6325
"48201533000",313,399,1109,497,215,148,455,550,3686
"48201533100",1224,71,2955,1231,396,216,1260,247,7600
"48201533200",936,147,1372,508,152,23,765,126,4029
"48201533300",809,139,3092,2727,23,38,832,113,7773
"48201533400",3955,1101,2791,1368,1626,52,5192,1153,17238
"48201533500",1972,924,715,15,986,77,2336,928,7953
"48201533600",2376,714,1349,248,694,245,2629,626,8881
"48201533701",3132,1576,611,94,532,269,3137,1858,11209
"48201533702",1316,787,625,39,594,95,1382,846,5684
"48201533801",3301,1663,951,570,1843,266,3853,1799,14246
"48201533802",2453,1717,639,331,786,451,2516,1872,10765
"48201533901",2846,1405,2434,511,2025,600,3755,1790,15366
"48201533902",976,669,1234,783,564,79,1323,711,6339
"48201534001",1066,414,110,10,575,373,1214,690,4452
"48201534002",3167,516,883,499,715,97,3245,547,9669
"48201534003",812,188,995,28,490,113,1054,168,3848
"48201534100",3285,1308,765,113,2054,45,2881,1189,11640
"48201534201",587,884,110,0,644,171,397,814,3607
"48201534202",6151,126,508,0,1637,28,1625,64,10139
"48201534203",499,201,151,10,572,21,652,167,2273
"48201540100",6795,441,742,17,3447,253,2564,393,14652
"48201540200",1523,316,70,83,715,115,1394,374,4590
"48201540501",4101,512,552,28,683,315,3156,784,10131
"48201540502",4114,360,62,0,235,0,1180,298,6249
"48201540601",2625,201,610,26,753,21,1373,166,5775
"48201540602",3664,582,1295,28,1036,437,2692,631,10365
"48201540700",3738,922,440,3,1996,483,2141,874,10597
"48201540800",3787,705,848,206,2803,82,4429,623,13483
"48201540901",1845,157,266,65,221,0,253,129,2936
"48201540902",4435,646,1313,120,933,82,1077,592,9198
"48201541001",5286,248,1486,504,2367,42,2095,58,12086
"48201541002",5241,37,1050,271,1723,111,1750,86,10269
"48201541003",7756,143,1846,442,3144,343,3405,132,17211
"48201541100",4326,135,841,444,991,71,1420,34,8262
"48201541201",5972,193,489,0,1566,31,1710,37,9998
"48201541202",5464,649,398,258,2095,427,2875,666,12832
"48201541203",2488,0,76,0,98,22,208,22,2914
"48201541300",6009,1720,2320,252,1661,470,5033,1540,19005
"48201541400",6141,885,3147,531,3141,516,4291,961,19613
"48201541500",3569,420,461,0,1103,115,2174,141,7983
"48201541601",3481,361,365,1,539,2,839,133,5721
"48201541602",6479,1036,834,76,1450,776,4570,1436,16657
"48201541700",5651,919,2380,107,1493,465,3444,1035,15494
"48201541800",3143,549,607,15,501,386,1381,359,6941
"48201541900",4077,538,746,0,988,229,2004,530,9112
"48201542000",9515,734,2288,191,1751,139,5768,472,20858
"48201542101",8656,2349,2960,854,2156,115,6632,2044,25766
"48201542102",6869,1719,3270,77,1836,346,4547,1886,20550
"48201542200",9285,659,3628,631,2423,418,7572,905,25521
"48201542301",8176,1019,1846,243,1772,413,4974,1250,19693
"48201542302",3866,161,1452,50,1336,13,2595,95,9568
"48201542400",5509,674,945,349,1718,542,4266,821,14824
"48201542500",2134,117,32,0,71,24,242,108,2728
"48201542600",2831,159,372,0,869,52,1348,52,5683
"48201542700",3306,465,83,53,262,237,882,478,5766
"48201542800",5653,562,75,0,607,198,1984,667,9746
"48201542900",6724,678,1281,0,2592,463,3837,685,16260
"48201543001",5533,157,1886,168,1291,97,2205,223,11560
"48201543002",6597,567,1548,0,2638,15,2453,302,14120
"48201543003",8800,739,3060,87,3144,1216,7082,1428,25556
"48201543100",1462,624,120,0,314,0,592,568,3680
"48201543200",3593,508,112,216,1011,124,1216,434,7214
"48201550100",922,983,1024,965,656,307,1266,1268,7391
"48201550200",655,609,1390,1027,141,172,689,773,5456
"48201550301",1993,478,3595,1326,267,14,1348,465,9486
"48201550302",2058,899,3027,1705,1292,159,1868,749,11757
"48201550401",4029,1967,2545,1134,1044,360,3438,1995,16512
"48201550402",1551,506,5532,1183,1031,152,1509,515,11979
"48201550500",1915,445,1353,523,842,74,2027,427,7606
"48201550601",2590,693,2430,823,659,146,2311,834,10486
"48201550602",998,318,960,156,467,243,1254,334,4730
"48201550603",1790,1015,1548,137,586,158,2100,1134,8468
"48201550700",901,392,881,60,525,19,773,367,3918
"48201550800",918,414,1721,509,413,11,975,407,5368
"48201550900",3733,1194,1851,58,1941,485,3396,1197,13855
"48201551000",1481,373,725,77,236,49,1555,387,4883
"48201551100",2377,1602,2447,526,2116,648,2428,1916,14060
"48201551200",3256,452,909,106,1397,149,1333,368,7970
"48201551300",1915,76,708,1,968,63,1047,53,4831
"48201551400",2480,232,815,49,1045,134,1198,288,6241
"48201551500",3777,133,1765,132,2142,375,3050,254,11628
"48201551600",4959,714,1171,12,1135,48,3531,551,12121
"48201551701",5360,77,1474,17,1563,210,1714,246,10661
"48201551702",2629,9,266,0,999,49,541,9,4502
"48201551703",4428,574,415,35,1441,164,1303,505,8865
"48201551800",3872,68,324,3,438,19,532,1,5257
"48201551900",2494,371,1507,289,701,279,1621,310,7572
"48201552001",4143,808,1669,456,2270,113,2552,165,12176
"48201552002",1245,73,607,6,247,58,396,45,2677
"48201552101",1945,293,594,27,921,0,779,206,4765
"48201552102",4474,42,480,57,985,0,1020,0,7058
"48201552103",2092,84,257,42,182,469,528,480,4134
"48201552200",3741,291,448,621,824,204,1235,279,7643
"48201552301",3229,90,147,0,228,12,426,8,4140
"48201552302",3692,231,149,0,1056,0,963,0,6091
"48201552400",4127,412,545,210,1064,310,1923,182,8773
"48201552500",6456,542,1142,81,1694,194,3041,213,13363
"48201552601",2144,309,954,656,727,332,1066,126,6314
"48201552602",4547,256,719,0,867,39,1500,193,8121
"48201552700",5479,618,509,68,1417,0,1352,394,9837
"48201552800",6843,502,544,124,751,146,1001,323,10234
"48201552900",4273,320,1180,307,327,30,498,44,6979
"48201553001",3478,163,976,0,452,16,1096,100,6281
"48201553002",1965,893,1064,8,705,93,754,889,6371
"48201553100",3269,334,1476,74,706,82,1358,227,7526
"48201553200",2734,437,1471,691,637,162,1390,443,7965
"48201553300",963,308,2100,881,631,68,851,334,6136
"48201553401",3185,50,334,0,269,0,870,15,4723
"48201553402",5339,111,233,0,1092,32,1176,111,8094
"48201553403",4670,91,193,45,875,13,1442,39,7368
"48201553500",4466,218,466,25,501,22,916,153,6767
"48201553600",5181,101,472,78,962,138,1261,68,8261
"48201553700",2856,294,484,3,326,129,447,265,4804
"48201553801",2373,217,28,1,56,0,261,215,3151
"48201553802",5618,328,762,48,535,18,1161,116,8586
"48201553900",5611,114,1013,0,1122,32,587,0,8479
"48201554001",2289,341,513,23,488,95,421,206,4376
"48201554002",3485,30,38,0,672,109,339,0,4673
"48201554101",1118,8,50,0,18,3,104,11,1312
"48201554102",6989,372,746,90,2293,43,2208,41,12782
"48201554200",4360,417,1457,125,646,121,1217,311,8654
"48201554301",6354,40,230,0,153,22,688,22,7509
"48201554302",2784,134,247,92,1233,38,693,12,5233
"48201554401",12490,226,233,0,1434,14,2540,39,16976
"48201554402",9563,90,1218,10,1181,230,1266,1,13559
"48201554403",6690,400,1149,64,614,65,2005,324,11311
"48201554501",4724,72,335,2,773,32,1520,1,7459
"48201554502",5617,114,49,0,501,0,557,0,6838
"48201554600",4227,39,113,0,345,8,470,0,5202
"48201554700",5558,93,520,0,939,36,1024,21,8191
"48201554801",9968,946,1746,36,2198,467,3793,639,19793
"48201554802",11600,642,642,0,1539,213,2595,107,17338
"48201554901",4923,376,1297,0,2086,90,1747,139,10658
"48201554902",5878,284,45,25,444,0,654,265,7595
"48201554903",8778,51,646,0,1472,55,1789,0,12791
"48201555000",5613,323,718,0,810,39,1398,14,8915
"48201555100",6325,359,463,342,778,5,1681,296,10249
"48201555200",4826,733,448,66,570,457,1884,912,9896
"48201555301",627,40,0,0,4,30,32,0,733
"48201555302",10909,343,206,0,559,88,2154,177,14436
"48201555303",3818,72,231,65,266,51,942,0,5445
"48201555401",1772,322,55,70,136,0,419,194,2968
"48201555402",4938,1244,588,412,473,14,845,141,8655
"48201555501",3039,835,0,3,159,175,519,688,5418
"48201555502",13497,1023,844,154,2235,916,4354,1428,24451
"48201555600",3681,684,91,1,448,0,744,620,6269
"48201555701",5750,59,880,0,618,27,1469,0,8803
"48201555702",8602,0,426,0,487,51,1459,0,11025
"48201556000",5054,827,632,123,693,0,1975,315,9619
"48201980000",4,4,0,0,0,0,0,0,8
"48201980100",177,50,298,89,131,0,308,31,1084
"48203020102",3548,391,430,508,76,52,247,130,5382
"48203020103",3264,562,339,113,145,26,171,176,4796
"48203020104",2726,97,726,288,108,23,429,4,4401
"48203020200",5809,524,738,326,108,44,300,43,7892
"48203020301",2978,139,612,167,141,0,308,0,4345
"48203020302",1987,607,873,626,0,0,769,421,5283
"48203020401",1413,287,1244,858,95,142,736,315,5090
"48203020402",999,242,2441,632,38,109,344,278,5083
"48203020501",948,516,349,408,139,24,512,203,3099
"48203020502",2728,396,1029,271,254,28,465,0,5171
"48203020603",4744,320,124,0,298,140,478,140,6244
"48203020604",2695,693,568,151,40,62,200,8,4417
"48203020605",4482,184,218,10,92,33,118,43,5180
"48203020606",4261,206,232,79,99,0,347,2,5226
"48205950200",3946,225,25,0,209,170,618,317,5510
"48207950300",1896,466,97,65,407,135,503,253,3822
"48207950400",1718,276,26,33,101,15,154,49,2372
"48209010100",1363,832,27,74,76,55,320,204,2951
"48209010200",404,275,30,0,73,60,13,12,867
"48209010302",1843,695,37,24,919,556,2133,919,7126
"48209010303",3379,2174,224,373,528,431,1838,1132,10079
"48209010304",2176,1997,164,140,660,574,1704,1358,8773
"48209010400",4329,1687,246,3,1385,464,3227,1378,12719
"48209010500",1929,942,148,23,604,282,1489,978,6395
"48209010600",7178,594,216,76,1056,173,2239,179,11711
"48209010701",3534,3375,0,0,327,342,632,953,9163
"48209010702",1704,796,0,87,112,0,292,127,3118
"48209010803",3512,781,0,0,162,21,281,98,4855
"48209010804",7717,345,147,1,295,0,524,46,9075
"48209010805",5849,82,79,0,459,0,777,7,7253
"48209010806",3659,240,1,3,66,14,74,2,4059
"48209010807",1652,318,0,1,133,48,376,141,2669
"48209010808",5118,317,0,2,263,12,655,95,6462
"48209010809",4502,172,40,0,712,0,905,25,6356
"48209010901",7042,279,72,0,421,25,1261,13,9113
"48209010902",8888,533,136,29,1151,111,3432,261,14541
"48209010905",4483,335,159,127,462,255,1888,377,8086
"48209010906",6986,565,660,30,2208,718,5244,1023,17434
"48209010907",6092,977,361,74,2117,752,5531,1442,17346
"48209010908",5462,998,270,0,1204,640,3918,1310,13802
"48209010909",4608,85,151,0,232,51,1331,0,6458
"48209010910",5974,449,755,41,1233,215,4202,573,13442
"48211950300",3240,259,0,0,211,199,1011,260,5180
"48213950100",5681,830,409,10,52,71,393,104,7550
"48213950200",3667,533,28,32,194,65,440,100,5059
"48213950300",6064,684,112,0,176,93,520,225,7874
"48213950400",3525,442,135,48,330,0,310,56,4846
"48213950500",1875,419,1,0,11,0,87,17,2410
"48213950601",1880,934,21,17,109,12,133,132,3238
"48213950602",4184,1115,14,98,133,20,136,277,5977
"48213950700",3479,1097,18,0,30,121,360,311,5416
"48213950800",3766,707,27,0,130,0,350,0,4980
"48213950901",4225,633,39,21,217,0,117,63,5315
"48213950902",1674,133,92,60,46,13,69,18,2105
"48213950903",1702,282,45,14,124,0,45,0,2212
"48213951000",1579,226,167,221,9,72,265,87,2626
"48213951100",2883,878,0,0,85,10,83,233,4172
"48213951200",2321,1461,948,687,539,17,1213,1045,8231
"48213951300",3552,558,316,312,111,288,555,582,6274
"48213951400",4893,1170,865,104,164,51,289,88,7624
"48215020101",2920,2979,11,2,139,274,2828,3168,12321
"48215020102",4509,3634,0,0,194,282,3622,3743,15984
"48215020201",4219,1995,0,0,643,389,4750,2377,14373
"48215020202",4468,2287,0,0,545,441,4883,2647,15271
"48215020204",5033,2808,69,0,548,164,4954,2752,16328
"48215020205",3412,1164,21,0,369,483,3521,1647,10617
"48215020301",8181,1163,146,0,581,156,6881,1230,18338
"48215020302",8256,540,77,0,621,68,7646,418,17626
"48215020402",5921,1318,99,0,1176,0,5104,1285,14903
"48215020403",2187,2060,0,1,440,372,2398,2335,9793
"48215020404",3494,790,25,0,206,109,2014,716,7354
"48215020501",3278,1516,0,3,123,121,3130,1551,9722
"48215020503",6263,3429,0,0,892,205,6922,3591,21302
"48215020504",4793,1665,93,0,574,184,4741,1839,13889
"48215020600",1374,801,14,0,76,146,1426,947,4784
"48215020701",7120,1182,97,49,761,105,6701,1276,17291
"48215020721",4771,2109,38,0,727,28,4704,2100,14477
"48215020723",2064,3100,0,28,233,264,2239,3278,11206
"48215020724",3264,554,0,0,223,183,2606,667,7497
"48215020725",2627,1077,0,50,230,123,2715,1209,8031
"48215020726",3033,2067,0,0,400,412,2492,2454,10858
"48215020802",4619,1852,0,0,630,631,4112,2459,14303
"48215020803",3966,808,144,0,450,87,3264,850,9569
"48215020804",2315,846,92,34,204,65,1726,711,5993
"48215020901",3352,1022,0,0,574,38,2638,1037,8661
"48215020903",3731,574,6,0,933,69,3946,564,9823
"48215020904",2614,892,7,0,476,89,2055,957,7090
"48215021000",3153,2161,25,9,344,420,3123,2441,11676
"48215021100",1036,1136,59,0,93,267,1100,1378,5069
"48215021201",1794,531,0,6,351,58,1514,537,4791
"48215021202",3723,610,0,1,728,52,3443,618,9175
"48215021302",8013,7361,14,0,567,380,8488,7633,32456
"48215021303",4653,2832,0,0,427,248,4943,3061,16164
"48215021304",4106,1924,0,0,29,193,4006,2115,12373
"48215021305",5019,1331,0,0,162,35,5130,1366,13043
"48215021401",2286,3021,0,1,158,155,2194,3076,10891
"48215021403",3076,835,0,28,379,177,2844,1010,8349
"48215021404",6083,1919,52,0,187,16,4790,1910,14957
"48215021500",2156,1369,0,0,204,98,2358,1466,7651
"48215021600",2022,1846,10,5,60,153,2073,1824,7993
"48215021701",6221,2069,0,0,848,87,6395,1926,17546
"48215021702",8390,3110,0,0,426,146,8206,3215,23493
"48215021803",2996,1682,0,0,224,85,3139,1763,9889
"48215021804",1253,2576,81,3,182,205,1512,2781,8593
"48215021805",6323,2433,0,0,345,67,6555,2401,18124
"48215021806",6450,2061,0,50,111,31,6472,2142,17317
"48215021901",6783,3231,0,0,131,555,5425,3585,19710
"48215021903",3175,925,0,3,171,15,3179,940,8408
"48215021904",3460,1266,17,0,108,40,2907,1286,9084
"48215022001",7576,2715,0,1,444,12,7627,2700,21075
"48215022003",3379,3514,0,0,209,57,2732,3446,13337
"48215022004",5738,4538,69,33,177,195,5366,4695,20811
"48215022103",3609,1584,0,48,170,411,2801,1951,10574
"48215022104",3930,4519,29,5,1095,914,4879,5352,20723
"48215022105",1385,2065,0,1,265,0,1598,1869,7183
"48215022106",2992,1735,60,0,441,108,2968,1763,10067
"48215022201",2842,2415,0,0,876,707,3146,3070,13056
"48215022203",1687,1231,0,1,345,248,1936,1385,6833
"48215022204",3081,1549,30,0,430,166,3450,1715,10421
"48215022300",6723,1725,7,0,761,390,5022,1999,16627
"48215022401",2110,1518,35,2,183,445,2092,1941,8326
"48215022402",3213,1251,0,0,906,284,3943,1525,11122
"48215022501",2896,2559,0,0,671,455,3415,2975,12971
"48215022502",2917,1337,65,0,484,380,3183,1654,10020
"48215022600",987,636,0,0,442,230,1411,866,4572
"48215022701",3290,1243,0,0,177,101,2048,1154,8013
"48215022702",3419,1816,0,0,128,80,2465,1712,9620
"48215022800",4491,3559,0,0,666,443,4744,4002,17905
"48215022900",2412,1196,7,0,294,658,2123,1643,8333
"48215023000",2392,1238,152,0,675,258,2998,1468,9181
"48215023102",2915,2948,15,24,858,833,3665,3763,15021
"48215023103",2884,2729,8,0,351,772,3044,3475,13263
"48215023104",2652,1481,51,8,439,621,2975,2100,10327
"48215023503",4714,2601,0,0,276,196,4759,2781,15327
"48215023504",6016,2675,70,0,396,185,5784,2806,17932
"48215023507",5662,2899,0,0,382,247,5647,3146,17983
"48215023509",7753,1103,148,200,1034,54,6659,1192,18143
"48215023510",7382,1005,15,0,1262,129,5720,1001,16514
"48215023511",4629,4408,0,0,332,722,4819,5130,20040
"48215023512",161,189,9,60,0,33,161,184,797
"48215023513",4389,3168,48,1,529,149,4627,3291,16202
"48215023514",3332,4313,0,0,504,446,3669,4370,16634
"48215023515",5435,4706,0,0,463,33,5620,4739,20996
"48215023600",4963,2552,0,10,459,309,5112,2732,16137
"48215023700",2249,2238,14,0,341,352,2528,2491,10213
"48215023801",6082,1382,0,0,873,38,6234,1368,15977
"48215023802",6220,1286,101,1,810,0,5947,1265,15630
"48215023902",9003,810,378,0,1284,485,8133,922,21015
"48215023903",2086,1098,142,0,335,233,2212,1259,7365
"48215023904",6055,1551,0,0,687,53,5787,1504,15637
"48215024000",9611,4298,138,38,1266,287,9790,4292,29720
"48215024105",5712,3098,0,0,587,583,5520,3569,19069
"48215024106",7287,2814,8,0,1181,339,7277,3077,21983
"48215024107",3008,1499,0,1,334,214,2981,1696,9733
"48215024108",2407,2629,0,0,950,242,3302,2871,12401
"48215024109",3151,2174,0,0,241,373,3280,2547,11766
"48215024110",6486,2399,0,0,738,517,6961,2916,20017
"48215024111",2964,1584,0,0,285,103,2991,1672,9599
"48215024112",3376,8611,8,0,428,957,3715,9535,26630
"48215024113",2328,3660,0,0,467,623,2770,4160,14008
"48215024114",3669,4601,0,0,734,644,4372,5245,19265
"48215024201",7435,6206,26,23,609,610,8061,6839,29809
"48215024203",4346,1589,0,0,220,83,2857,1558,10653
"48215024204",2160,1524,0,0,138,102,2030,1626,7580
"48215024205",3935,2178,0,0,558,453,4474,2614,14212
"48215024301",1057,194,0,0,192,5,1010,194,2652
"48215024302",390,507,0,0,87,43,325,529,1881
"48215024402",5273,2822,0,0,808,1002,5914,3729,19548
"48215024403",2356,2192,16,0,681,410,3053,2602,11310
"48215024404",2340,1070,0,16,176,129,2419,1215,7365
"48215024500",3249,3420,0,114,525,1032,3668,4481,16489
"48215024600",2573,1799,0,0,642,637,3160,2425,11236
"48215980000",0,0,0,0,0,0,0,0,0
"48217960100",2649,496,299,112,141,58,270,236,4261
"48217960200",3417,466,0,0,35,0,127,40,4085
"48217960400",1602,324,0,5,49,1,87,65,2133
"48217960500",5176,745,14,0,127,16,614,69,6761
"48217960600",871,204,0,6,17,4,124,22,1248
"48217960700",1662,277,2,0,30,0,232,45,2248
"48217960800",2362,605,183,20,204,12,703,445,4534
"48217960900",1262,485,133,222,146,81,1148,477,3954
"48217961000",802,257,445,86,56,15,447,221,2329
"48217961100",2738,452,31,38,197,41,436,161,4094
"48217961400",2851,525,500,117,73,83,251,154,4554
"48219950100",1013,235,31,15,206,44,521,221,2286
"48219950200",3103,523,19,10,760,24,1075,310,5824
"48219950300",3415,223,90,1,529,118,1806,278,6460
"48219950400",2722,1047,183,57,543,322,2274,1029,8177
"48219950500",3213,423,64,65,347,111,1122,271,5616
"48219950600",1181,68,19,2,195,22,524,75,2086
"48219950700",974,151,25,0,208,57,531,105,2051
"48221160100",3404,389,11,6,276,0,324,9,4419
"48221160204",2697,123,25,0,84,0,297,0,3226
"48221160205",4732,1233,65,38,515,196,704,337,7820
"48221160206",3336,295,10,0,142,0,172,0,3955
"48221160207",4515,959,0,1,80,29,47,85,5716
"48221160208",3120,865,0,0,1451,94,1420,94,7044
"48221160209",6686,574,0,18,127,17,513,27,7962
"48221160210",4685,227,0,0,120,0,234,56,5322
"48221160301",5026,257,79,0,211,201,593,202,6569
"48221160302",3261,523,0,0,181,145,133,175,4418
"48223950100",2652,378,16,13,85,34,305,63,3546
"48223950200",3730,653,9,8,92,3,188,118,4801
"48223950300",4394,871,62,17,241,124,877,428,7014
"48223950401",2681,675,162,227,186,22,762,154,4869
"48223950402",2698,265,195,186,192,100,421,100,4157
"48223950500",1389,694,229,115,173,15,279,191,3085
"48223950600",1872,575,959,218,265,200,174,181,4444
"48223950700",3202,758,111,0,191,0,378,265,4905
"48223950800",2015,500,22,16,105,0,373,68,3099
"48225950100",3985,406,438,153,56,199,162,177,5576
"48225950200",1032,146,314,32,117,0,117,116,1874
"48225950300",1073,76,444,509,46,37,43,37,2265
"48225950400",764,239,1054,1085,248,173,432,242,4237
"48225950500",2889,349,461,79,139,27,321,37,4302
"48225950600",1227,90,210,83,70,9,60,9,1758
"48225950700",1738,269,307,138,105,10,44,5,2616
"48227950100",1767,216,42,0,163,127,360,219,2894
"48227950200",1441,172,0,0,135,43,302,88,2181
"48227950300",433,436,62,10,299,259,539,643,2681
"48227950400",2327,508,211,85,341,120,948,284,4824
"48227950500",1901,532,58,71,520,187,1117,468,4854
"48227950600",3246,147,179,1,487,0,932,50,5042
"48227950700",2181,501,82,89,310,123,1316,264,4866
"48227950801",2947,202,101,38,843,96,755,123,5105
"48227950802",1138,163,163,23,347,52,509,193,2588
"48227950900",2979,232,7,9,356,81,547,90,4301
"48229950300",1621,1395,0,0,167,15,1287,1230,5715
"48231960100",1737,405,0,113,230,93,264,14,2856
"48231960200",1769,230,184,103,311,22,288,28,2935
"48231960300",2941,567,13,74,140,216,156,354,4461
"48231960400",3229,475,525,132,735,78,902,139,6215
"48231960500",1613,978,357,288,210,176,270,207,4099
"48231960600",1059,545,421,164,325,91,206,196,3007
"48231960700",4386,405,187,1,233,25,400,25,5662
"48231960800",909,828,679,318,717,738,1150,1225,6564
"48231960900",1677,684,421,784,501,420,1017,444,5948
"48231961000",1739,983,189,235,385,46,500,89,4166
"48231961100",5740,506,206,21,440,0,365,0,7278
"48231961200",3333,238,514,8,341,49,298,61,4842
"48231961300",4687,648,229,214,337,271,309,234,6929
"48231961400",5456,731,284,51,532,256,943,288,8541
"48231961501",2735,232,0,0,200,16,171,20,3374
"48231961502",3623,696,55,0,214,212,356,181,5337
"48231961503",3332,429,28,47,288,24,284,47,4479
"48231961600",3764,1567,0,1,212,25,145,76,5790
"48231961700",2578,196,0,0,128,0,83,0,2985
"48233950200",2278,177,0,0,65,15,139,19,2693
"48233950500",4228,495,0,17,278,26,236,23,5303
"48233950600",2490,988,161,131,143,181,1074,558,5726
"48233950700",955,447,151,11,67,189,424,244,2488
"48233950800",356,115,0,0,39,54,124,92,780
"48233950900",3205,246,7,30,534,51,809,91,4973
"48233951000",3042,207,33,1,219,45,606,24,4177
"48235950100",1318,138,38,0,107,2,368,65,2036
"48237950100",1419,81,0,0,6,23,169,0,1698
"48237950300",2619,474,20,0,36,10,498,177,3834
"48237950500",2210,708,2,0,157,0,185,56,3318
"48239950100",4402,425,28,30,382,56,1404,189,6916
"48239950200",2182,411,676,264,67,50,797,351,4798
"48239950300",3920,407,93,19,423,112,1165,241,6380
"48241950100",4560,461,618,179,73,104,49,53,6097
"48241950200",1468,283,640,662,168,0,297,168,3686
"48241950300",618,841,1258,649,118,0,131,466,4081
"48241950400",3466,324,378,134,154,28,165,97,4746
"48241950500",2783,769,598,0,96,0,99,0,4345
"48241950600",1248,210,206,115,53,82,111,68,2093
"48241950700",7704,687,0,19,29,49,63,47,8598
"48241950800",1986,423,137,63,140,91,19,0,2859
"48243950100",1928,161,0,0,149,5,822,112,3177
"48245000101",2678,179,1631,254,191,94,563,117,5707
"48245000102",589,153,937,113,50,26,86,67,2021
"48245000103",161,129,1311,1065,23,66,103,112,2970
"48245000200",1374,100,2692,523,293,116,264,181,5543
"48245000302",5123,249,605,70,510,0,467,0,7024
"48245000304",3368,582,1703,355,369,162,460,353,7352
"48245000306",2796,351,191,153,234,151,246,151,4273
"48245000307",1380,166,579,106,833,209,344,9,3626
"48245000308",2334,337,1470,337,603,310,197,118,5706
"48245000309",1801,60,535,22,180,116,146,24,2884
"48245000310",3734,103,821,53,304,42,473,43,5573
"48245000400",2847,216,738,666,83,0,116,1,4667
"48245000500",983,94,711,228,100,31,634,9,2790
"48245000600",932,151,3372,2003,487,462,1263,418,9088
"48245000700",316,26,1795,1017,47,0,207,16,3424
"48245000900",99,94,623,1008,0,109,71,120,2124
"48245001100",1262,288,378,0,222,37,268,118,2573
"48245001200",925,75,661,389,181,134,479,124,2968
"48245001301",2062,443,1794,71,421,23,736,49,5599
"48245001302",1340,116,697,466,275,65,424,42,3425
"48245001303",1733,117,695,233,346,8,256,0,3388
"48245001700",147,39,1017,593,33,16,10,12,1867
"48245001900",643,732,1043,251,393,235,685,696,4678
"48245002000",672,236,865,199,438,100,712,158,3380
"48245002100",267,100,1965,973,274,169,458,170,4376
"48245002200",203,1,1413,901,13,25,46,0,2602
"48245002300",111,109,2163,689,18,40,124,126,3380
"48245002400",659,167,1047,580,59,96,371,213,3192
"48245002500",976,246,2004,905,504,63,813,147,5658
"48245002600",387,539,1289,1654,146,338,115,181,4649
"48245005100",93,0,460,315,0,10,0,10,888
"48245005400",190,24,698,480,48,25,89,23,1577
"48245005500",767,228,739,284,379,283,599,90,3369
"48245005600",1363,906,636,46,432,334,1463,670,5850
"48245005900",13,110,542,981,0,0,13,0,1659
"48245006100",33,80,693,264,3,6,33,20,1132
"48245006300",63,69,893,513,30,0,0,3,1571
"48245006400",331,136,452,158,90,68,271,101,1607
"48245006500",1469,545,523,438,315,275,1050,708,5323
"48245006600",1436,649,597,697,400,245,888,424,5336
"48245006700",1371,327,434,15,529,217,1387,522,4802
"48245006800",767,89,444,134,379,109,531,174,2627
"48245006900",768,93,1596,527,110,23,32,0,3149
"48245007001",1281,621,1351,1067,616,217,106,459,5718
"48245007002",1904,87,724,487,1345,229,696,137,5609
"48245007100",2680,785,29,1,45,272,640,638,5090
"48245010100",1256,474,278,155,331,181,1109,547,4331
"48245010200",975,439,333,142,99,0,371,308,2667
"48245010300",1503,209,335,6,515,261,1294,314,4437
"48245010400",2450,168,72,104,138,160,175,10,3277
"48245010500",2299,530,513,241,452,13,1314,412,5774
"48245010600",4145,702,1,0,257,264,573,274,6216
"48245010700",3076,37,12,56,43,0,274,11,3509
"48245010800",3715,922,97,10,179,0,267,34,5224
"48245010901",2528,202,170,0,125,0,98,22,3145
"48245010902",4138,198,121,0,486,0,582,0,5525
"48245011001",3746,803,331,154,250,112,412,136,5944
"48245011002",3517,123,63,65,81,0,319,18,4186
"48245011101",3761,243,47,9,185,21,543,48,4857
"48245011102",2305,200,69,0,90,0,265,0,2929
"48245011201",5950,351,11,21,647,14,1073,14,8081
"48245011202",0,0,0,0,0,0,0,0,0
"48245011203",0,0,0,0,0,0,0,0,0
"48245011302",0,0,0,0,0,0,0,0,0
"48245011303",2044,126,0,0,131,37,219,37,2594
"48245011304",3037,111,166,73,130,7,203,15,3742
"48245011400",5199,716,1300,75,182,170,362,602,8606
"48245011500",1996,277,78,6,27,30,26,101,2541
"48245011600",1456,244,23,3,94,0,129,65,2014
"48245011700",661,160,443,402,103,0,649,156,2574
"48245011800",42,102,1074,527,13,0,23,57,1838
"48245980000",111,0,0,0,55,41,28,0,235
"48245990000",0,0,0,0,0,0,0,0,0
"48247950200",2357,165,0,0,110,7,2385,155,5179
"48247950400",1838,542,87,2,112,18,1871,560,5030
"48249950100",6969,1212,101,0,296,176,3954,731,13439
"48249950200",5382,1446,75,2,459,326,4888,1656,14234
"48249950300",5353,903,0,0,583,42,4879,918,12678
"48249950400",2544,849,51,0,48,39,2095,775,6401
"48249950500",4105,1324,0,54,250,268,3951,1377,11329
"48249950600",2794,1247,0,0,181,177,2836,1315,8550
"48249950700",2392,741,0,0,212,31,2077,763,6216
"48251130100",3623,328,0,11,116,0,553,63,4694
"48251130204",9538,759,226,2,213,0,1430,44,12212
"48251130205",3058,440,82,0,245,0,565,32,4422
"48251130207",5698,322,182,0,190,0,449,17,6858
"48251130208",4888,354,37,0,76,80,295,57,5787
"48251130210",4222,304,39,1,243,10,423,10,5252
"48251130211",5133,999,0,0,66,0,518,547,7263
"48251130212",4268,661,69,0,59,33,800,267,6157
"48251130213",3879,279,49,2,422,8,1366,52,6057
"48251130214",3809,520,64,0,64,26,365,57,4905
"48251130215",3621,98,385,0,45,14,250,14,4427
"48251130302",3185,908,87,66,294,202,533,178,5453
"48251130303",2498,773,9,211,211,0,756,535,4993
"48251130304",3779,892,168,234,183,18,1153,490,6917
"48251130405",5313,207,0,1,83,15,597,1,6217
"48251130406",5527,176,20,23,199,0,468,22,6435
"48251130407",6324,1074,91,9,333,265,2772,890,11758
"48251130408",5051,500,187,13,565,185,1458,111,8070
"48251130409",5267,237,20,1,228,172,604,163,6692
"48251130410",5325,1142,97,80,403,16,954,522,8539
"48251130500",6013,459,55,38,92,0,367,112,7136
"48251130601",5656,755,65,2,227,15,658,225,7603
"48251130602",1475,156,0,0,74,0,128,135,1968
"48251130700",3229,646,11,0,181,24,694,263,5048
"48251130800",2366,939,79,37,63,152,818,498,4952
"48251130900",1773,623,253,223,261,16,882,362,4393
"48251131000",3840,483,78,20,540,12,413,283,5669
"48251131100",4414,497,0,76,412,0,1215,134,6748
"48253020101",1063,194,6,0,52,0,110,10,1435
"48253020102",0,0,0,0,0,0,0,0,0
"48253020200",1709,305,5,4,88,59,577,229,2976
"48253020300",1550,425,33,32,51,25,285,106,2507
"48253020400",2117,617,15,98,240,128,618,399,4232
"48253020500",3701,453,33,45,142,71,321,30,4796
"48255970100",2115,174,0,0,79,103,119,129,2719
"48255970200",1571,384,141,7,859,219,1483,424,5088
"48255970300",2094,437,94,0,613,993,1517,1246,6994
"48255970400",636,73,6,0,542,267,702,337,2563
"48257050201",4922,289,458,0,525,7,771,106,7078
"48257050203",6049,110,1180,64,289,12,646,3,8353
"48257050204",4021,423,606,4,288,5,1324,196,6867
"48257050205",4598,277,607,27,496,16,770,21,6812
"48257050206",8089,246,802,161,714,66,1616,35,11729
"48257050300",2385,360,266,280,352,35,736,125,4539
"48257050400",4883,1300,274,54,517,297,1668,1383,10376
"48257050500",1374,353,2005,547,330,44,685,165,5503
"48257050600",4480,1262,613,0,578,0,901,704,8538
"48257050701",3539,482,197,11,218,130,325,415,5317
"48257050703",2155,365,12,58,138,22,319,160,3229
"48257050704",4168,1065,190,91,107,214,418,686,6939
"48257050800",8360,531,109,67,246,27,522,45,9907
"48257051000",706,359,81,123,322,51,620,296,2558
"48257051100",3328,401,237,133,368,189,1264,304,6224
"48257051201",1796,937,33,0,61,30,98,84,3039
"48257051202",4120,592,14,30,99,93,314,21,5283
"48257051300",7017,1263,367,90,207,164,572,139,9819
"48259970100",4677,1268,0,0,121,22,856,1051,7995
"48259970301",5130,405,2,2,71,0,950,40,6600
"48259970302",4093,66,38,0,61,206,480,227,5171
"48259970401",6339,161,0,5,317,129,1467,9,8427
"48259970402",5946,189,28,0,109,0,560,160,6992
"48259970500",3839,474,56,0,432,278,950,477,6506
"48261950100",343,172,8,0,1,0,250,162,936
"48261990000",0,0,0,0,0,0,0,0,0
"48263950100",776,74,0,0,10,0,82,34,976
"48265960100",4570,526,0,0,307,162,714,170,6449
"48265960200",3190,174,10,0,29,0,356,5,3764
"48265960301",3074,1248,0,0,134,28,701,588,5773
"48265960302",6171,662,0,11,244,15,814,71,7988
"48265960401",1723,317,0,0,276,18,959,117,3410
"48265960402",4377,318,203,0,257,6,874,9,6044
"48265960500",2989,683,157,162,685,203,1482,363,6724
"48265960600",4891,1788,190,11,211,87,2231,860,10269
"48265960700",4181,122,0,0,418,0,571,16,5308
"48265960800",2534,607,0,22,78,10,617,245,4113
"48267950100",1676,275,19,0,26,12,269,114,2391
"48267950200",1804,587,0,0,84,0,432,291,3198
"48269950100",288,19,0,0,14,0,66,10,397
"48271950100",2440,817,44,19,4,24,1252,674,5274
"48273020100",4250,707,0,31,195,201,2608,722,8714
"48273020200",3457,1657,0,26,301,86,3236,1627,10390
"48273020300",3219,1628,215,118,427,521,2396,1575,10099
"48273020400",4449,1105,279,61,336,90,3634,986,10940
"48273020500",4820,979,272,0,521,156,3744,921,11413
"48273990000",0,0,0,0,0,0,0,0,0
"48275950100",1320,256,11,53,106,18,337,139,2240
"48275950200",1183,316,96,79,127,24,504,155,2484
"48277000101",3939,530,40,0,399,0,476,4,5388
"48277000102",4028,494,71,28,104,6,71,112,4914
"48277000200",2635,370,124,110,189,28,108,173,3737
"48277000300",4450,704,60,27,196,48,291,95,5871
"48277000401",2258,490,585,47,299,53,10,86,3828
"48277000402",5548,277,386,3,382,13,486,2,7097
"48277000500",682,709,1024,750,105,241,25,312,3848
"48277000600",720,528,316,317,101,81,23,0,2086
"48277000700",1931,537,318,370,107,57,215,47,3582
"48277000800",1281,647,326,511,49,91,8,127,3040
"48277000900",3647,262,110,64,278,7,146,0,4514
"48277001000",2166,541,343,208,81,111,214,133,3797
"48279950100",1819,463,5,24,118,10,1176,423,4038
"48279950200",1235,279,21,12,46,4,562,273,2432
"48279950300",1687,439,38,23,147,147,790,416,3687
"48279950500",2203,804,248,20,131,66,1556,754,5782
"48279950600",2649,616,114,110,189,4,933,356,4971
"48281950100",2120,334,11,47,58,5,264,197,3036
"48281950301",5265,497,500,0,380,80,581,28,7331
"48281950302",2918,241,28,0,69,0,578,0,3834
"48281950400",1706,1003,19,137,341,262,524,669,4661
"48281950500",2617,673,118,15,128,20,630,49,4250
"48283950300",4167,1225,0,0,606,97,3875,1236,11206
"48285000100",3193,134,176,3,74,18,148,0,3746
"48285000200",2580,234,353,139,149,0,288,31,3774
"48285000300",1911,100,75,3,238,66,264,66,2723
"48285000400",2824,233,229,34,180,18,268,124,3910
"48285000500",2346,215,84,11,516,32,548,56,3808
"48285000600",1235,141,129,106,1057,84,1244,116,4112
"48287000100",4455,250,128,116,139,0,334,48,5470
"48287000200",1890,133,610,121,140,11,387,31,3323
"48287000300",2449,216,142,58,32,0,150,30,3077
"48287000400",3216,933,514,103,179,19,1613,786,7363
"48289950100",4639,1152,349,277,821,80,1190,348,8856
"48289950200",3505,640,58,28,143,57,154,190,4775
"48289950300",3574,622,449,88,164,0,199,175,5271
"48291700100",2748,1021,89,108,594,292,799,643,6294
"48291700200",558,379,1003,302,28,49,97,106,2522
"48291700300",6890,1389,196,25,529,877,1461,1666,13033
"48291700400",5476,765,132,50,347,34,397,179,7380
"48291700500",1869,335,27,21,0,17,97,5,2371
"48291700600",1835,547,78,11,83,242,71,196,3063
"48291700700",2074,280,20,8,102,0,297,0,2781
"48291700800",6820,861,230,217,622,33,977,66,9826
"48291700900",1259,238,163,17,72,10,287,157,2203
"48291701000",3934,598,447,401,788,266,1671,654,8759
"48291701100",4346,863,263,26,127,0,177,217,6019
"48291701200",3592,479,117,774,575,9,844,99,6489
"48291701300",2458,251,57,59,27,6,27,15,2900
"48291701400",4723,407,1200,439,569,181,1079,335,8933
"48293970100",1282,392,45,76,28,22,237,214,2296
"48293970200",2503,692,683,176,61,23,177,342,4657
"48293970300",1096,429,558,89,78,90,280,438,3058
"48293970400",297,299,610,20,115,109,178,335,1963
"48293970500",1048,368,741,160,31,0,385,294,3027
"48293970600",3357,744,402,105,126,50,482,211,5477
"48293970700",1308,261,0,0,63,0,103,0,1735
"48293970800",2388,480,86,36,52,22,99,14,3177
"48295950200",1393,217,12,0,316,61,578,184,2761
"48295950300",1170,80,0,0,74,6,157,15,1502
"48297950100",2440,614,6,0,128,0,983,235,4406
"48297950200",1328,525,0,1,108,16,696,459,3133
"48297950300",2143,172,0,4,125,0,546,110,3100
"48297950400",1886,377,0,0,101,0,347,30,2741
"48299970100",2204,119,0,0,102,0,131,11,2567
"48299970200",2591,784,0,4,15,14,384,101,3893
"48299970300",1641,170,0,10,20,11,55,18,1925
"48299970400",3554,75,108,0,54,0,97,0,3888
"48299970500",4525,1088,125,0,71,213,241,569,6832
"48299970600",1241,189,48,0,3,0,18,11,1510
"48301950100",44,0,0,0,29,10,23,3,109
"48303000100",1225,333,215,32,767,16,1403,349,4340
"48303000201",949,261,38,45,377,65,631,222,2588
"48303000202",793,538,22,41,325,354,1016,837,3926
"48303000301",1096,982,8,31,623,706,943,545,4934
"48303000302",3319,974,154,169,1616,677,4195,1052,12156
"48303000402",3327,629,179,71,348,100,1179,258,6091
"48303000403",2894,426,83,4,238,19,596,147,4407
"48303000404",4387,951,513,39,1627,295,1647,442,9901
"48303000405",5464,2478,660,411,1494,288,2719,724,14238
"48303000500",616,232,0,0,26,50,115,62,1101
"48303000603",246,1913,12,151,116,133,50,227,2848
"48303000605",72,670,0,0,7,176,10,197,1132
"48303000607",764,683,252,221,160,127,263,137,2607
"48303000700",784,107,13,26,228,58,825,152,2193
"48303000900",659,569,1415,948,672,111,1250,499,6123
"48303001000",422,800,825,307,546,303,813,813,4829
"48303001200",278,116,1330,683,169,18,383,130,3107
"48303001300",1063,1122,10,46,760,539,1427,1488,6455
"48303001400",2504,2488,84,51,465,184,1331,1390,8497
"48303001501",1290,529,0,2,60,63,248,74,2266
"48303001502",1402,415,0,3,84,34,213,80,2231
"48303001601",1382,299,62,17,396,62,419,107,2744
"48303001602",1734,719,49,216,502,118,780,279,4397
"48303001702",3153,707,285,387,165,25,678,401,5801
"48303001705",5211,521,186,20,299,65,488,97,6887
"48303001706",2814,811,130,343,1009,169,1424,156,6856
"48303001707",3136,237,97,26,323,56,634,64,4573
"48303001708",870,1356,150,44,256,118,368,864,4026
"48303001709",2541,685,366,246,339,137,1000,550,5864
"48303001801",2917,1145,482,51,967,167,1466,353,7548
"48303001803",3283,637,404,44,845,328,1222,236,6999
"48303001804",3302,191,56,26,199,61,527,55,4417
"48303001901",3283,660,247,13,360,26,1215,210,6014
"48303001903",4519,138,336,112,208,30,543,47,5933
"48303001904",1309,73,16,0,57,6,147,16,1624
"48303002001",1617,249,53,2,115,40,554,121,2751
"48303002002",1789,431,128,108,154,120,971,222,3923
"48303002101",4307,972,148,0,355,243,1455,256,7736
"48303002102",2362,104,128,10,174,26,582,49,3435
"48303002202",3279,689,350,25,617,195,1845,706,7706
"48303002203",1907,489,144,79,299,40,567,447,3972
"48303002204",2469,1228,203,225,426,432,1595,1395,7973
"48303002300",3006,745,433,185,211,114,2225,732,7651
"48303002400",3475,1448,349,334,840,275,3386,1442,11549
"48303002500",1156,472,141,29,252,190,948,496,3684
"48303010101",1662,96,0,20,40,0,285,7,2110
"48303010102",2047,174,8,2,355,39,927,131,3683
"48303010200",5750,1090,230,76,559,185,2741,783,11414
"48303010301",3092,447,0,0,154,78,553,97,4421
"48303010302",2017,370,0,0,214,85,557,297,3540
"48303010402",1192,315,112,57,170,92,535,298,2771
"48303010403",4659,227,65,0,409,64,1127,45,6596
"48303010404",2437,43,16,44,256,28,719,23,3566
"48303010405",3066,335,0,23,509,31,921,85,4970
"48303010406",3602,414,0,2,551,0,520,69,5158
"48303010407",6112,112,106,0,734,0,860,0,7924
"48303010408",7365,342,129,0,737,446,1432,424,10875
"48303010502",2763,53,12,0,165,12,207,12,3224
"48303010504",3578,35,8,0,350,0,409,11,4391
"48303010505",3486,283,290,17,454,144,1114,127,5915
"48303010506",3164,389,121,0,414,69,877,131,5165
"48303010508",5672,572,81,64,379,77,1721,138,8704
"48303010509",2347,46,35,0,188,4,135,0,2755
"48303010510",2205,105,40,0,27,0,198,12,2587
"48303010511",2977,358,179,27,448,36,739,283,5047
"48303010600",3755,833,214,195,479,524,1694,1068,8762
"48303010700",3507,586,80,28,136,1,827,234,5399
"48303980000",0,0,0,0,0,0,0,0,0
"48305950400",1460,274,0,0,139,28,553,214,2668
"48305950500",1851,424,34,0,116,87,792,437,3741
"48305950600",883,347,14,0,112,7,481,224,2068
"48307950300",3889,655,44,18,283,395,1309,529,7122
"48307950400",1500,172,0,0,7,0,371,74,2124
"48307950500",1055,89,0,5,28,25,155,65,1422
"48309000100",736,637,37,85,208,26,421,183,2333
"48309000200",502,2055,0,289,160,107,109,429,3651
"48309000300",22,0,0,0,0,0,0,0,22
"48309000400",1530,2962,354,436,705,599,1150,1316,9052
"48309000598",2059,1515,228,146,1014,263,2745,1606,9576
"48309000700",1960,689,218,75,195,36,1232,328,4733
"48309000800",1354,450,292,100,254,94,862,433,3839
"48309000900",2456,955,590,291,486,254,1429,651,7112
"48309001000",1124,624,381,476,164,110,1012,542,4433
"48309001100",2739,750,966,531,329,329,2298,710,8652
"48309001200",734,555,803,718,236,135,872,453,4506
"48309001300",1368,132,266,233,258,50,1152,76,3535
"48309001400",1330,671,3025,2293,154,373,381,609,8836
"48309001500",219,184,981,636,12,168,134,240,2574
"48309001600",2594,1588,419,277,501,119,1151,1277,7926
"48309001700",2802,932,1091,338,347,43,921,680,7154
"48309001800",1033,31,239,12,155,5,226,21,1722
"48309001900",648,2118,623,497,179,222,459,321,5067
"48309002000",2987,326,7,0,33,0,341,169,3863
"48309002100",2243,669,556,781,266,383,1193,756,6847
"48309002302",1852,966,1163,926,191,182,708,536,6524
"48309002498",2703,541,482,286,192,0,1066,215,5485
"48309002501",2664,393,718,253,315,84,738,292,5457
"48309002503",4718,189,389,41,230,0,548,25,6140
"48309002504",2982,181,44,16,87,0,306,0,3616
"48309002600",4679,404,364,43,173,0,614,325,6602
"48309002700",2064,387,593,322,333,319,1455,561,6034
"48309002800",2623,522,188,98,185,11,228,86,3941
"48309002900",3425,81,17,2,326,4,383,0,4238
"48309003000",2463,516,299,275,129,68,577,259,4586
"48309003200",2687,796,908,480,357,55,821,504,6608
"48309003300",454,628,107,120,53,97,60,96,1615
"48309003400",5074,706,194,27,212,108,533,68,6922
"48309003500",3383,415,22,0,129,7,429,6,4391
"48309003601",1597,434,423,152,52,13,108,273,3052
"48309003602",1843,450,64,28,42,28,114,75,2644
"48309003701",2532,190,281,0,77,0,415,106,3601
"48309003703",4728,425,95,1,85,15,559,37,5945
"48309003706",7461,230,767,142,889,91,1330,0,10910
"48309003707",5940,478,819,2,804,351,1695,192,10281
"48309003708",5251,284,529,0,705,62,747,102,7680
"48309003801",6220,235,36,0,185,15,530,48,7269
"48309003802",4757,765,273,72,113,88,721,205,6994
"48309003900",6779,685,468,129,223,41,1330,531,10186
"48309004000",4332,296,18,31,100,14,250,17,5058
"48309004102",4860,662,12,8,97,28,292,156,6115
"48309004103",6781,609,206,40,367,14,1083,37,9137
"48309004201",3027,582,70,60,31,8,278,184,4240
"48309004202",2587,308,57,11,74,0,203,41,3281
"48309004300",2830,1803,622,122,499,369,1793,1744,9782
"48309980000",0,0,0,0,0,0,0,0,0
"48311950100",470,118,0,0,28,0,279,71,966
"48313000100",1139,92,93,20,0,28,5,33,1410
"48313000200",1107,412,9,11,54,19,87,134,1833
"48313000300",1825,545,8,0,21,11,41,39,2490
"48313000400",2635,731,582,672,206,42,702,448,6018
"48315950100",1676,110,171,333,30,0,110,0,2430
"48315950200",1727,530,662,213,7,64,0,126,3329
"48315950300",1841,608,198,30,37,15,75,0,2804
"48315950400",1057,113,469,362,29,9,32,0,2071
"48317950100",1070,180,0,0,205,16,333,76,1880
"48317950200",2608,392,14,71,210,111,1585,273,5264
"48319950100",1615,435,0,0,65,0,543,184,2842
"48319950200",1802,100,0,0,0,13,134,0,2049
"48321730100",1413,524,215,182,231,74,1041,582,4262
"48321730201",4677,1424,299,38,449,146,1993,877,9903
"48321730202",1314,29,118,0,0,0,412,0,1873
"48321730301",3257,498,32,15,167,10,1339,165,5483
"48321730302",2089,853,889,135,316,148,977,613,6020
"48321730303",394,83,56,138,82,0,140,0,893
"48321730400",1352,142,594,337,34,192,626,65,3342
"48321730501",2234,391,596,82,102,8,409,97,3919
"48321730600",3655,711,21,0,461,712,2030,986,8576
"48321730700",3334,691,25,46,63,0,1256,506,5921
"48321990000",0,0,0,0,0,0,0,0,0
"48323950201",3554,2239,0,0,482,402,3806,2283,12766
"48323950204",3064,1250,0,0,171,37,3139,1287,8948
"48323950205",6032,2329,0,0,102,233,6036,2562,17294
"48323950300",5749,1159,0,0,419,201,5589,1339,14456
"48323950400",2190,796,0,32,259,104,2382,878,6641
"48323950500",3153,2745,0,0,250,99,3201,2833,12281
"48323950601",1425,1083,5,0,269,29,1674,1079,5564
"48323950602",3896,1484,7,1,272,80,4128,1564,11432
"48323950700",5937,2137,11,0,400,73,5915,2111,16584
"48325000101",5528,899,0,0,310,57,2942,494,10230
"48325000102",6693,639,122,13,600,5,2166,516,10754
"48325000200",1587,195,0,0,27,33,411,135,2388
"48325000300",3944,1025,112,172,388,1,1592,1086,8320
"48325000401",4495,668,0,0,140,109,3099,763,9274
"48325000402",2827,965,0,19,199,115,1275,681,6081
"48325000500",3316,1251,14,0,318,0,2029,1105,8033
"48325000800",4596,1515,0,0,863,94,2656,1128,10852
"48327950300",1491,471,0,17,156,17,526,214,2892
"48329000100",2673,323,1606,304,357,267,2228,573,8331
"48329000200",3788,468,177,22,109,38,964,220,5786
"48329000302",4001,259,592,87,502,77,1085,221,6824
"48329000303",4106,154,0,1,89,0,610,54,5014
"48329000304",2985,145,169,15,566,111,632,43,4666
"48329000305",3758,109,537,0,188,90,334,12,5028
"48329000401",2746,327,44,1,411,0,1535,144,5208
"48329000402",3393,664,195,0,444,0,1429,382,6507
"48329000500",4155,658,43,104,207,157,1460,448,7232
"48329000600",2866,445,155,4,525,11,1117,296,5419
"48329001100",3773,910,106,43,740,55,2858,598,9083
"48329001200",5302,402,228,0,1236,15,4214,328,11725
"48329001300",4378,447,178,0,743,104,2801,191,8842
"48329001400",2617,769,217,14,486,280,2759,921,8063
"48329001500",2308,381,793,203,690,99,2736,476,7686
"48329001700",2060,674,573,384,385,212,2363,893,7544
"48329010104",5691,102,973,50,822,26,1793,53,9510
"48329010105",2500,658,139,39,397,0,665,449,4847
"48329010106",4332,787,138,12,317,0,1164,488,7238
"48329010107",3786,189,39,2,566,0,983,14,5579
"48329010108",2799,147,185,6,265,0,312,41,3755
"48329010109",6248,467,302,16,990,51,4859,249,13182
"48329010112",9789,581,50,0,533,0,1985,349,13287
"48329010113",9004,328,0,0,474,36,2289,165,12296
"48329010114",4936,572,31,0,362,85,1788,99,7873
"48329010200",1521,408,149,103,532,57,1936,428,5134
"48329980000",0,0,0,0,0,0,0,0,0
"48331950100",1701,475,34,104,39,51,317,146,2867
"48331950300",3000,498,101,50,156,90,645,269,4809
"48331950401",2224,277,237,23,189,254,711,337,4252
"48331950402",2089,168,212,458,193,44,822,37,4023
"48331950500",2261,311,204,68,62,1,196,44,3147
"48331950700",3533,1022,168,319,277,216,1163,534,7232
"48331950800",2501,134,82,52,183,2,520,20,3494
"48333950100",1506,210,0,2,7,1,153,58,1937
"48333950200",2498,399,0,0,80,5,457,123,3562
"48335950200",3614,451,175,0,481,64,1604,304,6693
"48335950400",1526,187,32,22,290,87,444,145,2733
"48337950100",2315,300,0,0,58,0,115,15,2803
"48337950200",1469,168,5,5,26,0,96,32,1801
"48337950300",1791,835,0,0,106,92,374,157,3355
"48337950400",4517,147,0,11,122,95,312,100,5304
"48337950500",4125,1028,0,2,121,132,283,337,6028
"48337950600",1671,224,0,0,56,0,67,19,2037
"48339690100",7833,1383,18,0,342,712,1115,1320,12723
"48339690201",8804,641,88,0,353,50,871,56,10863
"48339690202",5297,1030,87,0,287,12,631,606,7950
"48339690300",3181,944,128,12,283,0,867,538,5953
"48339690401",4594,548,294,0,730,156,563,134,7019
"48339690402",12597,1232,223,3,1549,1006,2556,1518,20684
"48339690500",7450,84,13,0,270,42,327,54,8240
"48339690601",18475,750,49,148,1928,2,2277,164,23793
"48339690602",15687,832,300,0,2379,31,3702,444,23375
"48339690700",8005,346,407,29,574,16,906,16,10299
"48339690800",3706,79,0,0,292,0,197,32,4306
"48339690900",4286,66,20,15,298,13,351,0,5049
"48339691000",4106,76,55,0,252,0,271,0,4760
"48339691100",4364,128,0,0,189,0,520,25,5226
"48339691200",6317,316,217,19,640,22,704,113,8348
"48339691301",3988,106,128,0,519,40,571,7,5359
"48339691302",3807,474,177,349,367,57,842,121,6194
"48339691400",6560,736,714,0,1205,51,1331,18,10615
"48339691500",2957,391,54,209,465,22,616,285,4999
"48339691601",3117,189,0,0,515,97,634,105,4657
"48339691602",4251,441,62,188,360,78,1247,363,6990
"48339691700",1406,86,72,1,184,0,293,3,2045
"48339691800",6459,338,421,14,578,226,1238,249,9523
"48339691900",4889,430,279,0,216,318,1046,259,7437
"48339692001",23604,1262,2267,15,2253,283,4702,481,34867
"48339692002",5705,69,529,35,777,0,1311,18,8444
"48339692100",8748,685,406,28,867,258,1906,390,13288
"48339692200",6380,1043,109,1,815,137,1943,425,10853
"48339692300",11359,1691,578,65,1618,226,3759,1208,20504
"48339692400",5839,1265,242,54,649,563,1040,680,10332
"48339692500",6511,1366,34,128,643,45,1936,559,11222
"48339692601",2723,815,12,41,106,28,820,310,4855
"48339692602",6132,2076,120,0,760,520,1321,1250,12179
"48339692700",5553,823,211,0,197,314,952,345,8395
"48339692801",7227,1098,42,0,192,243,1003,461,10266
"48339692802",3236,353,136,6,320,280,1039,483,5853
"48339692900",3225,880,18,66,122,30,588,225,5154
"48339693000",6580,2286,357,0,837,203,2840,1620,14723
"48339693101",2411,1659,963,454,365,25,1737,1557,9171
"48339693102",3343,839,277,75,185,76,2197,604,7596
"48339693200",6625,545,394,58,413,18,696,242,8991
"48339693300",4871,596,510,290,398,13,1261,104,8043
"48339693400",1962,1405,474,486,48,280,1469,1289,7413
"48339693500",4176,1160,212,185,82,55,882,573,7325
"48339693600",2466,449,241,76,194,20,396,346,4188
"48339693700",6487,764,217,69,293,8,740,509,9087
"48339693800",2051,560,562,107,480,128,983,456,5327
"48339693900",5973,3237,187,33,308,14,3568,2808,16128
"48339694000",7158,1179,83,0,337,516,1287,793,11353
"48339694101",6832,1301,1022,227,675,654,1917,1300,13928
"48339694102",4236,661,174,1,228,24,1116,322,6762
"48339694201",4383,650,100,349,214,222,498,488,6904
"48339694202",9064,404,211,4,554,11,860,32,11140
"48339694301",10502,690,103,0,409,7,1040,0,12751
"48339694302",7313,210,18,0,260,0,661,0,8462
"48339694400",5686,686,268,1,429,147,812,288,8317
"48339694500",5399,346,52,0,410,7,385,16,6615
"48339694600",4697,391,467,232,536,131,674,278,7406
"48339694700",2298,612,237,49,75,0,121,143,3535
"48341950100",1881,253,3,0,267,40,717,177,3338
"48341950200",3971,677,164,0,1267,241,2523,597,9440
"48341950300",5426,1154,75,24,769,181,2925,1153,11707
"48341950400",3544,556,68,74,1030,163,2990,466,8891
"48343950100",2956,462,614,271,154,23,185,20,4685
"48343950200",3288,450,787,592,408,265,274,276,6340
"48343950300",1357,236,377,289,99,17,199,43,2617
"48345950100",831,283,7,3,38,14,138,51,1365
"48347950100",1824,163,125,65,78,61,76,103,2495
"48347950200",3979,400,43,25,148,109,188,156,5048
"48347950301",4825,1476,107,232,65,107,719,1075,8606
"48347950302",4263,1703,600,213,563,64,1718,1579,10703
"48347950400",5762,900,759,135,402,0,369,198,8525
"48347950501",1277,293,197,484,72,12,80,6,2421
"48347950502",3429,542,315,241,67,0,430,0,5024
"48347950600",925,712,449,170,28,111,31,57,2483
"48347950700",1384,995,824,680,113,94,733,616,5439
"48347950800",1894,643,602,314,256,118,1184,480,5491
"48347950900",219,349,987,1016,42,71,62,258,3004
"48347951000",2304,902,487,425,264,260,295,260,5197
"48347951100",3953,939,228,95,55,55,208,138,5671
"48349970100",2304,770,29,24,470,250,571,654,5072
"48349970200",2968,164,871,819,450,37,753,93,6155
"48349970300",5069,1054,649,286,535,5,1228,695,9521
"48349970400",3212,772,115,0,127,53,375,309,4963
"48349970500",3076,572,240,314,149,59,712,308,5430
"48349970600",2106,341,767,175,102,20,192,47,3750
"48349970700",3572,384,896,495,115,114,388,84,6048
"48349970800",614,421,167,27,119,42,426,367,2183
"48349970900",4287,1666,506,115,903,274,2573,1095,11419
"48349971000",2197,541,156,55,74,23,287,117,3450
"48351950100",1666,204,804,167,47,0,9,0,2897
"48351950200",2799,619,1021,404,50,10,48,22,4973
"48351950300",1414,234,486,57,30,0,36,23,2280
"48351950400",3201,521,0,0,163,22,201,0,4108
"48353950100",1577,123,0,0,76,58,225,114,2173
"48353950200",3142,530,114,0,147,75,723,273,5004
"48353950300",918,566,165,26,103,29,243,326,2376
"48353950400",2590,764,116,112,743,80,1987,488,6880
"48353950500",2002,312,0,0,206,18,552,204,3294
"48355000500",366,325,302,243,46,84,405,340,2111
"48355000600",4345,1288,216,292,832,200,4627,1411,13211
"48355000700",3009,1070,104,53,466,370,2735,1276,9083
"48355000800",1979,960,0,90,326,59,1897,716,6027
"48355000900",1702,1609,0,21,506,75,2157,1660,7730
"48355001000",1395,909,14,73,264,462,1601,1247,5965
"48355001100",779,674,92,192,26,27,769,676,3235
"48355001200",1773,1144,62,150,278,151,1381,983,5922
"48355001300",2828,750,63,0,329,533,3185,1231,8919
"48355001400",3882,369,0,0,332,270,1450,372,6675
"48355001500",2172,1585,33,139,230,220,2312,1700,8391
"48355001601",2435,745,209,91,480,54,2857,730,7601
"48355001602",2412,445,26,0,280,269,2609,701,6742
"48355001701",4069,1086,574,211,564,23,4460,1069,12056
"48355001702",1376,234,38,0,209,87,1461,269,3674
"48355001801",3391,1432,136,266,440,243,3684,1642,11234
"48355001802",1748,264,92,0,296,18,1968,250,4636
"48355001902",5348,2083,322,0,656,79,5181,1933,15602
"48355001903",2323,673,81,49,566,0,2672,621,6985
"48355001904",2520,1040,0,0,684,134,3004,1093,8475
"48355002001",2638,971,14,20,288,0,2507,848,7286
"48355002002",3120,471,0,0,225,248,3065,538,7667
"48355002101",2336,711,139,129,271,70,1598,633,5887
"48355002102",2880,237,0,0,122,21,902,171,4333
"48355002200",3384,1068,12,0,754,0,3305,837,9360
"48355002301",2985,531,46,0,183,82,2600,512,6939
"48355002303",3281,810,350,8,273,136,2875,775,8508
"48355002304",3986,1019,275,117,377,35,3292,993,10094
"48355002400",5376,467,109,0,417,31,3861,419,10680
"48355002500",3795,919,0,0,63,136,1466,695,7074
"48355002601",1439,702,0,29,209,11,509,556,3455
"48355002602",1343,559,15,0,71,8,869,364,3229
"48355002603",2571,669,35,0,160,1,1348,415,5199
"48355002703",4020,508,90,35,317,283,2173,424,7850
"48355002704",3978,909,266,56,238,175,1475,776,7873
"48355002705",4322,294,96,241,472,185,1771,306,7687
"48355002706",0,0,0,0,0,0,0,0,0
"48355002900",714,20,236,0,37,24,114,27,1172
"48355003001",3222,913,157,80,214,156,1198,617,6557
"48355003002",3475,737,25,154,751,161,1439,207,6949
"48355003101",4161,1063,189,60,1096,218,941,531,8259
"48355003102",3655,924,48,171,361,117,1391,481,7148
"48355003202",4746,247,194,26,487,45,3019,104,8868
"48355003203",4425,683,231,0,362,0,2996,531,9228
"48355003204",3645,130,140,0,654,40,2507,95,7211
"48355003303",1183,270,22,7,115,0,955,212,2764
"48355003304",4108,612,345,27,544,78,2649,528,8891
"48355003305",2469,1620,167,124,185,347,1759,1771,8442
"48355003306",2914,766,96,21,390,107,1865,683,6842
"48355003401",2798,322,265,94,260,135,2087,354,6315
"48355003402",4099,1056,121,35,367,0,2600,944,9222
"48355003500",1868,212,29,13,175,77,1485,255,4114
"48355003601",4498,695,130,2,491,3,2352,530,8701
"48355003602",4972,911,192,25,603,2,2822,520,10047
"48355003603",2501,331,56,156,283,15,1571,284,5197
"48355003700",2771,417,6,0,246,53,1794,298,5585
"48355005102",2798,399,0,0,39,0,263,19,3518
"48355005404",1971,12,181,0,283,0,905,0,3352
"48355005406",2299,276,65,0,154,40,1245,173,4252
"48355005407",1716,17,19,0,340,28,1412,33,3565
"48355005408",3343,181,119,39,68,0,2502,105,6357
"48355005409",3062,111,128,0,356,123,1806,50,5636
"48355005410",3001,164,491,1,191,1,1980,157,5986
"48355005411",2898,286,202,61,382,42,1694,163,5728
"48355005412",3572,198,619,0,634,0,2022,9,7054
"48355005413",2234,141,112,0,359,0,1497,40,4383
"48355005414",1694,4,59,66,237,0,913,4,2977
"48355005415",3280,132,235,0,895,37,2289,72,6940
"48355005416",2995,0,190,0,470,0,1165,0,4820
"48355005417",3081,5,339,41,808,122,1838,97,6331
"48355005601",4280,1585,42,11,327,124,4323,1594,12286
"48355005602",3559,2426,13,0,364,136,3743,2438,12679
"48355005801",5762,270,0,1,76,68,1405,219,7801
"48355005802",4715,825,39,0,280,0,2655,599,9113
"48355005900",2203,530,0,0,324,28,1979,495,5559
"48355006000",2297,222,0,0,274,15,2004,161,4973
"48355006100",2690,378,0,0,221,55,1950,399,5693
"48355006200",8679,335,83,0,721,24,1473,35,11350
"48355006300",1608,797,35,21,94,24,700,475,3754
"48355006400",857,338,238,140,41,109,447,258,2428
"48355980000",21,0,0,0,0,0,15,0,36
"48355990000",0,0,0,0,0,0,0,0,0
"48357950100",1044,80,16,0,399,8,456,0,2003
"48357950300",2413,852,43,26,445,111,1541,843,6274
"48357950400",3516,465,0,1,723,259,1938,403,7305
"48359950100",1532,241,4,11,71,15,138,71,2083
"48361020200",913,131,1536,589,170,11,0,38,3388
"48361020300",1485,422,123,138,94,40,38,44,2384
"48361020500",2344,492,229,12,59,47,249,145,3577
"48361020700",2923,503,653,319,195,120,157,79,4949
"48361020800",1143,195,325,35,14,54,96,2,1864
"48361020900",1408,300,1181,460,99,0,263,36,3747
"48361021000",1853,145,21,1,145,2,70,2,2239
"48361021100",1803,38,0,0,58,0,54,0,1953
"48361021200",4180,559,21,0,136,0,208,84,5188
"48361021300",4472,628,643,282,141,94,185,36,6481
"48361021400",3358,517,28,0,131,0,87,114,4235
"48361021501",2026,167,0,0,98,77,211,16,2595
"48361021502",6206,923,0,19,165,0,318,135,7766
"48361021600",3097,505,0,2,48,15,300,2,3969
"48361021700",1942,497,0,0,36,3,182,41,2701
"48361021800",2098,357,0,0,20,0,149,14,2638
"48361021900",5231,608,0,0,161,12,268,12,6292
"48361022000",3236,558,3,0,40,15,176,3,4031
"48361022200",2891,456,0,0,130,0,111,0,3588
"48361022300",5912,438,98,8,413,195,335,122,7521
"48361022400",3777,602,0,0,99,149,389,242,5258
"48363000100",2143,380,4,0,122,44,231,61,2985
"48363000200",1552,209,0,35,40,75,169,77,2157
"48363000300",3218,205,0,0,18,0,186,74,3701
"48363000400",5163,637,110,63,127,22,356,40,6518
"48363000500",1077,247,5,1,116,62,131,133,1772
"48363000600",1945,679,47,17,300,239,549,260,4036
"48363000700",2293,521,122,30,327,61,858,248,4460
"48363000800",1766,631,53,41,434,65,1022,170,4182
"48363000900",1180,593,73,41,265,206,302,223,2883
"48365950100",2575,430,649,127,42,0,48,0,3871
"48365950200",2057,395,360,68,52,8,78,192,3210
"48365950300",3471,329,624,131,657,29,1115,24,6380
"48365950400",4146,241,1075,654,194,0,366,15,6691
"48365950500",2366,226,181,33,17,0,5,5,2833
"48365950600",1713,265,116,19,22,0,48,0,2183
"48367140101",3575,530,43,125,328,442,1003,219,6265
"48367140102",3087,762,0,44,42,36,142,221,4334
"48367140200",5206,675,0,19,186,0,440,139,6665
"48367140300",4824,363,194,18,135,20,1027,205,6786
"48367140403",5299,537,90,0,202,29,298,81,6536
"48367140405",5085,668,15,2,307,24,553,65,6719
"48367140407",8970,658,39,0,122,86,458,136,10469
"48367140408",3201,382,18,17,137,45,273,40,4113
"48367140409",2553,906,0,0,109,0,360,466,4394
"48367140410",2517,462,0,0,713,18,813,55,4578
"48367140411",3724,419,42,50,115,0,57,125,4532
"48367140501",6505,246,178,0,75,91,363,127,7585
"48367140502",3784,632,0,2,146,10,99,80,4753
"48367140601",5959,440,323,0,262,28,353,224,7589
"48367140602",7904,1231,0,0,381,61,1070,47,10694
"48367140703",5679,498,0,0,305,8,210,254,6954
"48367140704",6633,463,36,0,272,41,402,99,7946
"48367140705",6415,1298,37,0,294,4,487,813,9348
"48367140706",6125,155,60,0,108,8,306,0,6762
"48369950200",3274,1118,0,0,185,92,2140,1131,7940
"48369950300",4046,830,75,48,289,48,2124,711,8171
"48371950100",1753,176,169,0,217,1,1146,134,3596
"48371950300",2192,716,0,0,190,35,2210,721,6064
"48371950400",3502,486,0,0,209,86,2600,432,7315
"48371950500",2692,594,4,0,98,117,1715,655,5875
"48373210101",3345,808,27,36,118,0,196,39,4569
"48373210102",4998,838,116,176,339,50,409,53,6979
"48373210203",1741,744,100,27,62,7,431,271,3383
"48373210204",2415,702,1057,43,55,288,284,564,5408
"48373210205",2180,457,21,68,47,0,65,56,2894
"48373210206",2861,501,7,62,61,54,41,53,3640
"48373210301",2453,863,44,2,36,0,66,0,3464
"48373210302",2742,413,799,185,46,138,234,126,4683
"48373210400",2685,810,677,287,316,27,981,302,6085
"48373210500",2822,339,222,131,470,249,363,125,4721
"48375010100",1353,409,39,26,117,2,251,19,2216
"48375010200",1703,37,0,0,60,0,92,0,1892
"48375010300",502,341,60,180,12,51,274,237,1657
"48375010400",2976,230,0,0,79,0,417,55,3757
"48375010600",1048,730,40,102,204,198,996,906,4224
"48375010700",2399,365,115,0,523,15,1763,203,5383
"48375011000",1229,575,14,35,55,148,887,557,3500
"48375011500",2841,529,21,11,289,22,601,217,4531
"48375011600",2569,616,177,56,745,347,822,482,5814
"48375011700",2719,404,326,324,270,133,611,441,5228
"48375011800",3140,299,37,69,229,60,608,42,4484
"48375011900",1949,724,305,126,255,140,716,391,4606
"48375012000",684,580,121,168,177,88,266,417,2501
"48375012200",2761,1027,246,23,144,158,2146,935,7440
"48375012600",1533,1248,263,34,491,160,1483,1044,6256
"48375012800",2421,750,526,408,451,115,2131,655,7457
"48375013000",228,137,596,583,32,29,146,116,1867
"48375013200",1319,41,102,0,9,31,87,42,1631
"48375013300",4129,249,55,0,622,54,356,40,5505
"48375013400",3153,474,0,0,68,0,369,12,4076
"48375013900",1068,297,864,595,219,175,686,359,4263
"48375014100",1650,651,84,0,208,42,805,429,3869
"48375014300",5241,398,77,0,367,64,302,65,6514
"48375014401",1582,262,113,15,122,0,480,32,2606
"48375014500",3553,1693,86,75,478,136,2501,1654,10176
"48375014700",3627,816,13,31,297,42,879,475,6180
"48375014800",508,387,851,298,112,81,406,431,3074
"48375014900",1840,448,548,198,2551,492,1407,364,7848
"48375015000",3815,1838,351,446,596,247,2797,1660,11750
"48375015100",2631,385,11,0,202,58,600,97,3984
"48375015200",2274,144,53,40,77,10,352,10,2960
"48375015300",2550,1338,366,386,325,152,960,861,6938
"48375015400",1167,709,79,174,379,111,1255,582,4456
"48375980000",0,0,0,0,0,0,0,0,0
"48377950100",2141,411,18,0,114,10,1518,192,4404
"48377950200",2993,1446,0,0,401,1,3040,1447,9328
"48379950100",5231,574,121,0,292,84,444,94,6840
"48379950200",3418,608,144,24,182,188,110,224,4898
"48381020100",1917,78,37,16,113,11,178,11,2361
"48381020200",1575,253,0,9,142,94,202,6,2281
"48381020300",1680,228,10,14,34,0,315,81,2362
"48381020400",1499,151,24,7,55,6,133,94,1969
"48381020500",2607,566,120,19,406,102,876,330,5026
"48381020600",3349,425,19,26,392,50,1718,179,6158
"48381020800",4716,976,480,0,568,279,1194,389,8602
"48381020900",2228,275,37,27,244,51,498,75,3435
"48381021000",2026,88,40,4,163,9,452,30,2812
"48381021101",3214,244,133,73,218,27,489,164,4562
"48381021102",1400,507,44,103,51,39,361,305,2810
"48381021200",4588,258,0,147,164,119,473,191,5940
"48381021300",4214,206,238,27,275,9,756,14,5739
"48381021500",4138,151,90,0,70,4,359,19,4831
"48381021602",4397,165,45,0,364,14,497,0,5482
"48381021603",1650,50,65,0,115,0,238,2,2120
"48381021604",4282,230,0,0,106,2,728,1,5349
"48381021605",1811,106,25,2,81,23,212,48,2308
"48381021606",4394,114,51,14,322,18,523,0,5436
"48381021608",6132,328,56,3,241,25,689,68,7542
"48381021609",2735,48,44,0,434,0,572,31,3864
"48381021702",2827,419,32,0,200,64,391,66,3999
"48381021703",4980,1007,44,5,484,58,735,117,7430
"48381021704",6860,264,48,3,132,0,448,0,7755
"48381021801",4912,891,42,1,419,179,1037,227,7708
"48381021802",2392,930,30,113,444,266,480,180,4835
"48381021900",4036,303,0,0,40,0,402,38,4819
"48381022001",4208,177,210,0,240,0,818,69,5722
"48381022002",4438,633,82,87,536,227,1447,488,7938
"48383950100",2536,229,83,7,441,85,1880,298,5559
"48385950100",2565,640,0,2,38,17,397,166,3825
"48387950100",2133,247,151,44,106,14,121,39,2855
"48387950500",2238,393,1300,299,25,69,243,261,4828
"48387950600",1987,445,25,37,78,3,64,0,2639
"48387950700",2082,343,156,81,169,25,120,0,2976
"48389950100",898,417,0,53,273,104,797,400,2942
"48389950200",1613,446,66,75,155,79,1645,525,4604
"48389950300",1349,463,106,71,0,60,1036,523,3608
"48389950400",3083,400,75,0,225,102,2095,457,6437
"48389950500",1298,237,0,60,23,3,815,258,2694
"48391950200",2368,517,210,90,116,50,1321,384,5056
"48391950400",2912,402,72,11,232,70,1431,292,5422
"48393950100",983,31,0,0,13,0,23,0,1050
"48395960100",1416,163,204,141,41,0,47,14,2026
"48395960200",468,156,475,379,82,14,136,59,1769
"48395960300",3436,652,157,29,149,10,322,0,4755
"48395960400",2234,332,156,6,80,0,428,117,3353
"48395960500",2658,597,1133,783,268,120,1490,431,7480
"48397040101",5221,198,323,67,633,100,641,50,7233
"48397040102",6379,81,295,0,566,0,974,55,8350
"48397040200",3938,81,19,15,435,31,535,0,5054
"48397040301",3558,138,475,87,672,0,760,21,5711
"48397040302",5964,162,240,34,563,0,584,29,7576
"48397040401",6545,925,531,307,795,151,1516,340,11110
"48397040402",7499,573,540,0,982,42,1731,140,11507
"48397040503",5443,674,343,21,445,0,2489,505,9920
"48397040504",6005,117,18,0,25,19,718,0,6902
"48397040505",9159,286,770,165,301,157,1753,33,12624
"48397040506",6526,228,0,34,224,7,191,0,7210
"48399950100",944,67,0,0,78,5,150,17,1261
"48399950200",1659,479,19,0,56,28,833,276,3350
"48399950500",1726,349,0,0,37,5,467,197,2781
"48399950600",3067,1104,0,125,350,68,993,443,6150
"48401950100",4219,262,796,68,46,0,813,52,6256
"48401950200",2448,192,561,110,44,103,68,0,3526
"48401950300",5176,546,635,201,135,53,761,54,7561
"48401950400",3575,834,344,181,103,18,594,174,5823
"48401950501",3366,1188,103,487,0,8,555,620,6327
"48401950502",1737,488,68,21,68,36,61,70,2549
"48401950600",1881,192,72,9,94,0,53,0,2301
"48401950700",1556,178,841,355,61,25,268,20,3304
"48401950800",1939,315,637,211,193,37,543,131,4006
"48401950900",1916,543,409,166,84,55,353,308,3834
"48401951000",1911,555,228,21,62,6,573,294,3650
"48401951100",2013,440,392,83,44,94,138,235,3439
"48401951200",1415,232,568,323,71,8,85,16,2718
"48403950100",1750,529,33,94,19,0,19,0,2444
"48403950200",2141,678,87,123,32,0,184,28,3273
"48403950300",3500,897,183,366,35,21,108,13,5123
"48405950100",1836,256,460,287,42,0,0,0,2881
"48405950200",1210,349,641,523,88,0,162,102,3075
"48405950300",2048,766,0,60,0,24,144,111,3153
"48407200101",4331,1406,428,193,114,100,432,26,7030
"48407200102",7338,1884,618,225,153,96,1107,877,12298
"48407200200",3343,686,682,206,0,0,166,73,5156
"48407200300",3660,250,471,242,46,34,219,34,4956
"48409010201",2808,653,0,34,94,144,833,556,5122
"48409010202",3507,931,8,143,240,14,1153,448,6444
"48409010301",3515,499,51,0,127,13,1458,266,5929
"48409010302",3559,682,46,0,271,0,1662,301,6521
"48409010500",1288,534,5,5,104,2,1277,509,3724
"48409010601",4573,820,36,79,260,24,1957,771,8520
"48409010602",2893,508,48,125,53,29,1431,400,5487
"48409010603",2003,168,25,0,293,0,538,71,3098
"48409010604",2716,37,10,42,321,0,579,21,3726
"48409010700",2913,434,60,1,143,10,1242,334,5137
"48409010800",3253,1070,6,0,239,129,2717,1164,8578
"48409010900",3888,505,0,0,156,65,2126,439,7179
"48409011000",5101,752,316,22,414,88,4334,799,11826
"48409011100",2004,431,1,0,38,1,1434,397,4306
"48409011200",2489,388,9,0,23,0,1174,200,4283
"48409011300",3069,1396,114,32,304,93,3192,1434,9634
"48411950100",2132,472,0,0,131,45,978,252,4010
"48411950200",2332,296,17,6,28,12,256,19,2966
"48413950300",2145,703,3,1,393,45,1212,346,4848
"48415950100",2279,589,51,0,385,140,1505,579,5528
"48415950200",1041,69,0,1,37,12,325,28,1513
"48415950300",4812,657,261,60,187,148,986,314,7425
"48415950600",3026,458,23,16,684,240,1503,504,6454
"48417950300",2561,502,40,0,180,31,174,163,3651
"48419950100",3448,601,381,417,68,4,425,278,5622
"48419950200",2412,492,501,241,71,71,228,145,4161
"48419950300",3361,1212,181,13,34,86,651,581,6119
"48419950400",2498,718,1142,719,499,21,1125,522,7244
"48419950500",2510,296,44,0,23,59,233,41,3206
"48419950600",2029,423,423,173,30,21,48,0,3147
"48421950200",2408,380,0,0,184,30,870,352,4224
"48423000100",1814,928,1586,1057,251,84,1455,711,7886
"48423000201",457,360,1736,1070,82,0,428,174,4307
"48423000202",353,123,551,362,406,62,746,163,2766
"48423000300",3691,737,697,140,256,231,3310,866,9928
"48423000400",709,430,795,325,192,25,869,380,3725
"48423000500",693,544,385,278,86,52,484,493,3015
"48423000600",1150,381,208,196,132,53,1036,378,3534
"48423000700",713,703,1318,1218,79,0,396,583,5010
"48423000800",3413,812,1083,229,296,58,1762,497,8150
"48423000900",2384,351,315,302,192,52,1457,156,5209
"48423001000",3684,283,667,348,267,0,1031,128,6408
"48423001101",2878,297,295,52,154,4,413,10,4103
"48423001102",2286,138,54,24,107,0,221,32,2862
"48423001200",2548,80,316,0,434,0,537,0,3915
"48423001300",1370,392,208,0,179,0,136,120,2405
"48423001401",7786,356,241,72,98,0,287,0,8840
"48423001403",5470,879,391,50,222,9,397,1,7419
"48423001404",3836,675,110,257,283,151,101,130,5543
"48423001500",3168,848,397,344,309,5,137,246,5454
"48423001601",2946,937,1462,435,326,24,1013,652,7795
"48423001602",2758,384,874,237,114,44,461,18,4890
"48423001604",3266,1024,1350,469,98,58,1346,617,8228
"48423001700",4540,1194,1076,314,867,131,2643,1229,11994
"48423001801",2938,648,2043,298,207,17,924,264,7339
"48423001802",6183,1776,392,454,409,132,1622,1045,12013
"48423001803",3549,445,155,362,342,227,400,0,5480
"48423001901",4009,586,281,256,263,98,279,99,5871
"48423001905",6319,567,1096,68,451,84,238,75,8898
"48423001906",4978,158,522,97,168,19,199,19,6160
"48423001907",5185,649,253,0,31,131,372,103,6724
"48423001908",7663,287,758,239,305,27,459,9,9747
"48423002003",1909,509,840,277,254,76,288,125,4278
"48423002004",2067,201,75,148,14,0,130,61,2696
"48423002006",2811,53,209,55,66,8,107,8,3317
"48423002007",4903,804,681,254,444,312,402,122,7922
"48423002008",4644,430,389,21,246,22,266,0,6018
"48423002009",6645,415,314,0,47,27,505,0,7953
"48423002101",2111,559,915,263,71,0,74,93,4086
"48423002102",4636,594,94,69,223,0,231,33,5880
"48423002200",5365,135,768,121,95,0,114,0,6598
"48423980000",0,0,0,0,0,0,0,0,0
"48425000100",5520,457,97,14,338,149,896,210,7681
"48425000200",1364,116,0,0,192,38,471,8,2189
"48427950101",787,253,0,4,39,12,797,269,2161
"48427950104",2755,1181,0,8,185,0,2929,1163,8221
"48427950105",2656,891,1,0,146,0,2768,877,7339
"48427950106",2053,1339,0,0,130,0,2178,1289,6989
"48427950107",1659,2714,0,0,136,184,1795,2898,9386
"48427950108",1960,1206,0,0,228,0,1945,1176,6515
"48427950202",1471,766,0,0,119,21,1522,779,4678
"48427950203",1565,1702,0,0,263,38,1817,1740,7125
"48427950204",2073,2932,0,5,194,99,2224,2982,10509
"48427950401",3775,2884,0,1,112,3,3825,2887,13487
"48427950402",2918,1332,0,0,245,254,3163,1586,9498
"48427950500",2785,1017,0,2,123,69,2877,1084,7957
"48427950600",4425,1658,0,0,260,24,4600,1682,12649
"48427950701",2015,1844,0,0,12,89,2010,1933,7903
"48427950702",1844,1171,0,9,29,114,1812,1285,6264
"48429950200",2810,471,61,0,457,285,885,381,5350
"48429950300",1324,759,49,35,48,12,145,352,2724
"48429950500",2298,85,0,0,48,0,56,5,2492
"48431950100",1096,189,0,0,20,10,391,33,1739
"48433950300",1065,93,0,49,28,76,123,89,1523
"48435950300",3378,284,54,1,290,7,2101,239,6354
"48437950200",1231,305,5,2,54,7,267,221,2092
"48437950300",2772,998,175,70,190,142,1085,858,6290
"48437950400",897,85,70,0,104,47,386,68,1657
"48439100101",2871,1014,37,0,2224,285,3547,1123,11101
"48439100102",2556,662,20,28,784,406,1956,859,7271
"48439100201",1799,1402,239,4,1152,395,2707,1774,9472
"48439100202",2343,656,19,0,1500,399,3445,959,9321
"48439100300",1511,1334,312,168,799,616,2232,1849,8821
"48439100400",3106,728,35,18,2827,1354,5528,1986,15582
"48439100501",4557,1083,835,289,2531,766,5642,1301,17004
"48439100502",2444,2285,89,1,2030,749,3492,2602,13692
"48439100601",1631,247,7,15,96,10,96,22,2124
"48439100602",1205,278,88,3,343,9,732,187,2845
"48439100700",2874,1145,56,33,182,357,1718,999,7364
"48439100800",2587,593,18,43,1951,857,4106,1396,11551
"48439100900",536,303,0,1,987,305,1466,593,4191
"48439101201",854,289,7,62,347,53,575,135,2322
"48439101202",2025,840,128,24,1015,289,2197,1003,7521
"48439101301",2473,340,1150,171,375,153,1291,172,6125
"48439101302",1053,281,680,351,300,305,499,495,3964
"48439101401",2627,164,904,255,366,639,1080,398,6433
"48439101402",1148,629,190,356,662,645,1375,1214,6219
"48439101403",1041,646,841,344,430,630,683,1104,5719
"48439101500",2399,430,507,1,721,377,1860,326,6621
"48439101700",207,587,177,1323,120,458,237,468,3577
"48439102000",1121,160,0,0,188,150,378,218,2215
"48439102100",3524,461,79,180,309,146,731,99,5529
"48439102201",2835,133,91,0,288,67,682,7,4103
"48439102202",2022,253,40,15,122,7,125,0,2584
"48439102301",1329,449,165,272,293,94,784,311,3697
"48439102302",3021,1046,49,245,507,305,1544,800,7517
"48439102401",2468,501,459,193,385,5,455,187,4653
"48439102402",3657,121,103,0,334,0,397,10,4622
"48439102500",249,299,1301,1009,204,262,310,441,4075
"48439102601",1767,281,324,112,758,155,1342,162,4901
"48439102602",2164,585,55,0,733,145,1318,494,5494
"48439102700",2854,182,25,0,210,12,437,30,3750
"48439102800",1355,10,18,4,34,0,165,0,1586
"48439103500",1252,940,471,383,1075,516,2043,1346,8026
"48439103601",102,138,457,1281,294,224,370,241,3107
"48439103602",278,71,1125,488,240,136,375,190,2903
"48439103701",1575,1338,542,367,299,71,1775,1368,7335
"48439103702",548,513,825,612,425,62,975,468,4428
"48439103800",286,315,861,1323,156,179,462,440,4022
"48439104100",2244,446,66,16,342,22,974,293,4403
"48439104201",2225,267,0,0,54,0,100,0,2646
"48439104202",2341,590,0,134,209,113,336,171,3894
"48439104300",3525,1222,104,0,324,499,715,386,6775
"48439104400",3031,1052,60,375,642,337,1851,1094,8442
"48439104502",1102,353,232,36,739,511,1684,837,5494
"48439104503",1249,372,5,0,512,429,1729,801,5097
"48439104504",1642,696,189,45,471,97,1923,725,5788
"48439104505",638,488,1416,1088,391,195,690,682,5588
"48439104601",950,639,1169,502,523,24,1453,663,5923
"48439104602",1717,1217,803,798,460,625,2078,1750,9448
"48439104603",1528,763,254,383,321,325,1550,986,6110
"48439104604",596,112,857,807,311,161,822,231,3897
"48439104605",370,789,1717,632,326,183,535,699,5251
"48439104701",2302,1274,15,0,815,516,3000,1701,9623
"48439104702",1675,1234,34,30,523,81,1966,1190,6733
"48439104802",2780,1503,104,157,265,366,2037,1646,8858
"48439104803",3495,1431,209,15,691,773,3413,1896,11923
"48439104804",1020,1034,11,0,559,525,1119,1182,5450
"48439104900",1193,421,56,13,1068,57,1544,374,4726
"48439105001",2259,1470,57,0,1019,799,2853,2183,10640
"48439105006",324,246,21,0,112,31,339,115,1188
"48439105007",3512,101,649,48,475,58,849,51,5743
"48439105008",5016,391,1247,40,1348,25,1601,259,9927
"48439105201",2319,1128,440,646,481,297,1416,1102,7829
"48439105203",1627,154,114,11,92,10,343,10,2361
"48439105204",1716,578,131,162,260,109,623,350,3929
"48439105205",1774,703,929,559,393,107,388,94,4947
"48439105403",4633,440,143,98,232,186,744,35,6511
"48439105404",3449,427,9,28,161,0,244,0,4318
"48439105405",2362,494,499,85,249,14,299,132,4134
"48439105406",4591,235,476,20,139,176,411,27,6075
"48439105502",4767,336,194,547,109,29,1167,280,7429
"48439105503",4026,272,1062,61,142,0,1035,8,6606
"48439105505",2740,559,323,81,738,329,714,216,5700
"48439105507",5019,146,487,12,533,33,326,1,6557
"48439105508",4296,557,933,247,528,55,952,55,7623
"48439105510",3301,444,2034,1161,787,146,1367,311,9551
"48439105511",3049,384,1717,741,306,17,1562,371,8147
"48439105512",2986,180,781,0,133,20,659,18,4777
"48439105513",1306,170,785,88,221,140,542,62,3314
"48439105514",1399,240,501,156,186,9,607,112,3210
"48439105600",3906,442,246,2,228,99,2122,373,7418
"48439105701",2697,291,298,31,226,53,1053,312,4961
"48439105703",1979,410,463,321,141,0,645,286,4245
"48439105704",4223,1543,2697,593,938,118,3793,1528,15433
"48439105800",2987,577,21,47,360,167,2286,565,7010
"48439105901",1406,1207,42,511,400,263,1537,1412,6778
"48439105902",1062,513,496,991,614,540,971,465,5652
"48439106001",4223,733,2014,374,391,0,2502,648,10885
"48439106002",1007,283,1478,604,192,200,948,467,5179
"48439106004",1943,484,1537,1006,280,224,874,659,7007
"48439106101",394,125,683,69,220,0,605,119,2215
"48439106102",1620,508,699,720,103,120,867,454,5091
"48439106201",184,26,1755,967,298,327,366,332,4255
"48439106202",523,87,2015,1395,0,320,514,328,5182
"48439106300",557,355,1345,653,11,105,544,410,3980
"48439106400",999,726,494,154,115,96,531,439,3554
"48439106502",1137,139,1000,224,128,279,281,301,3489
"48439106503",1545,520,1770,587,294,364,494,437,6011
"48439106507",990,90,334,56,163,0,75,0,1708
"48439106509",1816,286,1270,370,732,10,673,118,5275
"48439106510",5335,124,1161,92,1682,67,1196,87,9744
"48439106511",2965,367,2450,768,639,219,1685,351,9444
"48439106512",983,546,2303,609,359,60,332,316,5508
"48439106513",834,98,1384,264,341,125,483,93,3622
"48439106514",1730,432,1471,1050,594,257,757,260,6551
"48439106515",1289,67,1271,465,422,39,521,32,4106
"48439106516",890,747,1409,1162,712,306,1061,688,6975
"48439106517",2748,94,2184,905,1847,206,1137,31,9152
"48439106518",1282,114,1150,206,598,293,734,105,4482
"48439106600",1104,644,100,235,93,180,477,303,3136
"48439106700",1353,249,344,15,344,42,530,123,3000
"48439110101",3760,444,603,176,1198,750,1449,538,8918
"48439110102",2907,282,38,38,572,206,1204,404,5651
"48439110202",2941,204,16,10,648,176,1683,280,5958
"48439110203",4858,351,1127,0,1765,171,2120,336,10728
"48439110204",4197,347,99,37,1612,44,2375,100,8811
"48439110301",1876,719,0,0,1076,456,1516,843,6486
"48439110302",2978,1209,8,87,700,562,2137,998,8679
"48439110401",3691,263,0,0,423,24,1189,54,5644
"48439110402",2597,1197,0,0,491,312,1440,988,7025
"48439110500",4999,1148,172,0,1299,170,2948,1228,11964
"48439110600",1738,244,111,4,298,59,601,81,3136
"48439110701",4259,1273,184,411,586,138,1391,396,8638
"48439110703",3369,654,238,41,434,83,1040,234,6093
"48439110704",2616,902,265,63,247,107,862,412,5474
"48439110805",4923,181,715,0,439,7,1179,0,7444
"48439110806",3870,100,292,8,430,12,920,22,5654
"48439110807",4461,491,561,25,352,64,1192,282,7428
"48439110808",1638,6,22,0,241,145,138,0,2190
"48439110809",1540,185,267,0,48,1,120,35,2196
"48439110901",3819,101,98,0,394,26,597,14,5049
"48439110903",1416,106,46,0,45,0,153,20,1786
"48439110905",3790,288,202,31,242,0,410,65,5028
"48439110906",3799,248,35,1,110,64,264,101,4622
"48439110907",2400,93,94,0,192,0,92,0,2871
"48439111003",2072,231,395,54,116,6,749,164,3787
"48439111005",3641,647,2791,1294,624,308,2365,473,12143
"48439111008",4675,427,886,264,202,247,1266,92,8059
"48439111010",2804,230,50,60,7,0,385,0,3536
"48439111011",4309,461,2786,724,780,165,1966,214,11405
"48439111012",3612,295,3582,286,637,182,1956,125,10675
"48439111013",4624,391,2234,254,688,38,1568,71,9868
"48439111015",1865,92,422,12,136,12,128,14,2681
"48439111016",7823,860,680,30,283,0,1358,0,11034
"48439111017",6326,296,2383,46,1521,23,1600,141,12336
"48439111018",1624,61,253,0,229,9,191,0,2367
"48439111102",1490,394,1959,968,384,140,1449,477,7261
"48439111103",1572,229,828,232,269,285,1363,467,5245
"48439111104",553,112,1158,95,89,0,380,65,2452
"48439111202",3361,654,582,518,829,226,2209,693,9072
"48439111203",4110,180,568,190,427,0,801,2,6278
"48439111204",4747,597,111,6,206,0,713,283,6663
"48439111301",6752,675,472,65,674,436,762,571,10407
"48439111304",5779,180,468,0,981,0,457,0,7865
"48439111306",3535,553,509,159,269,160,898,568,6651
"48439111307",2314,193,570,34,84,21,728,128,4072
"48439111308",1209,72,11,51,117,38,137,39,1674
"48439111309",2561,524,285,78,441,40,795,238,4962
"48439111310",3850,530,1998,221,1263,179,1405,683,10129
"48439111311",4545,43,736,397,803,42,793,42,7401
"48439111312",3028,24,49,0,176,41,348,0,3666
"48439111313",4057,134,1061,26,582,10,232,28,6130
"48439111314",3140,87,1186,22,551,15,537,0,5538
"48439111402",4976,275,653,47,417,2,1071,140,7581
"48439111404",4770,197,1496,404,820,145,540,16,8388
"48439111405",1706,498,49,0,108,0,255,100,2716
"48439111406",2718,23,539,0,233,10,430,0,3953
"48439111407",2648,54,299,0,274,5,240,0,3520
"48439111408",1752,427,216,0,237,36,147,336,3151
"48439111409",3769,81,423,0,472,0,523,0,5268
"48439111505",3535,171,16,15,110,28,560,39,4474
"48439111506",4219,487,646,408,272,140,563,0,6735
"48439111513",2259,89,926,26,1164,58,1194,39,5755
"48439111514",3178,75,1573,116,1546,16,1822,34,8360
"48439111516",2882,282,1355,156,998,18,1562,1,7254
"48439111521",3218,962,1956,259,1428,568,2389,1076,11856
"48439111522",4415,362,896,278,1396,469,3563,315,11694
"48439111523",2954,716,2121,1404,1684,646,1893,475,11893
"48439111524",3004,485,1941,151,1561,397,2303,391,10233
"48439111525",2923,749,736,321,909,654,1901,312,8505
"48439111526",2821,298,467,417,408,12,633,361,5417
"48439111529",3588,175,65,0,240,0,519,0,4587
"48439111530",4702,205,531,13,434,0,433,22,6340
"48439111531",3153,479,243,9,453,85,339,74,4835
"48439111532",5585,410,920,0,480,0,809,33,8237
"48439111533",3920,152,473,22,495,76,591,94,5823
"48439111534",4478,173,530,44,556,24,835,0,6640
"48439111536",1184,206,1086,358,455,329,964,223,4805
"48439111537",2789,267,1920,190,1372,112,1418,28,8096
"48439111538",2906,110,1467,320,1057,67,1652,66,7645
"48439111539",4147,114,2285,939,1567,120,1601,0,10773
"48439111540",2579,437,1869,63,1363,263,1329,83,7986
"48439111541",1838,180,1051,79,745,0,836,112,4841
"48439111542",2865,331,1590,2,1213,89,1469,221,7780
"48439111543",2449,800,1766,518,953,289,1055,391,8221
"48439111544",4008,277,1805,193,1204,63,1921,52,9523
"48439111545",2128,187,59,6,116,79,59,1,2635
"48439111546",5194,416,623,60,482,0,1224,269,8268
"48439111547",6039,586,4151,737,4488,201,4160,360,20722
"48439111548",2561,182,2644,22,2093,134,1676,46,9358
"48439111549",3828,225,1924,194,1219,151,1058,313,8912
"48439111550",6619,427,4161,138,1895,181,3187,329,16937
"48439111551",4740,25,1065,228,927,153,687,8,7833
"48439111552",2651,205,301,62,150,56,256,36,3717
"48439111553",2176,464,431,14,445,55,594,182,4361
"48439113001",2657,154,355,16,520,0,777,85,4564
"48439113002",2393,518,1365,723,1035,200,2038,563,8835
"48439113102",2756,273,1255,391,178,50,414,36,5353
"48439113104",1563,329,981,65,411,0,559,92,4000
"48439113107",2110,0,149,0,128,16,158,0,2561
"48439113108",3738,354,103,0,527,0,344,0,5066
"48439113109",2034,202,912,256,381,8,798,73,4664
"48439113110",2247,620,885,434,307,87,683,458,5721
"48439113111",1640,818,847,484,126,161,1060,870,6006
"48439113112",1588,630,322,123,271,0,462,503,3899
"48439113113",1452,74,1505,36,462,95,321,0,3945
"48439113114",2044,213,1385,201,404,97,605,138,5087
"48439113115",1554,316,751,139,413,85,841,140,4239
"48439113116",1227,539,1445,401,503,27,462,186,4790
"48439113206",4416,484,198,87,609,0,1718,33,7545
"48439113207",3939,99,23,0,167,35,322,35,4620
"48439113210",5766,198,368,0,541,0,732,56,7661
"48439113212",3431,117,296,0,211,0,445,0,4500
"48439113213",2162,520,58,0,382,11,387,175,3695
"48439113214",3622,314,144,9,922,9,790,14,5824
"48439113215",4467,211,8,0,266,13,632,102,5699
"48439113216",3690,728,232,0,262,130,393,286,5721
"48439113217",3642,127,197,41,249,63,546,0,4865
"48439113218",2451,43,0,0,11,0,151,0,2656
"48439113220",4010,392,352,0,1231,315,2141,272,8713
"48439113221",4116,243,117,0,315,10,377,138,5316
"48439113301",3569,195,0,25,247,59,539,0,4634
"48439113302",3045,439,111,149,228,72,496,248,4788
"48439113403",1997,59,6,23,186,130,379,130,2910
"48439113404",4095,501,341,80,278,0,894,206,6395
"48439113405",4308,571,129,192,443,181,805,220,6849
"48439113407",2856,1224,340,224,936,717,1925,1460,9682
"48439113408",4030,654,113,0,748,16,1247,193,7001
"48439113509",2594,213,283,0,1300,597,1239,226,6452
"48439113510",2236,104,547,31,982,192,582,19,4693
"48439113511",2171,161,275,26,1446,137,590,122,4928
"48439113512",3854,512,378,39,579,71,417,277,6127
"48439113513",3415,490,395,25,1069,290,899,94,6677
"48439113514",1840,809,269,457,1443,262,1129,610,6819
"48439113516",2651,62,333,217,741,165,667,72,4908
"48439113517",2364,308,179,32,604,41,606,25,4159
"48439113518",2808,358,469,155,622,442,739,107,5700
"48439113519",4567,111,620,16,561,42,608,27,6552
"48439113520",3315,246,298,52,1061,86,625,102,5785
"48439113607",3286,181,220,63,353,284,660,231,5278
"48439113610",8816,174,180,21,1652,0,788,8,11639
"48439113611",3692,49,158,101,332,0,292,0,4624
"48439113612",3691,81,35,0,491,0,246,0,4544
"48439113613",3709,113,103,17,106,1,277,3,4329
"48439113618",4360,488,92,84,819,21,595,32,6491
"48439113619",2122,683,859,147,440,168,888,460,5767
"48439113622",4952,94,24,18,887,0,452,0,6427
"48439113623",3280,201,37,0,111,0,293,150,4072
"48439113624",3656,70,75,0,346,79,565,8,4799
"48439113625",3028,30,88,0,192,16,268,0,3622
"48439113626",3402,254,148,0,249,22,282,0,4357
"48439113627",3962,404,441,125,504,99,569,138,6242
"48439113628",2718,297,773,89,912,245,722,158,5914
"48439113629",3375,63,190,50,514,18,261,16,4487
"48439113630",2275,255,494,0,345,57,250,99,3775
"48439113631",4154,775,78,21,1286,751,1411,1350,9826
"48439113632",4600,21,15,0,350,0,300,13,5299
"48439113633",3547,44,55,17,430,296,341,10,4740
"48439113634",4268,80,83,1,487,1,402,3,5325
"48439113703",6837,757,165,16,741,1146,679,1689,12030
"48439113705",3879,664,113,17,664,384,1450,556,7727
"48439113707",4300,297,0,0,384,0,390,1,5372
"48439113709",4120,56,60,0,620,163,307,163,5489
"48439113710",3004,404,163,0,290,107,876,186,5030
"48439113711",3226,161,49,0,211,0,187,21,3855
"48439113803",4228,246,367,8,761,8,929,28,6575
"48439113808",5190,256,89,30,592,59,1047,135,7398
"48439113809",4053,210,159,190,585,42,1373,106,6718
"48439113810",2899,265,198,14,968,228,1080,135,5787
"48439113811",2964,76,176,0,427,29,795,0,4467
"48439113812",4971,213,176,88,422,0,435,0,6305
"48439113813",4527,59,63,0,502,4,310,10,5475
"48439113814",3783,10,212,0,178,44,190,44,4461
"48439113815",5027,45,159,0,286,0,222,0,5739
"48439113816",4606,128,45,0,480,0,390,0,5649
"48439113906",5476,45,253,0,632,15,486,15,6922
"48439113907",5476,178,159,1,786,0,326,0,6926
"48439113908",4793,82,29,0,483,64,98,0,5549
"48439113909",5803,335,40,0,482,0,388,0,7048
"48439113910",7623,319,59,15,567,4,183,123,8893
"48439113911",5767,562,20,49,877,0,762,59,8096
"48439113912",5096,251,167,0,516,0,378,9,6417
"48439113916",2808,342,250,270,549,54,897,153,5323
"48439113917",3647,206,546,1,1407,334,1118,334,7593
"48439113918",3700,139,565,0,698,0,558,17,5677
"48439113919",6216,190,273,0,724,178,757,71,8409
"48439113920",4225,9,316,0,743,13,729,0,6035
"48439113921",16497,870,1663,49,2471,0,2864,359,24773
"48439113922",12217,612,1835,26,3501,600,2460,440,21691
"48439113923",2222,7,290,0,497,36,908,0,3960
"48439113924",3431,188,618,0,804,575,832,644,7092
"48439113925",2516,126,124,278,841,82,955,14,4936
"48439113926",8723,272,1424,270,2306,329,2988,61,16373
"48439113927",9644,327,1025,0,1109,0,1365,145,13615
"48439113928",6981,2,579,1,1112,77,1835,26,10613
"48439113929",7385,184,707,0,991,0,1129,5,10401
"48439114003",5931,386,149,55,1252,72,2587,153,10585
"48439114005",6179,642,244,0,523,0,1101,402,9091
"48439114006",6018,341,26,0,536,79,1441,136,8577
"48439114007",9158,580,1029,113,2940,53,3938,118,17929
"48439114008",7968,619,875,266,2677,60,3591,405,16461
"48439114102",6879,206,121,0,431,0,525,0,8162
"48439114103",17218,581,889,0,1532,143,2669,396,23428
"48439114104",5771,265,86,0,602,0,361,0,7085
"48439114203",3592,967,74,0,127,41,286,151,5238
"48439114204",5316,588,83,0,147,18,529,60,6741
"48439114205",2347,609,0,26,92,193,385,13,3665
"48439114206",3321,652,77,0,184,30,232,334,4830
"48439114207",4912,228,150,0,537,142,709,148,6826
"48439121601",4726,1298,857,55,356,101,861,774,9028
"48439121604",3036,632,1082,213,323,36,992,238,6552
"48439121605",2207,256,313,1,108,42,350,43,3320
"48439121606",2440,79,233,124,491,0,247,0,3614
"48439121608",4069,409,245,0,389,132,357,183,5784
"48439121609",4528,123,386,1,957,0,237,1,6233
"48439121610",1901,97,99,11,93,14,247,20,2482
"48439121611",3381,102,459,305,485,0,628,0,5360
"48439121702",909,457,203,72,74,95,294,322,2426
"48439121703",1856,1187,827,403,692,238,1628,1209,8040
"48439121704",2050,747,139,141,478,0,1785,517,5857
"48439121903",2356,1485,816,264,466,714,2425,1977,10503
"48439121904",2298,816,750,247,475,10,1984,635,7215
"48439121905",1069,1263,781,717,1161,306,1133,1349,7779
"48439121906",1261,1145,582,106,722,91,1313,1087,6307
"48439122001",2410,1923,0,67,134,45,1318,1523,7420
"48439122002",2295,1031,375,166,558,197,2410,1116,8148
"48439122100",3314,1313,197,275,219,444,1779,1398,8939
"48439122200",1000,664,248,98,113,205,850,693,3871
"48439122300",819,405,123,156,525,862,390,198,3478
"48439122400",2644,1132,292,191,533,660,1007,1063,7522
"48439122500",3342,387,113,95,266,10,316,113,4642
"48439122600",2748,272,305,174,67,110,141,45,3862
"48439122700",2998,508,433,315,477,127,336,241,5435
"48439122801",1391,817,265,708,448,400,905,975,5909
"48439122802",2627,906,487,15,649,0,1763,815,7262
"48439122900",4032,1599,430,367,688,255,3439,1510,12320
"48439123000",3519,801,434,33,695,315,1033,604,7434
"48439123100",362,653,588,480,12,102,277,615,3089
"48439123200",1368,230,130,54,204,213,706,304,3209
"48439123300",2061,175,51,67,163,0,171,0,2688
"48439123400",1007,214,89,154,210,69,568,137,2448
"48439123500",291,209,612,745,311,250,507,435,3360
"48439123600",1006,541,71,220,374,90,951,326,3579
"48439980000",0,0,0,0,0,0,0,0,0
"48441010100",2646,1855,22,71,234,282,243,293,5646
"48441010200",1163,595,188,22,180,87,512,502,3249
"48441010300",1161,344,178,271,109,91,578,221,2953
"48441010400",842,383,58,170,296,210,885,485,3329
"48441010500",2214,595,156,178,221,84,948,489,4885
"48441010600",3504,354,105,33,137,22,1136,194,5485
"48441010700",1514,443,78,15,616,413,1358,638,5075
"48441010800",594,419,151,90,246,151,362,321,2334
"48441010900",3404,1268,814,424,250,16,696,260,7132
"48441011000",561,353,344,73,86,0,373,139,1929
"48441011200",2110,388,86,41,149,37,931,214,3956
"48441011300",2138,548,319,408,296,102,906,433,5150
"48441011400",2954,665,148,185,281,25,541,180,4979
"48441011500",2387,442,6,64,99,0,446,126,3570
"48441011600",1963,417,150,27,203,8,477,226,3471
"48441011700",1190,352,185,194,321,35,528,167,2972
"48441011900",1110,595,103,0,212,109,721,453,3303
"48441012000",1939,32,23,0,79,0,89,0,2162
"48441012100",127,281,37,25,9,12,33,74,598
"48441012200",1302,194,16,33,123,135,276,89,2168
"48441012300",2378,321,163,58,329,84,658,223,4214
"48441012400",1847,204,138,15,83,36,453,69,2845
"48441012500",2454,152,149,2,232,10,404,61,3464
"48441012600",2373,227,95,0,384,7,159,21,3266
"48441012700",6134,405,202,3,397,20,503,16,7680
"48441012801",2761,228,120,0,242,111,585,85,4132
"48441012802",2406,542,559,35,609,210,530,307,5198
"48441012900",1512,138,146,43,422,0,537,0,2798
"48441013000",8,5,0,0,0,0,8,0,21
"48441013100",3291,955,528,258,829,230,1767,473,8331
"48441013200",1328,230,18,18,137,75,272,111,2189
"48441013300",2339,316,64,6,206,19,426,55,3431
"48441013401",2902,284,197,17,109,60,764,35,4368
"48441013402",4715,648,251,1,525,13,468,65,6686
"48441013404",6217,431,270,101,462,90,985,9,8565
"48441013500",7042,222,39,8,264,8,401,34,8018
"48441013600",4170,443,36,3,342,78,801,61,5934
"48441980000",0,0,0,0,0,0,0,0,0
"48443950100",742,84,0,0,11,0,433,71,1341
"48445950100",1701,490,94,0,250,21,589,223,3368
"48445950300",1037,220,34,4,380,170,997,386,3228
"48445950400",5815,567,63,121,521,23,3324,366,10800
"48447950300",1360,212,0,2,21,5,91,62,1753
"48449950100",1516,358,203,125,111,0,223,188,2724
"48449950200",1832,320,56,0,171,25,466,244,3114
"48449950300",6601,1218,112,86,317,87,1861,1138,11420
"48449950400",4225,783,210,79,262,418,423,727,7127
"48449950500",1407,510,174,119,250,108,1328,558,4454
"48449950600",1545,799,893,394,373,99,1499,743,6345
"48449950700",660,119,240,102,29,257,412,343,2162
"48449950800",2982,716,285,0,364,260,1890,761,7258
"48451000100",2061,359,64,0,56,0,666,210,3416
"48451000200",3097,964,58,8,285,228,2072,791,7503
"48451000300",3544,1294,173,33,620,52,1636,892,8244
"48451000400",4318,1091,174,54,732,114,3857,1052,11392
"48451000700",2115,1396,63,108,557,185,1952,1291,7667
"48451000801",2955,879,96,0,342,15,1254,709,6250
"48451000802",2929,797,303,79,296,13,1944,606,6967
"48451000900",1656,356,1,16,174,107,1363,247,3920
"48451001000",4034,487,0,116,306,56,868,140,6007
"48451001101",4123,516,93,83,322,238,1558,270,7203
"48451001102",3505,403,51,0,306,104,2095,215,6679
"48451001200",4837,900,417,98,831,141,2777,693,10694
"48451001301",4222,491,160,206,240,73,669,183,6244
"48451001303",3053,312,280,16,391,23,713,45,4833
"48451001304",2294,243,90,0,336,83,415,106,3567
"48451001400",2890,1042,161,0,365,50,1484,476,6468
"48451001500",369,33,26,0,11,27,96,4,566
"48451001600",4245,169,8,4,261,24,852,103,5666
"48451001702",2424,212,0,0,225,8,467,125,3461
"48451001704",6749,885,81,14,335,31,921,152,9168
"48451001706",2891,321,37,0,236,26,619,193,4323
"48451001707",4193,325,58,33,237,117,493,218,5674
"48451001708",5032,309,13,0,207,0,511,207,6279
"48451001800",763,510,377,246,110,52,557,418,3033
"48451980000",0,0,0,0,0,0,0,0,0
"48453000101",3316,307,17,2,61,48,316,43,4110
"48453000102",2265,126,45,0,56,0,96,6,2594
"48453000203",851,369,31,11,102,106,115,95,1680
"48453000204",2035,521,70,0,238,63,153,37,3117
"48453000205",2453,466,174,35,290,120,291,103,3932
"48453000206",2537,241,129,55,211,60,304,42,3579
"48453000302",3210,1195,68,0,517,172,410,364,5936
"48453000304",1802,896,0,16,393,104,174,338,3723
"48453000305",2293,432,0,0,163,185,209,77,3359
"48453000306",1906,267,148,128,291,37,650,144,3571
"48453000307",1331,225,37,48,32,190,309,207,2379
"48453000401",1956,557,118,58,155,207,331,198,3580
"48453000402",1531,297,268,72,386,67,422,82,3125
"48453000500",2520,1341,30,19,369,268,415,249,5211
"48453000601",132,727,5,2,56,85,21,227,1255
"48453000603",767,3959,99,180,175,1985,200,1130,8495
"48453000604",614,2415,45,34,207,772,96,237,4420
"48453000700",772,304,16,0,34,8,151,80,1365
"48453000801",877,170,167,7,292,83,903,216,2715
"48453000802",944,646,894,522,68,512,590,1110,5286
"48453000803",1248,296,344,97,246,41,509,126,2907
"48453000804",954,484,402,281,129,160,471,477,3358
"48453000901",945,315,145,53,199,56,554,241,2508
"48453000902",2643,938,6,17,791,869,2528,1344,9136
"48453001000",1922,596,33,66,780,132,1746,505,5780
"48453001100",3343,352,78,152,489,40,326,92,4872
"48453001200",3408,447,123,0,416,0,500,66,4960
"48453001303",2126,222,18,46,98,36,239,22,2807
"48453001304",3156,338,18,1,206,45,452,85,4301
"48453001305",4079,971,82,198,128,196,958,865,7477
"48453001307",2448,738,128,128,139,33,811,396,4821
"48453001308",1963,545,114,28,125,30,893,354,4052
"48453001401",2213,303,44,0,225,49,268,0,3102
"48453001402",2096,374,57,49,92,45,410,23,3146
"48453001403",911,87,6,46,210,57,401,57,1775
"48453001501",4608,188,4,18,284,0,668,5,5775
"48453001503",2616,714,254,28,354,42,896,372,5276
"48453001504",3764,390,12,2,547,36,584,220,5555
"48453001505",3281,614,14,0,225,74,656,214,5078
"48453001602",2111,197,89,0,632,124,299,77,3529
"48453001603",4332,134,29,0,213,0,244,0,4952
"48453001604",3411,154,0,0,188,17,172,10,3952
"48453001605",2965,359,29,1,184,29,223,80,3870
"48453001606",110,169,0,41,0,0,14,20,354
"48453001705",4265,58,48,46,183,30,295,0,4925
"48453001706",2866,172,146,1,296,31,253,0,3765
"48453001707",3888,162,32,2,457,194,661,90,5486
"48453001712",3384,690,85,23,224,7,1246,423,6082
"48453001713",3317,256,97,35,255,214,923,177,5274
"48453001714",8298,794,611,18,2423,47,1090,314,13595
"48453001716",4276,234,49,11,519,1,585,0,5675
"48453001718",4164,365,75,1,728,115,368,41,5857
"48453001719",3355,128,38,0,377,0,429,0,4327
"48453001722",2798,166,195,0,664,58,455,58,4394
"48453001728",5768,542,295,80,406,33,1726,234,9084
"48453001729",3802,323,95,1,468,39,1187,113,6028
"48453001733",3285,215,71,0,37,3,619,24,4254
"48453001737",8813,194,149,0,1224,77,1767,0,12224
"48453001738",5883,277,15,0,460,34,1691,0,8360
"48453001740",3261,333,143,0,663,75,1045,23,5543
"48453001741",2931,290,0,0,551,21,701,116,4610
"48453001742",4914,558,0,0,504,334,1536,631,8477
"48453001745",1880,201,94,0,284,33,211,124,2827
"48453001746",2915,263,49,20,375,14,756,125,4517
"48453001747",3688,753,418,131,323,164,1126,591,7194
"48453001748",4855,541,125,6,504,32,1402,405,7870
"48453001749",3733,433,216,15,938,91,637,95,6158
"48453001750",3660,500,33,39,377,196,1014,338,6157
"48453001751",1753,10,96,0,58,44,126,0,2087
"48453001752",1857,696,216,69,704,462,555,57,4616
"48453001753",713,113,38,0,187,0,207,11,1269
"48453001754",3329,359,176,0,382,199,603,290,5338
"48453001755",3600,102,33,0,2046,84,405,0,6270
"48453001756",2957,200,104,3,707,3,243,6,4223
"48453001757",1718,60,62,0,230,0,215,9,2294
"48453001760",13205,338,254,0,2067,0,1051,78,16993
"48453001761",5984,367,0,0,703,82,519,0,7655
"48453001764",4976,332,0,0,186,0,452,20,5966
"48453001765",11510,761,196,43,1194,34,1634,84,15456
"48453001766",5902,553,0,2,367,17,986,74,7901
"48453001768",4737,98,69,29,301,12,601,0,5847
"48453001769",4336,168,0,1,630,124,930,0,6189
"48453001770",9475,170,115,0,1862,0,1561,0,13183
"48453001771",3605,134,44,0,232,0,443,0,4458
"48453001772",2485,103,160,25,440,34,1235,51,4533
"48453001773",5321,251,96,0,590,69,564,0,6891
"48453001774",6955,414,68,20,626,2,2046,131,10262
"48453001775",4171,27,47,0,759,0,776,6,5786
"48453001776",2003,59,174,10,366,49,692,72,3425
"48453001777",4606,351,415,135,353,0,1579,120,7559
"48453001778",3194,336,0,0,88,5,258,31,3912
"48453001779",5523,270,73,0,190,0,442,158,6656
"48453001780",3766,184,12,3,167,10,313,19,4474
"48453001781",2036,100,8,0,177,0,185,0,2506
"48453001782",3090,339,92,40,1516,288,557,199,6121
"48453001783",5102,135,0,0,329,48,565,32,6211
"48453001784",4707,155,26,0,859,52,534,0,6333
"48453001785",2889,174,58,1,789,253,1053,16,5233
"48453001786",3547,298,49,31,1069,262,405,187,5848
"48453001804",2497,2239,237,240,1439,333,2120,2121,11226
"48453001805",1900,669,228,322,1125,414,1931,971,7560
"48453001806",2681,1234,329,287,837,679,2506,1664,10217
"48453001811",953,939,454,120,421,397,911,1247,5442
"48453001812",2966,2037,590,507,992,514,3209,2273,13088
"48453001813",3436,661,220,311,741,912,3193,1341,10815
"48453001817",2597,268,173,0,465,74,397,75,4049
"48453001818",2980,861,104,127,605,714,920,1361,7672
"48453001819",860,1038,312,137,1461,801,1645,1635,7889
"48453001820",2241,1090,582,302,1532,1243,2531,1868,11389
"48453001821",3188,547,336,333,987,526,2333,849,9099
"48453001822",2579,1244,598,233,2132,445,3523,1502,12256
"48453001823",2121,1235,292,261,1847,922,3369,1820,11867
"48453001824",1283,108,43,0,416,62,439,82,2433
"48453001826",886,127,169,124,843,32,456,93,2730
"48453001828",3452,37,144,3,257,0,525,5,4423
"48453001829",2007,54,56,0,438,70,332,7,2964
"48453001832",1821,329,489,340,216,12,802,219,4228
"48453001833",2765,1393,965,196,2069,189,3172,1414,12163
"48453001834",3215,546,1622,33,2630,305,2005,426,10782
"48453001835",2135,619,603,146,1057,720,1776,1255,8311
"48453001839",3097,519,1175,29,1843,49,1077,260,8049
"48453001840",4903,990,1229,269,1906,383,3462,1249,14391
"48453001841",9138,1741,2117,46,3692,415,4166,1560,22875
"48453001842",4513,949,830,85,1784,545,3467,1226,13399
"48453001843",1314,226,149,0,600,0,527,184,3000
"48453001844",1873,322,435,150,549,111,918,226,4584
"48453001845",2120,462,223,8,326,167,476,496,4278
"48453001846",1942,284,28,2,226,28,373,1,2884
"48453001847",3291,578,699,450,2250,40,917,316,8541
"48453001848",2737,233,469,54,1102,99,972,210,5876
"48453001849",2625,212,545,76,1818,167,927,84,6454
"48453001850",1867,315,244,71,1416,302,1389,351,5955
"48453001851",5352,646,1507,54,1203,314,2036,223,11335
"48453001853",2122,38,280,1,641,79,641,21,3823
"48453001854",1937,243,1170,117,577,411,1010,607,6072
"48453001855",8656,524,2265,1128,2243,200,3427,427,18870
"48453001856",3334,367,1075,149,1017,51,1664,317,7974
"48453001857",3569,141,646,266,827,202,1904,51,7606
"48453001858",12232,219,2013,16,2153,107,3226,109,20075
"48453001859",995,93,52,6,123,9,325,102,1705
"48453001860",2640,342,531,247,442,209,1535,217,6163
"48453001861",3611,304,740,0,235,0,1348,86,6324
"48453001862",3528,207,1031,159,1014,75,1411,151,7576
"48453001863",1481,472,795,294,564,273,939,461,5279
"48453001864",1540,276,525,27,381,60,576,111,3496
"48453001901",4745,423,38,0,203,0,502,64,5975
"48453001908",6416,636,134,0,1503,0,1301,414,10404
"48453001910",3560,99,35,0,604,111,301,0,4710
"48453001911",2326,269,77,0,303,24,604,7,3610
"48453001912",3041,293,0,40,406,32,181,52,4045
"48453001913",3933,124,0,0,779,0,265,0,5101
"48453001914",5562,62,30,16,524,22,646,47,6909
"48453001915",1367,94,0,0,110,0,221,27,1819
"48453001916",2767,161,17,0,461,0,208,50,3664
"48453001917",4009,147,0,0,500,63,324,0,5043
"48453001918",1966,189,0,0,375,2,318,0,2850
"48453001919",3479,78,41,0,277,0,224,26,4125
"48453002002",2624,144,30,0,79,46,757,114,3794
"48453002003",2514,826,62,157,232,232,1242,629,5894
"48453002004",1546,227,0,21,172,69,528,92,2655
"48453002005",2773,1289,152,30,394,70,1012,946,6666
"48453002104",2051,261,232,300,124,39,471,230,3708
"48453002105",2512,1135,373,399,511,389,1824,1286,8429
"48453002106",1977,557,516,63,437,15,864,534,4963
"48453002107",1411,964,685,573,362,132,1014,904,6045
"48453002108",984,1012,1344,341,105,70,792,1004,5652
"48453002109",962,429,1442,322,204,84,486,432,4361
"48453002110",1092,699,837,501,813,463,1573,1064,7042
"48453002111",1912,999,542,191,552,353,1704,1360,7613
"48453002112",2004,1267,770,391,372,38,1516,1008,7366
"48453002113",1860,470,886,143,369,0,1103,366,5197
"48453002201",471,315,698,109,84,83,536,373,2669
"48453002202",3692,1129,1736,1108,585,854,3919,1899,14922
"48453002207",4779,895,1857,211,1216,180,4938,931,15007
"48453002208",2219,1661,1138,526,406,484,2113,2095,10642
"48453002209",4841,767,1415,308,1072,49,3523,611,12586
"48453002210",2324,556,75,0,227,134,1207,599,5122
"48453002211",1160,333,348,14,226,23,936,299,3339
"48453002212",180,0,90,0,293,0,389,0,952
"48453002304",1156,892,135,83,775,499,1170,1208,5918
"48453002307",2944,1078,306,124,894,319,2348,1070,9083
"48453002308",2794,1490,53,49,161,117,815,1070,6549
"48453002310",855,868,209,57,419,509,1018,1251,5186
"48453002312",2798,1438,142,343,1231,768,3615,2046,12381
"48453002313",1695,568,669,112,1252,355,1715,520,6886
"48453002314",1770,907,289,250,619,785,1378,1285,7283
"48453002315",1208,620,233,42,485,560,1194,979,5321
"48453002316",2002,1317,125,177,1023,843,2220,1880,9587
"48453002317",606,1907,263,641,511,1005,511,1701,7145
"48453002318",2128,2764,714,142,1242,1301,2392,2648,13331
"48453002319",2,6,0,4,0,0,0,1,13
"48453002402",3916,1136,428,1,838,451,1985,1367,10122
"48453002403",1969,254,164,26,117,73,1026,191,3820
"48453002407",4335,127,127,8,506,51,1799,99,7052
"48453002409",2307,519,92,81,241,21,1500,370,5131
"48453002410",2309,791,167,35,261,242,1259,642,5706
"48453002411",1682,1264,431,206,1748,787,3084,1995,11197
"48453002412",3001,645,356,11,1052,748,3640,1351,10804
"48453002413",1491,1410,463,202,846,650,1952,1975,8989
"48453002419",1764,746,302,231,836,410,1745,1026,7060
"48453002421",5408,605,352,122,840,129,2323,257,10036
"48453002422",3006,1018,282,32,1042,126,2386,521,8413
"48453002423",4166,599,241,12,532,51,2700,320,8621
"48453002424",2390,657,177,14,258,24,1216,506,5242
"48453002425",2337,66,29,0,517,0,1612,41,4602
"48453002426",4224,538,751,12,1851,414,4621,771,13182
"48453002427",3798,1561,252,55,1573,890,4441,2135,14705
"48453002428",3961,230,499,20,889,649,1719,497,8464
"48453002429",432,47,41,0,163,78,179,78,1018
"48453002430",1970,178,181,0,986,165,2312,234,6026
"48453002431",3657,1023,568,22,1888,151,4326,1119,12754
"48453002432",985,282,19,89,419,171,939,365,3269
"48453002433",3074,786,993,30,1192,175,2641,702,9593
"48453002434",1280,276,59,0,282,9,776,130,2812
"48453002435",3086,384,770,99,1497,1008,2925,1281,11050
"48453002436",1330,514,0,0,423,20,1040,517,3844
"48453002500",4130,387,77,5,692,111,643,56,6101
"48453980000",0,0,0,0,0,0,0,0,0
"48455950100",2384,419,456,20,42,6,185,0,3512
"48455950200",2672,615,205,83,20,0,219,126,3940
"48455950300",1510,242,0,20,22,0,36,31,1861
"48455950400",2956,455,23,0,16,84,191,150,3875
"48455950500",1217,126,491,228,0,0,161,51,2274
"48457950100",2370,366,43,6,66,0,79,20,2950
"48457950200",4257,860,665,59,114,115,337,9,6416
"48457950300",1593,319,256,265,37,36,38,8,2552
"48457950400",3891,787,188,11,48,18,165,18,5126
"48457950500",2279,255,59,42,44,222,9,222,3132
"48459950100",5883,1002,211,236,451,44,394,30,8251
"48459950200",2475,246,502,42,156,0,135,6,3562
"48459950300",6140,965,377,221,195,338,353,162,8751
"48459950400",2529,426,482,106,466,64,750,24,4847
"48459950500",4285,889,305,116,261,98,174,73,6201
"48459950600",2766,540,227,120,127,51,30,36,3897
"48459950700",4635,494,176,100,154,36,428,21,6044
"48461950100",815,88,11,0,147,19,270,45,1395
"48461950200",1224,237,67,22,421,187,946,343,3447
"48463950100",1988,651,28,0,42,71,934,458,4172
"48463950200",5543,1989,0,35,212,49,3013,1786,12627
"48463950300",4108,621,0,4,451,103,3387,662,9336
"48463950400",2441,822,48,0,121,12,1545,759,5748
"48463950500",3629,2337,0,58,405,118,3225,2435,12207
"48465950201",7055,786,221,14,426,0,4931,431,13864
"48465950301",3087,1204,86,1,257,80,2768,1224,8707
"48465950302",3152,662,0,94,389,34,3392,627,8350
"48465950400",2400,923,65,1,192,77,2228,935,6821
"48465950500",4470,1502,31,0,415,95,3294,1467,11274
"48465950601",2668,1306,0,0,197,47,2695,1305,8218
"48465950602",3109,938,0,0,221,170,3283,1099,8820
"48465950700",4535,1063,18,0,270,157,3939,1169,11151
"48465950800",3516,1273,0,0,44,40,2117,1196,8186
"48465980000",0,0,0,0,0,0,0,0,0
"48467950100",3697,609,20,0,141,3,170,34,4674
"48467950200",2228,838,0,0,117,51,388,303,3925
"48467950300",3587,455,231,11,68,20,294,3,4669
"48467950400",4048,624,0,0,115,11,454,44,5296
"48467950500",2989,738,203,265,88,5,73,155,4516
"48467950600",5781,812,82,0,412,115,246,21,7469
"48467950700",2941,382,108,16,71,23,294,107,3942
"48467950800",4453,1160,0,0,167,24,673,438,6915
"48467950900",5630,873,106,115,234,106,391,123,7578
"48467951000",5445,1143,90,32,82,46,346,357,7541
"48469000100",1132,569,104,55,134,0,963,389,3346
"48469000201",1667,601,230,116,346,171,1568,639,5338
"48469000202",3128,556,728,32,598,70,2913,579,8604
"48469000301",674,561,104,67,223,140,675,651,3095
"48469000302",913,541,167,100,341,123,1071,626,3882
"48469000400",1357,141,53,0,100,40,666,134,2491
"48469000501",2746,153,114,42,637,63,1664,105,5524
"48469000502",2274,776,111,14,223,308,1353,921,5980
"48469000601",1305,1000,123,92,267,288,930,1258,5263
"48469000602",2385,1088,216,12,275,302,1415,867,6560
"48469000700",2389,391,104,22,189,115,1573,338,5121
"48469000800",1406,216,48,75,108,20,528,135,2536
"48469001300",1598,186,44,0,182,79,346,199,2634
"48469001400",6399,583,126,115,411,308,1723,736,10401
"48469001501",3032,121,62,5,215,0,768,36,4239
"48469001503",1809,65,14,0,68,40,121,8,2125
"48469001504",5519,466,56,0,442,218,1250,279,8230
"48469001601",3815,510,828,40,393,555,1153,748,8042
"48469001604",4657,992,448,0,313,163,1991,954,9518
"48469001605",2819,235,105,44,206,0,1313,140,4862
"48469001606",6243,248,459,12,1150,30,1916,80,10138
"48469001700",3475,756,202,0,62,7,2069,665,7236
"48469980000",0,0,0,0,0,0,0,0,0
"48471790101",1671,202,11,85,0,0,47,0,2016
"48471790102",2535,545,424,61,119,24,559,303,4570
"48471790103",3249,776,502,569,47,230,214,649,6236
"48471790200",4401,796,349,177,130,4,357,554,6768
"48471790300",6203,231,573,135,114,0,169,16,7441
"48471790400",3594,581,373,548,140,190,531,143,6100
"48471790500",2230,888,797,1003,214,57,190,33,5412
"48471790600",589,687,719,223,369,87,668,585,3927
"48471790700",2085,1391,535,858,260,128,510,122,5889
"48471790800",1859,1044,240,543,171,54,50,105,4066
"48473680100",2287,137,25,0,184,22,577,139,3371
"48473680200",5447,1802,1261,701,464,212,3887,1275,15049
"48473680300",6048,495,2385,1392,745,127,2364,363,13919
"48473680400",0,0,0,0,0,0,0,0,0
"48473680500",4184,772,1714,1321,481,67,1074,700,10313
"48473680600",6712,918,58,0,295,323,1038,783,10127
"48475950100",2838,742,140,28,180,63,1299,396,5686
"48475950200",2965,596,218,13,214,163,1585,611,6365
"48475950300",1516,489,128,0,230,64,993,335,3755
"48477170100",1830,155,707,260,32,7,296,9,3296
"48477170200",3511,576,605,184,588,19,643,160,6286
"48477170300",4306,855,725,190,192,5,270,577,7120
"48477170400",4075,729,325,354,30,30,645,447,6635
"48477170500",4961,566,682,307,296,0,422,68,7302
"48477170600",3710,283,786,267,7,1,795,151,6000
"48479000101",2424,2163,13,0,94,128,2397,2290,9509
"48479000105",1237,1223,0,0,202,0,1432,1223,5317
"48479000106",2010,2341,1,0,185,110,2189,2446,9282
"48479000107",1341,2029,0,0,19,58,1307,2087,6841
"48479000108",2730,1088,0,1,26,98,2755,1186,7884
"48479000109",942,1095,0,29,18,64,960,1159,4267
"48479000200",1696,2040,52,1,86,147,1734,2187,7943
"48479000300",1130,1201,0,5,79,98,1186,1297,4996
"48479000601",1335,1510,0,0,117,73,1437,1583,6055
"48479000602",1972,765,103,4,38,36,2110,797,5825
"48479000700",1475,1258,0,0,151,0,1590,1257,5731
"48479000800",1048,1023,0,1,42,30,1090,1052,4286
"48479000901",2374,2244,10,0,132,81,2510,2321,9672
"48479000903",994,1675,0,0,89,33,1064,1708,5563
"48479000904",1849,1272,0,0,51,155,1885,1372,6584
"48479001001",3189,1857,0,0,199,94,3292,1886,10517
"48479001003",1253,954,0,0,28,203,1257,1140,4835
"48479001004",783,551,0,0,112,30,874,581,2931
"48479001101",2449,1364,36,0,247,49,2546,1413,8104
"48479001103",877,475,0,0,26,42,896,517,2833
"48479001104",2383,868,0,1,66,24,2211,882,6435
"48479001105",1597,1000,0,0,131,173,1667,1107,5675
"48479001201",1620,758,0,0,120,187,1735,943,5363
"48479001202",1260,1436,0,0,89,185,1271,1610,5851
"48479001300",1578,2205,0,2,84,15,1661,2159,7704
"48479001401",1561,2392,0,48,7,144,1547,2509,8208
"48479001402",1525,990,0,0,162,397,1687,1387,6148
"48479001501",1474,1153,0,0,141,38,1517,1164,5487
"48479001502",2963,1294,0,0,144,148,3041,1432,9022
"48479001601",3208,634,20,10,62,51,3201,674,7860
"48479001602",3677,448,0,10,216,0,3272,413,8036
"48479001706",2953,2273,20,16,168,9,2996,2280,10715
"48479001709",4832,985,0,1,308,66,4415,837,11444
"48479001710",1228,366,1,0,8,0,1145,366,3114
"48479001711",4697,595,0,0,252,30,4285,613,10472
"48479001712",5968,315,24,0,561,26,6016,341,13251
"48479001713",12346,1040,60,1,804,20,12130,1052,27453
"48479001714",2364,272,0,2,97,0,2176,270,5181
"48479001715",5609,888,0,0,432,9,5653,677,13268
"48479001716",4907,818,57,0,37,187,4909,979,11894
"48479001717",1475,1422,0,62,164,27,1526,1405,6081
"48479001718",1360,421,10,197,191,20,1406,441,4046
"48479001719",2714,629,0,1,233,32,2704,643,6956
"48479001720",4416,672,14,1,362,28,4233,542,10268
"48479001721",2149,423,2,0,106,0,1949,416,5045
"48479001722",5347,328,0,0,455,0,5191,282,11603
"48479001806",2387,1397,0,0,135,294,2491,1690,8394
"48479001807",5039,2521,38,0,370,23,5351,2543,15885
"48479001808",3952,2442,0,0,369,101,4311,2541,13716
"48479001809",3657,1991,21,0,405,137,3994,2128,12333
"48479001810",3140,1643,0,0,203,80,3186,1622,9874
"48479001811",3606,546,0,0,212,54,3769,598,8785
"48479001812",6067,1187,7,14,781,113,6811,1204,16184
"48479001813",666,220,6,0,0,16,621,221,1750
"48479001814",4508,2596,0,0,198,61,4316,2657,14336
"48479001815",1075,548,0,0,0,202,1043,750,3618
"48479001816",3346,780,83,0,124,125,3381,905,8744
"48479001817",3009,1778,0,0,0,83,2920,1852,9642
"48479001818",1735,1263,0,14,24,251,1759,1514,6560
"48479001900",1161,1760,14,2,61,51,1141,1797,5987
"48479980000",0,0,0,0,0,0,0,0,0
"48481740100",4350,257,532,196,28,7,723,125,6218
"48481740200",564,446,156,233,47,0,193,318,1957
"48481740300",765,177,688,240,5,0,541,96,2512
"48481740400",3938,389,528,388,310,46,2085,181,7865
"48481740500",1611,255,832,438,29,33,980,179,4357
"48481740600",2936,383,170,128,306,163,1397,322,5805
"48481740700",1058,551,62,297,30,42,652,489,3181
"48481740800",2088,866,299,51,6,102,1039,961,5412
"48481740900",5718,549,26,21,158,0,1563,291,8326
"48481741000",2873,1034,595,69,185,12,2002,943,7713
"48481741100",2024,246,0,27,32,3,285,124,2741
"48483950100",2515,276,18,0,231,119,708,313,4180
"48483950300",1681,320,67,26,148,38,256,112,2648
"48485010100",370,322,188,62,67,18,164,153,1344
"48485010200",355,397,8,46,157,66,72,265,1366
"48485010400",400,130,1290,322,0,51,349,141,2683
"48485010600",1630,152,17,145,452,53,618,66,3133
"48485010700",1900,196,114,52,225,27,876,0,3390
"48485010800",1332,521,48,57,532,101,742,328,3661
"48485010900",1363,242,28,40,27,6,143,37,1886
"48485011000",1561,283,41,8,405,55,710,94,3157
"48485011100",598,257,9,6,353,199,670,326,2418
"48485011200",911,536,87,187,57,85,92,206,2161
"48485011300",728,124,312,26,118,15,151,12,1486
"48485011400",1148,1377,194,49,268,197,648,1226,5107
"48485011500",1328,303,144,145,80,0,231,131,2362
"48485011600",2036,1126,229,229,349,59,602,528,5158
"48485011700",1998,75,95,1,218,10,285,17,2699
"48485011800",1670,149,4,0,56,7,223,5,2114
"48485011900",3016,405,228,0,283,96,480,78,4586
"48485012000",4338,745,195,614,190,74,287,76,6519
"48485012100",2365,300,38,0,212,0,413,85,3413
"48485012200",4579,788,235,67,392,67,661,169,6958
"48485012300",5546,716,255,351,700,81,769,47,8465
"48485012400",5929,499,310,26,356,117,706,99,8042
"48485012600",3038,328,376,0,185,0,351,128,4406
"48485012700",2140,339,69,11,198,18,645,200,3620
"48485012800",3187,397,164,125,407,0,613,123,5016
"48485012900",2271,95,0,0,16,0,161,1,2544
"48485013000",1347,613,181,44,271,56,219,243,2974
"48485013100",2964,325,576,81,297,169,546,71,5029
"48485013200",3436,295,1425,309,653,26,514,30,6688
"48485013300",1180,0,101,0,168,0,276,0,1725
"48485013401",364,22,172,0,29,0,72,0,659
"48485013501",4524,504,126,2,118,301,388,299,6262
"48485013502",4617,161,84,0,113,0,360,12,5347
"48485013600",4912,417,0,2,255,0,254,0,5840
"48485013700",2213,292,76,9,162,21,284,12,3069
"48485013800",3275,120,0,1,76,19,76,7,3574
"48485980000",0,0,0,0,0,0,0,0,0
"48487950300",1730,135,0,0,39,1,196,26,2127
"48487950500",1185,462,177,444,206,50,395,57,2976
"48487950600",4549,560,244,56,267,182,1204,371,7433
"48487950700",1685,679,50,63,110,42,810,349,3788
"48489950300",3852,2515,2,11,154,46,3609,2509,12698
"48489950400",3477,1620,7,7,162,27,3087,1504,9891
"48489950500",1861,1206,0,0,133,27,1669,1223,6119
"48489950600",974,1168,51,0,4,0,723,1141,4061
"48489950700",1108,1229,0,2,85,41,892,1129,4486
"48489990000",0,0,0,0,0,0,0,0,0
"48491020105",4153,24,0,0,43,0,328,0,4548
"48491020106",3082,123,102,0,286,0,326,0,3919
"48491020107",4364,171,0,0,74,0,110,0,4719
"48491020108",2638,64,168,0,1,1,72,1,2945
"48491020109",2579,40,49,0,170,0,167,0,3005
"48491020110",3258,110,0,0,131,0,370,40,3909
"48491020111",2681,143,37,37,167,15,375,19,3474
"48491020112",2728,42,0,0,137,69,312,0,3288
"48491020113",2377,215,0,0,141,0,636,171,3540
"48491020114",4354,513,132,82,399,0,1668,284,7432
"48491020115",2202,287,82,0,50,20,213,46,2900
"48491020201",1154,194,0,0,26,0,234,2,1610
"48491020202",4243,603,0,0,127,11,409,175,5568
"48491020203",2643,22,0,0,39,0,66,0,2770
"48491020204",3948,203,0,0,157,0,505,26,4839
"48491020301",5757,324,95,8,519,23,790,147,7663
"48491020302",2778,9,0,0,354,33,736,12,3922
"48491020310",2464,74,54,2,189,0,298,0,3081
"48491020311",2199,54,61,0,724,34,610,76,3758
"48491020312",6246,353,299,0,788,102,3467,309,11564
"48491020313",6620,378,102,31,1700,80,1600,34,10545
"48491020314",3940,162,164,0,1039,11,1561,58,6935
"48491020315",3704,111,207,68,717,0,737,8,5552
"48491020316",2307,138,371,0,614,93,340,100,3963
"48491020317",2479,167,193,31,398,143,380,69,3860
"48491020318",6960,212,283,30,1399,0,1275,0,10159
"48491020319",4589,88,95,0,495,22,887,9,6185
"48491020320",7303,269,123,0,526,0,1273,42,9536
"48491020321",1393,97,39,0,171,5,534,93,2332
"48491020322",7404,494,399,0,609,0,935,259,10100
"48491020323",2571,110,247,0,188,94,532,164,3906
"48491020324",5112,238,279,8,514,56,1100,56,7363
"48491020325",1831,180,680,32,199,283,1006,322,4533
"48491020326",5368,169,26,0,612,92,864,85,7216
"48491020327",1765,25,0,0,307,236,519,0,2852
"48491020328",5183,527,318,102,658,11,1212,189,8200
"48491020403",1561,71,14,16,153,49,255,0,2119
"48491020404",2756,77,34,0,350,82,366,24,3689
"48491020405",3701,392,330,0,1247,60,1413,110,7253
"48491020406",4131,280,570,14,829,70,1075,43,7012
"48491020408",3175,427,652,15,236,62,872,69,5508
"48491020409",2714,99,330,41,575,17,900,27,4703
"48491020410",4059,306,459,116,848,17,908,184,6897
"48491020411",3922,181,454,0,856,48,711,59,6231
"48491020503",4118,120,23,83,402,68,458,44,5316
"48491020504",4845,1939,433,126,1338,291,2405,1110,12487
"48491020505",2018,30,132,22,520,26,367,0,3115
"48491020506",6793,120,564,0,1255,35,1311,95,10173
"48491020507",2031,33,263,0,992,0,515,0,3834
"48491020508",3170,138,348,0,612,31,823,15,5137
"48491020509",5005,63,10,0,1607,0,572,0,7257
"48491020510",7203,130,542,0,2138,71,918,18,11020
"48491020602",3740,153,139,139,550,112,1493,197,6523
"48491020603",7442,306,187,0,1464,0,985,78,10462
"48491020604",4323,251,206,0,479,157,562,157,6135
"48491020605",5869,236,289,0,936,5,1142,93,8570
"48491020701",1547,269,180,9,246,44,1116,233,3644
"48491020703",7563,813,1851,259,1324,28,3834,338,16010
"48491020704",4657,343,543,22,208,261,2926,416,9376
"48491020706",3022,47,282,0,309,0,769,0,4429
"48491020707",3428,41,511,389,362,36,1551,50,6368
"48491020708",4842,109,421,0,1138,0,769,22,7301
"48491020803",2719,418,92,0,543,0,1124,150,5046
"48491020804",7363,446,361,0,1296,41,897,180,10584
"48491020805",6143,301,482,229,144,0,2007,203,9509
"48491020806",1964,52,158,64,136,0,585,48,3007
"48491020807",5125,202,1172,147,285,0,2234,63,9228
"48491020808",1088,54,63,48,99,0,164,8,1524
"48491020809",4315,114,1188,25,565,58,1253,58,7576
"48491020900",3693,434,76,26,91,2,468,138,4928
"48491021000",1307,811,479,189,165,74,979,766,4770
"48491021100",1777,445,251,88,284,77,1124,457,4503
"48491021201",2471,106,49,1,249,0,1014,0,3890
"48491021202",2649,97,212,85,157,0,805,21,4026
"48491021203",1879,364,202,126,388,55,662,168,3844
"48491021300",2547,409,197,56,81,86,678,348,4402
"48491021401",7076,526,465,37,789,113,3567,167,12740
"48491021402",2172,741,177,34,201,157,1101,752,5335
"48491021403",2620,239,122,391,393,18,1534,358,5675
"48491021502",3354,592,436,211,410,109,2284,648,8044
"48491021503",3083,616,288,75,191,103,1128,403,5887
"48491021504",4464,127,420,23,1206,15,1139,57,7451
"48491021505",5440,249,621,18,987,102,3059,174,10650
"48491021506",2298,52,189,0,174,34,889,62,3698
"48491021507",6314,273,651,329,1223,175,3020,151,12136
"48491021508",6255,201,337,22,459,15,1429,110,8828
"48491021601",2851,243,124,0,133,50,943,53,4397
"48491021602",2320,199,0,0,60,148,624,258,3609
"48491021603",1546,59,7,0,60,32,155,40,1899
"48493000102",2687,346,30,0,206,0,580,217,4066
"48493000103",2620,100,63,0,74,38,560,45,3500
"48493000104",3603,556,42,0,128,35,744,239,5347
"48493000201",1777,385,0,0,285,22,975,333,3777
"48493000202",1473,183,11,0,162,0,596,129,2554
"48493000300",3460,726,98,14,336,429,2200,991,8254
"48493000402",1783,216,0,54,208,46,841,209,3357
"48493000403",5927,172,46,0,623,120,2708,248,9844
"48493000404",4881,312,142,52,378,23,1548,245,7581
"48493000500",3299,772,32,9,204,36,836,347,5535
"48493000600",3085,233,0,0,322,72,1682,258,5652
"48495950200",1748,147,29,7,114,9,1073,77,3204
"48495950300",2609,412,105,0,262,130,1671,417,5606
"48495950400",1236,192,25,0,84,12,538,152,2239
"48497150101",3075,231,0,0,92,21,788,0,4207
"48497150102",5570,598,58,0,285,0,919,90,7520
"48497150200",4868,696,148,0,88,181,1263,641,7885
"48497150300",2633,449,0,0,88,0,151,0,3321
"48497150401",4449,877,0,0,96,25,577,175,6199
"48497150402",5076,258,21,0,195,19,389,10,5968
"48497150403",3019,279,24,0,110,5,93,31,3561
"48497150500",4200,1059,58,0,403,113,1748,847,8428
"48497150601",6812,788,0,0,239,44,255,48,8186
"48497150602",5695,359,86,15,340,27,1198,171,7891
"48497150603",4281,302,0,4,387,7,694,95,5770
"48499950100",3483,490,24,0,0,22,257,0,4276
"48499950200",1877,466,103,0,197,4,347,59,3053
"48499950301",2846,383,146,0,89,104,99,33,3700
"48499950302",4510,479,122,53,236,25,466,48,5939
"48499950400",3502,1108,0,0,51,54,248,83,5046
"48499950500",1748,152,73,11,98,5,83,7,2177
"48499950601",2865,417,380,96,61,54,66,45,3984
"48499950602",3760,324,0,0,54,0,176,0,4314
"48499950700",4357,606,37,0,66,157,387,242,5852
"48499950800",3140,573,394,189,225,125,362,316,5324
"48501950100",1812,297,5,0,122,93,899,243,3471
"48501950200",4322,424,107,22,590,86,3319,243,9113
"48503950200",3253,673,15,14,172,153,618,222,5120
"48503950400",4940,604,0,0,47,85,153,25,5854
"48503950500",2190,634,95,0,72,0,619,248,3858
"48503950600",4243,731,32,11,220,0,807,331,6375
"48505950301",2107,2191,0,0,24,0,2110,2191,8623
"48505950302",3237,996,126,20,0,0,3119,949,8447
"48505950400",3685,1596,0,0,0,64,3114,1634,10093
"48507950100",814,317,0,0,0,7,769,297,2204
"48507950200",1292,564,0,0,17,104,1010,640,3627
"48507950301",958,861,0,0,116,0,916,823,3674
"48507950302",3783,1994,0,0,505,181,4196,2110,12769
"49001100100",2705,488,0,0,122,88,122,154,3679
"49001100200",2523,193,0,0,62,120,234,141,3273
"49003960100",2568,398,5,0,41,7,67,2,3088
"49003960200",5516,778,0,0,223,17,326,63,6923
"49003960300",6488,688,0,0,861,0,1007,0,9044
"49003960400",4248,438,0,0,312,50,238,35,5321
"49003960500",4508,204,35,0,220,20,599,35,5621
"49003960601",3518,165,88,0,34,17,120,17,3959
"49003960602",2288,156,0,0,45,0,224,0,2713
"49003960701",3668,529,0,0,336,22,375,27,4957
"49003960702",1998,350,0,0,57,27,104,119,2655
"49003960801",3545,400,24,0,381,17,476,203,5046
"49003960802",3797,101,13,0,488,0,207,0,4606
"49005000101",3927,319,17,0,216,126,222,182,5009
"49005000102",1522,164,1,0,79,30,92,39,1927
"49005000201",2940,418,0,0,125,186,174,189,4032
"49005000202",5826,331,0,8,488,13,280,0,6946
"49005000300",5323,1084,22,0,309,122,846,181,7887
"49005000401",2837,436,16,0,199,13,554,0,4055
"49005000402",2854,181,0,0,197,0,26,0,3258
"49005000403",5197,326,0,18,247,90,125,53,6056
"49005000501",3581,1006,22,18,451,21,872,254,6225
"49005000502",3396,1198,142,0,568,450,425,418,6597
"49005000600",2762,2972,26,9,256,107,277,246,6655
"49005000701",3435,285,108,0,84,0,32,0,3944
"49005000702",517,439,88,14,141,211,25,43,1478
"49005000800",2568,2064,0,48,118,176,177,121,5272
"49005000900",2263,619,19,0,139,45,201,39,3325
"49005001001",1976,426,10,0,407,37,387,142,3385
"49005001002",2664,1241,7,0,774,192,718,835,6431
"49005001101",4762,316,0,0,260,0,406,8,5752
"49005001102",3613,223,30,17,250,15,97,38,4283
"49005001201",4450,155,10,0,222,0,106,58,5001
"49005001202",4630,397,11,37,576,12,565,52,6280
"49005001300",5242,579,2,0,97,50,92,0,6062
"49005001401",3436,631,6,0,200,15,274,355,4917
"49005001402",2830,195,0,0,305,43,610,47,4030
"49005001500",1894,125,4,0,29,0,67,0,2119
"49005980100",105,0,0,0,0,0,0,0,105
"49007000100",3370,237,0,0,91,173,278,141,4290
"49007000200",3447,490,13,0,482,112,549,87,5180
"49007000300",2644,931,18,10,104,106,336,265,4414
"49007000500",3450,319,0,6,196,37,400,46,4454
"49007000600",3398,520,3,1,154,139,338,163,4716
"49009960100",652,61,0,0,10,1,5,13,742
"49011125102",4079,130,0,0,62,0,166,0,4437
"49011125103",4175,191,157,0,278,70,473,0,5344
"49011125104",5306,331,0,9,222,110,410,22,6410
"49011125200",2213,396,179,0,579,53,594,14,4028
"49011125301",3232,574,116,36,685,482,797,461,6383
"49011125303",9499,229,122,22,922,66,1000,51,11911
"49011125304",4387,152,57,16,428,12,648,0,5700
"49011125305",5037,195,150,0,738,216,672,173,7181
"49011125401",10653,504,50,0,406,0,446,39,12098
"49011125403",10229,510,252,0,632,0,846,26,12495
"49011125405",8320,978,26,52,806,102,876,397,11557
"49011125406",5808,231,181,0,1004,132,808,143,8307
"49011125501",4191,312,5,0,690,274,643,269,6384
"49011125502",3815,420,80,43,561,11,850,63,5843
"49011125503",3964,317,79,0,280,0,465,0,5105
"49011125600",174,10,0,0,0,22,0,9,215
"49011125701",2169,830,5,36,612,168,141,388,4349
"49011125702",2891,279,51,110,116,0,280,24,3751
"49011125801",4762,793,116,35,463,333,654,622,7778
"49011125804",5768,313,147,0,667,11,692,31,7629
"49011125805",5430,273,71,23,612,32,847,44,7332
"49011125807",2205,289,173,23,145,468,111,579,3993
"49011125808",3616,914,111,21,943,72,688,146,6511
"49011125905",4583,840,43,13,369,217,244,139,6448
"49011125906",5714,381,58,9,577,0,357,36,7132
"49011125907",1923,22,24,0,34,4,34,0,2041
"49011125908",4247,128,0,0,404,0,224,50,5053
"49011126001",3561,462,24,15,434,27,307,141,4971
"49011126002",5023,268,16,0,48,103,264,103,5825
"49011126101",5164,386,38,0,387,71,399,87,6532
"49011126104",10140,787,60,0,450,14,233,165,11849
"49011126105",6513,115,74,0,71,0,179,0,6952
"49011126202",8270,206,139,0,192,17,254,0,9078
"49011126203",3971,136,63,0,66,39,23,0,4298
"49011126204",4270,390,0,0,196,11,109,0,4976
"49011126303",4257,279,6,0,133,0,210,0,4885
"49011126304",5427,101,71,0,177,0,108,0,5884
"49011126305",2235,11,0,0,46,0,37,0,2329
"49011126306",6304,354,25,0,511,34,278,42,7548
"49011126402",2932,210,0,0,284,0,283,0,3709
"49011126404",5401,423,0,0,326,0,270,113,6533
"49011126405",3599,105,0,0,167,11,186,0,4068
"49011126406",3215,296,0,0,531,32,544,14,4632
"49011126500",5395,477,0,0,377,10,129,0,6388
"49011126600",4127,308,139,0,226,95,164,0,5059
"49011126700",3378,422,14,0,267,128,286,50,4545
"49011126801",2968,130,104,0,147,0,58,0,3407
"49011126802",4380,221,0,28,106,0,93,22,4850
"49011126901",4444,453,0,0,666,53,848,293,6757
"49011126902",4820,511,16,0,161,408,241,115,6272
"49011127002",4465,584,188,0,1509,573,1183,55,8557
"49011127003",4810,156,0,0,199,0,94,0,5259
"49011127004",6750,522,20,0,745,0,347,86,8470
"49011127100",6123,426,16,85,225,255,192,148,7470
"49013940300",4086,251,0,0,75,4,126,4,4546
"49013940500",5919,796,0,0,794,155,656,184,8504
"49013940600",5771,338,6,0,414,127,161,99,6916
"49015976200",3498,263,0,0,105,0,171,25,4062
"49015976300",3053,222,0,0,77,0,40,0,3392
"49015976500",2870,544,0,49,126,2,157,247,3995
"49017000300",2101,266,0,0,25,6,111,0,2509
"49017000400",2117,291,28,0,133,8,103,37,2717
"49019000200",3619,529,16,0,132,61,351,195,4903
"49019000300",3766,599,1,5,364,55,91,241,5122
"49021110100",3158,269,0,20,104,83,31,30,3695
"49021110200",6033,1596,25,24,215,197,122,740,8952
"49021110300",2573,819,23,5,83,97,188,99,3887
"49021110400",2882,973,0,0,45,14,90,103,4107
"49021110500",5849,2384,68,1,703,103,439,362,9909
"49021110600",4002,1355,85,0,478,205,365,129,6619
"49021110701",5192,577,0,0,535,19,223,126,6672
"49021110702",3576,686,0,0,128,0,346,60,4796
"49023010100",4565,680,0,0,209,22,285,27,5788
"49023010200",3733,753,9,0,150,36,73,2,4756
"49025130100",1763,318,13,0,205,7,75,11,2392
"49025130200",4383,229,12,0,144,0,137,39,4944
"49027974100",3897,666,0,14,178,210,200,320,5485
"49027974200",2481,298,28,0,120,4,314,62,3307
"49027974300",3667,263,33,0,337,199,436,255,5190
"49029970100",7826,319,0,0,95,71,199,54,8564
"49029970200",1306,0,0,0,70,0,0,0,1376
"49031960100",1262,441,0,0,30,0,65,83,1881
"49033950100",2081,155,3,0,17,2,30,21,2309
"49035100100",950,141,16,0,225,33,307,49,1721
"49035100200",1087,3,92,0,111,0,81,0,1374
"49035100306",2465,768,82,78,1480,426,1764,700,7763
"49035100307",2386,251,195,312,1692,359,1439,332,6966
"49035100308",1930,510,335,0,830,547,1278,850,6280
"49035100500",3538,456,275,88,1436,493,1962,657,8905
"49035100600",3767,1253,94,20,1289,270,2686,994,10373
"49035100700",1716,472,63,37,290,97,215,62,2952
"49035100800",1545,494,70,0,168,86,151,126,2640
"49035101000",2789,111,19,0,138,112,88,0,3257
"49035101101",1563,187,147,0,60,0,58,10,2025
"49035101102",2529,339,84,17,411,51,409,0,3840
"49035101200",2785,583,0,2,276,99,118,70,3933
"49035101400",1285,836,0,0,632,449,114,160,3476
"49035101500",1574,872,41,26,383,249,194,138,3477
"49035101600",2226,801,0,32,287,214,156,79,3795
"49035101700",1794,388,40,51,354,216,127,75,3045
"49035101800",2410,484,1,0,255,94,148,52,3444
"49035101900",1342,519,10,35,151,155,93,116,2421
"49035102000",1436,393,63,16,355,332,217,301,3113
"49035102100",607,381,0,10,315,38,146,29,1526
"49035102300",1293,485,52,0,753,372,728,162,3845
"49035102500",1406,640,58,82,262,329,124,252,3153
"49035102600",1696,721,142,0,781,645,1158,929,6072
"49035102701",2274,333,146,56,1204,1051,1502,845,7411
"49035102702",1203,546,219,0,1140,712,1437,1122,6379
"49035102801",2237,1148,56,0,2001,957,2141,1254,9794
"49035102802",1997,423,97,33,1229,1045,1175,745,6744
"49035102900",2026,1081,385,173,504,446,705,564,5884
"49035103000",1584,236,54,97,724,64,592,90,3441
"49035103100",2792,679,41,32,427,302,802,132,5207
"49035103200",2958,792,0,29,452,148,316,218,4913
"49035103300",2752,390,133,11,442,42,130,34,3934
"49035103400",3139,419,27,446,320,103,143,91,4688
"49035103500",3495,326,110,2,62,0,75,0,4070
"49035103600",2268,116,0,0,71,39,48,36,2578
"49035103700",2335,267,13,0,68,0,74,0,2757
"49035103800",1869,328,31,6,243,36,111,0,2624
"49035103900",3427,392,9,0,407,44,349,0,4628
"49035104000",2810,230,38,0,130,0,119,0,3327
"49035104100",2524,205,0,0,225,43,124,0,3121
"49035104200",5202,635,70,0,970,0,102,0,6979
"49035104300",2125,349,23,0,184,78,169,0,2928
"49035104400",1936,46,0,0,148,0,45,0,2175
"49035104700",4419,480,0,0,147,182,314,39,5581
"49035104800",4265,332,0,0,449,16,241,0,5303
"49035104900",2615,178,151,54,205,46,388,13,3650
"49035110102",3745,210,21,0,274,71,160,21,4502
"49035110103",3469,134,0,0,141,0,199,0,3943
"49035110104",4888,90,0,0,275,7,121,0,5381
"49035110200",5013,156,0,4,227,2,187,0,5589
"49035110300",4587,365,0,0,398,0,210,36,5596
"49035110401",2603,125,102,0,217,76,50,48,3221
"49035110402",3224,158,69,25,231,33,93,3,3836
"49035110500",5361,271,0,0,337,21,186,26,6202
"49035110600",4841,148,0,0,175,0,134,0,5298
"49035110701",2689,483,51,0,521,37,113,43,3937
"49035110702",4202,228,43,0,536,94,310,36,5449
"49035110800",3889,605,9,0,362,73,306,63,5307
"49035110900",3998,369,0,0,229,1,119,11,4727
"49035111001",4373,113,0,0,92,22,86,0,4686
"49035111002",4517,447,0,0,466,21,105,182,5738
"49035111101",5300,590,195,0,352,15,733,87,7272
"49035111102",4700,387,202,1,261,144,237,117,6049
"49035111103",5308,367,0,0,171,0,348,0,6194
"49035111201",2336,237,0,0,209,15,75,72,2944
"49035111202",3990,113,119,0,560,25,230,25,5062
"49035111302",5218,192,0,0,142,117,22,0,5691
"49035111304",3263,136,8,0,125,61,31,0,3624
"49035111305",3831,127,79,0,237,0,326,0,4600
"49035111306",1952,115,14,0,412,0,199,0,2692
"49035111400",3480,1226,40,31,384,1668,625,1466,8920
"49035111500",798,188,29,8,217,52,382,96,1770
"49035111600",2518,1017,106,40,1031,734,765,918,7129
"49035111701",2968,1319,84,0,1011,269,1398,900,7949
"49035111702",2765,330,264,0,756,116,1141,145,5517
"49035111801",3919,311,41,447,493,305,336,61,5913
"49035111802",1616,341,10,18,210,105,211,34,2545
"49035111903",3493,243,10,12,310,0,571,0,4639
"49035111904",2905,382,88,6,172,73,112,0,3738
"49035111905",2696,327,71,58,149,82,342,103,3828
"49035111906",2362,583,12,323,543,225,720,145,4913
"49035112001",2821,320,0,0,168,120,252,210,3891
"49035112002",3425,599,18,0,14,15,172,35,4278
"49035112100",5232,1018,143,0,538,340,548,45,7864
"49035112201",4627,182,89,145,388,0,578,57,6066
"49035112202",3066,634,18,32,134,25,298,268,4475
"49035112301",3068,379,59,0,466,20,433,207,4632
"49035112302",3296,207,0,0,94,159,196,178,4130
"49035112402",3349,1154,29,17,776,441,948,983,7697
"49035112403",3284,796,76,26,557,224,1488,767,7218
"49035112404",2771,886,33,0,584,343,1238,848,6703
"49035112501",3230,394,14,15,188,56,472,35,4404
"49035112502",4569,643,49,0,853,107,319,145,6685
"49035112503",3809,227,105,0,479,110,622,90,5442
"49035112604",4417,222,0,0,143,18,242,0,5042
"49035112605",5905,444,45,0,844,28,486,69,7821
"49035112608",4889,220,0,0,203,0,352,0,5664
"49035112609",5067,347,116,0,170,22,101,0,5823
"49035112610",3023,732,15,294,272,63,289,198,4886
"49035112611",5707,213,0,0,464,60,506,0,6950
"49035112612",3010,654,11,4,454,91,539,251,5014
"49035112613",4275,196,0,0,139,0,150,9,4769
"49035112614",2740,74,26,0,270,0,16,0,3126
"49035112615",2129,124,0,0,70,0,21,14,2358
"49035112616",3365,434,56,0,438,18,46,99,4456
"49035112617",3349,66,14,0,40,107,75,107,3758
"49035112618",2718,223,8,0,315,10,358,2,3634
"49035112619",2435,105,0,0,478,70,469,30,3587
"49035112700",3799,510,60,0,435,48,626,38,5516
"49035112804",4914,305,0,0,420,54,597,0,6290
"49035112805",4968,214,43,0,415,2,275,0,5917
"49035112810",6466,673,38,0,96,15,583,145,8016
"49035112812",3921,647,11,0,434,13,290,0,5316
"49035112813",4653,305,11,0,757,26,433,50,6235
"49035112814",4057,239,0,4,313,5,146,0,4764
"49035112815",5015,137,29,0,277,0,334,0,5792
"49035112816",4596,34,0,0,180,132,170,0,5112
"49035112817",5249,843,0,0,541,106,278,77,7094
"49035112818",0,0,0,0,0,0,0,0,0
"49035112819",6405,261,15,0,387,39,191,0,7298
"49035112820",6620,326,149,0,986,67,695,46,8889
"49035112821",6330,278,91,0,301,0,291,79,7370
"49035112822",3810,498,12,0,244,88,231,301,5184
"49035112823",3812,322,104,0,468,42,415,0,5163
"49035112904",5090,190,11,28,904,166,1364,169,7922
"49035112905",4846,173,8,0,603,75,567,0,6272
"49035112907",3143,780,0,38,368,48,534,536,5447
"49035112912",2089,144,34,5,257,28,359,11,2927
"49035112913",4690,133,0,0,362,0,774,0,5959
"49035112914",4574,914,168,0,672,141,654,489,7612
"49035112916",3741,216,18,0,561,47,1013,83,5679
"49035112917",3199,126,143,0,379,43,211,90,4191
"49035112918",3955,496,102,0,595,139,945,376,6608
"49035112920",3556,241,40,0,307,76,571,5,4796
"49035112921",3081,101,37,0,361,13,279,13,3885
"49035113007",4835,147,0,0,527,7,664,7,6187
"49035113008",5792,161,36,0,422,0,362,41,6814
"49035113010",6195,293,9,0,234,0,331,58,7120
"49035113011",5204,89,0,0,230,0,157,0,5680
"49035113012",4298,311,0,0,409,0,185,24,5227
"49035113013",4631,237,32,0,304,97,258,44,5603
"49035113014",3543,60,0,12,139,0,90,10,3854
"49035113016",5603,61,45,0,803,0,406,0,6918
"49035113017",6975,99,0,0,129,0,105,0,7308
"49035113019",5669,80,0,0,576,8,123,0,6456
"49035113020",11043,318,116,0,870,0,636,0,12983
"49035113101",5661,898,81,0,671,47,1107,465,8930
"49035113102",3279,113,58,0,308,0,539,0,4297
"49035113105",3681,104,0,0,442,0,313,22,4562
"49035113107",19642,1335,139,76,867,359,1958,16,24392
"49035113108",3610,226,72,0,376,26,474,93,4877
"49035113305",3609,696,192,407,2112,1314,2545,890,11765
"49035113306",3011,754,91,15,1160,457,1263,667,7418
"49035113307",2850,915,237,122,2001,1366,2349,1785,11625
"49035113308",2218,616,68,290,2054,404,1541,779,7970
"49035113309",3325,820,182,1,398,819,738,1048,7331
"49035113310",1467,338,0,0,581,331,310,414,3441
"49035113406",3550,1324,26,0,1124,615,2008,1186,9833
"49035113407",7788,906,272,109,1108,140,2207,455,12985
"49035113408",4479,1033,0,0,775,206,1418,498,8409
"49035113409",4931,221,83,17,720,87,1687,76,7822
"49035113410",4047,600,149,0,952,379,1163,206,7496
"49035113411",2095,181,8,0,492,71,516,151,3514
"49035113412",1659,187,0,0,835,173,760,112,3726
"49035113413",4315,341,88,0,735,46,1321,120,6966
"49035113505",4637,1032,44,80,517,606,1227,1210,9353
"49035113509",3116,755,70,297,1589,678,1417,1095,9017
"49035113510",2590,115,56,0,428,249,562,53,4053
"49035113511",2753,372,8,137,528,401,518,333,5050
"49035113512",2115,424,9,46,698,215,518,333,4358
"49035113513",4247,620,351,216,569,215,1743,523,8484
"49035113514",3336,603,0,7,925,576,875,443,6765
"49035113515",4794,290,0,133,671,15,245,19,6167
"49035113520",2797,396,63,40,657,126,444,316,4839
"49035113521",4698,577,234,39,381,9,1046,228,7212
"49035113522",2992,156,17,0,177,36,497,0,3875
"49035113523",5116,655,91,0,513,79,1794,499,8747
"49035113525",4723,364,59,8,1358,212,1413,155,8292
"49035113526",3740,288,43,0,640,314,1032,159,6216
"49035113527",3182,130,0,0,621,428,1080,489,5930
"49035113528",4605,171,27,5,254,161,875,0,6098
"49035113532",3104,237,0,0,150,14,467,50,4022
"49035113533",4470,96,27,0,388,9,360,10,5360
"49035113534",5995,389,62,0,989,0,1546,259,9240
"49035113535",5959,432,19,0,355,80,731,59,7635
"49035113536",2296,642,0,0,733,447,1335,630,6083
"49035113537",2541,189,0,0,561,126,818,9,4244
"49035113538",1859,963,68,0,782,124,967,851,5614
"49035113539",2973,666,31,0,381,113,1104,367,5635
"49035113600",4001,871,21,0,505,114,1534,251,7297
"49035113701",2898,829,10,0,299,12,866,555,5469
"49035113702",2255,450,0,0,203,10,798,65,3781
"49035113801",4342,278,19,0,468,313,1735,67,7222
"49035113802",2445,489,0,0,190,464,394,627,4609
"49035113803",6470,526,69,0,1545,213,2461,353,11637
"49035113903",4364,355,8,0,538,300,1297,325,7187
"49035113904",4042,698,0,0,486,0,810,162,6198
"49035113905",5603,692,35,0,1107,214,1513,429,9593
"49035113906",2559,1104,25,12,362,109,461,295,4927
"49035113907",6435,817,97,12,446,0,1588,399,9794
"49035114000",1026,254,0,14,448,234,353,182,2511
"49035114100",2057,163,48,8,127,0,109,20,2532
"49035114200",3553,255,6,0,436,44,336,51,4681
"49035114300",14075,1190,368,48,1112,184,2324,509,19810
"49035114500",3927,556,26,0,1413,115,2203,324,8564
"49035114600",6505,762,0,0,341,0,310,18,7936
"49035114700",2484,914,117,58,927,164,967,660,6291
"49035114800",2912,70,0,0,244,0,24,0,3250
"49035115106",7366,237,0,0,280,78,585,78,8624
"49035115209",5996,503,43,0,254,311,1171,129,8407
"49035980000",0,0,0,0,0,0,0,0,0
"49037942000",111,0,0,0,2019,1299,3,0,3432
"49037942100",40,4,0,0,1316,1423,13,0,2796
"49037978100",2807,401,0,0,162,47,249,119,3785
"49037978200",3226,372,0,0,849,370,181,121,5119
"49039972100",6233,909,11,0,353,43,445,60,8054
"49039972200",3265,252,4,0,171,166,309,224,4391
"49039972300",2799,359,5,22,313,82,305,218,4103
"49039972400",3793,1637,30,58,298,24,322,137,6299
"49039972500",3735,359,16,0,128,22,51,14,4325
"49041975100",3953,370,2,0,142,134,156,122,4879
"49041975200",2351,174,0,0,25,0,77,6,2633
"49041975300",3493,797,0,21,133,56,153,75,4728
"49041975400",2535,546,0,0,92,49,79,90,3391
"49041975500",4173,898,0,0,150,55,83,87,5446
"49043964101",1607,186,0,0,67,3,68,36,1967
"49043964102",2926,357,0,0,99,13,349,178,3922
"49043964201",3460,287,6,5,76,87,304,183,4408
"49043964202",2861,101,0,0,14,1,198,39,3214
"49043964203",81,0,0,0,71,0,98,0,250
"49043964303",2523,79,21,0,38,0,97,0,2758
"49043964304",4268,335,0,0,482,0,280,161,5526
"49043964305",1571,152,23,0,117,0,135,59,2057
"49043964306",2143,37,27,0,126,0,265,0,2598
"49043964307",4472,124,20,0,126,0,113,0,4855
"49043964308",2381,427,0,0,147,125,88,291,3459
"49043964401",1252,121,0,0,29,99,21,10,1532
"49043964402",2833,535,28,0,50,68,674,567,4755
"49045130600",1463,375,10,3,161,40,654,340,3046
"49045130701",3261,549,0,93,37,9,223,14,4186
"49045130702",12782,410,23,7,227,143,1276,0,14868
"49045130703",6966,200,0,0,130,23,317,78,7714
"49045130800",4367,650,0,0,171,91,171,114,5564
"49045130900",3005,714,22,0,396,15,422,206,4780
"49045131001",1984,246,267,0,449,0,183,0,3129
"49045131002",6675,434,6,9,703,74,1028,0,8929
"49045131100",7138,636,33,0,122,10,1069,157,9165
"49045131200",2451,364,11,0,338,0,494,55,3713
"49045980000",0,0,0,0,0,0,0,0,0
"49047940201",2953,133,0,0,1838,721,154,70,5869
"49047968200",6356,469,0,0,316,223,208,197,7769
"49047968301",4126,787,56,0,394,35,218,207,5823
"49047968302",3964,237,0,0,8,45,196,45,4495
"49047968401",3341,303,0,0,522,238,566,194,5164
"49047968402",5465,454,0,0,161,209,215,188,6692
"49049000102",4130,309,0,0,147,115,431,159,5291
"49049000103",3277,197,36,0,140,36,145,10,3841
"49049000104",2826,205,0,0,102,25,159,0,3317
"49049000105",3945,18,0,0,59,0,106,0,4128
"49049000203",3784,317,0,0,275,0,458,79,4913
"49049000204",4426,467,0,0,269,183,180,78,5603
"49049000205",3224,219,0,0,308,0,142,0,3893
"49049000206",3002,177,59,0,180,0,278,54,3750
"49049000400",2496,839,0,0,107,67,271,19,3799
"49049000504",3286,622,10,17,180,26,133,54,4328
"49049000505",2881,171,0,0,115,0,498,0,3665
"49049000506",3215,379,9,0,82,48,271,25,4029
"49049000507",1770,84,19,0,12,6,164,0,2055
"49049000508",4039,524,13,0,81,0,289,176,5122
"49049000509",5482,1159,0,17,256,0,661,410,7985
"49049000601",2627,293,11,0,151,44,178,129,3433
"49049000603",3491,495,0,0,227,41,177,64,4495
"49049000604",2620,148,0,0,174,0,641,0,3583
"49049000703",4312,632,31,0,319,457,759,481,6991
"49049000706",4911,547,6,0,398,131,849,227,7069
"49049000707",2971,604,8,0,315,85,455,367,4805
"49049000708",2117,293,0,0,601,0,295,0,3306
"49049000709",2383,197,59,0,189,31,351,30,3240
"49049000710",2525,31,10,0,235,89,127,2,3019
"49049000711",1925,67,22,0,151,0,22,0,2187
"49049000801",3620,903,24,0,757,107,815,367,6593
"49049000802",3393,1312,0,0,328,88,688,466,6275
"49049000901",3406,1325,0,37,517,169,853,559,6866
"49049000903",2495,542,3,0,358,0,223,12,3633
"49049000904",2325,331,11,9,164,18,126,0,2984
"49049001001",3260,228,0,0,254,0,218,110,4070
"49049001002",2161,191,0,0,34,0,144,0,2530
"49049001103",1839,297,0,0,210,47,198,107,2698
"49049001105",2632,769,0,0,183,49,264,107,4004
"49049001106",2277,306,0,0,227,9,296,9,3124
"49049001107",3167,358,0,13,66,95,257,0,3956
"49049001108",2206,875,101,56,172,21,487,555,4473
"49049001201",3190,697,0,0,187,136,192,58,4460
"49049001202",3335,447,33,0,897,387,1028,300,6427
"49049001300",2601,564,50,0,160,82,145,172,3774
"49049001401",2408,618,0,42,313,0,40,201,3622
"49049001402",2653,1781,70,7,522,288,723,430,6474
"49049001501",3881,341,0,52,152,46,136,42,4650
"49049001503",3461,130,25,0,296,9,320,9,4250
"49049001504",2973,1066,0,24,287,181,267,62,4860
"49049001601",466,1640,0,40,102,327,18,120,2713
"49049001602",67,641,0,0,19,69,43,67,906
"49049001603",1092,1420,2,13,213,312,71,111,3234
"49049001701",3210,571,19,24,52,115,69,16,4076
"49049001702",2108,1669,0,0,519,123,837,127,5383
"49049001801",1766,4337,0,91,94,351,250,220,7109
"49049001802",2077,3059,0,0,136,210,165,121,5768
"49049001803",1032,1041,0,0,64,132,64,194,2527
"49049001900",2205,1243,100,15,298,379,319,258,4817
"49049002000",4366,780,21,0,646,517,1299,516,8145
"49049002101",3120,520,16,0,229,197,189,0,4271
"49049002102",1977,303,29,90,293,52,218,123,3085
"49049002201",3182,988,0,53,219,10,386,181,5019
"49049002204",3201,151,19,0,255,44,827,78,4575
"49049002205",3311,205,0,0,456,175,828,32,5007
"49049002206",2451,462,45,0,225,145,585,362,4275
"49049002207",2786,118,0,0,396,354,839,383,4876
"49049002300",2379,1143,16,16,594,69,648,708,5573
"49049002400",497,367,0,0,136,0,210,32,1242
"49049002500",2388,1353,31,0,329,171,443,669,5384
"49049002701",2605,314,0,7,192,4,460,13,3595
"49049002702",2863,1168,37,0,715,266,998,343,6390
"49049002801",1698,1198,0,0,512,639,855,950,5852
"49049002802",709,418,0,0,246,155,371,102,2001
"49049002901",4341,104,18,0,721,45,738,0,5967
"49049002902",2719,240,0,0,185,8,818,55,4025
"49049003001",3498,282,0,0,256,159,221,89,4505
"49049003002",2063,196,0,0,35,25,93,0,2412
"49049003103",2542,0,13,0,225,0,58,0,2838
"49049003104",3663,202,0,0,346,0,92,66,4369
"49049003105",3076,311,0,0,24,0,241,9,3661
"49049003106",2174,276,0,0,341,0,300,0,3091
"49049003201",2190,122,12,0,335,0,519,0,3178
"49049003203",3611,177,9,0,117,0,156,0,4070
"49049003204",2393,179,0,0,82,29,200,67,2950
"49049003205",3751,160,0,0,80,2,77,2,4072
"49049003300",5613,352,24,19,420,20,770,120,7338
"49049003401",2700,351,0,0,36,21,20,0,3128
"49049003402",5162,641,14,27,473,165,888,314,7684
"49049003403",4079,410,73,0,364,185,709,317,6137
"49049010103",6143,333,12,0,257,70,590,0,7405
"49049010104",6340,491,76,0,160,0,307,0,7374
"49049010105",7115,620,178,0,552,0,434,0,8899
"49049010106",3943,96,124,238,234,0,164,0,4799
"49049010107",1858,62,0,0,190,0,63,0,2173
"49049010108",5645,675,20,0,260,474,326,517,7917
"49049010109",6952,231,0,0,313,91,353,0,7940
"49049010110",1537,12,0,0,57,0,51,0,1657
"49049010111",6835,326,0,0,1013,0,692,39,8905
"49049010112",5171,97,37,0,59,0,228,0,5592
"49049010113",4704,77,0,0,145,18,219,0,5163
"49049010208",3851,176,0,0,71,4,13,51,4166
"49049010209",4729,199,0,0,386,0,285,0,5599
"49049010210",5331,393,55,5,307,0,69,0,6160
"49049010211",3154,79,0,0,101,11,27,0,3372
"49049010212",3531,70,17,0,472,0,438,0,4528
"49049010213",1938,225,15,0,176,84,51,38,2527
"49049010214",5163,130,12,0,405,84,426,0,6220
"49049010215",6195,400,0,0,219,11,279,167,7271
"49049010216",2864,21,0,0,37,23,175,0,3120
"49049010217",4358,102,30,0,128,53,66,43,4780
"49049010218",5642,360,12,0,63,0,131,0,6208
"49049010219",3773,509,0,0,57,0,78,37,4454
"49049010220",6248,199,0,0,250,0,269,0,6966
"49049010303",3777,205,0,2,499,121,161,68,4833
"49049010304",5974,520,0,0,217,91,485,60,7347
"49049010305",2340,65,23,0,308,0,230,21,2987
"49049010404",4025,253,0,0,165,12,210,4,4669
"49049010405",3963,100,39,0,236,0,122,0,4460
"49049010406",1780,155,65,0,21,0,11,0,2032
"49049010407",2076,160,58,0,81,39,77,47,2538
"49049010408",2981,290,25,6,187,0,216,0,3705
"49049010409",2426,159,8,0,77,0,78,0,2748
"49049010410",3000,335,0,0,172,91,649,163,4410
"49049010411",4479,207,9,0,208,75,158,80,5216
"49049010503",2001,94,0,0,0,0,6,0,2101
"49049010504",2833,233,0,9,101,18,251,0,3445
"49049010505",3043,560,7,0,419,0,324,0,4353
"49049010506",1436,32,0,0,116,191,154,181,2110
"49049010600",3317,254,4,0,73,22,229,105,4004
"49049010700",3752,516,40,20,182,65,84,11,4670
"49049010900",1360,13,0,0,43,0,113,0,1529
"49049980100",0,0,0,0,0,0,0,0,0
"49051940500",8125,753,50,16,204,138,960,345,10591
"49051960100",3135,474,7,0,187,17,764,73,4657
"49051960200",4938,582,0,0,201,34,399,351,6505
"49051960400",5166,311,0,0,47,0,257,13,5794
"49053270100",7051,1902,3,3,112,37,130,48,9286
"49053270200",2642,239,0,0,91,0,100,16,3088
"49053270300",5729,1039,0,2,797,62,557,211,8397
"49053270400",5561,817,0,20,205,13,387,17,7020
"49053270500",6354,367,21,0,429,0,175,15,7361
"49053270600",5625,1137,21,0,278,354,510,329,8254
"49053270700",7799,916,140,14,927,520,1461,516,12293
"49053270801",10843,1934,43,15,815,0,723,398,14771
"49053270802",4166,1222,0,0,141,561,722,312,7124
"49053270901",2724,806,0,0,121,0,251,0,3902
"49053270902",8418,922,0,0,450,140,677,30,10637
"49053271000",3172,781,35,11,108,55,296,135,4593
"49053271100",8223,1097,95,0,587,42,1245,163,11452
"49053271200",1891,811,6,64,59,26,92,337,3286
"49053271300",2023,1268,28,36,98,326,443,488,4710
"49053271400",3087,920,0,0,118,174,477,97,4873
"49053271500",4894,1081,7,0,392,0,694,30,7098
"49053271600",5391,359,0,0,230,0,199,30,6209
"49053271701",8391,545,0,0,426,0,584,0,9946
"49053271702",4430,415,0,0,433,192,318,102,5890
"49053271800",2719,184,0,0,157,34,50,0,3144
"49055979100",2185,463,17,0,29,35,97,32,2858
"49057200100",3186,354,39,0,644,177,1040,217,5657
"49057200202",1947,522,98,30,330,279,590,388,4184
"49057200203",3517,296,43,0,413,964,861,948,7042
"49057200204",3373,158,54,0,431,285,727,285,5313
"49057200300",4027,1044,60,0,1160,532,1755,773,9351
"49057200400",711,275,21,0,366,146,438,81,2038
"49057200500",4527,731,36,0,867,441,1392,684,8678
"49057200600",3394,605,116,0,263,61,400,28,4867
"49057200700",2546,256,67,0,146,178,89,134,3416
"49057200800",2839,1048,0,57,575,333,1183,762,6797
"49057200900",1895,1135,0,77,621,335,1082,773,5918
"49057201100",672,307,34,56,77,96,99,26,1367
"49057201200",669,696,112,49,531,332,836,610,3835
"49057201301",1599,487,43,23,574,157,1007,240,4130
"49057201302",1694,911,53,0,676,391,815,717,5257
"49057201400",2240,402,0,0,400,61,398,98,3599
"49057201500",2881,232,19,0,196,0,147,0,3475
"49057201600",2898,974,13,0,249,277,213,423,5047
"49057201700",1618,836,0,0,896,215,1127,539,5231
"49057201800",768,314,0,41,298,323,510,537,2791
"49057201900",480,257,55,11,108,277,251,342,1781
"49057202000",4798,710,0,115,297,92,353,44,6409
"49057210100",6689,326,81,0,178,6,133,18,7431
"49057210201",4066,115,78,0,192,0,297,0,4748
"49057210203",2456,159,0,0,35,0,28,0,2678
"49057210204",4023,296,0,6,79,0,124,126,4654
"49057210302",7039,142,12,0,937,17,811,9,8967
"49057210303",6286,252,26,0,221,0,201,0,6986
"49057210304",3384,90,0,0,126,0,328,0,3928
"49057210402",5317,324,46,0,401,49,301,75,6513
"49057210403",7589,42,0,0,222,0,281,0,8134
"49057210404",1631,101,0,4,41,5,27,9,1818
"49057210504",8286,341,0,0,175,0,287,0,9089
"49057210505",6387,421,0,26,250,148,432,112,7776
"49057210506",8734,626,671,0,777,270,1273,615,12966
"49057210508",1775,4,7,0,253,40,315,40,2434
"49057210509",3431,621,0,0,424,6,717,280,5479
"49057210510",3149,17,0,0,540,12,483,0,4201
"49057210511",3029,251,59,0,500,53,616,0,4508
"49057210512",3600,505,0,0,255,212,783,203,5558
"49057210600",5457,555,53,0,280,124,521,0,6990
"49057210701",4300,618,26,53,626,44,633,166,6466
"49057210703",2010,117,0,0,20,57,204,47,2455
"49057210704",5141,229,50,0,547,46,873,91,6977
"49057210800",1953,506,8,0,372,332,635,207,4013
"49057210900",4890,626,157,0,798,4,1062,0,7537
"49057211000",2713,150,37,0,140,111,212,69,3432
"49057211100",4562,363,16,183,219,264,376,231,6214
"49057211201",3394,448,75,0,309,0,339,0,4565
"49057211202",5790,165,42,0,435,47,486,11,6976
"50001960100",3354,317,26,3,83,0,22,0,3805
"50001960200",2503,207,24,9,29,0,14,0,2786
"50001960300",2105,240,12,71,65,40,33,8,2574
"50001960400",4550,326,22,1,126,12,143,33,5213
"50001960500",3386,357,0,0,100,28,67,0,3938
"50001960600",2261,318,0,0,66,6,4,41,2696
"50001960700",3137,717,9,42,122,9,26,0,4062
"50001960800",1526,413,0,0,22,49,24,0,2034
"50001960900",4623,444,19,18,99,0,90,0,5293
"50001961000",1998,238,6,0,69,10,41,0,2362
"50003970200",2006,37,0,0,12,0,8,0,2063
"50003970300",965,134,2,3,28,12,38,13,1195
"50003970400",4034,221,3,12,28,51,91,13,4453
"50003970500",1132,95,5,0,10,0,20,0,1262
"50003970600",2612,260,1,0,25,7,25,0,2930
"50003970700",2147,182,17,1,57,0,18,0,2422
"50003970800",3200,301,0,0,74,0,29,0,3604
"50003970900",1392,699,3,0,52,80,50,45,2321
"50003971000",2209,373,4,0,61,134,55,0,2836
"50003971100",3658,588,4,0,102,54,40,0,4446
"50003971200",3378,1192,50,22,112,29,55,18,4856
"50003971300",2975,400,0,0,117,13,0,0,3505
"50005957000",3248,678,15,0,45,24,22,0,4032
"50005957100",1938,173,38,0,23,0,9,0,2181
"50005957200",1988,474,44,0,23,3,38,11,2581
"50005957300",2135,573,0,0,0,93,11,0,2812
"50005957400",2615,676,22,0,196,5,17,14,3545
"50005957500",3182,447,16,0,109,6,163,13,3936
"50005957600",1945,226,0,0,40,0,9,0,2220
"50005957700",2528,378,0,0,74,4,0,0,2984
"50005957800",2613,276,4,0,26,0,13,0,2932
"50005957900",2840,194,1,0,108,6,13,6,3168
"50007000100",3685,326,46,7,310,219,133,57,4783
"50007000200",4834,304,145,16,240,0,71,0,5610
"50007000300",1975,564,77,22,436,392,0,0,3466
"50007000400",1512,700,112,191,294,181,31,0,3021
"50007000500",1650,2047,47,46,124,104,64,47,4129
"50007000600",2537,1149,164,35,259,48,57,46,4295
"50007000800",2074,435,26,53,132,13,134,21,2888
"50007000900",1627,508,0,86,46,29,32,14,2342
"50007001000",1328,553,104,38,109,131,42,17,2322
"50007001100",1886,238,0,0,54,153,46,5,2382
"50007002101",2464,222,16,0,197,4,49,0,2952
"50007002102",7001,368,17,0,115,0,124,0,7625
"50007002200",5250,784,0,45,300,14,125,31,6549
"50007002301",2008,124,0,0,64,0,31,0,2227
"50007002302",5791,459,16,18,122,58,77,98,6639
"50007002400",2084,416,167,185,144,89,8,30,3123
"50007002500",2840,837,72,0,177,113,58,10,4107
"50007002601",4615,243,103,0,282,0,173,0,5416
"50007002602",3450,315,62,14,219,0,0,0,4060
"50007002701",4958,161,95,0,129,0,138,0,5481
"50007002702",4430,278,74,7,251,0,37,0,5077
"50007002800",4695,160,17,16,118,8,42,32,5088
"50007002900",5770,199,30,0,179,3,27,0,6208
"50007003000",3667,109,0,102,182,0,26,0,4086
"50007003100",7722,426,105,0,416,62,159,14,8904
"50007003301",3250,27,0,0,487,0,56,0,3820
"50007003304",5056,242,241,0,154,90,59,0,5842
"50007003400",6812,271,0,0,167,8,114,0,7372
"50007003501",3484,96,15,0,153,2,157,0,3907
"50007003502",4676,207,15,1,116,140,3,1,5159
"50007003503",1790,141,12,0,27,15,24,11,2020
"50007003600",3214,320,47,0,302,8,113,0,4004
"50007003900",1083,409,0,23,46,16,44,11,1632
"50007004002",3937,97,159,0,152,132,49,11,4537
"50007980000",0,0,0,0,0,0,0,0,0
"50009950100",1627,320,30,1,5,8,23,3,2017
"50009950200",767,194,0,3,15,7,0,0,986
"50009950500",2710,449,18,5,83,8,39,5,3317
"50011010100",5974,762,20,0,181,69,74,5,7085
"50011010200",3754,541,4,37,92,69,114,21,4632
"50011010300",2524,581,17,4,193,0,45,7,3371
"50011010400",3125,263,3,0,89,3,34,14,3531
"50011010500",5190,817,0,8,291,100,0,70,6476
"50011010600",5259,246,81,0,157,17,23,9,5792
"50011010700",2559,497,12,2,207,36,0,34,3347
"50011010800",2901,476,11,0,121,49,9,1,3568
"50011010900",4261,102,0,0,198,0,81,0,4642
"50011011000",5286,156,0,0,111,2,61,0,5616
"50013020100",2820,202,0,0,132,5,46,2,3207
"50013020200",3371,258,22,0,153,16,36,9,3865
"50015953000",1937,399,3,9,52,10,5,8,2423
"50015953100",3199,362,0,0,122,0,21,0,3704
"50015953200",2122,565,44,10,211,0,68,0,3020
"50015953300",2498,306,0,0,132,15,69,18,3038
"50015953400",2207,219,0,0,40,8,0,0,2474
"50015953500",4322,683,28,0,126,23,87,0,5269
"50015953600",3857,404,0,0,56,8,51,0,4376
"50017959000",1874,336,0,0,34,11,22,9,2286
"50017959101",1773,302,28,6,68,0,24,19,2220
"50017959102",2088,352,13,0,67,17,19,8,2564
"50017959200",2962,364,11,0,6,0,90,0,3433
"50017959300",2132,237,0,0,36,9,0,9,2423
"50017959400",3505,666,0,0,57,12,9,30,4279
"50017959500",3714,362,17,11,187,11,39,0,4341
"50017959600",2195,283,0,0,105,0,17,0,2600
"50017959700",1440,149,2,2,39,13,11,0,1656
"50017959800",2113,558,10,0,59,0,0,0,2740
"50019951100",1785,462,0,0,25,9,14,10,2305
"50019951200",2273,268,40,0,145,3,14,0,2743
"50019951300",1488,274,28,0,26,25,0,0,1841
"50019951400",1527,161,0,0,15,0,6,0,1709
"50019951500",1650,707,17,0,31,6,6,0,2417
"50019951600",3924,588,9,0,52,9,51,4,4637
"50019951700",3406,523,3,1,54,5,105,11,4108
"50019951800",2142,350,21,39,60,58,16,7,2693
"50019951900",2011,320,8,0,30,12,52,0,2433
"50019952000",1478,225,0,0,24,2,10,2,1741
"50021962100",1605,112,0,0,49,2,20,0,1788
"50021962200",3448,422,13,0,28,16,0,0,3927
"50021962300",1977,314,0,0,31,3,12,0,2337
"50021962400",2470,456,6,0,23,0,7,0,2962
"50021962500",1573,142,2,0,2,0,17,0,1736
"50021962600",1942,293,11,0,21,5,80,0,2352
"50021962700",3699,229,49,1,47,0,0,0,4025
"50021962800",2442,277,3,0,75,0,53,0,2850
"50021963000",3293,572,4,0,157,0,23,15,4064
"50021963100",2922,605,8,28,11,32,18,0,3624
"50021963200",2450,384,0,0,101,33,17,0,2985
"50021963300",4170,734,23,0,131,0,71,0,5129
"50021963400",2168,292,15,0,79,8,10,0,2572
"50021963500",1497,150,7,0,61,0,9,0,1724
"50021963600",3018,727,32,0,21,76,13,0,3887
"50021963700",2180,297,0,0,222,0,221,0,2920
"50021963800",3480,589,4,0,69,4,9,4,4159
"50021964000",2867,359,0,0,80,17,29,0,3352
"50021964200",1472,203,0,0,43,2,33,3,1756
"50021964300",1202,247,0,2,23,22,5,6,1507
"50023954000",3496,630,62,0,165,25,90,29,4497
"50023954100",2087,209,0,0,141,3,24,0,2464
"50023954200",2520,168,15,0,81,32,23,11,2850
"50023954300",4542,336,26,0,126,0,0,33,5063
"50023954400",2717,157,0,0,75,27,169,13,3158
"50023954500",2229,232,9,30,169,0,39,0,2708
"50023954600",1940,143,27,0,25,52,32,0,2219
"50023954700",1279,193,0,0,23,8,7,0,1510
"50023954800",2074,150,18,0,41,0,0,0,2283
"50023954900",1499,132,0,0,64,0,15,0,1710
"50023955000",2321,205,24,0,27,0,93,39,2709
"50023955100",3362,732,0,0,52,38,0,0,4184
"50023955200",3456,658,234,7,101,6,0,0,4462
"50023955300",3847,98,0,0,19,23,36,0,4023
"50023955400",3651,145,0,0,135,0,136,0,4067
"50023955500",4532,667,0,0,112,6,174,0,5491
"50023955600",1387,134,0,0,27,0,9,0,1557
"50023955700",1624,143,4,0,23,0,13,0,1807
"50023955800",1078,50,0,0,4,0,0,0,1132
"50025967000",2265,543,47,0,128,24,43,24,3074
"50025967100",1714,346,0,0,93,0,35,14,2202
"50025967200",2444,441,10,0,75,14,31,27,3042
"50025967300",1324,70,27,0,43,0,0,0,1464
"50025967400",766,122,0,0,38,0,4,0,930
"50025967500",690,129,0,12,46,2,7,0,886
"50025967600",2624,324,9,5,66,17,146,0,3191
"50025967700",2037,224,0,0,5,0,76,0,2342
"50025967800",1604,127,3,0,8,0,14,7,1763
"50025967900",1217,80,0,6,37,0,41,0,1381
"50025968000",2327,122,0,0,88,17,0,0,2554
"50025968100",1083,149,0,0,9,18,5,0,1264
"50025968200",1353,210,36,0,29,0,19,0,1647
"50025968300",1803,83,5,0,38,0,7,0,1936
"50025968400",3097,498,120,0,318,95,177,0,4305
"50025968500",3886,969,46,12,189,29,46,2,5179
"50025968600",1977,260,58,1,12,8,17,0,2333
"50025968700",3592,331,20,4,100,14,47,13,4121
"50027965000",3050,180,33,0,88,45,75,0,3471
"50027965100",2232,433,23,36,24,13,0,28,2789
"50027965200",2535,274,3,0,40,0,7,0,2859
"50027965300",171,50,0,2,0,7,0,0,230
"50027965400",3728,334,4,0,74,11,22,0,4173
"50027965501",2742,188,4,0,222,13,0,0,3169
"50027965502",2045,408,29,0,131,6,63,0,2682
"50027965600",3465,339,5,16,212,0,42,0,4079
"50027965700",3116,174,0,0,102,0,0,0,3392
"50027965800",2872,114,2,0,21,0,52,0,3061
"50027965900",2657,265,0,0,13,14,0,0,2949
"50027966000",2683,519,56,0,30,0,28,0,3316
"50027966100",2519,254,25,1,17,0,12,0,2828
"50027966200",1634,175,2,5,43,2,58,0,1919
"50027966300",1543,275,6,0,41,19,31,5,1920
"50027966500",3610,351,0,0,144,7,92,2,4206
"50027966600",3902,761,0,0,192,80,85,122,5142
"50027966700",3475,279,0,22,93,36,0,0,3905
"51001090100",2362,348,12,107,77,28,22,0,2956
"51001090200",3527,459,1165,336,0,15,88,9,5599
"51001090300",1371,509,412,35,111,18,19,134,2609
"51001090400",3341,236,1478,732,214,347,1329,388,8065
"51001090500",1751,407,478,120,37,25,270,55,3143
"51001090600",2645,571,486,323,46,21,11,0,4103
"51001090700",2645,211,1342,827,82,0,255,9,5371
"51001090800",1660,327,762,694,0,25,95,129,3692
"51001980100",0,0,0,1,0,2,0,2,5
"51001980200",0,0,1,1,0,0,0,0,2
"51001990100",0,0,0,0,0,0,0,0,0
"51001990200",0,0,0,0,0,0,0,0,0
"51003010100",4079,181,140,23,149,0,41,2,4615
"51003010201",3522,149,386,53,459,21,340,21,4951
"51003010202",3011,137,12,0,76,0,39,84,3359
"51003010300",6798,208,383,61,1239,0,217,0,8906
"51003010401",3452,104,376,166,143,0,0,0,4241
"51003010402",2906,42,13,306,48,0,109,0,3424
"51003010500",3453,223,623,81,314,6,20,0,4720
"51003010601",3991,319,360,332,281,82,219,186,5770
"51003010602",2619,25,108,0,104,23,18,8,2905
"51003010700",3311,384,1000,72,591,191,919,155,6623
"51003010800",3348,231,459,340,467,66,265,0,5176
"51003010901",599,421,36,0,374,78,37,77,1622
"51003010902",257,235,93,32,273,127,0,77,1094
"51003010903",23,53,27,0,0,1,0,0,104
"51003011000",5383,291,377,0,150,94,22,19,6336
"51003011100",6686,299,321,58,558,16,356,16,8310
"51003011201",3235,411,71,29,72,50,48,50,3966
"51003011202",2380,199,467,48,334,0,256,0,3684
"51003011301",4860,611,108,53,155,0,117,21,5925
"51003011302",2120,994,397,403,225,245,469,594,5447
"51003011303",2415,220,268,0,214,45,195,0,3357
"51003011400",2780,655,717,40,153,18,171,35,4569
"51005070100",2707,808,207,103,61,44,73,5,4008
"51005080100",2714,426,246,0,54,0,0,0,3440
"51005080201",2268,206,109,0,12,0,40,60,2695
"51005080202",2154,205,74,27,0,0,11,0,2471
"51005080301",1918,99,27,0,23,0,0,0,2067
"51005080302",1358,92,0,0,5,4,5,4,1468
"51007930100",4505,231,1414,282,185,5,54,12,6688
"51007930200",3969,391,1232,141,249,1,12,7,6002
"51009010100",3852,388,482,211,168,48,139,48,5336
"51009010200",4688,401,1003,411,135,34,46,50,6768
"51009010300",2899,83,343,1,132,0,9,0,3467
"51009010401",2441,426,659,118,48,10,0,0,3702
"51009010402",2559,206,374,70,287,38,106,0,3640
"51009010502",183,46,67,48,11,0,0,0,355
"51009010503",1217,380,393,73,0,11,84,35,2193
"51009010504",2454,190,680,32,265,0,47,0,3668
"51009010600",1408,143,775,140,141,47,40,0,2694
"51011040100",4158,751,915,274,148,60,57,0,6363
"51011040200",2876,306,816,308,44,47,36,0,4433
"51011040300",2691,639,459,247,112,0,58,23,4229
"51013100100",4330,90,99,0,508,0,112,0,5139
"51013100200",6125,14,55,0,536,38,211,0,6979
"51013100300",5028,75,14,3,448,14,299,0,5881
"51013100400",3515,100,0,0,247,10,285,8,4165
"51013100500",3798,153,22,10,694,0,578,18,5273
"51013100600",2494,48,101,29,368,18,369,25,3452
"51013100700",3619,99,175,13,1215,12,547,39,5719
"51013100800",826,12,456,0,498,4,464,4,2264
"51013100900",3457,171,97,0,1060,45,683,53,5566
"51013101000",2341,100,169,12,422,38,154,16,3252
"51013101100",4769,92,29,2,753,22,385,0,6052
"51013101200",2621,198,153,5,927,12,641,12,4569
"51013101300",5398,115,65,0,1031,87,519,1,7216
"51013101401",1063,40,95,0,157,5,10,0,1370
"51013101402",2249,78,30,0,416,0,155,21,2949
"51013101403",4027,457,86,0,737,165,215,20,5707
"51013101404",2934,160,145,0,667,15,267,0,4188
"51013101500",6221,317,243,46,1139,74,817,32,8889
"51013101601",931,90,5,0,364,28,253,0,1671
"51013101602",1194,194,52,0,147,21,108,156,1872
"51013101603",2425,203,0,206,464,28,180,0,3506
"51013101701",1656,613,136,1,880,21,188,456,3951
"51013101702",2796,95,275,23,978,306,737,47,5257
"51013101703",1383,81,69,22,442,69,35,0,2101
"51013101801",1702,65,52,0,445,8,99,0,2371
"51013101802",4405,138,233,25,1205,526,797,353,7682
"51013101803",3223,13,271,21,516,71,420,27,4562
"51013101900",2717,87,13,38,177,7,198,22,3259
"51013102001",1474,129,56,8,849,337,1088,358,4299
"51013102002",1081,10,104,35,310,46,404,0,1990
"51013102003",1950,268,355,236,594,242,352,222,4219
"51013102100",1235,138,53,10,538,215,457,79,2725
"51013102200",1614,481,916,513,2442,1060,2470,1085,10581
"51013102301",1071,41,134,4,256,13,179,0,1698
"51013102302",2301,204,138,9,1212,339,1301,321,5825
"51013102400",2198,94,399,3,761,144,708,71,4378
"51013102500",3046,144,747,186,903,51,479,90,5646
"51013102600",2097,79,327,10,989,64,926,60,4552
"51013102701",721,163,595,209,1712,366,1159,301,5226
"51013102702",1168,50,264,30,356,82,498,50,2498
"51013102801",3181,255,1132,81,1497,620,1757,645,9168
"51013102802",1008,0,34,25,41,15,44,0,1167
"51013102901",2333,60,48,0,272,7,103,7,2830
"51013102902",3384,112,280,17,639,97,764,72,5365
"51013103000",2837,102,143,0,274,0,399,0,3755
"51013103100",1889,317,2208,481,1058,310,1087,411,7761
"51013103200",2639,406,589,65,977,384,629,395,6084
"51013103300",1055,0,676,133,249,20,229,8,2370
"51013103401",92,19,4,5,14,0,0,0,134
"51013103402",3386,82,648,0,718,147,207,0,5188
"51013103501",1997,100,108,0,753,0,286,0,3244
"51013103502",2097,185,197,85,274,218,367,0,3423
"51013103503",2681,22,273,19,453,13,252,0,3713
"51013103601",2180,48,0,0,202,14,222,1,2667
"51013103602",962,55,32,6,200,52,44,0,1351
"51013103700",2108,63,30,0,142,0,213,17,2573
"51013103800",2829,125,850,109,623,14,544,52,5146
"51013980100",0,0,0,0,0,0,0,0,0
"51013980200",4,0,0,0,0,0,0,0,4
"51015070100",2406,547,0,0,17,0,31,2,3003
"51015070200",3071,332,22,4,274,4,252,4,3963
"51015070300",5435,299,67,51,249,0,274,35,6410
"51015070400",4851,656,50,0,59,61,18,61,5756
"51015070500",4970,775,77,0,83,83,14,83,6085
"51015070600",7329,558,237,20,439,0,229,156,8968
"51015070700",4777,492,65,52,70,152,80,0,5688
"51015070800",5321,294,137,71,14,0,0,0,5837
"51015070900",4078,403,186,0,12,21,40,0,4740
"51015071000",4687,506,0,0,70,0,67,0,5330
"51015071101",3446,509,53,17,92,66,45,0,4228
"51015071102",5133,219,89,0,0,0,67,0,5508
"51015071200",5326,345,98,44,13,58,0,0,5884
"51017920100",3592,730,203,26,81,3,43,117,4795
"51019030101",6299,173,205,2,66,0,0,1,6746
"51019030103",5179,171,239,26,233,0,52,0,5900
"51019030104",3406,290,478,14,174,36,0,0,4398
"51019030201",7759,292,271,44,208,0,260,0,8834
"51019030202",4470,384,166,165,97,128,100,30,5540
"51019030300",3077,269,240,51,63,20,25,1,3746
"51019030401",2502,179,297,54,12,21,23,0,3088
"51019030402",4814,741,942,56,228,12,54,0,6847
"51019030501",3183,575,214,10,43,86,0,120,4231
"51019030503",2022,189,47,0,19,0,15,0,2292
"51019030504",2139,27,0,18,29,0,41,0,2254
"51019030601",2978,328,78,19,49,18,15,0,3485
"51019030602",3000,274,0,0,135,0,148,0,3557
"51019030603",2098,504,38,0,78,0,70,178,2966
"51019030604",2588,275,0,0,203,0,14,0,3080
"51019030605",2650,188,91,35,52,1,9,1,3027
"51021040100",2423,641,60,0,13,0,0,11,3148
"51021040200",2388,328,0,0,0,0,0,0,2716
"51023040100",2352,585,184,26,60,0,60,0,3267
"51023040200",3435,418,83,40,88,0,26,0,4090
"51023040301",2365,208,233,3,52,0,0,3,2864
"51023040302",6786,149,275,28,46,0,69,0,7353
"51023040401",2012,190,70,1,98,5,33,7,2416
"51023040402",4617,184,56,51,47,0,169,7,5131
"51023040501",6032,355,35,41,55,68,4,0,6590
"51023040502",1218,140,0,30,16,0,21,0,1425
"51025930100",1096,266,1462,338,58,0,0,0,3220
"51025930201",571,123,1097,361,5,0,0,0,2157
"51025930202",0,0,0,0,0,0,0,0,0
"51025930203",1061,281,1878,780,36,0,50,161,4247
"51025930300",2617,381,1325,1014,47,4,17,4,5409
"51027010100",2706,2084,1,28,87,0,0,1,4907
"51027010200",2446,878,0,0,0,0,0,0,3324
"51027010300",2539,480,0,0,55,0,81,0,3155
"51027010400",1800,567,67,12,21,42,0,0,2509
"51027010500",1128,423,0,0,47,0,0,0,1598
"51027010600",2698,736,0,0,0,0,0,0,3434
"51027010700",3273,674,0,0,62,0,0,0,4009
"51029930101",1914,639,1020,131,112,0,123,113,4052
"51029930102",1176,338,746,413,14,20,0,4,2711
"51029930201",1654,245,591,404,34,48,5,0,2981
"51029930202",2526,494,584,352,90,40,0,0,4086
"51031020101",3792,627,1448,28,225,0,279,96,6495
"51031020102",3408,326,179,96,55,135,0,0,4199
"51031020200",3159,644,297,132,107,36,0,0,4375
"51031020300",3378,283,77,33,232,35,66,0,4104
"51031020401",4004,1023,619,0,177,105,166,0,6094
"51031020402",2466,157,109,91,0,0,0,0,2823
"51031020403",4443,432,329,93,193,17,139,0,5646
"51031020500",5162,842,801,366,68,17,51,47,7354
"51031020600",2693,705,254,31,176,51,9,88,4007
"51031020700",1924,376,738,121,133,89,0,0,3381
"51031020800",2203,210,413,63,83,11,0,1,2984
"51031020900",2270,371,701,428,117,0,18,13,3918
"51033030100",2160,349,750,115,65,19,82,0,3540
"51033030201",1575,103,671,11,43,31,68,31,2533
"51033030202",1189,97,309,129,65,10,0,0,1799
"51033030300",1418,240,788,154,240,0,17,10,2867
"51033030400",1014,312,250,8,70,0,28,0,1682
"51033030500",7360,1052,2791,450,370,29,452,109,12613
"51033030600",1373,87,1194,240,72,8,87,1,3062
"51035080100",3283,682,0,0,0,0,44,0,4009
"51035080200",3369,1141,0,4,5,0,14,0,4533
"51035080300",3976,1084,0,28,0,0,158,0,5246
"51035080400",4143,564,38,70,92,0,247,0,5154
"51035080500",3536,524,0,0,230,0,328,0,4618
"51035080601",1948,265,0,0,1,0,0,0,2214
"51035080602",3596,1049,71,0,121,0,26,0,4863
"51036600100",1352,94,1054,220,151,5,52,0,2928
"51036600200",612,75,1139,114,424,27,26,2,2419
"51036600300",797,82,734,233,77,0,29,0,1952
"51037930100",3100,514,1304,473,160,5,79,26,5661
"51037930200",1568,298,533,237,12,15,4,51,2718
"51037930300",2639,196,714,450,62,12,81,4,4158
"51041100106",2563,55,18,2,146,0,84,33,2901
"51041100107",893,278,683,148,98,28,309,169,2606
"51041100205",2325,524,3044,477,1243,101,1728,483,9925
"51041100206",2389,599,1993,175,277,0,300,322,6055
"51041100208",2025,107,218,91,273,0,182,20,2916
"51041100209",3242,180,1884,334,234,2,242,0,6118
"51041100210",580,191,594,20,223,8,257,129,2002
"51041100300",783,80,552,164,207,58,207,58,2109
"51041100403",3458,370,595,3,596,54,362,0,5438
"51041100404",1301,540,356,31,245,6,906,360,3745
"51041100405",982,496,332,51,324,188,593,584,3550
"51041100406",269,98,517,273,104,40,69,243,1613
"51041100407",1523,235,521,67,353,32,459,0,3190
"51041100409",4692,534,692,57,186,0,387,114,6662
"51041100410",1137,36,544,62,48,0,24,0,1851
"51041100505",3576,243,959,62,174,29,174,0,5217
"51041100506",3952,242,1588,439,366,135,995,123,7840
"51041100507",4482,350,1375,24,229,0,272,0,6732
"51041100508",2769,173,1320,316,360,71,132,59,5200
"51041100509",4702,269,1541,0,433,0,269,20,7234
"51041100510",2673,33,380,97,139,11,125,0,3458
"51041100600",250,29,1103,135,15,0,0,6,1538
"51041100701",2453,121,2142,160,43,12,262,32,5225
"51041100702",1161,54,505,115,49,0,13,0,1897
"51041100703",5888,434,1388,6,157,0,98,30,8001
"51041100804",1386,294,1697,122,896,13,81,136,4625
"51041100805",2072,239,2674,61,711,12,720,59,6548
"51041100806",1246,117,1457,342,216,95,465,110,4048
"51041100807",1191,54,388,24,153,0,507,0,2317
"51041100812",3783,255,887,32,468,193,165,193,5976
"51041100814",1599,302,911,0,242,26,329,46,3455
"51041100815",2641,83,905,53,281,130,127,0,4220
"51041100816",3351,201,886,2,449,21,514,62,5486
"51041100817",1586,108,795,33,427,23,87,8,3067
"51041100818",1867,95,1907,87,272,51,564,0,4843
"51041100819",1515,374,3614,155,680,170,554,230,7292
"51041100820",806,13,1337,196,265,49,265,122,3053
"51041100821",3746,159,465,17,99,0,130,0,4616
"51041100822",3543,78,536,45,216,23,97,0,4538
"51041100823",3897,81,1153,75,317,21,270,0,5814
"51041100902",3282,140,41,18,196,14,132,14,3837
"51041100907",1807,253,178,8,139,85,210,60,2740
"51041100910",3411,97,1325,92,258,71,268,0,5522
"51041100912",5018,129,841,25,287,0,144,0,6444
"51041100915",2692,142,615,44,478,122,219,14,4326
"51041100919",4102,448,1168,24,617,38,205,209,6811
"51041100920",634,51,73,30,58,0,13,0,859
"51041100921",4269,217,790,138,811,0,486,0,6711
"51041100922",2824,356,1535,4,414,17,92,140,5382
"51041100923",1399,121,627,69,84,0,200,0,2500
"51041100924",3678,90,197,30,401,0,101,23,4520
"51041100926",5169,138,115,0,457,0,78,0,5957
"51041100927",6344,121,596,105,793,58,181,0,8198
"51041100928",4073,320,937,0,269,19,97,157,5872
"51041100929",5416,110,398,20,713,1,143,1,6802
"51041100930",2817,160,199,48,125,0,42,0,3391
"51041100931",4560,68,467,76,360,7,92,0,5630
"51041100932",2740,46,424,14,489,51,267,0,4031
"51041100933",1637,185,670,11,70,42,92,58,2765
"51041100934",3779,99,1858,411,1082,0,390,0,7619
"51041100935",3479,53,148,0,20,0,64,0,3764
"51041100936",3471,91,97,83,70,39,54,0,3905
"51041101003",3981,7,648,23,287,0,158,0,5104
"51041101004",3978,123,439,23,144,0,65,0,4772
"51041101007",5407,76,450,0,359,0,296,0,6588
"51041101008",3766,20,326,0,290,0,109,0,4511
"51041101009",4670,232,600,0,389,39,313,0,6243
"51041101010",6064,164,1017,0,329,0,241,0,7815
"51041101011",2907,239,215,8,296,11,138,11,3825
"51041101012",3639,32,812,101,495,14,364,0,5457
"51041101013",2783,0,642,0,45,0,206,0,3676
"51043010100",6931,342,347,106,312,24,295,26,8383
"51043010200",2411,186,166,26,112,2,146,2,3051
"51043010300",2566,229,19,0,114,11,42,0,2981
"51045050100",4635,393,0,2,81,54,0,0,5165
"51047930101",3977,191,431,60,406,20,855,0,5940
"51047930102",6606,305,607,58,315,0,96,0,7987
"51047930201",5242,269,624,268,310,3,529,0,7245
"51047930202",4820,310,481,0,364,24,434,0,6433
"51047930300",3487,420,1036,300,665,178,768,141,6995
"51047930400",3373,280,385,309,93,170,87,70,4767
"51047930501",2740,111,544,113,234,22,314,8,4086
"51047930502",2862,411,839,270,959,76,784,16,6217
"51049930100",4091,264,1444,465,12,52,108,0,6436
"51049930200",1767,227,935,495,38,108,1,8,3579
"51051040100",3286,1096,2,1,14,3,0,0,4402
"51051040200",2143,341,8,2,73,15,65,6,2653
"51051040300",4306,830,15,0,44,0,26,0,5221
"51051040400",2358,955,0,0,0,0,0,0,3313
"51053840100",3415,423,973,459,23,2,21,0,5316
"51053840200",3442,415,199,100,73,0,177,20,4426
"51053840300",3055,293,2652,206,349,0,342,43,6940
"51053840400",399,147,100,197,16,16,84,0,959
"51053840500",1514,358,848,231,131,0,0,0,3082
"51053840600",3980,271,2526,434,78,58,13,0,7360
"51053980100",0,0,0,0,0,0,0,0,0
"51057950600",1732,49,1496,250,133,0,0,0,3660
"51057950700",1945,301,1290,428,147,11,105,6,4233
"51057950800",2385,88,530,106,174,0,244,9,3536
"51059415100",2852,329,178,0,268,56,404,232,4319
"51059415200",2568,77,153,8,203,37,171,0,3217
"51059415300",2155,60,545,0,1105,0,1047,12,4924
"51059415401",2698,176,1219,468,641,149,1086,262,6699
"51059415402",1961,71,484,28,345,0,267,12,3168
"51059415500",4100,131,671,336,578,39,487,0,6342
"51059415600",2680,14,54,0,102,1,73,1,2925
"51059415700",3488,2,69,0,117,0,167,0,3843
"51059415800",4061,79,52,0,635,0,350,0,5177
"51059415900",2293,39,197,0,567,68,415,68,3647
"51059416000",3337,480,897,71,905,259,687,307,6943
"51059416100",2951,69,275,0,408,0,262,0,3965
"51059416200",3285,107,974,34,997,4,834,4,6239
"51059416300",1633,108,182,4,12,0,81,11,2031
"51059420100",1962,232,455,412,1017,128,826,169,5201
"51059420201",2070,47,672,0,823,56,345,82,4095
"51059420202",1237,108,527,0,243,0,355,0,2470
"51059420203",1711,16,271,47,448,120,206,0,2819
"51059420300",3430,119,590,0,1454,0,949,0,6542
"51059420400",1851,73,409,0,628,27,597,44,3629
"51059420501",1117,95,327,21,74,7,75,14,1730
"51059420502",805,119,276,3,312,45,99,45,1704
"51059420503",1385,85,527,84,561,96,659,47,3444
"51059420600",2307,177,623,55,1011,181,1055,131,5540
"51059420700",2877,122,347,0,457,23,614,82,4522
"51059420800",2110,71,525,22,585,197,786,190,4486
"51059421001",1568,91,252,18,1130,38,829,0,3926
"51059421002",2384,131,1154,40,1245,230,549,154,5887
"51059421101",3163,0,1367,23,1299,49,698,0,6599
"51059421102",2406,34,473,103,658,75,475,48,4272
"51059421103",3369,8,780,0,847,0,183,0,5187
"51059421200",1556,26,251,0,273,0,181,0,2287
"51059421300",2468,101,408,0,704,8,377,0,4066
"51059421400",2093,304,1053,450,2683,452,2215,286,9536
"51059421500",1644,193,1898,436,2200,503,1813,474,9161
"51059421600",1480,283,2000,252,1312,214,1695,473,7709
"51059421701",1496,214,1386,33,1385,30,1838,195,6577
"51059421702",1574,22,927,122,1065,0,943,72,4725
"51059421800",2274,319,1560,175,1049,157,1488,142,7164
"51059421900",1559,65,629,56,186,25,312,19,2851
"51059422000",1731,28,581,70,1222,94,472,94,4292
"51059422101",2953,47,1865,172,1439,17,955,0,7448
"51059422102",1472,128,2695,24,2344,13,1033,110,7819
"51059422201",1355,5,542,0,1608,75,356,0,3941
"51059422202",1937,111,1517,0,2008,81,742,64,6460
"51059422301",1806,0,383,0,607,32,362,0,3190
"51059422302",3352,42,952,0,1045,55,574,0,6020
"51059422401",1280,153,324,0,583,0,303,57,2700
"51059422402",2978,81,1110,7,947,40,627,49,5839
"51059422403",1877,76,335,7,253,3,262,0,2813
"51059430101",3882,104,142,1,513,20,375,0,5037
"51059430102",1532,44,263,0,869,0,324,25,3057
"51059430201",2759,105,243,0,1012,55,881,115,5170
"51059430202",3031,553,144,22,1444,49,510,33,5786
"51059430203",1947,63,77,8,599,99,288,0,3081
"51059430400",5028,93,62,0,1563,272,1038,28,8084
"51059430500",1035,50,54,0,495,15,135,38,1822
"51059430600",3644,493,307,46,2444,232,2834,442,10442
"51059430700",1843,13,108,0,1012,66,881,0,3923
"51059430801",3545,42,199,0,763,0,604,21,5174
"51059430802",2932,16,454,10,551,0,576,0,4539
"51059430901",2919,14,427,88,1193,25,850,14,5530
"51059430902",2191,54,178,0,1089,21,541,54,4128
"51059431001",3465,120,152,2,1343,56,1070,24,6232
"51059431002",1102,36,358,0,670,0,224,0,2390
"51059431300",3329,6,124,0,748,0,382,0,4589
"51059431400",2969,205,353,19,1121,28,319,53,5067
"51059431500",3853,126,364,12,646,112,379,16,5508
"51059431600",4541,142,313,15,2692,89,915,22,8729
"51059431801",2196,96,181,0,1679,58,500,0,4710
"51059431802",2550,24,23,0,913,0,667,0,4177
"51059431900",2400,0,123,0,779,10,268,10,3590
"51059432000",2494,42,167,2,535,52,701,37,4030
"51059432100",2457,302,53,0,635,98,267,9,3821
"51059432201",1620,54,160,0,682,26,623,0,3165
"51059432202",2867,327,371,31,748,148,324,445,5261
"51059432300",3593,0,196,0,1508,43,671,0,6011
"51059432401",2471,8,110,0,742,19,216,0,3566
"51059432402",3894,35,363,56,782,85,483,0,5698
"51059432500",3975,148,344,48,1099,0,503,0,6117
"51059432600",3125,128,350,15,1351,123,631,82,5805
"51059432701",2386,41,457,27,512,0,302,0,3725
"51059432702",2114,98,947,82,1046,65,818,0,5170
"51059432800",1178,29,376,90,579,48,251,10,2561
"51059440100",5260,183,118,163,1600,85,557,0,7966
"51059440201",1091,77,122,0,1010,59,552,100,3011
"51059440202",3387,273,377,26,2094,39,932,71,7199
"51059440300",2234,50,17,2,477,2,105,1,2888
"51059440501",3460,18,0,0,1394,44,446,0,5362
"51059440502",1279,110,372,0,616,24,151,0,2552
"51059440600",1982,90,44,14,1061,7,680,90,3968
"51059440701",2193,32,107,0,707,0,360,0,3399
"51059440702",4021,79,13,1,1344,47,319,20,5844
"51059440800",4436,39,297,0,1213,205,386,0,6576
"51059450100",2939,122,400,0,1657,153,1085,135,6491
"51059450200",1958,96,87,191,1528,300,1172,301,5633
"51059450300",2122,146,263,15,2014,64,1423,65,6112
"51059450400",2075,24,29,0,727,0,623,0,3478
"51059450500",1484,75,130,0,1162,95,1210,79,4235
"51059450601",2433,40,38,1,1308,22,640,1,4483
"51059450602",1896,72,150,1,1809,366,1366,111,5771
"51059450701",1600,58,306,0,862,76,336,2,3240
"51059450702",1946,530,489,50,1063,362,1751,708,6899
"51059450800",2160,101,273,0,1077,6,1041,54,4712
"51059450900",1220,0,7,0,360,37,372,0,1996
"51059451000",1619,170,53,6,677,36,338,30,2929
"51059451100",1693,36,0,0,335,41,396,47,2548
"51059451200",1421,22,78,9,182,18,134,7,1871
"51059451300",1864,29,36,0,427,6,402,2,2766
"51059451400",832,332,144,21,1132,418,977,307,4163
"51059451501",2258,375,561,85,1446,414,1291,414,6844
"51059451502",1936,510,1038,74,1145,22,898,503,6126
"51059451601",1574,331,94,0,2788,851,3171,1104,9913
"51059451602",1412,38,328,0,826,101,497,0,3202
"51059451800",2469,47,9,3,723,271,905,89,4516
"51059451900",3185,101,993,12,1120,201,1751,192,7555
"51059452000",1577,41,292,125,531,237,220,0,3023
"51059452101",2247,245,484,33,1917,78,497,62,5563
"51059452102",1360,203,85,129,1198,153,1042,203,4373
"51059452200",2756,546,536,70,2195,501,1620,726,8950
"51059452301",1516,434,351,0,1376,666,861,941,6145
"51059452302",2359,100,675,0,1462,159,1878,91,6724
"51059452400",3724,278,951,81,2044,88,1669,280,9115
"51059452501",2497,73,245,8,941,245,833,138,4980
"51059452502",1466,629,1383,542,782,205,942,590,6539
"51059452600",2695,70,1056,37,1657,294,1337,169,7315
"51059452700",2065,275,1159,334,1253,219,1327,299,6931
"51059452801",3094,475,712,267,601,181,954,68,6352
"51059452802",1656,484,420,95,299,71,209,49,3283
"51059460100",3370,41,166,0,1004,31,173,0,4785
"51059460200",3657,92,9,0,373,20,97,30,4278
"51059460300",2555,20,7,0,282,12,106,0,2982
"51059460400",3306,88,127,0,1141,149,180,7,4998
"51059460501",1977,59,5,13,660,41,155,24,2934
"51059460502",3413,316,333,57,3055,0,773,0,7947
"51059460600",3039,28,0,0,993,10,281,0,4351
"51059460701",2457,50,66,156,667,91,770,46,4303
"51059460702",3555,232,159,0,708,2,176,11,4843
"51059460800",2665,41,6,0,403,23,435,0,3573
"51059460900",1909,6,9,0,452,0,209,0,2585
"51059461000",1786,23,128,20,294,35,117,5,2408
"51059461100",5662,450,79,17,1590,112,1381,437,9728
"51059461201",4115,58,22,0,318,0,166,13,4692
"51059461202",2360,162,482,62,1812,192,412,0,5482
"51059461500",4216,108,346,0,1726,19,687,42,7144
"51059461601",4027,109,276,16,1651,63,438,0,6580
"51059461602",1412,77,88,0,2415,212,358,135,4697
"51059461700",3448,112,390,25,2665,116,873,45,7674
"51059461801",799,22,93,28,273,144,73,0,1432
"51059461802",3219,65,226,17,1940,0,798,0,6265
"51059461901",1742,36,552,210,851,194,495,18,4098
"51059461902",682,152,174,11,954,108,681,102,2864
"51059470100",2241,31,51,5,544,28,285,11,3196
"51059470300",2780,16,0,2,596,98,184,0,3676
"51059470400",3803,37,11,1,714,20,258,1,4845
"51059470500",4286,54,7,0,1319,80,462,0,6208
"51059470600",2000,11,17,1,594,50,86,0,2759
"51059470700",4190,41,35,0,1144,182,379,0,5971
"51059470800",2285,21,102,0,681,14,149,0,3252
"51059470900",6029,172,81,0,1024,0,441,0,7747
"51059471000",1627,29,11,0,409,9,34,0,2119
"51059471100",4430,282,102,0,2017,93,779,68,7771
"51059471201",1753,69,348,0,838,10,103,0,3121
"51059471202",2993,141,118,33,1357,0,546,55,5243
"51059471301",2100,162,61,38,1486,174,735,254,5010
"51059471303",2330,129,104,0,1155,145,362,33,4258
"51059471304",1407,40,13,0,336,0,84,0,1880
"51059471401",2209,146,139,0,1210,44,676,20,4444
"51059471402",1668,59,26,57,2152,21,1652,78,5713
"51059480100",3761,135,105,9,634,0,143,8,4795
"51059480201",3127,26,74,15,876,59,21,0,4198
"51059480202",1893,60,75,27,1092,75,177,0,3399
"51059480203",1108,93,290,9,934,100,214,0,2748
"51059480300",5197,93,37,0,1497,13,341,0,7178
"51059480401",3074,47,94,0,1191,25,305,0,4736
"51059480402",4489,26,57,0,1979,0,568,0,7119
"51059480501",2502,18,44,0,891,111,203,0,3769
"51059480502",4426,150,214,236,709,304,854,63,6956
"51059480503",2664,87,86,0,638,13,680,39,4207
"51059480504",1824,21,45,0,218,7,74,11,2200
"51059480505",2164,114,110,0,571,36,196,9,3200
"51059480801",2705,108,899,0,1356,154,1633,230,7085
"51059480802",2628,59,134,0,933,56,381,0,4191
"51059480901",3221,136,897,126,2340,305,2447,223,9695
"51059480902",2226,261,321,0,960,51,1184,180,5183
"51059480903",1492,50,278,45,1686,293,1507,56,5407
"51059481000",2574,145,503,61,2208,65,1681,183,7420
"51059481101",973,71,289,0,749,0,253,0,2335
"51059481102",1149,55,467,0,1622,20,240,14,3567
"51059481103",1412,6,396,21,1552,210,492,21,4110
"51059481104",633,64,263,0,1924,0,85,48,3017
"51059481105",3179,0,261,5,1819,0,389,0,5653
"51059481106",3941,0,173,0,1143,216,192,0,5665
"51059481201",862,5,63,0,360,34,28,0,1352
"51059481202",2494,294,785,78,2216,58,1934,207,8066
"51059481400",4268,335,344,147,563,155,475,0,6287
"51059481500",1950,11,100,0,256,0,90,5,2412
"51059481600",3017,49,20,0,379,0,226,0,3691
"51059481701",5047,35,196,0,711,5,114,0,6108
"51059481702",3125,45,149,74,859,45,327,25,4649
"51059481900",3485,226,514,218,752,31,253,151,5630
"51059482001",3807,132,204,0,695,70,273,10,5191
"51059482002",2932,49,150,0,507,0,306,11,3955
"51059482100",2636,89,254,168,650,5,767,18,4587
"51059482201",1187,585,270,111,351,11,238,443,3196
"51059482202",2338,132,299,13,550,86,214,17,3649
"51059482203",3043,58,46,75,555,5,362,0,4144
"51059482301",3881,38,505,0,427,13,226,0,5090
"51059482302",2261,212,360,975,991,37,1232,398,6466
"51059482303",2772,82,77,0,572,0,356,27,3886
"51059482400",1948,43,25,0,418,31,40,0,2505
"51059482501",2621,375,1398,58,3490,57,1332,19,9350
"51059482502",2192,50,108,0,884,0,337,16,3587
"51059482503",2677,152,276,18,1844,67,119,0,5153
"51059482504",4150,9,86,0,1453,0,280,0,5978
"51059482601",4511,96,361,0,1874,145,715,0,7702
"51059482602",3486,52,696,0,2773,62,369,0,7438
"51059490101",3735,53,197,435,736,248,352,14,5770
"51059490103",4132,51,171,0,1381,0,1087,0,6822
"51059490501",1626,19,108,39,921,385,251,270,3619
"51059490502",4115,114,303,0,1777,0,232,0,6541
"51059491000",1634,8,32,0,258,0,64,0,1996
"51059491101",3056,19,161,0,751,0,131,0,4118
"51059491102",2236,0,315,0,1060,0,588,0,4199
"51059491103",3707,496,253,0,2176,384,1648,397,9061
"51059491201",2963,26,578,92,1869,48,761,0,6337
"51059491202",673,58,127,0,608,232,193,0,1891
"51059491301",3526,9,701,0,2170,242,1375,0,8023
"51059491302",1875,80,219,0,1452,103,395,57,4181
"51059491303",1637,25,631,41,2175,250,1432,163,6354
"51059491401",2105,68,240,0,2098,37,484,0,5032
"51059491402",2099,175,368,36,1650,73,430,98,4929
"51059491403",3351,162,122,0,586,12,263,0,4496
"51059491404",2446,47,206,56,930,16,259,0,3960
"51059491405",2501,2,186,1,363,0,167,1,3221
"51059491501",2013,55,347,3,4519,104,342,0,7383
"51059491502",4465,149,214,0,1814,0,233,146,7021
"51059491601",2176,350,422,112,1405,714,615,647,6441
"51059491602",2775,129,278,0,2212,358,971,402,7125
"51059491701",2292,24,171,38,1000,23,386,0,3934
"51059491702",2933,641,1006,171,2776,94,677,455,8753
"51059491703",2313,134,756,0,1262,227,494,0,5186
"51059491704",2675,215,282,58,1464,120,161,0,4975
"51059491705",1718,6,101,15,1394,157,278,6,3675
"51059491801",867,59,167,0,792,256,149,0,2290
"51059491802",1934,9,140,0,767,0,485,9,3344
"51059491803",4620,207,199,173,1230,15,511,39,6994
"51059492000",5192,33,340,0,537,84,161,0,6347
"51059492100",5672,146,230,0,605,0,187,0,6840
"51059492201",2338,77,100,18,466,0,162,0,3161
"51059492202",5263,16,169,56,1265,0,356,0,7125
"51059492203",3408,27,54,0,586,27,204,0,4306
"51059492300",2154,199,123,39,624,0,399,178,3716
"51059492400",2731,75,437,81,1110,146,641,35,5256
"51059492500",3471,50,96,0,621,91,103,0,4432
"51059980100",0,0,0,0,0,0,0,0,0
"51059980200",0,0,0,0,0,0,0,0,0
"51059980300",0,0,0,0,0,0,0,0,0
"51061930100",3974,478,256,15,219,0,689,109,5740
"51061930203",2150,120,117,0,159,13,63,0,2622
"51061930204",3198,283,143,0,43,0,101,29,3797
"51061930205",1267,23,347,106,16,0,44,0,1803
"51061930206",2012,64,40,20,134,7,161,0,2438
"51061930207",1407,183,83,12,116,1,48,1,1851
"51061930302",5515,491,499,170,514,69,437,188,7883
"51061930303",3080,68,90,20,63,0,143,0,3464
"51061930304",2195,67,44,0,58,20,57,0,2441
"51061930401",4280,110,132,17,187,15,187,0,4928
"51061930402",5142,156,164,0,177,78,148,0,5865
"51061930403",5252,145,643,29,303,0,335,0,6707
"51061930703",2492,132,48,0,293,0,74,5,3044
"51061930704",3455,55,297,26,209,0,119,3,4164
"51061930705",3010,178,254,0,4,0,42,0,3488
"51061930706",4435,256,1087,109,348,12,1041,87,7375
"51061930707",1626,91,224,0,86,0,188,42,2257
"51063920101",5306,490,20,74,144,33,0,0,6067
"51063920102",3062,335,15,104,0,68,39,15,3638
"51063920200",4598,830,0,1,213,0,344,13,5999
"51065020101",3865,121,468,260,118,0,97,0,4929
"51065020102",8328,28,266,87,414,95,229,53,9500
"51065020200",3128,399,1170,408,108,46,250,1,5510
"51065020300",4185,225,658,41,123,23,150,0,5405
"51067020101",4284,183,76,0,174,0,18,26,4761
"51067020102",2069,433,90,17,0,12,0,1,2622
"51067020200",3750,935,237,76,140,0,45,436,5619
"51067020300",5847,151,249,109,143,66,15,0,6580
"51067020400",4344,783,240,0,34,0,181,34,5616
"51067020500",6731,986,238,54,123,1,122,1,8256
"51067020600",2386,584,0,0,56,15,17,23,3081
"51067020700",4065,715,322,0,138,24,25,157,5446
"51067020800",4018,695,1063,278,17,0,30,26,6127
"51067020900",5033,1375,1045,122,68,12,134,99,7888
"51069050100",3466,427,69,0,35,0,51,0,4048
"51069050200",3590,200,95,0,23,0,106,0,4014
"51069050300",5549,469,289,29,209,56,40,73,6714
"51069050400",6122,185,0,0,91,9,102,0,6509
"51069050500",4447,244,54,1,143,0,296,12,5197
"51069050600",3615,186,212,85,120,30,162,0,4410
"51069050700",2364,257,38,7,76,0,104,49,2895
"51069050801",3560,153,170,0,237,0,587,0,4707
"51069050802",5982,550,136,0,334,0,901,0,7903
"51069050803",5475,242,772,0,165,0,184,0,6838
"51069050900",3205,513,220,0,128,44,221,170,4501
"51069051000",7966,442,523,0,1022,42,640,89,10724
"51069051101",6049,624,234,4,495,43,518,39,8006
"51069051102",4582,603,69,94,696,8,892,58,7002
"51071930100",1840,212,23,0,130,22,74,0,2301
"51071930200",3223,484,88,5,0,6,26,72,3904
"51071930300",3999,794,0,1,17,30,47,0,4888
"51071930400",5222,609,20,23,122,69,0,0,6065
"51073100100",5755,677,431,126,299,0,96,0,7384
"51073100201",4673,84,614,28,212,0,136,0,5747
"51073100202",2691,310,409,28,69,0,87,0,3594
"51073100203",2971,108,288,66,173,2,27,0,3635
"51073100301",4456,302,231,57,176,12,33,0,5267
"51073100302",4406,895,467,100,91,0,272,80,6311
"51073100400",982,219,127,8,47,0,34,0,1417
"51073100500",3248,298,314,6,75,34,187,46,4208
"51075400100",5447,241,297,26,38,36,78,35,6198
"51075400200",3194,80,499,6,74,0,105,4,3962
"51075400300",145,68,0,0,6,1,0,1,221
"51075400400",3849,55,1150,200,0,0,32,0,5286
"51075400500",2740,135,648,233,167,0,189,0,4112
"51077060101",2245,611,0,17,28,0,32,0,2933
"51077060102",3151,849,39,16,0,0,55,0,4110
"51077060201",2441,561,87,27,57,176,100,208,3657
"51077060202",2341,294,62,17,4,0,8,8,2734
"51077060300",1736,289,0,25,5,2,0,2,2059
"51079030101",3185,321,330,82,21,9,24,9,3981
"51079030102",4522,501,155,77,126,1,26,96,5504
"51079030200",7215,510,345,153,310,558,209,458,9758
"51081880101",1508,182,1714,466,0,3,19,3,3895
"51081880102",0,0,0,0,0,0,0,0,0
"51081880200",1653,126,1654,1032,52,6,0,0,4523
"51083930100",1093,313,680,423,70,3,9,7,2598
"51083930201",2917,503,1329,512,45,30,4,0,5340
"51083930202",998,179,954,151,11,4,63,4,2364
"51083930301",1194,449,620,100,13,14,33,16,2439
"51083930302",2635,460,1230,259,63,14,15,8,4684
"51083930400",2449,457,445,229,102,140,89,134,4045
"51083930500",2315,261,792,188,15,6,2,6,3585
"51083930600",2564,211,1634,1505,243,52,151,52,6412
"51083930800",2271,134,928,891,53,0,19,0,4296
"51085320100",4419,593,536,34,95,0,69,0,5746
"51085320200",4611,168,605,68,166,33,185,0,5836
"51085320300",3481,190,413,1,60,12,31,0,4188
"51085320400",3352,427,334,0,365,29,92,0,4599
"51085320500",2921,68,102,7,76,0,18,0,3192
"51085320601",1369,116,786,83,355,74,58,19,2860
"51085320602",2508,108,155,54,126,63,31,0,3045
"51085320701",2446,52,120,26,167,0,41,0,2852
"51085320702",2337,37,150,28,112,0,1,0,2665
"51085320801",1967,82,287,111,6,43,6,0,2502
"51085320803",4570,176,515,0,80,1,127,7,5476
"51085320804",4744,13,317,0,266,0,58,0,5398
"51085320805",2550,129,127,5,96,0,40,0,2947
"51085320900",6821,174,542,69,219,28,231,0,8084
"51085321001",2720,133,372,0,247,0,18,37,3527
"51085321002",6323,180,575,0,242,0,190,24,7534
"51085321100",5043,164,125,96,206,9,224,27,5894
"51085321201",3917,395,183,43,104,34,112,36,4824
"51085321202",2897,80,800,163,223,56,173,6,4398
"51085321300",4995,203,366,30,404,0,221,0,6219
"51085321401",1957,59,64,13,107,0,4,0,2204
"51085321402",2937,158,169,61,5,5,56,0,3391
"51085321403",2575,35,135,0,22,0,33,0,2800
"51087200104",3178,190,760,153,419,254,351,180,5485
"51087200105",3854,765,625,101,681,277,641,126,7070
"51087200106",2687,663,412,115,473,180,176,331,5037
"51087200107",6053,476,709,67,878,0,381,99,8663
"51087200108",2629,30,5,24,14,1,32,1,2736
"51087200109",3534,0,20,0,95,21,10,0,3680
"51087200112",3895,251,464,40,112,29,8,0,4799
"51087200116",4536,186,367,23,161,22,169,0,5464
"51087200119",5658,247,675,21,2033,57,359,0,9050
"51087200120",5704,86,289,0,774,12,117,0,6982
"51087200121",5964,79,234,29,985,185,270,184,7930
"51087200122",3541,31,164,33,631,2,352,0,4754
"51087200123",2016,417,852,181,236,62,459,303,4526
"51087200124",3566,149,179,1,318,0,99,0,4312
"51087200125",1340,235,644,230,1448,21,176,8,4102
"51087200126",1449,165,648,44,1096,59,170,16,3647
"51087200127",4470,225,87,213,744,38,40,0,5817
"51087200128",3036,156,141,67,1269,184,72,0,4925
"51087200129",9329,135,692,23,2894,170,288,32,13563
"51087200130",5947,96,125,0,767,0,234,0,7169
"51087200201",2282,72,87,0,161,13,68,7,2690
"51087200202",3636,208,0,0,79,0,24,14,3961
"51087200301",908,49,18,0,61,5,27,0,1068
"51087200302",2177,101,268,0,223,7,187,7,2970
"51087200303",2179,214,268,34,533,63,150,62,3503
"51087200305",2186,207,350,63,947,150,203,61,4167
"51087200404",1687,331,441,34,428,146,237,204,3508
"51087200406",6522,167,970,303,966,127,345,0,9400
"51087200407",3093,185,636,90,631,90,237,2,4964
"51087200409",695,206,332,161,250,170,12,208,2034
"51087200410",1735,716,1387,150,184,77,372,173,4794
"51087200411",2411,457,1473,271,337,175,133,107,5364
"51087200412",802,354,862,61,163,173,281,304,3000
"51087200413",3691,96,261,33,591,18,40,0,4730
"51087200414",3622,65,935,0,1056,184,431,0,6293
"51087200501",1053,95,371,26,379,0,458,4,2386
"51087200502",1444,146,156,10,236,50,62,0,2104
"51087200503",2887,311,451,41,93,50,49,64,3946
"51087200600",2887,730,646,74,403,0,591,62,5393
"51087200700",2288,179,388,690,80,0,64,4,3693
"51087200801",1708,169,794,230,69,13,220,13,3216
"51087200802",954,200,764,0,209,0,100,23,2250
"51087200804",795,147,3320,814,640,62,729,22,6529
"51087200805",97,23,2254,2027,31,208,31,0,4671
"51087200903",3997,224,2015,123,800,29,43,0,7231
"51087200904",2199,40,3952,183,295,147,317,0,7133
"51087200905",1543,282,2062,451,486,33,208,37,5102
"51087200906",3216,144,729,135,198,0,35,0,4457
"51087201001",549,127,4647,455,326,43,243,0,6390
"51087201002",369,35,1871,317,326,68,17,0,3003
"51087201003",82,0,4565,471,203,0,195,0,5516
"51087201101",842,210,3869,1523,152,31,191,24,6842
"51087201102",1039,95,2432,360,234,52,29,102,4343
"51087201201",2478,572,2934,347,226,74,259,11,6901
"51087201202",1030,341,3821,657,126,0,86,175,6236
"51087201401",1072,185,2577,960,216,80,178,80,5348
"51087201403",1884,505,3080,308,25,37,111,97,6047
"51087201404",3564,167,323,81,43,22,42,0,4242
"51087201501",1865,191,6578,1434,317,189,198,200,10972
"51087201502",2451,320,1841,27,136,0,22,0,4797
"51087201601",2006,70,590,32,69,0,0,0,2767
"51087201602",2532,161,1790,79,142,13,65,11,4793
"51087201701",2754,439,773,108,124,58,40,310,4606
"51087980100",0,0,0,0,0,0,0,0,0
"51089010100",2667,487,480,138,145,101,114,306,4438
"51089010200",3328,481,1310,99,88,69,216,0,5591
"51089010300",3198,173,1336,524,40,5,365,42,5683
"51089010400",1888,177,996,159,401,16,415,52,4104
"51089010500",2465,452,649,149,276,144,165,112,4412
"51089010601",2225,197,261,56,101,5,0,0,2845
"51089010602",2743,434,506,143,36,10,9,32,3913
"51089010700",2113,402,558,249,29,38,0,0,3389
"51089010800",1037,174,837,213,14,26,78,0,2379
"51089010900",1630,408,385,22,48,0,21,0,2514
"51089011000",3149,989,669,354,63,149,15,272,5660
"51089011100",2130,359,170,71,0,0,0,117,2847
"51089011200",2421,514,132,110,70,155,20,158,3580
"51089011300",2690,480,501,298,26,7,87,8,4097
"51091970100",2038,231,0,0,3,0,0,0,2272
"51093280101",2112,297,1126,223,68,38,5,38,3907
"51093280103",4592,195,1144,48,646,0,350,93,7068
"51093280104",3613,56,561,64,160,7,94,25,4580
"51093280105",1973,101,1327,816,45,15,7,0,4284
"51093280106",1823,320,311,138,27,1,25,1,2646
"51093280200",2242,383,947,16,27,0,0,0,3615
"51093280300",3790,508,764,242,271,175,81,0,5831
"51093280400",2955,270,447,306,0,0,18,0,3996
"51095080101",4163,210,339,0,507,43,107,0,5369
"51095080102",1519,471,884,182,262,29,347,15,3709
"51095080202",4538,161,410,150,287,0,187,0,5733
"51095080203",2491,404,318,93,309,0,316,0,3931
"51095080205",1530,730,656,272,78,51,63,478,3858
"51095080206",8308,32,812,115,705,91,229,0,10292
"51095080301",6425,288,1634,203,400,41,277,46,9314
"51095080303",6433,523,293,51,321,88,261,75,8045
"51095080304",5220,174,16,10,81,32,174,32,5739
"51095080401",5357,776,1043,79,218,8,134,329,7944
"51095080402",4551,176,1097,329,288,34,183,34,6692
"51097950400",2139,101,1418,157,91,15,106,0,4027
"51097950500",2199,357,524,19,0,0,109,0,3208
"51099040100",3352,140,1266,61,426,15,497,29,5786
"51099040200",3018,351,456,66,142,0,22,80,4135
"51099040300",5775,542,1283,140,97,0,148,0,7985
"51099040400",2930,102,657,60,188,0,35,0,3972
"51099040500",1978,163,382,53,133,7,84,0,2800
"51101950101",2836,374,652,183,31,24,128,0,4228
"51101950102",4628,234,723,145,174,10,0,0,5914
"51101950200",1369,79,849,83,135,10,9,0,2534
"51101950300",2582,276,300,24,74,66,144,57,3523
"51103030100",2338,91,778,190,110,12,101,0,3620
"51103030200",2087,211,1219,493,31,14,14,0,4069
"51103030300",2830,202,357,73,48,18,22,8,3558
"51103990100",0,0,0,0,0,0,0,0,0
"51105950100",2859,801,0,0,0,0,0,13,3673
"51105950200",2989,1019,17,0,49,0,15,0,4089
"51105950300",2463,1252,6,0,0,0,34,7,3762
"51105950400",2689,764,0,0,0,0,0,0,3453
"51105950500",3621,1169,28,0,55,0,19,10,4902
"51105950600",2734,1409,0,0,44,0,3,0,4190
"51107610101",3521,158,58,0,144,0,99,17,3997
"51107610102",3480,44,36,0,133,0,125,0,3818
"51107610201",3926,239,20,29,248,28,129,0,4619
"51107610202",4000,110,39,0,304,0,321,9,4783
"51107610300",6478,245,294,0,457,0,379,22,7875
"51107610400",3521,1,202,35,446,43,454,43,4745
"51107610503",4747,0,810,188,1374,24,405,0,7548
"51107610504",5269,182,850,80,471,35,958,63,7908
"51107610505",3557,575,259,61,1751,71,3347,245,9866
"51107610506",2705,72,472,0,1319,660,745,627,6600
"51107610507",4561,100,392,0,899,17,209,0,6178
"51107610601",6170,34,552,0,490,38,643,57,7984
"51107610602",1844,17,8,0,384,30,274,0,2557
"51107610603",1700,210,619,188,250,30,380,20,3397
"51107610604",5396,128,224,8,1077,8,815,29,7685
"51107610701",4518,206,112,0,91,80,293,175,5475
"51107610702",4920,235,246,12,347,60,508,106,6434
"51107610703",3779,31,119,0,413,20,359,10,4731
"51107610800",4928,55,64,11,281,27,257,27,5650
"51107610900",1853,66,285,45,43,3,31,8,2334
"51107611002",2260,102,431,14,1270,339,586,273,5275
"51107611004",5438,236,630,14,1186,0,570,114,8188
"51107611005",3868,141,480,105,808,45,426,0,5873
"51107611006",3704,17,315,29,1315,68,565,49,6062
"51107611009",4019,0,436,0,805,0,721,0,5981
"51107611010",1339,20,23,0,79,0,45,0,1506
"51107611011",2147,53,460,75,788,62,334,62,3981
"51107611012",2631,0,184,0,1486,0,34,0,4335
"51107611013",2472,64,347,2,1335,13,225,16,4474
"51107611014",3859,87,472,26,957,4,756,61,6222
"51107611015",1003,3,219,0,924,0,466,0,2615
"51107611016",1933,0,225,7,244,22,107,0,2538
"51107611017",2356,23,162,0,483,13,119,7,3163
"51107611018",1233,82,362,0,636,4,222,36,2575
"51107611019",3590,40,339,113,1901,0,390,0,6373
"51107611020",2921,155,229,0,1624,16,384,127,5456
"51107611021",2469,0,516,0,2607,0,97,0,5689
"51107611022",3204,19,475,23,2250,11,356,0,6338
"51107611023",4711,97,98,0,741,21,256,31,5955
"51107611024",4424,78,370,25,933,0,299,0,6129
"51107611025",3322,167,386,2,1505,0,494,0,5876
"51107611101",3101,51,318,0,666,6,580,6,4728
"51107611102",5101,26,283,0,693,0,782,0,6885
"51107611202",3876,64,403,2,585,0,240,0,5170
"51107611204",3588,214,537,13,1331,78,1790,84,7635
"51107611205",3011,508,471,63,1688,128,1176,411,7456
"51107611206",2919,132,218,0,1048,56,440,90,4903
"51107611207",2740,17,258,0,1100,0,230,0,4345
"51107611208",2850,19,266,0,1178,55,265,31,4664
"51107611209",5391,91,100,0,1487,23,859,48,7999
"51107611300",2978,59,585,123,1641,139,1751,117,7393
"51107611400",3098,128,586,29,1006,195,1662,229,6933
"51107611501",1081,118,350,17,1263,279,722,235,4065
"51107611502",3272,239,440,0,1763,45,1152,48,6959
"51107611601",2370,121,553,39,1048,23,565,72,4791
"51107611602",2235,124,270,27,877,87,1681,149,5450
"51107611700",2887,346,470,50,2452,117,1575,328,8225
"51107611801",3418,21,338,2,1951,41,507,0,6278
"51107611802",4190,31,703,0,4000,91,1058,0,10073
"51107611803",3648,199,499,0,2170,20,425,0,6961
"51107611804",2896,216,245,0,1727,88,105,194,5471
"51107611805",3632,83,207,21,849,84,215,0,5091
"51107611806",3648,13,644,1,2679,41,468,0,7494
"51107611900",3181,0,451,10,4157,0,213,0,8012
"51107980100",0,0,0,0,0,0,0,0,0
"51109950100",5366,375,739,166,141,20,0,10,6817
"51109950201",3081,487,1165,235,290,35,263,82,5638
"51109950202",2784,455,452,0,193,5,72,0,3961
"51109950300",6326,638,1131,95,306,0,298,0,8794
"51109950400",1400,208,866,165,15,31,0,68,2753
"51109950500",4618,463,845,44,66,13,10,0,6059
"51111930100",2549,345,934,441,119,159,81,149,4777
"51111930200",2223,719,666,337,77,19,57,40,4138
"51111930300",1293,200,861,310,21,20,0,119,2824
"51113930100",5508,730,673,234,321,149,55,50,7720
"51113930200",4342,558,381,73,108,1,0,0,5463
"51115951300",4026,511,303,62,91,0,66,57,5116
"51115951400",3007,261,403,61,132,0,2,0,3866
"51115990100",0,0,0,0,0,0,0,0,0
"51117930101",1567,168,532,302,68,190,113,182,3122
"51117930102",2193,355,262,66,14,1,14,1,2906
"51117930200",2751,103,1998,1232,169,34,92,34,6413
"51117930300",1395,150,783,267,40,72,39,41,2787
"51117930400",2401,683,1826,703,154,37,0,1,5805
"51117930500",1233,191,356,76,4,2,5,2,1869
"51117930600",1364,215,704,266,15,18,3,11,2596
"51117930700",1291,113,784,143,25,69,45,13,2483
"51117930800",2350,175,391,381,31,2,139,8,3477
"51119950900",1186,141,375,68,0,6,32,0,1808
"51119951000",2294,156,626,180,26,19,44,15,3360
"51119951100",1990,151,461,165,12,0,0,0,2779
"51119951200",2444,92,109,6,34,2,82,2,2771
"51119990100",0,0,0,0,0,0,0,0,0
"51121020100",0,0,0,0,0,0,0,0,0
"51121020201",2135,1893,58,80,435,541,0,136,5278
"51121020202",1644,397,14,34,87,46,101,0,2323
"51121020300",3489,1447,215,20,790,403,182,32,6578
"51121020400",1720,3886,14,403,565,827,100,201,7716
"51121020500",3830,1159,74,63,597,480,10,123,6336
"51121020600",3215,1344,3,86,530,228,64,173,5643
"51121020700",2913,1580,121,246,407,342,115,56,5780
"51121020800",4827,767,378,305,39,14,287,0,6617
"51121020900",4051,435,70,1,236,7,30,0,4830
"51121021000",4098,358,43,36,50,0,51,0,4636
"51121021100",6037,575,275,287,88,0,163,65,7490
"51121021200",5596,766,163,38,179,0,86,0,6828
"51121021300",3273,157,0,17,57,0,66,0,3570
"51121021400",4206,627,125,64,33,0,33,0,5088
"51121021500",7292,860,77,0,55,12,98,0,8394
"51125950100",3525,1041,1145,62,65,12,34,16,5900
"51125950200",4142,380,428,0,35,0,112,0,5097
"51125950300",2687,382,550,202,0,10,25,10,3866
"51127700100",4610,154,661,0,219,24,51,0,5719
"51127700200",3427,323,713,29,101,0,96,0,4689
"51127700300",6197,461,1012,58,224,25,205,25,8207
"51131930100",2143,359,1378,565,28,19,72,28,4592
"51131930200",2024,308,693,281,58,7,375,182,3928
"51131930300",2153,374,653,1012,6,15,196,42,4451
"51131990100",0,0,0,0,0,0,0,0,0
"51133020100",2838,103,425,255,9,0,61,0,3691
"51133020200",1682,200,1289,89,0,0,0,18,3278
"51133020300",3754,134,950,585,0,0,0,0,5423
"51133990100",0,0,0,0,0,0,0,0,0
"51135000100",2864,381,2143,439,305,47,214,1,6394
"51135000200",1712,366,735,154,16,35,77,16,3111
"51135000300",3065,465,1366,513,52,76,265,46,5848
"51135980100",0,0,8,0,0,0,0,0,8
"51137110102",6772,554,1256,154,24,89,399,0,9248
"51137110103",8005,655,691,190,538,31,387,63,10560
"51137110104",2181,271,335,43,200,8,81,0,3119
"51137110200",3088,778,603,212,57,57,196,29,5020
"51137110300",4708,783,520,282,131,72,32,39,6567
"51139030100",2445,342,0,0,14,0,11,10,2822
"51139030200",3361,484,99,44,136,65,63,16,4268
"51139030300",4167,597,131,0,62,7,68,72,5104
"51139030400",5055,1341,0,1,49,136,44,2,6628
"51139030500",4499,542,27,0,99,20,80,27,5294
"51141030100",4516,940,115,212,57,48,48,5,5941
"51141030200",4701,1037,223,17,17,54,293,0,6342
"51141030301",1789,278,381,42,4,0,17,13,2524
"51141030302",3103,479,185,0,0,0,79,9,3855
"51143010100",2583,316,935,162,66,2,0,5,4069
"51143010200",3043,536,759,75,45,0,94,14,4566
"51143010300",2646,516,415,543,20,25,125,1,4291
"51143010400",2671,356,588,122,128,14,81,19,3979
"51143010500",2693,184,796,393,51,0,37,0,4154
"51143010600",1955,245,572,172,87,19,44,3,3097
"51143010700",1085,68,496,218,77,0,319,12,2275
"51143010801",1090,128,960,232,0,5,0,5,2420
"51143010802",4542,468,708,173,185,44,16,54,6190
"51143010900",2264,375,257,0,10,22,0,22,2950
"51143011001",3085,352,654,154,22,69,24,69,4429
"51143011002",3488,445,451,159,73,1,0,1,4618
"51143011100",1642,249,639,128,13,1,20,1,2693
"51143011200",1635,237,354,20,169,31,0,13,2459
"51143011300",4817,389,633,379,63,341,77,222,6921
"51143011400",2660,388,726,222,154,29,75,13,4267
"51145500101",5516,264,189,12,94,0,72,0,6147
"51145500102",4614,259,115,33,291,0,0,0,5312
"51145500200",7302,412,495,72,100,105,190,6,8682
"51145500300",352,2,28,5,9,0,62,1,459
"51145500400",3784,139,517,44,88,0,65,0,4637
"51147930100",2142,556,1646,1290,85,136,22,45,5922
"51147930201",1448,263,411,157,0,19,11,0,2309
"51147930202",2127,224,1209,106,0,16,11,0,3693
"51147930203",0,0,23,0,0,0,0,0,23
"51147930300",4050,168,1593,713,103,11,245,16,6899
"51149850100",321,100,33,0,61,0,26,0,541
"51149850200",1737,0,1873,177,441,133,523,138,5022
"51149850301",3069,117,2064,387,783,121,723,121,7385
"51149850302",3093,148,916,130,141,0,203,31,4662
"51149850400",3946,281,652,219,135,0,57,0,5290
"51149850501",4021,237,992,189,207,0,28,0,5674
"51149850502",3324,132,1146,199,151,11,21,0,4984
"51153900100",2110,121,444,16,717,41,287,16,3752
"51153900201",1113,145,245,136,271,1,682,133,2726
"51153900202",2288,442,466,110,1163,24,2021,248,6762
"51153900203",1261,474,1826,58,676,136,1273,220,5924
"51153900300",3612,253,2014,13,1956,25,1738,73,9684
"51153900403",1904,120,1180,211,1672,40,720,21,5868
"51153900404",3243,356,1105,53,896,83,1749,276,7761
"51153900407",2370,190,2207,120,1103,81,1697,148,7916
"51153900408",1889,77,1353,59,1007,153,1014,88,5640
"51153900409",2441,110,1161,31,456,182,1354,266,6001
"51153900410",1322,381,2036,473,731,0,812,382,6137
"51153900501",4298,207,876,186,2499,84,4309,165,12624
"51153900502",1052,0,539,0,741,0,367,0,2699
"51153900600",3105,1236,737,173,1604,515,2628,1751,11749
"51153900701",2012,49,2038,164,1174,116,888,16,6457
"51153900702",3800,143,1353,259,2334,133,1623,208,9853
"51153900801",2298,123,1521,36,1503,0,795,0,6276
"51153900802",1841,342,3063,273,1150,104,1208,237,8218
"51153900901",1850,234,1912,753,592,549,875,633,7398
"51153900904",1736,225,2192,109,933,81,953,116,6345
"51153900905",2244,125,1948,112,633,13,528,0,5603
"51153901001",3385,184,1982,53,969,96,966,0,7635
"51153901005",3103,0,773,10,525,0,396,0,4807
"51153901008",2178,139,2427,159,1374,104,1495,132,8008
"51153901009",4228,230,1341,0,705,91,536,0,7131
"51153901010",2402,116,1187,25,306,0,100,0,4136
"51153901011",3198,0,1495,57,834,26,587,26,6223
"51153901012",1832,9,519,0,635,11,171,0,3177
"51153901100",3383,147,254,5,939,95,1027,8,5858
"51153901203",2278,45,730,128,549,135,870,25,4760
"51153901208",1997,73,706,35,80,40,298,22,3251
"51153901209",3499,171,1177,9,1242,60,1108,63,7329
"51153901211",1921,89,883,206,864,81,1238,81,5363
"51153901212",2354,137,2106,122,2098,205,1754,171,8947
"51153901219",4412,69,354,28,486,0,262,0,5611
"51153901221",2798,213,984,26,1268,0,980,185,6454
"51153901222",1964,30,414,0,359,0,403,0,3170
"51153901223",3937,124,1228,186,590,102,815,177,7159
"51153901224",2964,74,224,12,308,20,637,20,4259
"51153901225",2748,240,1146,0,474,95,888,35,5626
"51153901226",2402,0,1972,13,1340,81,946,0,6754
"51153901227",2696,54,1437,262,843,126,1375,126,6919
"51153901228",3404,267,1600,19,785,10,1121,131,7337
"51153901229",1784,20,788,203,1166,0,983,0,4944
"51153901230",2026,163,1031,0,923,91,912,0,5146
"51153901231",5050,104,206,0,532,20,674,0,6586
"51153901232",2301,51,51,56,683,0,204,0,3346
"51153901233",5368,103,388,0,777,0,548,0,7184
"51153901234",1932,132,46,60,135,235,7,0,2547
"51153901235",1827,0,331,0,947,0,405,0,3510
"51153901236",3031,31,1041,16,486,208,568,0,5381
"51153901237",1984,18,1216,186,192,0,323,0,3919
"51153901303",3297,215,716,0,789,0,964,215,6196
"51153901304",1870,96,267,0,84,74,399,36,2826
"51153901305",2196,103,34,0,320,0,137,55,2845
"51153901306",4450,60,706,325,136,0,231,325,6233
"51153901403",3585,271,894,129,1061,83,1339,285,7647
"51153901407",2106,265,806,0,322,43,1477,258,5277
"51153901408",3191,673,1278,306,1261,109,2235,368,9421
"51153901409",4065,100,589,3,936,54,1470,1,7218
"51153901410",5719,37,643,19,1564,0,873,6,8861
"51153901411",4152,178,502,0,1175,21,566,17,6611
"51153901412",4653,121,795,10,1490,68,868,38,8043
"51153901413",2878,29,475,32,918,53,628,0,5013
"51153901414",3345,19,875,0,709,0,236,0,5184
"51153901415",2770,0,396,0,835,162,433,148,4744
"51153901416",3747,84,919,0,759,0,342,84,5935
"51153901417",2293,13,18,0,61,7,105,7,2504
"51153901503",5137,37,52,0,973,0,597,0,6796
"51153901504",2820,25,87,216,175,0,13,0,3336
"51153901505",5106,122,848,0,1242,0,442,11,7771
"51153901506",3380,96,679,11,855,35,963,75,6094
"51153901507",1754,23,295,13,166,39,97,0,2387
"51153901508",2591,28,585,63,808,48,490,63,4676
"51153901509",4163,105,53,0,364,55,345,0,5085
"51153901510",3703,57,437,0,806,29,267,0,5299
"51153901511",2080,6,129,0,211,0,99,0,2525
"51153901601",2887,105,228,24,318,64,1315,15,4956
"51153901602",4969,279,1304,159,1085,106,2474,199,10575
"51153901701",4435,699,896,295,1128,456,2932,588,11429
"51153901702",2377,692,162,10,498,58,1246,727,5770
"51153901900",3021,277,597,54,1216,97,1304,107,6673
"51153980100",0,0,0,0,0,0,0,0,0
"51155210100",6111,699,110,17,155,15,105,0,7212
"51155210201",2402,618,208,182,252,0,15,0,3677
"51155210202",3334,203,49,0,45,0,0,0,3631
"51155210300",3219,500,278,36,16,27,42,0,4118
"51155210400",3886,968,182,254,113,0,130,0,5533
"51155210500",2467,265,16,0,24,0,0,0,2772
"51155210600",2843,226,201,82,12,0,84,0,3448
"51155210700",2940,539,130,60,84,0,70,0,3823
"51155980100",0,0,0,0,0,0,0,0,0
"51155980200",0,0,0,0,0,0,0,0,0
"51157950100",2271,235,174,7,83,0,140,0,2910
"51157950200",3791,523,133,9,128,26,83,0,4693
"51159040100",3194,367,599,198,88,60,69,111,4686
"51159040200",1546,295,599,20,355,0,191,55,3061
"51161030100",3068,316,40,42,12,0,64,0,3542
"51161030201",3853,93,459,69,142,0,139,8,4763
"51161030203",3097,380,105,0,77,16,41,107,3823
"51161030204",5169,278,373,182,42,99,116,23,6282
"51161030205",3075,55,414,28,184,45,124,0,3925
"51161030300",5582,264,257,12,175,0,239,1,6530
"51161030500",2932,135,60,0,129,0,0,0,3256
"51161030600",6886,267,38,13,281,199,189,81,7954
"51161030701",5959,79,19,7,509,3,13,3,6592
"51161030702",4640,343,393,64,282,96,38,0,5856
"51161030801",4403,261,324,128,474,189,193,2,5974
"51161030802",4326,93,25,6,237,10,172,0,4869
"51161030900",4777,321,73,57,325,4,8,6,5571
"51161031000",3622,253,293,0,30,15,83,0,4296
"51161031101",3481,455,233,232,54,22,21,275,4773
"51161031102",2852,183,258,174,0,0,0,41,3508
"51161031201",4208,279,112,94,132,72,17,4,4918
"51161031202",5812,56,254,0,318,0,103,0,6543
"51163930100",6562,1004,82,117,208,19,90,4,8086
"51163930200",3255,547,4,10,125,0,81,0,4022
"51163930300",5333,538,76,0,246,15,37,0,6245
"51163930400",3259,380,131,67,34,83,29,72,4055
"51165010100",2612,219,6,0,8,29,8,0,2882
"51165010200",2530,531,72,0,0,0,23,9,3165
"51165010300",4421,218,44,5,11,0,38,0,4737
"51165010400",2005,262,0,28,21,32,60,0,2408
"51165010500",2208,181,27,0,272,215,784,75,3762
"51165010600",3468,200,7,0,66,58,238,58,4095
"51165010700",2830,365,1,0,28,0,7,0,3231
"51165010800",5015,878,163,13,109,6,134,0,6318
"51165010900",2086,324,15,32,71,4,109,4,2645
"51165011000",2909,387,0,0,35,6,15,0,3352
"51165011100",3124,116,8,0,31,0,33,0,3312
"51165011200",4499,397,0,0,44,0,212,68,5220
"51165011400",4715,841,15,32,281,0,454,319,6657
"51165011500",3903,511,49,23,221,0,251,31,4989
"51165011600",1905,87,13,0,133,0,23,0,2161
"51165011700",2300,600,64,0,49,8,260,207,3488
"51165011800",7365,202,28,0,370,72,537,0,8574
"51165011900",2899,215,186,0,78,9,60,0,3447
"51165012000",3741,624,72,46,245,84,157,68,5037
"51167030100",3371,1196,24,0,140,74,1,0,4806
"51167030200",4195,1163,76,3,17,11,0,0,5465
"51167030300",3017,749,18,0,18,0,0,0,3802
"51167030401",4692,859,118,21,78,9,0,0,5777
"51167030402",2231,347,2,1,0,0,0,0,2581
"51167030500",1849,438,1,7,0,1,0,0,2296
"51167030600",2958,570,9,0,71,22,71,0,3701
"51169030100",2797,628,57,4,39,9,0,0,3534
"51169030200",3015,623,50,10,12,24,0,0,3734
"51169030300",2830,867,0,0,46,3,0,31,3777
"51169030400",3092,657,0,0,2,0,22,62,3835
"51169030500",3329,328,0,0,23,0,19,0,3699
"51169030600",2979,959,0,0,74,6,126,0,4144
"51171040100",7183,674,297,11,348,68,196,89,8866
"51171040201",2304,196,0,0,0,0,0,0,2500
"51171040202",2752,335,0,0,54,0,42,0,3183
"51171040300",3828,354,8,4,148,3,291,72,4708
"51171040400",2110,136,0,0,147,0,42,0,2435
"51171040500",6711,1382,182,180,39,19,475,358,9346
"51171040600",3202,206,11,1,171,12,187,95,3885
"51171040700",3188,692,78,5,162,6,320,63,4514
"51171040800",3763,577,17,7,203,19,383,42,5011
"51173030100",2743,286,0,0,0,18,0,0,3047
"51173030200",3563,932,12,0,45,17,60,17,4646
"51173030301",2185,440,74,60,0,8,4,8,2779
"51173030302",3246,636,218,82,41,0,35,15,4273
"51173030400",1741,273,0,0,46,0,15,62,2137
"51173030500",1923,436,0,2,22,0,21,2,2406
"51173030600",1726,872,56,0,48,80,82,0,2864
"51173030701",3820,856,5,0,42,93,51,168,5035
"51173030702",3989,678,0,0,29,0,0,0,4696
"51175200100",3007,229,809,143,95,0,30,40,4353
"51175200200",1231,212,834,338,62,0,0,23,2700
"51175200300",68,65,16,147,0,0,0,0,296
"51175200400",3444,399,1702,490,140,39,32,36,6282
"51175200500",1792,206,1121,459,111,18,3,0,3710
"51177020104",3596,366,596,72,316,13,395,14,5368
"51177020105",2065,41,61,0,88,0,62,0,2317
"51177020106",4101,94,382,0,644,0,336,0,5557
"51177020107",1432,126,400,0,34,0,72,0,2064
"51177020108",2458,163,492,400,333,29,404,36,4315
"51177020109",2443,134,209,333,235,206,81,192,3833
"51177020110",3004,277,275,5,345,0,485,0,4391
"51177020111",1578,18,462,0,162,0,157,0,2377
"51177020112",1530,179,711,5,168,38,326,19,2976
"51177020113",3539,42,821,109,186,0,254,14,4965
"51177020114",3716,73,760,524,667,11,569,0,6320
"51177020201",3246,267,899,91,975,162,484,115,6239
"51177020202",3333,154,938,9,548,55,408,37,5482
"51177020203",3271,149,940,181,302,39,172,73,5127
"51177020204",3754,107,248,0,558,0,365,0,5032
"51177020205",2903,249,727,68,282,57,388,65,4739
"51177020304",2646,240,569,10,638,19,448,8,4578
"51177020305",2201,283,589,0,59,118,64,118,3432
"51177020306",3299,36,1288,20,760,278,564,278,6523
"51177020307",2181,96,576,145,760,128,688,81,4655
"51177020308",2729,30,417,0,749,0,516,0,4441
"51177020309",4378,221,558,173,235,37,208,0,5810
"51177020310",3379,119,623,0,364,11,160,0,4656
"51177020311",3721,248,647,536,378,25,338,117,6010
"51177020403",3094,124,483,101,62,6,81,0,3951
"51177020404",2750,342,421,30,36,11,32,28,3650
"51177020405",2727,379,362,0,14,28,103,0,3613
"51177020406",2569,253,247,15,64,0,0,0,3148
"51177020407",3962,278,476,87,246,44,147,16,5256
"51177020408",1723,66,387,0,109,0,144,0,2429
"51179010103",2685,15,490,7,264,75,339,50,3925
"51179010105",4725,92,1431,284,910,65,576,30,8113
"51179010106",2818,74,133,5,57,0,14,0,3101
"51179010107",2587,73,212,0,118,27,243,20,3280
"51179010108",3310,11,1014,68,1110,75,912,4,6504
"51179010201",19,14,16,0,31,0,0,0,80
"51179010202",5004,140,433,0,540,0,478,21,6616
"51179010204",4882,295,922,44,629,45,402,28,7247
"51179010205",4781,161,1493,11,595,55,399,0,7495
"51179010206",3135,50,1135,0,585,40,555,40,5540
"51179010207",3192,401,1895,125,1755,191,1394,126,9079
"51179010210",3601,222,1862,0,891,164,448,170,7358
"51179010211",2453,19,847,0,451,420,311,342,4843
"51179010212",3055,119,701,10,874,11,1039,23,5832
"51179010213",1808,98,362,0,307,17,293,0,2885
"51179010214",2922,76,609,7,177,66,146,51,4054
"51179010301",2905,128,510,22,554,0,340,0,4459
"51179010303",5716,228,1668,108,726,175,436,139,9196
"51179010304",3502,168,1225,0,399,32,552,0,5878
"51179010305",3395,370,1110,33,593,258,226,295,6280
"51179010403",2177,105,356,10,236,1,157,0,3042
"51179010404",4305,293,825,40,775,15,565,0,6818
"51179010405",4862,92,931,9,448,0,433,0,6775
"51179010406",1921,243,446,28,327,111,176,10,3262
"51179010502",3798,98,221,0,160,28,240,7,4552
"51179010503",1989,97,31,30,90,0,13,0,2250
"51179010504",1340,115,44,31,38,9,20,0,1597
"51181860100",1582,166,1156,309,38,51,16,70,3388
"51181860200",1666,140,1625,128,57,4,6,4,3630
"51183870100",920,40,1381,161,0,2,11,5,2520
"51183870201",1150,108,715,214,9,10,0,10,2216
"51183870202",0,0,0,0,0,0,0,0,0
"51183870300",870,70,815,385,16,16,14,23,2209
"51183870400",761,61,496,222,13,1,3,3,1560
"51185020100",1895,310,7,7,8,14,0,0,2241
"51185020200",3817,533,147,71,33,68,0,0,4669
"51185020300",5169,1814,31,0,150,0,0,149,7313
"51185020400",3663,484,0,0,16,0,0,0,4163
"51185020500",2176,1129,0,0,113,0,0,0,3418
"51185020600",3828,718,69,0,80,45,0,35,4775
"51185020700",2020,427,0,19,154,61,0,0,2681
"51185020800",1708,524,117,41,66,0,21,0,2477
"51185020900",1648,549,0,0,26,0,0,0,2223
"51185021000",3286,541,13,16,58,0,50,0,3964
"51185021100",4743,525,236,46,188,0,0,0,5738
"51187020100",7034,515,72,34,224,14,285,0,8178
"51187020200",2390,257,136,0,28,0,9,172,2992
"51187020300",5981,360,146,27,265,0,76,0,6855
"51187020400",3234,359,265,186,226,20,183,0,4473
"51187020500",2606,444,404,25,480,13,257,0,4229
"51187020601",4834,226,14,65,221,0,227,0,5587
"51187020602",1707,690,57,0,114,54,63,0,2685
"51187020700",3138,156,32,0,13,21,81,0,3441
"51191010100",5836,740,15,0,120,0,76,0,6787
"51191010200",5496,163,0,0,8,0,0,0,5667
"51191010300",5522,789,0,5,35,48,31,25,6455
"51191010401",1866,93,24,0,92,0,38,0,2113
"51191010402",2585,298,23,28,0,1,78,0,3013
"51191010501",3260,511,134,5,29,42,38,44,4063
"51191010502",1977,892,105,55,25,40,12,89,3195
"51191010601",3715,459,122,0,117,0,156,0,4569
"51191010602",1557,313,9,0,66,1,0,1,1947
"51191010700",3796,875,22,16,32,7,20,48,4816
"51191010800",2509,479,0,1,20,0,0,0,3009
"51191010900",4040,372,16,0,26,2,8,0,4464
"51191011000",3519,213,3,1,120,0,56,0,3912
"51193010100",2029,552,1927,401,28,0,114,0,5051
"51193010200",1977,253,1111,109,104,7,117,18,3696
"51193010300",2040,297,681,170,48,0,706,0,3942
"51193010400",4403,417,756,40,59,0,76,0,5751
"51195930700",2494,699,0,0,40,0,0,0,3233
"51195930800",1678,545,0,0,0,0,0,0,2223
"51195930900",3234,563,25,0,50,18,0,2,3892
"51195931000",2685,320,0,7,56,0,0,0,3068
"51195931100",1981,718,0,58,75,17,11,0,2860
"51195931200",3550,1354,201,86,49,65,52,100,5457
"51195931300",2816,860,0,64,42,0,20,0,3802
"51195931400",3501,538,0,0,54,0,0,0,4093
"51195931500",3784,1059,108,68,56,17,22,79,5193
"51195931600",1886,726,21,27,14,23,20,39,2756
"51195931700",1367,534,39,0,29,0,4,4,1977
"51197050100",4381,366,481,190,36,0,86,3,5543
"51197050200",4968,989,256,48,132,0,71,0,6464
"51197050301",3548,691,41,0,15,14,81,0,4390
"51197050302",3202,399,0,0,7,10,0,0,3618
"51197050401",3273,557,9,15,33,8,20,9,3924
"51197050402",4336,871,45,2,11,0,0,25,5290
"51199050203",4722,58,705,58,1069,52,167,12,6843
"51199050204",3941,261,765,40,633,15,751,0,6406
"51199050205",4055,54,416,29,418,0,101,0,5073
"51199050206",5367,167,658,0,598,31,341,0,7162
"51199050303",4263,248,373,0,377,160,171,36,5628
"51199050304",4669,246,229,0,209,33,105,20,5511
"51199050305",2061,132,186,0,604,0,160,32,3175
"51199050306",3388,251,582,88,355,37,79,0,4780
"51199050401",2732,43,435,0,171,0,150,0,3531
"51199050402",3437,116,28,0,37,0,14,0,3632
"51199050500",1243,25,1289,303,84,119,482,107,3652
"51199050900",917,9,608,171,44,57,86,0,1892
"51199051000",2715,259,149,79,128,13,37,54,3434
"51199051100",4606,98,1253,347,429,56,218,0,7007
"51199990100",0,0,0,0,0,0,0,0,0
"51510200102",2110,424,696,83,1205,0,1340,175,6033
"51510200103",2680,128,2668,168,1259,344,1540,285,9072
"51510200104",1252,140,1181,102,784,400,929,379,5167
"51510200105",754,83,3054,468,454,21,185,68,5087
"51510200106",1883,98,368,10,545,0,222,74,3200
"51510200107",3498,151,754,101,902,218,571,23,6218
"51510200201",2178,42,511,206,168,0,162,16,3283
"51510200202",1427,41,73,0,91,9,85,0,1726
"51510200301",1523,125,634,57,620,97,307,94,3457
"51510200302",2129,170,1554,20,703,94,721,17,5408
"51510200303",2425,332,1035,103,708,229,696,132,5660
"51510200403",809,9,313,0,240,30,61,9,1471
"51510200404",2911,12,509,0,433,0,261,0,4126
"51510200405",2810,268,1941,182,1242,162,1646,219,8470
"51510200406",1612,169,1601,156,1227,77,1092,62,5996
"51510200407",2569,110,1222,92,556,0,310,0,4859
"51510200500",1990,108,1352,137,502,50,1003,0,5142
"51510200600",2574,97,915,326,1160,20,1229,66,6387
"51510200701",571,39,53,0,38,0,77,0,778
"51510200702",3354,130,125,28,232,23,548,0,4440
"51510200703",1548,31,561,471,223,30,146,20,3030
"51510200801",2201,65,396,5,246,15,50,52,3030
"51510200802",2141,66,323,287,176,22,369,54,3438
"51510200900",4250,127,33,42,307,0,134,0,4893
"51510201000",2375,44,69,0,244,31,226,12,3001
"51510201100",2662,33,118,7,390,16,187,24,3437
"51510201202",2632,98,338,1,209,33,611,12,3934
"51510201203",3161,1112,547,229,877,17,2634,1088,9665
"51510201204",1742,124,705,39,591,0,962,84,4247
"51510201300",2540,80,294,211,235,0,326,0,3686
"51510201400",3502,79,145,99,405,69,683,69,5051
"51510201500",3126,60,15,0,224,0,94,0,3519
"51510201600",2620,105,828,957,253,10,122,0,4895
"51510201801",4326,32,484,156,312,40,465,0,5815
"51510201802",1515,29,140,252,59,0,82,0,2077
"51510201900",1360,52,60,12,86,6,85,0,1661
"51510202001",1815,51,15,0,134,0,65,0,2080
"51510202002",1928,46,81,0,87,0,97,0,2239
"51515050100",3854,613,829,425,61,55,94,12,5943
"51520020100",3020,623,215,2,0,37,4,22,3923
"51520020200",3137,958,289,271,0,114,0,68,4837
"51520020300",1562,861,66,218,128,61,0,0,2896
"51520020400",5171,380,24,0,45,100,59,0,5779
"51530930600",4517,1198,332,95,130,0,0,56,6328
"51540000201",1392,367,541,207,87,141,102,22,2859
"51540000202",545,2259,727,399,167,297,0,101,4495
"51540000302",1658,191,375,12,77,18,56,1,2388
"51540000401",1054,440,1086,490,225,11,267,33,3606
"51540000402",2498,637,568,28,102,25,35,36,3929
"51540000501",981,208,1598,369,193,184,84,152,3769
"51540000502",2858,651,825,102,343,153,0,24,4956
"51540000600",994,1623,85,84,300,503,207,107,3903
"51540000700",2238,513,45,63,244,134,132,68,3437
"51540000800",2568,456,374,107,133,215,314,22,4189
"51540000900",1992,87,50,47,87,0,155,0,2418
"51540001000",2337,173,144,35,115,0,73,28,2905
"51550020001",1035,154,30,0,51,0,75,0,1345
"51550020002",1949,301,1260,375,248,77,277,47,4534
"51550020003",4144,211,595,246,94,38,247,0,5575
"51550020100",568,40,2722,985,105,32,184,0,4636
"51550020200",267,10,2622,1338,84,0,0,7,4328
"51550020300",448,55,523,428,147,49,17,23,1690
"51550020400",1525,289,1015,162,73,7,80,0,3151
"51550020500",552,117,338,46,287,0,352,128,1820
"51550020600",3022,226,655,10,40,0,367,0,4320
"51550020700",1281,489,2647,375,151,14,334,266,5557
"51550020804",5040,311,1060,294,726,0,340,0,7771
"51550020805",3009,108,1773,121,675,53,138,43,5920
"51550020806",4452,293,1674,68,726,0,173,13,7399
"51550020807",4542,43,2015,81,712,27,261,10,7691
"51550020808",657,14,2768,212,228,0,219,0,4098
"51550020809",2667,131,1570,149,300,6,228,6,5057
"51550020903",549,121,1797,219,44,0,62,0,2792
"51550020904",4981,141,2206,560,583,40,210,17,8738
"51550020905",1937,181,484,55,146,0,270,38,3111
"51550020906",3888,328,2007,269,605,0,383,0,7480
"51550021004",4443,115,567,64,695,0,374,17,6275
"51550021005",3047,312,778,20,317,69,374,0,4917
"51550021006",6285,409,468,0,395,0,156,0,7713
"51550021009",3663,37,108,31,174,0,73,0,4086
"51550021010",4476,123,579,34,315,55,157,12,5751
"51550021011",3106,67,141,0,113,0,51,0,3478
"51550021012",5084,164,216,18,431,0,359,36,6308
"51550021013",3599,69,608,90,517,0,252,0,5135
"51550021101",4564,130,216,6,105,0,211,0,5232
"51550021102",4881,288,543,17,505,0,99,1,6334
"51550021200",4357,258,404,22,265,48,119,37,5510
"51550021301",3112,266,1405,87,295,0,200,0,5365
"51550021302",4951,273,2574,359,629,149,307,246,9488
"51550021401",1273,92,457,19,69,9,41,6,1966
"51550021402",4174,418,1162,65,616,210,185,154,6984
"51550021403",2674,262,1054,222,293,131,302,105,5043
"51550021404",1313,306,4956,445,158,30,247,103,7558
"51550021501",4755,280,4124,788,1059,94,562,0,11662
"51550021502",5240,581,1455,44,638,0,58,0,8016
"51550021601",6176,206,975,87,879,13,66,0,8402
"51550021602",2725,65,2591,777,474,91,421,0,7144
"51570830100",4309,158,138,103,169,21,129,0,5027
"51570830200",1782,349,307,187,243,19,7,0,2894
"51570830300",1800,99,546,22,302,0,140,19,2928
"51570830400",1728,259,363,69,83,0,111,0,2613
"51570830500",3206,285,552,29,137,0,339,0,4548
"51580060100",1915,631,574,27,66,13,0,48,3274
"51580060200",1765,557,75,4,175,3,86,0,2665
"51590000100",2547,152,2250,693,96,91,7,0,5836
"51590000200",1370,489,1212,467,79,110,108,24,3859
"51590000300",855,265,1216,781,5,35,0,5,3162
"51590000400",411,191,1629,1144,0,17,0,56,3448
"51590000500",193,84,662,563,21,27,0,0,1550
"51590000600",532,131,1218,885,95,33,108,8,3010
"51590000700",2135,234,240,137,27,42,53,0,2868
"51590000800",1228,152,885,363,84,0,0,0,2712
"51590000900",1971,580,789,402,68,151,5,213,4179
"51590001000",758,198,1094,1224,34,18,34,47,3407
"51590001100",375,46,575,394,22,21,9,7,1449
"51590001200",645,316,294,194,217,68,189,75,1998
"51590001301",577,99,479,53,21,10,23,0,1262
"51590001302",345,255,166,5,15,4,41,41,872
"51590001400",2066,155,281,35,265,7,194,0,3003
"51590980100",13,0,0,10,0,0,0,0,23
"51595890100",247,126,1628,779,107,28,88,0,3003
"51595890200",1270,112,615,561,73,2,0,0,2633
"51600300100",2764,162,280,117,1068,279,446,0,5116
"51600300200",3716,84,19,21,1009,82,967,47,5945
"51600300300",3614,256,205,0,1737,92,1191,7,7102
"51600300400",2254,119,235,104,818,32,723,0,4285
"51600300500",2512,263,146,0,462,8,277,8,3676
"51610500100",2717,64,45,2,156,12,129,1,3126
"51610500200",3657,88,500,88,1340,144,880,45,6742
"51610500300",3244,32,40,0,522,74,124,10,4046
"51620090100",2812,209,1225,76,247,0,38,34,4641
"51620090200",166,91,1975,1537,31,15,19,0,3834
"51630000100",2185,268,259,45,159,32,141,17,3106
"51630000200",3090,1047,840,482,471,81,611,134,6756
"51630000301",69,372,0,0,0,0,0,0,441
"51630000302",3196,473,552,73,260,295,532,172,5553
"51630000400",814,321,1421,106,124,71,117,26,3000
"51630000500",2707,327,1825,309,1070,40,839,35,7152
"51640070101",2854,1275,109,20,90,76,156,445,5025
"51640070102",1846,282,59,15,39,22,316,106,2685
"51650010103",4698,434,1493,85,506,149,369,154,7888
"51650010104",2161,115,2519,1358,322,107,95,43,6720
"51650010200",467,0,91,0,39,24,49,0,670
"51650010304",2762,72,2769,358,781,0,378,0,7120
"51650010306",3024,101,2552,378,729,0,639,226,7649
"51650010307",1990,60,2267,265,509,31,150,47,5319
"51650010309",1642,308,2143,229,182,0,167,0,4671
"51650010310",2203,157,1663,81,453,0,263,0,4820
"51650010311",1378,39,1823,404,430,12,236,0,4322
"51650010312",2475,247,746,54,46,11,70,56,3705
"51650010313",1910,476,2325,632,424,90,170,30,6057
"51650010314",437,92,1144,0,70,3,65,0,1811
"51650010400",1323,91,4379,1173,54,0,58,0,7078
"51650010501",1441,60,3516,917,159,92,203,0,6388
"51650010502",201,78,1838,649,324,10,160,0,3260
"51650010601",347,14,1103,790,0,0,117,0,2371
"51650010602",358,14,1442,974,75,21,53,155,3092
"51650010701",1278,224,885,820,264,126,100,76,3773
"51650010702",2315,310,960,1,199,0,74,0,3859
"51650010703",2122,51,699,8,125,0,308,0,3313
"51650010800",3078,49,1780,377,338,0,118,17,5757
"51650010900",278,78,1216,499,41,36,192,0,2340
"51650011000",2717,218,1923,466,339,0,7,9,5679
"51650011100",298,9,161,0,96,0,2,0,566
"51650011200",1392,258,496,366,295,34,237,0,3078
"51650011300",966,48,871,529,40,0,111,18,2583
"51650011400",29,31,56,346,0,0,29,19,510
"51650011500",2827,175,641,164,168,0,294,19,4288
"51650011600",751,46,1348,521,229,0,177,0,3072
"51650011800",1093,141,2474,839,189,40,134,0,4910
"51650011900",160,137,2011,592,29,67,32,112,3140
"51650012000",418,170,1627,371,119,5,113,0,2823
"51650012100",4346,190,627,21,382,0,246,0,5812
"51650990100",0,0,0,0,0,0,0,0,0
"51660000101",3181,713,586,178,255,25,1107,178,6223
"51660000102",2643,890,367,339,253,125,530,344,5491
"51660000203",1089,515,5,0,7,23,21,54,1714
"51660000204",1667,1222,111,164,267,39,559,244,4273
"51660000205",2888,1699,47,115,389,159,968,0,6265
"51660000206",199,52,0,0,0,0,21,0,272
"51660000207",698,3470,8,207,70,559,207,225,5444
"51660000301",2610,486,39,26,181,20,564,4,3930
"51660000302",2984,946,275,40,417,198,897,335,6092
"51660000401",1762,170,95,24,245,82,96,60,2534
"51660000402",4343,1438,208,258,253,6,1250,364,8120
"51670820100",500,353,446,174,11,61,61,186,1792
"51670820300",942,178,640,432,282,6,221,0,2701
"51670820400",3823,201,1039,571,176,0,157,0,5967
"51670820500",3300,454,463,313,86,0,44,0,4660
"51670820600",1687,491,1517,663,604,28,698,51,5739
"51670820700",205,6,1672,465,104,0,35,0,2487
"51670980100",0,0,0,0,0,0,0,0,0
"51678930500",2025,585,455,67,141,229,77,230,3809
"51680000100",3242,222,186,89,89,0,136,0,3964
"51680000201",5110,481,372,67,195,5,63,2,6295
"51680000202",3507,848,1317,819,195,58,45,30,6819
"51680000203",61,195,22,19,43,0,0,0,340
"51680000300",1956,300,677,245,67,52,85,9,3391
"51680000400",869,143,1486,637,81,0,1,0,3217
"51680000500",142,66,64,79,5,15,0,0,371
"51680000600",357,63,1397,1004,269,0,267,0,3357
"51680000700",900,417,1122,579,118,245,16,38,3435
"51680000801",1205,397,163,227,25,31,70,0,2118
"51680000802",2048,377,471,52,210,34,57,33,3282
"51680000900",3083,497,1185,758,261,129,397,0,6310
"51680001000",1987,152,407,192,56,104,24,42,2964
"51680001100",360,82,664,286,28,70,10,17,1517
"51680001400",103,176,1,87,0,0,0,0,367
"51680001600",3396,2267,872,574,806,637,400,115,9067
"51680001700",3235,446,531,27,290,101,88,0,4718
"51680001800",1506,140,264,39,65,34,141,15,2204
"51680001900",1123,768,1889,1184,298,34,0,0,5296
"51683910100",2932,318,321,248,314,6,650,147,4936
"51683910201",3608,227,231,2,504,39,1021,106,5738
"51683910202",4957,476,1010,37,1212,132,2265,334,10423
"51683910301",2608,669,754,33,519,10,944,596,6133
"51683910302",4017,591,427,83,715,154,1717,321,8025
"51683910401",3411,1223,1618,25,364,143,2394,1335,10513
"51683910402",3871,116,716,39,508,19,680,17,5966
"51685920100",5304,159,277,0,938,68,3074,158,9978
"51685920200",4409,403,1479,246,1633,186,1727,105,10188
"51690000100",1205,129,1295,442,79,0,211,0,3361
"51690000200",74,50,1394,1148,0,171,0,0,2837
"51690000300",1221,255,420,368,45,0,39,0,2348
"51690000400",822,364,376,285,301,141,304,12,2605
"51690000500",2332,122,116,152,47,0,0,0,2769
"51700030100",364,158,1408,1779,85,23,37,39,3893
"51700030300",535,147,3234,1831,83,362,153,257,6602
"51700030400",55,11,1880,1419,25,104,17,81,3592
"51700030500",0,0,1289,477,35,31,13,0,1845
"51700030600",46,30,1702,862,42,0,14,0,2696
"51700030800",0,0,1327,588,42,0,26,7,1990
"51700030900",465,29,940,472,110,0,80,0,2096
"51700031100",1196,70,1061,90,119,0,16,0,2552
"51700031200",620,90,876,322,152,14,74,24,2172
"51700031300",1021,38,2035,567,115,92,93,0,3961
"51700031400",2439,399,2208,541,126,4,175,51,5943
"51700031500",4512,182,772,145,373,83,252,6,6325
"51700031601",3018,391,2544,195,350,35,295,218,7046
"51700031602",2515,372,541,27,264,3,142,35,3899
"51700031701",1429,241,306,157,128,51,97,0,2409
"51700031702",2246,171,693,177,105,54,117,25,3588
"51700031800",3622,253,147,8,212,0,57,0,4299
"51700031901",3114,72,262,55,179,33,0,1,3716
"51700031902",2375,81,722,255,291,20,195,0,3939
"51700032001",2452,57,276,11,226,17,63,0,3102
"51700032002",3956,86,1457,30,617,29,295,39,6509
"51700032005",1936,87,405,27,141,0,44,0,2640
"51700032006",786,334,1228,898,351,57,249,256,4159
"51700032007",2151,215,939,123,302,0,218,8,3956
"51700032113",1267,255,519,36,149,34,174,103,2537
"51700032114",1125,34,303,15,243,0,95,2,1817
"51700032117",2199,311,1132,613,131,13,195,0,4594
"51700032123",2405,158,2111,412,587,159,795,41,6668
"51700032124",1230,133,2040,168,588,40,292,29,4520
"51700032126",2425,274,642,40,317,51,1047,245,5041
"51700032127",2005,469,997,123,200,99,269,26,4188
"51700032128",1678,215,821,413,385,49,960,142,4663
"51700032129",1230,77,1329,442,174,30,95,23,3400
"51700032130",3418,124,1154,0,657,0,279,42,5674
"51700032131",2592,196,1534,107,356,73,218,89,5165
"51700032132",2973,355,1200,321,432,195,731,104,6311
"51700032211",3532,41,1455,0,649,85,218,0,5980
"51700032212",455,239,2081,719,313,164,478,228,4677
"51700032223",1183,93,1227,265,446,30,351,0,3595
"51700032224",2271,106,3162,908,907,41,320,26,7741
"51700032225",711,336,2317,513,129,16,121,120,4263
"51700032226",1768,270,1002,45,376,77,500,241,4279
"51700032300",1625,218,866,0,713,237,640,131,4430
"51700032400",1768,52,967,37,267,55,246,7,3399
"51710000100",1583,193,623,10,87,0,75,10,2581
"51710000201",1330,200,526,165,504,43,210,38,3016
"51710000202",2508,492,355,140,464,139,111,50,4259
"51710000300",1473,221,589,341,526,27,398,16,3591
"51710000400",2151,277,783,100,213,33,255,12,3824
"51710000500",2005,340,196,70,188,28,148,55,3030
"51710000600",2014,207,1368,321,407,126,355,166,4964
"51710000700",1758,194,451,49,267,0,88,56,2863
"51710000800",1354,73,543,81,207,125,346,48,2777
"51710000901",2029,401,799,38,384,102,495,150,4398
"51710000902",714,47,407,6,266,0,120,0,1560
"51710001100",1161,71,433,203,440,303,247,0,2858
"51710001200",2346,311,733,124,264,0,286,40,4104
"51710001300",1085,95,822,331,162,0,159,26,2680
"51710001400",1527,239,382,109,364,8,196,0,2825
"51710001500",1149,75,626,62,95,67,161,0,2235
"51710001600",199,70,1325,315,116,19,46,0,2090
"51710001700",1444,19,500,270,179,29,169,29,2639
"51710002000",965,81,208,0,21,0,58,0,1333
"51710002100",1201,112,105,25,18,0,43,39,1543
"51710002200",1457,121,202,0,125,0,25,0,1930
"51710002300",1823,227,3,0,165,36,38,0,2292
"51710002400",3110,311,65,26,128,9,96,0,3745
"51710002500",209,560,734,544,82,18,44,51,2242
"51710002600",756,789,215,363,233,201,36,158,2751
"51710002700",449,43,1596,617,200,18,64,9,2996
"51710002800",2271,363,972,102,280,57,371,43,4459
"51710002900",338,232,2557,564,103,84,93,17,3988
"51710003000",1104,189,496,85,178,32,105,0,2189
"51710003100",740,80,1450,508,484,91,192,104,3649
"51710003200",496,99,1545,299,176,25,93,23,2756
"51710003300",270,13,2080,285,9,8,39,0,2704
"51710003400",160,43,1194,703,9,29,67,0,2205
"51710003501",18,18,1836,1181,61,73,0,55,3242
"51710003600",1033,71,126,18,106,12,38,5,1409
"51710003700",1525,270,153,117,114,8,40,0,2227
"51710003800",2349,265,68,9,127,0,83,0,2901
"51710004001",1139,36,34,0,81,9,42,0,1341
"51710004002",2399,434,47,67,79,179,56,19,3280
"51710004100",0,5,615,1207,0,34,0,17,1878
"51710004200",0,0,596,1062,0,0,0,0,1658
"51710004300",47,48,1492,1551,113,92,10,36,3389
"51710004400",64,0,1176,285,22,0,0,0,1547
"51710004500",17,0,1546,108,69,17,5,7,1769
"51710004600",121,33,897,649,59,0,1,0,1760
"51710004700",30,7,296,59,7,0,0,0,399
"51710004800",0,2,326,1020,0,0,0,70,1418
"51710004900",2272,237,191,163,168,7,62,0,3100
"51710005000",30,10,2169,569,0,75,17,23,2893
"51710005100",147,47,2553,1811,262,99,62,105,5086
"51710005500",1442,288,1179,431,233,268,707,343,4891
"51710005601",3341,313,282,394,238,45,140,36,4789
"51710005602",2227,210,615,115,77,50,95,28,3417
"51710005701",1228,231,2225,1103,541,10,704,138,6180
"51710005702",412,38,2016,184,70,78,71,9,2878
"51710005800",605,46,2930,673,133,206,295,172,5060
"51710005901",1115,175,2771,787,366,125,653,71,6063
"51710005902",1133,192,928,501,705,75,88,9,3631
"51710005903",631,16,647,183,369,7,84,0,1937
"51710006000",1839,685,926,218,218,11,293,4,4194
"51710006100",2840,537,3370,371,709,126,482,135,8570
"51710006200",1254,222,1187,193,275,34,135,20,3320
"51710006400",868,27,2193,562,167,82,195,0,4094
"51710006501",1335,460,671,492,170,95,81,26,3330
"51710006502",1686,136,361,260,200,76,99,0,2818
"51710006601",603,14,396,15,43,0,7,0,1078
"51710006602",2210,119,23,7,255,0,74,0,2688
"51710006603",1879,225,385,83,281,29,186,17,3085
"51710006604",961,147,442,219,289,133,205,30,2426
"51710006605",1684,71,549,37,244,25,175,0,2785
"51710006606",1980,364,1375,318,362,21,174,189,4783
"51710006607",1160,115,880,31,543,223,162,36,3150
"51710006800",934,191,303,33,317,9,201,14,2002
"51710006901",799,369,1567,201,620,114,318,178,4166
"51710006902",1478,142,279,186,198,14,31,5,2333
"51710007001",236,126,1172,67,160,7,31,13,1812
"51710007002",1030,98,2164,107,115,124,170,67,3875
"51710980100",0,0,0,0,0,0,0,0,0
"51710980200",0,0,0,0,0,0,0,0,0
"51710980300",0,0,0,0,0,0,0,0,0
"51710990000",0,0,0,0,0,0,0,0,0
"51720960100",2868,699,266,0,100,16,91,0,4040
"51730810100",58,80,1315,1382,0,67,0,49,2951
"51730810300",377,14,1311,614,99,28,75,28,2546
"51730810400",29,8,850,660,3,10,21,10,1591
"51730810500",273,68,2342,1384,4,47,66,10,4194
"51730810600",15,19,1140,415,52,38,10,18,1707
"51730810700",82,172,1420,582,15,10,63,32,2376
"51730810900",725,47,1967,387,141,18,166,14,3465
"51730811000",1270,174,2150,566,137,0,135,0,4432
"51730811100",640,44,1777,90,77,0,44,0,2672
"51730811200",834,81,2129,662,183,49,360,56,4354
"51730811300",507,73,1197,650,63,0,62,0,2552
"51735340100",3362,120,21,0,141,0,81,0,3725
"51735340200",4685,367,0,0,189,109,80,0,5430
"51735340300",2822,77,0,0,131,0,82,0,3112
"51735990100",0,0,0,0,0,0,0,0,0
"51740210200",1414,144,377,133,45,29,0,0,2142
"51740210300",1320,128,836,0,110,0,112,0,2506
"51740210400",1098,102,204,95,112,0,67,40,1718
"51740210500",135,8,1071,694,60,28,115,23,2134
"51740210600",791,77,322,125,101,33,191,0,1640
"51740210900",1570,184,676,160,81,9,80,40,2800
"51740211100",75,52,853,460,0,175,0,0,1615
"51740211400",0,0,1158,184,15,0,0,0,1357
"51740211500",599,43,359,472,53,33,0,0,1559
"51740211600",2857,258,631,97,262,41,271,9,4426
"51740211700",192,42,2282,235,48,112,0,13,2924
"51740211800",115,9,1100,2584,0,49,0,49,3906
"51740211900",60,0,1398,571,3,0,0,0,2032
"51740212000",8,3,1065,670,112,10,0,10,1878
"51740212100",9,6,834,425,14,0,0,0,1288
"51740212300",1870,360,1477,913,189,82,38,37,4966
"51740212400",1300,24,1233,953,229,46,182,46,4013
"51740212500",1045,145,394,197,179,40,12,0,2012
"51740212600",554,31,356,23,13,13,0,0,990
"51740212701",59,0,4178,797,99,9,79,0,5221
"51740212702",58,8,2310,589,0,148,0,34,3147
"51740212801",2311,340,1367,112,137,59,90,0,4416
"51740212802",1997,108,420,12,255,0,86,10,2888
"51740212900",4100,257,437,65,119,9,0,0,4987
"51740213001",3439,72,1369,41,581,31,513,0,6046
"51740213002",3266,161,597,53,154,0,40,0,4271
"51740213101",894,104,2952,914,426,70,266,78,5704
"51740213103",2735,299,2380,593,473,0,161,88,6729
"51740213104",853,27,2505,473,259,30,77,0,4224
"51740213200",524,4,829,274,64,22,32,22,1771
"51740980100",0,0,0,0,0,0,0,0,0
"51750010101",1833,1620,58,53,69,72,61,17,3783
"51750010102",1068,1797,0,107,29,146,3,87,3237
"51750010200",4562,1197,509,155,447,47,159,26,7102
"51760010200",2814,287,669,169,221,11,41,0,4212
"51760010300",33,11,1282,430,15,0,24,0,1795
"51760010401",1957,106,529,401,195,2,5,0,3195
"51760010402",1472,160,735,247,67,6,31,0,2718
"51760010500",217,60,893,95,32,12,7,0,1316
"51760010600",256,27,1504,174,98,0,0,0,2059
"51760010700",60,0,2040,600,0,8,0,0,2708
"51760010800",131,149,2804,785,68,13,5,36,3991
"51760010900",151,142,1646,377,205,24,119,0,2664
"51760011000",97,17,1520,432,8,77,0,0,2151
"51760011100",172,227,1244,547,120,24,11,47,2392
"51760020100",6,41,511,1069,0,0,0,0,1627
"51760020200",72,207,1426,2687,4,73,72,129,4670
"51760020300",60,26,984,631,0,3,0,3,1707
"51760020400",0,0,1835,1783,7,24,23,0,3672
"51760020500",1685,405,534,412,361,298,82,35,3812
"51760020600",843,135,452,99,73,14,9,0,1625
"51760020700",238,66,418,491,0,0,0,6,1219
"51760020800",712,43,425,94,89,5,20,0,1388
"51760020900",284,157,2261,262,11,78,0,18,3071
"51760021000",365,101,597,585,6,0,14,0,1668
"51760021100",175,30,882,271,4,0,28,0,1390
"51760021200",193,19,1306,208,41,0,0,0,1767
"51760030100",6,45,752,1851,60,184,0,44,2942
"51760030200",562,567,314,132,353,48,4,4,1984
"51760030500",952,505,408,314,346,485,0,57,3067
"51760040200",894,803,652,344,64,208,55,184,3204
"51760040300",169,183,28,67,40,153,15,43,698
"51760040400",1288,1449,222,485,70,141,0,109,3764
"51760040500",2454,486,229,57,115,9,62,33,3445
"51760040600",1145,352,118,71,54,16,0,0,1756
"51760040700",2020,184,214,76,127,45,162,31,2859
"51760040800",1283,253,73,29,37,4,97,70,1846
"51760040900",1878,406,133,37,219,25,36,40,2774
"51760041000",2315,241,17,22,159,0,46,4,2804
"51760041100",2283,1045,482,312,78,139,111,35,4485
"51760041200",730,368,31,24,37,119,19,34,1362
"51760041300",450,180,1366,722,92,142,0,0,2952
"51760041400",725,66,837,314,22,22,26,0,2012
"51760041600",648,110,579,51,34,14,18,1,1455
"51760050100",2277,224,204,65,19,0,64,15,2868
"51760050200",2541,129,46,0,128,0,13,0,2857
"51760050300",1010,86,4,0,147,0,3,7,1257
"51760050400",2436,115,151,0,84,14,64,38,2902
"51760050500",2407,177,0,0,56,0,0,0,2640
"51760050600",2302,54,15,0,94,9,11,9,2494
"51760060200",175,34,1360,593,32,0,26,59,2279
"51760060400",512,391,2598,1214,162,388,62,36,5363
"51760060500",2713,185,2007,615,453,155,79,40,6247
"51760060600",2032,62,235,0,24,21,72,0,2446
"51760060700",167,219,2232,2320,150,9,126,18,5241
"51760060800",670,69,1269,760,316,154,611,212,4061
"51760060900",495,252,350,239,198,99,434,171,2238
"51760061000",840,136,1185,915,170,100,46,0,3392
"51760070100",3214,167,932,2,330,0,254,0,4899
"51760070300",1623,175,922,234,160,96,238,241,3689
"51760070400",2968,122,606,36,102,26,35,1,3896
"51760070601",1367,1362,1767,364,749,618,1591,1680,9498
"51760070602",401,39,1372,306,308,0,343,7,2776
"51760070700",983,196,2776,627,222,183,603,246,5836
"51760070801",1540,399,3915,1232,291,262,965,209,8813
"51760070802",804,39,1143,539,355,7,443,0,3330
"51760070900",1103,433,3305,1407,197,195,341,166,7147
"51760071001",636,192,3187,609,397,76,67,95,5259
"51760071002",572,142,1834,405,289,148,253,116,3759
"51760071100",2281,106,1833,279,222,13,44,17,4795
"51770000100",915,405,1965,375,187,11,114,13,3985
"51770000300",3074,549,746,149,281,22,779,240,5840
"51770000400",3041,462,284,76,74,17,161,165,4280
"51770000500",2625,325,782,374,109,322,411,21,4969
"51770000601",4049,607,349,109,280,0,211,0,5605
"51770000602",2720,299,121,57,746,109,785,117,4954
"51770000900",777,485,2687,1778,24,44,0,37,5832
"51770001000",557,458,591,592,115,22,112,28,2475
"51770001100",571,44,37,6,35,2,13,8,716
"51770001200",1754,459,128,268,209,133,203,0,3154
"51770001800",3013,288,287,167,220,84,0,0,4059
"51770001900",3328,566,370,96,282,279,90,360,5371
"51770002100",2688,287,97,72,100,10,29,0,3283
"51770002200",1529,124,730,0,161,0,0,0,2544
"51770002300",2055,654,2516,663,740,292,122,431,7473
"51770002400",199,80,2059,1119,56,143,0,3,3659
"51770002500",267,529,2452,2062,234,180,98,104,5926
"51770002600",943,726,143,304,58,63,10,35,2282
"51770002700",3382,1438,200,147,69,171,96,27,5530
"51770002800",3556,1062,144,169,401,64,116,12,5524
"51770002900",4468,463,172,33,25,0,0,0,5161
"51770003000",3186,156,222,34,90,70,40,0,3798
"51770003100",3189,184,366,14,253,8,321,27,4362
"51775010100",4032,524,486,308,28,40,61,0,5479
"51775010200",4564,424,51,34,88,12,12,0,5185
"51775010300",2698,748,558,168,46,38,121,0,4377
"51775010501",2829,171,105,11,404,0,300,27,3847
"51775010502",4170,215,82,0,230,0,41,0,4738
"51790000100",902,164,107,9,38,0,168,6,1394
"51790000200",2137,842,474,128,113,22,125,0,3841
"51790000300",3893,570,297,247,96,144,77,0,5324
"51790000400",5028,727,376,120,342,19,65,0,6677
"51790000500",1451,409,116,12,76,0,9,0,2073
"51790000600",2733,424,393,242,17,0,10,11,3830
"51800065100",159,70,1211,734,61,0,0,0,2235
"51800065200",1265,213,401,125,118,41,122,8,2293
"51800065300",1352,77,1053,921,102,0,118,24,3647
"51800065400",214,44,2291,884,116,142,53,46,3790
"51800065500",58,17,1496,942,72,0,13,0,2598
"51800075101",2849,23,3353,238,715,21,437,0,7636
"51800075102",2580,85,742,0,346,62,97,0,3912
"51800075201",3852,95,575,26,243,0,105,0,4896
"51800075202",782,0,436,0,17,0,0,0,1235
"51800075203",2080,0,1005,0,286,160,192,160,3883
"51800075204",1804,135,2212,296,226,65,271,9,5018
"51800075301",1544,57,270,12,119,0,82,0,2084
"51800075302",1358,63,261,265,52,93,26,6,2124
"51800075401",1224,43,287,54,120,0,160,22,1910
"51800075402",1971,105,1369,390,217,0,297,0,4349
"51800075403",1924,51,2049,95,139,16,44,0,4318
"51800075404",790,41,191,0,0,0,23,0,1045
"51800075405",1894,20,181,5,18,0,13,0,2131
"51800075501",2418,128,1335,533,174,26,36,0,4650
"51800075502",2369,40,1721,121,226,72,148,0,4697
"51800075601",315,4,2830,482,45,135,20,0,3831
"51800075602",1309,32,92,20,61,42,19,0,1575
"51800075701",961,18,358,174,30,21,0,0,1562
"51800075702",2307,140,823,36,141,0,65,7,3519
"51800075703",748,13,302,5,0,0,0,0,1068
"51800075801",2222,37,530,36,89,0,5,0,2919
"51800075802",876,59,682,447,27,16,0,0,2107
"51800075803",1033,146,176,19,28,0,12,0,1414
"51810040000",605,133,307,87,232,97,137,89,1687
"51810040200",1071,368,2114,514,201,82,370,226,4946
"51810040402",1998,310,3196,674,631,99,298,64,7270
"51810040403",2180,190,600,63,338,151,414,55,3991
"51810040404",4627,139,1195,18,730,75,476,0,7260
"51810040600",1446,271,2490,855,578,178,516,92,6426
"51810040801",2969,209,604,31,232,63,390,21,4519
"51810040802",1905,307,1110,221,570,30,322,111,4576
"51810041002",1315,205,142,17,205,51,93,0,2028
"51810041003",1921,285,692,185,564,17,117,0,3781
"51810041004",2491,162,611,161,608,7,324,13,4377
"51810041200",4795,90,339,0,604,0,199,30,6057
"51810041400",3805,155,470,0,524,8,226,54,5242
"51810041600",2230,138,511,1,526,17,197,10,3630
"51810041801",3287,489,581,321,400,160,239,165,5642
"51810041802",4864,175,67,0,335,0,231,0,5672
"51810042000",3028,63,37,0,114,0,29,0,3271
"51810042201",3173,118,36,0,266,13,60,0,3666
"51810042202",4051,121,125,2,263,0,12,0,4574
"51810042400",3357,518,327,16,288,47,146,20,4719
"51810042600",1847,86,280,54,107,0,114,0,2488
"51810042801",4444,262,1174,3,397,7,717,8,7012
"51810042802",2328,279,1088,86,700,66,379,52,4978
"51810043002",4063,64,32,0,183,0,225,30,4597
"51810043003",3658,198,224,13,65,17,15,0,4190
"51810043004",3491,197,15,0,66,17,51,0,3837
"51810043200",552,55,330,49,147,22,103,52,1310
"51810043400",2140,16,0,0,69,9,0,0,2234
"51810043600",1543,65,0,0,21,0,0,0,1629
"51810043800",3389,219,86,22,174,0,38,0,3928
"51810044001",4132,255,950,101,255,0,252,12,5957
"51810044003",4774,350,118,0,159,0,48,0,5449
"51810044004",1564,209,256,20,194,225,89,0,2557
"51810044200",3139,602,947,806,539,166,285,250,6734
"51810044401",3405,37,0,0,178,0,168,0,3788
"51810044402",4764,86,482,0,241,72,159,0,5804
"51810044600",5416,172,0,0,117,0,343,0,6048
"51810044805",2602,140,663,105,271,0,400,17,4198
"51810044806",1401,410,1015,95,237,159,134,0,3451
"51810044807",3446,365,601,697,672,0,308,158,6247
"51810044808",2837,148,386,202,433,53,377,34,4470
"51810045000",47,37,0,0,0,0,0,0,84
"51810045200",1856,99,412,38,89,9,224,9,2736
"51810045405",2420,113,1161,209,803,23,610,8,5347
"51810045406",3674,240,2358,55,2204,100,785,63,9479
"51810045407",2661,207,727,216,521,104,159,115,4710
"51810045408",4260,459,815,0,1069,55,658,16,7332
"51810045412",1379,55,9,0,151,0,11,0,1605
"51810045414",2721,202,1336,356,668,149,560,257,6249
"51810045415",1512,94,380,38,113,0,3,0,2140
"51810045417",7173,155,575,0,744,167,570,0,9384
"51810045420",3932,256,151,0,404,0,122,0,4865
"51810045421",2270,45,630,0,410,4,260,0,3619
"51810045422",3317,76,970,53,704,0,598,64,5782
"51810045423",5506,295,1017,21,889,20,323,32,8103
"51810045424",3291,62,179,8,660,15,127,0,4342
"51810045425",2768,71,63,0,192,0,281,0,3375
"51810045426",5370,183,830,12,483,0,437,9,7324
"51810045427",4995,351,726,280,266,179,173,231,7201
"51810045428",1238,115,0,0,108,0,41,0,1502
"51810045601",2288,46,341,30,188,0,24,0,2917
"51810045603",1104,42,328,4,148,9,184,9,1828
"51810045604",3455,318,1101,501,627,55,547,30,6634
"51810045801",2668,250,654,58,613,24,446,69,4782
"51810045803",2203,74,590,0,352,0,201,0,3420
"51810045805",889,139,196,0,129,4,119,22,1498
"51810045806",2646,185,761,142,518,130,367,0,4749
"51810045807",998,113,269,4,165,14,187,51,1801
"51810045808",1099,121,462,109,280,9,24,70,2174
"51810045809",3399,248,1630,242,1135,394,524,235,7807
"51810045810",578,106,669,765,160,33,137,17,2465
"51810046002",3790,191,359,0,403,258,125,171,5297
"51810046005",3878,471,1725,268,799,12,377,28,7558
"51810046006",3745,167,327,55,497,69,125,71,5056
"51810046009",3691,25,659,99,434,16,374,46,5344
"51810046010",1992,12,527,54,378,25,162,5,3155
"51810046011",907,59,199,63,217,4,36,0,1485
"51810046012",3959,372,2572,79,980,61,535,65,8623
"51810046013",1966,172,1255,18,651,251,564,92,4969
"51810046014",1785,164,1256,218,1070,129,400,143,5165
"51810046015",3043,74,1473,72,868,30,555,0,6115
"51810046016",2157,0,687,36,764,0,97,36,3777
"51810046204",3913,90,221,0,191,8,135,9,4567
"51810046206",3165,90,803,86,872,141,167,0,5324
"51810046207",3328,419,1250,115,714,128,326,51,6331
"51810046211",2216,24,361,4,436,19,297,0,3357
"51810046212",2983,89,354,210,539,0,149,10,4334
"51810046213",2990,434,1385,47,1040,177,623,0,6696
"51810046214",2936,146,1100,0,874,5,298,0,5359
"51810046216",3066,67,1270,11,1434,211,343,25,6427
"51810046217",2493,124,972,41,1286,0,462,27,5405
"51810046219",1540,61,1042,10,1261,30,315,0,4259
"51810046220",1714,234,1933,491,453,17,144,12,4998
"51810046221",1200,53,2108,307,433,35,307,0,4443
"51810046222",3288,143,798,6,681,12,182,0,5110
"51810046223",1926,28,363,12,344,3,74,0,2750
"51810046224",2057,257,783,115,1434,0,378,0,5024
"51810046225",2628,104,927,1,533,168,179,61,4601
"51810046400",4595,238,227,10,131,0,169,1,5371
"51810990100",0,0,0,0,0,0,0,0,0
"51820003100",622,344,79,109,34,0,22,92,1302
"51820003200",3014,819,745,77,609,99,203,39,5605
"51820003300",2320,966,853,482,97,183,37,209,5147
"51820003400",3959,506,86,60,274,0,69,0,4954
"51820003500",3581,375,267,26,50,79,87,87,4552
"51830370100",2573,823,156,64,92,7,195,69,3979
"51830370200",1512,210,638,241,120,57,257,59,3094
"51830370300",2304,366,539,162,154,30,98,0,3653
"51840000100",3635,1185,651,600,241,550,1236,840,8938
"51840000201",2829,249,132,125,167,40,278,49,3869
"51840000202",3951,549,524,0,398,20,343,14,5799
"51840000301",2689,578,416,82,271,48,347,353,4784
"51840000302",3972,1017,166,12,336,83,461,41,6088
"53001950100",2114,316,0,0,33,28,45,35,2571
"53001950200",1244,293,0,0,104,76,106,66,1889
"53001950300",2622,868,0,0,2916,421,4120,1085,12032
"53001950400",1461,377,0,0,518,451,1260,772,4839
"53001950500",1730,811,6,0,1539,592,2372,1355,8405
"53003960100",3498,331,0,0,305,87,43,16,4280
"53003960200",4293,204,11,0,94,0,83,0,4685
"53003960300",2503,503,11,27,174,37,29,37,3321
"53003960400",1720,365,27,0,127,71,12,116,2438
"53003960500",2576,800,0,0,83,107,111,135,3812
"53003960600",3073,352,0,0,67,27,58,25,3602
"53005010100",3578,311,15,0,468,12,138,48,4570
"53005010201",3599,216,275,0,460,41,216,51,4858
"53005010202",3428,864,7,0,1576,221,781,266,7143
"53005010300",4599,251,66,58,599,151,445,96,6265
"53005010400",2887,246,150,0,403,65,272,45,4068
"53005010500",2324,280,0,36,355,31,240,40,3306
"53005010600",2904,488,12,0,695,117,503,107,4826
"53005010701",1792,65,75,0,189,0,109,0,2230
"53005010703",2251,245,8,0,188,160,276,69,3197
"53005010705",4974,140,0,0,200,0,510,28,5852
"53005010707",2491,84,11,0,140,0,103,0,2829
"53005010708",1806,100,18,0,174,100,274,100,2572
"53005010803",6091,120,80,0,586,128,486,118,7609
"53005010805",4404,378,108,0,549,71,327,30,5867
"53005010807",1138,110,0,0,11,0,147,5,1411
"53005010809",5513,349,34,0,558,263,513,378,7608
"53005010810",4574,265,11,0,140,11,104,0,5105
"53005010811",3167,52,0,0,117,0,51,0,3387
"53005010813",8155,232,44,0,1056,18,761,13,10279
"53005010814",2585,25,0,0,162,75,75,0,2922
"53005010901",3309,698,122,28,1026,481,878,469,7011
"53005010902",2483,517,73,28,1231,528,1160,492,6512
"53005011001",2297,701,101,0,644,923,406,1156,6228
"53005011002",2709,695,0,0,658,171,718,292,5243
"53005011100",5505,357,107,0,1535,170,1567,229,9470
"53005011200",2602,1812,234,31,1219,1473,1461,1932,10764
"53005011300",2379,904,81,190,1349,470,1879,560,7812
"53005011401",2364,652,16,14,402,189,660,348,4645
"53005011402",4413,136,8,0,637,74,607,67,5942
"53005011501",5086,338,54,0,1412,0,1828,78,8796
"53005011503",7310,326,145,0,891,254,456,301,9683
"53005011504",2585,151,134,0,105,61,314,61,3411
"53005011600",482,46,0,0,229,349,264,142,1512
"53005011700",5167,351,0,0,1206,404,2155,478,9761
"53005011800",4698,1062,46,1,645,711,1969,1287,10419
"53005011900",3421,714,39,0,1267,171,1282,196,7090
"53005012000",24,0,0,0,0,0,0,0,24
"53007960100",2004,297,0,0,60,47,258,101,2767
"53007960200",5087,751,0,0,275,129,344,154,6740
"53007960300",4876,1020,0,0,368,627,1383,1037,9311
"53007960400",2714,452,25,11,235,113,1180,182,4912
"53007960500",5322,762,34,0,417,24,1028,40,7627
"53007960600",3254,481,12,0,270,92,1019,332,5460
"53007960700",3367,47,21,6,221,101,384,0,4147
"53007960801",2483,258,0,0,325,37,389,233,3725
"53007960802",4952,1290,0,0,757,30,1335,471,8835
"53007961000",4961,479,0,0,346,142,1977,233,8138
"53007961100",6235,1279,0,13,1415,185,3645,764,13536
"53007961200",3632,256,0,0,178,0,871,42,4979
"53007961301",1010,21,90,0,171,2,146,0,1440
"53007961302",6316,591,0,0,1200,17,1406,50,9580
"53009000200",735,233,0,19,46,35,86,122,1276
"53009000300",3275,501,19,1,359,303,308,279,5045
"53009000400",839,166,0,0,410,91,111,18,1635
"53009000600",2400,377,0,0,205,166,54,19,3221
"53009000700",3094,709,41,0,150,44,149,0,4187
"53009000800",3033,615,47,55,226,101,197,71,4345
"53009000900",2002,340,0,12,80,211,126,23,2794
"53009001000",1850,262,0,0,155,32,33,15,2347
"53009001100",1988,386,49,80,277,211,34,51,3076
"53009001200",2661,518,6,0,224,0,37,0,3446
"53009001300",3029,438,0,12,121,27,335,0,3962
"53009001400",3618,304,0,0,336,103,83,53,4497
"53009001500",1335,266,0,0,416,242,62,0,2321
"53009001600",2663,330,0,0,101,0,101,26,3221
"53009001700",3718,503,0,0,155,10,66,24,4476
"53009001800",1994,478,0,0,118,0,0,0,2590
"53009001900",5296,253,0,0,260,57,394,0,6260
"53009002000",4360,401,104,0,423,120,157,0,5565
"53009002100",2503,487,0,18,270,52,238,42,3610
"53009002300",3689,409,53,1,97,38,127,26,4440
"53009940000",175,23,0,0,991,248,139,23,1599
"53009990100",0,0,0,0,0,0,0,0,0
"53011040101",4004,362,3,0,130,32,55,13,4599
"53011040102",2822,227,0,0,181,7,42,0,3279
"53011040201",4641,327,47,0,414,1,150,6,5586
"53011040202",3264,277,157,3,308,19,116,2,4146
"53011040203",4479,201,0,0,301,0,109,0,5090
"53011040301",1394,58,0,0,53,23,0,0,1528
"53011040302",5331,431,0,0,487,0,256,1,6506
"53011040403",3578,83,64,0,110,23,283,22,4163
"53011040407",3766,900,35,0,263,40,200,24,5228
"53011040408",3141,131,0,15,107,9,180,9,3592
"53011040409",1593,26,14,0,6,0,82,0,1721
"53011040411",1622,136,0,0,83,15,199,71,2126
"53011040412",3531,401,72,0,307,9,146,108,4574
"53011040413",2682,135,8,0,117,51,61,36,3090
"53011040414",5020,437,101,0,454,0,204,0,6216
"53011040415",3173,549,35,0,67,0,155,211,4190
"53011040416",3144,272,0,0,141,0,22,0,3579
"53011040504",4364,443,0,11,71,0,0,0,4889
"53011040505",4923,179,0,9,180,40,149,13,5493
"53011040507",1664,279,0,0,158,151,109,145,2506
"53011040508",5566,254,65,26,328,0,121,0,6360
"53011040509",2264,790,0,0,183,106,175,70,3588
"53011040510",4435,263,0,0,179,24,11,16,4928
"53011040511",2028,295,0,0,205,0,12,54,2594
"53011040603",4113,239,46,0,276,27,315,0,5016
"53011040604",4116,467,130,2,599,151,327,97,5889
"53011040605",3889,107,214,0,257,5,143,0,4615
"53011040608",3203,20,166,0,609,34,207,0,4239
"53011040609",3821,115,0,0,924,13,212,0,5085
"53011040610",2942,104,118,0,337,0,49,0,3550
"53011040703",4976,732,163,0,723,0,197,179,6970
"53011040706",2588,829,0,51,217,190,85,96,4056
"53011040707",3135,218,0,0,89,0,156,36,3634
"53011040709",3673,268,112,13,166,20,208,0,4460
"53011040710",4837,272,19,0,30,25,513,62,5758
"53011040711",2588,266,72,77,316,115,171,204,3809
"53011040712",3892,199,37,26,1446,55,101,47,5803
"53011040803",4115,199,54,35,809,645,486,773,7116
"53011040805",4502,649,38,0,557,16,317,32,6111
"53011040806",3948,620,40,22,504,61,193,9,5397
"53011040808",1228,256,14,0,21,23,67,76,1685
"53011040809",4058,513,59,0,796,266,1123,339,7154
"53011040810",1937,195,34,0,205,0,116,0,2487
"53011040904",4408,1025,3,0,343,282,289,164,6514
"53011040905",2682,62,22,0,76,89,41,36,3008
"53011040907",3824,86,52,0,484,10,80,0,4536
"53011040908",5545,181,48,0,453,31,443,0,6701
"53011040909",4376,464,99,0,547,112,366,167,6131
"53011040910",3521,210,0,0,334,107,28,13,4213
"53011041003",3015,505,23,12,99,110,65,41,3870
"53011041005",1132,484,49,0,335,652,295,706,3653
"53011041007",2259,272,42,148,132,466,91,523,3933
"53011041008",3142,200,40,1,367,11,94,0,3855
"53011041009",2832,370,8,3,229,96,241,84,3863
"53011041010",2547,476,0,0,358,126,378,86,3971
"53011041011",2509,100,0,0,356,46,122,0,3133
"53011041104",2246,875,83,113,310,167,89,76,3959
"53011041105",3989,353,107,0,701,53,282,2,5487
"53011041107",2103,130,2,0,244,83,124,0,2686
"53011041108",4999,627,131,21,525,152,257,140,6852
"53011041110",3770,402,0,0,829,54,414,0,5469
"53011041111",1493,1176,100,50,581,31,283,706,4420
"53011041112",3877,596,43,149,585,16,374,66,5706
"53011041201",4313,586,418,0,999,110,429,10,6865
"53011041203",3017,530,336,49,942,118,419,187,5598
"53011041205",2835,654,29,0,634,302,469,39,4962
"53011041206",3889,124,153,147,439,58,342,0,5152
"53011041309",3679,421,41,20,499,267,542,231,5700
"53011041310",3741,236,140,0,619,59,279,0,5074
"53011041312",2619,522,57,118,495,219,301,213,4544
"53011041313",1207,644,67,2,512,162,383,128,3105
"53011041317",2825,342,192,31,387,8,290,6,4081
"53011041318",3347,596,9,86,726,48,233,0,5045
"53011041319",4498,547,100,62,506,186,172,125,6196
"53011041320",4948,556,153,0,1000,69,488,0,7214
"53011041321",2492,132,21,0,384,96,286,0,3411
"53011041322",3204,546,128,0,357,79,588,107,5009
"53011041323",3550,816,51,276,447,282,218,102,5742
"53011041325",3685,230,134,0,1081,160,254,17,5561
"53011041326",1838,284,0,39,375,129,380,155,3200
"53011041327",5646,966,327,0,1607,312,463,134,9455
"53011041328",3956,183,40,0,1015,55,230,0,5479
"53011041329",2953,202,272,0,669,68,502,0,4666
"53011041330",3190,444,47,0,692,49,381,30,4833
"53011041331",1739,289,43,70,657,12,316,24,3150
"53011041332",2581,380,50,0,879,168,498,286,4842
"53011041333",2656,189,70,0,242,19,86,0,3262
"53011041400",4066,349,53,0,354,74,187,35,5118
"53011041500",2193,532,0,0,60,0,83,0,2868
"53011041600",1997,630,36,53,385,105,372,35,3613
"53011041700",1811,861,78,18,736,191,294,240,4229
"53011041800",1930,678,20,9,485,135,387,129,3773
"53011041900",1320,188,115,74,154,55,41,51,1998
"53011042000",1473,53,8,0,85,54,145,0,1818
"53011042100",2105,159,50,41,347,175,276,97,3250
"53011042300",1738,993,17,28,89,105,134,48,3152
"53011042400",880,292,0,15,30,36,21,7,1281
"53011042500",957,121,15,120,51,18,18,0,1300
"53011042600",3239,1035,139,0,374,279,114,230,5410
"53011042700",1932,1566,51,50,947,411,729,930,6616
"53011042800",2364,172,79,20,117,19,238,14,3023
"53011042900",848,284,16,0,136,48,12,69,1413
"53011043000",1247,178,56,38,200,71,160,4,1954
"53011043100",3217,388,49,10,330,84,183,172,4433
"53013960200",3089,561,0,0,182,116,136,115,4199
"53015000300",275,223,40,0,0,32,170,0,740
"53015000400",3021,192,15,0,205,66,362,17,3878
"53015000501",1986,404,0,13,242,191,87,109,3032
"53015000502",2112,1805,10,46,420,489,590,433,5905
"53015000601",2318,1121,0,0,485,179,91,324,4518
"53015000602",2512,276,13,0,316,30,78,0,3225
"53015000702",2628,169,0,0,146,17,46,2,3008
"53015000703",962,291,0,0,86,34,48,78,1499
"53015000704",5239,1264,18,0,326,94,180,276,7397
"53015000800",5602,466,0,0,382,27,61,27,6565
"53015000900",5672,488,23,0,371,182,522,13,7271
"53015001000",731,441,0,0,0,15,190,119,1496
"53015001100",3116,1656,164,0,242,119,325,406,6028
"53015001200",3662,413,22,0,157,53,370,48,4725
"53015001300",2394,803,18,0,191,205,284,91,3986
"53015001501",2277,164,0,0,58,17,41,28,2585
"53015001502",5354,1121,0,13,386,313,574,485,8246
"53015001600",6074,587,0,0,422,9,325,0,7417
"53015001700",4408,476,0,0,237,20,212,9,5362
"53015001800",1436,249,0,0,136,22,52,0,1895
"53015001900",4458,594,20,0,11,71,142,0,5296
"53015002001",3204,298,0,0,159,98,41,20,3820
"53015002002",5491,396,14,8,467,85,238,1,6700
"53015002100",1826,944,0,53,472,408,247,296,4246
"53017950100",2749,748,0,17,2150,716,2484,1017,9881
"53017950200",1974,333,0,13,156,89,91,56,2712
"53017950300",3517,341,0,0,850,1035,989,1180,7912
"53017950400",4927,489,20,1,786,235,895,269,7622
"53017950500",2170,229,0,0,593,91,718,56,3857
"53017950600",3788,159,0,0,703,18,755,8,5431
"53017950700",2870,586,0,0,801,507,802,606,6172
"53017950800",3510,238,0,20,864,239,1000,291,6162
"53019940000",328,69,0,0,975,291,15,17,1695
"53019970100",1794,379,2,10,95,218,73,116,2687
"53019970200",2586,545,5,2,172,41,29,0,3380
"53021020100",3246,1007,22,62,3616,1458,5480,2449,17340
"53021020200",1816,980,0,38,2349,1312,3214,2006,11715
"53021020300",1812,515,97,0,2335,723,3264,1052,9798
"53021020400",2681,1372,181,237,2407,2480,3735,3376,16469
"53021020501",3863,303,45,0,399,0,783,82,5475
"53021020502",5988,345,249,0,1467,112,1961,192,10314
"53021020601",6181,667,68,0,1182,148,2038,298,10582
"53021020603",1544,81,0,11,560,1673,592,1553,6014
"53021020605",6650,164,0,0,943,101,2434,99,10391
"53021020606",4943,104,129,119,1700,420,1832,390,9637
"53021020700",1043,157,0,0,173,0,146,7,1526
"53021020800",3815,367,52,0,2311,1162,3072,1340,12119
"53021980100",0,0,0,0,0,0,0,0,0
"53023970300",1876,226,0,0,63,40,19,50,2274
"53025010100",2934,434,19,2,352,106,131,17,3995
"53025010200",2059,355,0,0,182,31,163,69,2859
"53025010300",2510,623,15,1,314,201,231,176,4071
"53025010400",5254,1262,46,0,767,379,755,347,8810
"53025010500",1568,98,11,0,1066,721,1144,749,5357
"53025010600",2833,720,9,0,1892,1337,3295,1929,12015
"53025010700",1614,126,0,2,963,235,1088,279,4307
"53025010800",2072,1182,50,105,565,594,533,884,5985
"53025010901",1140,176,0,0,230,21,242,21,1830
"53025010902",7150,759,267,103,1856,512,2836,295,13778
"53025011000",7893,1105,56,0,1661,209,2362,833,14119
"53025011100",4412,1150,221,0,711,337,1158,701,8690
"53025011200",4434,283,0,0,320,430,522,464,6453
"53025011300",1974,308,40,20,1194,463,1835,593,6427
"53025011401",1213,121,0,0,506,97,572,97,2606
"53025011402",3712,1052,0,37,4944,2358,7021,3250,22374
"53027000200",6260,651,78,0,417,174,230,0,7810
"53027000300",2886,286,0,0,137,93,98,73,3573
"53027000400",5514,492,0,0,328,15,216,0,6565
"53027000500",5050,964,44,3,493,167,219,152,7092
"53027000600",2740,650,9,0,130,22,126,39,3716
"53027000700",2917,667,11,0,607,144,62,61,4469
"53027000800",3285,670,18,0,76,59,38,174,4320
"53027000900",4182,638,11,0,804,192,419,122,6368
"53027001000",1655,1041,0,8,324,462,307,709,4506
"53027001100",3148,406,8,7,266,34,231,0,4100
"53027001200",2781,1060,18,44,506,400,860,577,6246
"53027001300",2404,622,0,0,330,156,48,332,3892
"53027001400",1263,430,27,32,290,188,103,260,2593
"53027001500",2682,850,0,0,184,101,271,30,4118
"53027001600",3033,854,0,0,220,91,165,168,4531
"53027940000",155,31,0,9,520,345,42,21,1123
"53027990000",0,0,0,0,0,0,0,0,0
"53029970100",1856,193,61,0,223,22,60,42,2457
"53029970200",345,44,34,9,55,13,70,0,570
"53029970300",3705,248,70,0,415,40,27,9,4514
"53029970400",3778,535,127,49,1449,219,361,116,6634
"53029970500",4396,229,38,0,523,257,425,0,5868
"53029970601",2103,145,201,0,936,46,403,31,3865
"53029970602",2243,231,99,7,546,209,196,54,3585
"53029970700",1004,222,117,20,384,33,307,37,2124
"53029970800",1927,226,91,9,309,9,155,53,2779
"53029970900",3127,217,378,123,843,78,490,52,5308
"53029971000",3938,523,8,18,563,1,321,87,5459
"53029971100",2870,163,43,0,103,18,152,6,3355
"53029971300",3964,356,0,0,26,95,0,0,4441
"53029971400",3320,150,28,14,282,19,111,0,3924
"53029971500",2922,225,0,0,78,0,69,0,3294
"53029971600",3352,238,6,0,531,20,227,0,4374
"53029971700",3700,163,0,0,311,33,298,47,4552
"53029971800",2128,73,0,0,70,8,30,0,2309
"53029971900",3156,538,36,0,261,16,85,0,4092
"53029972000",3379,469,17,0,123,64,201,0,4253
"53029972100",3238,233,23,0,181,16,49,0,3740
"53029992201",0,0,0,0,0,0,0,0,0
"53031950202",1345,194,0,2,154,3,32,0,1730
"53031950300",4733,381,60,0,511,23,107,0,5815
"53031950400",3179,589,10,0,185,46,69,8,4086
"53031950500",5216,679,0,0,539,22,447,0,6903
"53031950601",4594,1049,0,0,456,29,107,22,6257
"53031950602",2702,453,1,13,35,3,10,0,3217
"53031950702",1108,227,0,0,296,139,19,19,1808
"53031990000",0,0,0,0,0,0,0,0,0
"53033000100",3270,751,444,216,935,635,303,528,7082
"53033000200",4513,494,238,156,1754,191,343,0,7689
"53033000300",1669,237,49,46,505,30,146,72,2754
"53033000401",2660,977,668,332,862,462,132,152,6245
"53033000402",3273,174,121,89,526,50,179,0,4412
"53033000500",2498,152,12,0,384,63,159,0,3268
"53033000600",4742,484,235,62,1521,143,412,215,7814
"53033000700",2739,323,157,52,954,124,257,125,4731
"53033000800",2062,165,0,0,300,83,35,0,2645
"53033000900",1547,63,0,0,303,73,25,0,2011
"53033001000",1126,50,173,189,212,141,79,72,2042
"53033001100",1779,166,96,31,505,72,158,0,2807
"53033001200",2782,686,377,0,1942,423,581,111,6902
"53033001300",2396,316,268,67,1183,290,600,60,5180
"53033001400",4144,283,0,0,583,98,323,122,5553
"53033001500",2401,42,0,0,108,17,113,0,2681
"53033001600",3281,198,9,10,424,27,136,27,4112
"53033001701",2498,135,90,21,1252,40,379,0,4415
"53033001702",2807,329,14,53,504,101,155,53,4016
"53033001800",3593,262,0,28,934,273,262,314,5666
"53033001900",2735,453,111,51,750,208,185,0,4493
"53033002000",2730,342,8,0,356,13,69,13,3531
"53033002100",2812,195,133,0,633,59,63,22,3917
"53033002200",4324,144,0,0,845,20,245,19,5597
"53033002400",2254,146,25,0,480,24,106,0,3035
"53033002500",2380,129,113,0,328,0,20,0,2970
"53033002600",3832,288,88,28,579,50,186,43,5094
"53033002700",4192,284,64,0,607,30,212,0,5389
"53033002800",3535,310,161,1,502,99,133,13,4754
"53033002900",3427,181,0,1,422,10,169,11,4221
"53033003000",4968,72,17,0,415,56,188,56,5772
"53033003100",5231,407,28,0,487,0,215,17,6385
"53033003200",6272,554,0,29,711,176,256,211,8209
"53033003300",5012,419,68,0,511,59,269,38,6376
"53033003400",2967,83,20,0,380,0,150,5,3605
"53033003500",3047,174,15,4,537,41,205,11,4034
"53033003600",4354,367,35,31,958,161,345,76,6327
"53033003800",1610,107,45,5,407,14,108,0,2296
"53033003900",2500,200,0,0,392,0,72,0,3164
"53033004000",1714,297,39,193,502,180,23,30,2978
"53033004100",6414,566,0,0,1003,96,146,0,8225
"53033004200",6326,340,127,2,944,273,165,0,8177
"53033004301",2154,511,0,17,554,286,65,11,3598
"53033004302",884,1125,46,80,159,419,28,104,2845
"53033004400",3367,1490,145,23,585,352,77,44,6083
"53033004500",1888,586,19,0,422,107,97,0,3119
"53033004600",2723,198,0,0,350,62,164,13,3510
"53033004700",5733,414,116,0,938,176,476,92,7945
"53033004800",4068,257,165,0,255,45,171,0,4961
"53033004900",5014,417,11,28,891,134,199,75,6769
"53033005000",2887,152,65,119,402,64,25,0,3714
"53033005100",2906,149,11,0,549,2,177,7,3801
"53033005200",3027,1317,39,79,867,1297,195,73,6894
"53033005301",1016,1300,40,12,527,1768,82,231,4976
"53033005302",42,55,0,0,21,57,0,0,175
"53033005400",3521,429,21,0,793,14,291,70,5139
"53033005600",5541,133,37,0,433,55,68,0,6267
"53033005700",5330,209,0,13,862,26,194,58,6692
"53033005801",4091,209,323,102,479,0,272,0,5476
"53033005802",3943,283,78,0,657,68,153,45,5227
"53033005900",4497,872,34,52,630,138,109,12,6344
"53033006000",4031,402,51,3,621,38,293,0,5439
"53033006100",4333,312,80,0,566,47,170,5,5513
"53033006200",3310,118,110,12,271,9,134,0,3964
"53033006300",4432,187,24,0,407,55,178,42,5325
"53033006400",2780,102,54,7,280,10,112,0,3345
"53033006500",3293,261,17,0,444,17,228,18,4278
"53033006600",2093,244,34,0,677,95,152,23,3318
"53033006700",5008,258,221,55,968,167,333,40,7050
"53033006800",2432,195,28,0,306,13,57,0,3031
"53033006900",3566,146,73,0,361,69,26,38,4279
"53033007000",5595,274,214,39,886,112,504,14,7638
"53033007100",2098,257,105,33,383,107,137,92,3212
"53033007200",2845,579,261,52,1153,501,158,60,5609
"53033007300",3147,369,87,87,856,260,387,39,5232
"53033007401",2999,445,195,24,667,0,181,36,4547
"53033007402",2954,786,225,184,860,301,201,168,5679
"53033007500",5274,593,216,364,684,75,560,86,7852
"53033007600",2650,352,239,64,469,85,257,47,4163
"53033007700",2926,315,546,248,497,10,107,3,4652
"53033007800",3901,193,512,59,759,144,175,133,5876
"53033007900",3700,464,455,108,490,253,424,39,5933
"53033008001",3104,336,397,305,860,346,171,13,5532
"53033008002",1808,504,106,57,342,142,140,143,3242
"53033008100",2072,623,107,244,635,290,125,61,4157
"53033008200",2182,333,235,18,559,210,269,29,3835
"53033008300",1908,247,45,41,342,62,82,0,2727
"53033008400",2541,328,174,146,742,134,179,14,4258
"53033008500",1131,367,94,250,402,435,324,50,3053
"53033008600",1326,521,166,162,406,477,123,118,3299
"53033008700",1796,183,894,167,893,182,361,28,4504
"53033008800",2179,182,575,96,352,214,234,24,3856
"53033008900",2013,120,1165,169,874,46,174,0,4561
"53033009000",919,198,412,127,924,348,142,0,3070
"53033009100",394,144,206,338,1012,475,6,11,2586
"53033009200",930,401,134,155,371,570,58,54,2673
"53033009300",861,343,183,125,690,150,235,25,2612
"53033009400",2113,229,223,127,2318,627,261,119,6017
"53033009500",3212,351,792,126,926,335,214,77,6033
"53033009600",4507,300,53,159,458,45,302,0,5824
"53033009701",5003,245,74,0,577,0,288,0,6187
"53033009702",4529,154,24,52,504,45,53,13,5374
"53033009800",5839,157,26,59,555,118,230,26,7010
"53033009900",3133,288,334,95,796,105,313,32,5096
"53033010001",1211,63,826,229,1542,303,318,0,4492
"53033010002",1705,286,231,31,1927,88,799,181,5248
"53033010100",2318,171,1146,165,1462,368,227,90,5947
"53033010200",2635,202,673,21,1029,45,113,18,4736
"53033010300",1773,288,951,681,1605,367,264,103,6032
"53033010401",689,169,385,203,2904,372,56,58,4836
"53033010402",1128,79,549,0,2794,174,331,116,5171
"53033010500",4270,542,137,28,810,132,255,90,6264
"53033010600",6191,454,86,70,807,67,522,43,8240
"53033010701",1254,315,492,260,548,208,73,36,3186
"53033010702",1055,262,684,1112,470,107,79,35,3804
"53033010800",2354,272,212,291,1497,66,242,58,4992
"53033010900",744,144,22,0,193,28,170,21,1322
"53033011001",486,200,841,918,1602,607,159,0,4813
"53033011002",342,72,496,1058,2211,152,124,39,4494
"53033011101",1084,72,1036,184,1846,464,341,39,5066
"53033011102",1855,235,331,266,1436,96,293,201,4713
"53033011200",1980,857,83,93,1222,345,1318,874,6772
"53033011300",3069,386,335,19,2204,209,393,46,6661
"53033011401",2016,397,518,30,917,136,783,219,5016
"53033011402",2303,267,255,263,810,436,752,270,5356
"53033011500",2984,171,71,12,690,87,304,85,4404
"53033011600",5081,321,70,5,1044,0,193,0,6714
"53033011700",933,48,1114,593,3452,240,412,38,6830
"53033011800",2137,911,1441,1324,1251,729,629,886,9308
"53033011900",1580,195,1695,202,2953,839,533,89,8086
"53033012000",2670,148,25,0,518,24,137,0,3522
"53033012100",2265,12,29,0,511,52,172,0,3041
"53033020100",2452,194,6,5,418,13,103,0,3191
"53033020200",4208,306,128,43,929,128,256,0,5998
"53033020300",3792,399,259,0,1811,126,618,43,7048
"53033020401",2156,301,234,0,592,60,322,12,3677
"53033020402",4267,214,166,0,577,57,502,3,5786
"53033020500",3669,443,326,101,1271,97,386,50,6343
"53033020600",1907,194,228,0,998,189,198,69,3783
"53033020700",2283,570,142,98,647,258,417,262,4677
"53033020800",3341,219,105,25,310,9,54,31,4094
"53033020900",2518,151,127,29,537,51,297,0,3710
"53033021000",3233,372,440,17,1287,233,265,17,5864
"53033021100",2000,143,231,510,1436,124,503,37,4984
"53033021300",2409,227,58,31,751,89,156,11,3732
"53033021400",3030,290,16,19,399,54,190,0,3998
"53033021500",3716,57,24,51,584,13,83,0,4528
"53033021600",3160,336,224,64,991,98,199,13,5085
"53033021700",5626,605,156,0,1969,243,681,593,9873
"53033021802",3405,416,115,0,1375,98,435,0,5844
"53033021803",3085,506,55,81,637,86,418,199,5067
"53033021804",3098,189,46,9,753,236,343,216,4890
"53033021903",3130,417,83,0,1004,42,314,0,4990
"53033021904",2897,88,13,0,1446,452,387,153,5436
"53033021905",3467,209,117,0,970,0,593,0,5356
"53033021906",3133,160,75,0,813,29,147,25,4382
"53033022001",3906,425,0,0,676,0,172,69,5248
"53033022003",3418,243,145,24,795,42,462,14,5143
"53033022005",2656,132,241,30,964,35,378,48,4484
"53033022006",2535,98,12,17,476,157,280,0,3575
"53033022101",3433,268,24,0,867,103,164,14,4873
"53033022102",4258,235,37,0,1358,50,506,35,6479
"53033022201",3375,198,7,0,389,38,155,4,4166
"53033022202",5117,328,116,35,1208,34,597,90,7525
"53033022203",3631,99,26,0,810,0,218,0,4784
"53033022300",1801,53,19,0,416,1,117,1,2408
"53033022400",6347,276,74,42,993,74,244,24,8074
"53033022500",5536,281,0,0,959,31,375,0,7182
"53033022603",3232,197,78,0,965,0,176,0,4648
"53033022604",2983,66,119,0,797,56,97,0,4118
"53033022605",3492,450,90,0,1719,204,967,226,7148
"53033022606",4347,38,87,0,854,324,206,16,5872
"53033022701",1800,115,0,0,407,36,93,0,2451
"53033022702",2400,207,29,0,511,33,83,69,3332
"53033022703",1521,120,15,0,647,0,260,38,2601
"53033022801",3304,338,215,28,4033,199,394,77,8588
"53033022802",3040,136,51,1,1571,40,218,0,5057
"53033022803",2158,400,334,0,2444,87,129,27,5579
"53033022901",1834,134,41,18,771,9,87,89,2983
"53033022902",4123,177,66,0,1879,176,269,0,6690
"53033023000",3654,139,42,0,1120,50,306,8,5319
"53033023100",2600,106,121,12,1067,20,162,24,4112
"53033023201",2036,299,236,29,3134,177,421,68,6400
"53033023202",2087,365,204,107,1474,303,576,111,5227
"53033023300",4456,218,48,0,1222,39,171,0,6154
"53033023401",1794,265,26,71,766,253,170,43,3388
"53033023403",2950,107,60,15,988,81,101,42,4344
"53033023404",2811,13,29,15,540,0,10,0,3418
"53033023500",2415,121,43,30,979,70,141,31,3830
"53033023601",2025,157,60,50,1004,170,188,74,3728
"53033023603",2252,331,174,119,2780,312,803,194,6965
"53033023604",3191,372,243,140,1934,513,682,540,7615
"53033023700",2857,186,27,0,924,12,153,1,4160
"53033023801",1503,102,51,0,677,42,123,8,2506
"53033023803",2558,66,115,0,1076,398,43,0,4256
"53033023804",2711,228,0,1,1504,348,192,0,4984
"53033023900",5021,454,94,0,1253,114,157,139,7232
"53033024000",5007,158,29,2,2339,56,210,0,7801
"53033024100",3866,89,0,0,685,22,67,13,4742
"53033024200",2361,133,9,0,451,7,63,0,3024
"53033024300",5035,283,152,48,1541,154,104,18,7335
"53033024400",2160,70,0,8,656,0,191,15,3100
"53033024500",3492,60,123,0,1144,0,121,0,4940
"53033024601",3958,25,0,0,532,1,163,0,4679
"53033024602",3061,54,0,14,611,13,221,13,3987
"53033024701",1993,70,74,6,1172,98,181,17,3611
"53033024702",4997,60,76,41,1781,320,304,30,7609
"53033024800",2836,155,223,0,1866,344,328,0,5752
"53033024901",2474,170,70,2,2297,104,140,0,5257
"53033024902",2583,63,66,0,1161,55,264,0,4192
"53033024903",3453,13,30,2,3015,66,63,0,6642
"53033025001",3185,143,63,0,1396,24,32,0,4843
"53033025003",4497,257,63,0,2090,94,422,87,7510
"53033025005",2420,110,90,25,1837,16,95,9,4602
"53033025006",3754,25,49,189,1318,186,286,171,5978
"53033025101",3089,405,284,56,1296,653,719,723,7225
"53033025102",3848,76,361,6,3438,341,576,0,8646
"53033025200",5036,290,375,429,2122,187,909,295,9643
"53033025301",3225,206,237,32,852,54,52,27,4685
"53033025302",2529,447,452,403,774,227,313,52,5197
"53033025400",3325,481,389,50,2074,489,1241,235,8284
"53033025500",2351,452,428,54,1783,239,1140,460,6907
"53033025601",2091,351,254,59,1795,294,552,203,5599
"53033025602",3771,178,52,0,2227,100,93,50,6471
"53033025701",3206,759,453,416,774,125,645,31,6409
"53033025702",1927,73,361,32,1034,102,389,24,3942
"53033025803",2577,328,373,460,930,251,810,290,6019
"53033025804",2060,197,225,93,1085,65,498,85,4308
"53033025805",2333,266,349,138,1510,142,541,201,5480
"53033025806",1573,56,492,13,2166,208,207,44,4759
"53033026001",2133,117,1280,120,2346,24,383,8,6411
"53033026002",2593,210,1479,917,2316,407,841,301,9064
"53033026100",1592,185,1552,505,2413,447,391,83,7168
"53033026200",2377,469,998,196,1181,391,608,217,6437
"53033026300",461,40,187,0,646,62,21,7,1424
"53033026400",2655,362,578,349,1068,1050,957,759,7778
"53033026500",1422,222,479,329,1091,470,504,91,4608
"53033026600",1098,194,297,32,863,282,252,125,3143
"53033026700",3229,303,167,39,1229,348,349,295,5959
"53033026801",2105,447,335,458,1840,380,1363,461,7389
"53033026802",1957,779,208,136,1181,265,819,579,5924
"53033027000",1791,105,127,21,766,464,326,212,3812
"53033027100",1558,220,210,61,1121,298,833,169,4470
"53033027200",946,100,168,284,703,342,202,93,2838
"53033027300",2825,948,676,121,1084,810,1113,819,8396
"53033027400",2366,545,213,127,1407,86,549,280,5573
"53033027500",2379,207,93,79,1093,221,592,55,4719
"53033027600",2389,522,261,93,661,532,987,753,6198
"53033027701",5426,395,0,0,306,203,85,20,6435
"53033027702",4277,204,12,0,200,0,233,0,4926
"53033027800",2601,142,11,0,134,1,59,5,2953
"53033027900",4598,690,85,27,511,476,666,644,7697
"53033028000",1943,763,370,202,382,189,790,545,5184
"53033028100",796,100,260,230,674,179,402,59,2700
"53033028200",1522,493,687,548,899,166,302,270,4887
"53033028300",2672,101,339,102,1343,68,462,24,5111
"53033028402",1806,128,859,390,1210,385,696,65,5539
"53033028403",2197,294,566,353,728,418,177,186,4919
"53033028500",1911,171,194,0,888,249,448,111,3972
"53033028600",5191,124,15,13,836,244,513,0,6936
"53033028700",3336,271,411,0,974,359,377,47,5775
"53033028801",1612,252,93,1,480,97,675,92,3302
"53033028802",2909,652,806,1220,934,459,1362,393,8735
"53033028901",2346,170,40,47,559,2,252,27,3443
"53033028902",2422,546,693,677,1370,419,1192,252,7571
"53033029001",3103,284,110,10,932,141,543,174,5297
"53033029003",2698,462,1029,164,1106,407,845,169,6880
"53033029004",1336,376,416,247,685,417,944,476,4897
"53033029101",1390,35,426,11,1231,161,184,0,3438
"53033029102",1865,267,450,36,1223,150,165,148,4304
"53033029203",1147,417,112,92,569,298,423,348,3406
"53033029204",3107,432,927,274,2220,135,832,264,8191
"53033029205",2448,506,236,31,1540,145,1167,328,6401
"53033029206",1503,713,191,53,873,256,447,493,4529
"53033029303",3157,247,697,38,2886,63,192,86,7366
"53033029304",3143,399,241,25,1285,27,158,170,5448
"53033029305",2215,200,75,355,824,124,147,45,3985
"53033029306",1482,124,380,35,1105,30,122,12,3290
"53033029307",2659,117,118,1,922,133,118,106,4174
"53033029403",2609,210,413,203,1866,177,568,122,6168
"53033029405",2907,226,314,331,1846,93,331,0,6048
"53033029406",2293,83,544,387,1602,80,362,0,5351
"53033029407",2018,290,352,64,876,636,354,433,5023
"53033029408",2071,446,154,47,1137,250,825,278,5208
"53033029502",3454,456,450,20,1836,209,268,201,6894
"53033029503",2587,2031,483,162,1731,930,1216,1343,10483
"53033029504",2273,581,716,233,1362,232,664,351,6412
"53033029601",2670,761,699,245,1601,415,412,95,6898
"53033029602",3331,535,106,83,1365,31,430,0,5881
"53033029700",4797,697,253,575,686,341,929,531,8809
"53033029801",4105,488,652,14,1897,643,835,314,8948
"53033029802",5678,602,417,36,2238,457,585,517,10530
"53033029901",3682,211,355,1,924,8,595,1,5777
"53033029902",2746,102,360,0,893,0,151,13,4265
"53033030003",3015,396,810,58,1404,293,911,292,7179
"53033030004",3500,1085,797,335,1850,432,1246,728,9973
"53033030005",2876,788,219,14,874,212,1101,461,6545
"53033030006",1323,410,375,82,911,622,484,589,4796
"53033030100",4916,631,635,0,876,119,230,69,7476
"53033030201",3078,105,336,78,1376,235,1081,15,6304
"53033030202",3193,653,793,115,984,151,693,238,6820
"53033030304",1951,177,82,29,849,65,236,123,3512
"53033030305",3160,251,535,244,660,229,185,187,5451
"53033030306",3697,447,338,108,1216,256,488,281,6831
"53033030308",3438,553,491,67,1600,308,758,427,7642
"53033030309",3035,384,263,88,1503,423,683,474,6853
"53033030310",3125,211,345,13,1714,230,411,101,6150
"53033030311",2277,1219,298,19,1101,452,847,1044,7257
"53033030312",2753,319,249,55,1279,24,205,0,4884
"53033030313",1629,369,166,260,942,205,230,195,3996
"53033030314",2191,504,513,51,862,171,637,122,5051
"53033030401",5522,556,442,70,1854,599,833,49,9925
"53033030403",2683,150,323,0,1150,92,481,0,4879
"53033030404",4009,112,0,0,509,184,235,161,5210
"53033030501",1217,461,10,27,106,230,214,34,2299
"53033030503",2087,576,211,74,1367,348,681,29,5373
"53033030504",2272,414,152,84,962,436,644,352,5316
"53033030600",3480,547,191,25,615,296,261,234,5649
"53033030700",2005,596,128,245,669,199,286,149,4277
"53033030801",3005,1558,137,119,1708,766,1599,1684,10576
"53033030802",2723,500,42,50,723,123,281,100,4542
"53033030901",2081,217,31,7,977,173,560,166,4212
"53033030902",2985,701,138,10,1662,239,779,217,6731
"53033031000",2512,28,166,0,503,16,106,0,3331
"53033031100",3495,730,272,75,1572,285,350,206,6985
"53033031202",4583,214,3,11,771,812,190,226,6810
"53033031204",5153,182,51,0,427,0,110,0,5923
"53033031205",4201,536,288,131,1412,390,288,6,7252
"53033031206",3023,286,231,20,866,195,700,132,5453
"53033031301",2257,127,4,15,178,44,195,84,2904
"53033031302",3477,248,10,0,392,0,273,6,4406
"53033031400",4222,908,342,0,204,155,110,381,6322
"53033031501",3594,355,16,0,265,0,196,43,4469
"53033031502",3609,508,0,0,169,68,77,22,4453
"53033031601",4606,260,97,0,291,88,181,79,5602
"53033031603",4538,307,118,9,589,53,360,36,6010
"53033031604",4157,156,55,0,728,0,424,21,5541
"53033031605",3014,284,76,0,275,0,451,8,4108
"53033031703",4366,462,241,1,1015,16,401,235,6737
"53033031704",2833,275,199,20,1379,92,300,129,5227
"53033031705",3053,29,78,0,655,0,443,0,4258
"53033031706",4529,260,590,210,1215,0,424,17,7245
"53033031800",3466,232,125,16,920,20,265,13,5057
"53033031903",5177,125,130,2,1262,293,409,240,7638
"53033031904",3051,123,70,0,644,19,460,0,4367
"53033031906",2370,44,92,0,1007,43,195,0,3751
"53033031907",4371,84,339,0,2604,212,297,144,8051
"53033031908",2746,234,560,22,1356,110,589,86,5703
"53033031909",2089,163,334,0,770,80,108,20,3564
"53033032002",2823,68,35,8,319,21,151,7,3432
"53033032003",4967,355,45,3,121,0,116,0,5607
"53033032005",5214,472,96,196,814,80,574,128,7574
"53033032006",3906,154,37,0,284,3,32,0,4416
"53033032007",3127,260,146,0,167,45,131,24,3900
"53033032008",3608,0,26,0,423,0,163,0,4220
"53033032010",4081,242,136,0,786,28,224,0,5497
"53033032011",3438,58,172,0,516,8,314,8,4514
"53033032102",4739,210,0,0,121,43,106,10,5229
"53033032103",3035,218,15,0,634,67,131,12,4112
"53033032104",4961,104,282,115,654,104,352,0,6572
"53033032203",5380,47,67,0,1293,59,127,0,6973
"53033032207",2656,22,0,0,506,8,119,0,3311
"53033032208",5875,211,187,0,1474,2,241,15,8005
"53033032210",7773,174,88,41,3037,24,714,0,11851
"53033032211",3385,139,37,0,1606,0,84,41,5292
"53033032212",5645,114,233,0,2419,548,370,15,9344
"53033032213",3635,89,1,0,891,33,68,0,4717
"53033032214",3276,39,35,1,2991,51,90,0,6483
"53033032215",3208,8,27,0,1766,22,147,0,5178
"53033032307",6096,96,14,83,552,34,159,16,7050
"53033032309",2993,223,105,0,1874,369,379,24,5967
"53033032311",5264,255,30,0,343,0,198,0,6090
"53033032313",3379,293,130,0,2703,198,1297,192,8192
"53033032315",5183,135,11,15,400,37,137,0,5918
"53033032316",4261,44,0,0,1203,0,242,0,5750
"53033032317",4933,372,77,0,699,113,216,168,6578
"53033032318",3775,57,41,0,1659,78,340,0,5950
"53033032319",3503,365,38,38,639,79,295,13,4970
"53033032320",3683,66,14,0,467,3,130,0,4363
"53033032321",3171,88,49,0,1585,44,145,0,5082
"53033032322",2994,119,12,0,576,46,85,0,3832
"53033032323",3948,118,47,0,1354,0,352,0,5819
"53033032324",3442,306,62,0,965,178,410,137,5500
"53033032325",3493,321,227,18,1115,18,295,30,5517
"53033032326",3528,105,28,0,481,0,362,0,4504
"53033032327",3933,111,0,0,325,0,0,0,4369
"53033032328",3388,26,11,59,190,0,92,0,3766
"53033032329",5045,79,41,24,3085,47,428,19,8768
"53033032401",4896,572,0,0,463,0,251,151,6333
"53033032402",5342,227,108,0,453,0,271,0,6401
"53033032500",4581,252,37,0,502,108,142,97,5719
"53033032601",2486,203,0,0,206,0,221,0,3116
"53033032602",8922,402,0,0,2011,0,249,104,11688
"53033032702",5879,248,0,0,343,72,245,42,6829
"53033032703",1650,139,5,16,108,32,37,117,2104
"53033032704",4752,571,38,3,287,208,128,352,6339
"53033032800",2299,164,0,3,49,3,72,1,2591
"53033990100",0,0,0,0,0,0,0,0,0
"53035080101",1746,201,194,14,479,45,308,48,3035
"53035080102",2835,430,112,45,1067,426,400,392,5707
"53035080200",2065,355,196,175,473,335,292,172,4063
"53035080300",2150,427,93,36,281,136,254,23,3400
"53035080400",2496,227,70,20,320,34,50,1,3218
"53035080500",1195,583,33,142,218,161,178,55,2565
"53035080600",3226,1034,234,16,798,122,448,23,5901
"53035080700",2831,240,13,10,198,24,178,0,3494
"53035080800",1125,134,101,0,292,178,274,10,2114
"53035080900",3272,603,28,5,314,239,185,40,4686
"53035081000",1962,573,604,18,575,345,360,241,4678
"53035081100",1578,344,74,3,749,374,222,316,3660
"53035081200",2163,531,187,31,199,152,126,46,3435
"53035081400",164,0,0,0,17,0,36,0,217
"53035090101",4563,261,10,0,860,145,213,114,6166
"53035090102",5064,385,0,0,908,86,256,34,6733
"53035090201",4082,316,0,0,156,0,163,0,4717
"53035090202",4332,220,0,0,647,2,363,107,5671
"53035090300",3087,221,109,0,365,26,876,116,4800
"53035090400",4148,352,0,0,251,19,129,41,4940
"53035090501",2642,315,14,0,271,0,158,28,3428
"53035090502",3419,376,76,19,862,101,454,95,5402
"53035090700",4360,223,87,0,275,42,259,14,5260
"53035090800",3494,255,26,0,326,7,74,0,4182
"53035090900",6223,319,12,0,652,36,341,60,7643
"53035091000",5400,317,122,58,655,19,97,0,6668
"53035091100",4007,258,8,0,355,75,255,0,4958
"53035091201",2667,299,40,19,566,267,251,44,4153
"53035091203",4826,254,346,17,1967,207,576,38,8231
"53035091204",2523,235,53,33,505,108,199,73,3729
"53035091301",3622,95,52,0,329,8,115,9,4230
"53035091302",4363,371,48,0,819,8,386,15,6010
"53035091400",2282,154,23,0,563,62,20,62,3166
"53035091500",2606,200,300,37,653,48,126,49,4019
"53035091600",3968,366,402,0,1444,148,191,141,6660
"53035091700",5350,304,218,221,2001,0,720,0,8814
"53035091800",2090,210,173,0,447,0,203,0,3123
"53035091900",2738,159,91,103,953,134,189,0,4367
"53035092000",5116,140,47,0,653,0,73,0,6029
"53035092100",6022,449,43,0,265,238,15,31,7063
"53035092200",3674,754,49,26,783,311,327,163,6087
"53035092300",3738,798,124,0,1037,123,424,12,6256
"53035092400",3914,746,306,0,1050,44,279,94,6433
"53035092500",4247,347,190,11,322,53,163,0,5333
"53035092600",4901,463,29,17,449,26,109,0,5994
"53035092701",3254,412,0,0,336,138,112,164,4416
"53035092704",2613,170,0,0,290,46,30,46,3195
"53035092801",3269,415,73,8,322,84,173,70,4414
"53035092802",3284,269,35,0,568,44,266,0,4466
"53035092803",2262,354,0,0,92,35,48,11,2802
"53035092901",4749,384,93,12,297,26,169,0,5730
"53035092902",4705,369,0,0,323,188,311,0,5896
"53035940000",2719,294,10,3,297,36,87,0,3446
"53035940100",4359,329,39,0,1018,174,344,37,6300
"53035990100",0,0,0,0,0,0,0,0,0
"53037975100",5123,650,0,3,316,80,256,76,6504
"53037975200",4343,406,4,0,401,141,167,135,5597
"53037975300",4018,448,17,0,169,0,80,0,4732
"53037975401",1991,2360,187,34,200,349,297,336,5754
"53037975402",4188,839,0,0,184,135,323,0,5669
"53037975500",3159,1724,0,0,419,474,154,255,6185
"53037975600",1226,574,0,0,156,34,182,25,2197
"53037975700",3355,490,0,8,636,22,728,46,5285
"53039950100",6601,1624,2,69,563,465,269,541,10134
"53039950200",3265,543,0,8,155,42,82,51,4146
"53039950300",5752,731,0,22,421,63,900,372,8261
"53041970100",2826,516,0,0,115,41,30,0,3528
"53041970200",2265,671,0,0,191,0,239,77,3443
"53041970300",3374,736,21,79,172,2,304,0,4688
"53041970400",3946,1021,10,10,429,56,931,262,6665
"53041970500",1667,251,8,0,173,5,132,43,2279
"53041970600",1214,328,1,0,179,78,332,97,2229
"53041970700",3301,1055,35,2,102,164,578,386,5623
"53041970800",2982,448,0,0,256,22,348,83,4139
"53041970900",1558,195,17,0,64,26,212,15,2087
"53041971000",2379,363,0,0,105,134,195,131,3307
"53041971100",2589,534,28,0,228,38,127,13,3557
"53041971200",2773,226,6,0,194,21,39,17,3276
"53041971300",5173,415,0,0,591,40,605,16,6840
"53041971400",2091,47,62,0,484,103,157,7,2951
"53041971500",5903,982,3,0,467,141,425,34,7955
"53041971600",2760,687,62,0,132,68,150,46,3905
"53041971700",3850,366,0,0,328,70,260,99,4973
"53041971800",3096,698,0,0,142,0,58,0,3994
"53041971900",1957,478,0,0,108,24,34,0,2601
"53041972000",2226,280,5,0,178,36,10,0,2735
"53043960100",1305,414,0,0,44,6,39,0,1808
"53043960200",2862,259,0,13,52,10,28,0,3224
"53043960300",1957,288,10,0,168,16,86,0,2525
"53043960400",2292,392,0,0,208,71,48,51,3062
"53045940000",96,62,46,7,282,163,31,26,713
"53045960100",779,64,0,0,18,17,3,0,881
"53045960200",4100,1036,0,0,456,467,23,280,6362
"53045960300",4760,964,0,165,377,255,44,165,6730
"53045960400",6986,1064,0,0,413,43,282,57,8845
"53045960500",4145,212,0,54,113,70,62,0,4656
"53045960600",2152,525,98,0,726,144,623,111,4379
"53045960700",893,240,0,0,131,276,136,364,2040
"53045960800",2109,732,0,17,308,60,237,211,3674
"53045960900",3047,852,13,0,433,494,428,583,5850
"53045961000",4083,513,68,0,485,112,393,59,5713
"53045961100",4381,579,96,0,325,35,99,50,5565
"53045961200",3066,302,45,0,410,20,68,0,3911
"53045961300",2574,465,6,2,546,131,130,237,4091
"53047940100",834,183,6,0,1308,687,24,74,3116
"53047940200",969,359,0,0,1151,453,214,217,3363
"53047970300",4927,999,0,6,841,450,795,465,8483
"53047970400",2659,685,7,0,309,431,482,358,4931
"53047970500",2250,254,0,0,157,46,89,39,2835
"53047970600",4327,397,20,23,943,568,409,436,7123
"53047970700",2635,454,8,59,258,363,470,347,4594
"53047970800",2756,562,0,3,956,483,1738,768,7266
"53047970900",1682,218,0,0,69,8,42,4,2023
"53047971000",2906,549,2,4,133,120,181,200,4095
"53049950200",2978,671,8,26,606,237,541,67,5134
"53049950300",1996,549,0,0,474,175,275,236,3705
"53049950400",3079,390,0,0,110,50,55,27,3711
"53049950500",2313,370,5,4,105,68,50,75,2990
"53049950600",1035,218,2,0,94,12,121,10,1492
"53049950700",2261,296,0,0,55,31,37,0,2680
"53049950800",1731,236,37,0,133,191,26,163,2517
"53049990100",0,0,0,0,0,0,0,0,0
"53051970100",1636,328,0,0,103,16,47,10,2140
"53051970200",1956,248,0,0,357,180,30,9,2780
"53051970300",2373,893,4,0,114,61,95,28,3568
"53051970400",2032,333,13,0,61,11,78,0,2528
"53051970500",1358,479,0,0,183,64,109,7,2200
"53053060200",504,62,12,0,55,0,0,0,633
"53053060300",3091,236,116,0,504,44,133,0,4124
"53053060400",3562,173,12,0,303,103,339,9,4501
"53053060500",3268,355,75,0,347,0,191,11,4247
"53053060600",3951,348,220,15,350,76,153,0,5113
"53053060700",3311,1113,99,27,438,57,133,0,5178
"53053060800",4424,306,30,8,177,14,160,0,5119
"53053060903",2549,406,198,34,344,0,89,146,3766
"53053060904",3447,868,183,53,550,133,276,176,5686
"53053060905",4165,678,347,93,944,158,361,115,6861
"53053060906",1706,56,68,27,227,54,134,33,2305
"53053061001",2939,212,52,134,416,10,162,24,3949
"53053061002",2713,235,398,188,438,201,198,9,4380
"53053061100",4678,307,418,15,897,167,206,0,6688
"53053061200",3097,450,662,116,831,174,493,130,5953
"53053061300",2098,502,739,458,519,375,276,108,5075
"53053061400",758,626,267,188,554,136,51,129,2709
"53053061500",2770,910,303,116,434,85,286,220,5124
"53053061601",753,469,129,148,194,270,76,60,2099
"53053061602",446,131,75,27,148,17,58,0,902
"53053061700",1796,531,750,233,472,411,367,101,4661
"53053061800",1096,441,201,62,326,251,106,0,2483
"53053061900",976,142,72,80,244,317,50,127,2008
"53053062000",2212,468,250,64,1085,224,395,169,4867
"53053062300",1744,660,319,65,1768,477,1085,449,6567
"53053062400",3887,276,243,49,481,121,239,145,5441
"53053062500",4422,482,607,458,1825,102,535,0,8431
"53053062600",1418,449,289,23,365,201,209,215,3169
"53053062801",2582,1028,1092,335,1364,194,783,413,7791
"53053062802",2154,360,604,63,687,158,350,56,4432
"53053062900",3575,1085,714,338,1148,244,626,391,8121
"53053063000",1305,290,525,36,773,155,312,66,3462
"53053063100",1770,349,374,115,1045,373,209,195,4430
"53053063200",2988,384,275,68,945,421,223,138,5442
"53053063300",2481,652,684,762,3150,661,1854,584,10828
"53053063400",3049,918,375,488,1993,491,405,459,8178
"53053063501",1800,422,353,150,1428,381,704,254,5492
"53053063502",1695,142,559,148,1739,905,516,364,6068
"53053070100",2807,219,6,0,174,35,130,31,3402
"53053070203",4836,111,55,195,429,0,454,9,6089
"53053070204",2527,511,0,0,235,43,256,11,3583
"53053070205",2809,255,0,0,145,8,120,0,3337
"53053070206",3459,158,21,5,154,24,109,7,3937
"53053070207",3780,625,10,0,482,33,100,0,5030
"53053070307",4484,295,0,0,283,0,85,0,5147
"53053070308",2926,261,17,0,96,1,45,24,3370
"53053070309",4250,293,0,33,294,243,154,17,5284
"53053070310",4410,122,14,0,605,140,200,93,5584
"53053070311",3751,480,46,0,380,299,354,299,5609
"53053070312",4253,209,53,13,829,0,238,0,5595
"53053070313",4587,200,0,0,384,26,159,19,5375
"53053070314",2541,200,53,0,229,0,59,0,3082
"53053070315",3842,115,127,0,925,0,236,0,5245
"53053070316",3208,45,471,0,1327,0,327,0,5378
"53053070401",1741,151,67,0,123,0,120,13,2215
"53053070403",2684,329,0,1,427,0,359,0,3800
"53053070404",3651,511,51,0,399,0,240,28,4880
"53053070703",4546,465,36,26,883,34,242,0,6232
"53053071100",1781,131,0,0,255,135,6,0,2308
"53053071205",3578,285,87,10,477,40,135,11,4623
"53053071206",4768,567,308,16,873,101,476,81,7190
"53053071207",4291,410,84,73,976,88,627,54,6603
"53053071208",5437,560,243,0,827,92,604,0,7763
"53053071209",3437,163,77,40,368,11,171,0,4267
"53053071210",3603,98,0,1,590,9,278,0,4579
"53053071304",4004,464,375,37,935,106,435,0,6356
"53053071305",2616,212,249,39,413,203,170,126,4028
"53053071306",4870,99,378,71,1089,117,90,53,6767
"53053071307",3328,301,442,22,349,132,192,0,4766
"53053071309",2779,410,65,0,637,59,308,0,4258
"53053071310",3512,230,101,5,1056,79,708,0,5691
"53053071403",2806,407,114,0,465,45,430,92,4359
"53053071406",3748,366,418,0,1831,92,484,138,7077
"53053071407",4070,546,604,0,945,53,610,22,6850
"53053071408",2422,302,318,39,514,181,230,122,4128
"53053071409",2210,594,684,0,1148,68,516,78,5298
"53053071410",3810,757,764,0,806,219,592,366,7314
"53053071411",3047,390,676,57,843,46,588,33,5680
"53053071503",3259,258,689,0,1272,45,818,0,6341
"53053071504",1636,1083,279,216,758,238,190,270,4670
"53053071505",3629,375,585,38,983,93,318,37,6058
"53053071506",2768,323,232,91,1545,51,306,40,5356
"53053071601",2192,456,405,20,1197,745,881,692,6588
"53053071602",3138,504,557,329,1550,485,283,211,7057
"53053071703",1418,417,549,141,677,396,555,293,4446
"53053071704",1999,383,539,82,1076,780,1321,525,6705
"53053071705",1869,556,308,93,621,497,226,650,4820
"53053071706",746,301,260,31,441,24,163,0,1966
"53053071707",1668,483,114,33,406,162,313,148,3327
"53053071803",2753,577,614,153,853,231,798,178,6157
"53053071805",851,401,203,203,1582,526,222,266,4254
"53053071806",1140,834,412,294,857,709,752,1038,6036
"53053071807",1829,385,315,72,689,163,500,150,4103
"53053071808",1687,741,268,133,522,232,1082,459,5124
"53053071901",2421,587,453,60,1026,276,355,396,5574
"53053071902",4053,493,112,69,346,113,93,56,5335
"53053072000",1970,1187,265,139,500,467,267,811,5606
"53053072105",2999,269,151,39,1067,177,268,46,5016
"53053072106",3824,440,554,13,1481,197,1131,100,7740
"53053072107",2896,44,383,53,697,89,367,11,4540
"53053072108",3201,590,707,12,894,92,214,121,5831
"53053072109",2529,125,113,9,704,30,263,9,3782
"53053072111",1774,160,46,11,447,30,84,21,2573
"53053072112",2499,234,500,89,1131,117,625,0,5195
"53053072305",4380,267,268,0,834,149,239,122,6259
"53053072307",2826,130,692,23,478,17,218,9,4393
"53053072308",5304,232,368,0,1247,240,316,195,7902
"53053072309",3886,538,303,0,881,118,262,14,6002
"53053072310",2680,164,152,25,664,23,66,23,3797
"53053072311",2404,302,360,53,757,392,291,82,4641
"53053072312",2655,880,312,64,1331,193,240,211,5886
"53053072313",2637,135,78,40,690,10,168,26,3784
"53053072405",3642,209,0,0,303,0,91,16,4261
"53053072406",5415,274,17,0,516,32,200,153,6607
"53053072407",3474,397,95,2,636,96,422,69,5191
"53053072408",5087,285,83,0,228,56,164,71,5974
"53053072409",2361,126,12,0,26,19,85,43,2672
"53053072410",3326,202,14,15,259,0,11,0,3827
"53053072503",3634,247,8,0,356,27,137,1,4410
"53053072504",3072,304,93,0,228,123,17,0,3837
"53053072505",6214,69,16,0,593,45,370,0,7307
"53053072506",2923,160,72,0,371,53,44,26,3649
"53053072507",2261,259,11,0,95,0,98,0,2724
"53053072601",3975,575,89,7,441,82,125,1,5295
"53053072602",3742,176,0,0,308,1,146,10,4383
"53053072603",3803,491,30,43,195,17,36,0,4615
"53053072800",5861,278,643,14,1762,114,722,62,9456
"53053072901",1905,48,377,16,175,21,426,18,2986
"53053072903",838,118,349,22,299,25,255,7,1913
"53053072905",3890,296,955,0,494,94,1254,59,7042
"53053072906",83,0,0,0,16,0,16,0,115
"53053072907",3002,639,502,0,821,32,613,60,5669
"53053073001",4501,804,20,0,248,26,82,0,5681
"53053073005",4171,1036,0,0,338,42,15,42,5644
"53053073006",2476,306,0,0,282,0,56,0,3120
"53053073108",4876,523,720,0,1495,299,584,655,9152
"53053073110",3304,50,41,2,588,41,538,12,4576
"53053073111",3077,332,83,0,442,0,273,25,4232
"53053073113",5215,236,252,44,777,30,481,0,7035
"53053073114",4019,383,624,13,266,257,226,201,5989
"53053073115",3485,151,42,0,594,18,306,10,4606
"53053073116",2364,340,125,0,262,4,85,3,3183
"53053073117",3143,332,86,0,186,120,167,0,4034
"53053073118",3773,309,32,0,225,45,171,9,4564
"53053073119",2586,194,133,0,159,18,44,3,3137
"53053073120",2059,447,318,184,871,0,471,0,4350
"53053073121",3820,102,0,0,897,8,381,83,5291
"53053073122",3186,226,157,0,725,73,510,0,4877
"53053073123",3540,171,107,0,912,28,172,0,4930
"53053073124",2858,285,13,0,245,1,67,1,3470
"53053073125",6514,513,661,160,1325,278,477,206,10134
"53053073126",2233,190,523,0,763,0,402,58,4169
"53053073200",4589,567,7,0,271,55,299,109,5897
"53053073301",4143,562,78,0,786,274,754,107,6704
"53053073302",3131,140,6,0,417,0,207,8,3909
"53053073404",4747,626,57,0,389,124,223,8,6174
"53053073405",2456,258,231,2,514,86,259,15,3821
"53053073406",3735,324,19,11,523,0,509,15,5136
"53053073407",2901,530,0,0,227,44,290,115,4107
"53053073408",3338,352,40,0,250,49,225,172,4426
"53053073500",5769,400,28,0,740,35,571,0,7543
"53053940001",2191,78,58,0,303,44,99,3,2776
"53053940002",2459,299,189,38,572,244,208,42,4051
"53053940003",3833,341,679,99,1799,301,993,234,8279
"53053940004",5154,293,256,0,498,31,218,4,6454
"53053940005",3643,305,412,51,1303,210,656,69,6649
"53053940006",439,270,131,418,529,720,65,169,2741
"53053940007",1206,439,189,68,968,372,418,126,3786
"53053940008",3974,376,620,20,1269,63,301,128,6751
"53053940009",2561,116,85,0,149,18,222,3,3154
"53053940010",3012,587,82,0,129,22,217,148,4197
"53053940011",3172,90,143,23,848,17,117,7,4417
"53055960100",4221,503,18,0,203,89,120,84,5238
"53055960300",4111,372,30,19,167,10,147,26,4882
"53055960400",2545,261,9,0,240,20,304,84,3463
"53055960500",2245,352,26,1,115,52,45,68,2904
"53055990100",0,0,0,0,0,0,0,0,0
"53057940200",1956,91,0,0,146,8,98,0,2299
"53057940300",4158,290,21,3,194,15,127,12,4820
"53057940400",6168,292,20,0,348,39,325,0,7192
"53057940500",1744,458,10,10,276,28,245,72,2843
"53057940600",1167,226,4,16,60,15,49,6,1543
"53057940700",1245,157,17,0,96,16,39,0,1570
"53057940800",1983,156,20,10,688,355,146,9,3367
"53057950100",582,171,2,0,29,3,14,0,801
"53057950800",5610,170,2,0,227,0,727,12,6748
"53057950900",3091,481,44,110,349,154,209,103,4541
"53057951000",2309,314,6,0,133,41,157,32,2992
"53057951100",3267,771,13,1,411,114,282,19,4878
"53057951200",2783,98,1,0,85,1,123,0,3091
"53057951300",1432,141,0,0,96,0,64,17,1750
"53057951400",2916,297,41,0,360,128,246,53,4041
"53057951500",6867,1330,52,0,952,137,1159,56,10553
"53057951600",3732,438,10,0,177,205,786,348,5696
"53057951700",2632,204,0,0,491,25,267,40,3659
"53057951800",2044,1023,34,28,663,273,972,717,5754
"53057951900",3251,47,0,1,294,7,434,0,4034
"53057952100",2782,296,0,2,142,20,315,2,3559
"53057952200",2260,1425,0,15,770,210,745,994,6419
"53057952301",2381,1162,21,64,604,385,1348,1279,7244
"53057952302",6634,536,25,0,947,477,1791,808,11218
"53057952401",2286,467,25,0,186,33,671,76,3744
"53057952402",6299,559,20,1,783,170,1736,534,10102
"53057952500",1374,355,7,18,606,48,543,82,3033
"53057952600",3335,152,39,1,199,13,474,68,4281
"53057952700",3170,287,0,5,273,29,286,7,4057
"53057990100",0,0,0,0,0,0,0,0,0
"53059950100",183,0,0,0,0,0,0,0,183
"53059950200",4052,458,9,3,241,27,88,0,4878
"53059950300",1244,284,0,0,133,36,135,0,1832
"53059950400",1829,225,27,0,26,30,180,0,2317
"53059950500",1731,299,0,0,172,20,184,0,2406
"53061040100",3230,365,57,0,214,7,129,3,4005
"53061040200",2875,1066,304,215,869,515,465,610,6919
"53061040300",1908,551,13,0,286,38,297,205,3298
"53061040400",2739,306,115,0,296,71,217,25,3769
"53061040500",1455,210,45,28,369,211,111,196,2625
"53061040700",2321,880,75,84,160,64,133,105,3822
"53061040800",1704,395,23,73,140,134,162,15,2646
"53061040900",2204,116,52,0,149,59,135,38,2753
"53061041000",3953,834,143,16,543,58,402,249,6198
"53061041100",3089,347,59,0,779,226,658,74,5232
"53061041201",2170,189,102,0,675,133,415,56,3740
"53061041202",3992,1078,248,0,1074,116,852,486,7846
"53061041301",3995,363,31,0,571,0,17,0,4977
"53061041303",3070,391,59,0,928,62,509,43,5062
"53061041304",2401,44,15,0,447,17,220,0,3144
"53061041400",4009,727,24,0,1006,43,789,176,6774
"53061041500",958,201,143,3,117,36,119,25,1602
"53061041601",3933,281,173,15,1255,81,608,103,6449
"53061041605",4959,372,32,1,824,1,717,95,7001
"53061041606",3484,170,85,6,1177,138,313,0,5373
"53061041607",3105,174,92,0,594,15,107,71,4158
"53061041608",4674,237,151,0,1320,16,94,0,6492
"53061041701",2654,552,91,290,570,180,363,190,4890
"53061041703",3464,334,166,316,1286,0,535,177,6278
"53061041704",3013,398,61,0,1310,102,140,152,5176
"53061041805",2943,209,347,65,1331,140,599,32,5666
"53061041806",4272,933,240,132,1391,735,1039,860,9602
"53061041808",2677,392,118,29,470,84,582,89,4441
"53061041809",2756,733,540,71,909,235,575,503,6322
"53061041810",2968,739,309,80,599,463,415,918,6491
"53061041811",3811,790,412,0,1645,201,1166,638,8663
"53061041812",2093,885,259,0,1547,470,715,313,6282
"53061041901",2539,337,242,11,951,55,334,206,4675
"53061041903",3984,1221,279,152,1325,269,811,361,8402
"53061041904",3085,997,219,115,1044,171,1400,509,7540
"53061041905",3204,592,264,76,1112,318,1084,0,6650
"53061042001",4451,152,65,13,902,46,88,3,5720
"53061042003",2418,101,11,0,431,116,55,0,3132
"53061042004",3155,211,104,0,978,50,78,13,4589
"53061042005",3591,56,48,86,1424,276,141,0,5622
"53061042006",3217,153,37,0,1207,379,283,13,5289
"53061050101",2163,182,22,14,214,55,109,0,2759
"53061050102",3309,681,119,63,1011,315,190,0,5688
"53061050200",3533,290,26,0,445,26,177,0,4497
"53061050300",4437,395,0,0,451,76,35,0,5394
"53061050401",5550,329,385,76,757,53,468,41,7659
"53061050402",3700,292,89,36,883,2,152,0,5154
"53061050500",5707,384,0,0,476,239,350,16,7172
"53061050600",1031,19,78,0,146,3,50,1,1328
"53061050700",4424,125,185,87,693,568,242,190,6514
"53061050800",4541,207,163,0,896,122,216,30,6175
"53061050900",2115,323,216,0,410,28,195,83,3370
"53061051000",3373,522,150,0,462,122,546,65,5240
"53061051100",2933,62,33,0,777,43,564,0,4412
"53061051200",2725,327,0,20,1051,291,634,219,5267
"53061051300",4370,445,169,37,1269,296,386,46,7018
"53061051400",3377,717,507,203,1625,927,1111,571,9038
"53061051500",3210,674,218,0,837,318,579,220,6056
"53061051601",2682,597,277,121,671,127,440,144,5059
"53061051602",2853,233,132,0,971,212,298,74,4773
"53061051701",3477,561,198,0,1429,304,409,308,6686
"53061051702",2572,198,150,0,1054,130,185,50,4339
"53061051802",2277,497,379,14,2210,93,603,119,6192
"53061051803",2546,344,358,57,1750,527,607,112,6301
"53061051804",2411,83,336,2,1347,0,519,0,4698
"53061051905",4493,526,477,63,1783,293,549,98,8282
"53061051912",1932,79,0,0,309,0,26,0,2346
"53061051913",3222,71,21,4,719,58,175,0,4270
"53061051914",3211,250,0,0,558,57,273,34,4383
"53061051915",5753,348,253,0,1375,54,397,88,8268
"53061051916",3138,150,80,0,504,42,384,24,4322
"53061051917",3383,165,0,0,552,1,170,1,4272
"53061051918",3910,170,0,0,622,84,30,55,4871
"53061051921",3507,134,54,0,315,89,508,0,4607
"53061051922",3078,115,66,38,821,126,247,0,4491
"53061051923",3059,492,11,0,1040,58,186,1,4847
"53061051924",3896,290,0,29,2166,0,782,42,7205
"53061051925",4326,191,109,1,2185,124,172,0,7108
"53061051926",3572,101,0,0,951,0,206,0,4830
"53061051927",3310,101,24,0,1273,44,78,11,4841
"53061051928",2694,128,61,49,1498,339,641,104,5514
"53061052003",4525,411,250,0,2965,72,224,0,8447
"53061052004",4205,67,233,0,1435,28,130,0,6098
"53061052005",4045,247,130,0,884,0,221,0,5527
"53061052006",2770,257,35,0,1128,92,261,16,4559
"53061052007",3433,182,40,0,1438,52,491,0,5636
"53061052104",2693,82,199,0,488,2,139,0,3603
"53061052105",1525,42,13,0,92,98,0,98,1868
"53061052107",3308,105,0,0,910,154,154,0,4631
"53061052108",5158,447,48,0,146,10,176,0,5985
"53061052112",2359,225,0,0,229,13,50,0,2876
"53061052113",2858,53,44,0,222,28,210,28,3443
"53061052114",4310,51,0,1,667,24,304,0,5357
"53061052115",6205,231,62,0,850,27,459,47,7881
"53061052118",5543,292,40,0,972,110,277,54,7288
"53061052203",4844,124,15,19,522,17,341,2,5884
"53061052204",4708,108,83,14,796,29,708,30,6476
"53061052206",3774,149,0,0,135,57,242,71,4428
"53061052207",5008,243,0,0,273,70,163,152,5909
"53061052208",2313,647,87,0,713,94,685,354,4893
"53061052209",1862,468,0,0,125,1,640,115,3211
"53061052301",3856,337,0,1,176,9,136,158,4673
"53061052302",3286,166,12,0,480,17,54,22,4037
"53061052401",3152,285,1,17,304,79,180,26,4044
"53061052402",2792,617,0,12,216,45,170,0,3852
"53061052502",3831,303,0,0,305,14,50,0,4503
"53061052503",5572,620,80,0,527,78,485,78,7440
"53061052504",1878,145,57,0,114,11,63,13,2281
"53061052603",2023,213,11,0,465,0,211,0,2923
"53061052604",3449,544,12,11,323,147,660,222,5368
"53061052605",4937,190,0,0,317,51,153,0,5648
"53061052606",4134,417,15,12,377,99,649,34,5737
"53061052607",4890,244,35,0,598,33,570,83,6453
"53061052701",1423,38,0,0,70,0,73,0,1604
"53061052705",5740,407,96,0,854,188,565,372,8222
"53061052706",4435,288,16,0,822,34,602,9,6206
"53061052707",3067,101,9,102,457,0,262,32,4030
"53061052708",3910,497,26,0,708,17,372,0,5530
"53061052709",2932,93,50,0,277,8,177,0,3537
"53061052803",3593,421,161,2,566,4,109,90,4946
"53061052804",5479,441,0,0,1347,56,424,0,7747
"53061052805",3395,268,0,48,301,260,94,9,4375
"53061052806",4659,277,55,102,1168,390,672,57,7380
"53061052903",2630,731,9,0,273,93,264,213,4213
"53061052904",4079,525,49,42,293,245,226,375,5834
"53061052905",2847,782,2,0,584,174,553,196,5138
"53061052906",3777,720,0,2,356,27,290,0,5172
"53061053101",3180,306,0,1,322,139,303,15,4266
"53061053102",4104,241,0,0,266,5,60,17,4693
"53061053201",3119,379,56,0,276,0,62,20,3912
"53061053202",3825,292,10,0,289,73,147,49,4685
"53061053301",5242,778,0,0,256,71,256,40,6643
"53061053302",4593,147,18,0,297,0,187,0,5242
"53061053400",4886,427,59,25,157,0,86,0,5640
"53061053504",5283,643,0,0,279,359,464,323,7351
"53061053505",4428,243,0,0,281,0,342,14,5308
"53061053506",4475,318,0,0,492,50,169,0,5504
"53061053507",4440,219,131,14,410,5,282,0,5501
"53061053508",2572,606,0,1,289,22,271,74,3835
"53061053509",2794,354,18,0,461,214,332,45,4218
"53061053602",4772,338,0,0,477,36,479,0,6102
"53061053603",3051,220,0,0,239,19,16,0,3545
"53061053604",4177,72,115,0,173,0,303,0,4840
"53061053700",2614,500,11,0,117,59,0,0,3301
"53061053801",2728,452,10,0,90,24,138,13,3455
"53061053802",4438,483,0,0,406,0,424,0,5751
"53061053803",4663,521,19,0,239,48,336,56,5882
"53061940001",3989,518,12,7,1555,433,397,94,7005
"53061940002",2045,249,74,6,844,296,128,12,3654
"53061990002",0,0,0,0,0,0,0,0,0
"53061990100",0,0,0,0,0,0,0,0,0
"53063000200",2926,1046,53,262,462,151,210,61,5171
"53063000300",3527,662,14,35,426,679,472,144,5959
"53063000400",2609,833,264,107,418,123,167,49,4570
"53063000500",2494,471,33,16,185,1,175,23,3398
"53063000600",2730,134,39,0,167,57,70,0,3197
"53063000700",3710,531,16,0,314,63,186,0,4820
"53063000800",3961,555,24,0,189,67,63,0,4859
"53063000900",4844,739,0,3,254,13,201,55,6109
"53063001000",4798,621,14,0,333,90,19,75,5950
"53063001100",2993,143,29,0,210,56,108,56,3595
"53063001200",1567,352,39,8,68,36,27,4,2101
"53063001300",2305,622,194,94,240,76,205,66,3802
"53063001400",3956,1217,170,234,558,144,380,146,6805
"53063001500",3330,964,49,0,394,103,285,0,5125
"53063001600",2127,840,0,131,414,166,281,88,4047
"53063001800",2116,557,50,18,62,55,58,157,3073
"53063001900",2280,539,80,11,165,236,158,45,3514
"53063002000",2214,1010,25,0,307,415,165,83,4219
"53063002100",1371,407,37,288,135,166,110,66,2580
"53063002300",2677,1292,126,48,359,302,30,87,4921
"53063002400",1005,771,0,0,70,116,73,96,2131
"53063002500",2317,1789,77,77,262,630,209,303,5664
"53063002600",2946,793,116,31,1078,160,126,30,5280
"53063002900",2250,211,21,0,746,71,186,66,3551
"53063003000",1190,700,97,164,125,356,146,367,3145
"53063003100",3677,728,178,55,293,646,151,202,5930
"53063003200",1577,449,40,0,160,71,62,42,2401
"53063003500",1100,874,38,15,34,70,59,75,2265
"53063003600",2920,1156,33,37,76,93,92,124,4531
"53063003800",1244,367,0,0,147,24,83,2,1867
"53063003900",1896,150,20,0,119,0,51,0,2236
"53063004000",2909,1296,205,24,367,55,119,130,5105
"53063004100",1887,189,0,0,158,17,20,8,2279
"53063004200",4144,243,0,0,246,35,144,2,4814
"53063004300",2819,176,38,9,112,30,47,0,3231
"53063004400",3125,471,223,42,317,60,105,0,4343
"53063004500",2992,265,96,0,178,57,53,0,3641
"53063004601",2597,422,80,8,402,116,205,0,3830
"53063004602",2439,189,23,2,129,25,124,32,2963
"53063004700",4840,538,178,0,483,239,407,60,6745
"53063004800",3185,173,75,32,129,0,36,0,3630
"53063004900",4731,505,22,24,437,0,32,0,5751
"53063005000",3191,256,0,0,265,54,141,0,3907
"53063010100",5742,463,0,0,190,0,138,0,6533
"53063010201",3368,359,0,0,88,61,52,0,3928
"53063010202",6472,367,0,0,403,0,283,0,7525
"53063010301",2991,1010,0,0,164,73,272,39,4549
"53063010303",2628,253,0,0,99,63,24,63,3130
"53063010304",4278,782,0,0,249,20,164,0,5493
"53063010305",5599,51,0,0,271,0,90,2,6013
"53063010401",2080,799,157,27,407,344,177,269,4260
"53063010402",6596,539,0,0,234,19,78,0,7466
"53063010501",6469,947,45,32,243,0,222,222,8180
"53063010503",6414,239,20,0,312,2,187,0,7174
"53063010504",3346,133,0,0,64,0,65,0,3608
"53063010601",3296,98,40,12,158,0,60,10,3674
"53063010602",6548,119,39,0,575,0,237,0,7518
"53063010700",5234,92,28,0,787,14,256,0,6411
"53063010800",1345,442,23,3,77,105,34,27,2056
"53063010900",2972,485,9,0,276,50,146,0,3938
"53063011000",3581,238,9,24,204,92,139,0,4287
"53063011101",2731,1437,188,29,316,264,185,356,5506
"53063011102",2511,623,0,0,419,116,115,78,3862
"53063011201",5263,824,122,49,327,286,76,23,6970
"53063011202",3094,427,6,0,232,63,151,9,3982
"53063011300",6142,627,48,0,746,35,253,0,7851
"53063011400",4348,412,60,0,444,257,108,263,5892
"53063011500",1110,169,0,3,93,16,27,0,1418
"53063011600",1408,187,24,63,75,10,26,14,1807
"53063011701",1745,306,15,0,46,179,0,0,2291
"53063011702",3357,1644,292,25,278,349,139,449,6533
"53063011800",2599,1031,25,54,306,12,104,54,4185
"53063011900",2761,1141,232,0,375,14,382,81,4986
"53063012000",3382,434,13,0,139,0,61,128,4157
"53063012100",1784,458,33,39,113,200,60,38,2725
"53063012200",1798,204,43,6,141,11,154,0,2357
"53063012300",3869,961,155,0,439,90,77,0,5591
"53063012401",3637,245,0,0,215,0,33,13,4143
"53063012402",5212,311,25,0,407,27,306,0,6288
"53063012500",2553,503,30,4,202,59,106,0,3457
"53063012600",3002,431,18,0,320,0,132,27,3930
"53063012701",2997,255,0,0,168,11,11,0,3442
"53063012702",1847,108,0,0,111,16,50,0,2132
"53063012801",3299,300,18,34,296,20,111,0,4078
"53063012802",3005,198,11,0,220,23,77,10,3544
"53063012901",2265,640,17,0,145,9,153,70,3299
"53063012902",5404,395,14,0,542,88,404,14,6861
"53063013000",6198,749,39,17,490,99,324,58,7974
"53063013100",8467,877,0,26,775,17,217,44,10423
"53063013201",6344,694,0,0,333,37,134,41,7583
"53063013202",8484,292,0,0,690,47,424,49,9986
"53063013300",2603,113,10,0,80,0,37,0,2843
"53063013401",4480,129,8,0,298,0,263,0,5178
"53063013500",7182,175,77,0,419,130,306,27,8316
"53063013600",2983,435,87,67,484,21,317,0,4394
"53063013700",2537,307,110,39,181,86,397,9,3666
"53063013800",1866,100,80,0,324,33,237,0,2640
"53063013900",4034,498,31,72,228,37,131,8,5039
"53063014001",1801,1225,148,59,332,417,271,105,4358
"53063014002",3018,1586,28,143,112,24,60,197,5168
"53063014100",4721,463,11,126,154,0,70,0,5545
"53063014200",2305,354,0,0,63,65,18,18,2823
"53063014300",2514,278,4,0,155,27,63,20,3061
"53063014400",3610,597,13,110,578,51,371,0,5330
"53063014500",1012,824,14,22,154,72,102,22,2222
"53065941000",232,62,1,11,1194,480,25,14,2019
"53065950100",6275,1113,14,5,296,58,91,8,7860
"53065950200",3040,706,0,0,56,138,177,2,4119
"53065950300",1928,496,0,1,115,78,34,125,2777
"53065950500",1472,615,0,0,52,31,59,68,2297
"53065950600",1878,305,0,0,47,44,11,7,2292
"53065950700",1878,397,0,0,171,17,36,24,2523
"53065950800",2587,298,0,0,126,7,46,0,3064
"53065950900",1218,280,0,0,91,10,9,2,1610
"53065951100",2255,760,69,0,250,64,41,22,3461
"53065951300",3398,382,136,0,159,0,110,57,4242
"53065951400",6387,658,0,0,508,47,194,0,7794
"53067010100",2627,517,31,0,97,17,97,18,3404
"53067010200",3950,621,15,0,456,201,243,48,5534
"53067010300",3345,516,82,12,208,152,222,107,4644
"53067010400",3348,159,0,29,293,0,106,0,3935
"53067010510",901,384,8,0,130,18,25,14,1480
"53067010520",3553,777,85,99,330,164,325,84,5417
"53067010600",4097,1365,12,0,318,419,270,170,6651
"53067010700",4717,325,14,0,882,0,636,0,6574
"53067010800",5201,490,19,0,661,91,259,108,6829
"53067010910",4408,446,374,83,1368,218,406,24,7327
"53067010920",3075,509,132,42,221,136,104,160,4379
"53067011000",4226,419,0,0,305,71,164,0,5185
"53067011100",2678,439,61,25,737,64,309,63,4376
"53067011200",2871,697,194,16,386,144,285,96,4689
"53067011300",2983,120,165,20,802,154,289,33,4566
"53067011410",3173,528,126,6,774,99,175,238,5119
"53067011420",5232,674,347,16,926,29,466,137,7827
"53067011500",3259,894,102,0,782,288,266,260,5851
"53067011610",4610,594,307,10,1205,139,385,116,7366
"53067011621",4432,646,477,51,1243,202,484,66,7601
"53067011622",2913,368,262,123,974,74,451,75,5240
"53067011623",3749,489,300,0,957,18,376,82,5971
"53067011624",2990,205,53,0,368,141,203,119,4079
"53067011710",6017,452,81,0,915,14,348,2,7829
"53067011720",4109,203,16,0,377,33,155,70,4963
"53067011810",3650,117,0,0,260,40,97,39,4203
"53067011821",3560,229,25,0,119,86,220,29,4268
"53067011822",3516,477,0,0,448,97,27,91,4656
"53067011900",5977,471,0,25,446,15,50,40,7024
"53067012000",4740,725,0,0,893,204,295,83,6940
"53067012100",3403,237,0,0,180,0,96,0,3916
"53067012211",1975,209,78,6,239,100,139,87,2833
"53067012212",4581,650,236,20,1897,19,411,0,7814
"53067012221",4165,150,313,46,663,67,190,38,5632
"53067012222",5652,181,275,210,976,57,381,99,7831
"53067012310",6819,257,827,53,2107,53,1240,37,11393
"53067012320",1682,178,116,0,629,388,314,19,3326
"53067012330",2673,609,345,11,1040,139,437,444,5698
"53067012411",4657,1712,107,10,733,207,750,405,8581
"53067012412",3388,298,0,0,535,157,275,103,4756
"53067012420",3549,107,32,0,429,260,413,0,4790
"53067012510",2789,410,0,12,242,22,335,0,3810
"53067012520",5514,832,0,0,347,62,169,77,7001
"53067012530",3248,222,48,11,237,88,152,64,4070
"53067012610",4940,365,71,0,398,1,231,0,6006
"53067012620",3149,937,3,1,262,27,148,257,4784
"53067012710",1748,223,0,0,179,18,97,27,2292
"53067012720",4902,789,3,69,828,140,911,260,7902
"53067012730",4460,169,0,0,399,15,89,1,5133
"53067990100",0,0,0,0,0,0,0,0,0
"53069950100",2842,834,0,0,160,41,119,23,4019
"53071920000",4127,456,35,8,381,188,1298,366,6859
"53071920100",3740,559,0,0,228,34,401,116,5078
"53071920200",3051,902,18,5,193,83,638,605,5495
"53071920300",5767,1288,41,6,320,108,586,308,8424
"53071920400",0,0,0,0,0,0,0,0,0
"53071920500",1558,961,4,17,592,136,1311,709,5288
"53071920600",3470,1033,0,14,496,367,1172,535,7087
"53071920701",2756,573,7,0,242,274,286,362,4500
"53071920702",3649,469,0,0,190,132,381,205,5026
"53071920801",3438,895,8,0,497,26,626,14,5504
"53071920802",1427,538,0,0,170,137,109,173,2554
"53071920900",7495,358,83,22,553,43,755,10,9319
"53073000100",6604,1061,61,9,986,57,360,204,9342
"53073000200",6631,1274,84,15,825,247,510,216,9802
"53073000300",4347,1455,60,80,1102,675,521,649,8889
"53073000400",5059,530,0,0,293,74,142,111,6209
"53073000501",2799,1075,42,3,223,20,66,175,4403
"53073000502",1633,566,6,0,348,58,329,44,2984
"53073000600",497,402,10,0,71,135,18,77,1210
"53073000700",4128,1327,44,6,935,802,1089,392,8723
"53073000803",4614,512,40,2,570,428,193,225,6584
"53073000804",6485,237,127,0,529,0,248,0,7626
"53073000805",3876,741,0,0,526,43,184,78,5448
"53073000806",6553,622,0,60,544,155,427,141,8502
"53073000901",4745,1655,0,12,557,84,535,123,7711
"53073000902",4522,719,140,0,369,36,151,26,5963
"53073001000",1113,1443,26,24,445,288,190,158,3687
"53073001100",5518,670,0,15,337,122,89,148,6899
"53073001201",3146,2931,6,201,167,532,68,210,7261
"53073001202",2908,300,16,0,149,17,44,0,3434
"53073010100",7051,1328,2,0,436,232,430,35,9514
"53073010200",6068,1302,2,19,688,98,918,475,9570
"53073010301",6086,268,44,0,209,43,770,0,7420
"53073010302",4286,334,25,2,282,15,627,38,5609
"53073010303",4198,349,18,0,713,103,599,17,5997
"53073010401",6724,625,28,0,1198,145,323,72,9115
"53073010403",3325,240,24,49,762,358,122,338,5218
"53073010404",4881,734,82,0,510,249,205,240,6901
"53073010501",5695,629,153,0,598,251,94,186,7606
"53073010502",5274,1099,98,0,638,51,661,106,7927
"53073010600",5330,322,0,0,769,9,575,2,7007
"53073010701",4561,222,11,1,371,0,525,35,5726
"53073010702",3090,370,0,0,613,171,436,75,4755
"53073010900",865,52,7,0,162,12,0,0,1098
"53073011000",967,226,26,0,56,12,16,0,1303
"53073940000",1706,284,30,0,2046,579,212,5,4862
"53075000100",650,2465,0,36,111,438,43,170,3913
"53075000200",4318,820,0,0,584,340,296,83,6441
"53075000300",3857,635,101,5,513,164,218,38,5531
"53075000400",2638,768,34,0,214,106,73,61,3894
"53075000500",117,331,0,0,56,342,18,23,887
"53075000600",1266,3380,110,364,780,992,105,296,7293
"53075000700",2965,502,7,1,102,9,59,12,3657
"53075000800",2785,427,17,0,64,45,14,9,3361
"53075000900",3037,392,16,0,207,16,118,14,3800
"53075001000",1823,167,0,0,26,27,21,10,2074
"53077000100",606,598,37,37,151,801,417,1005,3652
"53077000200",1305,1335,119,41,1866,1307,2405,1768,10146
"53077000300",2323,816,0,0,669,536,986,865,6195
"53077000400",5837,404,97,0,730,3,672,126,7869
"53077000500",3226,388,0,30,1114,161,1235,160,6314
"53077000600",1917,1682,4,10,2438,1751,3658,2720,14180
"53077000700",3421,778,223,31,1942,902,2629,1189,11115
"53077000800",3263,280,41,0,814,22,792,10,5222
"53077000901",5771,261,132,0,1311,19,1172,7,8673
"53077000902",2526,447,17,0,835,272,876,235,5208
"53077001000",4172,712,0,0,491,585,1285,488,7733
"53077001100",4458,556,16,129,1481,536,1659,565,9400
"53077001201",1593,413,51,0,702,419,1135,574,4887
"53077001202",3148,748,0,22,1102,807,1787,1124,8738
"53077001300",1383,284,0,0,385,303,818,356,3529
"53077001400",1143,526,28,32,1260,569,1450,696,5704
"53077001501",1971,1667,40,0,1342,1346,2635,2246,11247
"53077001502",1064,557,0,1,708,295,1356,632,4613
"53077001601",1944,277,0,0,163,51,266,46,2747
"53077001602",5283,165,11,0,828,0,1044,41,7372
"53077001701",2556,381,0,8,93,40,489,276,3843
"53077001702",4170,192,11,4,1400,221,2330,285,8613
"53077001800",5405,610,0,0,1118,189,3484,501,11307
"53077001901",1883,1115,23,0,846,519,1811,1377,7574
"53077001902",4263,705,44,34,684,212,3390,894,10226
"53077002001",4184,2701,45,0,1002,522,4401,3078,15933
"53077002002",5686,2211,0,0,997,94,4884,1896,15768
"53077002101",1215,402,0,0,281,17,777,381,3073
"53077002102",4388,1934,0,0,910,215,3406,2059,12912
"53077002200",5201,1696,0,0,833,285,2269,1577,11861
"53077002701",2059,511,0,0,515,41,2192,550,5868
"53077002801",4934,143,0,0,522,9,722,2,6332
"53077002802",6882,395,15,0,831,233,1419,197,9972
"53077002900",3905,369,0,0,975,621,1811,873,8554
"53077003001",3109,636,0,2,240,284,231,284,4786
"53077003002",2603,533,0,40,151,197,212,367,4103
"53077003100",4253,388,0,0,374,97,237,230,5579
"53077003200",4364,1007,34,0,841,401,768,536,7951
"53077003400",3593,436,135,0,262,33,395,4,4858
"53077940001",2808,881,0,67,1925,575,1482,540,8278
"53077940002",1864,639,33,0,1491,712,1276,717,6732
"53077940003",1267,90,0,0,1453,811,350,94,4065
"53077940004",2846,1869,0,12,1128,899,3374,1946,12074
"53077940005",2104,1485,241,0,681,124,1980,1396,8011
"53077940006",2296,1057,9,0,765,487,2501,1320,8435
"54001965500",3650,332,77,0,0,0,35,0,4094
"54001965600",2180,751,0,0,24,69,0,17,3041
"54001965700",3851,952,0,0,163,0,35,0,5001
"54001965800",3344,625,0,0,36,119,9,3,4136
"54003971101",3561,587,254,0,279,114,58,103,4956
"54003971102",7224,832,259,0,153,10,209,0,8687
"54003971201",7856,962,499,10,346,0,396,8,10077
"54003971202",4834,349,0,0,120,0,24,77,5404
"54003971300",6157,1261,632,253,534,81,458,35,9411
"54003971400",8222,586,679,21,380,0,261,0,10149
"54003971500",2296,767,351,232,182,383,21,215,4447
"54003971600",2915,600,333,179,28,65,122,3,4245
"54003971700",3323,1416,143,351,147,170,123,239,5912
"54003971800",7465,594,60,0,93,0,310,64,8586
"54003971900",7363,880,519,12,588,8,329,14,9713
"54003972000",7972,1086,1259,317,417,271,419,26,11767
"54003972101",4316,440,342,16,157,0,114,0,5385
"54003972102",7277,684,774,78,299,45,232,13,9402
"54005958200",3340,1157,0,0,0,0,9,0,4506
"54005958300",2989,785,0,0,29,0,0,0,3803
"54005958400",1529,452,33,0,5,0,0,0,2019
"54005958501",2828,481,36,0,1,0,22,0,3368
"54005958502",2644,545,126,0,54,24,0,24,3417
"54005958600",1900,393,0,0,0,0,9,0,2302
"54005958700",1624,451,0,0,16,0,8,0,2099
"54005958800",2068,737,13,0,33,0,21,14,2886
"54007967900",3722,837,0,0,17,0,12,25,4613
"54007968000",3415,819,11,0,19,84,14,0,4362
"54007968100",3658,1269,4,10,6,38,11,8,5004
"54009031101",3952,795,190,0,15,9,25,0,4986
"54009031102",4562,226,0,0,32,0,31,0,4851
"54009031200",2642,346,39,83,8,25,9,0,3152
"54009031400",3300,775,41,0,12,0,0,0,4128
"54009031600",2995,280,0,1,107,1,47,0,3431
"54009031700",2040,428,0,0,13,32,25,0,2538
"54011000101",1145,625,11,0,31,0,42,0,1854
"54011000102",1417,474,33,96,15,38,0,0,2073
"54011000200",2071,967,0,36,49,72,0,0,3195
"54011000300",1509,793,34,0,115,111,14,56,2632
"54011000400",1085,1562,49,114,165,13,0,13,3001
"54011000500",156,458,0,115,0,100,0,8,837
"54011000600",236,495,39,52,10,104,2,0,938
"54011000900",849,622,11,66,6,18,13,2,1587
"54011001000",1308,466,129,0,110,208,0,0,2221
"54011001100",1244,537,22,20,9,11,0,0,1843
"54011001200",2355,341,139,68,11,0,56,0,2970
"54011001300",2050,652,200,108,17,0,40,0,3067
"54011001400",1033,333,594,316,40,36,59,46,2457
"54011001500",596,287,354,460,124,184,0,0,2005
"54011001600",567,322,133,10,59,61,0,0,1152
"54011001800",1492,1505,156,184,127,146,0,0,3610
"54011001900",1747,239,0,0,59,57,0,23,2125
"54011002000",2826,132,81,28,205,46,58,15,3391
"54011002100",2884,295,28,0,90,15,31,0,3343
"54011010102",5292,852,0,0,35,0,83,15,6277
"54011010201",4646,673,132,0,274,41,86,0,5852
"54011010202",3458,407,10,0,87,15,0,0,3977
"54011010300",2659,264,39,0,47,0,0,0,3009
"54011010400",5224,723,0,12,180,151,102,0,6392
"54011010500",4340,771,0,0,120,112,38,112,5493
"54011010600",3007,582,0,0,38,57,0,0,3684
"54011010700",6830,652,19,4,65,30,88,0,7688
"54011010800",5185,552,0,15,37,0,0,0,5789
"54011010900",759,737,89,15,9,43,74,11,1737
"54013962600",2645,758,1,0,46,41,1,0,3492
"54013962700",3160,768,3,17,11,71,0,0,4030
"54015957900",2579,927,0,0,83,0,33,0,3622
"54015958000",2486,926,0,0,15,0,0,0,3427
"54015958100",1738,437,23,0,33,3,0,0,2234
"54017965000",2990,416,2,0,1,20,34,0,3463
"54017965100",3380,768,22,0,145,0,7,0,4322
"54019020100",4070,946,86,0,138,0,14,0,5254
"54019020201",2466,885,482,169,22,0,15,0,4039
"54019020202",2916,702,165,13,64,81,50,0,3991
"54019020300",2382,615,0,0,8,8,0,8,3021
"54019020400",2828,907,164,167,50,44,87,0,4247
"54019020500",1453,649,122,109,25,7,11,0,2376
"54019020600",1630,312,0,50,11,0,8,5,2016
"54019020700",3153,862,190,41,59,30,69,3,4407
"54019020800",3954,508,70,82,44,36,0,3,4697
"54019020900",3787,686,18,0,6,0,7,26,4530
"54019021000",2150,608,0,0,13,0,53,0,2824
"54019021100",2012,771,20,0,1,0,0,7,2811
"54021967700",3180,1089,0,0,44,104,0,0,4417
"54021967800",1311,547,24,58,53,43,13,0,2049
"54023969400",2842,463,0,1,8,0,9,0,3323
"54023969500",3143,614,0,0,0,0,15,0,3772
"54023969600",3819,562,69,74,143,0,64,0,4731
"54025950100",3864,812,154,118,52,40,10,9,5059
"54025950200",3364,867,57,6,37,32,3,13,4379
"54025950300",2929,689,55,0,39,21,17,7,3757
"54025950400",5573,1284,28,0,365,9,203,0,7462
"54025950500",2614,526,26,27,54,24,22,8,3301
"54025950600",3906,569,107,104,87,59,72,51,4955
"54025950700",4554,1406,59,68,56,205,8,18,6374
"54027968200",3831,494,74,0,40,0,40,0,4479
"54027968300",4455,1120,0,0,156,71,85,0,5887
"54027968400",3620,971,36,0,34,11,58,0,4730
"54027968500",2494,502,0,4,10,0,10,0,3020
"54027968600",4186,944,48,47,0,0,38,22,5285
"54029020600",3514,205,71,0,107,4,52,7,3960
"54029020700",3509,462,60,108,50,40,32,12,4273
"54029020900",2347,565,68,0,61,0,16,11,3068
"54029021100",3141,473,109,0,0,0,59,0,3782
"54029021200",2653,739,0,0,17,1,4,0,3414
"54029021300",2141,1106,120,22,2,150,6,91,3638
"54029021400",3074,335,198,10,40,11,27,9,3704
"54029021500",3676,852,0,0,12,0,0,0,4540
"54031970100",4147,718,37,2,14,0,41,63,5022
"54031970200",3598,615,181,18,35,18,110,53,4628
"54031970300",3651,679,0,0,0,127,57,137,4651
"54033030100",1560,1056,61,24,56,18,39,0,2814
"54033030200",1995,765,0,0,0,27,27,27,2841
"54033030300",1740,698,62,13,2,34,2,0,2551
"54033030400",2346,309,253,33,63,0,16,0,3020
"54033030500",3636,708,0,103,57,47,24,33,4608
"54033030601",2310,236,0,0,0,0,0,0,2546
"54033030602",4797,1158,33,0,352,42,87,92,6561
"54033030700",2038,269,3,0,9,9,0,0,2328
"54033030800",3557,897,0,0,9,7,46,35,4551
"54033031000",2841,538,20,14,115,12,53,0,3593
"54033031100",1776,447,4,105,27,0,58,73,2490
"54033031200",2021,114,19,0,60,4,88,12,2318
"54033031300",2203,293,23,0,12,0,13,0,2544
"54033031400",2332,437,0,0,53,36,12,0,2870
"54033031500",1160,160,0,0,0,0,0,0,1320
"54033031600",1675,501,24,12,65,18,17,8,2320
"54033031700",1456,707,0,0,0,0,10,0,2173
"54033031800",1974,410,0,0,43,0,12,0,2439
"54033031900",1951,624,0,0,13,45,7,0,2640
"54033032000",1987,408,1,1,0,0,45,0,2442
"54033032101",3272,544,35,37,12,0,9,0,3909
"54033032102",5366,94,203,22,341,0,67,0,6093
"54035963200",4076,857,59,0,12,154,30,0,5188
"54035963300",3265,767,0,0,14,48,0,0,4094
"54035963400",3581,616,0,0,0,0,0,0,4197
"54035963500",2467,294,18,0,18,0,18,0,2815
"54035963600",3251,818,0,0,24,9,0,0,4102
"54035963700",6464,1661,0,156,45,78,0,0,8404
"54037972201",3346,255,110,16,264,43,71,19,4124
"54037972203",1648,129,44,3,52,0,31,2,1909
"54037972204",1719,332,98,0,86,0,49,11,2295
"54037972300",4284,459,171,10,322,45,169,0,5460
"54037972401",1581,189,634,0,222,30,512,47,3215
"54037972402",2872,332,382,291,163,0,162,17,4219
"54037972501",4248,151,269,0,346,5,511,0,5530
"54037972503",2216,233,349,0,57,214,122,6,3197
"54037972505",1911,262,327,145,28,0,174,32,2879
"54037972506",2094,228,235,29,235,31,335,15,3202
"54037972601",1722,204,61,0,27,32,0,0,2046
"54037972602",3989,97,13,0,51,0,30,0,4180
"54037972701",2327,203,0,0,72,0,14,0,2616
"54037972702",2996,439,110,26,196,0,114,0,3881
"54037972800",4960,1312,51,0,57,159,111,23,6673
"54039000100",653,433,54,104,95,161,9,20,1529
"54039000200",1187,372,152,230,150,65,0,0,2156
"54039000300",2409,505,44,22,85,99,18,0,3182
"54039000500",1649,351,44,30,29,146,40,0,2289
"54039000600",3148,744,173,181,170,20,47,10,4493
"54039000700",750,298,437,206,225,132,60,0,2108
"54039000800",724,312,167,123,197,77,26,0,1626
"54039000900",297,159,62,57,70,10,20,0,675
"54039001100",3487,648,293,254,285,101,6,7,5081
"54039001200",501,247,210,99,132,228,61,57,1535
"54039001300",1211,319,145,54,258,107,12,51,2157
"54039001500",3521,150,89,0,175,0,17,0,3952
"54039001700",1235,512,11,0,41,5,0,0,1804
"54039001800",1867,405,0,4,454,39,179,0,2948
"54039001901",3601,108,32,0,426,0,53,0,4220
"54039001902",3442,216,16,0,241,0,0,0,3915
"54039002000",3051,121,131,0,12,0,4,0,3319
"54039002100",3850,499,147,210,423,12,67,0,5208
"54039010100",3063,343,216,50,146,71,25,46,3960
"54039010200",1688,379,71,112,31,0,0,0,2281
"54039010300",1872,170,94,14,62,16,60,0,2288
"54039010400",432,106,357,70,85,31,9,0,1090
"54039010500",3984,639,27,115,175,0,148,0,5088
"54039010600",5137,374,11,0,87,14,0,0,5623
"54039010701",4546,291,172,0,26,179,9,0,5223
"54039010702",4240,378,81,0,72,0,0,0,4771
"54039010801",5699,505,0,0,433,183,0,0,6820
"54039010802",2774,456,0,0,294,58,0,0,3582
"54039010900",2244,298,0,0,93,50,119,31,2835
"54039011000",4524,150,16,0,388,32,0,0,5110
"54039011100",4222,691,13,0,249,161,0,0,5336
"54039011200",3215,472,0,0,320,21,4,0,4032
"54039011301",2247,668,0,0,159,32,30,12,3148
"54039011302",4659,452,0,0,511,16,9,0,5647
"54039011401",1538,274,0,0,257,74,8,6,2157
"54039011402",3092,301,0,0,180,89,10,0,3672
"54039011500",3032,319,286,77,205,116,0,20,4055
"54039011800",3464,796,44,0,792,234,0,0,5330
"54039012100",2798,442,42,44,614,79,40,6,4065
"54039012200",2988,846,49,32,338,236,56,0,4545
"54039012300",5389,919,7,0,311,33,23,5,6687
"54039012800",3731,265,98,0,122,28,15,0,4259
"54039012900",1077,179,67,0,50,6,9,0,1388
"54039013000",3977,324,202,25,157,31,46,0,4762
"54039013100",3062,646,195,36,107,114,21,7,4188
"54039013200",2658,454,39,10,81,0,15,0,3257
"54039013300",2158,121,25,0,66,0,23,18,2411
"54039013400",1642,313,87,29,75,45,40,8,2239
"54039013500",2651,67,20,11,89,0,0,0,2838
"54039013600",3307,680,286,23,101,27,44,11,4479
"54039013701",2120,97,19,0,41,0,0,0,2277
"54039013702",5499,724,17,0,46,0,70,0,6356
"54039013800",2088,732,23,15,22,31,25,12,2948
"54041967200",2728,801,1,0,124,27,0,0,3681
"54041967300",3162,424,0,0,46,0,12,0,3644
"54041967400",2151,463,0,0,11,11,24,0,2660
"54041967500",1964,1022,9,23,13,0,9,0,3040
"54041967600",2636,499,0,0,59,19,0,0,3213
"54043955400",5131,1881,18,16,20,0,0,0,7066
"54043955500",2940,603,0,0,0,16,3,0,3562
"54043955600",2894,1646,36,0,24,37,4,14,4655
"54043955700",2128,499,19,0,12,46,0,0,2704
"54043955800",2392,1125,12,0,42,10,0,0,3581
"54045956101",5311,1061,11,1,25,65,48,15,6537
"54045956102",2939,663,0,0,10,0,13,0,3625
"54045956200",2355,640,149,18,105,25,20,0,3312
"54045956400",3063,633,104,18,47,16,0,0,3881
"54045956500",1645,585,0,50,0,14,7,0,2301
"54045956600",3783,674,124,0,62,0,90,0,4733
"54045956700",3132,872,34,131,22,0,63,0,4254
"54045956800",3722,940,0,45,0,0,0,0,4707
"54045956900",1828,546,63,44,26,17,5,12,2541
"54047953600",552,565,219,248,0,15,0,0,1599
"54047953800",2330,936,11,9,3,41,0,0,3330
"54047953900",1251,732,0,2,0,0,0,0,1985
"54047954000",1157,733,0,0,0,1,0,0,1891
"54047954200",1189,867,15,0,0,0,2,0,2073
"54047954501",840,535,297,67,0,0,0,0,1739
"54047954503",1819,846,611,273,12,5,0,0,3566
"54047954504",2879,1708,132,5,26,0,0,0,4750
"54049020100",486,435,67,158,20,56,12,36,1270
"54049020200",1231,995,76,108,0,65,0,27,2502
"54049020300",3129,232,20,0,112,0,13,0,3506
"54049020400",943,169,27,36,53,0,10,4,1242
"54049020500",745,396,572,270,69,35,0,14,2101
"54049020600",1391,219,37,0,4,0,3,0,1654
"54049020700",3097,982,0,0,22,0,0,0,4101
"54049020800",2305,445,21,5,46,0,38,0,2860
"54049020900",3347,631,0,0,36,0,39,0,4053
"54049021000",4335,431,43,0,53,0,0,0,4862
"54049021100",2549,146,44,2,49,0,124,0,2914
"54049021200",5344,366,87,2,323,7,167,0,6296
"54049021300",2815,524,25,0,63,9,3,16,3455
"54049021400",1602,124,72,17,36,0,5,0,1856
"54049021500",3176,376,76,84,0,0,10,0,3722
"54049021600",3821,725,0,3,65,19,9,0,4642
"54049021700",1669,204,0,0,28,11,0,0,1912
"54049021800",2385,507,42,0,8,11,23,0,2976
"54051020200",1661,281,0,3,56,14,24,21,2060
"54051020500",596,338,14,17,23,3,1,38,1030
"54051020601",1564,375,0,0,11,0,0,3,1953
"54051020702",1122,212,0,22,10,8,6,0,1380
"54051020800",4094,750,0,0,14,15,22,18,4913
"54051020900",4331,703,51,0,11,0,0,0,5096
"54051021000",5172,982,14,7,72,25,67,20,6359
"54051021100",4247,821,0,60,92,2,15,2,5239
"54051021300",3746,541,10,0,95,2,6,43,4443
"54053954801",1993,602,4,0,54,9,0,0,2662
"54053954802",3389,718,9,0,16,8,0,0,4140
"54053954900",5285,1381,0,0,114,0,0,0,6780
"54053955000",4273,456,166,0,174,78,0,61,5208
"54053955101",2471,862,0,0,21,0,31,0,3385
"54053955102",3503,914,0,0,0,0,40,0,4457
"54055000900",2023,831,10,51,82,20,0,20,3037
"54055001000",3677,1386,0,0,14,0,18,3,5098
"54055001100",4415,603,3,12,246,32,36,0,5347
"54055001200",2926,379,0,0,29,33,32,6,3405
"54055001300",2574,1440,77,101,56,86,50,48,4432
"54055001400",1668,261,144,12,38,69,16,0,2208
"54055001500",4001,1067,240,1,181,1,0,0,5491
"54055001600",1077,394,31,12,20,6,0,0,1540
"54055001700",3736,1714,10,123,87,0,25,0,5695
"54055001800",4110,1016,17,142,0,54,0,0,5339
"54055001900",638,247,464,299,0,6,0,11,1665
"54055002000",1382,424,360,334,41,12,15,0,2568
"54055002100",2416,431,237,65,32,68,16,2,3267
"54055002200",3206,355,529,98,127,0,140,0,4455
"54055002300",3875,805,51,10,83,96,40,0,4960
"54055002400",2296,425,25,0,61,0,8,0,2815
"54057010100",2157,375,0,3,18,0,0,2,2555
"54057010200",2809,434,5,0,7,0,0,0,3255
"54057010300",4145,583,0,37,7,0,121,0,4893
"54057010400",3852,679,0,0,31,0,0,0,4562
"54057010500",3633,361,120,43,46,0,0,0,4203
"54057010600",4019,959,275,193,96,185,43,13,5783
"54057010700",1544,415,143,34,32,12,20,5,2205
"54059957100",3178,932,0,0,0,17,10,0,4137
"54059957200",2905,758,0,0,0,6,0,0,3669
"54059957300",3124,811,0,12,34,0,21,7,4009
"54059957400",2644,646,187,118,107,191,0,0,3893
"54059957500",2536,1033,30,13,67,9,24,6,3718
"54059957600",2267,666,9,81,9,16,0,0,3048
"54059957700",3148,712,0,0,6,0,0,0,3866
"54061010101",115,391,0,6,8,19,5,19,563
"54061010102",831,1849,29,15,73,305,50,13,3165
"54061010201",1820,1799,15,48,234,100,41,60,4117
"54061010202",1746,2207,49,14,179,41,14,36,4286
"54061010400",3008,351,98,128,231,93,4,0,3913
"54061010600",2289,1908,526,88,570,134,96,5,5616
"54061010700",1713,849,144,182,147,127,26,15,3203
"54061010800",3379,528,28,151,151,59,29,0,4325
"54061010901",2108,1050,31,105,87,43,24,29,3477
"54061010902",2909,298,217,34,90,34,64,0,3646
"54061011000",1986,1109,36,39,24,42,43,77,3356
"54061011100",1788,587,48,17,29,0,0,8,2477
"54061011200",2602,380,76,25,69,157,0,0,3309
"54061011300",3525,437,17,0,58,0,108,0,4145
"54061011400",3196,304,0,0,0,0,0,0,3500
"54061011500",4479,397,0,0,39,0,0,0,4915
"54061011600",3506,1112,105,0,798,80,98,136,5835
"54061011700",3265,282,128,101,129,0,14,0,3919
"54061011803",2721,644,69,0,22,17,6,0,3479
"54061011804",3453,119,0,0,13,0,66,0,3651
"54061011805",4325,290,0,0,142,46,97,46,4946
"54061011806",4450,442,115,6,120,13,15,95,5256
"54061011900",3684,297,39,0,74,0,14,0,4108
"54061012000",2505,444,108,23,238,81,42,0,3441
"54063950100",2972,710,31,1,84,17,0,0,3815
"54063950200",3476,763,17,36,37,30,0,0,4359
"54063950300",4970,267,0,0,0,0,142,0,5379
"54065970700",5188,638,0,0,11,104,13,0,5954
"54065970800",3252,673,23,14,70,0,13,15,4060
"54065970900",2053,717,3,34,10,6,68,0,2891
"54065971000",3948,418,77,47,48,0,7,37,4582
"54067950100",2841,332,0,0,0,0,0,0,3173
"54067950200",5452,1044,0,1,0,0,0,0,6497
"54067950300",990,284,0,0,0,0,0,0,1274
"54067950400",3236,1227,0,0,0,0,0,0,4463
"54067950500",981,518,0,0,56,0,14,0,1569
"54067950600",4493,865,0,0,260,27,0,0,5645
"54067950700",2587,469,0,0,0,190,50,0,3296
"54069000200",2676,389,62,51,45,0,51,6,3280
"54069000300",1548,146,67,33,83,116,0,0,1993
"54069000400",584,502,18,40,10,4,14,0,1172
"54069000500",1067,260,14,86,130,0,40,0,1597
"54069000600",595,469,35,0,17,0,0,0,1116
"54069000700",357,151,171,151,5,8,5,1,849
"54069001300",1277,210,0,0,113,0,0,0,1600
"54069001400",2309,245,7,9,113,0,7,0,2690
"54069001500",2142,240,1,2,20,0,100,21,2526
"54069001600",1789,232,1,0,129,0,0,0,2151
"54069001700",1502,14,0,0,54,1,0,0,1571
"54069001800",4495,479,119,277,49,71,28,17,5535
"54069001901",2311,114,0,0,41,6,6,0,2478
"54069002000",4771,329,9,8,76,0,9,14,5216
"54069002100",2405,481,2,7,23,21,8,0,2947
"54069002200",2201,297,26,91,8,0,0,7,2630
"54069002600",1513,472,0,18,5,9,0,0,2017
"54069002700",261,400,99,14,5,0,5,0,784
"54071970400",1208,383,0,0,8,14,10,0,1623
"54071970500",2901,663,75,12,15,0,76,0,3742
"54071970600",1705,315,60,15,66,0,0,0,2161
"54073962100",2194,535,0,0,36,0,21,0,2786
"54073962200",3736,430,2,37,56,26,8,14,4309
"54075960101",920,250,0,0,0,1,16,1,1188
"54075960102",868,226,23,2,8,0,0,0,1127
"54075960200",2823,871,2,12,111,17,8,20,3864
"54075960300",2001,177,0,0,0,38,0,10,2226
"54077963800",3718,388,0,0,28,0,28,0,4162
"54077963900",3392,484,0,0,32,0,0,0,3908
"54077964000",3220,709,56,0,9,0,17,0,4011
"54077964100",3639,656,20,0,36,0,12,0,4363
"54077964200",3463,546,0,0,44,0,11,0,4064
"54077964300",4068,583,0,0,8,6,11,0,4676
"54077964400",2746,473,0,0,91,0,9,6,3325
"54077964500",2586,282,2,0,31,0,0,0,2901
"54079020100",3792,1197,0,0,18,73,0,0,5080
"54079020200",4631,756,0,0,58,0,105,6,5556
"54079020300",3967,233,51,0,56,0,37,0,4344
"54079020400",6407,433,7,0,35,195,9,0,7086
"54079020500",5348,720,9,0,71,0,57,0,6205
"54079020601",4978,214,177,0,202,0,8,0,5579
"54079020603",6179,822,0,0,74,0,197,28,7300
"54079020604",2124,213,113,187,204,0,0,0,2841
"54079020605",6732,650,0,0,167,0,54,0,7603
"54079020700",3775,568,26,20,72,0,5,0,4466
"54081000200",1356,313,694,507,213,190,26,0,3299
"54081000300",2255,372,1102,339,129,124,17,0,4338
"54081000400",1697,620,605,281,155,3,0,13,3374
"54081000500",3483,300,132,41,115,18,136,40,4265
"54081000600",2742,706,260,600,250,111,0,0,4669
"54081000700",2719,442,135,59,20,19,21,0,3415
"54081000802",3499,337,13,84,48,0,0,0,3981
"54081000803",3645,803,0,0,88,82,0,90,4708
"54081000804",4938,628,21,0,28,3,0,0,5618
"54081000900",4770,712,0,18,44,50,91,0,5685
"54081001001",4179,737,44,0,4,0,33,0,4997
"54081001002",2431,545,18,0,0,94,0,76,3164
"54081001100",4766,833,97,8,104,0,0,0,5808
"54081001200",3872,926,0,0,0,26,0,0,4824
"54081001300",4002,853,47,21,48,111,121,0,5203
"54081001400",3984,457,36,2,93,31,26,14,4643
"54081001500",3256,416,199,8,90,21,27,0,4017
"54083965900",3077,678,46,0,28,0,0,0,3829
"54083966000",3462,432,0,0,71,0,34,18,4017
"54083966100",2240,724,148,0,72,63,9,97,3353
"54083966200",3704,567,0,0,10,3,0,0,4284
"54083966300",2741,327,0,0,64,0,0,0,3132
"54083966400",4501,669,3,6,26,20,13,0,5238
"54083966500",2764,860,0,0,11,0,0,0,3635
"54085962300",3344,770,6,0,86,3,56,13,4278
"54085962400",2230,447,0,0,42,0,0,0,2719
"54085962500",2289,914,14,0,8,15,2,6,3248
"54087962800",1664,287,0,0,71,30,2,0,2054
"54087962900",2959,664,0,0,189,61,6,0,3879
"54087963000",2330,1201,0,2,140,44,27,39,3783
"54087963100",3456,1237,0,0,134,91,45,0,4963
"54089000500",1756,850,51,0,0,0,65,0,2722
"54089000600",4171,464,35,12,0,30,244,0,4956
"54089000700",818,526,10,55,0,0,0,0,1409
"54089000800",3165,454,72,1,110,0,0,0,3802
"54091964600",3838,1101,28,0,7,0,49,0,5023
"54091964700",3824,600,34,36,11,21,55,0,4581
"54091964800",3743,1009,46,0,94,3,47,0,4942
"54091964900",1428,352,44,0,43,18,0,0,1885
"54093965200",1477,241,0,9,0,7,4,7,1745
"54093965300",1677,341,0,0,0,0,10,17,2045
"54093965400",2461,616,0,0,72,10,0,0,3159
"54095961800",2620,780,0,8,34,17,42,2,3503
"54095961900",2955,526,0,0,8,2,2,5,3498
"54095962000",1604,465,0,0,10,0,2,0,2081
"54097966600",3691,680,0,0,81,10,0,0,4462
"54097966700",1560,642,9,16,35,1,0,66,2329
"54097966800",2718,863,12,0,24,0,25,47,3689
"54097966900",2797,476,0,0,50,0,0,0,3323
"54097967000",3985,888,74,47,59,31,0,0,5084
"54097967100",3609,544,0,0,35,23,0,0,4211
"54099005100",1554,365,2,0,0,5,0,0,1926
"54099005200",1750,176,0,0,38,0,0,0,1964
"54099020100",1946,285,1,0,50,4,11,0,2297
"54099020300",3596,938,0,0,7,34,0,0,4575
"54099020400",5990,540,0,16,65,0,0,0,6611
"54099020500",3554,961,0,0,62,20,0,20,4617
"54099020600",4331,1173,21,0,114,5,28,0,5672
"54099020700",3035,313,0,0,0,10,0,0,3358
"54099020800",3033,1471,4,0,52,0,0,10,4570
"54099020900",2214,1029,0,0,28,0,0,0,3271
"54099021000",1788,956,0,0,116,12,0,165,3037
"54101970100",3495,1219,0,0,64,0,30,0,4808
"54101970200",1580,615,0,0,26,41,11,0,2273
"54101970300",1545,384,0,0,0,0,0,0,1929
"54103004900",2697,729,0,0,15,0,18,12,3471
"54103030400",2340,599,0,0,7,0,43,0,2989
"54103030500",3169,985,0,0,56,33,0,0,4243
"54103030700",3318,784,4,0,54,0,15,6,4181
"54103030800",1418,64,8,0,0,25,0,0,1515
"54105030101",2802,443,19,0,87,7,0,0,3358
"54105030102",1743,636,0,0,12,28,0,0,2419
"54107000100",2654,835,15,0,144,0,10,0,3658
"54107000300",2001,437,92,67,98,13,15,0,2723
"54107000400",2004,219,32,0,12,0,13,0,2280
"54107000500",2636,1163,73,9,63,119,71,26,4160
"54107000701",1463,833,47,102,37,75,31,0,2588
"54107000702",1210,309,7,0,36,9,6,13,1590
"54107000801",970,428,6,2,9,15,0,0,1430
"54107000802",2603,701,63,22,53,0,52,0,3494
"54107000901",955,223,0,0,34,4,36,0,1252
"54107000902",875,230,12,0,44,98,0,0,1259
"54107000903",3566,929,5,10,17,70,0,11,4608
"54107010101",1946,248,0,0,8,0,8,0,2210
"54107010102",1556,298,19,0,6,0,0,0,1879
"54107010200",2719,199,0,0,24,0,61,0,3003
"54107010300",3958,296,37,0,266,29,61,29,4676
"54107010400",1561,165,17,17,45,1,0,0,1806
"54107010501",1308,253,0,0,10,0,21,0,1592
"54107010502",3189,639,16,42,111,12,0,0,4009
"54107010601",4203,268,41,0,144,46,37,35,4774
"54107010602",3825,516,0,0,40,0,28,0,4409
"54107010701",4792,1170,0,0,59,0,125,22,6168
"54107010702",7027,896,52,17,95,0,0,0,8087
"54107010800",2213,499,0,0,42,0,42,0,2796
"54107010901",4477,187,0,0,136,34,0,0,4834
"54107010902",3199,550,28,0,61,5,12,0,3855
"54107011000",2342,430,0,18,51,16,0,0,2857
"54109002800",2232,399,0,0,52,0,0,0,2683
"54109002901",3732,840,0,0,19,89,0,42,4722
"54109002902",2962,580,0,0,41,25,26,0,3634
"54109003000",1439,557,0,0,0,0,0,0,1996
"54109003100",3659,1314,0,17,0,3,0,0,4993
"54109003200",3957,1098,111,55,34,7,33,11,5306
"55001950100",2968,67,0,0,6,0,13,0,3054
"55001950201",1286,121,0,0,16,0,16,2,1441
"55001950202",2206,365,8,4,83,2,95,5,2768
"55001950400",3584,496,10,13,120,64,114,15,4416
"55001950501",1331,243,10,4,19,0,39,13,1659
"55001950502",2346,330,0,2,67,4,29,0,2778
"55001950700",3135,283,7,5,65,45,31,53,3624
"55003940000",617,156,11,0,578,520,25,13,1920
"55003950300",1724,189,0,6,200,130,29,59,2337
"55003950400",1609,507,0,0,62,49,37,64,2328
"55003950500",1747,342,0,0,84,0,0,0,2173
"55003950600",1121,197,0,3,17,14,0,4,1356
"55003950700",1780,394,0,0,30,15,23,4,2246
"55003950800",2364,283,0,0,494,81,28,0,3250
"55003990000",0,0,0,0,0,0,0,0,0
"55005000100",3546,303,2,2,54,3,40,4,3954
"55005000200",3058,487,0,0,115,76,102,45,3883
"55005000300",3392,443,31,16,200,113,128,16,4339
"55005000400",4117,721,297,23,120,0,59,0,5337
"55005000500",3838,524,0,0,136,51,114,0,4663
"55005000600",4622,929,0,6,138,20,118,65,5898
"55005000800",4597,529,0,2,140,18,23,11,5320
"55005000900",4315,441,20,0,117,8,70,1,4972
"55005001001",1594,167,0,0,44,2,0,32,1839
"55005001002",4726,884,26,0,50,14,87,10,5797
"55007960100",1291,129,24,3,787,530,7,3,2774
"55007960200",1321,258,0,0,57,18,28,0,1682
"55007960300",2933,381,16,0,173,61,45,30,3639
"55007960400",4150,405,7,0,190,31,41,0,4824
"55007960600",1894,177,0,14,14,5,13,17,2134
"55007990000",0,0,0,0,0,0,0,0,0
"55009000100",1411,499,31,165,234,199,75,74,2688
"55009000200",4804,688,64,152,505,269,344,44,6870
"55009000302",3405,428,0,55,486,107,158,191,4830
"55009000303",1482,373,94,171,385,61,109,17,2692
"55009000401",3143,467,385,18,493,149,113,76,4844
"55009000402",1922,166,0,0,136,0,8,0,2232
"55009000500",1850,717,21,229,440,7,176,109,3549
"55009000600",3479,212,141,45,341,10,337,10,4575
"55009000700",3762,359,102,65,416,197,98,120,5119
"55009000800",1239,369,76,79,175,85,641,61,2725
"55009000900",2448,643,29,32,478,282,1279,324,5515
"55009001000",534,355,59,12,83,51,28,14,1136
"55009001100",1121,552,0,0,146,89,461,388,2757
"55009001200",1158,415,55,73,277,67,384,90,2519
"55009001300",1803,567,34,92,213,111,300,293,3413
"55009001400",2907,338,0,2,428,257,951,103,4986
"55009001600",3169,896,75,265,666,515,919,495,7000
"55009001701",1480,711,9,95,577,158,453,253,3736
"55009001702",2134,627,113,13,579,185,795,160,4606
"55009001801",3522,385,49,0,488,44,502,45,5035
"55009001802",3501,353,6,0,291,39,23,10,4223
"55009002001",6313,903,0,117,598,89,393,458,8871
"55009002002",4281,522,49,55,253,235,168,295,5858
"55009002003",2908,251,0,278,138,0,23,0,3598
"55009010100",5156,299,152,0,223,16,374,7,6227
"55009010201",2369,305,0,0,242,33,169,6,3124
"55009010202",4261,266,115,65,169,19,13,47,4955
"55009010300",5966,323,233,31,195,146,339,0,7233
"55009020100",5062,290,0,0,114,4,23,11,5504
"55009020203",6217,38,15,1,159,14,16,12,6472
"55009020204",4865,118,0,0,14,0,13,0,5010
"55009020502",4025,451,65,15,557,117,272,132,5634
"55009020503",7468,297,0,0,257,2,656,0,8680
"55009020504",4210,364,25,0,55,0,46,0,4700
"55009020600",4700,424,7,0,74,88,131,0,5424
"55009020702",5193,496,114,0,352,126,46,49,6376
"55009020703",6137,248,0,0,310,79,63,44,6881
"55009020704",5602,1382,46,0,862,48,719,584,9243
"55009020800",1946,202,33,0,143,0,147,0,2471
"55009020900",2232,63,13,0,205,51,0,0,2564
"55009021000",2196,209,108,0,100,0,84,25,2722
"55009021100",0,0,0,0,0,0,0,0,0
"55009021200",4476,201,32,20,356,8,329,0,5422
"55009021301",2853,87,62,0,287,6,147,0,3442
"55009021302",5639,195,0,0,229,237,72,0,6372
"55009021303",2509,627,20,19,287,143,99,0,3704
"55009021304",1691,113,70,0,185,56,9,0,2124
"55009021400",6453,317,3,1,212,70,451,75,7582
"55009021500",2805,153,10,5,88,6,107,15,3189
"55009021600",5432,450,0,0,57,0,55,0,5994
"55009940001",13062,416,0,0,1508,184,109,0,15279
"55009940002",4017,264,48,0,506,36,220,0,5091
"55009940003",2559,160,51,41,578,199,45,42,3675
"55009940004",1957,103,0,43,351,149,48,20,2671
"55011960100",2390,330,0,0,29,0,17,0,2766
"55011960200",2268,447,0,0,22,49,8,0,2794
"55011960300",1771,222,0,0,45,34,50,34,2156
"55011960400",2140,240,0,0,61,0,83,2,2526
"55011960500",2917,251,2,0,29,17,21,17,3254
"55013970400",3394,367,19,7,121,120,42,11,4081
"55013970600",1355,136,0,21,315,90,20,4,1941
"55013970700",1980,279,0,0,160,42,16,0,2477
"55013970800",1545,517,0,6,25,69,7,1,2170
"55013970900",2065,562,0,5,118,75,66,2,2893
"55013971000",1501,281,2,9,28,10,19,0,1850
"55015020100",4482,103,0,0,53,0,185,0,4823
"55015020200",3415,245,15,11,74,6,108,6,3880
"55015020303",3086,216,0,5,435,0,145,0,3887
"55015020304",3140,296,0,32,287,12,257,0,4024
"55015020306",5733,73,0,0,536,0,221,0,6563
"55015020308",3110,125,0,0,18,0,231,27,3511
"55015020400",3217,158,0,0,60,34,17,6,3492
"55015020500",4404,624,0,4,10,0,9,0,5051
"55015020600",4366,558,27,0,116,46,19,0,5132
"55015020700",3823,96,0,0,155,12,52,12,4150
"55015020800",5185,229,35,0,101,231,75,378,6234
"55017010100",2462,242,0,0,198,119,0,0,3021
"55017010200",5183,664,105,0,336,25,25,0,6338
"55017010300",4616,1034,42,1,67,0,91,0,5851
"55017010400",4203,286,0,1,182,0,94,6,4772
"55017010500",3684,822,0,0,124,86,35,44,4795
"55017010700",7216,343,42,0,46,0,14,12,7673
"55017010800",4646,865,14,0,132,4,7,0,5668
"55017010900",4283,788,76,0,44,33,91,9,5324
"55017011000",6078,509,69,0,152,15,70,0,6893
"55017011100",3655,452,0,0,42,12,11,31,4203
"55017011200",5955,388,0,0,42,45,157,0,6587
"55019950100",4016,449,0,0,104,27,515,120,5231
"55019950200",3471,619,16,3,110,18,166,75,4478
"55019950300",3638,586,21,0,100,11,69,5,4430
"55019950400",3138,731,0,2,12,9,35,11,3938
"55019950500",4449,803,5,0,28,6,58,24,5373
"55019950600",3922,888,17,20,74,5,106,0,5032
"55019950700",2879,470,22,5,146,11,57,0,3590
"55019950800",2724,379,3,2,66,16,60,5,3255
"55021970100",3521,429,14,2,110,10,89,39,4214
"55021970200",5217,505,11,0,177,4,118,0,6032
"55021970300",3293,307,20,0,158,18,189,18,4003
"55021970400",4419,1126,0,75,135,73,43,73,5944
"55021970500",3510,601,65,0,124,20,204,130,4654
"55021970600",4404,168,0,3,65,0,60,0,4700
"55021970700",3555,199,0,25,129,8,18,22,3956
"55021970800",5163,159,27,0,117,26,130,26,5648
"55021970900",4277,170,0,0,113,0,44,0,4604
"55021971000",3523,293,2,7,57,29,25,14,3950
"55021971100",2949,321,18,5,100,0,52,18,3463
"55021971200",4507,533,26,0,26,0,94,0,5186
"55023960100",2166,453,15,7,56,4,13,15,2729
"55023960200",2110,309,0,0,10,8,10,5,2452
"55023960300",2185,224,0,1,18,1,21,0,2450
"55023960400",2747,362,6,1,26,8,36,0,3186
"55023960500",1851,99,0,0,0,0,37,0,1987
"55023960600",2560,511,18,0,31,0,0,0,3120
"55025000100",1999,136,40,0,210,15,56,9,2465
"55025000201",1796,117,0,0,215,27,24,0,2179
"55025000202",2530,154,78,0,312,88,68,0,3230
"55025000204",3093,58,157,625,1127,210,87,0,5357
"55025000205",4215,300,81,19,410,26,35,0,5086
"55025000300",3286,255,89,15,1222,223,222,12,5324
"55025000401",2916,141,37,11,252,0,100,0,3457
"55025000402",2131,60,29,26,117,53,106,36,2558
"55025000405",4778,445,357,22,826,62,582,297,7369
"55025000406",2252,208,123,1,387,43,184,0,3198
"55025000407",3236,209,997,439,525,199,371,0,5976
"55025000408",1357,124,24,1,72,0,9,0,1587
"55025000501",3132,273,706,93,138,25,181,138,4686
"55025000503",4899,514,293,279,895,396,1097,325,8698
"55025000504",4861,313,305,140,798,400,213,64,7094
"55025000600",2256,189,296,1196,1228,558,2042,556,8321
"55025000700",2790,68,133,0,111,37,55,0,3194
"55025000800",2978,343,39,38,244,68,90,12,3812
"55025000901",1964,48,37,0,81,0,24,0,2154
"55025000902",2885,2407,58,6,158,326,91,41,5972
"55025001000",1784,45,12,0,32,5,54,13,1945
"55025001101",687,3151,58,74,70,425,13,98,4576
"55025001102",38,232,39,20,26,119,45,43,562
"55025001200",3172,2187,98,118,359,334,319,108,6695
"55025001300",1738,240,140,49,218,35,159,0,2579
"55025001401",1729,862,795,468,1324,782,1108,540,7608
"55025001402",3171,659,549,477,435,47,1018,198,6554
"55025001403",4419,373,443,421,1762,242,1451,243,9354
"55025001501",1391,364,155,78,117,45,87,208,2445
"55025001502",2814,1053,309,287,1028,136,720,631,6978
"55025001603",244,2042,0,47,139,537,59,45,3113
"55025001604",866,2155,0,107,176,669,119,74,4166
"55025001605",1339,1391,15,85,159,195,42,0,3226
"55025001606",602,1894,0,46,37,104,150,133,2966
"55025001704",1620,406,48,18,203,101,62,23,2481
"55025001705",2388,952,71,20,268,249,130,39,4117
"55025001802",2261,493,43,44,37,24,54,31,2987
"55025001804",2327,472,211,42,241,114,235,71,3713
"55025001900",5040,705,47,22,227,91,191,149,6472
"55025002000",4428,345,253,343,192,63,161,2,5787
"55025002100",3168,789,213,204,281,201,223,38,5117
"55025002200",2650,453,337,255,199,53,107,39,4093
"55025002301",1867,427,367,222,61,189,266,323,3722
"55025002302",1006,139,62,42,82,10,15,18,1374
"55025002401",2883,64,266,0,181,0,128,0,3522
"55025002402",1850,280,175,374,123,428,107,13,3350
"55025002500",831,242,71,164,92,174,90,104,1768
"55025002601",1114,230,209,53,191,55,69,149,2070
"55025002602",4108,303,365,140,608,77,385,50,6036
"55025002603",3008,200,507,231,1278,16,491,42,5773
"55025002700",2931,250,29,7,69,17,142,0,3445
"55025002800",1833,106,24,23,123,20,115,43,2287
"55025002900",2518,174,242,59,200,19,320,0,3532
"55025003001",4265,323,183,31,198,95,407,334,5836
"55025003002",1888,320,462,112,252,146,296,105,3581
"55025003100",5330,193,308,138,210,0,134,14,6327
"55025003200",913,233,32,18,1302,187,199,27,2911
"55025010100",1479,49,24,1,103,0,60,0,1716
"55025010200",1367,24,5,0,15,0,11,4,1426
"55025010300",3192,284,16,1,73,43,235,208,4052
"55025010400",2758,208,137,20,60,30,58,0,3271
"55025010501",2259,46,27,316,279,138,48,0,3113
"55025010502",7043,270,13,0,425,18,95,0,7864
"55025010600",4759,216,37,0,99,0,275,0,5386
"55025010701",4960,73,100,0,469,71,210,55,5938
"55025010702",5053,113,188,0,373,0,334,11,6072
"55025010800",9501,189,109,452,616,84,125,84,11160
"55025010901",4635,109,130,0,762,213,139,150,6138
"55025010903",2256,174,201,0,297,0,143,0,3071
"55025010904",7687,161,37,0,509,12,378,0,8784
"55025011000",3199,139,239,9,515,44,232,0,4377
"55025011101",3685,331,87,293,327,35,255,196,5209
"55025011102",7070,385,84,0,617,0,376,0,8532
"55025011200",8256,244,69,0,512,1,125,1,9208
"55025011301",5653,205,32,2,284,0,207,75,6458
"55025011302",2609,80,31,8,87,0,106,0,2921
"55025011401",6029,271,257,0,340,8,374,0,7279
"55025011402",7355,347,258,0,832,57,263,11,9123
"55025011503",7208,264,223,69,759,14,127,14,8678
"55025011504",3180,215,96,45,151,79,53,10,3829
"55025011505",2869,565,315,61,155,96,135,31,4227
"55025011506",3860,230,319,13,244,201,88,96,5051
"55025011600",5942,261,20,0,373,19,265,22,6902
"55025011700",3292,342,33,22,189,36,54,36,4004
"55025011800",5070,503,3,236,188,3,253,275,6531
"55025011900",5862,376,96,0,137,45,69,47,6632
"55025012001",7583,310,68,0,395,57,251,0,8664
"55025012002",4844,55,0,0,110,14,10,7,5040
"55025012100",2311,156,0,0,61,4,45,4,2581
"55025012201",1873,85,0,4,23,0,0,0,1985
"55025012202",5742,448,1,1,209,275,0,0,6676
"55025012300",4574,435,72,173,92,10,298,0,5654
"55025012400",4598,256,0,0,52,0,50,0,4956
"55025012501",5825,494,38,11,136,45,20,53,6622
"55025012502",3877,22,0,0,318,0,71,0,4288
"55025012600",4170,182,15,0,95,0,19,19,4500
"55025012700",3610,230,13,0,82,12,29,0,3976
"55025012800",6972,372,42,60,103,4,21,50,7624
"55025012900",3632,71,11,0,68,0,23,3,3808
"55025013000",4075,128,0,11,58,0,46,0,4318
"55025013100",4055,285,4,12,125,17,84,52,4634
"55025013200",8237,295,32,0,190,105,519,35,9413
"55025013301",4174,141,0,0,389,0,64,0,4768
"55025013302",5262,31,13,0,162,0,84,0,5552
"55025013700",4470,248,121,9,177,12,0,0,5037
"55025991702",0,0,0,0,0,0,0,0,0
"55025991703",0,0,0,0,0,0,0,0,0
"55027960100",5187,437,79,0,110,0,242,27,6082
"55027960200",2811,245,5,0,45,0,82,12,3200
"55027960300",4810,652,0,6,12,0,178,0,5658
"55027960400",4209,200,0,0,95,0,124,0,4628
"55027960500",2124,232,21,15,66,26,48,10,2542
"55027960600",3457,279,0,1,52,2,66,0,3857
"55027960700",3772,481,274,63,23,0,405,160,5178
"55027960800",3193,144,0,0,101,85,248,12,3783
"55027960900",3427,484,0,2,71,19,92,115,4210
"55027961000",3503,633,0,15,38,34,250,16,4489
"55027961100",3381,416,0,0,104,74,209,58,4242
"55027961200",3062,207,61,0,86,17,75,0,3508
"55027961300",4587,435,20,0,123,0,74,29,5268
"55027961400",3546,313,0,0,38,7,34,23,3961
"55027961500",4757,418,48,0,53,0,65,0,5341
"55027961600",3906,511,0,0,76,78,94,43,4708
"55027961700",2668,123,8,0,64,13,42,7,2925
"55027961800",3954,346,4,0,50,11,71,7,4443
"55027961900",5408,174,23,5,110,3,134,0,5857
"55027962000",1899,217,22,8,93,17,162,0,2418
"55029100100",1883,210,3,10,14,53,5,0,2178
"55029100300",2078,132,0,1,31,28,49,34,2353
"55029100400",2585,248,11,0,77,53,181,95,3250
"55029100500",2972,177,3,7,24,0,20,0,3203
"55029100600",2841,302,19,2,79,26,86,2,3357
"55029100700",3603,449,16,13,96,95,0,85,4357
"55029100800",4650,501,0,0,121,36,51,16,5375
"55029100900",1496,225,0,0,26,0,22,0,1769
"55029101000",1870,187,3,1,52,0,56,0,2169
"55029990000",0,0,0,0,0,0,0,0,0
"55031020300",1697,928,0,38,111,53,23,71,2921
"55031020400",2721,166,65,4,205,55,0,0,3216
"55031020500",1763,360,79,12,30,22,4,0,2270
"55031020600",3026,1089,19,0,285,54,41,0,4514
"55031020700",3584,336,42,0,98,18,57,0,4135
"55031020800",2466,483,0,22,139,14,0,0,3124
"55031020900",1912,252,43,0,29,10,0,10,2256
"55031021000",1368,282,47,0,147,24,23,0,1891
"55031021100",1305,676,36,9,96,54,28,0,2204
"55031030100",5336,530,8,3,221,68,46,0,6212
"55031030200",4228,414,12,0,276,25,97,5,5057
"55031030300",4432,372,14,0,219,22,54,25,5138
"55031990000",0,0,0,0,0,0,0,0,0
"55033970100",3301,362,2,0,98,18,70,42,3893
"55033970200",4136,512,0,0,30,24,7,10,4719
"55033970300",5104,671,10,0,82,51,66,19,6003
"55033970400",5453,423,15,4,157,21,115,20,6208
"55033970500",4543,677,79,28,253,15,73,0,5668
"55033970600",3656,379,0,0,55,104,48,0,4242
"55033970700",3721,1655,0,0,491,97,0,145,6109
"55033970800",2695,1226,8,47,188,39,0,0,4203
"55035000100",3564,1058,6,8,270,34,183,38,5161
"55035000200",4113,351,8,0,67,39,6,4,4588
"55035000301",3151,305,0,0,77,10,0,0,3543
"55035000302",5725,555,0,0,415,0,172,0,6867
"55035000400",6529,402,0,0,399,53,28,0,7411
"55035000501",4123,508,23,0,199,100,0,0,4953
"55035000502",4044,237,50,0,315,0,19,0,4665
"55035000600",3234,1051,20,0,211,249,32,40,4837
"55035000700",4606,631,12,2,120,91,625,13,6100
"55035000801",3216,84,12,0,200,0,0,0,3512
"55035000802",3300,352,14,13,137,27,0,20,3863
"55035000803",4319,665,49,0,465,53,81,0,5632
"55035000900",3605,871,0,0,324,181,127,0,5108
"55035001101",771,852,0,33,16,33,10,50,1765
"55035001200",1683,2857,0,37,46,117,0,206,4946
"55035001300",4066,519,33,246,248,109,37,0,5258
"55035001400",5892,696,0,0,443,131,49,52,7263
"55035001500",3014,280,74,2,172,34,24,0,3600
"55035001600",5106,175,4,0,206,59,75,0,5625
"55035001700",1410,789,14,1,61,28,12,9,2324
"55037190100",2305,340,0,0,83,104,19,0,2851
"55037190200",1378,190,0,0,22,0,15,0,1605
"55039040100",3673,207,0,0,79,99,55,99,4212
"55039040200",2177,407,47,0,115,10,32,15,2803
"55039040300",3468,1052,124,34,888,541,617,534,7258
"55039040400",2605,250,0,16,68,30,17,11,2997
"55039040500",2121,874,67,120,168,113,248,62,3773
"55039040700",3559,278,13,0,62,56,161,0,4129
"55039040800",4073,522,14,1,153,13,296,21,5093
"55039040900",2791,315,41,0,66,0,137,10,3360
"55039041000",2383,392,0,33,111,0,123,11,3053
"55039041100",7803,511,102,0,359,108,200,0,9083
"55039041300",5603,375,0,0,437,104,401,145,7065
"55039041400",5514,143,19,0,57,47,18,60,5858
"55039041500",2757,207,0,0,45,0,245,0,3254
"55039041600",4636,455,48,22,146,92,108,46,5553
"55039041700",3632,211,21,3,87,8,181,15,4158
"55039041800",4458,274,0,0,54,0,72,0,4858
"55039041900",6375,491,18,1,95,25,158,37,7200
"55039042000",7315,294,0,32,399,0,95,33,8168
"55039042100",4271,237,0,0,76,7,31,0,4622
"55039042200",5416,601,3,4,140,13,62,9,6248
"55041950100",1040,182,0,8,39,0,0,8,1277
"55041950200",1826,262,4,34,193,165,20,0,2504
"55041950300",1810,263,6,9,482,81,61,44,2756
"55041950400",1760,288,0,0,358,192,15,3,2616
"55043960100",3114,462,6,2,42,2,45,7,3680
"55043960200",3121,582,7,1,52,17,13,3,3796
"55043960300",3438,525,0,0,14,0,20,22,4019
"55043960400",3050,594,2,0,8,33,63,40,3790
"55043960500",3202,610,0,0,46,4,11,0,3873
"55043960600",3180,485,15,2,50,54,10,25,3821
"55043960700",3634,230,7,16,0,21,8,37,3953
"55043960800",2577,381,0,0,33,11,11,7,3020
"55043960900",2417,1522,44,81,68,5,69,10,4216
"55043961000",3381,1338,47,0,203,17,91,33,5110
"55043961100",3837,345,0,6,34,11,35,0,4268
"55043961200",3584,430,6,0,27,6,8,11,4072
"55045960100",5926,267,26,2,132,8,127,3,6491
"55045960200",5182,282,6,9,75,0,77,41,5672
"55045960300",4128,423,5,6,158,15,47,10,4792
"55045960400",3258,1043,0,0,99,0,0,100,4500
"55045960500",3269,482,12,10,18,59,257,122,4229
"55045960600",2825,366,0,0,24,0,77,0,3292
"55045960700",3716,213,18,4,27,38,37,61,4114
"55045960800",3747,524,0,0,73,19,56,0,4419
"55047100100",2745,552,0,0,192,0,220,236,3945
"55047100200",2372,192,0,0,143,0,61,16,2784
"55047100300",2662,297,0,6,49,10,43,10,3077
"55047100400",2331,164,23,0,57,1,45,0,2621
"55047100500",2545,467,22,0,19,8,11,0,3072
"55047100600",3446,425,2,3,22,41,101,53,4093
"55049950100",3383,229,5,0,65,3,8,4,3697
"55049950200",2515,395,6,4,78,25,25,0,3048
"55049950300",2756,310,0,0,97,0,53,0,3216
"55049950400",4636,448,13,26,97,0,59,0,5279
"55049950500",4191,407,18,8,42,4,135,6,4811
"55049950600",3243,436,3,0,22,0,24,20,3748
"55051180100",1835,400,0,4,40,20,13,11,2323
"55051180200",1245,174,0,0,36,3,4,0,1462
"55051180300",1677,350,0,0,22,0,0,0,2049
"55051990000",0,0,0,0,0,0,0,0,0
"55053960100",1874,261,4,2,408,182,24,63,2818
"55053960200",2630,445,4,0,146,20,68,22,3335
"55053960300",3474,676,3,0,27,164,54,69,4467
"55053960400",3289,611,1,0,165,50,58,21,4195
"55053960500",3506,702,0,56,318,59,23,46,4710
"55055100100",4457,961,31,0,178,73,128,58,5886
"55055100200",2650,479,19,5,129,16,267,68,3633
"55055100300",5007,633,47,16,192,193,336,200,6624
"55055100400",5216,378,0,0,86,0,261,94,6035
"55055100500",5545,703,0,11,159,21,205,37,6681
"55055100601",1376,35,10,0,14,0,5,0,1440
"55055100602",2838,413,0,1,60,0,7,7,3326
"55055100700",3885,541,26,6,106,41,173,57,4835
"55055100800",3829,228,9,5,38,32,40,46,4227
"55055100900",3485,180,0,0,51,23,63,4,3806
"55055101000",3088,333,0,0,270,38,427,105,4261
"55055101100",3567,417,67,0,149,10,447,123,4780
"55055101201",2138,82,23,0,25,0,10,0,2278
"55055101202",1592,65,0,0,29,0,49,0,1735
"55055101300",5194,248,0,0,318,79,242,32,6113
"55055101400",2451,647,0,11,130,72,114,228,3653
"55055101500",2841,727,7,0,223,44,190,270,4302
"55055101600",4209,863,47,0,300,44,790,137,6390
"55055101701",1406,75,0,0,17,0,40,0,1538
"55055101702",4194,313,41,27,71,0,170,0,4816
"55057100100",2360,361,13,0,93,0,154,0,2981
"55057100200",3219,316,18,11,143,57,11,2,3777
"55057100300",2490,538,27,0,21,11,54,0,3141
"55057100400",3758,648,20,15,127,30,87,53,4738
"55057100500",3366,560,21,41,83,24,106,17,4218
"55057100600",2876,349,19,30,32,36,46,26,3414
"55057100700",3282,423,19,2,186,38,81,12,4043
"55059000100",4404,919,301,106,504,25,569,216,7044
"55059000300",2280,699,176,77,102,169,342,352,4197
"55059000400",2937,436,41,67,7,56,165,117,3826
"55059000500",4249,621,147,3,77,67,411,100,5675
"55059000601",4328,243,197,89,138,0,300,38,5333
"55059000602",5166,868,598,39,383,0,304,189,7547
"55059000700",3318,522,439,640,434,72,1148,408,6981
"55059000800",1702,452,722,100,33,172,667,522,4370
"55059000900",2032,944,241,161,111,65,724,397,4675
"55059001000",1214,334,92,171,154,8,190,71,2234
"55059001100",1022,883,644,503,172,35,657,253,4169
"55059001200",3119,406,167,137,144,42,575,91,4681
"55059001300",2359,384,277,684,356,159,742,213,5174
"55059001400",5514,915,120,2,303,24,417,79,7374
"55059001500",2780,426,26,276,142,45,287,106,4088
"55059001600",1691,714,266,73,216,289,763,510,4522
"55059001700",1791,176,169,235,144,45,415,33,3008
"55059001800",1527,349,200,108,35,52,317,155,2743
"55059001900",2014,83,85,65,276,0,142,0,2665
"55059002000",5057,218,0,0,402,22,276,30,6005
"55059002100",3127,1399,156,237,281,180,792,1023,7195
"55059002200",3202,120,52,17,115,1,285,19,3811
"55059002300",4816,636,9,147,138,20,224,20,6010
"55059002400",3978,272,152,0,446,0,395,65,5308
"55059002500",3207,119,80,98,27,15,33,57,3636
"55059002601",6846,494,872,0,1236,0,868,172,10488
"55059002602",7008,329,642,0,283,78,590,112,9042
"55059002700",5177,188,59,0,189,1,410,1,6025
"55059002800",5912,526,0,0,89,71,178,47,6823
"55059002903",2614,283,0,24,39,41,80,0,3081
"55059002904",4950,692,0,0,0,52,317,123,6134
"55059002905",3222,232,0,3,109,0,113,0,3679
"55059002906",4538,120,37,0,132,0,114,0,4941
"55059003001",3773,586,0,1,25,0,39,0,4424
"55059003002",4398,289,5,0,106,15,157,15,4985
"55059990000",0,0,0,0,0,0,0,0,0
"55061960100",2579,396,0,44,0,7,0,18,3044
"55061960200",2394,213,0,8,5,8,37,0,2665
"55061960400",7818,539,20,0,219,57,267,66,8986
"55061960500",5224,605,0,0,135,41,34,41,6080
"55061990000",0,0,0,0,0,0,0,0,0
"55063000100",3780,189,0,0,536,128,156,84,4873
"55063000200",2858,1256,143,57,652,33,51,0,5050
"55063000300",1391,420,97,122,26,33,31,15,2135
"55063000400",1593,2972,80,44,172,44,20,44,4969
"55063000500",596,1352,0,0,39,102,0,3,2092
"55063000600",1621,241,0,12,143,73,7,13,2110
"55063000700",4000,208,22,9,155,43,0,0,4437
"55063000800",2223,755,0,0,162,42,81,43,3306
"55063000900",2151,672,210,52,433,99,58,35,3710
"55063001000",2636,562,49,56,206,26,0,0,3535
"55063001101",1915,287,0,0,22,0,18,0,2242
"55063001102",3147,398,0,1,72,253,57,105,4033
"55063001200",3530,263,87,57,146,65,11,0,4159
"55063010101",4823,527,13,0,33,18,17,9,5440
"55063010102",4012,299,7,0,112,0,86,0,4516
"55063010201",8451,596,0,1,657,86,73,0,9864
"55063010202",5998,484,9,0,519,0,59,159,7228
"55063010203",1489,110,5,6,42,4,6,0,1662
"55063010300",3915,546,0,0,93,5,0,0,4559
"55063010401",4786,209,32,0,321,0,21,0,5369
"55063010402",7426,322,86,70,850,260,161,11,9186
"55063010500",4562,368,215,0,525,51,64,0,5785
"55063010600",3067,141,23,3,52,7,47,0,3340
"55063010700",4836,175,0,33,32,0,0,0,5076
"55063010800",2859,211,0,0,50,0,79,16,3215
"55065970100",2778,275,11,1,2,6,26,0,3099
"55065970200",3243,634,4,1,90,0,278,60,4310
"55065970300",2887,256,3,18,140,3,90,32,3429
"55065970400",2644,422,0,0,51,0,31,34,3182
"55065970500",2826,334,1,2,31,0,6,0,3200
"55067960100",2456,259,0,1,39,32,0,7,2794
"55067960300",2310,228,0,0,75,85,1,73,2772
"55067960400",3437,216,22,0,114,5,9,22,3825
"55067960500",1549,198,0,4,6,19,4,9,1789
"55067960600",3413,908,38,44,61,133,8,113,4718
"55067960700",3007,686,0,0,129,0,93,4,3919
"55069960100",2038,120,0,1,26,0,4,12,2201
"55069960200",1780,520,0,0,44,12,16,0,2372
"55069960300",1552,192,0,1,20,0,26,0,1791
"55069960400",1641,149,1,0,27,0,18,0,1836
"55069960500",1795,147,0,0,49,0,6,27,2024
"55069960600",4033,299,11,1,55,0,19,0,4418
"55069960700",3668,158,0,3,5,0,5,3,3842
"55069960800",2816,471,0,0,96,32,88,6,3509
"55069960900",2314,317,0,0,148,6,67,0,2852
"55069961000",2692,617,0,25,30,17,19,14,3414
"55071000100",4042,817,0,0,100,1,171,1,5132
"55071000200",2239,64,0,0,61,67,100,0,2531
"55071000300",5118,163,0,0,256,0,64,4,5605
"55071000400",3236,402,86,0,300,76,134,130,4364
"55071000500",2211,238,18,21,164,111,286,9,3058
"55071000600",3976,489,0,0,564,13,65,26,5133
"55071000700",4368,652,0,0,508,267,379,133,6307
"55071000800",3044,560,0,0,184,249,214,9,4260
"55071005100",1937,178,0,53,141,79,0,0,2388
"55071005200",3816,350,32,0,39,2,39,0,4278
"55071005300",1567,267,0,121,122,7,0,47,2131
"55071005400",2798,352,0,0,44,75,69,63,3401
"55071010100",4216,175,20,0,65,0,13,0,4489
"55071010200",5264,332,6,0,76,0,16,98,5792
"55071010300",4060,308,0,0,62,4,101,7,4542
"55071010400",5532,457,0,0,104,4,156,12,6265
"55071010500",3083,297,0,0,56,6,0,0,3442
"55071010600",4761,280,37,0,108,0,159,6,5351
"55071010700",3685,221,1,0,97,0,79,0,4083
"55071990000",0,0,0,0,0,0,0,0,0
"55073000100",963,861,18,42,691,128,84,130,2917
"55073000200",1800,404,0,0,316,323,0,38,2881
"55073000300",4087,476,0,2,78,60,0,0,4703
"55073000400",4327,767,121,0,580,66,221,103,6185
"55073000500",1667,293,0,90,470,518,0,210,3248
"55073000601",1380,115,0,0,300,58,0,16,1869
"55073000602",2203,673,0,0,723,384,103,88,4174
"55073000700",3644,805,0,26,751,474,52,0,5752
"55073000800",2691,189,82,2,109,149,38,0,3260
"55073000900",1974,111,0,0,143,128,55,0,2411
"55073001000",2915,182,0,0,137,0,14,0,3248
"55073001102",7418,301,4,3,222,286,225,4,8463
"55073001103",4051,355,9,0,497,197,24,0,5133
"55073001104",5113,438,17,0,84,61,248,0,5961
"55073001201",7357,541,19,0,295,0,14,0,8226
"55073001202",4745,393,0,6,101,24,14,23,5306
"55073001300",6292,215,38,0,308,0,66,0,6919
"55073001400",5721,723,71,0,415,0,34,304,7268
"55073001500",3765,154,1,0,78,0,14,0,4012
"55073001600",5582,239,4,0,165,8,87,8,6093
"55073001700",3368,285,0,0,29,28,35,0,3745
"55073001800",5036,219,15,0,51,37,143,13,5514
"55073001900",5316,555,0,0,88,32,67,20,6078
"55073002000",3591,310,28,4,64,0,58,0,4055
"55073002100",6070,479,30,1,202,7,67,0,6856
"55073002200",2918,298,2,4,70,18,206,61,3577
"55073002300",6475,862,14,0,122,73,165,49,7760
"55075960100",2418,391,0,0,38,28,35,0,2910
"55075960200",3448,528,0,0,49,32,9,4,4070
"55075960600",2028,318,1,0,62,27,0,0,2436
"55075960700",2424,511,0,0,32,0,0,6,2973
"55075960800",2053,288,0,0,61,3,7,0,2412
"55075960900",2425,206,16,0,6,0,30,52,2735
"55075961000",3704,347,2,0,56,7,100,12,4228
"55075961100",4352,606,0,0,112,7,9,31,5117
"55075961200",2420,157,0,0,52,0,10,0,2639
"55075961300",2310,631,8,0,141,14,86,0,3190
"55075961400",3389,607,0,9,75,68,34,20,4202
"55075961500",3294,487,0,42,117,33,42,50,4065
"55075990000",0,0,0,0,0,0,0,0,0
"55077960100",2317,215,11,14,85,6,16,0,2664
"55077960200",2089,413,4,2,27,0,8,0,2543
"55077960300",3034,560,4,0,64,23,51,4,3740
"55077960400",2209,259,4,0,99,14,98,32,2715
"55077960500",2983,549,0,0,110,6,117,65,3830
"55078940101",42,1,0,0,690,672,29,0,1434
"55078940102",437,59,0,2,1740,595,32,43,2908
"55079000101",1128,115,2280,1096,324,35,291,0,5269
"55079000102",919,151,1601,590,224,93,19,80,3677
"55079000201",1070,235,1193,1458,537,292,431,341,5557
"55079000202",2709,83,1685,1106,578,136,142,34,6473
"55079000301",956,49,218,2,114,0,0,0,1339
"55079000302",439,83,1608,773,122,59,83,62,3229
"55079000303",817,61,567,361,111,88,37,12,2054
"55079000304",1331,16,1001,137,432,144,47,0,3108
"55079000400",556,54,965,419,374,82,85,0,2535
"55079000501",1440,181,1033,403,324,148,110,81,3720
"55079000502",531,118,1709,918,151,31,6,11,3475
"55079000600",1306,161,2564,1014,1504,111,122,0,6782
"55079000700",1176,34,1552,255,260,13,67,13,3370
"55079000800",1174,104,2718,686,633,51,319,50,5735
"55079000900",744,50,1622,1090,169,75,145,30,3925
"55079001000",510,66,1761,864,453,52,161,27,3894
"55079001100",236,68,1877,467,6,14,0,0,2668
"55079001200",239,13,757,717,659,394,98,81,2958
"55079001300",313,3,1954,1017,605,0,52,82,4026
"55079001400",328,47,724,713,562,141,56,34,2605
"55079001500",513,25,1058,734,475,330,0,0,3135
"55079001600",518,0,1388,736,294,66,34,46,3082
"55079001700",1435,7,1965,840,92,2,118,0,4459
"55079001800",288,277,1140,1112,103,116,32,26,3094
"55079001900",549,116,924,1001,337,61,58,73,3119
"55079002000",317,80,1152,617,58,39,54,0,2317
"55079002100",134,20,1254,626,28,5,15,5,2087
"55079002200",529,64,483,372,134,0,72,0,1654
"55079002300",177,0,2692,1073,86,40,15,0,4083
"55079002400",25,8,968,529,0,226,0,10,1766
"55079002500",75,1,964,794,132,71,8,16,2061
"55079002600",214,35,1648,883,5,15,42,15,2857
"55079002700",87,30,1070,435,147,0,0,0,1769
"55079002800",155,19,1004,843,182,11,55,0,2269
"55079002900",129,19,980,751,101,21,111,21,2133
"55079003000",429,141,1907,792,601,169,94,24,4157
"55079003100",401,27,2262,517,409,87,35,27,3765
"55079003200",500,30,1423,428,415,102,114,74,3086
"55079003300",1093,141,2576,788,575,129,334,54,5690
"55079003400",1847,138,1905,1450,424,269,171,132,6336
"55079003500",574,60,2219,451,211,39,48,0,3602
"55079003600",184,64,1208,496,79,0,37,0,2068
"55079003700",178,19,1215,702,48,0,5,0,2167
"55079003800",195,10,1398,609,89,22,34,13,2370
"55079003900",50,0,1923,670,27,0,0,0,2670
"55079004000",95,2,1492,873,29,11,17,0,2519
"55079004100",115,25,1476,651,53,54,36,14,2424
"55079004200",146,5,1444,1633,27,0,133,0,3388
"55079004300",311,96,3147,1601,58,169,205,0,5587
"55079004400",920,185,1632,1052,51,78,169,139,4226
"55079004500",31,60,1409,1456,80,116,33,74,3259
"55079004600",49,1,1993,988,97,10,19,0,3157
"55079004700",46,0,2637,1177,26,7,65,0,3958
"55079004800",88,62,2060,1740,65,70,17,0,4102
"55079004900",1036,44,2071,668,263,23,90,9,4204
"55079005000",1264,116,2375,1237,232,92,116,62,5494
"55079005100",549,89,1603,955,97,2,32,55,3382
"55079005200",739,61,478,94,75,16,25,0,1488
"55079005300",1251,41,385,124,208,18,208,0,2235
"55079005400",2827,365,323,96,59,90,100,9,3869
"55079005500",2656,52,326,0,227,0,236,0,3497
"55079005600",1638,77,122,3,65,0,35,0,1940
"55079005700",1966,87,184,14,57,0,47,0,2355
"55079005800",2095,149,812,358,114,0,200,0,3728
"55079005900",657,118,1894,465,373,43,246,39,3835
"55079006000",165,43,1089,1153,24,10,49,5,2538
"55079006100",292,23,1242,324,134,74,11,74,2174
"55079006200",38,13,1225,868,42,32,5,36,2259
"55079006300",8,28,1363,815,16,43,45,15,2333
"55079006400",0,0,1196,1472,44,209,0,0,2921
"55079006500",69,21,1002,1448,66,8,57,4,2675
"55079006600",75,232,990,2089,83,40,70,244,3823
"55079006700",23,15,773,660,5,21,11,44,1552
"55079006800",22,8,1387,1181,82,0,108,0,2788
"55079006900",119,117,870,1478,80,284,170,282,3400
"55079007000",229,38,1156,860,128,17,224,66,2718
"55079007100",1016,514,101,119,161,22,176,31,2140
"55079007200",1964,337,381,216,159,43,284,69,3453
"55079007300",1459,807,74,24,46,102,111,14,2637
"55079007400",983,446,83,27,0,0,4,22,1565
"55079007500",1648,486,13,0,169,0,160,0,2476
"55079007600",2125,698,93,98,108,137,120,28,3407
"55079007700",2058,1247,176,21,280,84,93,53,4012
"55079007800",1374,1878,65,52,128,96,21,123,3737
"55079007900",1068,335,126,40,168,61,38,23,1859
"55079008000",936,484,149,252,203,42,266,28,2360
"55079008100",220,60,356,467,45,73,50,108,1379
"55079008400",20,57,587,528,62,13,20,57,1344
"55079008500",0,13,460,882,84,42,84,12,1577
"55079008600",4,180,650,251,5,0,0,177,1267
"55079008700",9,0,739,604,0,36,0,63,1451
"55079008800",0,13,1033,918,84,0,28,11,2087
"55079008900",64,13,297,591,0,20,42,3,1030
"55079009000",61,27,1173,1460,36,67,10,9,2843
"55079009100",286,47,760,1082,166,19,9,19,2388
"55079009200",324,70,1016,510,134,24,58,4,2140
"55079009300",1261,52,593,361,159,0,124,0,2550
"55079009400",1682,56,372,192,310,12,255,12,2891
"55079009500",1386,75,239,232,207,26,56,5,2226
"55079009600",121,50,813,1148,99,128,58,85,2502
"55079009700",26,112,731,190,441,289,9,0,1798
"55079009800",19,0,484,765,100,111,6,0,1485
"55079009900",58,45,712,251,33,46,33,77,1255
"55079010600",380,349,181,346,52,27,77,315,1727
"55079010700",1306,362,88,145,169,158,193,59,2480
"55079010800",1368,468,109,91,97,46,38,5,2222
"55079011000",2156,585,206,59,167,39,59,0,3271
"55079011100",1224,244,36,6,127,18,76,36,1767
"55079011200",1616,494,136,92,62,50,209,25,2684
"55079011300",984,271,72,48,39,50,53,75,1592
"55079011400",797,69,193,69,35,0,6,0,1169
"55079012200",193,81,598,812,433,700,43,23,2883
"55079012300",169,8,340,300,158,29,28,4,1036
"55079012400",1349,115,705,168,397,80,134,0,2948
"55079012500",1919,127,52,3,44,14,48,0,2207
"55079012600",1720,313,60,69,246,39,255,9,2711
"55079012700",992,70,20,0,60,0,142,0,1284
"55079012800",1819,210,189,62,243,59,435,23,3040
"55079012900",2214,300,93,46,268,163,298,86,3468
"55079013000",1311,330,133,55,171,21,318,114,2453
"55079013300",396,113,203,78,276,84,111,0,1261
"55079013400",339,36,519,810,538,338,328,177,3085
"55079013500",304,248,452,716,96,67,107,109,2099
"55079013600",327,53,917,446,113,409,53,170,2488
"55079013700",137,63,517,412,178,401,164,31,1903
"55079014100",145,117,610,463,42,0,65,34,1476
"55079014300",1739,310,97,33,214,18,88,12,2511
"55079014400",1520,226,158,34,311,0,50,17,2316
"55079014600",200,759,128,479,132,121,27,22,1868
"55079014700",130,1044,143,1010,18,171,7,53,2576
"55079014800",419,274,333,526,98,149,23,27,1849
"55079014900",314,348,168,373,42,30,72,90,1437
"55079015700",803,689,83,136,494,513,1054,977,4749
"55079015800",824,613,276,273,734,542,1275,810,5347
"55079015900",1240,982,103,155,856,439,1433,766,5974
"55079016000",1344,1124,103,205,506,226,1171,1080,5759
"55079016100",1504,496,0,68,766,329,1559,721,5443
"55079016200",1241,460,12,287,915,362,1628,690,5595
"55079016300",995,878,143,535,1570,933,2291,1363,8708
"55079016400",1023,320,22,334,957,1405,1601,1687,7349
"55079016500",466,358,79,124,904,577,1174,863,4545
"55079016600",636,472,147,323,419,305,729,465,3496
"55079016700",693,261,240,123,1200,1107,1688,1237,6549
"55079016800",756,540,111,318,905,631,1335,910,5506
"55079016900",684,925,172,420,898,1028,1325,1639,7091
"55079017000",2321,967,127,139,1171,1114,2571,1658,10068
"55079017100",1440,412,133,117,779,124,1661,310,4976
"55079017200",1530,434,27,1,397,59,1422,459,4329
"55079017300",2082,1013,88,263,292,241,1571,1174,6724
"55079017400",1042,730,107,228,438,351,1138,1011,5045
"55079017500",1498,1058,90,280,371,471,1368,1109,6245
"55079017600",1204,677,153,222,682,347,1381,892,5558
"55079017900",2141,461,39,38,479,25,633,69,3885
"55079018000",2377,358,37,0,79,23,425,73,3372
"55079018100",1397,65,0,74,173,0,90,7,1806
"55079018200",1546,54,0,0,35,0,75,0,1710
"55079018300",1932,406,7,0,82,23,116,132,2698
"55079018400",1206,53,0,0,35,0,59,0,1353
"55079018500",1548,137,0,0,46,0,258,56,2045
"55079018600",1829,497,57,307,341,220,1619,610,5480
"55079018700",1544,686,19,166,297,366,1364,925,5367
"55079018800",894,738,4,240,303,134,959,949,4221
"55079018900",1063,413,21,21,187,17,551,375,2648
"55079019000",3795,625,343,0,149,20,744,324,6000
"55079019100",2297,485,202,10,352,35,742,30,4153
"55079019200",2598,86,102,66,264,172,598,82,3968
"55079019300",2382,72,86,0,195,10,322,0,3067
"55079019400",3365,163,68,59,137,35,561,40,4428
"55079019500",3108,346,20,0,98,29,231,66,3898
"55079019600",3124,229,215,48,74,0,177,33,3900
"55079019700",3975,472,65,91,443,287,373,384,6090
"55079019800",3799,555,117,4,258,134,270,381,5518
"55079019900",3305,169,84,80,227,77,807,125,4874
"55079020000",2059,402,193,255,399,172,911,171,4562
"55079020100",2104,569,310,73,232,86,1008,410,4792
"55079020200",1812,435,21,43,369,132,541,342,3695
"55079020300",2743,475,132,28,816,26,1212,382,5814
"55079020400",2590,448,88,52,258,53,1859,448,5796
"55079020500",2541,550,0,7,411,21,1877,288,5695
"55079020600",2865,334,43,0,233,0,618,29,4122
"55079020700",3611,295,0,15,333,43,313,41,4651
"55079020800",2317,315,72,2,235,45,264,0,3250
"55079020900",2219,203,83,0,63,89,324,75,3056
"55079021000",1924,273,11,30,148,6,343,6,2741
"55079021100",1319,33,5,0,55,0,310,27,1749
"55079021200",1413,364,31,0,77,10,106,103,2104
"55079021300",1165,147,81,70,115,49,252,104,1983
"55079021400",2203,588,64,33,369,319,768,316,4660
"55079021500",2096,220,10,1,287,32,207,201,3054
"55079021600",2516,807,171,246,473,114,624,253,5204
"55079021700",4865,416,443,3,446,232,1755,108,8268
"55079021800",1750,157,30,7,171,61,281,92,2549
"55079030100",3886,99,145,1,214,0,68,0,4413
"55079035100",2154,41,0,0,32,0,6,6,2239
"55079035200",3584,169,238,19,269,0,165,0,4444
"55079040100",1297,23,40,0,203,12,50,12,1637
"55079050101",3791,41,1430,62,666,78,370,0,6438
"55079050102",2871,391,1638,488,547,7,168,0,6110
"55079060101",2805,290,216,51,287,0,52,8,3709
"55079060102",2609,46,443,0,223,7,258,0,3586
"55079060200",3948,548,569,234,157,103,201,178,5938
"55079070100",4054,73,57,0,323,0,153,0,4660
"55079070200",4719,114,33,126,112,13,115,0,5232
"55079070300",3865,38,111,0,401,67,148,0,4630
"55079080100",1973,116,72,9,269,7,16,0,2462
"55079080200",2844,135,89,8,213,6,111,20,3426
"55079080300",3684,110,26,24,196,54,96,0,4190
"55079080400",2300,747,64,48,122,84,66,17,3448
"55079090100",3690,269,297,11,147,1,99,9,4523
"55079090200",1779,12,120,11,35,45,19,0,2021
"55079090300",2411,87,255,31,476,40,93,0,3393
"55079090600",4322,247,62,0,185,155,369,33,5373
"55079090700",3052,29,0,0,92,0,63,0,3236
"55079090800",2213,9,88,0,35,0,45,0,2390
"55079090900",2865,65,284,0,174,25,36,0,3449
"55079091000",3704,236,249,1,320,0,82,42,4634
"55079091100",3613,168,40,0,263,23,70,0,4177
"55079091200",3490,369,392,9,182,0,90,14,4546
"55079091300",3336,286,31,31,123,8,8,0,3823
"55079091400",2023,102,33,28,55,0,68,0,2309
"55079100100",1974,482,508,108,238,121,330,177,3938
"55079100200",2573,444,175,31,620,267,909,97,5116
"55079100300",1984,463,11,0,235,253,158,45,3149
"55079100400",1850,290,68,65,127,36,229,48,2713
"55079100500",2526,433,134,186,118,40,230,73,3740
"55079100600",1873,274,62,15,52,1,74,108,2459
"55079100700",2168,171,55,1,162,1,188,0,2746
"55079100800",2589,116,8,35,186,32,123,32,3121
"55079100900",2638,493,33,24,340,153,224,201,4106
"55079101000",3925,432,197,307,284,45,322,102,5614
"55079101100",1403,189,90,5,142,52,146,7,2034
"55079101200",2649,198,8,0,64,21,205,26,3171
"55079101300",2540,229,10,43,207,0,174,0,3203
"55079101400",2655,279,60,20,275,65,338,0,3692
"55079101500",3518,871,47,151,127,104,416,194,5428
"55079101600",3672,339,95,47,379,76,500,220,5328
"55079101700",2763,499,86,67,183,11,297,100,4006
"55079101800",2144,137,25,15,237,25,83,0,2666
"55079110100",2355,549,223,165,733,162,816,243,5246
"55079120101",3483,132,0,0,297,0,56,0,3968
"55079120102",3260,314,21,0,115,0,141,62,3913
"55079120201",3082,215,113,1,164,9,91,0,3675
"55079120202",2967,155,142,0,59,99,455,8,3885
"55079120203",3127,302,12,25,90,11,265,135,3967
"55079120300",1541,124,23,23,126,73,316,53,2279
"55079120400",5584,432,72,0,224,0,932,82,7326
"55079120501",3274,261,60,152,518,1,311,116,4693
"55079120502",3976,413,20,18,606,40,186,18,5277
"55079130100",4316,302,31,0,171,0,253,0,5073
"55079130200",2516,177,37,0,58,29,85,26,2928
"55079140100",2614,222,19,0,66,65,64,9,3059
"55079140201",4480,360,117,0,362,43,382,0,5744
"55079140202",4799,534,69,18,357,28,125,0,5930
"55079150100",6565,645,44,19,1303,96,404,115,9191
"55079150301",4998,255,28,0,527,0,166,0,5974
"55079150303",4442,218,0,0,297,0,98,0,5055
"55079150304",3035,394,142,0,278,59,51,36,3995
"55079160100",5482,752,55,19,154,119,399,233,7213
"55079160202",5820,467,108,0,414,222,444,90,7565
"55079160203",5008,298,217,0,539,17,388,80,6547
"55079160204",3924,297,69,17,499,13,508,8,5335
"55079160300",8704,257,180,0,704,2,631,108,10586
"55079170100",2363,231,0,0,97,29,162,7,2889
"55079170200",3160,370,21,11,177,19,260,135,4153
"55079170300",2159,366,41,0,64,25,125,67,2847
"55079170400",3089,91,27,0,105,0,82,0,3394
"55079170500",1763,295,37,0,17,23,130,0,2265
"55079170600",2366,577,21,81,271,66,470,46,3898
"55079170700",2717,50,5,43,112,12,174,12,3125
"55079180100",2659,168,24,90,126,49,227,6,3349
"55079180200",3070,956,23,33,520,89,529,59,5279
"55079180300",2209,563,196,23,314,28,693,158,4184
"55079180400",2098,346,0,0,151,11,62,0,2668
"55079180500",3781,295,72,0,248,57,362,218,5033
"55079185100",3450,469,98,14,199,172,407,44,4853
"55079185200",3911,461,179,0,340,29,385,49,5354
"55079185300",3063,101,20,17,153,0,54,0,3408
"55079185400",13,13,704,608,149,31,18,0,1536
"55079185500",31,14,877,1043,10,0,0,0,1975
"55079185600",340,13,856,747,48,0,0,0,2004
"55079185700",62,15,814,841,86,1,112,1,1932
"55079185800",49,10,916,412,104,60,28,0,1579
"55079185900",112,15,410,390,62,263,31,0,1283
"55079186000",120,45,462,690,12,1,0,0,1330
"55079186100",93,16,620,823,262,135,57,49,2055
"55079186200",60,22,581,399,84,46,98,38,1328
"55079186300",992,179,73,34,82,21,81,7,1469
"55079186400",139,246,37,9,19,20,0,4,474
"55079186500",651,278,29,23,199,255,275,414,2124
"55079186600",799,571,27,198,355,20,786,475,3231
"55079186800",208,100,101,339,223,203,291,193,1658
"55079186900",1594,103,162,0,255,0,105,13,2232
"55079187000",2150,477,58,135,449,46,96,0,3411
"55079187200",2932,130,8,0,276,0,113,9,3468
"55079187300",5711,269,37,0,655,0,709,47,7428
"55079187400",2068,107,125,41,51,5,29,0,2426
"55079980000",0,0,0,0,0,0,0,0,0
"55079990000",0,0,0,0,0,0,0,0,0
"55081950100",3939,320,33,2,348,111,53,44,4850
"55081950200",4098,371,24,0,52,33,63,0,4641
"55081950300",5136,582,103,0,160,143,407,235,6766
"55081950400",3438,740,8,8,51,0,123,14,4382
"55081950500",5008,637,160,2,175,4,178,0,6164
"55081950600",2954,846,71,30,97,57,31,0,4086
"55081950700",3778,905,3,5,87,13,12,0,4803
"55081950800",3202,904,0,4,201,81,261,130,4783
"55081950900",4376,560,10,0,153,2,65,30,5196
"55083100300",2510,216,0,0,27,38,2,0,2793
"55083100500",1856,258,20,3,26,21,15,7,2206
"55083100600",2006,340,0,0,157,71,22,0,2596
"55083100700",2521,284,0,0,122,66,62,77,3132
"55083100800",2109,214,0,0,43,40,10,27,2443
"55083100900",2358,357,18,0,114,79,29,4,2959
"55083101000",3305,309,0,7,52,5,44,29,3751
"55083101100",4394,330,0,0,67,8,60,0,4859
"55083101200",3302,480,0,0,100,36,68,0,3986
"55083101300",8076,582,24,5,87,26,105,0,8905
"55083990000",0,0,0,0,0,0,0,0,0
"55085970101",1308,95,0,0,108,18,23,0,1552
"55085970102",3291,220,1,0,73,20,16,0,3621
"55085970400",2547,268,0,0,20,0,0,0,2835
"55085970500",1646,101,0,3,12,6,12,3,1783
"55085970601",1825,94,0,0,29,0,38,0,1986
"55085970602",3112,304,0,0,88,12,12,0,3528
"55085970800",1704,243,0,6,60,54,8,11,2086
"55085970900",2039,171,4,0,0,8,7,2,2231
"55085971001",1144,79,0,0,17,5,42,5,1292
"55085971002",2131,212,12,0,142,0,28,0,2525
"55085971100",1934,84,0,1,56,0,27,0,2102
"55085971300",1466,219,0,0,132,1,17,0,1835
"55085971400",2948,511,0,60,58,0,36,61,3674
"55085971500",3414,923,0,26,29,0,0,19,4411
"55087010100",1342,521,25,33,109,37,5,4,2076
"55087010200",3223,357,0,0,297,98,377,16,4368
"55087010300",1345,331,5,96,287,102,52,0,2218
"55087010500",2493,451,0,57,241,38,71,0,3351
"55087010601",2737,421,87,0,474,111,124,0,3954
"55087010602",3348,148,0,1,613,0,64,0,4174
"55087010700",3449,245,166,22,418,48,438,82,4868
"55087010800",1479,66,17,0,0,3,5,3,1573
"55087010900",1754,49,32,0,99,132,46,80,2192
"55087011000",4138,652,7,1,370,375,489,169,6201
"55087011101",4018,490,22,0,515,59,297,89,5490
"55087011102",5607,852,37,16,776,102,645,216,8251
"55087011200",1864,219,0,83,475,177,252,14,3084
"55087011300",2490,264,18,89,57,13,118,13,3062
"55087011400",4236,459,0,0,108,100,0,180,5083
"55087011501",3017,68,28,2,184,31,25,0,3355
"55087011502",3072,438,0,42,611,162,65,54,4444
"55087011600",6292,249,46,16,220,6,168,11,7008
"55087011700",2510,195,59,35,16,0,10,12,2837
"55087011800",1452,99,6,0,0,23,4,0,1584
"55087011900",7082,597,0,1,213,100,88,58,8139
"55087012000",5903,127,109,0,244,0,124,0,6507
"55087012100",6803,432,0,13,137,53,104,59,7601
"55087012200",1488,353,0,0,128,5,71,12,2057
"55087012300",1263,206,0,11,13,0,20,0,1513
"55087012400",2428,195,51,0,49,26,177,26,2952
"55087012503",3391,195,0,0,100,0,17,0,3703
"55087012504",2929,107,0,21,135,0,10,0,3202
"55087012505",2914,95,28,0,380,99,66,0,3582
"55087012506",3480,106,28,0,556,0,54,0,4224
"55087012601",7860,385,358,0,185,11,33,148,8980
"55087012602",4273,45,0,0,139,0,15,0,4472
"55087012700",5625,518,0,0,91,14,219,72,6539
"55087012800",6605,407,35,0,150,22,162,6,7387
"55087012901",5705,285,0,0,57,0,76,9,6132
"55087012902",3351,62,0,0,0,0,7,0,3420
"55087013100",5004,515,0,0,258,8,157,0,5942
"55087013200",3312,370,0,0,83,64,122,102,4053
"55087013300",6508,225,18,0,208,0,26,40,7025
"55087940000",2113,326,1,0,1531,556,86,148,4761
"55089610101",3943,232,9,8,49,35,26,0,4302
"55089610102",3295,145,23,0,206,11,252,44,3976
"55089620100",5595,275,0,0,103,0,90,0,6063
"55089630100",2254,257,10,0,19,7,151,55,2753
"55089630201",4176,381,6,9,178,2,75,191,5018
"55089630202",4474,229,18,0,139,5,50,0,4915
"55089640100",4966,645,4,46,186,0,96,0,5943
"55089640200",7520,313,121,0,264,0,97,0,8315
"55089650101",6023,171,0,0,355,0,169,0,6718
"55089650102",2531,289,0,1,60,0,29,0,2910
"55089650200",4141,378,0,0,166,0,54,0,4739
"55089650300",4990,74,69,0,146,0,100,0,5379
"55089660100",2729,157,31,0,283,10,173,10,3393
"55089660201",3162,108,275,43,226,0,18,0,3832
"55089660202",3950,326,211,5,161,11,81,17,4762
"55089660301",5915,156,34,0,161,0,225,0,6491
"55089660303",4643,89,33,0,142,0,14,0,4921
"55089660304",3043,34,86,26,149,0,0,0,3338
"55089990000",0,0,0,0,0,0,0,0,0
"55091950100",3332,483,10,3,32,5,16,27,3908
"55091950200",2932,411,4,4,50,1,29,4,3435
"55093960100",2501,272,4,0,54,11,68,10,2920
"55093960200",5114,634,14,1,142,75,164,7,6151
"55093960300",2165,845,12,27,80,0,0,0,3129
"55093960400",3789,1205,26,30,157,147,0,0,5354
"55093960500",7273,287,14,0,120,59,55,59,7867
"55093960600",4678,232,29,0,47,13,46,0,5045
"55093960700",3945,520,0,22,26,30,11,28,4582
"55093960800",3236,305,1,0,44,23,84,47,3740
"55095960100",2917,501,0,0,77,39,41,0,3575
"55095960200",3083,350,6,8,80,0,66,2,3595
"55095960300",4507,610,0,0,219,158,7,26,5527
"55095960500",2377,326,10,6,64,10,77,8,2878
"55095960600",1643,176,0,0,24,12,9,2,1866
"55095960700",4751,580,4,9,133,20,65,11,5573
"55095960800",5970,506,11,2,142,17,110,22,6780
"55095960900",4699,503,0,0,54,7,32,5,5300
"55095961000",4181,354,49,1,111,63,42,52,4853
"55095961100",3449,380,3,17,29,27,61,23,3989
"55097960100",4024,318,0,0,25,12,52,6,4437
"55097960200",4218,285,0,0,68,0,49,51,4671
"55097960300",2295,1196,59,0,278,179,49,6,4062
"55097960400",2435,1595,0,3,127,165,48,46,4419
"55097960500",6313,177,0,0,317,20,205,20,7052
"55097960600",4762,416,22,8,97,6,71,19,5401
"55097960701",4911,329,0,17,115,26,27,158,5583
"55097960702",2711,243,0,0,74,12,67,0,3107
"55097960800",3892,629,79,0,402,184,67,64,5317
"55097960900",2441,502,24,0,86,24,35,52,3164
"55097961000",2017,846,0,18,0,107,0,66,3054
"55097961100",4898,459,0,0,670,14,13,0,6054
"55097961200",5251,695,48,0,177,36,76,77,6360
"55097961300",4620,481,5,0,62,135,239,235,5777
"55099970100",2318,260,1,32,65,6,0,0,2682
"55099970200",1935,579,0,0,8,8,22,7,2559
"55099970400",1651,94,1,0,54,0,3,1,1804
"55099970500",1627,353,0,0,63,68,24,0,2135
"55099970600",1816,310,0,1,16,28,12,0,2183
"55099970700",1969,436,1,0,33,9,25,64,2537
"55101000100",354,240,108,108,18,14,37,30,909
"55101000200",2146,309,719,850,778,29,1224,182,6237
"55101000300",511,870,762,658,891,167,789,898,5546
"55101000400",1236,788,473,663,279,305,1023,621,5388
"55101000500",1359,678,1161,960,494,434,1338,968,7392
"55101000600",3624,636,687,591,628,294,912,399,7771
"55101000700",3671,561,559,128,398,316,640,350,6623
"55101000800",3079,326,554,142,208,59,912,181,5461
"55101000901",2522,279,245,34,161,158,431,56,3886
"55101000903",3304,92,430,20,250,10,200,7,4313
"55101000904",3823,276,417,0,322,99,214,0,5151
"55101001001",1177,200,283,592,107,169,162,282,2972
"55101001002",2020,180,207,0,64,5,215,17,2708
"55101001003",2721,139,369,193,176,149,555,22,4324
"55101001100",4859,195,325,87,635,0,593,37,6731
"55101001201",2085,523,243,364,234,182,213,296,4140
"55101001202",3597,583,519,333,786,273,970,317,7378
"55101001301",2564,253,302,3,245,33,244,33,3677
"55101001302",1937,677,577,462,507,247,724,348,5479
"55101001400",4854,569,612,14,476,0,384,0,6909
"55101001501",2927,219,34,0,259,0,240,0,3679
"55101001502",5730,316,238,41,237,71,422,67,7122
"55101001504",1892,133,249,95,469,23,213,32,3106
"55101001505",3417,263,194,332,154,171,405,135,5071
"55101001601",5462,177,144,33,221,93,360,0,6490
"55101001602",2779,418,93,0,139,0,84,0,3513
"55101001701",2175,261,527,141,282,10,279,2,3677
"55101001702",4275,189,10,102,246,32,300,10,5164
"55101001703",3595,291,17,2,380,0,465,131,4881
"55101001705",4647,172,168,0,215,7,408,47,5664
"55101001706",3392,99,166,80,116,0,199,0,4052
"55101001801",4625,274,0,9,190,0,93,0,5191
"55101001802",2754,95,0,0,39,0,67,22,2977
"55101001900",3727,92,15,1,18,0,137,0,3990
"55101002001",2719,87,1,0,32,0,0,0,2839
"55101002002",4739,272,4,4,112,0,135,12,5278
"55101002100",2998,180,0,13,46,0,73,0,3310
"55101002401",4662,588,72,4,371,9,342,0,6048
"55101002402",3544,608,22,364,71,234,158,243,5244
"55101002600",5583,358,12,14,10,15,31,15,6038
"55101002701",3150,254,110,0,163,0,58,37,3772
"55101002702",5448,356,13,0,97,9,318,5,6246
"55101002800",5651,158,47,0,136,27,48,0,6067
"55101980000",38,16,2,2,7,0,0,0,65
"55101990000",0,0,0,0,0,0,0,0,0
"55103970100",2296,307,4,0,98,34,3,3,2745
"55103970200",4184,585,0,0,84,10,21,3,4887
"55103970300",2307,235,66,0,26,0,91,0,2725
"55103970400",2679,556,13,0,146,17,134,25,3570
"55103970500",3432,412,26,10,22,82,20,62,4066
"55105000100",662,257,26,8,31,21,15,30,1050
"55105000200",2188,372,7,17,104,40,85,47,2860
"55105000300",1196,716,7,228,308,197,302,102,3056
"55105000400",2385,599,17,36,290,131,174,75,3707
"55105000500",3422,650,15,40,72,40,112,128,4479
"55105000600",2193,604,24,62,122,42,19,52,3118
"55105000700",2817,629,53,57,107,109,68,72,3912
"55105000800",3289,248,15,3,59,38,218,51,3921
"55105000900",2747,11,61,0,15,0,120,0,2954
"55105001000",1996,777,23,31,224,72,162,279,3564
"55105001100",4209,541,54,30,66,47,78,0,5025
"55105001201",4646,219,41,0,131,0,69,7,5113
"55105001202",4673,165,0,0,45,105,158,0,5146
"55105001302",6346,406,42,10,130,151,52,0,7137
"55105001303",3934,282,14,0,283,3,108,0,4624
"55105001304",7059,766,141,12,124,122,218,176,8618
"55105001400",5390,638,24,14,169,254,193,193,6875
"55105001500",886,311,28,74,17,78,205,126,1725
"55105001600",2404,1315,338,321,331,151,914,128,5902
"55105001700",3080,635,401,315,438,314,1056,365,6604
"55105001800",1318,662,501,383,260,295,789,441,4649
"55105001900",1657,234,38,251,85,89,189,34,2577
"55105002000",3187,497,31,17,177,145,355,7,4416
"55105002100",2778,536,186,99,342,31,421,9,4402
"55105002200",2004,253,38,4,111,0,28,82,2520
"55105002300",1335,175,237,5,173,48,235,79,2287
"55105002400",3066,432,85,16,104,0,8,0,3711
"55105002500",1693,231,226,88,219,33,264,39,2793
"55105002601",3653,520,207,210,500,161,446,314,6011
"55105002602",3421,256,69,79,195,78,277,264,4639
"55105002700",2424,162,0,0,103,4,21,0,2714
"55105002800",4517,567,18,7,94,18,46,24,5291
"55105002900",7599,501,9,14,142,34,347,17,8663
"55105003001",4281,675,0,0,0,0,286,0,5242
"55105003002",4351,177,0,0,237,37,154,37,4993
"55105003100",6998,497,1,45,53,139,89,0,7822
"55105003200",2266,215,0,2,124,3,244,107,2961
"55105003300",2872,162,34,0,113,19,243,39,3482
"55107960100",3117,500,2,4,55,14,12,2,3706
"55107960200",1691,375,6,0,6,17,12,33,2140
"55107960300",1751,422,0,0,6,18,26,0,2223
"55107960400",2334,539,19,6,36,4,24,3,2965
"55107960500",2480,681,18,29,78,64,67,0,3417
"55109120100",2127,185,13,0,85,0,45,0,2455
"55109120201",5332,444,110,0,263,9,72,0,6230
"55109120202",5203,31,0,0,142,0,83,0,5459
"55109120300",5234,149,13,0,86,80,154,53,5769
"55109120400",9169,922,71,9,209,169,226,363,11138
"55109120501",4248,615,13,40,72,141,52,0,5181
"55109120502",4428,645,0,7,83,52,7,0,5222
"55109120600",7445,478,28,15,98,24,60,14,8162
"55109120700",3950,287,1,2,88,18,47,0,4393
"55109120800",7105,596,15,9,225,22,141,3,8116
"55109120901",3798,198,5,0,30,8,179,19,4237
"55109120903",6923,596,186,1,453,19,61,0,8239
"55109120904",3729,167,11,0,14,13,5,0,3939
"55109121000",6414,373,29,9,180,72,96,34,7207
"55111000100",5237,522,43,0,305,297,218,210,6832
"55111000200",4204,252,7,2,184,41,85,20,4795
"55111000300",5381,1128,33,0,127,63,130,49,6911
"55111000401",4728,343,0,10,315,29,332,10,5767
"55111000402",2701,376,41,1,13,0,0,0,3132
"55111000500",2696,356,10,3,281,170,318,169,4003
"55111000600",5775,452,21,0,368,2,166,103,6887
"55111000700",2546,131,0,0,123,0,94,0,2894
"55111000800",3086,344,0,4,85,50,25,37,3631
"55111000900",4214,406,20,2,111,12,97,77,4939
"55111001001",5685,481,0,0,484,0,153,20,6823
"55111001002",2229,465,21,1,9,335,65,303,3428
"55111001100",3694,360,1,0,48,9,32,10,4154
"55113100300",3145,567,24,30,296,139,8,65,4274
"55113100400",1968,281,5,0,58,66,12,0,2390
"55113100500",2997,276,0,0,109,1,22,6,3411
"55113100700",1047,187,8,1,122,61,9,9,1444
"55113100800",1229,294,0,0,68,10,20,41,1662
"55113940000",746,113,5,3,1311,1017,49,16,3260
"55115100100",2611,211,5,0,77,47,54,88,3093
"55115100200",1684,109,0,0,50,4,2,0,1849
"55115100300",3243,195,2,6,258,27,49,9,3789
"55115100400",3204,563,0,0,639,38,48,104,4596
"55115100500",3403,540,66,0,610,6,12,17,4654
"55115100600",2203,309,7,8,1342,418,76,35,4398
"55115100700",2763,361,0,0,71,124,86,104,3509
"55115100800",3716,644,2,14,195,107,116,31,4825
"55115100900",3165,311,0,0,83,32,25,2,3618
"55115101000",3240,388,0,0,39,0,4,39,3710
"55115101100",3426,234,0,0,39,8,11,0,3718
"55117000100",2981,460,0,0,362,0,132,73,4008
"55117000201",1573,319,50,81,418,520,184,245,3390
"55117000202",3087,410,0,107,242,0,172,25,4043
"55117000300",5647,248,57,0,977,276,337,22,7564
"55117000400",3121,534,0,0,395,59,352,161,4622
"55117000500",2116,895,71,60,626,177,261,328,4534
"55117000800",3318,1175,31,54,777,249,779,749,7132
"55117000900",3817,122,54,1,378,16,259,16,4663
"55117001000",5592,563,151,0,661,250,467,32,7716
"55117001100",2961,249,21,0,274,72,147,29,3753
"55117010100",1418,69,4,3,12,4,4,12,1526
"55117010200",3956,82,9,0,85,0,85,7,4224
"55117010300",2895,198,27,1,21,1,28,1,3172
"55117010400",2160,66,0,0,12,2,6,0,2246
"55117010501",6554,607,110,0,109,0,38,0,7418
"55117010502",3204,394,26,0,152,9,4,112,3901
"55117010601",5020,234,0,0,180,11,11,0,5456
"55117010602",3376,409,0,0,56,0,109,233,4183
"55117010700",8223,126,0,0,322,16,95,0,8782
"55117010800",3270,43,0,0,113,0,96,0,3522
"55117010900",2927,183,0,0,60,14,23,0,3207
"55117011000",2172,335,0,0,132,10,6,51,2706
"55117011100",2809,115,0,27,57,3,27,0,3038
"55117011200",3209,206,0,0,53,0,57,0,3525
"55117011300",6642,251,13,6,209,20,169,8,7318
"55117011400",1590,220,0,49,103,38,180,44,2224
"55117990000",0,0,0,0,0,0,0,0,0
"55119960100",3615,531,39,9,45,19,93,9,4360
"55119960200",1954,211,12,0,5,0,19,0,2201
"55119960300",2325,560,15,0,34,28,56,31,3049
"55119960400",4237,546,0,0,43,8,24,0,4858
"55119960500",2283,356,0,1,0,0,41,0,2681
"55119960600",2829,540,0,0,54,18,27,30,3498
"55121100100",2899,256,4,0,111,46,59,0,3375
"55121100200",2897,246,0,0,46,3,140,0,3332
"55121100300",2030,176,0,35,29,114,106,140,2630
"55121100400",2892,752,0,0,144,0,107,0,3895
"55121100500",2543,399,0,0,55,5,53,3,3058
"55121100600",2988,351,43,0,360,225,670,309,4946
"55121100700",4751,345,3,8,55,16,49,35,5262
"55121100800",3244,386,1,0,37,23,43,0,3734
"55123960100",3289,991,8,0,80,10,71,7,4456
"55123960200",3492,1041,4,12,24,97,26,107,4803
"55123960300",3590,337,51,0,25,7,12,0,4022
"55123960400",4186,369,0,0,43,85,4,0,4687
"55123960500",2958,566,2,0,80,4,18,27,3655
"55123960600",4001,438,4,2,93,7,66,3,4614
"55123960700",3283,319,5,2,78,0,68,2,3757
"55125940000",1184,127,1,0,1302,830,142,9,3595
"55125950200",3528,408,1,0,100,92,16,0,4145
"55125950500",4686,752,4,3,139,4,41,18,5647
"55125950600",3422,316,0,0,25,10,3,2,3778
"55125950700",3818,239,37,26,104,0,58,2,4284
"55127000101",4603,832,5,4,45,20,254,0,5763
"55127000102",2443,238,18,0,87,0,84,0,2870
"55127000200",5979,314,37,0,368,36,356,77,7167
"55127000301",2793,188,3,6,60,6,105,0,3161
"55127000302",5614,418,11,0,178,21,196,18,6456
"55127000400",2722,927,7,43,298,103,431,73,4604
"55127000501",812,1303,0,85,19,0,11,16,2246
"55127000502",2019,1003,123,0,152,182,131,175,3785
"55127000600",4548,475,57,49,340,38,760,127,6394
"55127000701",3284,501,0,3,79,240,737,429,5273
"55127000702",3282,836,5,0,314,126,844,287,5694
"55127000800",3904,355,0,0,334,32,446,19,5090
"55127000901",5494,310,65,1,98,43,552,46,6609
"55127000902",2573,498,0,0,127,96,224,390,3908
"55127001000",4210,343,35,2,173,3,0,2,4768
"55127001501",2780,302,0,0,275,0,335,132,3824
"55127001502",4177,455,0,0,95,87,438,170,5422
"55127001602",4881,1026,26,8,104,153,650,389,7237
"55127001603",2141,229,0,6,124,6,128,41,2675
"55127001604",4114,520,0,0,172,0,514,71,5391
"55127001701",5342,256,82,11,353,8,472,53,6577
"55127001702",4112,469,9,8,223,82,281,136,5320
"55129950100",1566,224,0,0,26,1,17,9,1843
"55129950200",1639,183,0,0,39,28,4,8,1901
"55129950300",2133,275,0,0,158,11,30,10,2617
"55129950500",3973,777,45,6,94,93,21,77,5086
"55129950600",3655,527,1,3,75,14,37,3,4315
"55131400102",3517,217,94,0,32,0,30,0,3890
"55131400103",3517,336,0,0,108,0,24,0,3985
"55131400104",5164,410,0,0,275,0,74,2,5925
"55131410100",4573,342,161,40,46,0,43,0,5205
"55131420103",5393,216,0,1,287,0,14,0,5911
"55131420104",4451,237,4,0,45,0,71,0,4808
"55131420105",3682,531,0,100,175,129,183,328,5128
"55131420106",3290,417,2,0,53,66,69,53,3950
"55131420200",4914,436,17,0,132,27,39,0,5565
"55131420300",4586,574,69,0,102,85,205,0,5621
"55131420401",1643,167,14,8,39,8,29,8,1916
"55131420402",1993,178,0,0,35,0,0,0,2206
"55131430100",5382,145,14,0,12,0,134,4,5691
"55131440103",4294,275,36,14,166,13,98,0,4896
"55131440104",4577,579,0,0,242,0,359,70,5827
"55131440105",3153,193,0,0,108,0,32,36,3522
"55131440106",3535,124,0,8,90,2,154,8,3921
"55131440200",3416,372,35,15,103,0,129,174,4244
"55131450103",4559,453,0,0,7,0,29,159,5207
"55131450104",5881,79,0,0,232,29,58,27,6306
"55131450105",2741,8,0,0,3,0,31,0,2783
"55131450106",5509,354,12,0,79,0,99,0,6053
"55131460101",5858,151,46,0,297,0,85,0,6437
"55131460102",4757,78,96,0,51,0,85,0,5067
"55131470100",4292,269,107,0,114,0,268,7,5057
"55131470202",5904,97,35,0,146,0,95,0,6277
"55131470203",3775,351,115,10,40,74,96,15,4476
"55131470204",3982,22,161,0,312,0,68,0,4545
"55133200101",3888,228,38,1,179,1,205,0,4540
"55133200102",4443,187,14,0,423,0,221,0,5288
"55133200103",2663,103,19,158,295,12,155,6,3411
"55133200201",3027,230,150,0,43,10,0,0,3460
"55133200202",3828,65,74,0,279,0,0,0,4246
"55133200300",3587,194,208,0,183,23,113,23,4331
"55133200400",5812,177,191,1,445,0,102,0,6728
"55133200500",4435,189,342,0,366,41,63,0,5436
"55133200600",1380,126,29,8,94,124,65,113,1939
"55133200700",3280,152,27,0,155,0,49,18,3681
"55133200801",4829,72,0,0,43,0,77,0,5021
"55133200803",4003,277,0,1,168,0,129,0,4578
"55133200804",3395,188,0,0,127,4,42,56,3812
"55133200901",3370,172,96,0,73,23,18,0,3752
"55133200902",3700,81,12,0,171,0,43,0,4007
"55133201000",5760,86,13,0,136,0,31,0,6026
"55133201101",4620,121,14,0,323,98,192,19,5387
"55133201102",2542,129,68,0,109,11,104,60,3023
"55133201201",1834,45,0,0,161,0,45,0,2085
"55133201202",4849,170,211,0,701,90,202,0,6223
"55133201203",2649,37,13,0,215,0,48,0,2962
"55133201300",4187,221,33,0,401,86,30,25,4983
"55133201402",3990,231,0,0,332,15,115,0,4683
"55133201403",3483,235,91,0,213,42,103,0,4167
"55133201404",3575,139,57,5,73,16,21,0,3886
"55133201503",6296,142,0,0,608,0,245,0,7291
"55133201504",5468,155,0,0,351,0,281,0,6255
"55133201505",2737,51,0,0,97,0,47,0,2932
"55133201506",4652,128,23,8,117,0,19,0,4947
"55133201600",4770,158,0,0,231,24,127,0,5310
"55133201701",4218,362,0,0,73,0,93,0,4746
"55133201703",5721,118,0,0,177,0,156,0,6172
"55133201704",4644,70,0,0,267,0,53,0,5034
"55133201800",1486,95,0,0,31,0,23,0,1635
"55133201900",4790,239,0,0,211,0,205,0,5445
"55133202001",4706,149,25,0,131,0,100,0,5111
"55133202002",3643,158,0,0,97,15,159,0,4072
"55133202101",3643,112,0,0,384,76,176,0,4391
"55133202102",4460,240,27,0,175,0,324,0,5226
"55133202103",3233,68,24,0,87,0,88,0,3500
"55133202201",4010,73,0,1,88,0,133,0,4305
"55133202202",4432,640,29,35,582,104,736,100,6658
"55133202301",3687,232,245,0,262,19,255,85,4785
"55133202302",4544,1112,270,427,339,65,974,535,8266
"55133202400",3760,290,16,0,305,105,339,33,4848
"55133202500",3139,533,0,175,246,105,357,180,4735
"55133202600",1701,453,0,0,49,140,304,306,2953
"55133202700",1119,219,6,0,136,0,116,0,1596
"55133202800",2624,578,19,14,271,156,743,519,4924
"55133202901",3236,269,72,25,604,232,216,199,4853
"55133202902",2768,292,86,18,225,14,188,0,3591
"55133203000",1448,110,9,23,79,185,149,161,2164
"55133203101",5521,264,176,62,587,38,325,0,6973
"55133203102",6314,286,0,0,351,0,453,130,7534
"55133203103",3864,416,72,0,94,30,440,79,4995
"55133203200",3896,172,0,0,140,9,205,0,4422
"55133203303",3642,84,0,0,48,0,16,0,3790
"55133203304",3685,57,11,30,431,0,63,0,4277
"55133203305",3702,230,36,0,126,0,53,0,4147
"55133203306",5254,430,0,0,388,18,245,0,6335
"55133203402",3413,154,64,0,254,0,60,0,3945
"55133203403",5480,15,34,0,62,1,116,0,5708
"55133203404",2534,358,9,49,40,8,23,8,3029
"55133203405",4109,70,41,0,158,0,53,0,4431
"55133203406",5929,142,93,3,129,25,44,0,6365
"55133203500",6519,81,6,0,121,0,93,0,6820
"55133203601",3538,299,33,0,144,9,32,19,4074
"55133203602",5012,266,19,12,287,27,162,27,5812
"55133203702",4644,96,0,0,268,0,223,0,5231
"55133203703",3411,124,2,0,126,0,8,0,3671
"55133203704",4280,218,51,0,127,9,28,0,4713
"55133203802",6084,204,0,0,271,0,51,0,6610
"55133203803",3693,53,47,1,138,0,126,0,4058
"55133203804",6443,182,69,0,124,8,167,0,6993
"55133203901",4195,284,0,1,11,0,147,42,4680
"55133203902",3615,203,0,0,128,77,18,0,4041
"55133204002",4811,229,68,0,133,7,163,0,5411
"55133204003",3682,119,3,0,77,0,196,0,4077
"55133204004",3929,67,0,1,228,0,39,0,4264
"55133204100",4698,123,63,0,113,15,146,8,5166
"55133204200",5882,445,51,0,628,0,646,9,7661
"55133204301",4390,94,0,20,99,16,33,0,4652
"55133204302",3329,267,86,0,89,0,204,5,3980
"55133204400",1867,84,4,0,85,0,45,21,2106
"55133204501",2197,53,0,0,42,0,48,0,2340
"55133204502",5845,536,55,0,82,0,74,0,6592
"55135100100",3321,421,0,0,81,30,44,9,3906
"55135100200",2474,267,0,0,92,29,12,27,2901
"55135100300",3388,367,0,0,51,12,19,14,3851
"55135100400",3887,398,5,0,44,4,71,2,4411
"55135100500",2302,157,0,12,19,0,19,0,2509
"55135100600",4391,405,0,0,38,12,198,19,5063
"55135100700",2588,611,12,0,61,93,154,108,3627
"55135100800",4293,184,18,13,7,0,21,11,4547
"55135100900",5164,440,196,4,146,6,172,6,6134
"55135101000",4802,715,0,0,78,97,87,17,5796
"55135101100",4072,730,0,0,61,102,243,0,5208
"55135101200",3534,250,13,0,67,4,59,6,3933
"55137960100",2394,310,12,4,17,0,19,4,2760
"55137960200",3546,489,1,37,79,15,62,20,4249
"55137960300",2637,404,0,7,131,21,260,72,3532
"55137960400",2868,393,1,3,59,10,105,8,3447
"55137960600",1893,145,0,0,4,0,0,0,2042
"55137960700",2941,374,11,5,157,14,125,23,3650
"55137960800",3604,395,8,26,138,29,543,41,4784
"55139000100",2330,720,0,0,159,0,29,10,3248
"55139000200",1905,444,94,115,45,42,42,143,2830
"55139000300",3266,560,13,73,37,115,0,146,4210
"55139000400",1954,626,0,0,55,0,50,0,2685
"55139000500",3419,2595,115,33,322,61,64,63,6672
"55139000700",533,1407,0,28,36,44,8,12,2068
"55139000800",2607,239,102,9,69,0,153,13,3192
"55139000900",2384,313,42,27,124,0,13,24,2927
"55139001000",2345,242,0,0,90,10,86,0,2773
"55139001100",3149,338,20,0,116,89,66,0,3778
"55139001200",1488,307,145,11,142,8,88,19,2208
"55139001300",2300,143,0,6,128,99,48,0,2724
"55139001400",3516,373,6,0,270,11,81,30,4287
"55139001500",2663,229,21,72,41,303,50,0,3379
"55139001600",1925,485,34,3,28,9,111,12,2607
"55139001700",2397,126,6,15,130,189,23,0,2886
"55139001801",4680,466,0,0,156,0,141,0,5443
"55139001803",5211,341,18,0,130,0,150,0,5850
"55139001804",3730,213,0,0,186,0,30,0,4159
"55139001900",4591,334,12,2,96,0,69,27,5131
"55139002000",6842,441,0,0,96,43,514,161,8097
"55139002100",3158,188,3,0,32,0,41,0,3422
"55139002201",4187,206,0,2,42,29,7,9,4482
"55139002202",2558,181,0,0,36,0,33,2,2810
"55139002300",4923,94,11,0,267,0,63,0,5358
"55139002400",9361,361,96,89,383,151,357,170,10968
"55139002500",3752,526,26,6,238,0,711,30,5289
"55139002601",3196,253,0,0,362,9,22,0,3842
"55139002602",3931,350,9,56,193,48,77,47,4711
"55139002700",1801,190,6,0,96,63,44,0,2200
"55139002800",3731,752,0,0,529,0,40,0,5052
"55139002900",1565,359,16,9,68,189,27,54,2287
"55139003000",1280,304,26,0,38,1,22,28,1699
"55139003100",1682,60,0,0,123,61,39,0,1965
"55139003200",2051,18,0,0,164,0,87,0,2320
"55139003300",2159,463,0,3,73,48,25,0,2771
"55139003400",3290,338,0,4,172,25,86,0,3915
"55139003500",2034,395,34,0,252,0,497,0,3212
"55139003600",3634,123,0,0,154,0,22,0,3933
"55139003701",2886,533,15,63,211,112,255,52,4127
"55139003702",7659,421,18,0,356,33,140,0,8627
"55141010100",4106,455,8,0,28,0,45,0,4642
"55141010200",4175,326,2,0,64,10,19,0,4596
"55141010300",2470,670,29,3,164,1,205,53,3595
"55141010400",2659,519,1,0,126,0,86,43,3434
"55141010500",2660,246,0,0,107,11,52,5,3081
"55141010600",3890,610,3,5,119,11,45,9,4692
"55141010700",4701,213,12,0,145,6,104,4,5185
"55141010800",2521,215,0,0,24,2,77,7,2846
"55141010900",3481,227,4,0,145,72,60,0,3989
"55141011000",4215,677,66,0,107,53,187,0,5305
"55141011100",2922,497,0,0,114,70,8,19,3630
"55141011200",2921,966,0,20,89,189,72,86,4343
"55141011300",3339,506,0,11,441,0,12,0,4309
"55141011400",4465,338,0,0,422,116,68,41,5450
"55141011500",5589,177,0,0,218,0,125,0,6109
"55141011600",4846,244,0,0,15,0,217,0,5322
"55141011700",3778,522,45,33,78,81,61,42,4640
"56001962700",2697,451,0,6,305,112,220,108,3899
"56001962800",2606,615,0,0,250,48,241,104,3864
"56001962900",1272,297,0,0,200,190,320,194,2473
"56001963000",1216,588,0,89,110,145,156,43,2347
"56001963100",4486,1532,70,0,400,118,354,111,7071
"56001963400",1990,1057,0,100,245,229,135,1,3757
"56001963500",82,476,0,32,66,26,0,17,699
"56001963600",3527,936,0,0,92,34,95,89,4773
"56001963700",3422,1502,70,104,348,142,597,164,6349
"56001963900",1754,68,23,0,152,13,115,13,2138
"56003962600",1950,77,0,0,86,3,114,2,2232
"56003962700",3047,379,0,0,132,184,311,229,4282
"56003962800",4911,493,0,0,233,37,292,37,6003
"56005000100",7654,445,166,9,543,0,513,80,9410
"56005000200",5853,198,0,0,231,95,132,95,6604
"56005000300",4104,794,15,33,449,64,406,31,5896
"56005000400",3607,374,0,6,665,45,784,136,5617
"56005000500",6180,113,4,0,121,410,187,373,7388
"56005000600",4577,216,13,0,437,9,629,15,5896
"56005000700",7831,771,69,8,256,0,247,30,9212
"56007967600",1261,259,0,0,39,2,119,26,1706
"56007967700",3162,729,0,20,351,150,950,339,5701
"56007967800",3321,126,43,0,363,11,852,55,4771
"56007968000",2893,468,0,0,79,1,87,28,3556
"56007968100",1107,166,0,3,63,44,98,7,1488
"56009956400",4534,285,0,0,195,2,321,16,5353
"56009956500",2331,224,0,0,142,139,139,67,3042
"56009956600",2746,226,0,0,98,0,130,0,3200
"56009956700",2433,268,14,19,107,26,216,36,3119
"56011950200",4280,294,4,0,24,16,102,7,4727
"56011950300",2262,163,0,0,4,0,58,0,2487
"56013000100",2540,634,0,0,339,297,88,126,4024
"56013000200",3087,181,0,0,408,9,12,0,3697
"56013000300",3755,125,12,0,162,34,240,13,4341
"56013000400",1599,62,0,0,30,11,0,0,1702
"56013940100",534,60,32,0,2713,515,98,13,3965
"56013940201",3393,244,0,0,305,22,222,10,4196
"56013940202",1773,77,25,0,1997,656,149,109,4786
"56013940300",3061,1287,14,49,823,388,194,197,6013
"56013940400",3985,549,0,0,696,244,355,104,5933
"56013940500",1967,414,15,0,323,89,215,206,3229
"56015957700",1505,405,0,0,0,4,14,0,1928
"56015957800",2084,814,3,0,265,38,402,125,3731
"56015957900",3915,360,2,0,88,104,327,53,4849
"56015958000",2222,526,10,0,218,58,229,116,3379
"56017967800",2388,447,0,0,16,11,31,57,2950
"56017967900",1650,99,10,0,83,5,34,0,1881
"56019955100",2562,144,1,0,20,0,21,0,2748
"56019955200",4933,482,0,0,342,15,192,106,6070
"56021000200",2160,1347,210,0,431,256,624,384,5412
"56021000300",2474,525,243,37,387,106,591,268,4631
"56021000401",3607,740,24,0,492,40,627,99,5629
"56021000402",3705,774,118,0,340,189,742,294,6162
"56021000501",6572,440,12,0,660,298,1149,52,9183
"56021000600",4523,563,244,23,530,110,878,191,7062
"56021000700",2596,472,62,2,631,58,684,94,4599
"56021000800",1428,104,26,0,125,16,162,0,1861
"56021000900",2042,71,16,0,281,0,247,0,2657
"56021001000",2379,365,180,0,293,157,440,99,3913
"56021001100",1746,21,342,0,397,10,306,0,2822
"56021001200",4340,105,40,0,192,5,559,0,5241
"56021001300",6610,351,0,0,550,33,1167,33,8744
"56021001401",3452,204,0,0,338,58,329,48,4429
"56021001402",2101,85,7,61,27,9,140,11,2441
"56021001501",3647,316,260,0,492,0,529,9,5253
"56021001502",3230,777,101,290,567,192,559,70,5786
"56021001901",5050,94,74,0,123,13,322,0,5676
"56021001902",3733,182,25,0,29,0,113,0,4082
"56021002000",6825,250,40,0,190,71,406,122,7904
"56021980801",0,0,0,0,0,0,0,0,0
"56023978000",5868,401,3,2,270,6,289,61,6900
"56023978100",5509,535,4,0,69,12,109,12,6250
"56023978200",1794,140,0,0,66,0,26,0,2026
"56023978400",3048,136,0,0,98,13,263,14,3572
"56025000200",2606,639,177,31,619,128,496,99,4795
"56025000300",3106,485,0,0,405,63,513,40,4612
"56025000400",3569,196,23,0,180,110,188,110,4376
"56025000501",4382,459,137,0,394,0,424,29,5825
"56025000502",2338,453,23,0,297,48,431,109,3699
"56025000600",6346,675,0,0,447,0,380,41,7889
"56025000700",2338,171,0,0,161,1,318,15,3004
"56025000800",3317,347,16,0,146,5,188,5,4024
"56025000901",4196,220,0,11,202,139,200,151,5119
"56025000902",3251,27,0,0,79,0,67,0,3424
"56025001000",4030,320,0,14,138,50,111,62,4725
"56025001100",1966,500,0,20,42,19,89,29,2665
"56025001200",1280,293,0,0,47,49,65,103,1837
"56025001401",4790,611,12,0,199,59,305,148,6124
"56025001602",5379,306,83,0,234,48,374,0,6424
"56025001603",3070,273,0,0,141,8,78,60,3630
"56025001700",4078,418,0,0,97,0,226,0,4819
"56025001800",3776,301,7,0,76,0,74,0,4234
"56027957200",1793,336,5,8,80,21,29,0,2272
"56029965100",4308,268,3,0,64,41,182,25,4891
"56029965200",4871,650,0,0,210,0,273,21,6025
"56029965300",6499,363,51,3,151,0,153,21,7241
"56029965400",5425,668,75,0,172,1,672,28,7041
"56029965500",3559,195,0,59,165,23,19,39,4059
"56031959100",1771,355,0,0,51,28,45,22,2272
"56031959400",5233,872,0,0,142,125,141,403,6916
"56033000100",3853,500,0,0,52,21,88,5,4519
"56033000200",2890,134,104,0,183,0,151,0,3462
"56033000300",2972,371,10,0,260,52,92,13,3770
"56033000400",4296,822,20,0,447,71,459,35,6150
"56033000500",6408,231,4,0,135,9,103,3,6893
"56033000600",4012,171,9,1,268,114,144,0,4719
"56035000101",3428,350,0,0,202,0,129,0,4109
"56035000102",5121,248,0,0,767,23,601,6,6766
"56037970500",2278,255,19,0,197,0,154,51,2954
"56037970601",3486,702,0,0,230,82,635,115,5250
"56037970602",3301,287,0,0,170,0,442,0,4200
"56037970700",3218,139,17,0,199,25,299,34,3931
"56037970800",3899,962,51,19,551,245,693,704,7124
"56037970901",5496,263,7,0,604,30,620,125,7145
"56037970902",3548,449,0,0,451,107,535,199,5289
"56037970903",1885,353,0,0,98,52,358,304,3050
"56037971000",1999,122,0,0,73,25,310,97,2626
"56037971100",2418,425,0,0,293,47,731,37,3951
"56037971200",2278,204,5,25,42,0,103,0,2657
"56037971600",1878,110,0,6,64,23,184,11,2276
"56039967600",4040,262,21,5,15,19,198,3,4563
"56039967701",2628,46,0,2,157,2,421,2,3258
"56039967702",5454,899,0,0,197,180,1033,317,8080
"56039967800",6689,349,0,0,509,0,1019,207,8773
"56041975200",5401,670,8,0,203,23,256,21,6582
"56041975300",6410,693,6,2,287,114,746,20,8278
"56041975400",5586,998,0,0,165,278,489,317,7833
"56043000200",2617,184,29,0,150,231,70,229,3510
"56043000301",2339,358,0,0,35,14,288,53,3087
"56043000302",2005,221,10,0,122,1,397,113,2869
"56045951100",2834,257,0,0,38,0,20,0,3149
"56045951300",3015,421,0,0,176,88,161,12,3873
"72001956300",1557,2499,9,7,23,138,1539,2629,8401
"72001956400",955,1586,0,0,0,66,943,1640,5190
"72001956500",1103,1729,0,34,0,55,1103,1808,5832
"72001956600",820,1304,44,0,127,197,991,1501,4984
"72001956700",803,924,40,0,0,16,843,938,3564
"72001956800",2077,2797,7,0,71,191,2155,2977,10275
"72003430100",1750,1739,208,190,901,498,2827,2268,10381
"72003430200",1761,1696,108,12,540,1246,2393,2861,10617
"72003430300",666,1016,53,30,364,745,1033,1702,5609
"72003430401",1035,1978,38,182,850,1092,1787,2961,9923
"72003430402",1098,2091,56,172,403,817,1503,2951,9091
"72003430501",1767,1617,67,86,1243,1057,2752,2421,11010
"72003430502",1029,1535,10,151,1195,660,2046,2162,8788
"72003430601",1389,2229,22,14,370,516,1706,2630,8876
"72003430602",1195,768,39,8,802,445,1755,1141,6153
"72003990000",0,0,0,0,0,0,0,0,0
"72005400100",1997,1844,161,70,548,641,2516,2500,10277
"72005400300",2033,677,84,27,272,37,1960,727,5817
"72005400400",1629,1668,8,54,301,159,1929,1846,7594
"72005400501",1765,1621,44,41,176,268,1933,1930,7778
"72005400502",2493,1991,61,26,677,449,3135,2373,11205
"72005400600",857,1504,47,40,125,188,1005,1674,5440
"72005400700",1652,954,40,77,147,49,1788,1080,5787
"72005400800",421,1040,8,78,84,185,498,1264,3578
"72005400900",549,1402,28,54,54,348,631,1741,4807
"72005401000",253,751,0,13,116,69,369,821,2392
"72005401100",374,833,59,0,13,285,446,1118,3128
"72005401200",883,1472,21,28,677,620,1479,2000,7180
"72005401301",1399,2048,27,180,718,697,1956,2826,9851
"72005401302",2638,2187,16,210,1678,747,4145,3039,14660
"72005401401",1798,875,37,88,504,499,2098,1268,7167
"72005401402",1310,1399,221,77,571,471,2066,1930,8045
"72005990000",0,0,0,0,0,0,0,0,0
"72007230100",2196,2472,17,59,167,179,2380,2664,10134
"72007230200",3040,2319,19,118,202,387,3210,2802,12097
"72007230300",1231,1688,23,123,184,127,1429,1938,6743
"72007230400",1374,2709,63,103,256,306,1693,3117,9621
"72007230501",1376,1455,90,154,569,696,2022,2305,8667
"72007230502",1704,1882,97,41,492,353,2293,2246,9108
"72009250100",2442,1550,464,98,353,168,3248,1816,10139
"72009250200",2890,2099,80,98,213,183,3176,2380,11119
"72009250300",1246,1805,291,111,86,143,1607,2059,7348
"72009250400",993,1056,0,108,42,216,1035,1377,4827
"72009250500",2287,1618,54,310,171,466,2512,2394,9812
"72009250600",1346,1484,113,113,321,496,1756,2084,7713
"72011810100",883,1380,18,105,110,405,1011,1890,5802
"72011810200",3608,3295,15,296,829,968,4431,4543,17985
"72011810300",1003,590,37,84,131,292,1171,966,4274
"72011810400",299,451,17,49,138,53,454,552,2013
"72011810500",2171,1559,26,0,905,621,3043,2180,10505
"72011810600",1929,1571,51,24,325,642,2255,2225,9022
"72011810700",1430,1427,30,93,447,694,1890,2174,8185
"72011990000",0,0,0,0,0,0,0,0,0
"72013300101",2209,2124,289,90,267,130,2750,2333,10192
"72013300102",2707,1825,33,22,119,85,2859,1932,9582
"72013300200",1355,1220,250,42,536,303,2141,1565,7412
"72013300301",1525,1352,0,117,167,83,1692,1552,6488
"72013300302",3484,1562,214,42,202,211,3899,1815,11429
"72013300400",518,758,228,115,174,250,907,1100,4050
"72013300500",247,722,33,34,84,187,364,943,2614
"72013300700",439,572,15,18,108,89,562,679,2482
"72013300800",2493,2020,130,91,165,570,2772,2680,10921
"72013301000",3388,1343,47,0,353,246,3788,1589,10754
"72013301100",4131,2206,307,86,601,486,5009,2726,15552
"72013301200",2172,1574,93,90,204,175,2455,1814,8577
"72013301300",448,2701,0,108,87,380,524,3188,7436
"72013301400",372,561,86,60,93,169,551,775,2667
"72013301500",2630,1770,292,111,499,359,3393,2240,11294
"72013301600",1866,1232,29,148,412,388,2290,1721,8086
"72013301700",2340,1858,42,37,108,193,2490,2072,9140
"72013301800",718,1002,17,0,13,34,735,1036,3555
"72013301900",1497,2756,0,61,0,225,1497,3042,9078
"72013302000",1385,855,30,14,118,91,1517,950,4960
"72013302100",2344,2743,70,20,38,49,2452,2792,10508
"72013302201",791,1692,0,14,104,81,877,1787,5346
"72013302202",2265,2290,32,46,126,28,2395,2279,9461
"72013302300",999,1458,45,0,55,46,1099,1470,5172
"72013992900",0,0,0,0,0,0,0,0,0
"72015280101",241,655,332,480,276,743,849,1878,5454
"72015280102",2271,1870,666,706,756,1091,3693,3667,14720
"72015280201",1014,943,672,618,780,526,2466,2087,9106
"72015280202",1348,1124,466,730,572,551,2350,2384,9525
"72015991500",0,0,0,0,0,0,0,0,0
"72017590100",3103,3453,40,40,0,197,3143,3672,13648
"72017590200",1139,2485,92,1,33,170,1249,2640,7809
"72017590300",3551,4454,60,15,63,66,3601,4535,16345
"72017590400",3282,2425,0,56,35,102,3317,2502,11719
"72017990000",0,0,0,0,0,0,0,0,0
"72019952201",884,774,55,56,1206,1723,2145,2544,9387
"72019952202",717,1137,68,171,1168,2222,1953,3501,10937
"72019952301",994,664,12,8,968,1280,1974,1952,7852
"72019952302",579,1293,13,39,1627,2466,2175,3798,11990
"72019952400",375,808,0,97,329,919,704,1824,5056
"72019952500",1427,1263,161,151,1908,2373,3496,3787,14566
"72021030101",1154,382,186,7,742,190,2033,563,5257
"72021030103",1105,1135,204,290,729,985,2038,2402,8888
"72021030104",2724,337,131,19,1013,63,3771,419,8477
"72021030105",1245,299,237,11,428,195,1597,505,4517
"72021030200",2007,619,160,78,416,172,2575,799,6826
"72021030300",1004,990,156,44,1338,455,2488,1489,7964
"72021030700",261,534,75,141,145,533,481,1203,3373
"72021030800",613,64,11,44,100,188,719,296,2035
"72021030901",854,281,75,44,363,42,1292,367,3318
"72021030902",1328,390,94,22,310,267,1732,664,4807
"72021030903",891,286,59,6,337,142,1247,434,3402
"72021030904",926,757,56,30,278,187,1260,969,4463
"72021031004",1443,255,185,25,713,304,2295,566,5786
"72021031005",1080,701,102,40,490,757,1603,1490,6263
"72021031011",2247,196,216,0,920,173,3353,369,7474
"72021031013",2364,1332,566,257,2276,878,5185,2387,15245
"72021031021",1516,584,218,110,508,483,2233,1177,6829
"72021031023",1276,492,106,12,614,401,1996,905,5802
"72021031031",1877,658,209,184,1136,686,3082,1528,9360
"72021031032",1039,176,210,160,731,170,1889,506,4881
"72021031033",1551,699,106,121,904,500,2526,1289,7696
"72021031101",1322,383,208,36,548,352,2035,741,5625
"72021031113",2003,1258,218,208,612,345,2797,1760,9201
"72021031114",1163,1270,227,184,255,504,1645,1958,7206
"72021031121",1296,965,323,77,231,687,1850,1707,7136
"72021031122",1752,558,156,148,535,291,2443,997,6880
"72021031123",1160,714,187,60,503,373,1834,1146,5977
"72021031124",405,343,44,20,361,694,810,1057,3734
"72021031125",1173,324,54,34,477,490,1687,834,5073
"72021031201",662,713,111,86,173,1452,900,2251,6348
"72021031202",838,432,91,45,500,328,1429,789,4452
"72021031203",1108,270,162,38,262,104,1524,412,3880
"72021031301",2700,713,205,312,1111,473,4005,1498,11017
"72021031304",893,228,11,0,740,607,1644,835,4958
"72021031305",2259,988,231,38,831,662,3311,1688,10008
"72021031306",1665,388,229,98,1082,414,2838,900,7614
"72021031307",1350,292,106,43,580,254,2013,589,5227
"72021031401",1253,548,182,151,580,195,1996,877,5782
"72021031402",913,566,97,404,346,349,1340,1285,5300
"72021031403",1352,761,150,86,221,234,1716,1081,5601
"72021031501",1171,534,213,117,652,259,2009,910,5865
"72021031502",797,438,60,100,239,299,1096,837,3866
"72021031503",630,657,95,63,287,221,980,941,3874
"72021031611",1340,566,106,203,326,268,1772,1018,5599
"72021031612",1908,1575,277,496,407,544,2582,2615,10404
"72021031621",1239,272,139,78,451,313,1829,646,4967
"72021031622",1326,595,198,117,477,443,1993,1155,6304
"72021031631",1157,459,83,42,518,247,1707,709,4922
"72021031632",1021,673,108,80,405,304,1526,1057,5174
"72021031641",1106,555,147,153,522,154,1775,862,5274
"72021031651",1137,877,103,174,478,449,1684,1492,6394
"72021031701",1934,832,191,165,450,408,2575,1405,7960
"72021031702",1815,1433,191,92,459,446,2465,1968,8869
"72021031703",1520,633,213,48,597,206,2330,869,6416
"72021031704",2341,1166,428,87,632,289,3401,1535,9879
"72021031800",2588,910,348,56,1124,1265,4060,2227,12578
"72021031900",2550,1430,68,36,1228,704,3837,2158,12011
"72021032000",441,494,31,0,218,439,690,933,3246
"72021032100",477,315,26,6,586,822,1089,1143,4464
"72021032200",610,796,64,121,294,615,968,1532,5000
"72021032301",1676,170,101,24,781,202,2558,396,5908
"72021032302",640,685,103,29,432,312,1175,1026,4402
"72023830101",2487,2511,87,28,91,19,2646,2544,10413
"72023830102",2449,2135,276,50,9,83,2734,2268,10004
"72023830200",2894,2092,370,9,43,29,3307,2113,10857
"72023830300",4317,1651,104,12,225,12,4592,1675,12588
"72023830400",2201,3310,53,108,0,0,2238,3410,11320
"72023830502",1747,2467,7,0,45,31,1770,2498,8565
"72023830503",3165,3248,10,25,26,0,3201,3273,12948
"72023830504",1390,2025,90,0,20,0,1500,2025,7050
"72023830603",2142,3247,0,76,22,10,2094,3322,10913
"72023830604",1429,1754,0,0,59,90,1488,1844,6664
"72023980000",0,0,0,0,0,0,0,0,0
"72023990000",0,0,0,0,0,0,0,0,0
"72025200100",4317,1552,390,94,766,1138,5442,2711,16410
"72025200200",1513,1618,110,20,1517,720,3094,2342,10934
"72025200302",4050,396,188,23,766,567,4972,986,11948
"72025200303",5025,1038,587,32,2139,604,7658,1657,18740
"72025200304",2895,1076,307,75,820,659,3959,1809,11600
"72025200400",1617,553,172,159,448,114,2237,826,6126
"72025200500",2530,1351,357,177,701,244,3565,1742,10667
"72025200600",1486,1335,207,140,587,247,2280,1722,8004
"72025200700",2215,943,152,56,134,119,2470,1100,7189
"72025200800",1994,804,329,91,257,50,2580,945,7050
"72025200900",284,921,27,297,68,139,379,1337,3452
"72025201000",457,1055,107,137,136,161,700,1332,4085
"72025201200",1078,1225,139,53,125,264,1323,1542,5749
"72025201300",1857,810,32,14,119,113,2008,937,5890
"72025201400",1028,985,116,185,104,212,1240,1382,5252
"72025201500",1121,1093,20,171,124,154,1265,1418,5366
"72025201600",580,2033,35,249,17,508,624,2790,6836
"72025201700",717,902,104,171,92,105,913,1178,4182
"72025201800",1377,1279,83,125,56,247,1508,1599,6274
"72025201900",808,1135,72,156,70,247,950,1538,4976
"72025202000",1888,2108,88,134,331,174,2292,2401,9416
"72025202100",1758,1041,183,47,155,86,2096,1163,6529
"72025202200",847,618,76,128,63,90,986,820,3628
"72025202300",2014,795,129,16,87,76,2216,866,6199
"72025202402",4568,2128,265,75,460,97,5049,2262,14904
"72025202403",1742,1490,61,0,233,136,2014,1626,7302
"72025202404",2548,1165,79,132,466,127,3093,1424,9034
"72025202500",2255,1213,58,20,135,109,2417,1342,7549
"72025202601",3576,1948,445,68,422,94,4443,2041,13037
"72025202602",4227,1570,599,205,471,45,5297,1785,14199
"72025202701",1876,1081,270,179,807,979,2938,2222,10352
"72025202702",2189,1163,122,112,1309,252,3620,1515,10282
"72025202800",960,1378,239,125,812,314,2011,1817,7656
"72027320100",1083,1572,17,9,0,64,1100,1598,5443
"72027320200",3556,2769,24,34,80,270,3608,3041,13382
"72027320300",4037,2417,3,28,147,442,4179,2887,14140
"72027320401",2845,1104,55,0,202,114,3102,1218,8640
"72027320402",1821,1683,52,14,65,52,1938,1725,7350
"72027320500",2340,2526,233,22,41,67,2594,2615,10438
"72027320600",2518,1952,42,8,50,394,2610,2291,9865
"72027990000",0,0,0,0,0,0,0,0,0
"72029100101",725,649,635,517,807,896,2167,2041,8437
"72029100103",606,812,444,259,435,1086,1485,2157,7284
"72029100104",640,1364,57,461,469,2272,1166,4085,10514
"72029100200",554,683,237,208,258,407,1049,1297,4693
"72029100400",1378,1767,495,398,1720,1209,3580,3374,13921
"72029100502",1455,477,643,137,792,307,2882,921,7614
"72029100503",3248,732,400,101,1376,335,5024,1168,12384
"72029100504",1886,142,394,14,492,56,2772,212,5968
"72029100601",1107,728,311,53,803,508,2221,1289,7020
"72029100602",650,644,244,314,712,506,1606,1464,6140
"72029100700",1448,912,160,72,973,661,2581,1645,8452
"72029100800",529,472,28,17,197,190,754,679,2866
"72031050103",3714,637,269,28,141,157,3909,771,9626
"72031050105",1724,548,394,367,130,51,2223,949,6386
"72031050106",1064,230,49,0,278,24,1097,219,2961
"72031050107",1472,116,107,0,120,0,1549,105,3469
"72031050110",1918,395,303,155,408,250,2593,771,6793
"72031050111",836,141,73,0,93,0,947,122,2212
"72031050211",1929,550,580,169,612,89,3097,808,7834
"72031050212",3213,1139,473,376,668,525,4344,2003,12741
"72031050221",3146,824,784,148,348,224,4182,1182,10838
"72031050222",954,1144,634,1007,372,862,1903,3013,9889
"72031050231",1104,677,703,245,668,288,2418,1184,7287
"72031050232",2631,608,687,121,1160,390,4455,1119,11171
"72031050241",2585,783,1071,95,571,243,4175,1101,10624
"72031050242",2032,1036,931,184,760,281,3681,1453,10358
"72031050302",1577,467,783,140,171,109,2517,716,6480
"72031050311",1398,776,70,75,263,123,1731,948,5384
"72031050321",2002,698,696,323,461,406,3131,1402,9119
"72031050331",943,425,200,40,372,122,1485,587,4174
"72031050341",1266,803,760,934,284,379,2202,2116,8744
"72031050401",1584,324,360,70,301,87,2212,481,5419
"72031050402",3729,1730,994,730,1060,916,5635,3376,18170
"72031050501",4211,841,885,75,768,72,5736,988,13576
"72031050503",2324,881,663,319,465,121,3452,1321,9546
"72031050504",3602,2005,1532,384,362,195,5461,2565,16106
"72031050600",1927,1292,830,676,399,255,3100,2223,10702
"72031050700",383,237,172,139,203,295,758,657,2844
"72031050803",1766,770,766,306,539,410,3071,1479,9107
"72031050811",2345,451,601,221,566,238,3490,910,8822
"72031050812",1838,863,522,290,382,268,2742,1421,8326
"72031050821",1900,735,725,183,630,280,3220,1146,8819
"72031050822",1424,476,644,378,440,327,2499,1164,7352
"72031050831",1840,878,705,224,771,434,3309,1529,9690
"72031050841",889,581,355,597,436,468,1680,1646,6652
"72031050901",1916,645,650,341,986,574,3552,1527,10191
"72031050902",2487,499,581,500,1016,418,4084,1395,10980
"72031051001",1721,1038,214,162,578,603,2488,1803,8607
"72031051002",1104,818,213,373,560,345,1857,1516,6786
"72031051102",1200,811,374,332,620,1066,2194,2170,8767
"72031051103",2271,514,515,152,1240,191,3989,857,9729
"72031051104",2068,445,488,217,693,26,3217,675,7829
"72031980003",0,0,0,0,0,0,0,0,0
"72031990000",0,0,0,0,0,0,0,0,0
"72033020200",814,1273,169,252,298,563,1264,2057,6690
"72033020302",406,915,23,61,282,374,711,1350,4122
"72033020403",1888,1264,372,351,601,344,2861,1959,9640
"72033020422",794,949,29,130,207,455,1030,1534,5128
"72033020423",2262,733,154,22,500,209,2916,964,7760
"72033020425",751,1043,247,84,142,697,1140,1808,5912
"72033020426",127,1378,0,232,44,622,163,2227,4793
"72033020427",149,340,29,109,154,329,332,746,2188
"72033020500",3059,541,95,16,449,56,3553,600,8369
"72033980001",0,0,0,0,0,0,0,0,0
"72033980002",0,0,0,0,0,0,0,0,0
"72033980003",10,163,0,0,0,20,10,183,386
"72033980004",0,0,0,0,0,0,0,0,0
"72033980005",0,0,0,0,0,0,0,0,0
"72033980006",0,13,0,0,35,25,35,38,146
"72033980007",0,0,0,0,0,0,0,0,0
"72033980008",0,0,0,0,0,0,0,0,0
"72033990201",0,0,0,0,0,0,0,0,0
"72035260100",4336,2093,185,62,1666,892,6182,2991,18407
"72035260201",2523,595,35,54,387,104,2933,753,7384
"72035260202",1912,785,96,56,647,190,2617,1031,7334
"72035260300",1738,1386,56,31,539,377,2333,1794,8254
"72035260400",1995,1424,38,67,437,893,2470,2384,9708
"72035260500",2081,979,42,77,391,856,2500,1912,8838
"72035260600",937,1640,84,73,177,410,1198,2123,6642
"72035260700",979,1167,151,61,121,445,1251,1664,5839
"72035260800",1718,1072,154,81,345,275,2202,1397,7244
"72035260901",2421,493,96,10,539,72,2979,575,7185
"72035260902",1578,1484,27,64,612,331,2200,1879,8175
"72037160100",0,0,0,0,0,0,0,0,0
"72037160201",2028,1002,183,71,1036,704,3239,1777,10040
"72037160202",1157,1207,39,42,635,514,1798,1763,7155
"72037160300",1886,1102,170,167,573,836,2629,2079,9442
"72037990000",0,0,0,0,0,0,0,0,0
"72039955600",2121,3043,22,0,61,12,2198,3055,10512
"72039955700",961,1947,0,1,83,38,1044,1986,6060
"72039955800",2474,2654,61,49,91,26,2599,2729,10683
"72039955900",1279,3370,32,11,104,37,1415,3407,9655
"72041240101",2700,917,84,16,842,351,3593,1284,9787
"72041240102",2006,1255,13,0,719,241,2718,1496,8448
"72041240201",1782,1216,53,19,1159,466,2976,1700,9371
"72041240202",1832,1440,90,99,463,486,2385,2025,8820
"72041240300",1166,511,61,27,210,122,1418,660,4175
"72041240401",2169,1049,303,22,753,421,3214,1492,9423
"72041240402",1698,994,91,21,396,521,2185,1536,7442
"72041240500",1864,1816,74,26,345,376,2283,2217,9001
"72041240601",1973,1634,113,168,685,750,2771,2552,10646
"72041240602",1982,1269,13,154,673,364,2646,1775,8876
"72043953900",958,948,91,21,197,342,1246,1311,5114
"72043954000",1024,1309,36,154,280,515,1340,1978,6636
"72043954100",427,1134,101,172,188,557,716,1863,5158
"72043954200",2670,1880,165,333,854,801,3666,2995,13364
"72043954300",565,893,39,172,87,253,691,1318,4018
"72043954400",996,854,42,52,192,281,1230,1187,4834
"72043954500",2169,3137,181,269,1150,1385,3482,4779,16552
"72043954600",1781,1225,196,119,814,938,2791,2282,10146
"72043954700",3375,1859,198,196,900,930,4473,2930,14861
"72045951700",1519,1652,46,130,202,864,1767,2628,8808
"72045951800",1561,1598,36,0,1066,1792,2663,3390,12106
"72045951900",586,1317,37,0,79,867,682,2167,5735
"72045952000",437,975,25,14,489,441,951,1430,4762
"72045952100",1601,1155,93,123,604,1281,2298,2559,9714
"72047530100",914,579,70,42,855,1191,1839,1805,7295
"72047530200",1564,1045,22,15,1717,2145,3303,3194,13005
"72047530300",969,913,9,0,730,1863,1708,2776,8968
"72047530400",1565,777,25,0,2052,2397,3642,3174,13632
"72047530500",1978,1633,48,0,2068,2663,4035,4254,16679
"72047530600",1014,1562,0,0,1719,2593,2733,4116,13737
"72049950500",440,423,40,40,206,329,674,720,2872
"72049990501",0,0,0,0,0,0,0,0,0
"72051540100",1373,947,232,217,253,232,1858,1396,6508
"72051540200",2481,702,407,39,214,235,2958,856,7892
"72051540300",1018,779,214,205,208,195,1440,1179,5238
"72051540400",5511,960,615,344,758,365,6627,1651,16831
"72051540500",3431,1926,769,614,674,548,4624,3070,15656
"72051540600",1776,1393,520,615,163,464,2396,2450,9777
"72051540700",3179,1948,298,538,411,399,3869,2843,13485
"72051990021",0,0,0,0,0,0,0,0,0
"72053150102",1119,590,163,71,415,268,1697,924,5247
"72053150104",1781,988,190,177,673,295,2596,1453,8153
"72053150200",2534,1257,287,111,838,259,3651,1609,10546
"72053150301",1126,972,175,244,440,1080,1741,2296,8074
"72053150302",677,523,105,25,220,322,1002,860,3734
"72053150400",1580,770,187,221,432,828,2157,1819,7994
"72053150500",1263,1251,190,296,701,1347,2154,2894,10096
"72053150601",769,633,170,75,572,415,1511,1123,5268
"72053150602",2519,1072,447,88,1371,864,4254,2024,12639
"72053990103",0,0,0,0,0,0,0,0,0
"72054580100",2327,2952,9,0,44,0,2380,2938,10650
"72054580200",3334,3916,0,0,0,52,3334,3954,14590
"72055960900",1914,2586,31,98,29,75,1974,2738,9445
"72055961000",935,1175,27,32,23,281,900,1488,4861
"72055961100",785,2470,32,59,100,127,917,2640,7130
"72055961200",457,862,38,71,48,85,543,1018,3122
"72055961300",746,1533,11,50,11,212,739,1783,5085
"72055961400",840,656,31,44,33,42,904,742,3292
"72055961500",876,1440,7,95,14,7,897,1501,4837
"72055990000",0,0,0,0,0,0,0,0,0
"72057270100",2297,1669,112,287,532,476,2929,2407,10709
"72057270201",1574,1728,280,251,965,1220,2819,3111,11948
"72057270202",493,866,145,113,177,411,815,1390,4410
"72057270300",2446,1847,562,445,766,510,3774,2802,13152
"72057270400",689,1475,95,243,102,161,886,1879,5530
"72057270500",2738,1539,679,287,519,285,3936,2111,12094
"72057270600",784,1295,182,297,152,639,1118,2231,6698
"72057270700",930,822,206,366,261,553,1397,1741,6276
"72057270800",2868,2621,438,197,624,708,3930,3526,14912
"72057992600",0,0,0,0,0,0,0,0,0
"72059740101",1184,1627,0,20,66,113,1209,1760,5979
"72059740102",1615,1788,12,14,128,55,1733,1826,7171
"72059740200",2426,2437,100,108,261,185,2780,2730,11027
"72059740300",1659,1486,72,60,124,68,1855,1614,6938
"72059740400",1990,3228,148,25,160,18,2298,3271,11138
"72059990001",0,0,0,0,0,0,0,0,0
"72061040101",696,800,89,62,379,352,1163,1214,4755
"72061040102",629,717,254,314,355,226,1219,1224,4938
"72061040103",564,778,155,114,268,494,987,1383,4743
"72061040200",2706,398,70,96,267,299,2978,778,7592
"72061040301",1235,138,30,8,63,0,1297,146,2917
"72061040302",1871,214,26,0,90,118,1916,331,4566
"72061040303",1288,129,70,0,182,0,1532,129,3330
"72061040304",4627,333,104,126,276,156,4891,601,11114
"72061040403",4101,832,298,227,610,459,4994,1518,13039
"72061040411",3347,763,36,148,234,518,3557,1429,10032
"72061040412",1507,157,55,9,48,0,1567,166,3509
"72061040421",5946,1007,350,128,961,542,7050,1677,17661
"72061040422",1736,476,226,84,179,306,2104,841,5952
"72061040432",2017,638,113,23,269,136,2377,768,6341
"72061040442",2581,268,34,17,478,263,3084,477,7202
"72061040500",2235,919,157,37,406,166,2778,1122,7820
"72061040601",2275,1344,132,47,756,604,3163,1995,10316
"72061040602",7561,721,384,55,1036,182,8646,958,19543
"72061040700",3791,2201,249,97,1072,989,5112,3287,16798
"72061040800",1333,1473,103,38,526,374,1922,1885,7654
"72061040900",1966,903,87,0,293,455,2329,1358,7391
"72061041000",1104,413,60,72,527,560,1670,1045,5451
"72061041100",1882,1222,10,14,712,286,2534,1510,8170
"72063210100",1647,1350,151,73,439,686,2229,2109,8684
"72063210201",885,926,45,41,459,502,1389,1469,5716
"72063210202",3002,2080,708,502,2452,1369,6162,3916,20191
"72063210300",279,989,179,179,322,539,772,1692,4951
"72063210400",1417,1104,186,302,870,737,2473,2126,9215
"72063210502",7363,770,367,269,2838,615,10498,1632,24352
"72063210503",1522,196,191,34,429,207,2142,437,5158
"72063210504",2386,1370,631,630,884,759,3857,2716,13233
"72065310100",4459,2788,115,0,172,346,4725,3134,15739
"72065310200",2179,2663,9,43,285,127,2345,2833,10484
"72065310300",3679,2399,50,51,246,105,3927,2497,12954
"72065310400",4481,3724,32,43,75,317,4525,4055,17252
"72065310500",4472,3373,0,43,36,63,4458,3479,15924
"72065310600",2198,3168,0,20,70,59,2268,3247,11030
"72065990016",0,0,0,0,0,0,0,0,0
"72067820100",2139,1189,163,12,2758,1535,4972,2691,15459
"72067820300",2040,565,138,42,1356,617,3427,1218,9403
"72067820400",702,748,0,52,298,259,987,1059,4105
"72067820500",1060,374,112,26,643,145,1815,537,4712
"72069180100",1576,1054,284,332,915,873,2767,2238,10039
"72069180201",1144,661,60,17,498,354,1693,999,5426
"72069180202",1950,1240,412,67,925,1249,3048,2544,11435
"72069180301",1117,561,42,57,948,672,2107,1290,6794
"72069180302",1510,1271,86,110,595,882,2178,2263,8895
"72069180400",1700,1430,341,153,561,923,2602,2506,10216
"72069180500",2632,887,154,87,1245,345,3978,1319,10647
"72069180600",1346,1458,160,212,496,1172,1986,2832,9662
"72069180700",1721,1744,193,151,709,721,2614,2595,10448
"72069180800",2365,1519,158,107,1034,883,3459,2475,12000
"72069180901",1280,832,30,238,725,1123,2035,2180,8443
"72069180902",2694,724,95,10,931,514,3562,1238,9768
"72069991800",0,0,0,0,0,0,0,0,0
"72071410100",2042,1680,80,48,951,991,2991,2719,11502
"72071410200",642,1207,145,113,307,507,1094,1804,5819
"72071410300",1215,1078,47,80,193,388,1444,1546,5991
"72071410401",971,1444,105,42,327,485,1383,1971,6728
"72071410402",2364,2904,247,291,933,1089,3532,4240,15600
"72071410500",2846,1913,175,129,829,753,3817,2732,13194
"72071410600",1142,2109,45,125,407,1277,1594,3511,10210
"72071410701",1113,861,11,269,336,689,1460,1797,6536
"72071410702",1542,2654,146,378,949,1400,2637,4395,14101
"72071990000",0,0,0,0,0,0,0,0,0
"72073956000",2140,2680,70,103,746,160,2956,2932,11787
"72073956100",968,1223,0,157,126,147,1085,1517,5223
"72073956200",3285,3264,109,108,465,625,3859,3997,15712
"72075710102",1202,1867,71,181,615,1267,1870,3301,10374
"72075710200",1420,1636,140,275,805,1276,2352,3187,11091
"72075710301",2129,942,207,134,309,412,2562,1485,8180
"72075710302",1891,1127,161,184,617,548,2649,1859,9036
"72075710400",426,1161,23,111,283,293,732,1565,4594
"72075710500",307,429,207,32,120,226,634,687,2642
"72075710600",942,476,88,62,231,194,1261,732,3986
"72075710700",604,672,14,53,234,240,852,965,3634
"72075710800",2116,2181,171,268,800,883,3087,3286,12792
"72075710901",1807,1399,163,338,867,1075,2837,2812,11298
"72075710902",1675,1860,255,521,528,1555,2458,3936,12788
"72075711002",944,1080,272,379,709,1153,1889,2596,9022
"72075990001",0,0,0,0,0,0,0,0,0
"72077500100",3161,3097,124,22,506,610,3791,3729,15040
"72077500200",3556,2209,343,234,481,307,4333,2714,14177
"72077500301",4391,2271,234,150,282,629,4907,2949,15813
"72077500302",2705,2823,97,46,240,610,3042,3442,13005
"72077500401",2202,2792,185,61,348,334,2704,3187,11813
"72077500402",2480,1978,31,46,236,415,2747,2439,10372
"72079850101",1056,1922,39,12,0,11,1095,1945,6080
"72079850102",2547,3311,120,13,19,10,2686,3334,12040
"72079850200",1987,2614,64,37,145,21,2166,2672,9706
"72079850300",1785,3769,93,47,66,108,1944,3858,11670
"72079850400",1597,3530,137,0,190,142,1924,3672,11192
"72079991100",0,0,0,0,0,0,0,0,0
"72081957700",1805,2697,38,7,49,180,1892,2870,9538
"72081957800",1903,4063,44,0,15,191,1962,4230,12408
"72081957900",2065,2652,0,36,15,117,2061,2805,9751
"72081958000",1228,2280,9,0,60,84,1284,2364,7309
"72081958100",837,1101,0,7,37,26,874,1134,4016
"72081958200",1460,2063,0,73,4,88,1464,2224,7376
"72081958300",599,1686,0,10,0,111,599,1807,4812
"72081958400",884,1021,20,6,119,13,978,1040,4081
"72083959700",892,1831,24,7,45,4,939,1828,5570
"72083959800",611,642,0,0,16,6,627,646,2548
"72083959900",2467,2860,6,121,0,92,2473,3038,11057
"72085190101",2041,2928,148,275,1105,1403,3294,4585,15779
"72085190102",4492,2187,191,36,1596,910,6242,3133,18787
"72085190201",1172,1756,99,69,667,447,1925,2272,8407
"72085190202",1006,1381,109,267,351,132,1466,1780,6492
"72085190301",2058,2974,317,122,1831,1457,4206,4535,17500
"72085190302",1652,1945,138,64,691,571,2481,2580,10122
"72087110101",249,84,486,769,461,818,1196,1666,5729
"72087110102",141,168,541,452,444,562,1126,1182,4616
"72087110200",145,162,221,490,519,727,885,1379,4528
"72087110301",345,499,653,487,884,1394,1882,2380,8524
"72087110302",260,271,1250,301,1072,883,2582,1447,8066
"72087110303",1375,514,364,210,579,127,2318,851,6338
"72087110304",1879,500,862,299,753,318,3494,1111,9216
"72087110400",161,311,299,488,96,864,556,1663,4438
"72087110500",93,143,268,282,151,262,512,687,2398
"72087110600",170,122,890,695,311,327,1371,1144,5030
"72087990000",0,0,0,0,0,0,0,0,0
"72089140101",1324,492,299,120,715,355,2324,950,6579
"72089140102",1158,1148,156,18,760,574,2063,1740,7617
"72089140201",582,961,103,280,138,669,716,1826,5275
"72089140202",1983,820,264,249,746,787,2929,1856,9634
"72089140300",1538,785,181,227,1288,1095,2926,2078,10118
"72089990001",0,0,0,0,0,0,0,0,0
"72091570100",3195,2407,169,104,397,330,3716,2814,13132
"72091570201",3358,1937,34,21,335,185,3706,2128,11704
"72091570202",1815,1267,182,0,383,80,2350,1329,7406
"72091570300",1064,1960,21,46,77,253,1162,2259,6842
"72091570400",1325,1699,58,212,73,284,1446,2195,7292
"72091570500",2598,1707,229,55,303,238,3051,1938,10119
"72091570600",1463,1849,39,53,154,151,1648,2006,7363
"72091570700",1587,2204,66,18,121,181,1774,2389,8340
"72091570800",3542,2453,208,102,113,380,3772,2917,13487
"72091990025",0,0,0,0,0,0,0,0,0
"72093960100",1809,2388,18,18,24,142,1851,2539,8789
"72093960200",960,1088,30,8,15,52,1005,1148,4306
"72095951400",1483,1742,739,621,1148,1345,3370,3708,14156
"72095951500",311,825,462,746,303,845,1076,2416,6984
"72095951600",440,345,142,214,240,82,822,629,2914
"72095990000",0,0,0,0,0,0,0,0,0
"72097080100",57,232,16,45,170,490,243,767,2020
"72097080200",371,268,33,33,94,1125,498,1405,3827
"72097080300",333,516,87,39,304,1107,724,1662,4772
"72097080400",157,135,27,16,167,484,351,635,1972
"72097080500",159,231,71,21,218,420,433,672,2225
"72097080600",175,231,0,16,176,1335,344,1559,3836
"72097080800",887,445,215,8,439,711,1523,1146,5374
"72097080900",360,247,40,61,128,749,523,1057,3165
"72097081000",138,316,0,23,240,627,378,966,2688
"72097081100",194,183,9,38,125,238,328,459,1574
"72097081200",228,1308,0,280,306,3729,534,5304,11689
"72097081300",1306,479,27,23,490,544,1802,1033,5704
"72097081501",996,414,58,11,1041,2270,2077,2695,9562
"72097081512",1657,2456,258,228,365,344,2182,2956,10446
"72097081522",1179,116,84,31,1749,716,2941,846,7662
"72097081601",1253,406,0,0,2378,1511,3579,1912,11039
"72097081602",647,400,64,27,1575,1160,2249,1559,7681
"72097081700",577,568,181,33,965,1183,1715,1762,6984
"72097081800",1269,732,39,7,357,173,1628,895,5100
"72097081900",3114,1827,49,48,78,549,3174,2397,11236
"72097082001",2200,2656,258,42,688,269,3146,2942,12201
"72097082012",2381,1462,93,49,463,54,2918,1565,8985
"72097082022",2386,1428,22,25,72,93,2403,1546,7975
"72097082102",1361,1235,60,179,399,284,1820,1609,6947
"72097082103",2033,1988,155,122,254,318,2399,2404,9673
"72097082104",1141,1678,15,26,197,163,1341,1832,6393
"72097990000",0,0,0,0,0,0,0,0,0
"72099420100",2076,3059,110,253,976,271,3141,3478,13364
"72099420200",3127,3610,12,60,392,379,3482,4031,15093
"72099420301",1784,2745,108,23,249,613,2141,3363,11026
"72099420302",2031,1954,14,9,221,467,2266,2381,9343
"72099420401",1185,1729,22,16,157,127,1364,1870,6470
"72099420402",2154,2290,16,72,336,726,2506,3060,11160
"72099420500",3131,2094,0,0,540,356,3650,2450,12221
"72101955201",1756,2723,34,142,134,510,1924,3375,10598
"72101955202",2427,2513,77,0,361,391,2865,2904,11538
"72101955300",2827,4314,124,188,543,825,3494,5299,17614
"72101955401",3055,2624,24,12,506,699,3585,3335,13840
"72101955402",1188,1430,30,8,260,253,1478,1691,6338
"72101955500",642,1250,31,32,184,287,857,1568,4851
"72103170100",2086,2210,72,208,831,916,2918,3287,12528
"72103170200",2552,2632,43,0,570,818,3127,3391,13133
"72103170300",1739,1798,51,182,894,982,2684,2961,11291
"72103170400",2971,2660,243,190,850,1241,4045,4072,16272
"72103990013",0,0,0,0,0,0,0,0,0
"72105520100",1416,955,84,148,1856,1270,3356,2373,11458
"72105520200",849,1415,62,16,1195,1768,2106,3178,10589
"72105520300",355,377,10,111,449,1205,801,1693,5001
"72105520400",976,1484,61,86,2126,2617,3145,4187,14682
"72105520500",2129,1663,163,113,2903,2287,5144,4063,18465
"72107954801",1576,1928,16,147,288,456,1880,2508,8799
"72107954802",829,816,0,29,29,506,858,1351,4418
"72107954901",1025,2138,1,44,71,557,1097,2738,7671
"72107954902",559,786,0,44,111,285,670,1115,3570
"72107955001",1843,2285,0,147,288,524,2131,2941,10159
"72107955002",831,900,0,117,119,484,929,1501,4881
"72107955100",1098,1221,84,109,370,392,1552,1705,6531
"72109290100",1176,1296,230,544,408,597,1814,2437,8502
"72109290200",1275,2396,499,268,790,816,2564,3480,12088
"72109290300",1286,1747,311,250,607,900,2204,2887,10192
"72109290400",897,984,99,222,817,541,1783,1743,7086
"72109990000",0,0,0,0,0,0,0,0,0
"72111730100",2057,3231,9,0,252,278,2318,3437,11582
"72111730200",1137,1114,9,0,73,104,1208,1202,4847
"72111730300",2309,4253,118,153,97,494,2509,4832,14765
"72111730400",604,1170,84,16,166,108,826,1266,4240
"72111730700",1513,2150,92,209,87,222,1677,2581,8531
"72111730800",693,735,10,14,81,30,784,779,3126
"72111990000",0,0,0,0,0,0,0,0,0
"72113070100",2793,1665,93,38,339,206,3173,1909,10216
"72113070201",1049,1264,0,119,622,731,1645,2077,7507
"72113070202",352,934,0,169,153,327,505,1409,3849
"72113070300",768,1383,89,240,550,392,1407,2015,6844
"72113070400",241,1503,25,244,15,657,273,2404,5362
"72113070502",1755,1258,81,0,398,480,2227,1738,7937
"72113070503",2353,1036,8,35,377,221,2707,1268,8005
"72113070513",821,1358,35,108,420,601,1276,2059,6678
"72113070514",957,686,177,92,479,314,1613,1074,5392
"72113070522",1753,868,121,43,212,448,2069,1344,6858
"72113070800",308,915,16,115,84,442,408,1456,3744
"72113070900",404,1331,9,177,155,557,568,2065,5266
"72113071000",463,1001,28,55,78,173,569,1229,3596
"72113071200",717,891,125,227,273,388,1098,1506,5225
"72113071300",360,1720,72,314,226,815,658,2849,7014
"72113071401",1031,769,16,0,264,304,1305,1059,4748
"72113071402",2227,1445,66,42,322,109,2615,1596,8422
"72113071500",1343,1790,31,55,339,413,1713,2248,7932
"72113071601",1498,778,108,250,339,159,1914,1178,6224
"72113071602",425,1834,43,381,283,1346,751,3509,8572
"72113071700",494,610,117,11,393,179,929,790,3523
"72113071800",391,807,61,19,75,306,527,1113,3299
"72113071900",748,2112,112,210,524,1497,1384,3811,10398
"72113072000",1130,482,63,87,146,203,1329,772,4212
"72113072101",341,849,20,107,214,296,575,1252,3654
"72113072102",2216,1372,181,0,933,223,3330,1595,9850
"72113072201",953,968,123,259,556,667,1624,1885,7035
"72113072202",2785,824,218,58,802,338,3777,1220,10022
"72113072300",168,449,146,101,76,545,390,1095,2970
"72113072400",3400,1431,147,336,907,783,4454,2517,13975
"72113072500",3233,1964,265,74,1638,783,5115,2821,15893
"72113072600",982,1896,57,37,138,547,1177,2480,7314
"72113072701",1763,860,126,86,122,247,2011,1193,6408
"72113072703",2583,1765,70,50,232,191,2812,2006,9709
"72113072704",766,1539,16,107,45,364,827,2010,5674
"72113072900",4451,1789,192,61,410,225,4986,2075,14189
"72113073001",1221,1208,8,67,217,160,1446,1435,5762
"72113073002",1365,2714,8,46,300,252,1598,3012,9295
"72113073003",871,1115,15,25,14,19,837,1159,4055
"72113073004",1799,1841,17,25,416,232,2232,2072,8634
"72113073005",2173,783,127,7,276,31,2576,821,6794
"72113073006",1381,1779,44,14,154,410,1579,2197,7558
"72113073008",0,0,0,0,11,0,11,0,22
"72113073009",976,3085,62,81,117,888,1155,4031,10395
"72113073010",2253,1271,82,21,154,197,2489,1489,7956
"72113993000",0,0,0,0,0,0,0,0,0
"72115330100",3062,3307,140,91,928,986,4130,4367,17011
"72115330200",1520,2744,39,249,396,433,1955,3408,10744
"72115330300",1828,2528,154,80,462,888,2444,3468,11852
"72115330400",1776,2259,115,63,563,1035,2454,3319,11584
"72115990000",0,0,0,0,0,0,0,0,0
"72117959400",1936,1548,131,37,601,883,2357,2279,9772
"72117959500",1035,1076,14,162,406,675,1274,1746,6388
"72117959600",1945,1822,28,243,915,1618,2694,3548,12813
"72117990400",0,0,0,0,0,0,0,0,0
"72119130101",1754,1368,298,388,672,833,2695,2562,10570
"72119130102",2925,723,492,58,1217,116,4555,897,10983
"72119130200",562,658,177,86,233,545,972,1289,4522
"72119130300",1425,883,435,125,358,322,2213,1329,7090
"72119130401",1482,404,423,143,1216,499,3121,1046,8334
"72119130402",1160,1223,574,795,748,1345,2482,3363,11690
"72119130500",1656,1247,554,462,1475,838,3671,2547,12450
"72119130601",1163,490,88,270,698,631,1925,1376,6641
"72119130602",1586,775,131,179,862,779,2545,1705,8562
"72119130701",2361,1666,445,16,1428,1248,4234,2930,14328
"72119130702",1184,1271,464,294,1259,786,2907,2351,10516
"72119992700",0,0,0,0,0,0,0,0,0
"72121960300",2327,2713,26,137,116,98,2469,2866,10752
"72121960400",3142,1660,25,73,180,86,3289,1724,10179
"72121960500",697,895,0,6,0,67,670,945,3280
"72121960600",1704,1427,5,59,38,44,1747,1530,6554
"72121960700",2047,2354,118,116,158,122,2300,2546,9761
"72121960800",1674,2404,74,38,179,63,1927,2487,8846
"72123952600",855,1513,0,53,294,615,1149,2155,6634
"72123952700",364,702,59,117,381,643,804,1462,4532
"72123952800",1513,1990,137,271,1323,1681,2973,3942,13830
"72123952900",2246,2204,180,106,1331,1851,3757,4161,15836
"72123953000",723,892,79,230,338,804,1140,1926,6132
"72123953100",604,609,23,73,192,554,819,1216,4090
"72123953200",1257,1290,121,356,651,1185,2029,2803,9692
"72123992800",0,0,0,0,0,0,0,0,0
"72125840100",1775,2592,0,13,0,70,1775,2613,8838
"72125840200",2893,2835,0,0,21,55,2914,2890,11608
"72125840300",2982,1977,29,279,17,41,3028,2296,10649
"72125840400",3202,2355,174,88,69,129,3431,2572,12020
"72125840500",2038,1527,83,24,70,29,2184,1572,7527
"72125840600",2354,2016,16,126,160,41,2516,2183,9412
"72125840700",2364,1764,17,22,179,58,2549,1844,8797
"72127000400",337,251,50,134,59,114,427,485,1857
"72127000506",777,231,10,27,116,117,765,362,2405
"72127000600",582,564,38,351,141,233,750,1129,3788
"72127000700",546,526,51,127,68,76,655,717,2766
"72127000900",2028,333,83,29,148,42,1965,383,5011
"72127001000",3706,553,97,145,128,35,3597,642,8903
"72127001100",1132,209,18,11,162,42,1148,243,2965
"72127001200",1751,246,74,29,165,50,1850,296,4461
"72127001301",253,757,194,641,11,342,458,1740,4396
"72127001302",154,1975,173,1364,101,522,415,3797,8501
"72127001400",318,290,377,154,70,251,765,679,2904
"72127001500",954,411,178,195,130,202,1192,791,4053
"72127001600",1062,216,133,47,181,64,1376,327,3406
"72127001800",1183,266,143,139,153,292,1449,676,4301
"72127001900",2719,394,91,69,263,131,2958,594,7219
"72127002002",414,200,83,55,181,175,678,430,2216
"72127002100",550,293,67,345,254,175,824,778,3286
"72127002200",396,355,169,317,241,229,800,873,3380
"72127002300",219,232,297,133,257,263,753,617,2771
"72127002400",679,428,53,157,177,213,860,768,3335
"72127002500",451,468,440,147,124,133,990,736,3489
"72127002600",673,335,272,548,306,582,1251,1465,5432
"72127002800",477,735,441,412,187,506,1105,1643,5506
"72127002900",494,313,236,287,97,196,822,796,3241
"72127003000",333,305,220,443,257,300,798,1048,3704
"72127003100",596,642,557,623,222,226,1315,1452,5633
"72127003200",258,541,526,386,66,227,794,1154,3952
"72127003300",519,130,178,152,233,168,917,424,2721
"72127003400",542,1067,86,376,63,118,691,1541,4484
"72127003501",449,2183,119,934,161,935,718,4002,9501
"72127003502",517,540,220,230,183,236,920,981,3827
"72127003600",337,243,51,178,50,115,438,536,1948
"72127003700",745,1238,526,1146,482,792,1745,3176,9850
"72127003800",511,206,416,479,321,474,1184,1144,4735
"72127003902",1075,1393,360,520,339,274,1766,2151,7878
"72127004200",742,503,375,542,143,180,1233,1187,4905
"72127004306",120,1214,28,199,0,769,138,2182,4650
"72127004400",490,527,171,264,237,233,898,991,3811
"72127004500",563,692,272,176,244,458,1074,1325,4804
"72127004600",1485,1108,213,254,369,413,2036,1765,7643
"72127004700",1570,1761,357,62,459,401,2345,2181,9136
"72127004800",131,1372,119,501,26,836,276,2690,5951
"72127004900",570,1264,285,1208,57,519,879,2974,7756
"72127005000",1619,1409,746,407,452,961,2795,2709,11098
"72127005101",848,438,243,90,229,251,1314,779,4192
"72127005102",610,607,128,176,187,418,900,1163,4189
"72127005103",444,1403,264,348,156,735,821,2458,6629
"72127005201",1235,516,471,178,275,129,1962,783,5549
"72127005202",1474,791,312,254,197,158,1940,1164,6290
"72127005204",1006,494,228,113,247,146,1481,753,4468
"72127005214",1404,1122,424,257,733,360,2493,1739,8532
"72127005215",697,785,398,281,221,561,1303,1548,5794
"72127005300",1106,774,611,282,315,397,1968,1379,6832
"72127005401",3925,1169,373,244,577,637,4806,2021,13752
"72127005402",109,856,66,289,86,579,261,1706,3952
"72127005403",2463,1332,284,544,543,799,3217,2640,11822
"72127005500",1846,661,516,271,682,735,3001,1622,9334
"72127005601",1730,489,521,166,484,196,2654,851,7091
"72127005602",1267,1330,634,758,310,520,2195,2514,9528
"72127005800",1392,382,264,23,305,162,1785,567,4880
"72127005900",537,593,74,44,169,100,780,737,3034
"72127006000",425,698,126,189,197,616,748,1462,4461
"72127006101",815,1597,235,324,233,781,1259,2694,7938
"72127006102",649,396,137,24,174,147,960,567,3054
"72127006200",777,701,131,204,103,141,995,1024,4076
"72127006300",2530,1326,310,41,384,202,3186,1503,9482
"72127006500",1267,290,40,23,156,6,1383,306,3471
"72127006600",484,694,99,33,140,147,723,826,3146
"72127006700",2371,775,175,53,375,119,2889,947,7704
"72127006800",3011,813,104,132,156,207,3271,1126,8820
"72127006900",1082,360,360,412,129,255,1562,1018,5178
"72127007004",1276,621,300,99,116,116,1676,836,5040
"72127007100",932,334,549,263,226,8,1691,583,4586
"72127007300",2188,675,259,77,580,52,3002,781,7614
"72127007400",984,414,300,230,69,276,1317,910,4500
"72127007500",533,562,344,353,157,289,1034,1204,4476
"72127007600",875,564,359,657,56,73,1290,1280,5154
"72127007700",965,694,619,581,134,162,1718,1437,6310
"72127007800",1847,1337,780,1276,84,133,2711,2746,10914
"72127007900",2047,449,153,112,153,0,2256,541,5711
"72127008001",1715,871,320,923,152,139,2118,1917,8155
"72127008002",1435,1705,484,1108,68,250,1961,3044,10055
"72127008100",1970,259,121,49,80,103,2048,411,5041
"72127008201",212,1593,99,852,142,29,453,2410,5790
"72127008202",1107,742,251,495,201,151,1524,1388,5859
"72127008300",894,409,266,448,98,314,1258,1171,4858
"72127008400",1918,590,524,394,262,76,2669,1022,7455
"72127008500",2057,933,530,270,64,130,2635,1325,7944
"72127008601",1356,191,138,9,37,3,1491,203,3428
"72127008602",2505,804,149,25,219,64,2753,862,7381
"72127008603",1546,263,80,67,44,26,1659,356,4041
"72127008700",527,673,103,257,252,274,850,1153,4089
"72127008900",304,549,508,155,259,774,1044,1457,5050
"72127009000",714,455,122,487,121,551,957,1479,4886
"72127009111",1411,673,404,159,559,151,2248,967,6572
"72127009112",1442,935,281,292,488,216,2136,1378,7168
"72127009121",2352,838,210,63,378,265,2849,1102,8057
"72127009122",3064,917,367,300,932,499,4139,1634,11852
"72127009123",1479,450,243,0,436,55,2108,489,5260
"72127009300",828,678,330,263,634,641,1767,1540,6681
"72127009400",917,346,163,128,318,178,1386,652,4088
"72127009601",1137,266,52,0,112,12,1248,271,3098
"72127009602",1333,260,90,90,197,135,1620,479,4204
"72127009603",1718,253,49,96,172,144,1929,493,4854
"72127009614",1491,138,26,13,159,0,1614,151,3592
"72127009624",2296,1116,49,166,822,568,3138,1781,9936
"72127009800",4640,579,279,48,285,109,5118,711,11769
"72127009901",2647,515,176,209,372,201,3133,925,8178
"72127009902",2025,1387,421,127,650,539,3082,2028,10259
"72127009903",2789,404,216,46,637,114,3550,548,8304
"72127009904",1891,239,53,2,199,13,2137,254,4788
"72127010001",3946,563,207,112,1223,189,5296,864,12400
"72127010002",4673,215,89,0,619,45,5357,260,11258
"72127010012",2864,726,154,253,1054,324,4062,1303,10740
"72127010022",2011,450,122,92,504,178,2599,720,6676
"72127010032",1804,1138,466,110,790,1084,3017,2332,10741
"72127010042",4038,874,244,147,2044,889,6281,1910,16427
"72127010100",3649,1076,385,226,1395,931,5404,2233,15299
"72127010200",2228,1542,626,372,1515,492,4326,2406,13507
"72127010500",2096,568,109,50,414,218,2562,836,6853
"72127980000",0,0,0,0,0,0,0,0,0
"72127980101",0,0,0,0,0,0,0,0,0
"72127980102",0,0,0,0,0,0,0,0,0
"72127980103",20,786,0,0,55,305,75,1091,2332
"72127980104",0,0,0,0,0,0,0,0,0
"72127980105",0,0,0,0,0,0,0,0,0
"72127980107",0,0,0,0,0,0,0,0,0
"72127980108",0,0,0,0,0,0,0,0,0
"72127980200",0,32,0,0,0,0,0,32,64
"72127980300",0,0,0,0,0,0,0,0,0
"72127990000",0,0,0,0,0,0,0,0,0
"72129220100",3502,1429,412,360,849,615,4750,2404,14321
"72129220200",907,2045,61,123,170,505,1138,2657,7606
"72129220300",614,799,9,0,74,103,685,814,3098
"72129220401",2563,1183,224,31,706,140,3493,1354,9694
"72129220402",2542,1980,127,167,433,275,3074,2422,11020
"72129220501",1717,1499,75,72,115,376,1892,1914,7660
"72129220502",2349,1394,31,35,498,607,2878,2036,9828
"72129220600",1018,1531,17,11,331,257,1335,1799,6299
"72129220700",1761,2674,66,253,281,443,2094,3354,10926
"72131009200",701,1734,24,14,15,168,725,1885,5266
"72131958500",1490,2591,45,20,52,288,1552,2889,8927
"72131958700",2913,2303,17,120,293,171,3223,2565,11605
"72131958800",3495,2304,59,24,146,248,3675,2530,12481
"72131958900",1114,1675,25,61,63,0,1202,1732,5872
"72131959000",2277,2347,35,21,124,86,2436,2446,9772
"72131959200",1875,2903,27,0,25,388,1886,3251,10355
"72131959300",1679,2585,0,17,99,233,1751,2784,9148
"72131959500",2016,2401,40,72,0,187,2030,2660,9406
"72133953300",1982,719,168,227,766,755,2897,1701,9215
"72133953500",913,1357,72,228,812,1101,1797,2686,8966
"72133953600",2359,1128,184,225,1405,1070,3948,2423,12742
"72133953700",792,583,106,104,254,334,1152,1021,4346
"72133953800",1403,1965,93,118,540,1468,2036,3551,11174
"72133990000",0,0,0,0,0,0,0,0,0
"72135510101",4644,775,546,20,2534,609,7724,1393,18245
"72135510102",1185,1488,349,289,409,695,1916,2472,8803
"72135510200",3501,1571,322,430,1812,1201,5583,3170,17590
"72135510300",850,538,333,141,351,714,1534,1393,5854
"72135510400",1010,1704,58,106,912,914,1954,2724,9382
"72135510502",2410,1395,159,204,743,514,3312,2113,10850
"72135510503",4030,1662,605,85,1515,1287,6150,3034,18368
"72135510504",2062,629,279,46,1214,605,3478,1280,9593
"72135510505",3184,381,280,101,636,178,4069,660,9489
"72135510601",1716,643,0,92,1954,521,3670,1256,9852
"72135510602",2201,1132,35,268,1377,1236,3613,2636,12498
"72135510701",1501,361,125,88,1066,459,2692,908,7200
"72135510702",1137,1532,176,219,977,1341,2290,3092,10764
"72137120200",1432,673,121,170,1042,407,2554,1250,7649
"72137120300",1141,456,177,164,640,220,1951,823,5572
"72137120400",647,238,79,37,474,251,1146,526,3398
"72137120500",652,225,206,20,388,225,1182,470,3368
"72137120600",1496,401,344,76,591,254,2431,731,6324
"72137120700",370,177,96,0,390,69,819,246,2167
"72137120800",1447,606,460,58,1031,477,2847,1106,8032
"72137120900",1713,377,375,58,1054,564,3142,952,8235
"72137121001",1350,532,359,102,985,315,2667,949,7259
"72137121002",1756,319,372,269,1255,296,3383,884,8534
"72137121100",609,344,390,250,1383,901,2367,1486,7730
"72137121200",345,451,62,147,1234,1392,1641,1934,7206
"72137121300",232,131,106,36,789,410,1127,577,3408
"72137121400",2405,278,421,48,1622,373,4360,699,10206
"72137121701",890,371,110,124,899,617,1892,1112,6015
"72137121702",744,1129,349,328,1341,2032,2414,3489,11826
"72137121801",1448,1965,207,294,685,1081,2325,3340,11345
"72137121802",1979,1863,398,60,608,365,2973,2266,10512
"72137121900",1791,727,394,71,342,238,2487,1036,7086
"72137122001",1646,1239,237,127,977,522,2860,1862,9470
"72137122002",1958,617,152,29,794,182,2904,828,7464
"72137122100",495,999,73,219,340,487,908,1705,5226
"72137122201",795,1468,51,132,391,576,1237,2176,6826
"72137122202",667,1016,239,143,554,382,1460,1541,6002
"72137122400",375,627,130,392,368,261,873,1263,4289
"72137990000",0,0,0,0,0,0,0,0,0
"72139060102",1904,469,212,143,711,114,2827,709,7089
"72139060103",1007,607,158,155,537,482,1702,1242,5890
"72139060104",2880,966,530,30,1618,518,5028,1514,13084
"72139060211",2685,1040,336,163,763,1084,3770,2273,12114
"72139060212",1913,992,223,338,755,1368,2815,2698,11102
"72139060213",1920,227,187,0,564,87,2635,314,5934
"72139060222",2495,827,541,156,1243,573,4226,1545,11606
"72139060223",1767,692,205,172,891,386,2847,1250,8210
"72139060301",2639,740,141,83,1708,439,4473,1262,11485
"72139060302",3977,1118,278,57,2197,811,6426,1986,16850
"72139060401",1510,913,72,56,756,341,2338,1310,7296
"72139060403",2778,519,232,25,710,232,3675,776,8947
"72139060404",2957,456,184,0,759,175,3844,631,9006
"72139060501",1493,1146,243,268,798,1057,2534,2471,10010
"72139060502",1073,1010,99,104,860,703,2021,1817,7687
"72141956900",1628,2584,87,127,131,371,1817,3039,9784
"72141957000",1953,2203,39,180,174,327,2166,2710,9752
"72141957100",1858,2157,56,60,187,141,2075,2358,8892
"72141957200",1924,2127,15,71,192,274,2098,2428,9129
"72141957300",2236,1849,58,42,302,98,2582,1989,9156
"72141957400",631,1466,38,7,21,79,680,1552,4474
"72141957500",1007,1668,0,89,68,148,1075,1889,5944
"72141957600",1606,1851,0,32,190,194,1796,2060,7729
"72143550100",4380,3250,353,448,372,416,5054,3966,18239
"72143550200",1535,2917,148,154,252,179,1855,3234,10274
"72143550300",2068,2050,31,133,245,118,2286,2259,9190
"72143550400",1547,2218,106,252,53,347,1629,2700,8852
"72143550500",2547,1299,489,458,341,626,3377,2382,11519
"72143550601",2101,2542,162,107,380,350,2621,2987,11250
"72143550602",1573,1388,457,317,204,222,2214,1906,8281
"72143990000",0,0,0,0,0,0,0,0,0
"72145560100",1726,2246,66,129,28,0,1789,2358,8342
"72145560201",2559,1789,59,12,257,28,2840,1761,9305
"72145560204",1617,1903,45,0,17,35,1662,1863,7142
"72145560300",1862,2694,58,82,171,35,2039,2693,9634
"72145560401",1396,1219,0,0,75,8,1441,1205,5344
"72145560402",3292,1942,263,46,240,52,3748,2010,11593
"72145560500",952,631,56,4,8,27,973,651,3302
"72145560600",2697,3599,154,23,109,96,2834,3547,13059
"72145560701",2844,2892,65,61,487,152,3360,2951,12812
"72145560702",3099,3155,258,52,243,39,3579,3190,13615
"72145560801",970,1644,37,18,113,1,1107,1602,5492
"72145560802",1281,2590,122,20,38,6,1427,2561,8045
"72145560900",1330,2176,45,136,164,14,1539,2201,7605
"72145990000",0,0,0,0,0,0,0,0,0
"72147950500",1930,1014,445,253,1045,956,3321,2192,11156
"72147950600",710,717,92,311,1018,732,1686,1710,6976
"72147990000",0,0,0,0,0,0,0,0,0
"72149720100",1534,1957,42,185,317,961,1893,3103,9992
"72149720300",2323,2174,40,35,1107,1096,3470,3281,13526
"72149720400",514,1004,45,31,182,341,741,1375,4233
"72149720502",1143,897,73,40,206,569,1422,1506,5856
"72149720503",1617,1690,34,74,489,1060,2127,2805,9896
"72149720504",1664,730,37,0,442,785,2143,1437,7238
"72151950600",2131,2405,420,294,972,1274,3499,3973,14968
"72151950700",1950,2015,91,297,910,262,2941,2574,11040
"72151950800",1258,1381,248,234,605,463,2111,2078,8378
"72151950900",1800,1730,136,185,541,709,2477,2569,10147
"72151951000",959,859,213,97,249,67,1411,1023,4878
"72151951100",717,1014,95,189,151,491,955,1689,5301
"72151951200",982,1610,216,180,645,640,1843,2413,8529
"72151951300",1681,2036,376,144,715,585,2759,2752,11048
"72151990000",0,0,0,0,0,0,0,0,0
"72153750101",629,1551,0,58,0,123,629,1732,4722
"72153750102",939,2298,0,64,112,15,1051,2365,6844
"72153750201",1355,1585,32,0,112,173,1486,1758,6501
"72153750202",1296,2625,14,38,59,229,1369,2862,8492
"72153750300",2375,1733,71,11,125,123,2497,1844,8779
"72153750400",1398,2392,61,61,115,213,1574,2651,8465
"72153750501",2774,2358,116,26,137,94,2998,2459,10962
"72153750502",1192,904,0,4,133,74,1317,967,4591
"72153750503",791,741,41,23,32,182,851,946,3607
"72153750601",3468,2046,135,143,81,99,3566,2288,11826
"72153750602",889,1947,110,44,38,160,999,2151,6338
