"id","whiteh","whitel","blackh","blackl","otherh","otherl","hisph","hispl","pop"
"01001020100",1536,144,105,29,55,15,14,0,1898
"01001020200",588,226,1055,164,137,5,59,0,2234
"01001020300",2133,277,428,299,86,47,44,0,3314
"01001020400",3493,141,264,0,373,1,321,0,4593
"01001020500",8046,379,1243,530,517,0,186,0,10901
"01001020600",2844,319,331,183,73,32,202,139,4123
"01001020700",1894,265,110,471,56,3,67,0,2866
"01001020801",2442,216,166,111,67,94,28,80,3204
"01001020802",8273,1055,628,393,108,0,86,104,10647
"01001020900",4188,674,637,46,79,0,24,0,5648
"01001021000",2192,53,633,285,21,15,25,0,3224
"01001021100",1279,90,1590,444,36,0,11,0,3450
"01003010100",2116,383,637,148,120,0,19,0,3423
"01003010200",1740,676,242,132,177,35,47,0,3049
"01003010300",5631,324,665,248,110,26,28,0,7032
"01003010400",3733,565,87,59,77,117,20,215,4873
"01003010500",3355,493,102,330,96,0,52,0,4428
"01003010600",1109,151,1425,836,0,0,92,0,3613
"01003010701",6948,383,278,0,336,0,377,0,8322
"01003010703",13727,415,657,1,626,104,746,0,16276
"01003010704",4597,57,219,0,58,82,318,5,5336
"01003010705",6566,963,1235,104,352,0,251,16,9487
"01003010800",5037,513,1447,902,22,0,35,0,7956
"01003010903",3893,425,306,360,40,210,238,72,5544
"01003010904",5782,495,47,15,157,0,154,0,6650
"01003010905",5748,566,479,139,375,113,587,156,8163
"01003010906",4335,458,82,7,86,0,388,0,5356
"01003011000",2614,1021,268,4,206,68,111,17,4309
"01003011101",7742,877,0,226,354,141,436,55,9831
"01003011102",3649,367,45,0,86,41,121,0,4309
"01003011201",3502,575,173,28,150,15,56,34,4533
"01003011202",3989,183,742,250,176,101,104,5,5550
"01003011300",3858,469,140,160,44,0,40,202,4913
"01003011401",6952,1659,1323,65,344,0,155,413,10911
"01003011403",7559,584,65,0,231,119,365,117,9040
"01003011405",3298,236,12,4,163,10,245,10,3978
"01003011406",2764,471,0,0,101,349,278,0,3963
"01003011407",3697,1171,0,0,337,31,95,0,5331
"01003011408",726,11,0,0,0,0,0,0,737
"01003011501",4526,935,19,54,125,0,149,284,6092
"01003011502",6937,1056,540,1533,442,270,555,137,11470
"01003011601",5095,1361,36,25,40,13,633,9,7212
"01003011602",4281,577,268,0,172,93,133,8,5532
"01003990000",0,0,0,0,0,0,0,0,0
"01005950100",1559,115,1218,455,41,170,0,170,3728
"01005950200",732,35,1297,760,19,0,27,0,2870
"01005950300",550,121,436,478,15,60,19,60,1739
"01005950400",1541,195,574,160,280,7,288,79,3124
"01005950500",2109,436,330,327,504,81,170,28,3985
"01005950600",907,231,323,193,61,140,48,126,2029
"01005950700",684,4,622,450,0,0,5,0,1765
"01005950800",1058,83,856,110,21,0,126,6,2260
"01005950900",1275,51,1240,1113,131,57,89,0,3956
"01007010001",2226,315,131,0,157,0,124,0,2953
"01007010002",4835,1199,222,53,36,29,190,108,6672
"01007010003",3388,305,615,354,66,31,0,0,4759
"01007010004",3981,676,1824,622,23,12,0,0,7138
"01009050101",5685,1317,184,163,142,34,659,527,8711
"01009050102",4942,1228,167,40,320,23,1052,492,8264
"01009050200",2762,511,2,3,287,0,480,68,4113
"01009050300",4044,1110,10,0,180,165,262,303,6074
"01009050400",3422,1226,0,0,58,18,133,100,4957
"01009050500",4742,1366,54,104,86,118,166,386,7022
"01009050601",3675,544,0,9,45,0,0,11,4284
"01009050602",8500,844,10,0,182,27,217,3,9783
"01009050700",7582,990,25,5,111,21,21,0,8755
"01011952100",109,11,1235,185,6,0,0,0,1546
"01011952200",1149,210,3011,820,91,0,331,94,5706
"01011952500",1069,65,1306,794,92,0,0,0,3326
"01013952700",983,340,587,310,18,0,0,0,2238
"01013952800",1014,133,375,42,0,0,0,0,1564
"01013952900",851,114,782,333,64,0,68,0,2212
"01013953000",746,84,267,213,64,0,0,0,1374
"01013953100",632,67,1338,1050,12,32,88,0,3219
"01013953200",1983,224,846,644,66,9,35,20,3827
"01013953300",1444,400,176,0,14,0,0,0,2034
"01013953400",741,239,963,622,9,7,0,0,2581
"01013953500",707,307,261,46,26,23,0,22,1392
"01015000200",825,302,1311,843,139,22,12,0,3454
"01015000300",237,185,1014,840,0,0,77,16,2369
"01015000400",310,391,1228,403,7,55,24,0,2418
"01015000500",78,25,589,744,63,1,63,20,1583
"01015000600",118,115,548,794,0,69,26,0,1670
"01015000700",1036,295,714,849,247,48,86,71,3346
"01015000800",472,104,441,223,52,6,4,16,1318
"01015000900",2495,139,436,353,126,0,36,0,3585
"01015001000",3976,270,1304,203,225,84,245,27,6334
"01015001100",4997,685,533,441,95,25,403,0,7179
"01015001201",1951,80,463,537,114,78,231,41,3495
"01015001202",2513,333,482,10,56,194,25,190,3803
"01015001300",1594,531,26,0,91,0,19,0,2261
"01015001400",1800,400,944,103,0,13,37,13,3310
"01015001500",3786,482,133,157,245,173,229,184,5389
"01015001600",1959,714,197,278,89,49,62,17,3365
"01015001700",3789,147,1557,279,680,11,372,0,6835
"01015001800",4207,1323,565,261,201,57,84,4,6702
"01015002000",5522,1038,18,111,221,30,192,299,7431
"01015002101",714,799,326,731,0,0,0,11,2581
"01015002102",2634,218,116,118,124,79,9,79,3377
"01015002103",3721,1706,679,558,311,31,349,59,7414
"01015002200",2926,574,60,48,101,6,34,0,3749
"01015002300",2134,1000,307,65,13,62,75,0,3656
"01015002400",3834,603,35,0,26,0,26,0,4524
"01015002501",6181,932,99,184,0,26,0,82,7504
"01015002502",3868,531,0,16,192,0,27,0,4634
"01015002600",3973,597,149,7,31,0,27,0,4784
"01015981901",4,0,0,0,0,0,0,0,4
"01015981902",0,0,0,0,0,0,0,0,0
"01015981903",0,0,0,0,0,0,0,0,0
"01017953800",2047,543,639,288,85,0,0,0,3602
"01017953900",1376,278,827,692,26,37,20,0,3256
"01017954000",2368,153,2419,1285,35,0,0,0,6260
"01017954200",2221,372,482,389,0,0,10,0,3474
"01017954300",2318,551,1122,698,214,0,24,0,4927
"01017954400",85,39,518,208,18,0,7,0,875
"01017954500",1530,121,1084,1050,17,18,53,44,3917
"01017954600",2092,258,393,192,0,9,0,0,2944
"01017954700",2605,500,944,370,137,0,0,0,4556
"01019955701",2416,560,239,49,67,16,20,13,3380
"01019955702",2772,1237,16,34,3,43,88,18,4211
"01019955800",4080,904,171,35,59,34,33,130,5446
"01019955900",3408,640,98,125,50,0,32,0,4353
"01019956000",3091,490,210,98,105,77,36,5,4112
"01019956100",3179,986,164,0,56,42,0,0,4427
"01021060101",2749,677,1006,360,112,10,0,296,5210
"01021060102",4241,923,287,338,220,16,347,0,6372
"01021060200",2350,340,45,0,0,0,0,0,2735
"01021060300",3083,527,20,0,97,0,253,45,4025
"01021060401",4410,630,343,71,364,75,516,75,6484
"01021060402",5715,1361,292,203,488,543,629,773,10004
"01021060500",2026,201,637,226,5,8,9,0,3112
"01021060600",2133,549,187,41,209,11,121,74,3325
"01021060700",3912,791,116,227,115,0,228,0,5389
"01023956700",712,55,1577,705,8,0,0,0,3057
"01023956800",2259,385,1124,471,39,0,0,47,4325
"01023956900",2584,290,670,158,38,3,0,2,3745
"01023957000",792,347,686,453,4,0,7,0,2289
"01025957500",950,222,153,73,10,0,10,0,1418
"01025957601",784,34,149,115,0,0,40,0,1122
"01025957602",2379,340,1662,496,112,0,0,0,4989
"01025957700",610,245,493,308,0,0,0,0,1656
"01025957800",1797,456,1385,1347,43,48,0,17,5093
"01025957901",2090,456,618,677,32,12,0,12,3897
"01025957902",1744,192,1149,772,37,23,0,23,3940
"01025958001",397,247,199,121,0,0,0,0,964
"01025958002",447,53,1011,520,0,0,0,0,2031
"01027958900",3788,331,716,279,125,38,185,0,5462
"01027959000",1833,495,259,253,147,45,216,23,3271
"01027959100",2072,484,0,44,0,114,0,0,2714
"01027959200",1550,353,325,45,0,0,0,0,2273
"01029959500",1883,325,0,3,3,0,14,0,2228
"01029959600",2510,652,230,48,43,110,62,175,3830
"01029959700",2668,590,76,8,102,120,21,59,3644
"01029959800",4516,835,19,0,87,0,0,0,5457
"01031010100",1386,426,118,7,171,79,11,30,2228
"01031010200",1385,289,122,10,40,68,5,0,1919
"01031010300",3735,463,287,167,242,40,100,3,5037
"01031010400",1285,283,212,107,91,21,59,0,2058
"01031010500",2168,368,773,617,29,46,74,39,4114
"01031010600",1111,348,35,7,72,15,0,3,1591
"01031010700",1781,160,50,4,142,70,168,11,2386
"01031010800",2205,346,36,14,90,26,78,50,2845
"01031010900",1321,395,577,202,42,23,56,60,2676
"01031011000",2699,337,363,213,120,15,257,65,4069
"01031011100",1271,168,169,249,39,33,88,48,2065
"01031011201",6004,528,514,110,663,77,357,145,8398
"01031011202",4964,911,1188,669,490,84,493,431,9230
"01031011300",1586,721,999,643,86,44,358,231,4668
"01033020100",2023,408,532,423,87,84,62,0,3619
"01033020200",1125,447,338,179,9,9,26,9,2142
"01033020300",704,219,508,345,25,16,4,0,1821
"01033020400",1236,57,0,0,118,0,4,0,1415
"01033020500",3656,737,251,159,127,74,0,0,5004
"01033020600",2139,482,826,242,341,77,106,0,4213
"01033020701",4043,402,666,576,109,31,0,0,5827
"01033020703",3788,272,1141,18,73,9,57,0,5358
"01033020704",3420,598,398,40,32,8,14,70,4580
"01033020801",3047,545,585,190,61,445,44,445,5362
"01033020802",2403,433,424,92,100,0,103,0,3555
"01033020901",3326,789,81,0,83,5,9,7,4300
"01033020902",2781,490,200,38,292,20,212,0,4033
"01033021000",2561,821,307,56,152,24,95,3,4019
"01035960200",751,91,632,153,121,0,29,0,1777
"01035960300",1125,262,125,90,67,4,15,0,1688
"01035960400",1086,428,1449,576,13,18,2,63,3635
"01035960500",688,207,384,315,60,81,87,10,1832
"01035960600",1797,310,352,1721,22,0,0,0,4202
"01037961000",1341,339,1490,636,133,0,68,40,4047
"01037961100",2925,556,267,39,15,0,0,0,3802
"01037961200",1991,235,575,385,26,0,114,16,3342
"01039961600",3414,288,37,52,7,0,0,0,3798
"01039961700",3100,733,407,106,35,22,111,0,4514
"01039961800",1853,337,271,252,36,10,57,5,2821
"01039961900",1899,228,189,57,0,75,57,0,2505
"01039962000",2205,684,517,184,83,35,104,0,3812
"01039962100",665,216,472,532,39,22,8,0,1954
"01039962300",2716,233,8,5,75,0,5,0,3042
"01039962400",2841,619,0,0,30,0,0,0,3490
"01039962500",953,327,85,0,94,0,0,0,1459
"01039962600",724,432,11,230,0,0,0,0,1397
"01039962700",835,120,331,354,13,0,16,0,1669
"01039962800",1364,190,0,0,81,4,0,2,1641
"01039962900",1357,226,94,4,113,0,18,28,1840
"01039963000",2348,652,320,174,131,76,108,27,3836
"01041963400",976,132,553,167,48,0,0,0,1876
"01041963500",1445,154,75,108,147,11,89,6,2035
"01041963600",2009,346,562,62,104,3,61,3,3150
"01041963700",1956,458,617,280,234,3,44,0,3592
"01041963800",910,122,507,122,63,33,0,26,1783
"01041963900",1021,313,140,44,4,0,0,0,1522
"01043964100",4298,774,35,8,66,7,42,0,5230
"01043964200",5538,1297,95,106,396,66,262,306,8066
"01043964300",3875,547,23,7,79,52,236,10,4829
"01043964400",3386,446,0,0,45,0,21,13,3911
"01043964500",3598,653,0,14,81,104,0,11,4461
"01043964600",3533,617,0,0,143,0,135,34,4462
"01043964700",4059,510,0,77,58,51,145,181,5081
"01043964800",3019,1137,7,16,183,110,136,343,4951
"01043964900",4789,1118,6,70,109,2,242,183,6519
"01043965000",4606,1269,0,0,38,144,119,306,6482
"01043965100",2727,882,0,0,177,0,122,184,4092
"01043965200",2116,278,0,12,49,28,0,20,2503
"01043965300",3911,990,6,1,83,8,149,50,5198
"01043965401",1808,287,75,13,83,60,17,7,2350
"01043965402",3020,923,18,5,52,24,0,0,4042
"01043965500",4538,648,271,45,138,7,24,86,5757
"01043965600",2023,330,0,0,0,0,0,18,2371
"01043965700",2058,595,0,0,9,16,41,0,2719
"01045020000",3453,130,250,101,268,0,889,41,5132
"01045020100",2734,482,257,81,38,33,11,23,3659
"01045020200",2181,143,60,0,19,11,85,0,2499
"01045020300",1986,180,248,97,26,0,0,0,2537
"01045020400",1661,198,154,35,49,45,18,0,2160
"01045020500",1107,167,284,249,33,5,59,8,1912
"01045020700",987,422,1033,720,53,37,42,7,3301
"01045020801",2095,160,933,189,261,51,75,112,3876
"01045020802",2501,384,633,385,104,120,22,97,4246
"01045021101",3154,392,410,235,193,253,388,127,5152
"01045021102",2023,803,858,287,208,193,58,240,4670
"01045021200",1604,324,204,150,88,97,48,94,2609
"01045021300",2986,410,394,78,193,34,98,10,4203
"01045021400",2933,798,695,501,209,134,124,40,5434
"01047956100",3188,433,1979,759,72,98,0,0,6529
"01047956201",1109,398,527,341,15,0,14,0,2404
"01047956202",1409,163,333,164,11,0,0,0,2080
"01047956300",319,61,1718,1114,51,0,0,0,3263
"01047956400",11,9,1227,1932,0,71,0,0,3250
"01047956500",91,96,1691,2163,8,6,0,0,4055
"01047956600",279,40,1957,1510,0,113,13,0,3912
"01047956701",1212,77,546,150,12,0,0,0,1997
"01047956702",545,174,350,376,64,0,61,0,1570
"01047956800",690,62,748,521,98,0,0,30,2149
"01047956900",461,0,1004,1099,0,0,0,0,2564
"01047957000",255,22,359,665,0,0,0,0,1301
"01047957100",512,17,606,271,10,2,0,0,1418
"01047957200",20,3,1024,776,0,0,0,0,1823
"01047957300",386,64,2166,1406,8,7,15,7,4059
"01049960100",4990,1324,0,0,345,47,6,0,6712
"01049960200",2792,613,61,0,286,0,248,36,4036
"01049960300",5600,973,17,17,217,52,234,47,7157
"01049960400",5285,434,172,0,99,0,0,0,5990
"01049960500",4361,795,17,3,390,18,49,6,5639
"01049960600",5177,639,0,0,355,381,427,368,7347
"01049960700",4969,1428,0,0,961,1340,1319,1539,11556
"01049960800",2407,922,66,148,259,287,402,644,5135
"01049960900",2288,640,218,33,80,46,329,226,3860
"01049961000",2923,823,37,7,41,159,446,478,4914
"01049961100",1966,517,109,9,284,0,286,40,3211
"01049961200",1799,117,3,0,71,9,169,0,2168
"01049961300",3649,1157,161,70,313,552,1243,1301,8446
"01049961400",3154,514,5,3,192,51,69,1,3989
"01051030100",5101,1003,322,64,40,0,24,0,6554
"01051030200",3460,391,284,190,84,13,0,0,4422
"01051030300",2216,67,82,10,0,0,9,0,2384
"01051030400",4916,274,1537,325,583,0,113,0,7748
"01051030500",3490,502,213,57,59,9,9,0,4339
"01051030600",3880,841,1026,216,42,0,111,67,6183
"01051030701",5225,377,846,18,238,23,37,0,6764
"01051030702",3278,292,292,67,124,0,182,0,4235
"01051030800",3826,354,1225,447,189,60,207,0,6308
"01051030901",4676,188,982,33,65,2,195,0,6141
"01051030902",2131,248,801,330,325,84,178,152,4249
"01051031000",4432,535,652,995,259,0,191,250,7314
"01051031100",3367,284,709,132,70,5,17,0,4584
"01051031200",656,60,538,229,179,21,170,17,1870
"01051031300",2137,403,546,480,146,71,102,71,3956
"01053969800",2758,869,902,843,132,27,137,67,5735
"01053969900",2707,640,662,111,20,104,49,0,4293
"01053970100",2440,639,730,92,49,0,18,0,3968
"01053970200",349,40,776,654,13,0,0,0,1832
"01053970300",2236,550,485,248,68,0,16,38,3641
"01053970400",1641,473,160,54,833,189,191,79,3620
"01053970500",3330,737,594,678,215,0,90,0,5644
"01053970600",518,120,1805,1623,42,20,17,0,4145
"01053970700",2254,416,516,80,198,102,42,0,3608
"01055000200",1152,546,926,423,93,64,0,0,3204
"01055000300",190,288,1019,1123,21,0,0,0,2641
"01055000400",3576,323,76,0,165,0,85,0,4225
"01055000500",1202,267,43,0,62,0,249,0,1823
"01055000600",925,681,193,96,53,0,92,81,2121
"01055000700",608,88,242,287,0,4,0,0,1229
"01055000800",189,198,416,300,0,44,16,46,1209
"01055000900",1350,829,264,185,34,164,62,118,3006
"01055001000",367,267,406,557,33,100,39,57,1826
"01055001100",4013,298,158,99,236,0,61,8,4873
"01055001200",1564,596,267,320,165,39,19,121,3091
"01055001300",899,336,640,398,13,16,9,0,2311
"01055001600",720,61,2147,588,86,0,142,0,3744
"01055001700",564,127,490,148,37,6,0,0,1372
"01055010100",1091,376,275,153,14,48,0,43,2000
"01055010200",3870,689,369,19,71,107,323,8,5456
"01055010300",2421,193,69,30,65,0,0,0,2778
"01055010401",2096,715,267,145,79,11,25,18,3356
"01055010402",4372,854,260,0,68,0,111,2,5667
"01055010501",7589,327,61,53,137,2,552,0,8721
"01055010502",4281,557,184,21,45,56,0,0,5144
"01055010601",5510,302,0,0,21,0,33,0,5866
"01055010602",3112,268,0,0,136,7,56,0,3579
"01055010700",3028,434,309,51,47,0,45,7,3921
"01055010800",1932,624,0,6,93,42,78,23,2798
"01055010900",1226,217,22,13,6,0,10,0,1494
"01055011001",3782,700,30,0,108,14,74,41,4749
"01055011002",4741,625,135,0,66,5,295,34,5901
"01055011100",3463,962,18,0,93,16,49,67,4668
"01055011200",554,598,582,551,13,402,84,463,3247
"01057020000",1307,350,8,0,0,2,0,0,1667
"01057020100",2645,401,139,7,12,70,11,22,3307
"01057020200",3096,530,390,245,31,17,46,19,4374
"01057020300",2275,457,540,560,50,41,6,17,3946
"01057020400",2731,741,48,30,2,41,0,0,3593
"01059972900",2484,482,203,0,0,39,88,76,3372
"01059973000",2792,1719,486,104,429,434,1257,1167,8388
"01059973100",2339,312,0,0,19,22,29,0,2721
"01059973200",2641,682,186,339,267,115,710,265,5205
"01059973300",2077,749,84,0,125,0,659,485,4179
"01059973400",1969,692,0,46,0,0,13,0,2720
"01059973500",1857,232,6,0,55,0,25,0,2175
"01059973600",1451,476,6,4,36,34,59,0,2066
"01059973700",4116,1076,0,0,76,44,26,20,5358
"01061050100",3363,890,280,298,93,64,144,29,5161
"01061050200",1600,254,102,233,44,33,0,0,2266
"01061050300",3533,1206,299,144,161,116,40,0,5499
"01061050400",3750,932,369,235,199,112,84,288,5969
"01061050500",3251,452,368,81,0,75,128,59,4414
"01061050600",2940,756,74,36,28,66,122,53,4075
"01063060000",172,17,842,579,0,0,0,5,1615
"01063060100",738,137,2046,1042,125,0,34,0,4122
"01063060200",314,168,1302,1261,7,0,0,0,3052
"01065040000",1900,297,876,147,86,0,71,0,3377
"01065040100",766,130,366,206,14,0,0,0,1482
"01065040200",710,53,532,258,60,10,60,0,1683
"01065040300",218,48,1029,807,0,0,0,0,2102
"01065040400",1013,235,1971,1630,24,0,0,0,4873
"01065040500",552,51,732,305,31,36,31,2,1740
"01067030100",995,129,743,168,10,0,0,0,2045
"01067030200",869,279,1082,366,261,0,41,0,2898
"01067030300",2099,336,247,112,35,0,26,0,2855
"01067030400",1155,210,235,152,0,20,119,25,1916
"01067030500",4253,245,1180,246,28,0,18,0,5970
"01067030600",1144,190,176,25,19,48,146,43,1791
"01069040100",4051,498,153,78,115,169,294,104,5462
"01069040201",7551,386,629,105,505,11,134,9,9330
"01069040202",7124,360,654,159,385,14,223,17,8936
"01069040301",2019,170,977,412,110,37,113,0,3838
"01069040302",1357,286,1187,553,146,33,160,30,3752
"01069040400",1943,117,186,272,38,17,34,0,2607
"01069040500",2503,259,390,183,76,6,48,59,3524
"01069040600",109,159,833,865,10,74,33,45,2128
"01069040700",1320,361,605,439,60,28,16,51,2880
"01069040800",5396,846,876,371,214,152,199,230,8284
"01069040900",3102,326,944,248,174,26,138,43,5001
"01069041000",1393,363,1991,1264,137,138,63,49,5398
"01069041100",2057,413,779,286,186,52,168,81,4022
"01069041200",674,252,734,682,82,47,80,54,2605
"01069041400",451,65,1288,1017,119,25,17,3,2985
"01069041500",795,94,2036,1208,27,44,28,3,4235
"01069041600",2912,471,1262,433,156,76,140,24,5474
"01069041700",948,124,155,52,2,15,40,0,1336
"01069041800",1306,159,395,117,26,7,16,0,2026
"01069041900",5438,767,642,323,322,47,48,93,7680
"01069042000",4441,773,388,153,91,28,42,12,5928
"01069042100",6004,1183,212,32,34,0,57,230,7752
"01071950100",4405,1051,0,0,199,19,0,0,5674
"01071950200",2440,381,131,189,177,90,53,11,3472
"01071950300",4462,904,249,118,65,139,24,130,6091
"01071950400",1592,330,1,0,96,76,20,43,2158
"01071950500",3050,688,4,27,106,40,38,10,3963
"01071950600",3827,966,386,146,261,101,78,5,5770
"01071950700",3687,236,3,16,133,0,23,0,4098
"01071950800",2817,771,93,111,103,209,53,377,4534
"01071950900",5131,459,144,0,126,0,210,0,6070
"01071951000",3092,902,7,0,352,24,3,3,4383
"01071951100",5401,1329,15,6,316,239,65,246,7617
"01073000100",295,198,1472,801,10,105,23,115,3019
"01073000300",171,330,1149,527,317,0,162,287,2943
"01073000400",151,130,1653,1458,23,13,25,0,3453
"01073000500",38,181,1915,1553,30,18,52,0,3787
"01073000700",0,0,1019,1461,0,60,0,65,2605
"01073000800",15,46,2870,1010,76,22,56,0,4095
"01073001100",0,0,3521,1144,15,0,0,0,4680
"01073001200",156,69,1893,746,114,0,233,107,3318
"01073001400",54,0,1484,558,4,0,0,0,2100
"01073001500",64,46,1714,1042,10,41,0,0,2917
"01073001600",193,107,1278,1455,122,69,160,60,3444
"01073001902",59,104,1058,576,65,42,80,103,2087
"01073002000",397,407,1774,975,29,0,66,13,3661
"01073002100",389,122,1496,628,0,0,0,0,2635
"01073002200",140,27,1574,839,0,18,0,38,2636
"01073002303",40,19,1567,2124,9,92,0,0,3851
"01073002305",2139,124,387,367,33,0,90,0,3140
"01073002306",2398,235,822,158,224,0,107,0,3944
"01073002400",947,253,894,1511,88,5,176,40,3914
"01073002700",1023,359,682,606,79,9,27,27,2812
"01073002900",0,27,1050,963,0,22,0,0,2062
"01073003001",184,27,1721,240,0,0,60,0,2232
"01073003002",0,141,1134,1416,8,0,0,133,2832
"01073003100",96,16,1982,1435,0,21,2,21,3573
"01073003200",0,95,522,505,0,0,0,0,1122
"01073003300",0,1,547,422,0,0,0,0,970
"01073003400",96,127,1174,1018,5,0,13,16,2449
"01073003500",203,78,1671,945,0,11,0,0,2908
"01073003600",165,9,3212,627,0,0,0,0,4013
"01073003700",148,5,3124,1109,226,9,137,0,4758
"01073003802",296,73,3899,1415,0,10,13,0,5706
"01073003803",84,1,2204,1256,0,0,0,0,3545
"01073003900",50,49,828,731,0,0,50,49,1757
"01073004000",48,0,2185,1296,15,0,32,0,3576
"01073004200",3,7,1507,640,0,3,1,3,2164
"01073004500",276,136,353,1157,140,76,0,8,2146
"01073004701",2746,541,99,49,216,0,263,59,3973
"01073004702",2752,250,73,187,19,33,7,32,3353
"01073004800",1624,156,116,31,81,7,72,0,2087
"01073004901",693,124,152,11,51,59,17,16,1123
"01073004902",1632,638,260,159,253,192,205,86,3425
"01073005000",1531,510,479,185,507,89,637,252,4190
"01073005101",0,8,780,1080,15,13,15,6,1917
"01073005103",210,330,1835,376,27,197,82,259,3316
"01073005104",775,454,1454,980,325,48,649,142,4827
"01073005200",0,0,2284,1159,56,21,0,0,3520
"01073005302",1503,177,1630,184,107,0,0,0,3601
"01073005500",203,363,933,789,19,0,22,39,2368
"01073005600",3091,624,368,283,0,81,19,0,4466
"01073005701",36,0,1902,623,15,0,15,0,2591
"01073005702",11,16,2410,1063,0,2,0,2,3504
"01073005800",960,453,1056,865,253,160,353,179,4279
"01073005903",1113,265,2651,639,69,0,33,166,4936
"01073005905",1061,217,3087,713,62,206,316,206,5868
"01073005907",498,7,1547,47,68,0,62,0,2229
"01073005908",817,258,1758,545,27,0,95,163,3663
"01073005909",254,8,1927,276,32,0,0,0,2497
"01073005910",287,66,4004,904,16,65,8,34,5384
"01073010001",2596,411,849,151,104,216,37,171,4535
"01073010002",3307,444,1360,16,165,80,73,115,5560
"01073010100",14,16,885,822,0,0,0,0,1737
"01073010200",510,347,1089,552,0,248,0,248,2994
"01073010301",416,103,973,928,28,12,0,0,2460
"01073010302",70,19,2067,2047,16,69,58,0,4346
"01073010401",708,158,1464,490,47,0,35,0,2902
"01073010402",408,196,1085,318,188,5,176,0,2376
"01073010500",324,63,694,442,0,15,0,0,1538
"01073010602",88,19,3377,1867,171,61,158,0,5741
"01073010603",183,0,1800,392,15,0,26,0,2416
"01073010701",999,263,219,187,41,7,65,128,1909
"01073010702",3670,368,283,176,12,13,68,13,4603
"01073010703",2021,60,0,0,77,5,9,0,2172
"01073010704",2037,337,357,0,58,9,199,13,3010
"01073010705",3273,365,115,20,120,44,5,44,3986
"01073010706",2404,784,1472,192,334,40,12,0,5238
"01073010801",5021,167,88,0,229,0,117,0,5622
"01073010802",3492,73,0,11,13,4,44,4,3641
"01073010803",3211,218,2229,458,103,0,171,0,6390
"01073010804",2805,75,2,4,6,8,42,0,2942
"01073010805",6570,383,157,32,268,10,84,0,7504
"01073010900",1231,303,1645,1324,419,186,202,157,5467
"01073011001",3916,717,557,65,167,22,216,251,5911
"01073011002",754,166,565,516,12,13,27,5,2058
"01073011104",3529,236,3173,370,77,0,142,0,7527
"01073011107",9635,146,636,0,346,70,0,0,10833
"01073011108",3599,259,658,17,156,0,5,0,4694
"01073011109",3004,460,166,0,55,56,0,0,3741
"01073011110",4284,347,973,0,144,0,0,0,5748
"01073011111",6381,199,686,32,273,0,93,0,7664
"01073011205",1468,130,299,34,22,0,9,0,1962
"01073011206",4358,419,766,151,53,14,0,0,5761
"01073011207",1442,57,2804,693,101,0,42,0,5139
"01073011208",2790,178,681,75,77,0,30,79,3910
"01073011209",693,57,1606,1130,81,7,142,0,3716
"01073011210",1298,199,1494,479,219,0,234,0,3923
"01073011301",1946,389,218,212,306,9,303,0,3383
"01073011302",5563,724,38,20,34,1,40,0,6420
"01073011400",4837,892,656,40,153,18,48,128,6772
"01073011500",4592,577,1,0,106,0,0,0,5276
"01073011600",3136,563,119,128,80,0,26,35,4087
"01073011703",6829,452,1252,385,236,6,64,6,9230
"01073011704",3496,155,1,1,119,0,0,0,3772
"01073011705",6121,620,409,12,75,126,299,249,7911
"01073011706",1533,202,30,149,63,0,62,0,2039
"01073011802",2547,169,2792,1586,45,72,19,0,7230
"01073011803",1144,36,3018,947,247,0,117,0,5509
"01073011804",518,85,1659,529,67,143,45,118,3164
"01073011901",1059,623,220,271,327,69,290,209,3068
"01073011904",6,14,1798,395,6,58,0,58,2335
"01073012001",1758,370,1601,467,38,0,0,0,4234
"01073012002",3405,341,1741,728,590,36,607,0,7448
"01073012103",1496,344,1890,414,97,38,190,38,4507
"01073012104",1625,183,702,116,7,386,19,386,3424
"01073012200",2239,414,0,0,25,0,12,2,2692
"01073012302",3245,247,106,5,16,0,12,0,3631
"01073012304",1527,123,833,30,21,10,0,0,2544
"01073012305",2555,340,4718,130,6,0,37,0,7786
"01073012401",245,10,2975,468,6,37,0,0,3741
"01073012402",1023,236,1251,221,7,46,25,0,2809
"01073012403",1615,308,1158,211,106,0,0,0,3398
"01073012500",2187,544,990,463,15,28,8,0,4235
"01073012602",1909,348,637,384,43,6,68,33,3428
"01073012701",2041,685,481,48,193,205,517,737,4907
"01073012703",5187,229,369,54,250,46,720,116,6971
"01073012704",1869,169,39,0,32,8,73,0,2190
"01073012802",2136,165,118,17,114,43,117,37,2747
"01073012803",3640,324,79,51,191,8,36,0,4329
"01073012905",3669,184,168,4,148,8,34,0,4215
"01073012906",4982,490,432,0,378,67,36,272,6657
"01073012907",3084,363,494,18,531,0,198,0,4688
"01073012908",2196,100,1304,208,990,431,1011,431,6671
"01073012910",2579,118,483,0,237,25,43,11,3496
"01073012911",5460,202,0,0,122,0,0,0,5784
"01073012912",1106,167,1999,431,481,800,341,615,5940
"01073012913",1325,205,1535,280,958,341,884,402,5930
"01073012914",1725,346,29,3,156,0,132,0,2391
"01073012915",5263,105,323,55,507,0,33,0,6286
"01073013002",4,3,887,853,0,0,0,0,1747
"01073013100",155,0,2476,1942,0,0,14,0,4587
"01073013200",202,10,1542,615,0,0,0,0,2369
"01073013300",157,153,1685,734,317,430,328,532,4336
"01073013400",420,36,3213,501,95,0,0,0,4265
"01073013601",222,26,2655,633,5,102,18,83,3744
"01073013801",84,59,1061,590,70,23,70,18,1975
"01073013901",366,45,1021,291,34,0,15,0,1772
"01073013902",1189,189,659,163,15,12,0,17,2244
"01073014001",3289,521,0,34,11,15,0,0,3870
"01073014002",2733,472,730,0,14,31,15,0,3995
"01073014102",4173,295,292,98,53,39,27,0,4977
"01073014104",1647,84,1029,480,120,11,77,0,3448
"01073014105",757,128,2635,447,119,223,12,0,4321
"01073014203",8595,402,3072,0,642,22,244,0,12977
"01073014204",7558,363,1175,45,841,0,286,0,10268
"01073014301",1511,253,658,288,50,4,17,4,2785
"01073014302",3302,244,1764,370,346,10,102,64,6202
"01073014404",3619,156,801,276,276,91,181,60,5460
"01073014405",2862,86,350,6,390,9,48,0,3751
"01073014406",5155,35,261,54,683,0,121,0,6309
"01073014408",1461,218,1355,68,596,18,114,38,3868
"01073014409",2588,150,189,17,358,138,53,149,3642
"01073014410",3483,125,494,18,590,124,98,79,5011
"01073014412",4013,77,112,0,637,3,427,0,5269
"01073014413",7403,180,768,0,592,17,94,31,9085
"01075030000",3098,945,498,361,40,15,26,92,5075
"01075030100",3910,949,273,99,22,15,10,57,5335
"01075030200",2830,656,219,139,41,16,1,5,3907
"01077010100",407,391,153,165,5,36,81,0,1238
"01077010200",793,420,270,147,22,13,38,6,1709
"01077010300",8,19,615,687,15,21,0,0,1365
"01077010400",1344,595,444,105,147,36,9,19,2699
"01077010600",1166,853,422,180,154,137,86,103,3101
"01077010700",845,676,214,273,0,74,0,16,2098
"01077010800",2317,852,279,549,63,99,44,51,4254
"01077010900",5119,1006,512,248,236,35,183,79,7418
"01077011000",2424,980,824,430,190,35,193,12,5088
"01077011101",4352,445,585,0,159,29,17,0,5587
"01077011102",3155,410,394,67,65,0,0,0,4091
"01077011200",2981,508,320,115,114,0,39,151,4228
"01077011300",1633,382,0,0,29,0,30,8,2082
"01077011400",5724,990,11,1,104,11,101,78,7020
"01077011501",5130,446,270,0,122,0,86,14,6068
"01077011502",3749,953,23,14,69,140,0,0,4948
"01077011602",4785,621,12,2,29,0,24,0,5473
"01077011603",4064,438,111,1,26,0,376,0,5016
"01077011604",5938,686,159,4,193,0,73,53,7106
"01077011700",3525,447,58,8,108,74,29,0,4249
"01077011801",3791,560,0,34,74,2,52,0,4513
"01077011802",2767,418,129,64,73,12,56,0,3519
"01079979100",687,165,675,210,39,0,43,0,1819
"01079979200",1834,359,1480,342,35,106,28,8,4192
"01079979300",3200,402,0,0,781,39,94,24,4540
"01079979400",2558,646,245,247,365,72,64,0,4197
"01079979500",3893,810,131,0,583,235,0,0,5652
"01079979600",4242,710,165,10,638,130,110,177,6182
"01079979700",1535,269,48,20,160,39,0,0,2071
"01079979800",2798,375,5,0,248,0,44,48,3518
"01079979900",1235,463,50,23,177,79,0,17,2044
"01081040200",2545,1199,634,247,235,343,230,106,5539
"01081040300",1162,673,99,126,164,33,19,2,2278
"01081040400",3684,2001,739,522,433,105,64,11,7559
"01081040500",6164,168,639,362,617,12,363,31,8356
"01081040602",1843,496,1135,969,239,35,77,0,4794
"01081040603",418,205,276,126,0,54,0,6,1085
"01081040604",1850,2892,460,480,102,85,183,301,6353
"01081040700",162,447,45,31,32,62,0,0,779
"01081040800",537,1884,0,327,122,285,11,70,3236
"01081040901",2323,463,591,144,110,5,65,21,3722
"01081040902",2253,1303,691,114,1240,8,510,79,6198
"01081041000",3744,629,1754,816,473,35,32,3,7486
"01081041100",3927,1180,1766,1058,892,619,642,811,10895
"01081041200",3947,223,539,146,40,0,40,0,4935
"01081041300",1850,225,577,528,125,54,49,6,3414
"01081041400",274,305,1745,1379,119,3,149,169,4143
"01081041600",857,76,1098,1090,193,28,10,16,3368
"01081041700",4537,1200,1839,466,87,36,49,36,8250
"01081041800",4940,1183,923,241,192,20,0,0,7499
"01081041900",5972,746,673,216,52,0,15,73,7747
"01081042002",4605,379,871,9,251,42,128,18,6303
"01081042003",2877,338,312,22,0,0,70,0,3619
"01081042004",7402,755,2189,299,709,0,628,10,11992
"01081042005",2715,518,1206,111,68,27,40,0,4685
"01081042006",1216,262,365,15,245,5,63,0,2171
"01081042101",2310,119,699,586,17,0,10,0,3741
"01081042102",5064,824,717,392,58,214,0,37,7306
"01083020101",3421,752,157,0,10,368,33,368,5109
"01083020102",5167,891,119,7,274,115,32,0,6605
"01083020201",3728,1411,227,37,158,42,330,345,6278
"01083020202",3762,686,102,28,144,22,66,308,5118
"01083020300",3568,300,0,21,33,0,6,0,3928
"01083020401",4368,995,230,57,265,85,170,0,6170
"01083020402",4515,266,167,21,144,127,302,136,5678
"01083020500",1570,210,437,170,189,12,156,0,2744
"01083020600",2515,910,205,150,356,124,680,413,5353
"01083020700",893,371,449,58,87,86,39,173,2156
"01083020801",4355,359,507,88,366,56,155,56,5942
"01083020802",5650,444,731,115,370,0,179,0,7489
"01083020900",3578,178,321,127,129,115,73,108,4629
"01083021000",1347,107,915,155,102,0,111,0,2737
"01083021100",4343,256,1058,345,141,65,418,45,6671
"01083021200",7490,460,1869,218,820,274,169,35,11335
"01085780800",1026,16,1456,823,13,0,44,36,3414
"01085781000",875,32,1317,865,0,0,17,0,3106
"01085781100",127,12,753,727,5,0,0,0,1624
"01085781200",665,20,1417,650,0,20,0,0,2772
"01087231400",493,61,437,152,26,26,95,26,1316
"01087231500",1173,331,900,496,37,9,14,0,2960
"01087231601",229,0,617,128,0,0,0,0,974
"01087231602",73,28,660,427,111,5,0,0,1304
"01087231603",42,0,884,357,25,0,13,0,1321
"01087231700",30,6,174,164,11,19,0,11,415
"01087231800",5,15,928,307,0,0,0,0,1255
"01087231900",18,4,830,483,2,5,10,0,1352
"01087232000",44,0,1173,374,21,0,9,7,1628
"01087232100",0,0,1454,361,0,0,0,0,1815
"01087232200",570,27,1521,435,0,0,0,0,2553
"01087232300",36,0,963,617,35,3,0,0,1654
"01089000201",17,15,595,305,23,3,14,0,972
"01089000202",437,218,771,444,113,67,32,12,2094
"01089000301",799,343,2155,564,21,25,248,220,4375
"01089000302",704,86,2100,383,271,0,392,0,3936
"01089000403",665,69,3568,470,160,37,143,0,5112
"01089000501",335,38,1367,217,61,14,76,14,2122
"01089000502",220,203,1372,456,92,7,81,11,2442
"01089000503",350,4,1231,196,27,0,134,0,1942
"01089000601",437,215,592,272,67,6,83,61,1733
"01089000602",569,83,1205,295,73,52,31,89,2397
"01089000701",231,267,1910,602,52,552,18,291,3923
"01089000702",554,386,1327,125,201,16,173,0,2782
"01089000901",3411,287,304,26,141,25,51,15,4260
"01089000902",1348,264,106,43,150,32,9,0,1952
"01089001000",1845,437,272,28,53,71,77,33,2816
"01089001200",48,190,1044,1772,8,175,0,16,3253
"01089001301",449,303,1316,821,170,74,149,11,3293
"01089001302",514,37,941,419,166,20,58,0,2155
"01089001401",1217,88,123,0,309,26,101,0,1864
"01089001402",2167,417,1348,598,361,212,129,13,5245
"01089001500",1301,253,1133,501,203,180,43,30,3644
"01089001700",1812,22,0,0,34,0,13,0,1881
"01089001801",3917,106,27,0,66,0,167,0,4283
"01089001901",3179,15,24,0,207,7,77,0,3509
"01089001902",1262,27,15,0,24,0,71,0,1399
"01089001903",2372,68,61,0,95,4,56,0,2656
"01089002000",1968,94,0,0,6,0,48,17,2133
"01089002100",713,793,559,1030,96,144,46,298,3679
"01089002200",756,440,298,122,123,46,117,108,2010
"01089002300",2823,512,334,964,60,188,355,299,5535
"01089002400",1933,876,832,794,344,0,619,529,5927
"01089002501",1325,969,524,417,127,286,624,831,5103
"01089002502",778,464,600,510,74,182,363,252,3223
"01089002600",2864,348,202,29,227,167,85,0,3922
"01089002701",2010,87,239,8,51,24,20,8,2447
"01089002721",3561,114,126,0,140,40,160,10,4151
"01089002722",2781,0,137,0,199,54,56,0,3227
"01089002801",3108,258,328,158,255,82,99,54,4342
"01089002802",5073,588,418,0,449,36,125,0,6689
"01089002911",4003,189,207,0,195,9,295,0,4898
"01089002912",2298,141,0,0,143,0,85,0,2667
"01089002921",5010,506,112,0,577,47,80,12,6344
"01089002922",3913,139,30,0,420,0,77,0,4579
"01089003000",1010,380,642,351,141,57,56,6,2643
"01089003100",1391,352,72,171,24,6,39,16,2071
"01089010100",6737,293,1200,39,628,40,258,0,9195
"01089010200",4842,203,526,0,153,0,167,0,5891
"01089010301",5992,780,421,119,239,94,15,0,7660
"01089010302",3132,232,436,13,78,0,23,0,3914
"01089010401",4335,981,255,390,243,146,33,0,6383
"01089010402",4084,476,1303,201,470,73,97,126,6830
"01089010501",7536,234,2672,473,461,92,270,127,11865
"01089010502",1809,110,891,418,92,26,7,0,3353
"01089010612",2860,147,1404,28,192,137,201,51,5020
"01089010621",4458,149,1681,20,501,27,146,0,6982
"01089010622",3116,446,2855,1923,910,167,239,0,9656
"01089010623",4571,112,1240,13,413,0,144,0,6493
"01089010624",6406,183,1276,32,298,12,292,0,8499
"01089010701",4878,946,1335,204,802,138,381,0,8684
"01089010702",4216,548,2620,219,503,54,429,44,8633
"01089010800",8206,614,783,87,376,48,336,0,10450
"01089010901",12577,236,122,0,679,0,534,0,14148
"01089010902",1866,290,262,132,51,49,33,0,2683
"01089011011",6938,28,923,0,986,55,411,0,9341
"01089011012",5110,74,502,0,487,0,269,16,6458
"01089011013",3939,264,698,73,118,49,173,27,5341
"01089011014",5743,476,1052,551,892,74,386,15,9189
"01089011021",2363,269,912,356,510,181,272,43,4906
"01089011022",5242,294,1291,0,440,178,186,163,7794
"01089011100",555,58,159,12,72,0,37,0,893
"01089011200",4980,63,1981,500,905,54,451,3,8937
"01089011300",4262,558,78,41,412,102,58,0,5511
"01089011400",3869,410,17,0,131,26,27,0,4480
"01091972900",1022,251,1618,1528,0,0,0,30,4449
"01091973000",2144,66,1382,944,96,9,106,40,4787
"01091973100",548,212,816,346,7,13,44,0,1986
"01091973200",869,52,1061,616,6,0,0,0,2604
"01091973300",1092,197,690,262,6,0,7,0,2254
"01091973400",2867,169,784,358,176,31,167,31,4583
"01093964000",3048,1473,0,0,53,19,0,17,4610
"01093964100",2007,707,0,0,31,0,0,0,2745
"01093964200",1289,173,25,4,9,0,0,0,1500
"01093964300",3589,548,79,20,179,16,332,51,4814
"01093964400",3864,669,187,157,312,0,31,0,5220
"01093964500",1927,457,0,0,10,18,58,0,2470
"01093964600",2232,675,76,55,27,14,7,0,3086
"01093964700",4844,621,67,107,20,5,155,23,5842
"01095030100",1995,708,0,0,66,144,92,180,3185
"01095030201",4480,985,0,0,141,39,64,0,5709
"01095030202",4189,599,0,8,25,7,0,0,4828
"01095030300",5558,406,95,3,178,30,87,0,6357
"01095030401",3499,674,0,0,125,7,53,95,4453
"01095030402",3107,286,0,0,13,0,66,8,3480
"01095030500",5826,815,0,10,71,192,36,121,7071
"01095030600",4540,1231,366,200,146,54,162,130,6829
"01095030701",2336,760,141,41,204,57,159,116,3814
"01095030702",2745,522,160,4,112,164,26,158,3891
"01095030801",3476,960,125,2,220,305,571,494,6153
"01095030802",4882,1742,55,12,237,673,1410,1613,10624
"01095030902",3673,738,0,4,73,17,532,95,5132
"01095030903",4424,1260,10,143,174,271,1498,723,8503
"01095030904",3762,932,17,1,206,65,355,391,5729
"01095031000",4119,1316,0,0,177,151,735,161,6659
"01095031100",2927,1330,138,0,399,103,741,479,6117
"01095031200",5037,346,0,0,291,162,299,177,6312
"01097000200",381,147,243,171,31,0,0,0,973
"01097000401",0,17,609,718,0,0,0,0,1344
"01097000402",0,0,353,236,0,0,0,0,589
"01097000500",0,2,1216,948,14,6,13,0,2199
"01097000600",19,6,933,1287,0,21,11,23,2300
"01097000701",0,0,1253,897,0,5,15,0,2170
"01097000702",0,0,1552,588,0,42,0,0,2182
"01097000800",58,23,3390,1133,19,0,35,0,4658
"01097000901",980,116,482,198,10,10,28,0,1824
"01097000902",1461,114,56,88,53,58,2,40,1872
"01097000903",590,102,708,364,7,0,20,13,1804
"01097001001",673,191,293,446,32,0,39,0,1674
"01097001002",857,126,580,430,20,24,67,0,2104
"01097001100",18,0,1235,522,10,0,9,0,1794
"01097001200",10,0,758,523,0,0,0,38,1329
"01097001302",34,66,1348,1249,21,0,0,36,2754
"01097001400",19,0,1122,846,0,0,0,0,1987
"01097001501",6,0,551,1180,0,0,0,0,1737
"01097001502",0,0,294,1084,12,8,0,28,1426
"01097001800",846,417,623,263,173,3,172,148,2645
"01097001901",659,408,642,373,59,8,13,0,2162
"01097001902",1062,217,1088,732,37,155,42,106,3439
"01097002000",1013,34,479,285,30,0,45,0,1886
"01097002100",568,198,2908,780,0,11,0,0,4465
"01097002200",445,189,1276,712,82,0,31,0,2735
"01097002301",156,63,1088,495,0,0,29,0,1831
"01097002302",25,24,1488,836,0,0,0,0,2373
"01097002400",586,49,1708,772,31,115,0,115,3376
"01097002501",2948,135,277,130,57,11,165,11,3734
"01097002502",1985,137,256,1,1,0,0,0,2380
"01097002600",233,71,1331,962,0,0,1,0,2598
"01097002700",193,78,1124,1014,0,39,0,0,2448
"01097002800",1941,638,986,956,35,47,44,20,4667
"01097002900",1746,147,932,894,123,6,194,18,4060
"01097003000",1869,190,534,156,34,0,47,0,2830
"01097003100",3868,354,411,60,72,0,57,15,4837
"01097003202",1255,88,873,312,46,19,182,0,2775
"01097003203",1749,389,974,346,91,25,0,77,3651
"01097003204",1045,167,934,499,466,142,220,0,3473
"01097003205",686,12,885,1023,215,139,72,139,3171
"01097003301",1632,317,375,97,148,0,98,0,2667
"01097003302",3165,313,300,18,42,0,275,87,4200
"01097003402",736,60,2274,749,0,13,0,0,3832
"01097003404",362,36,1226,751,0,0,41,0,2416
"01097003405",813,28,828,166,3,22,0,18,1878
"01097003406",1109,98,927,405,147,0,66,0,2752
"01097003407",3207,827,2756,388,69,195,101,320,7863
"01097003408",877,560,2144,242,120,0,134,0,4077
"01097003501",2982,323,372,154,0,72,0,0,3903
"01097003502",2365,198,39,3,2,0,18,0,2625
"01097003602",82,157,468,313,0,31,9,0,1060
"01097003605",0,0,0,0,0,0,0,0,0
"01097003606",2289,308,617,215,134,95,90,7,3755
"01097003607",1248,558,1303,706,169,0,118,0,4102
"01097003608",276,47,898,44,77,0,12,0,1354
"01097003703",1918,118,750,149,203,100,176,32,3446
"01097003704",3180,301,503,98,124,20,154,0,4380
"01097003705",2561,192,611,39,252,0,79,0,3734
"01097003706",2293,159,399,92,100,3,174,74,3294
"01097003707",2079,260,1528,374,702,16,102,0,5061
"01097003708",2694,140,870,0,381,0,193,0,4278
"01097003709",3843,478,1371,151,504,0,418,0,6765
"01097003710",2482,410,1293,48,108,0,71,0,4412
"01097003800",538,101,451,107,51,0,0,0,1248
"01097003901",16,7,1249,677,15,2,0,1,1967
"01097003902",0,0,456,239,0,0,0,0,695
"01097004000",5,0,1093,1164,27,14,26,15,2344
"01097004100",0,0,444,508,0,0,0,0,952
"01097004800",45,87,667,413,0,0,0,0,1212
"01097004900",92,92,2014,1341,0,0,0,0,3539
"01097005000",403,239,993,307,14,0,0,0,1956
"01097005100",519,230,359,396,35,40,33,62,1674
"01097005200",767,151,273,353,20,0,2,0,1566
"01097005300",1148,310,191,285,13,0,23,26,1996
"01097005400",3270,331,399,114,311,120,406,0,4951
"01097005500",1651,255,426,36,202,30,52,0,2652
"01097005600",5441,402,627,232,145,25,48,0,6920
"01097005700",5479,828,645,139,251,23,0,10,7375
"01097005800",1380,362,1147,387,568,437,0,44,4325
"01097005900",3402,197,707,385,202,10,23,0,4926
"01097006000",2796,396,711,158,337,29,61,0,4488
"01097006102",1542,465,282,62,104,26,42,0,2523
"01097006103",1346,320,2299,971,88,83,55,14,5176
"01097006104",3650,512,615,11,84,136,285,0,5293
"01097006105",4150,690,1194,144,166,64,123,17,6548
"01097006200",4194,1018,143,12,42,0,43,0,5452
"01097006301",8789,1334,817,15,151,20,109,0,11235
"01097006302",5011,444,797,0,316,175,258,83,7084
"01097006402",2360,689,718,248,68,66,8,0,4157
"01097006403",1061,238,643,84,94,0,171,0,2291
"01097006404",6631,565,2554,266,776,137,330,0,11259
"01097006405",5635,304,531,366,547,0,28,0,7411
"01097006406",6084,410,767,40,401,0,154,321,8177
"01097006407",5407,167,358,31,18,0,0,0,5981
"01097006501",3743,214,880,222,133,21,83,0,5296
"01097006502",9657,1095,426,77,273,18,227,31,11804
"01097006600",4071,433,350,109,51,215,133,0,5362
"01097006701",4057,740,440,433,174,459,424,113,6840
"01097006702",2114,462,342,49,467,8,0,0,3442
"01097006801",6587,275,904,86,1054,64,177,2,9149
"01097006802",2292,280,239,165,26,0,13,7,3022
"01097006901",4750,1344,474,785,353,258,76,0,8040
"01097006902",3095,500,235,154,383,40,183,0,4590
"01097007000",4377,169,134,0,232,11,46,6,4975
"01097007101",3200,579,315,218,323,52,212,67,4966
"01097007102",954,141,1779,278,79,93,96,0,3420
"01097007103",2768,622,133,148,67,0,0,0,3738
"01097007201",1972,372,126,0,249,58,0,0,2777
"01097007202",2116,67,40,0,67,13,25,0,2328
"01097007300",1969,630,293,296,723,434,211,6,4562
"01097007400",1378,358,900,823,29,30,14,0,3532
"01097007500",0,4,848,708,0,4,0,0,1564
"01097007600",63,0,1028,1002,4,0,0,0,2097
"01097007700",0,0,799,725,34,24,0,0,1582
"01097990000",0,0,0,0,0,0,0,0,0
"01099075600",251,59,513,394,10,0,0,0,1227
"01099075700",534,117,467,566,8,0,0,0,1692
"01099075800",348,78,646,260,0,0,0,0,1332
"01099075900",2281,514,1537,1552,126,0,134,86,6230
"01099076000",1259,190,974,946,25,0,12,0,3406
"01099076100",4449,995,656,628,147,8,2,0,6885
"01099076200",1044,165,190,24,300,0,0,0,1723
"01101000100",106,21,50,244,0,48,0,11,480
"01101000200",80,118,535,137,13,0,0,0,883
"01101000300",164,124,660,287,17,0,17,0,1269
"01101000400",1216,302,954,1374,42,6,0,0,3894
"01101000500",1261,403,476,420,215,67,373,207,3422
"01101000600",4,0,389,626,78,0,0,0,1097
"01101000700",277,55,489,399,5,0,20,0,1245
"01101000900",712,29,134,3,76,0,39,0,993
"01101001000",97,32,311,595,4,8,0,0,1047
"01101001100",0,0,1649,1818,0,7,0,0,3474
"01101001200",5,0,743,835,0,16,0,0,1599
"01101001300",563,40,635,356,159,18,149,0,1920
"01101001400",2031,290,402,33,39,2,37,2,2836
"01101001500",464,30,791,800,76,131,51,0,2343
"01101001600",819,892,1066,873,122,15,16,425,4228
"01101001700",3590,257,451,658,67,0,66,0,5089
"01101001800",1847,383,449,125,52,56,7,51,2970
"01101001900",2318,356,326,70,62,0,163,0,3295
"01101002000",3173,109,958,409,86,0,76,0,4811
"01101002100",845,95,2450,1003,9,0,0,0,4402
"01101002201",99,15,3001,1075,19,29,0,19,4257
"01101002202",13,0,567,642,11,0,0,0,1233
"01101002300",6,0,1989,605,11,16,0,0,2627
"01101002400",0,9,1185,468,8,0,0,0,1670
"01101002500",515,102,972,1040,172,99,82,63,3045
"01101002600",4319,336,444,141,124,67,68,0,5499
"01101002700",2786,67,891,426,102,9,105,0,4386
"01101002800",1201,40,2112,937,28,0,69,106,4493
"01101002900",204,0,4594,2476,353,14,338,0,7979
"01101003000",355,306,1217,1610,61,0,39,239,3827
"01101003100",305,31,2836,879,34,17,0,0,4102
"01101003200",302,60,4108,1667,14,0,0,96,6247
"01101003301",2038,118,946,74,67,0,36,0,3279
"01101003302",2063,122,2339,1228,618,57,94,0,6521
"01101005101",827,38,2032,443,370,0,83,0,3793
"01101005102",255,214,2853,1566,24,4,12,4,4932
"01101005301",395,16,91,54,105,22,52,14,749
"01101005302",716,130,721,270,204,64,158,35,2298
"01101005402",1636,247,2857,940,318,43,116,21,6178
"01101005403",718,142,2019,784,286,8,0,0,3957
"01101005406",6638,156,1829,411,574,154,166,0,9928
"01101005407",2633,163,902,39,308,0,20,0,4065
"01101005408",4475,622,2495,94,577,39,172,0,8474
"01101005409",824,81,1200,238,6,0,0,0,2349
"01101005410",1683,149,2711,409,294,23,0,0,5269
"01101005501",549,18,741,346,21,0,195,0,1870
"01101005502",295,0,516,34,106,0,16,0,967
"01101005503",3127,51,1078,161,404,0,53,0,4874
"01101005504",653,0,165,48,11,0,0,0,877
"01101005603",647,476,3061,2141,382,500,885,802,8894
"01101005604",1992,40,1386,37,8,0,30,0,3493
"01101005605",837,102,2910,63,339,8,46,8,4313
"01101005606",405,0,3042,1479,0,47,15,0,4988
"01101005607",2870,42,506,22,657,15,146,0,4258
"01101005608",989,53,136,0,76,0,0,0,1254
"01101005609",1560,71,2278,236,273,120,114,0,4652
"01101005610",527,20,658,76,141,0,14,0,1436
"01101005611",1858,12,661,17,301,346,0,0,3195
"01101005612",1027,7,208,0,119,0,0,0,1361
"01101005700",744,67,377,209,3,0,0,0,1400
"01101005800",1337,210,659,143,21,0,0,0,2370
"01101005901",2582,194,1630,579,82,0,297,0,5364
"01101005902",27,45,2306,1218,0,0,0,0,3596
"01101006000",1408,785,1112,419,60,136,117,777,4814
"01101006100",47,29,1476,633,32,0,29,9,2255
"01103000100",2022,650,383,548,35,136,293,251,4318
"01103000200",3378,155,0,82,144,0,39,0,3798
"01103000300",2485,140,243,0,132,12,107,12,3131
"01103000400",1806,262,634,123,384,63,345,10,3627
"01103000600",421,296,686,724,120,154,228,322,2951
"01103000700",780,682,1804,637,327,84,478,314,5106
"01103000800",1481,588,378,178,230,0,331,380,3566
"01103000900",2781,1290,885,397,470,179,1328,570,7900
"01103001000",1847,300,582,153,333,0,349,123,3687
"01103005101",4576,522,306,83,166,95,634,27,6409
"01103005103",667,168,142,2,125,2,54,0,1160
"01103005105",1909,197,72,12,41,13,142,0,2386
"01103005106",3898,283,539,163,301,22,167,0,5373
"01103005107",4357,62,46,0,192,14,132,0,4803
"01103005108",2894,60,229,377,58,35,177,0,3830
"01103005109",2119,735,1285,370,212,185,660,349,5915
"01103005200",5643,845,55,15,218,82,103,0,6961
"01103005301",6992,702,468,176,164,101,128,30,8761
"01103005302",3184,107,95,1,169,4,184,15,3759
"01103005303",2990,549,157,26,114,0,52,0,3888
"01103005304",4816,363,223,0,14,51,28,10,5505
"01103005404",4348,345,85,0,134,9,33,75,5029
"01103005405",3898,584,169,16,153,0,34,0,4854
"01103005500",3981,706,56,0,228,30,149,19,5169
"01103005600",5048,559,9,0,90,6,98,0,5810
"01103005701",2439,487,44,0,122,0,42,0,3134
"01103005702",4717,838,168,1,269,22,0,442,6457
"01105686800",457,118,350,176,0,0,7,0,1108
"01105687000",1168,211,1611,1502,58,0,0,0,4550
"01105687100",596,71,1668,1456,14,0,0,0,3805
"01107050000",3258,563,489,235,25,0,25,0,4595
"01107050100",2278,218,677,560,63,11,88,0,3895
"01107050200",1288,284,343,173,7,0,0,0,2095
"01107050300",1331,119,1194,670,3,63,25,9,3414
"01107050400",1315,220,2020,1800,45,13,7,0,5420
"01109188600",1493,203,133,156,42,0,4,0,2031
"01109188700",866,117,550,147,39,68,114,13,1914
"01109188800",1567,235,409,157,2,16,10,0,2396
"01109188900",1179,472,2232,1470,36,28,115,39,5571
"01109189000",4132,681,1161,919,418,47,162,25,7545
"01109189100",2313,1242,711,706,126,260,101,0,5459
"01109189200",1864,187,350,324,119,4,76,11,2935
"01109189300",1640,280,1274,630,84,164,29,13,4114
"01111000100",2373,623,94,70,28,188,60,201,3637
"01111000200",2542,390,107,23,132,9,31,0,3234
"01111000300",2605,693,387,224,8,0,11,13,3941
"01111000400",2720,809,721,440,68,80,73,67,4978
"01111000500",2349,655,1373,583,22,82,15,37,5116
"01111000600",1236,135,128,183,38,4,91,0,1815
"01113030200",641,322,451,927,36,43,0,74,2494
"01113030300",1863,553,398,337,51,0,67,0,3269
"01113030401",3616,479,1038,220,652,8,460,0,6473
"01113030402",2133,249,407,31,31,0,0,0,2851
"01113030500",1326,209,384,177,52,2,69,0,2219
"01113030600",1723,268,3645,1686,208,173,359,165,8227
"01113030700",873,130,1195,1342,47,0,241,20,3848
"01113030800",89,65,2424,744,0,19,0,1,3342
"01113030901",3900,1467,932,64,326,72,72,0,6833
"01113030902",4047,496,3560,565,540,152,647,49,10056
"01113031000",2480,516,490,159,27,0,132,0,3804
"01113031100",264,67,905,362,2,7,4,0,1611
"01113031200",1998,258,950,241,56,7,160,62,3732
"01115040103",7439,689,595,164,282,20,21,0,9210
"01115040104",4792,158,501,0,18,0,52,0,5521
"01115040105",2720,1292,3,62,151,9,112,302,4651
"01115040106",4914,569,296,311,166,0,30,0,6286
"01115040201",4165,1171,13,35,26,14,33,210,5667
"01115040203",3278,1217,1028,526,130,14,79,32,6304
"01115040204",5203,806,553,152,129,142,40,19,7044
"01115040205",4514,533,578,0,145,16,55,0,5841
"01115040300",3936,998,304,64,64,44,0,0,5410
"01115040401",2836,1177,521,182,134,89,225,63,5227
"01115040402",3265,559,17,0,15,74,11,54,3995
"01115040501",9618,788,208,134,34,44,0,0,10826
"01115040502",6268,1162,461,148,418,0,369,86,8912
"01117030102",2757,402,713,234,59,24,3,70,4262
"01117030103",795,41,0,50,97,11,9,2,1005
"01117030211",2523,157,299,0,76,0,12,0,3067
"01117030212",1594,365,862,268,659,127,339,200,4414
"01117030213",3363,272,458,146,278,49,295,87,4948
"01117030214",7054,222,454,35,240,0,229,68,8302
"01117030215",3402,70,282,0,246,32,86,0,4118
"01117030216",4796,133,600,0,529,0,58,0,6116
"01117030217",4709,185,441,0,297,0,195,0,5827
"01117030303",6060,216,574,78,327,365,134,70,7824
"01117030304",5273,196,256,0,218,0,47,0,5990
"01117030305",3890,81,40,0,98,6,13,0,4128
"01117030306",2764,187,127,78,378,260,377,228,4399
"01117030314",2305,118,519,113,115,0,168,0,3338
"01117030315",3812,408,265,105,772,0,1222,271,6855
"01117030316",4485,143,597,52,633,0,369,32,6311
"01117030317",3361,51,492,0,165,49,65,49,4232
"01117030319",974,54,790,146,224,374,183,379,3124
"01117030320",4203,259,648,26,63,13,125,60,5397
"01117030330",4198,344,301,96,354,17,38,0,5348
"01117030331",3694,280,136,0,255,51,268,24,4708
"01117030332",1019,15,102,10,18,0,6,0,1170
"01117030333",3840,173,444,0,718,0,28,72,5275
"01117030334",3520,119,86,35,136,191,48,191,4326
"01117030336",4943,139,514,28,275,24,11,65,5999
"01117030337",1078,131,83,41,233,0,297,28,1891
"01117030340",4470,215,460,104,77,0,100,8,5434
"01117030341",1223,170,351,11,157,131,212,179,2434
"01117030342",2102,23,15,28,298,0,190,3,2659
"01117030344",2398,127,483,0,133,0,129,15,3285
"01117030345",2302,124,158,0,124,14,37,0,2759
"01117030405",691,54,477,59,10,0,0,0,1291
"01117030406",2299,369,323,80,264,116,521,205,4177
"01117030407",570,367,246,122,0,0,80,29,1414
"01117030408",2066,322,504,71,65,4,24,0,3056
"01117030501",4790,714,1005,98,361,119,473,415,7975
"01117030502",1666,95,407,0,22,0,30,0,2220
"01117030604",4840,355,771,37,517,240,665,249,7674
"01117030605",5718,169,863,223,115,415,162,415,8080
"01117030607",4544,464,516,1,256,109,0,226,6116
"01117030608",2612,182,375,0,159,0,44,0,3372
"01117030609",5368,277,1126,0,398,0,293,14,7476
"01117030701",2363,505,298,184,44,22,67,108,3591
"01117030703",2715,494,378,343,74,22,80,64,4170
"01117030704",2889,604,152,125,51,0,107,41,3969
"01117030800",2955,640,107,76,82,10,27,2,3899
"01117030900",2319,183,42,0,15,3,15,0,2577
"01117980000",0,0,0,0,0,0,0,0,0
"01119011300",1054,430,1762,1955,17,0,0,8,5226
"01119011400",341,24,586,651,70,0,5,0,1677
"01119011500",534,20,2265,1614,0,22,6,0,4461
"01119011600",619,20,616,194,6,0,26,0,1481
"01121010101",3540,218,608,153,169,89,66,0,4843
"01121010102",3107,506,745,251,28,58,32,49,4776
"01121010201",2185,391,715,94,9,0,9,0,3403
"01121010202",2888,593,487,105,154,95,0,0,4322
"01121010301",1471,452,211,852,7,17,26,0,3036
"01121010302",2561,335,1080,416,0,0,0,0,4392
"01121010400",1846,547,435,34,47,15,35,1,2960
"01121010500",922,88,1038,746,159,32,206,0,3191
"01121010600",404,99,1058,1202,0,0,0,31,2794
"01121010700",120,5,780,191,0,0,43,0,1139
"01121010900",1551,614,794,97,26,51,0,92,3225
"01121011000",2132,258,215,66,225,0,0,0,2896
"01121011100",1871,324,1941,537,61,0,41,0,4775
"01121011200",589,123,1052,202,4,0,0,0,1970
"01121011300",2698,776,1075,991,62,40,13,0,5655
"01121011400",1344,327,757,477,35,6,76,46,3068
"01121011500",4119,604,346,75,184,0,15,3,5346
"01121011600",2924,857,774,495,23,98,0,0,5171
"01121011700",2778,826,526,365,8,170,172,89,4934
"01121011800",944,353,278,546,6,163,38,162,2490
"01121011900",1606,380,379,247,0,0,19,0,2631
"01121012000",1163,132,602,423,0,46,84,43,2493
"01123961900",1950,258,142,273,6,0,8,19,2656
"01123962000",2037,259,1370,747,0,24,27,0,4464
"01123962100",1503,346,1020,957,62,0,54,0,3942
"01123962200",2305,840,825,198,208,36,280,178,4870
"01123962300",3719,1160,850,213,48,145,0,360,6495
"01123962400",2115,622,1074,369,42,90,0,0,4312
"01123962501",3196,363,503,73,35,0,14,0,4184
"01123962502",2495,310,116,32,2,10,40,39,3044
"01123962600",325,78,799,329,15,0,15,0,1561
"01123962700",4656,241,628,616,38,0,0,0,6179
"01125010101",3471,158,26,0,512,0,157,0,4324
"01125010102",2647,177,67,9,83,0,0,0,2983
"01125010103",4791,386,153,27,40,18,9,0,5424
"01125010201",3293,95,166,0,0,0,119,13,3686
"01125010202",8556,322,1178,115,74,32,679,80,11036
"01125010203",2528,258,247,0,76,47,34,0,3190
"01125010204",3132,297,757,58,152,47,29,0,4472
"01125010301",4811,225,546,347,204,53,137,0,6323
"01125010302",2487,347,42,87,16,0,17,0,2996
"01125010303",1756,150,701,225,21,0,0,0,2853
"01125010403",1815,413,887,290,112,0,101,164,3782
"01125010404",911,48,591,764,47,0,0,0,2361
"01125010405",2313,232,247,0,201,248,37,167,3445
"01125010406",4348,187,94,87,232,43,199,0,5190
"01125010407",1970,182,399,118,43,96,66,0,2874
"01125010500",707,244,850,668,47,6,57,90,2669
"01125010601",3461,900,277,28,40,3,54,5,4768
"01125010602",8866,901,660,38,168,0,21,0,10654
"01125010701",4295,590,1179,293,89,42,65,0,6553
"01125010702",5925,812,523,17,117,7,254,2,7657
"01125010703",2130,465,126,10,15,10,95,0,2851
"01125010802",3296,133,927,97,98,0,122,0,4673
"01125010803",1209,440,821,423,19,0,148,321,3381
"01125010804",1780,334,568,122,84,8,87,52,3035
"01125011200",325,101,6,16,0,0,0,0,448
"01125011401",461,390,6,132,57,88,0,0,1134
"01125011402",374,1272,53,42,117,107,0,83,2048
"01125011600",332,146,1258,545,37,7,16,0,2341
"01125011701",16,0,1317,987,0,0,0,0,2320
"01125011703",175,20,3338,1626,15,0,0,5,5179
"01125011800",5,2,2146,1211,0,0,0,20,3384
"01125011901",1131,354,414,684,65,32,39,9,2728
"01125011902",170,162,914,288,48,61,0,125,1768
"01125012000",1552,770,38,0,70,60,288,0,2778
"01125012100",2957,1129,919,239,334,0,389,42,6009
"01125012303",4425,407,1289,1205,328,11,142,142,7949
"01125012304",712,207,1734,712,41,16,40,6,3468
"01125012305",1702,133,2356,581,92,47,65,57,5033
"01125012403",1756,311,1415,345,34,0,0,0,3861
"01125012404",384,216,1076,388,17,0,0,0,2081
"01125012405",1460,340,3904,2207,80,0,356,0,8347
"01125012501",261,117,1225,187,0,0,30,0,1820
"01125012502",4321,349,1668,333,227,0,22,0,6920
"01125012503",3144,258,815,5,219,0,17,120,4578
"01125012600",497,611,221,406,38,21,63,18,1875
"01125012700",1837,496,1395,447,20,129,232,232,4788
"01125012800",233,110,1074,845,16,39,69,24,2410
"01127020100",1981,806,340,288,316,41,223,0,3995
"01127020200",3324,521,16,48,29,35,32,0,4005
"01127020300",4470,1288,535,272,48,33,116,249,7011
"01127020400",1143,461,420,103,29,5,103,33,2297
"01127020600",2005,459,31,14,74,0,41,44,2668
"01127020700",2524,303,0,16,112,151,92,151,3349
"01127020800",4257,640,110,47,62,268,36,28,5448
"01127020900",3345,1407,1,1,23,8,0,0,4785
"01127021000",2420,1269,0,0,2,48,0,5,3744
"01127021100",2389,782,127,32,75,16,0,0,3421
"01127021200",2475,910,0,0,26,29,0,48,3488
"01127021300",2994,569,67,58,148,32,0,26,3894
"01127021400",2455,803,194,59,85,70,0,9,3675
"01127021500",2277,525,95,51,56,36,58,27,3125
"01127021600",1124,228,85,0,29,12,13,12,1503
"01127021700",3157,692,254,123,61,13,34,12,4346
"01127021800",2454,601,105,14,26,78,0,20,3298
"01127021900",1665,657,53,0,13,75,0,0,2463
"01129043900",1651,368,359,180,144,7,72,0,2781
"01129044000",2599,202,528,249,0,0,0,7,3585
"01129044100",2073,371,808,84,25,0,0,0,3361
"01129044200",1500,304,1276,301,1361,70,13,0,4825
"01129044300",1714,288,107,199,65,56,0,106,2535
"01131034700",48,14,272,739,0,0,0,0,1073
"01131034800",1287,178,1550,1532,7,16,7,8,4585
"01131035100",1052,110,1101,1292,2,53,0,53,3663
"01131035200",231,35,1057,544,0,0,0,0,1867
"01133965501",1782,550,0,0,47,21,0,0,2400
"01133965502",1931,579,0,0,6,0,6,0,2522
"01133965503",2478,243,0,0,13,33,46,0,2813
"01133965600",3938,776,5,2,43,207,79,0,5050
"01133965700",3271,989,0,0,129,67,202,160,4818
"01133965800",3086,1258,30,0,32,65,66,11,4548
"01133965900",1584,401,0,41,8,65,0,76,2175
"02013000100",648,96,227,115,1871,327,366,73,3723
"02016000100",131,31,0,0,642,108,19,12,943
"02016000200",1468,64,182,63,2530,215,510,25,5057
"02020000101",4856,396,0,0,966,49,280,0,6547
"02020000102",4403,35,1,0,793,160,628,17,6037
"02020000201",3352,64,177,0,768,26,251,0,4638
"02020000202",4760,414,0,0,925,142,554,11,6806
"02020000203",9806,85,740,0,1249,18,1120,0,13018
"02020000204",2847,115,42,0,327,22,82,0,3435
"02020000300",4429,203,1017,0,1087,0,959,0,7695
"02020000400",3168,114,621,54,644,86,433,69,5189
"02020000500",838,84,254,0,836,45,232,19,2308
"02020000600",1241,308,376,295,3132,1618,739,157,7866
"02020000701",2519,92,547,0,1940,365,532,25,6020
"02020000702",2705,217,966,0,1218,177,538,0,5821
"02020000703",1904,184,508,125,2576,591,301,11,6200
"02020000801",2270,233,322,64,2793,1363,1016,96,8157
"02020000802",2331,223,530,56,1003,419,390,143,5095
"02020000901",1424,192,284,327,2037,584,324,67,5239
"02020000902",1334,61,230,216,849,158,108,39,2995
"02020001000",1710,467,336,76,736,266,179,88,3858
"02020001100",343,64,67,19,96,13,30,1,633
"02020001200",2892,75,123,0,348,29,105,0,3572
"02020001300",2547,109,12,0,322,15,192,0,3197
"02020001400",2571,108,270,581,1129,329,484,27,5499
"02020001500",3438,140,128,42,941,219,325,0,5233
"02020001601",2125,56,362,5,1509,36,410,14,4517
"02020001602",2524,196,70,23,917,92,283,0,4105
"02020001701",3705,178,1182,106,1848,304,275,31,7629
"02020001702",3352,210,411,0,1068,135,369,7,5552
"02020001731",3262,281,252,0,1568,180,275,28,5846
"02020001732",3793,143,442,0,1327,368,295,15,6383
"02020001801",3440,89,243,110,860,75,258,107,5182
"02020001802",2541,252,239,21,1796,522,388,197,5956
"02020001900",1300,173,122,31,2089,580,304,10,4609
"02020002000",1657,249,292,0,1126,284,526,115,4249
"02020002100",2263,131,119,30,1522,15,118,10,4208
"02020002201",3025,204,110,32,1622,121,327,0,5441
"02020002202",1659,292,140,0,776,224,138,316,3545
"02020002301",5640,429,6,0,1254,5,584,11,7929
"02020002302",3431,271,35,12,1232,65,215,21,5282
"02020002303",4900,428,270,42,2396,489,813,0,9338
"02020002400",1938,229,153,0,761,81,287,23,3472
"02020002501",3188,64,164,0,1209,217,443,63,5348
"02020002502",3375,126,136,35,1600,144,557,0,5973
"02020002601",2769,215,166,84,1829,115,358,116,5652
"02020002602",3358,246,287,14,2017,159,351,42,6474
"02020002603",4176,146,112,0,1799,49,483,14,6779
"02020002702",7508,146,91,14,2334,67,839,54,11053
"02020002711",4913,18,77,0,1193,35,368,0,6604
"02020002712",4805,245,309,41,2896,486,748,100,9630
"02020002811",3729,81,104,34,2096,240,497,96,6877
"02020002812",6445,215,491,9,776,4,262,116,8318
"02020002813",4084,130,0,0,702,2,221,0,5139
"02020002821",4245,76,160,44,727,11,300,0,5563
"02020002822",3749,45,42,0,387,18,32,7,4280
"02020002823",4963,29,184,0,511,18,80,18,5803
"02020002900",2362,83,0,0,280,55,303,2,3085
"02050000100",181,29,3,0,6591,2861,39,24,9728
"02050000200",1541,64,108,0,3608,672,172,22,6187
"02050000300",161,11,2,0,936,433,6,0,1549
"02060000100",547,10,2,0,366,61,53,1,1040
"02068000100",1575,167,12,0,143,86,32,14,2029
"02070000100",116,3,3,0,1926,617,2,0,2667
"02070000200",753,41,8,0,1226,229,120,7,2384
"02090000100",1196,124,53,0,434,115,75,9,2006
"02090000200",1890,313,143,46,398,136,141,32,3099
"02090000300",1688,359,511,72,1158,293,293,0,4374
"02090000400",2990,143,95,61,1171,223,333,0,5016
"02090000500",1923,75,195,66,429,113,511,13,3325
"02090000600",2729,402,77,0,1088,109,89,0,4494
"02090000700",2675,174,102,189,798,279,439,113,4769
"02090000800",3711,226,528,0,1488,255,590,55,6853
"02090000900",4592,274,41,0,824,25,431,0,6187
"02090001000",1185,114,0,0,185,140,39,2,1665
"02090001100",4220,771,1014,23,1043,66,1147,129,8413
"02090001200",5503,95,0,0,983,59,255,0,6895
"02090001300",4620,362,0,0,593,10,48,0,5633
"02090001400",6139,267,18,0,930,168,353,24,7899
"02090001500",9288,338,271,0,1426,2,433,0,11758
"02090001600",3500,276,221,0,626,196,158,0,4977
"02090001700",982,137,0,0,28,12,23,0,1182
"02090001800",1558,34,402,0,309,4,306,11,2624
"02090001900",8931,394,0,7,836,93,272,5,10538
"02100000100",1918,120,0,0,404,74,29,2,2547
"02105000200",12,0,0,0,47,7,0,0,66
"02105000300",949,104,12,0,779,207,19,19,2089
"02110000100",4068,95,0,0,533,32,192,8,4928
"02110000200",4836,84,16,30,1960,171,682,24,7803
"02110000300",3298,105,80,0,1876,459,278,127,6223
"02110000400",2132,122,81,15,1772,193,142,6,4463
"02110000500",2809,147,12,0,749,85,123,51,3976
"02110000600",4133,264,126,0,1077,231,169,46,6046
"02122000100",162,2,0,0,184,49,0,0,397
"02122000200",4296,310,23,0,615,50,365,23,5682
"02122000300",941,30,0,0,9,36,23,11,1050
"02122000400",5725,492,60,0,264,104,82,0,6727
"02122000500",5081,211,8,0,962,138,258,38,6696
"02122000600",5066,634,15,0,1415,180,134,24,7468
"02122000700",8025,505,60,0,1157,82,529,22,10380
"02122000800",2947,417,2,0,259,72,54,11,3762
"02122000900",1705,164,0,0,166,23,16,0,2074
"02122001000",3170,419,28,0,455,113,124,65,4374
"02122001100",2378,456,14,5,141,59,67,53,3173
"02122001200",376,32,7,1,331,179,0,1,927
"02122001300",3131,264,13,0,982,111,43,0,4544
"02130000100",2846,76,0,0,467,64,95,9,3557
"02130000200",2632,379,23,0,1503,311,255,0,5103
"02130000300",1426,224,26,0,850,293,171,42,3032
"02130000400",1537,82,1,0,587,111,31,20,2369
"02150000100",823,50,14,65,715,283,111,11,2072
"02150000200",3764,420,0,0,2089,328,434,22,7057
"02150000300",598,125,0,0,2047,121,266,50,3207
"02150000400",475,41,0,2,394,33,24,11,980
"02150000500",992,74,9,1,135,14,178,3,1406
"02164000100",319,12,8,0,888,254,28,1,1510
"02170000101",469,225,0,0,22,19,0,9,744
"02170000102",1689,217,0,0,71,64,1,0,2042
"02170000200",916,203,0,9,96,70,40,0,1334
"02170000300",5241,242,37,0,509,45,354,0,6428
"02170000401",1318,267,22,0,381,57,13,35,2093
"02170000402",1529,295,0,0,133,5,57,7,2026
"02170000501",1420,167,26,22,521,3,136,22,2317
"02170000502",1548,222,0,0,199,0,67,0,2036
"02170000601",3742,414,26,0,562,75,30,25,4874
"02170000603",5377,349,0,0,749,88,304,0,6867
"02170000604",3317,370,0,0,631,81,57,24,4480
"02170000701",2526,250,0,0,221,7,101,0,3105
"02170000703",2323,651,9,0,501,88,139,16,3727
"02170000705",3233,288,0,10,454,53,469,0,4507
"02170000706",4287,694,33,0,681,193,182,0,6070
"02170000800",3480,529,37,53,674,134,92,20,5019
"02170000900",2030,67,79,10,489,85,90,27,2877
"02170001001",2766,121,0,0,621,108,204,18,3838
"02170001003",2539,302,16,1,652,25,151,37,3723
"02170001004",4212,363,48,0,577,66,174,0,5440
"02170001100",4384,278,89,28,575,43,166,6,5569
"02170001201",3838,333,22,14,702,84,310,33,5336
"02170001202",3930,329,103,0,799,193,248,14,5616
"02170001300",4731,347,113,0,492,119,210,20,6032
"02180000100",218,9,1,0,3380,2214,20,3,5845
"02180000200",1299,81,49,2,1954,329,120,0,3834
"02185000100",477,4,25,4,3156,507,198,0,4371
"02185000200",146,1,2,0,1911,334,15,1,2410
"02185000300",2384,94,10,0,376,17,81,0,2962
"02188000100",190,28,1,0,2938,1232,8,13,4410
"02188000200",667,23,17,5,2053,447,90,0,3302
"02195000200",2142,217,69,5,680,77,198,42,3430
"02198000100",1072,214,3,0,772,166,15,0,2242
"02198000200",1359,197,11,0,711,180,91,9,2558
"02198000300",7,5,0,0,0,0,0,0,12
"02198940100",113,11,5,0,1274,210,57,7,1677
"02220000100",2369,63,55,13,948,203,159,0,3810
"02220000200",3126,249,13,0,1596,177,295,35,5491
"02230000100",752,38,0,0,197,7,31,0,1025
"02240000100",1110,144,0,0,703,212,0,9,2178
"02240000400",3791,573,71,0,347,19,202,75,5078
"02261000100",1547,150,25,0,613,280,28,0,2643
"02261000200",2002,16,0,0,542,46,15,0,2621
"02261000300",3011,272,0,0,854,169,337,20,4663
"02270000100",260,51,19,0,4911,2505,18,2,7766
"02275000300",1615,85,0,3,513,147,22,0,2385
"02282000100",236,4,37,0,332,26,27,0,662
"02290000100",154,20,0,0,688,316,0,19,1197
"02290000200",535,132,2,5,621,228,8,49,1580
"02290000300",219,10,0,0,1243,430,8,0,1910
"02290000400",155,20,10,0,617,185,2,4,993
"04001942600",0,0,0,0,774,698,0,0,1472
"04001942700",68,0,0,0,2930,1829,13,8,4848
"04001944000",278,30,138,45,3208,2424,55,30,6208
"04001944100",61,15,3,0,2744,2706,62,36,5627
"04001944201",344,37,17,3,2382,1297,18,118,4216
"04001944202",86,40,9,0,1681,2044,68,49,3977
"04001944300",50,17,3,1,4683,2602,45,8,7409
"04001944901",49,98,5,28,2221,1342,4,63,3810
"04001944902",108,5,30,0,2800,2505,38,39,5525
"04001945001",71,102,8,0,3087,1500,45,7,4820
"04001945002",71,18,2,5,2563,1675,120,23,4477
"04001945100",104,48,12,3,1292,925,45,12,2441
"04001970200",3437,955,7,6,305,53,664,54,5481
"04001970300",2050,372,0,0,596,256,733,188,4195
"04001970501",3604,810,20,0,369,154,713,212,5882
"04001970502",2712,401,0,6,310,275,294,107,4105
"04003000100",1006,191,0,0,271,110,350,122,2050
"04003000201",2218,271,0,0,683,0,1724,97,4993
"04003000202",2656,460,0,1,675,90,2056,229,6167
"04003000203",1993,290,17,0,171,72,198,14,2755
"04003000301",2444,733,15,0,368,267,772,344,4943
"04003000302",4809,349,3,0,116,1,267,145,5690
"04003000303",2791,334,0,0,43,45,136,71,3420
"04003000400",1402,463,0,0,268,40,437,152,2762
"04003000500",2239,378,60,19,258,42,499,22,3517
"04003000600",1063,553,0,0,582,312,1335,753,4598
"04003000700",2325,1170,0,0,605,420,2575,1579,8674
"04003000800",2159,610,18,0,1156,322,2788,833,7886
"04003000901",1022,867,0,0,555,587,1506,1403,5940
"04003000902",902,360,31,13,562,276,1382,618,4144
"04003001000",864,228,0,12,161,44,174,5,1488
"04003001100",2075,917,0,0,388,197,1212,615,5404
"04003001200",2013,400,5,0,194,296,992,533,4433
"04003001300",3645,751,109,163,697,84,833,304,6586
"04003001401",1421,329,149,0,314,20,288,0,2521
"04003001402",500,68,170,0,130,0,192,14,1074
"04003001501",1859,580,160,46,707,126,858,187,4523
"04003001502",2324,779,208,43,845,149,1164,422,5934
"04003001601",3116,704,220,3,1221,51,1380,51,6746
"04003001602",1853,622,127,118,282,55,451,235,3743
"04003001701",2468,291,243,0,601,470,773,447,5293
"04003001702",2195,753,201,60,804,51,821,367,5252
"04003001703",3415,198,235,0,793,106,853,43,5643
"04003001800",7099,194,772,6,845,18,1159,50,10143
"04003001900",5194,180,360,19,803,10,797,39,7402
"04003002001",3462,853,0,0,234,310,867,415,6141
"04003002002",3725,502,10,34,199,11,911,186,5578
"04003002100",4268,375,61,0,222,293,572,113,5904
"04005000100",2825,241,15,0,551,112,252,25,4021
"04005000200",2964,438,49,2,508,145,448,81,4635
"04005000300",2385,1076,210,57,1308,1650,1155,1499,9340
"04005000400",3308,521,90,0,1198,218,828,303,6466
"04005000500",2522,444,68,0,1072,364,1057,388,5915
"04005000600",4039,358,97,0,917,103,347,11,5872
"04005000700",2340,350,14,3,359,176,338,9,3589
"04005000800",1762,1746,134,29,554,518,410,276,5429
"04005000900",4146,895,32,54,976,617,554,410,7684
"04005001000",220,694,0,10,43,473,47,177,1664
"04005001101",3336,590,219,1,819,46,594,58,5663
"04005001102",3249,1528,10,35,1248,763,1277,789,8899
"04005001200",1856,586,17,43,199,31,345,222,3299
"04005001301",4263,195,41,0,729,1,525,164,5918
"04005001302",4379,482,186,0,235,19,752,118,6171
"04005001500",2322,286,0,0,305,21,218,0,3152
"04005001600",2673,259,0,0,109,0,105,14,3160
"04005001700",2146,803,31,21,375,303,525,323,4527
"04005002000",1469,297,0,0,286,83,27,15,2177
"04005002100",4067,336,0,0,1818,1042,657,104,8024
"04005002200",4195,436,0,6,892,496,583,278,6886
"04005002300",3549,879,12,55,559,288,484,152,5978
"04005942201",25,4,0,2,2777,1099,46,0,3953
"04005942202",19,0,40,0,2130,1614,34,17,3854
"04005944900",97,13,0,0,2996,2051,62,5,5224
"04005945000",99,0,25,0,2581,1633,117,18,4473
"04005945100",25,13,2,0,2295,1153,49,34,3571
"04005945200",183,0,0,0,3219,1415,34,0,4851
"04007000100",1397,148,0,0,59,0,20,0,1624
"04007000200",1733,385,0,0,0,0,105,0,2223
"04007000301",4829,1020,0,0,309,31,293,391,6873
"04007000302",2261,398,0,19,25,18,63,102,2886
"04007000400",3144,621,0,0,144,11,318,11,4249
"04007000500",4743,482,4,0,261,5,244,0,5739
"04007000600",969,282,0,0,26,111,28,111,1527
"04007000700",1149,509,0,1,0,2,0,3,1664
"04007000800",1441,287,0,0,21,9,469,53,2280
"04007000900",1987,900,0,0,266,18,1186,309,4666
"04007001000",3662,1220,0,0,378,0,1201,411,6872
"04007001100",2782,460,0,58,520,126,1625,229,5800
"04007001200",2944,388,92,33,414,351,1003,241,5466
"04007001300",860,210,0,0,126,79,660,250,2185
"04007940200",31,0,5,0,1073,894,0,0,2003
"04007940400",160,43,37,10,2706,2576,167,39,5738
"04009940500",9,41,4,6,2348,2382,128,118,5036
"04009961100",3381,541,9,0,220,135,851,295,5432
"04009961201",2309,419,0,20,190,54,363,184,3539
"04009961202",2766,369,17,0,342,0,1211,45,4750
"04009961300",2191,797,45,0,232,142,1158,425,4990
"04009961400",3836,470,25,0,603,20,2008,248,7210
"04009961500",2943,1271,3,6,247,21,1040,416,5947
"04009961600",703,165,11,0,8,10,84,46,1027
"04009961700",3018,147,10,7,288,135,1037,96,4738
"04011960100",2126,198,55,0,343,46,1477,149,4394
"04011960200",2502,190,46,0,270,119,1469,239,4835
"04011960300",1834,643,0,0,206,69,515,289,3556
"04012020100",1641,469,0,0,250,191,534,430,3515
"04012020201",1519,349,0,0,53,0,84,24,2029
"04012020202",497,22,0,0,0,5,9,0,533
"04012020501",1247,288,0,0,376,10,444,0,2365
"04012020502",3848,417,0,0,16,6,157,17,4461
"04012020602",897,226,0,0,213,0,226,0,1562
"04012940200",1247,155,8,0,1241,197,1011,178,4037
"04012940300",1232,380,20,0,2097,991,1376,478,6574
"04012980000",0,0,0,0,0,0,0,0,0
"04013010101",4819,233,0,0,130,0,39,0,5221
"04013010102",3409,313,25,2,236,0,84,5,4074
"04013030401",3584,238,0,0,71,2,160,25,4080
"04013030402",3230,269,12,0,242,16,139,34,3942
"04013040502",3839,1036,74,0,100,13,509,250,5821
"04013040506",4909,324,0,2,58,1,26,0,5320
"04013040507",5409,392,0,0,100,0,0,0,5901
"04013040512",1432,67,5,0,59,0,28,0,1591
"04013040513",2716,41,40,0,9,0,0,0,2806
"04013040514",2718,113,0,0,84,0,38,0,2953
"04013040515",3443,775,0,20,32,20,617,643,5550
"04013040516",2951,197,0,0,124,0,390,20,3682
"04013040517",5676,1180,42,10,122,113,764,491,8398
"04013040518",5939,374,584,101,471,25,1306,371,9171
"04013040519",3653,189,47,0,220,0,69,0,4178
"04013040520",3991,19,100,14,163,24,401,0,4712
"04013040521",4494,123,489,9,759,37,407,0,6318
"04013040522",4021,150,0,0,84,0,0,0,4255
"04013040523",2650,98,16,0,165,0,26,0,2955
"04013040524",1509,11,18,0,12,0,16,0,1566
"04013040525",3073,98,41,0,31,8,61,0,3312
"04013040526",2154,47,72,0,0,0,70,0,2343
"04013040527",2984,677,118,0,165,11,192,163,4310
"04013040528",5938,335,32,27,136,0,49,28,6545
"04013040529",2907,41,27,0,79,0,78,0,3132
"04013040530",3183,714,114,0,154,14,613,26,4818
"04013040531",2634,530,188,56,86,0,434,106,4034
"04013050603",3035,556,11,0,175,90,1108,271,5246
"04013050604",2478,494,13,0,173,39,864,303,4364
"04013050605",4762,317,371,0,741,102,1314,129,7736
"04013050606",5885,810,250,44,412,90,845,420,8756
"04013050607",4476,1774,232,66,476,176,1889,856,9945
"04013050608",4134,951,454,36,1592,192,1871,678,9908
"04013050609",3536,261,108,280,670,217,1939,222,7233
"04013050610",5064,856,848,254,1139,239,2404,811,11615
"04013050611",3497,274,40,36,864,8,1702,211,6632
"04013050701",3193,828,335,0,736,248,1644,811,7795
"04013050702",2812,1458,155,34,676,218,1881,1056,8290
"04013060801",2857,2334,138,92,460,331,2014,1780,10006
"04013060802",1716,205,161,4,382,35,644,65,3212
"04013060901",3256,502,372,127,197,56,1608,274,6392
"04013060902",1867,555,54,30,249,361,1805,745,5666
"04013060903",3243,653,91,0,564,435,2581,663,8230
"04013060904",2056,908,100,14,258,117,1076,599,5128
"04013061009",6685,459,439,2,1146,0,2471,21,11223
"04013061010",3815,278,82,0,374,0,730,153,5432
"04013061011",3619,609,441,30,705,116,1452,241,7213
"04013061012",4958,533,490,248,1397,195,1215,505,9541
"04013061013",3450,337,707,18,1012,45,1396,237,7202
"04013061014",3463,452,943,122,743,53,1482,374,7632
"04013061015",4478,385,417,282,886,21,1963,104,8536
"04013061016",3393,133,336,34,811,34,803,57,5601
"04013061017",0,0,0,0,0,0,0,0,0
"04013061018",4047,363,30,0,117,35,63,61,4716
"04013061019",2402,113,422,4,324,26,927,46,4264
"04013061020",2847,66,259,0,480,47,1061,0,4760
"04013061021",1264,27,317,70,343,0,360,10,2391
"04013061022",7183,1313,578,589,1037,100,3568,584,14952
"04013061023",8159,289,1014,252,1113,139,3959,284,15209
"04013061024",1794,186,62,95,147,0,1269,148,3701
"04013061025",5546,178,534,0,472,583,804,13,8130
"04013061026",4140,432,102,0,543,99,964,49,6329
"04013061027",4143,310,14,0,342,31,1462,53,6355
"04013061028",1874,118,159,116,72,6,230,40,2615
"04013061029",4173,261,224,0,255,6,574,18,5511
"04013061030",6174,149,386,0,841,134,1094,136,8914
"04013061031",2761,215,276,52,302,104,1173,51,4934
"04013061032",4000,1108,140,97,540,108,708,133,6834
"04013061033",4854,649,187,15,497,143,636,445,7426
"04013061034",4582,681,421,28,340,58,1386,77,7573
"04013061035",5532,194,538,37,734,108,1383,128,8654
"04013061036",1918,129,552,1,321,0,361,28,3310
"04013061037",4033,537,141,0,224,0,757,347,6039
"04013061038",3244,8,727,17,432,12,967,8,5415
"04013061039",3463,464,60,0,238,81,839,52,5197
"04013061040",3042,523,116,42,550,76,998,228,5575
"04013061041",1976,296,373,0,1562,360,1894,505,6966
"04013061042",1551,680,55,0,41,26,180,186,2719
"04013061043",1852,300,47,37,355,5,1095,128,3819
"04013061044",5032,413,259,0,510,50,1294,77,7635
"04013061045",4227,219,0,0,737,141,880,131,6335
"04013061046",3594,132,984,259,741,146,1679,115,7650
"04013061047",2344,98,406,2,499,16,790,18,4173
"04013061100",1267,112,159,51,127,29,294,29,2068
"04013061200",2601,1973,240,223,495,133,2294,1889,9848
"04013061300",1292,401,7,32,257,39,819,274,3121
"04013061401",729,587,166,16,157,168,792,606,3221
"04013061402",1991,1624,324,55,759,281,2289,1621,8944
"04013071503",4272,167,56,0,90,12,79,0,4676
"04013071504",3217,213,15,0,0,51,31,0,3527
"04013071505",5790,355,101,41,126,0,326,0,6739
"04013071506",3517,300,24,0,128,30,179,78,4256
"04013071509",4066,532,203,26,935,78,439,93,6372
"04013071510",3508,91,109,52,505,26,542,0,4833
"04013071511",2360,308,364,17,254,72,425,24,3824
"04013071512",5257,239,21,0,584,5,767,19,6892
"04013071513",1516,58,24,0,123,4,152,33,1910
"04013071514",3541,365,47,0,398,142,573,9,5075
"04013071515",2888,187,148,2,297,51,331,86,3990
"04013071516",2429,216,104,11,91,1,178,21,3051
"04013071517",3179,115,164,3,433,29,782,102,4807
"04013071600",2092,832,98,24,282,148,979,415,4870
"04013071701",2437,324,17,0,118,0,824,85,3805
"04013071702",2778,308,22,26,60,1,190,15,3400
"04013071801",3753,639,85,0,81,45,149,29,4781
"04013071802",2896,217,119,14,111,0,88,17,3462
"04013071903",5519,351,177,0,850,0,2191,111,9199
"04013071906",3980,572,85,155,745,254,1863,409,8063
"04013071909",3475,273,74,1,167,205,1053,56,5304
"04013071910",4113,1937,406,1,418,413,1506,949,9743
"04013071911",2028,488,299,0,433,141,813,333,4535
"04013071912",1505,567,216,0,430,39,833,451,4041
"04013071913",2807,1076,541,70,528,87,1596,530,7235
"04013071914",2155,625,95,13,496,234,1421,352,5391
"04013071915",2326,731,204,34,322,49,1226,611,5503
"04013082002",3953,308,465,225,581,107,2622,291,8552
"04013082007",2310,777,73,13,528,56,1880,612,6249
"04013082008",2898,1295,194,299,856,170,2967,1337,10016
"04013082009",2702,1596,450,40,602,186,2590,1418,9584
"04013082010",1885,1044,86,132,547,133,1858,1021,6706
"04013082012",4197,297,331,0,1152,81,3095,334,9487
"04013082016",1736,279,53,44,504,91,1221,241,4169
"04013082017",2393,632,1103,130,747,80,1729,499,7313
"04013082018",3435,330,482,14,737,112,3210,388,8708
"04013082019",1802,151,166,0,144,16,519,30,2828
"04013082020",2360,278,552,10,582,24,1015,182,5003
"04013082021",1401,77,165,6,152,0,594,14,2409
"04013082022",2715,176,386,0,618,13,1793,75,5776
"04013082023",3444,435,389,51,776,36,1890,348,7369
"04013082024",2713,671,440,0,517,294,1700,840,7175
"04013082025",1383,405,124,114,268,11,742,336,3383
"04013082026",4019,281,455,8,861,78,2889,91,8682
"04013082027",2587,532,306,6,528,142,1986,555,6642
"04013082028",1537,770,265,182,1218,38,1744,662,6416
"04013082203",5516,701,904,0,1096,267,4981,953,14418
"04013082204",3897,632,511,296,880,137,3805,620,10778
"04013082205",3196,611,445,67,739,38,2731,600,8427
"04013082206",2164,89,215,278,429,80,1748,144,5147
"04013082207",2183,213,44,0,325,45,1839,216,4865
"04013082208",2613,986,17,12,145,35,2521,933,7262
"04013082209",1869,811,23,0,212,85,1981,877,5858
"04013082210",2795,501,357,218,546,125,2260,479,7281
"04013082211",3299,226,260,58,1058,10,2958,182,8051
"04013083000",3991,1681,163,144,629,99,3842,1584,12133
"04013092305",3132,501,96,0,501,53,992,216,5491
"04013092306",4060,747,416,100,1002,137,1191,496,8149
"04013092307",4006,784,359,12,1027,29,1884,491,8592
"04013092308",4684,981,150,0,372,517,1297,809,8810
"04013092309",3587,316,452,102,606,146,1291,222,6722
"04013092311",1452,485,34,12,96,39,405,133,2656
"04013092312",2841,972,315,0,498,662,1177,243,6708
"04013092401",1780,862,276,175,670,374,1521,741,6399
"04013092402",1849,487,111,13,658,7,1005,166,4296
"04013092500",2520,886,448,73,868,129,1914,648,7486
"04013092600",1126,879,0,158,754,712,1011,1175,5815
"04013092705",1528,513,452,135,631,298,879,679,5115
"04013092708",1178,296,65,64,330,8,472,226,2639
"04013092709",3044,669,187,112,480,60,1268,326,6146
"04013092710",3132,397,108,0,495,11,1365,103,5611
"04013092711",1713,1076,35,16,467,219,976,889,5391
"04013092712",2443,658,422,102,768,11,1819,593,6816
"04013092713",2816,717,96,12,730,103,2091,585,7150
"04013092715",1877,1056,244,238,1089,149,2207,1122,7982
"04013092716",2498,558,168,13,697,166,2351,596,7047
"04013092717",1908,769,565,63,1038,456,1819,1179,7797
"04013092718",1702,1023,282,111,565,416,1583,1252,6934
"04013092719",2549,345,537,31,470,76,1041,67,5116
"04013092720",3097,144,446,0,993,92,1983,180,6935
"04013092721",1753,128,499,14,564,41,1024,52,4075
"04013092723",2989,386,235,29,63,67,864,215,4848
"04013092724",2508,373,13,72,413,32,411,118,3940
"04013092801",1575,1838,8,283,860,692,1932,2077,9265
"04013092802",2454,1230,45,367,894,510,2404,1416,9320
"04013092900",1079,862,31,36,284,549,1128,1276,5245
"04013093001",1964,1078,416,156,714,831,1441,1436,8036
"04013093002",1484,1634,117,200,803,92,1071,1199,6600
"04013093101",1875,1366,161,75,804,446,1670,1279,7676
"04013093104",1456,1576,134,256,482,352,1359,1378,6993
"04013093105",1914,1817,199,197,795,737,1986,2228,9873
"04013093106",1981,779,69,79,1056,277,2117,636,6994
"04013093200",1203,772,266,86,253,371,704,730,4385
"04013103205",2530,117,29,0,185,0,110,2,2973
"04013103206",2209,109,28,0,78,0,165,9,2598
"04013103207",2346,49,59,8,19,7,127,0,2615
"04013103208",3079,309,219,0,278,50,781,0,4716
"04013103209",4398,427,0,0,128,49,214,196,5412
"04013103210",4684,1299,152,20,444,71,389,668,7727
"04013103211",3807,328,0,0,207,8,298,0,4648
"04013103212",3744,324,9,0,171,16,200,0,4464
"04013103214",3498,65,37,18,133,15,52,0,3818
"04013103215",2411,50,0,0,148,0,133,0,2742
"04013103216",4652,137,73,0,365,54,369,37,5687
"04013103217",5206,277,16,0,866,110,372,0,6847
"04013103219",2161,203,8,0,339,10,29,20,2770
"04013103220",2414,63,2,0,373,80,171,0,3103
"04013103302",4756,1197,368,144,554,0,1919,296,9234
"04013103303",2709,441,83,0,175,16,377,174,3975
"04013103304",1908,1412,250,193,745,996,1687,2215,9406
"04013103305",1514,664,71,0,471,325,1420,723,5188
"04013103306",1718,1129,144,27,431,508,1180,1167,6304
"04013103400",3395,696,13,117,401,50,960,142,5774
"04013103501",2554,516,62,53,359,100,762,358,4764
"04013103502",4828,590,47,15,142,171,245,262,6300
"04013103604",2329,621,45,56,599,150,473,401,4674
"04013103605",5383,79,11,0,311,16,359,0,6159
"04013103606",3098,461,94,278,241,209,302,0,4683
"04013103607",4041,399,62,10,384,5,498,297,5696
"04013103608",2548,263,138,14,697,0,589,8,4257
"04013103609",3184,904,218,57,627,151,962,404,6507
"04013103611",4457,193,45,0,251,68,152,68,5234
"04013103612",3582,530,248,165,478,99,441,284,5827
"04013103614",2518,194,28,3,485,0,493,85,3806
"04013103615",2083,1411,257,206,377,307,1332,1150,7123
"04013103701",2306,931,114,114,654,94,455,315,4983
"04013103702",2528,321,47,34,317,0,642,72,3961
"04013103900",3529,1401,57,16,1017,322,1178,670,8190
"04013104000",4491,725,182,64,1165,97,1262,218,8204
"04013104100",4097,1313,14,29,803,118,1197,460,8031
"04013104202",4197,591,197,0,242,59,400,47,5733
"04013104203",4298,525,58,42,756,46,1009,75,6809
"04013104204",2464,293,15,72,214,86,721,44,3909
"04013104205",3336,363,69,20,1039,362,1465,299,6953
"04013104206",2362,524,0,0,843,221,1205,249,5404
"04013104207",3683,263,51,2,288,80,904,58,5329
"04013104212",4896,602,192,129,628,13,1131,132,7723
"04013104214",1915,224,11,5,118,11,372,78,2734
"04013104215",3339,439,180,15,231,95,525,185,5009
"04013104216",3584,670,142,7,409,113,538,150,5613
"04013104217",3897,564,79,40,252,127,533,55,5547
"04013104218",2697,368,0,101,396,11,598,35,4206
"04013104219",2318,464,67,0,257,19,630,116,3871
"04013104221",4283,364,315,72,640,317,1120,226,7337
"04013104222",3778,715,421,198,695,26,803,334,6970
"04013104223",1586,116,106,0,194,51,388,0,2441
"04013104224",4355,596,16,86,707,89,472,102,6423
"04013104225",3322,194,11,0,116,151,398,119,4311
"04013104226",3150,407,249,60,273,158,463,120,4880
"04013104227",1399,185,104,122,183,8,444,182,2627
"04013104301",2696,662,38,88,142,155,682,463,4926
"04013104302",1690,461,214,180,506,46,410,53,3560
"04013104401",2835,487,248,163,503,174,1235,320,5965
"04013104402",1097,345,60,73,1140,202,425,136,3478
"04013104501",1268,1005,171,194,186,219,817,871,4731
"04013104502",2337,2316,12,145,77,257,1778,2095,9017
"04013104600",2519,1434,154,24,171,75,1087,1075,6539
"04013104701",1490,542,57,0,218,166,468,429,3370
"04013104702",2311,1032,124,95,171,216,933,739,5621
"04013104801",2674,336,10,0,304,6,186,221,3737
"04013104802",4437,513,205,0,194,100,269,61,5779
"04013104900",3917,165,40,0,173,14,412,11,4732
"04013105002",2408,280,10,0,99,0,129,152,3078
"04013105003",4268,381,12,7,108,0,221,22,5019
"04013105004",2485,326,110,0,327,59,249,28,3584
"04013105101",3839,128,33,0,121,5,166,0,4292
"04013105102",3110,366,36,0,412,48,148,14,4134
"04013105103",2595,84,4,4,195,0,222,1,3105
"04013105200",4021,737,535,336,725,461,1774,461,9050
"04013105300",3915,808,19,35,152,36,1005,259,6229
"04013105400",2776,242,153,32,283,3,417,31,3937
"04013105501",821,790,138,67,617,175,744,550,3902
"04013105502",643,351,276,92,183,236,395,196,2372
"04013105503",1155,486,286,440,545,162,599,206,3879
"04013105601",2541,574,30,120,616,475,2094,703,7153
"04013105602",3255,1785,647,145,863,370,1201,1169,9435
"04013105701",2382,286,57,0,367,0,676,233,4001
"04013105702",2208,738,104,1,369,278,853,740,5291
"04013105800",3935,673,145,14,1361,727,2499,946,10300
"04013105900",3419,1134,66,338,470,102,1141,629,7299
"04013106001",793,498,65,115,79,58,351,357,2316
"04013106002",1234,477,75,33,48,29,466,228,2590
"04013106003",1502,501,93,71,388,231,497,342,3625
"04013106100",3890,331,72,59,375,37,478,160,5402
"04013106200",2951,112,65,0,347,0,253,41,3769
"04013106300",3288,850,118,26,193,28,514,87,5104
"04013106400",1980,259,195,0,555,32,78,122,3221
"04013106501",2525,225,10,0,336,209,553,185,4043
"04013106502",2308,421,184,84,401,15,520,115,4048
"04013106600",3007,90,0,0,231,115,371,19,3833
"04013106701",1120,780,302,346,322,720,478,325,4393
"04013106702",819,97,108,94,74,306,166,20,1684
"04013106703",1801,129,33,0,217,6,561,10,2757
"04013106801",1180,971,275,295,437,438,1037,708,5341
"04013106802",1954,640,107,58,655,32,740,312,4498
"04013106900",3610,1454,495,33,1565,542,3106,1626,12431
"04013107000",4049,1217,66,337,1009,597,2960,1314,11549
"04013107101",2161,1332,92,121,583,322,1887,1046,7544
"04013107102",1434,2550,268,118,234,636,1055,2606,8901
"04013107201",841,989,99,66,356,770,695,1293,5109
"04013107202",2547,1533,54,12,1008,107,2174,1089,8524
"04013107300",2261,1074,572,169,2474,118,2459,643,9770
"04013107400",3027,1832,521,480,838,719,1307,1319,10043
"04013107500",2885,148,163,79,170,74,229,25,3773
"04013107601",1903,839,116,97,152,247,338,132,3824
"04013107602",2117,227,63,63,241,119,555,95,3480
"04013107700",2037,272,134,42,561,119,245,71,3481
"04013107800",2418,81,9,0,88,0,118,15,2729
"04013107900",3366,28,0,33,216,133,198,0,3974
"04013108000",3238,201,11,0,80,0,225,0,3755
"04013108100",1573,89,42,0,71,69,150,38,2032
"04013108200",2825,331,22,0,158,77,534,77,4024
"04013108301",3220,325,0,0,126,48,485,130,4334
"04013108302",2280,186,45,22,306,8,200,0,3047
"04013108400",3155,661,157,30,433,337,633,391,5797
"04013108501",1609,346,77,15,444,90,643,316,3540
"04013108502",2392,273,160,12,812,127,792,84,4652
"04013108601",819,949,57,127,457,178,656,911,4154
"04013108602",2041,308,353,90,1143,312,1457,301,6005
"04013108802",973,255,27,61,393,87,298,115,2209
"04013108901",1319,489,147,250,557,204,487,441,3894
"04013108902",1847,1156,157,290,543,662,789,1012,6456
"04013109001",1364,1758,273,474,640,654,1147,1894,8204
"04013109002",1313,1093,432,213,507,701,1097,1350,6706
"04013109003",1553,2347,38,212,899,546,1962,2421,9978
"04013109101",1309,1148,45,133,561,269,1297,1254,6016
"04013109102",2512,1800,123,327,721,146,2936,1593,10158
"04013109200",1444,1455,33,222,248,425,1092,1397,6316
"04013109300",2326,1945,196,75,217,27,2062,1808,8656
"04013109400",1698,2445,234,83,1889,985,2497,2702,12533
"04013109500",2999,833,179,77,1038,205,2814,954,9099
"04013109601",2350,1343,286,197,1018,274,2662,1258,9388
"04013109602",3497,1404,132,318,538,510,3069,1646,11114
"04013109603",2775,1360,310,0,322,362,2501,1518,9148
"04013109604",1862,712,153,441,541,221,1855,922,6707
"04013109701",3048,2524,144,160,1449,714,3939,3070,15048
"04013109702",2157,1437,186,277,905,495,2501,1744,9702
"04013109703",1001,1076,84,30,590,132,1168,1096,5177
"04013109704",1468,576,151,21,281,550,1514,1016,5577
"04013109705",1052,525,68,0,243,41,1079,539,3547
"04013109801",1759,1268,81,97,616,229,1974,1477,7501
"04013109802",2298,1218,44,45,935,280,2555,1338,8713
"04013109900",3025,2229,350,206,616,625,3139,2737,12927
"04013110001",2056,1080,72,92,453,198,2029,1121,7101
"04013110002",886,1433,94,218,723,569,1311,1770,7004
"04013110100",2890,3263,84,0,420,104,2985,3198,12944
"04013110400",3270,563,69,83,905,185,1418,112,6605
"04013110501",1943,206,88,59,701,32,346,28,3403
"04013110502",1070,364,274,105,673,86,593,58,3223
"04013110600",2206,507,692,0,434,335,801,432,5407
"04013110701",996,562,179,79,269,346,593,473,3497
"04013110702",2065,733,51,141,323,215,1116,492,5136
"04013110801",2306,860,374,92,777,417,963,469,6258
"04013110802",1758,200,39,10,222,40,847,67,3183
"04013110901",1637,580,0,144,309,533,531,639,4373
"04013110902",2262,1073,155,133,686,914,1089,1236,7548
"04013111000",3358,258,298,45,581,131,1108,192,5971
"04013111100",3243,241,49,132,349,72,391,29,4506
"04013111201",2176,1114,381,104,1055,880,1316,1446,8472
"04013111202",635,401,50,38,242,161,403,438,2368
"04013111203",436,191,347,161,250,66,186,23,1660
"04013111204",1371,249,214,11,285,20,458,193,2801
"04013111300",3553,400,272,164,635,261,1245,178,6708
"04013111401",2485,1034,128,0,893,395,2563,1156,8654
"04013111402",2103,511,400,76,588,524,1651,733,6586
"04013111501",681,552,33,0,241,449,772,984,3712
"04013111502",2440,1294,85,56,1413,802,2590,1703,10383
"04013111601",1103,944,157,46,612,296,1196,1010,5364
"04013111602",1394,1371,41,258,873,881,1735,2002,8555
"04013111700",3247,1074,235,69,538,423,1350,931,7867
"04013111800",2706,382,172,101,325,19,419,34,4158
"04013111900",1851,126,121,19,175,61,360,68,2781
"04013112100",1491,1800,12,24,407,345,1604,2142,7825
"04013112201",1824,1362,41,86,292,266,1979,1603,7453
"04013112202",2352,1039,224,9,277,347,2128,1277,7653
"04013112301",1982,1421,194,104,1357,303,3086,1733,10180
"04013112302",2205,1930,554,210,1762,906,3144,2651,13362
"04013112401",2700,1420,290,161,1674,734,4145,2202,13326
"04013112402",2505,1444,144,17,875,156,3084,1589,9814
"04013112502",2582,1746,267,0,725,891,2949,2463,11623
"04013112503",3659,2603,101,2,1311,721,3980,2932,15309
"04013112504",1661,1279,224,42,347,249,1640,1246,6688
"04013112505",3200,3180,89,38,1475,710,3951,3721,16364
"04013112507",846,1102,115,97,177,279,984,1198,4798
"04013112508",1246,587,0,13,138,58,960,593,3595
"04013112509",3073,2368,985,230,793,1245,2799,3123,14616
"04013112510",3387,499,234,57,395,0,3073,459,8104
"04013112511",4589,981,378,61,750,212,4118,860,11949
"04013112512",781,629,142,20,204,41,608,601,3026
"04013112513",5341,507,795,250,893,477,5065,558,13886
"04013112514",1577,360,1256,181,728,269,1476,571,6418
"04013112601",902,1193,52,165,220,182,866,1157,4737
"04013112602",2122,3928,0,65,736,549,2406,4129,13935
"04013112700",2253,2665,132,149,494,416,2547,3030,11686
"04013112900",2188,1776,115,240,347,128,1434,1399,7627
"04013113000",1384,237,83,25,141,13,306,87,2276
"04013113100",903,544,352,72,203,64,290,65,2493
"04013113201",847,1181,11,45,305,481,913,1454,5237
"04013113202",378,858,125,61,175,506,428,1163,3694
"04013113203",917,793,31,38,286,289,819,973,4146
"04013113300",1445,2115,50,134,288,1414,1268,2955,9669
"04013113400",0,7,0,0,0,0,0,7,14
"04013113501",1841,428,287,248,944,267,2249,634,6898
"04013113502",796,510,75,179,401,688,1053,1150,4852
"04013113601",1618,888,286,47,1045,152,1778,923,6737
"04013113602",636,716,556,319,800,592,1218,1200,6037
"04013113700",2998,1016,471,1330,777,995,1906,1478,10971
"04013113801",728,356,74,0,298,432,394,530,2812
"04013113802",0,0,0,0,0,0,0,0,0
"04013113900",120,368,32,215,133,160,175,507,1710
"04013114000",496,296,242,261,274,328,340,374,2611
"04013114100",314,127,31,22,45,18,41,54,652
"04013114200",416,744,16,189,59,59,317,623,2423
"04013114301",228,585,99,91,165,108,272,255,1803
"04013114302",501,1061,385,478,83,180,521,1104,4313
"04013114401",775,753,87,107,138,78,859,688,3485
"04013114402",513,821,36,154,104,193,532,934,3287
"04013114500",1357,1593,107,67,423,242,1628,1764,7181
"04013114600",894,780,2,2,297,69,1140,804,3988
"04013114703",419,562,0,0,97,87,402,557,2124
"04013114800",1566,899,175,160,286,374,1610,1067,6137
"04013114900",632,1443,112,87,242,200,647,1454,4817
"04013115200",788,596,446,328,199,296,549,622,3824
"04013115300",1114,464,282,248,369,420,1248,837,4982
"04013115400",744,624,91,9,974,166,1644,671,4923
"04013115500",1795,1272,35,0,495,180,1918,1393,7088
"04013115600",1408,690,974,761,486,420,1488,1009,7236
"04013115700",2626,1670,385,227,1122,423,3441,2001,11895
"04013115801",1546,1803,105,199,276,541,1450,2185,8105
"04013115802",1453,1083,165,195,385,150,1702,1118,6251
"04013115900",1260,1165,627,203,1188,658,1606,1745,8452
"04013116000",1841,326,1138,494,612,364,1568,418,6761
"04013116100",1145,1321,463,343,363,362,1385,1452,6834
"04013116202",2021,1122,258,227,1233,260,2580,1056,8757
"04013116203",1748,434,843,182,858,534,1112,749,6460
"04013116204",1381,222,128,26,1398,151,1738,208,5252
"04013116205",1826,1150,479,116,782,556,1008,1315,7232
"04013116300",1911,638,1227,171,1742,1066,2749,1501,11005
"04013116400",1728,671,807,273,1078,1143,2388,1607,9695
"04013116500",2855,712,201,77,1122,300,3578,921,9766
"04013116602",3993,1245,1414,304,1114,542,3918,1713,14243
"04013116603",3634,97,1081,179,1104,197,2756,184,9232
"04013116604",1721,204,724,459,531,257,1263,129,5288
"04013116605",3435,266,591,275,558,29,2634,71,7859
"04013116606",2341,879,1256,281,1269,405,2340,1113,9884
"04013116607",1601,32,1003,94,174,39,1511,44,4498
"04013116608",2067,266,121,41,790,48,1458,199,4990
"04013116609",1792,180,1116,0,606,8,833,16,4551
"04013116610",2567,361,920,273,843,300,1832,367,7463
"04013116611",2716,4,151,28,612,93,1725,38,5367
"04013116612",2418,515,930,0,1405,0,2248,462,7978
"04013116613",2536,1166,867,240,1000,111,1106,1178,8204
"04013116702",2747,1331,561,367,1616,973,3063,1991,12649
"04013116703",1639,373,519,65,940,217,1542,555,5850
"04013116704",3799,195,949,20,1872,152,2099,164,9250
"04013116707",2123,49,19,0,449,0,397,0,3037
"04013116708",4351,229,136,195,312,111,368,121,5823
"04013116709",1273,98,82,6,345,24,226,3,2057
"04013116710",3550,128,119,13,527,23,489,21,4870
"04013116711",1244,81,272,34,361,22,170,6,2190
"04013116712",4490,409,496,59,772,125,962,73,7386
"04013116713",5173,95,280,61,416,233,784,18,7060
"04013116714",2772,206,165,22,561,18,236,57,4037
"04013116715",1722,47,30,0,186,2,213,9,2209
"04013116717",2266,127,477,114,898,171,769,75,4897
"04013116718",1935,126,385,18,203,108,475,52,3302
"04013116719",5641,159,213,23,769,50,997,10,7862
"04013116720",2469,128,248,42,794,24,818,71,4594
"04013116721",2873,309,29,0,318,41,257,38,3865
"04013116725",4147,171,172,0,424,0,308,0,5222
"04013116727",3041,131,48,8,523,15,337,0,4103
"04013116728",3876,104,185,0,640,31,297,0,5133
"04013116729",3537,83,122,0,554,8,386,43,4733
"04013116730",1179,67,262,0,438,8,108,0,2062
"04013116731",2678,113,54,0,405,0,293,17,3560
"04013116732",1749,713,156,0,686,133,1254,695,5386
"04013116733",292,0,0,0,38,0,28,0,358
"04013116800",1585,845,82,0,93,72,721,638,4036
"04013116900",1027,866,26,0,127,224,1015,1022,4307
"04013117000",2682,895,277,159,989,799,1913,1091,8805
"04013117100",1540,200,122,9,623,94,669,98,3355
"04013117200",527,200,0,0,398,205,755,372,2457
"04013117300",301,779,9,16,6,111,242,876,2340
"04013216806",2475,162,0,13,194,44,126,0,3014
"04013216807",4698,277,7,0,210,0,165,0,5357
"04013216809",4357,168,80,0,496,73,54,0,5228
"04013216810",889,89,13,44,124,20,51,0,1230
"04013216813",3813,176,40,0,121,18,40,0,4208
"04013216816",4540,548,0,0,460,13,390,171,6122
"04013216818",5610,291,213,78,219,82,102,20,6615
"04013216819",6034,104,13,4,152,15,143,0,6465
"04013216820",4080,229,0,0,164,32,321,64,4890
"04013216821",5021,248,35,59,233,50,115,25,5786
"04013216822",3345,185,105,0,176,0,113,26,3950
"04013216826",3815,381,57,0,301,33,122,18,4727
"04013216829",3997,195,182,29,560,0,77,0,5040
"04013216830",2630,221,117,0,159,7,115,7,3256
"04013216831",2330,129,28,0,114,62,34,123,2820
"04013216832",1604,128,9,0,0,0,20,0,1761
"04013216833",3302,509,0,0,376,44,197,48,4476
"04013216834",1911,68,48,0,32,2,159,0,2220
"04013216835",1844,92,98,14,101,10,327,22,2508
"04013216836",2902,339,0,0,146,0,107,0,3494
"04013216837",4209,171,117,0,644,21,185,38,5385
"04013216838",3824,125,94,0,599,0,378,2,5022
"04013216839",3278,171,9,0,457,0,181,2,4098
"04013216840",4413,157,0,0,68,17,116,0,4771
"04013216841",3228,120,54,0,140,24,221,24,3811
"04013216842",3187,204,0,19,421,28,182,0,4041
"04013216843",3019,62,0,0,121,0,99,0,3301
"04013216844",3015,212,0,0,250,2,173,24,3676
"04013216845",1678,46,72,0,211,0,192,0,2199
"04013216846",6127,192,115,0,551,36,355,0,7376
"04013216847",4987,397,8,0,633,18,484,0,6527
"04013216848",5185,161,0,1,433,0,302,27,6109
"04013216849",5343,203,0,0,672,20,163,11,6412
"04013216850",3335,28,52,0,482,0,722,0,4619
"04013216851",3083,212,59,0,106,173,128,29,3790
"04013216852",3025,91,5,22,269,19,311,0,3742
"04013216853",3656,554,53,0,561,82,114,13,5033
"04013216901",2389,78,0,0,87,70,86,70,2780
"04013216902",3249,252,48,6,128,8,134,25,3850
"04013217001",3775,582,8,0,321,0,527,0,5213
"04013217002",4611,291,103,0,441,69,630,0,6145
"04013217101",2447,165,0,0,162,0,267,0,3041
"04013217102",2318,251,0,11,73,133,268,113,3167
"04013217201",871,210,132,24,179,30,90,29,1565
"04013217203",2659,233,193,0,176,55,168,128,3612
"04013217204",1918,594,128,68,369,135,210,207,3629
"04013217300",2422,169,53,22,234,20,122,0,3042
"04013217400",2895,263,23,12,188,0,456,11,3848
"04013217501",1607,1134,103,29,202,476,375,1380,5306
"04013217502",2272,403,95,126,75,87,656,126,3840
"04013217600",3728,331,168,2,468,71,1099,143,6010
"04013217700",3845,155,160,38,195,63,464,11,4931
"04013217800",4842,1392,383,0,715,83,823,840,9078
"04013217900",3424,335,28,130,239,20,368,51,4595
"04013218000",4436,814,45,0,278,265,1198,264,7300
"04013218100",1400,166,149,0,157,19,451,89,2431
"04013218200",3566,666,56,0,1019,232,1751,380,7670
"04013218300",2589,547,6,0,515,0,277,56,3990
"04013318400",2008,1071,166,51,338,306,797,559,5296
"04013318501",2420,587,19,0,455,68,752,105,4406
"04013318700",422,216,12,15,27,48,0,3,743
"04013318800",3054,1470,141,161,870,574,982,863,8115
"04013318900",3704,1216,192,71,703,483,1262,145,7776
"04013319000",1287,677,37,18,205,96,93,54,2467
"04013319101",451,591,7,184,342,668,245,219,2707
"04013319103",790,1446,47,163,755,1181,279,515,5176
"04013319104",1977,1692,38,203,618,1111,962,727,7328
"04013319201",1967,1401,195,146,727,425,890,594,6345
"04013319202",1113,933,361,334,269,550,244,617,4421
"04013319300",1228,623,58,128,445,206,761,94,3543
"04013319401",4343,561,345,38,540,82,831,249,6989
"04013319402",3160,272,195,7,469,72,597,59,4831
"04013319403",2859,816,185,18,534,416,368,461,5657
"04013319404",2771,269,48,17,245,25,702,65,4142
"04013319500",3450,994,109,26,1031,25,1066,59,6760
"04013319600",4038,1068,121,83,648,150,504,413,7025
"04013319703",2511,355,63,157,828,291,674,119,4998
"04013319704",692,177,96,0,336,46,237,76,1660
"04013319705",2322,284,77,113,343,153,526,136,3954
"04013319706",2293,1393,251,56,1156,289,1567,1254,8259
"04013319800",3886,1482,161,59,1043,461,1442,884,9418
"04013319902",1615,222,40,89,303,0,446,48,2763
"04013319903",4356,391,271,15,841,19,801,28,6722
"04013319904",3762,159,220,0,280,50,814,62,5347
"04013319905",3985,431,60,15,649,225,1078,19,6462
"04013319906",2240,124,210,48,491,35,366,9,3523
"04013319907",2012,42,86,0,159,0,162,0,2461
"04013319908",1471,137,126,37,320,30,622,63,2806
"04013319909",1942,9,25,1,296,33,266,11,2583
"04013319910",3117,290,11,0,836,129,390,108,4881
"04013320001",2754,470,974,331,1280,441,1134,293,7677
"04013320002",930,386,46,82,3282,1125,2795,897,9543
"04013320007",3879,813,344,0,2137,650,2015,723,10561
"04013320100",1561,423,13,49,516,124,206,99,2991
"04013420104",4668,228,45,0,185,26,562,15,5729
"04013420105",4574,262,0,7,526,41,398,63,5871
"04013420107",5993,86,61,0,363,0,351,0,6854
"04013420108",1177,49,0,0,43,0,22,0,1291
"04013420109",3411,127,93,0,138,33,310,6,4118
"04013420110",4960,505,36,0,69,37,978,118,6703
"04013420111",3435,605,13,0,330,23,986,111,5503
"04013420112",2719,177,9,94,108,9,494,87,3697
"04013420113",1972,725,87,24,437,171,494,168,4078
"04013420114",1907,1117,76,36,504,83,519,343,4585
"04013420115",1923,714,58,0,53,11,590,186,3535
"04013420116",1863,472,9,13,221,33,257,218,3086
"04013420202",4454,527,85,56,544,36,1094,267,7063
"04013420206",2968,366,0,0,74,0,77,10,3495
"04013420207",2363,114,0,0,152,55,142,0,2826
"04013420208",4091,526,82,42,401,106,1067,178,6493
"04013420209",3682,162,116,0,240,12,464,47,4723
"04013420210",3981,382,7,0,352,159,599,142,5622
"04013420211",3567,281,12,0,302,16,360,11,4549
"04013420212",2577,226,8,2,47,3,140,37,3040
"04013420213",2141,206,0,0,24,0,12,0,2383
"04013420214",2723,458,44,0,182,142,251,177,3977
"04013420215",1274,226,29,0,173,0,473,79,2254
"04013420216",3179,451,182,241,96,80,432,108,4769
"04013420301",1818,47,47,2,118,11,212,4,2259
"04013420302",4164,549,39,43,391,81,443,45,5755
"04013420303",3003,407,7,34,277,44,261,324,4357
"04013420304",980,28,3,0,164,11,15,0,1201
"04013420401",2612,1142,5,71,201,449,749,802,6031
"04013420402",1245,423,0,2,68,4,107,110,1959
"04013420501",4604,655,186,138,514,401,1710,259,8467
"04013420503",2071,249,415,63,388,129,285,82,3682
"04013420504",2295,355,64,33,228,19,541,121,3656
"04013420602",3934,281,294,52,267,9,925,98,5860
"04013420603",2842,254,100,0,403,0,537,72,4208
"04013420604",3447,216,24,0,234,21,525,21,4488
"04013420704",4049,489,182,12,280,131,817,216,6176
"04013420705",2850,156,24,6,419,34,137,46,3672
"04013420706",3064,448,47,15,496,140,515,197,4922
"04013420707",1997,293,106,24,194,67,302,93,3076
"04013420708",2967,430,111,0,465,177,464,72,4686
"04013420709",2721,345,91,10,132,65,184,81,3629
"04013420710",2177,621,88,46,27,73,386,201,3619
"04013420800",3389,583,49,5,255,70,545,364,5260
"04013420901",2208,953,91,0,136,307,822,673,5190
"04013420902",2157,566,41,51,314,131,622,339,4221
"04013421001",2291,995,92,24,73,113,486,704,4778
"04013421002",1645,302,51,10,301,41,605,112,3067
"04013421101",2277,789,234,28,547,163,1001,471,5510
"04013421102",3793,717,296,9,817,213,1297,374,7516
"04013421201",3216,1043,180,79,436,355,759,576,6644
"04013421202",3046,347,69,134,544,66,1352,208,5766
"04013421302",3566,1319,119,0,450,376,2118,1483,9431
"04013421303",2508,715,174,197,672,427,1459,481,6633
"04013421304",1314,560,234,106,361,214,478,230,3497
"04013421400",1369,500,38,230,185,109,667,213,3311
"04013421501",2134,527,0,20,589,219,1670,485,5644
"04013421502",2035,597,33,14,66,140,802,636,4323
"04013421601",2220,895,10,4,241,89,1057,668,5184
"04013421602",2503,1266,22,28,310,244,1616,1344,7333
"04013421701",3070,692,229,91,697,132,1439,219,6569
"04013421702",2747,710,95,0,223,30,1460,476,5741
"04013421801",1795,256,24,0,468,391,1178,474,4586
"04013421802",2919,1000,0,26,332,345,1645,1146,7413
"04013421901",2467,452,49,26,306,287,1865,440,5892
"04013421902",2919,1521,110,66,1045,549,2945,1827,10982
"04013422001",1873,2263,47,0,133,343,1133,2325,8117
"04013422002",2359,1022,43,53,204,114,1851,892,6538
"04013422102",2984,592,60,74,692,127,2290,284,7103
"04013422103",1586,1156,122,137,648,416,441,523,5029
"04013422104",2721,1048,39,380,339,851,1208,877,7463
"04013422105",2362,691,53,0,312,170,1345,529,5462
"04013422106",3029,1769,161,233,711,366,2133,1534,9936
"04013422107",1675,771,250,237,559,292,857,300,4941
"04013422203",3088,1114,422,58,719,191,727,533,6852
"04013422204",2010,359,143,81,473,151,415,141,3773
"04013422205",1194,42,0,0,55,0,306,11,1608
"04013422209",5335,543,353,0,502,294,1618,172,8817
"04013422210",4378,331,95,9,678,115,1163,23,6792
"04013422211",2090,151,0,0,234,0,259,48,2782
"04013422212",3046,232,116,0,563,58,522,94,4631
"04013422213",2049,158,81,4,287,24,466,27,3096
"04013422215",1401,172,109,6,194,2,387,93,2364
"04013422216",4612,326,23,0,434,49,922,21,6387
"04013422217",2689,268,92,0,404,4,463,26,3946
"04013422218",2152,221,68,10,538,76,1043,24,4132
"04013422219",2176,210,203,12,319,72,505,52,3549
"04013422220",1706,34,26,0,224,0,303,0,2293
"04013422221",2504,371,110,0,509,34,561,130,4219
"04013422222",1241,389,76,9,354,8,404,112,2593
"04013422301",3364,1550,100,0,696,92,2722,1346,9870
"04013422302",3290,463,106,0,835,289,1506,380,6869
"04013422304",2453,133,85,197,283,9,938,168,4266
"04013422305",4573,269,131,0,972,59,693,62,6759
"04013422307",3524,179,220,0,536,142,1221,25,5847
"04013422308",4279,297,150,9,707,71,1187,120,6820
"04013422309",3773,304,155,47,1099,85,1005,10,6478
"04013422401",1715,304,278,47,647,64,998,140,4193
"04013422402",3642,671,74,12,536,196,961,505,6597
"04013422403",4134,425,52,125,506,10,789,49,6090
"04013422404",3825,109,81,0,421,20,369,0,4825
"04013422501",4556,418,302,22,603,4,1527,268,7700
"04013422502",3943,870,172,28,522,31,686,480,6732
"04013422503",4299,1035,145,0,668,16,2128,581,8872
"04013422504",3881,352,70,15,578,154,947,294,6291
"04013422506",4303,344,187,24,469,82,824,15,6248
"04013422507",3562,432,65,0,269,0,406,67,4801
"04013422508",2732,564,45,0,241,159,222,94,4057
"04013422509",4256,226,167,1,413,21,599,87,5770
"04013422510",2744,92,92,29,342,155,280,28,3762
"04013422511",2633,85,32,13,146,0,335,39,3283
"04013422512",4688,41,68,0,780,0,946,0,6523
"04013422513",3647,237,173,44,189,57,418,26,4791
"04013422514",3273,429,138,187,310,11,932,51,5331
"04013422606",8551,89,104,1,1391,0,588,4,10728
"04013422607",3727,202,76,0,43,0,389,36,4473
"04013422609",2651,516,59,1,580,72,734,269,4882
"04013422610",2415,210,39,0,15,0,123,0,2802
"04013422615",5327,389,263,0,1338,39,1225,87,8668
"04013422616",4227,321,128,1,454,0,929,21,6081
"04013422617",4658,228,162,4,599,118,626,92,6487
"04013422618",2891,118,8,0,21,0,78,0,3116
"04013422620",3129,39,0,8,279,9,440,0,3904
"04013422621",3439,602,22,0,791,0,644,0,5498
"04013422622",4158,97,120,37,441,42,845,0,5740
"04013422623",3293,798,138,1,506,157,629,147,5669
"04013422624",2460,446,12,0,28,67,65,83,3161
"04013422625",2202,651,96,0,332,75,90,130,3576
"04013422626",2042,291,0,4,160,8,188,62,2755
"04013422627",2501,847,0,0,240,69,799,38,4494
"04013422628",2224,1211,123,19,257,16,844,434,5128
"04013422629",2461,231,36,1,296,0,609,0,3634
"04013422630",3203,1412,0,0,161,300,405,953,6434
"04013422631",3004,347,527,0,496,62,664,117,5217
"04013422632",3234,458,225,0,192,10,854,1,4974
"04013422633",2402,738,46,38,274,30,741,222,4491
"04013422634",3389,876,17,0,119,0,1221,466,6088
"04013422635",1872,100,0,0,163,5,442,0,2582
"04013422636",1485,114,337,39,141,103,119,20,2358
"04013422637",2764,57,214,0,366,0,543,13,3957
"04013422638",2244,656,186,86,298,72,741,93,4376
"04013422639",3148,328,33,0,96,0,0,0,3605
"04013422640",3836,264,205,0,289,98,511,146,5349
"04013422641",4445,444,130,12,953,103,1282,120,7489
"04013422642",3840,547,130,58,1100,0,1022,1,6698
"04013422643",4634,187,166,3,925,26,1235,46,7222
"04013422644",6304,545,0,11,709,0,773,179,8521
"04013422646",6917,119,510,92,716,236,1109,236,9935
"04013522800",636,258,9,22,81,47,43,26,1122
"04013522901",3250,332,192,0,424,104,1153,161,5616
"04013522903",2862,1156,355,218,389,449,2406,1470,9305
"04013522904",2037,1923,532,12,686,238,1528,2082,9038
"04013523002",4070,1101,76,23,477,307,2784,1029,9867
"04013523003",3648,829,456,59,1007,283,1467,738,8487
"04013523005",3537,330,150,125,892,80,991,43,6148
"04013523006",3655,736,345,30,642,187,855,491,6941
"04013523102",3174,1298,160,101,632,242,1642,1245,8494
"04013523103",3485,304,395,0,1316,234,1100,351,7185
"04013523104",3306,707,120,203,749,263,2168,662,8178
"04013610000",5472,166,48,0,668,0,349,0,6703
"04013610100",783,22,11,0,192,0,84,0,1092
"04013610200",7014,414,422,0,282,12,1401,39,9584
"04013610300",8419,335,38,0,1097,0,1344,128,11361
"04013610400",5528,115,40,0,245,20,692,16,6656
"04013610500",6001,123,0,0,255,0,359,0,6738
"04013610600",4612,227,87,1,293,12,183,23,5438
"04013610700",6584,1033,47,0,177,23,671,47,8582
"04013610800",2808,47,106,0,775,0,500,27,4263
"04013610900",5685,109,77,0,760,2,462,2,7097
"04013611000",2400,3,18,65,148,21,189,22,2866
"04013611100",2954,33,22,0,129,34,230,0,3402
"04013611200",5048,70,62,11,505,0,852,21,6569
"04013611300",3956,224,89,27,310,35,668,19,5328
"04013611400",5208,204,240,0,404,167,538,0,6761
"04013611500",5180,104,95,1,1042,0,331,2,6755
"04013611600",2858,50,27,0,252,0,505,0,3692
"04013611700",4858,337,383,49,163,63,361,21,6235
"04013611800",6268,444,66,0,305,0,455,0,7538
"04013611900",2129,252,12,0,170,5,170,0,2738
"04013612000",2330,34,11,0,162,0,113,0,2650
"04013612200",3038,234,75,0,529,0,309,0,4185
"04013612300",6370,464,257,17,1365,14,1229,262,9978
"04013612400",5958,371,45,0,691,49,408,55,7577
"04013612500",3846,306,30,0,250,35,198,151,4816
"04013612600",1899,68,12,0,54,10,97,0,2140
"04013612700",2159,58,0,0,97,25,137,0,2476
"04013612800",1850,46,0,0,274,0,146,0,2316
"04013612900",2177,84,0,6,98,1,42,1,2409
"04013613000",3250,155,8,0,110,2,333,0,3858
"04013613100",2358,142,19,0,211,0,60,0,2790
"04013613200",2976,196,0,0,453,51,84,0,3760
"04013613300",6590,577,71,0,326,0,528,38,8130
"04013613400",3488,239,0,0,48,0,353,17,4145
"04013613500",3748,409,40,1,297,0,394,0,4889
"04013613600",3833,163,23,2,359,51,568,2,5001
"04013613700",4543,251,132,0,413,0,658,87,6084
"04013613800",3890,11,126,2,94,0,394,0,4517
"04013613900",5134,460,15,0,594,11,586,0,6800
"04013614000",3980,228,41,0,125,0,427,0,4801
"04013614100",4902,195,284,0,622,0,518,62,6583
"04013614200",4337,224,96,0,239,34,465,0,5395
"04013614300",2239,65,73,2,409,26,222,0,3036
"04013614400",2646,410,66,0,278,0,417,0,3817
"04013614500",3393,403,172,8,298,106,681,61,5122
"04013614600",4734,398,171,105,728,83,723,76,7018
"04013614700",1659,550,90,69,38,0,369,84,2859
"04013614800",2994,653,34,12,489,130,633,14,4959
"04013614900",2490,276,19,11,716,56,116,0,3684
"04013615000",6376,365,99,0,1029,0,274,108,8251
"04013615100",3084,349,14,0,297,0,129,48,3921
"04013615200",4956,252,113,0,503,12,434,0,6270
"04013615300",1961,306,9,0,17,11,38,2,2344
"04013615400",2365,172,0,0,36,10,0,10,2593
"04013615500",2586,88,36,0,46,0,43,0,2799
"04013615600",3439,234,76,0,15,0,448,1,4213
"04013615700",2251,24,83,0,178,0,239,0,2775
"04013615800",4041,275,66,0,714,41,463,20,5620
"04013615900",3039,656,0,0,289,82,295,63,4424
"04013616000",1179,116,36,6,241,17,187,7,1789
"04013616100",2694,212,66,0,467,63,635,21,4158
"04013616200",2812,224,86,0,238,9,511,18,3898
"04013616300",1491,27,0,1,422,0,389,1,2331
"04013616400",2806,362,91,120,1697,155,142,8,5381
"04013616500",2292,213,267,63,318,20,685,84,3942
"04013616600",4787,475,216,1,563,16,1036,0,7094
"04013616700",3475,292,88,0,442,0,724,0,5021
"04013616800",4659,700,123,0,398,3,817,339,7039
"04013616900",3551,515,45,56,208,169,352,0,4896
"04013617000",4752,716,106,0,478,43,674,207,6976
"04013617100",1842,122,46,0,219,0,112,0,2341
"04013617200",2502,52,62,0,177,0,161,24,2978
"04013617300",2680,149,12,9,490,2,374,0,3716
"04013617400",5884,726,223,22,96,0,457,17,7425
"04013617500",2919,320,63,0,45,0,234,0,3581
"04013617600",4413,396,182,0,851,18,895,18,6773
"04013617700",2502,445,245,40,352,133,256,73,4046
"04013617800",2447,96,29,0,60,6,324,15,2977
"04013617900",2295,149,35,0,303,55,537,91,3465
"04013618000",3724,441,113,25,484,61,495,132,5475
"04013618100",3451,236,46,0,380,14,461,79,4667
"04013618200",2840,334,103,39,197,241,508,82,4344
"04013618300",2460,167,95,0,224,90,369,12,3417
"04013618400",2784,448,134,10,283,49,626,231,4565
"04013618500",2991,420,95,33,292,72,667,170,4740
"04013618600",2963,881,37,0,391,206,698,539,5715
"04013618700",2209,433,10,0,178,116,457,310,3713
"04013618800",2927,1197,150,29,384,112,901,782,6482
"04013618900",4663,724,144,76,593,15,698,135,7048
"04013619000",2482,242,94,31,165,0,182,36,3232
"04013619100",1777,463,243,82,101,95,632,138,3531
"04013619200",3550,1144,103,27,362,238,1651,553,7628
"04013619300",3075,649,0,21,349,12,675,148,4929
"04013619400",3023,640,75,0,708,74,873,444,5837
"04013619500",4590,917,84,0,332,54,1119,582,7678
"04013619600",1555,130,60,0,279,13,430,4,2471
"04013619700",3293,232,144,20,302,57,927,117,5092
"04013619800",3014,241,108,2,1145,55,347,22,4934
"04013619900",4337,223,39,0,821,17,185,0,5622
"04013723303",26,0,0,0,0,0,0,0,26
"04013723304",2780,907,36,72,258,20,1264,557,5894
"04013723305",1794,502,18,0,261,343,1487,472,4877
"04013723306",28,39,0,0,0,0,2,39,108
"04013723307",2070,54,35,0,253,18,307,24,2761
"04013723308",5801,231,305,0,522,187,978,201,8225
"04013810000",1240,23,97,0,450,63,163,46,2082
"04013810100",5329,93,146,6,892,67,686,0,7219
"04013810200",2183,170,123,13,805,22,365,75,3756
"04013810300",3815,626,154,71,1190,35,1055,344,7290
"04013810400",3226,203,332,57,857,162,871,173,5881
"04013810500",4052,60,353,0,733,28,858,0,6084
"04013810600",5401,90,252,1,971,15,950,2,7682
"04013810700",4647,109,717,2,1085,606,1489,206,8861
"04013810800",3452,267,28,12,851,47,578,148,5383
"04013810900",4144,172,490,0,661,168,816,0,6451
"04013811000",2493,15,16,2,340,0,554,0,3420
"04013811100",1854,37,11,55,243,163,232,0,2595
"04013811200",1543,121,195,120,750,91,501,0,3321
"04013811300",2281,153,41,21,490,34,531,81,3632
"04013811400",4491,214,121,0,483,0,1092,71,6472
"04013811500",1652,81,249,8,412,72,423,23,2920
"04013811600",2646,488,226,0,765,13,632,411,5181
"04013811700",3604,337,159,43,503,13,1403,205,6267
"04013811800",1382,7,182,10,619,0,178,1,2379
"04013811900",4671,102,130,0,1169,27,1109,72,7280
"04013812000",2387,569,130,0,600,247,703,424,5060
"04013812100",4106,147,568,1,1181,19,623,2,6647
"04013812200",5961,30,159,1,1329,41,1320,3,8844
"04013812300",3599,85,350,15,676,0,387,50,5162
"04013812400",2664,263,65,0,765,0,443,0,4200
"04013812500",1633,6,0,188,787,0,403,0,3017
"04013812600",3233,139,347,0,380,36,460,16,4611
"04013812700",4399,63,226,0,945,253,455,209,6550
"04013812800",2858,427,111,0,1139,13,478,0,5026
"04013812900",1797,129,67,14,616,11,178,0,2812
"04013813000",2967,63,57,0,714,69,198,18,4086
"04013813100",1557,0,34,0,718,7,176,0,2492
"04013813200",3104,21,85,13,1033,78,516,12,4862
"04013813300",4220,24,38,2,1317,0,764,22,6387
"04013813400",2742,95,158,0,718,1,655,29,4398
"04013813500",2909,16,115,0,398,0,229,0,3667
"04013813600",2593,30,137,0,523,28,342,14,3667
"04013813700",2247,99,32,0,45,0,90,0,2513
"04013813800",2379,225,0,0,31,0,46,0,2681
"04013813900",3981,273,471,93,677,171,1236,21,6923
"04013814000",2229,170,0,0,17,0,193,0,2609
"04013814100",4301,411,177,0,1038,51,1466,45,7489
"04013814200",1900,50,121,20,416,17,183,24,2731
"04013814300",3346,116,293,0,417,83,580,0,4835
"04013814400",4054,154,115,0,509,58,700,35,5625
"04013814500",4206,105,350,0,596,0,1024,18,6299
"04013814600",3587,281,100,0,683,77,914,87,5729
"04013814700",3536,236,518,0,230,0,501,140,5161
"04013814800",5266,574,138,113,693,0,847,64,7695
"04013814900",2392,52,20,0,336,38,558,30,3426
"04013815000",3740,50,123,18,363,3,351,20,4668
"04013815100",3398,164,42,0,743,24,1006,60,5437
"04013815200",6024,576,274,0,544,1,1117,143,8679
"04013815300",3495,187,84,0,634,0,518,0,4918
"04013815400",5603,493,220,44,1015,53,1450,132,9010
"04013815500",3989,89,155,0,1162,0,829,55,6279
"04013815600",3921,75,425,20,766,102,277,13,5599
"04013815700",4558,649,53,20,445,0,819,486,7030
"04013815800",4669,168,86,51,381,37,1178,0,6570
"04013815900",5098,121,168,0,1473,7,850,24,7741
"04013816000",8363,633,474,2,802,389,800,44,11507
"04013816100",6552,227,251,11,547,45,1339,14,8986
"04013816200",3284,257,106,0,805,106,1047,26,5631
"04013816300",2699,127,27,0,28,0,48,0,2929
"04013816400",6197,587,34,0,814,0,932,0,8564
"04013816500",3287,258,108,8,321,24,465,91,4562
"04013816600",4417,233,118,0,266,0,679,0,5713
"04013816700",1816,100,137,0,464,7,495,1,3020
"04013816800",2062,109,157,0,620,0,670,4,3622
"04013816900",3569,249,161,0,517,0,547,0,5043
"04013817000",3075,241,14,0,74,9,132,0,3545
"04013817100",5609,1227,51,41,746,174,1443,1001,10292
"04013817200",5191,348,177,29,440,187,1109,281,7762
"04013817300",4554,372,30,0,200,24,126,24,5330
"04013817400",2581,172,0,0,35,0,51,0,2839
"04013817500",2383,109,0,0,29,0,9,0,2530
"04013817600",558,154,0,0,151,209,210,306,1588
"04013940700",0,0,0,0,6,93,0,0,99
"04013941000",82,134,5,13,1176,1720,207,255,3592
"04013941100",0,0,0,0,32,0,4,0,36
"04013941200",39,30,26,2,643,288,83,14,1125
"04013941300",1372,408,0,0,2727,1595,662,176,6940
"04013980100",0,0,0,0,0,0,0,0,0
"04013980400",0,6,0,3,0,2,0,0,11
"04013980500",31,0,0,0,38,0,69,0,138
"04013980600",0,0,0,0,0,0,0,0,0
"04013980700",0,0,0,0,0,0,0,0,0
"04015940400",56,18,0,0,646,314,16,26,1076
"04015940501",1986,298,0,0,209,24,87,31,2635
"04015950100",6183,4206,0,0,476,52,653,104,11674
"04015950401",1632,608,0,0,14,0,224,0,2478
"04015950402",2868,620,53,0,293,33,121,60,4048
"04015950500",747,228,0,14,41,61,25,38,1154
"04015950600",5980,1721,20,17,608,192,312,286,9136
"04015950703",2284,1210,25,0,201,13,244,138,4115
"04015950704",4170,875,0,0,267,27,411,22,5772
"04015950705",2442,1128,19,0,263,76,505,358,4791
"04015950706",2308,1484,0,0,125,364,317,880,5478
"04015951401",2964,548,30,129,147,37,417,301,4573
"04015951402",3004,572,64,0,278,37,554,75,4584
"04015951501",3148,316,12,68,52,28,547,44,4215
"04015951502",4399,393,0,0,319,84,391,252,5838
"04015951601",1751,393,0,31,652,160,932,298,4217
"04015951602",3096,844,35,0,138,85,882,221,5301
"04015951700",3627,1582,7,6,143,117,1136,469,7087
"04015951800",2232,756,54,41,363,108,546,301,4401
"04015951900",3075,529,50,0,503,169,522,387,5235
"04015952001",1616,125,3,116,162,42,120,43,2227
"04015952002",5636,314,0,0,508,56,682,14,7210
"04015952003",3566,424,0,0,549,15,491,100,5145
"04015952004",2392,810,0,30,312,18,719,145,4426
"04015952400",1585,577,0,0,69,468,41,477,3217
"04015952500",4166,503,28,0,188,0,672,100,5657
"04015952600",2468,599,0,0,230,0,413,175,3885
"04015952700",3385,979,22,0,312,117,759,160,5734
"04015952800",5000,537,71,0,425,101,362,0,6496
"04015952900",3690,722,58,22,100,223,516,169,5500
"04015953000",4864,801,0,0,168,3,584,40,6460
"04015953100",2431,486,0,53,89,0,353,228,3640
"04015953200",2210,94,0,0,11,11,146,0,2472
"04015953300",5891,145,32,77,200,13,547,56,6961
"04015953401",4078,879,9,1,199,111,394,192,5863
"04015953402",4778,659,6,0,600,0,866,56,6965
"04015953601",7076,1085,0,0,886,172,984,162,10365
"04015953602",1145,907,0,0,72,30,115,396,2665
"04015953800",4204,1033,5,13,559,75,551,454,6894
"04015953900",4494,1246,64,52,500,50,452,151,7009
"04015954800",4444,692,54,30,229,192,266,101,6008
"04015954900",2536,890,40,0,226,91,209,100,4092
"04015955000",2776,1198,0,0,832,333,838,597,6574
"04017940008",0,0,0,0,712,463,0,0,1175
"04017940010",17,2,0,0,1174,1713,0,18,2924
"04017940011",70,12,0,0,1550,1056,34,29,2751
"04017940012",39,0,0,0,2207,1233,34,21,3534
"04017940013",86,39,0,0,2548,1570,31,40,4314
"04017940014",15,17,3,0,1330,1424,32,43,2864
"04017940015",8,15,0,0,2188,2089,103,54,4457
"04017940100",251,35,28,21,2205,2173,273,142,5128
"04017940301",36,10,2,0,2059,2122,0,4,4233
"04017940302",50,7,0,0,1832,1231,50,7,3177
"04017942300",25,23,0,0,1253,812,3,19,2135
"04017942400",0,0,8,0,989,1411,9,0,2417
"04017942500",311,20,0,0,2416,2337,194,38,5316
"04017960100",797,156,0,0,452,394,207,110,2116
"04017960200",1974,455,64,7,721,268,552,273,4314
"04017960400",1686,517,60,26,1081,274,666,318,4628
"04017960500",1215,232,0,0,630,531,478,214,3300
"04017960600",1651,277,21,19,1432,932,1040,267,5639
"04017961300",2596,327,0,31,264,51,586,111,3966
"04017961700",4529,1397,27,0,294,13,384,382,7026
"04017962500",2458,712,2,0,335,0,320,225,4052
"04017963300",3884,594,0,0,82,0,189,109,4858
"04017963400",2800,413,26,0,102,31,133,90,3595
"04017963700",1152,155,0,0,10,23,130,61,1531
"04017963800",3136,412,32,0,408,38,573,97,4696
"04017964201",950,497,0,0,528,1,0,98,2074
"04017964202",1117,501,0,0,191,171,236,61,2277
"04017964800",3920,353,0,0,215,6,291,0,4785
"04017964900",2210,165,0,0,189,0,246,0,2810
"04017965200",2846,968,0,2,319,80,95,253,4563
"04017965300",2608,1011,8,0,138,263,332,298,4658
"04019000100",287,117,12,12,34,32,125,46,665
"04019000200",2068,740,0,14,647,840,2003,948,7260
"04019000300",723,423,48,15,284,102,491,277,2363
"04019000400",1464,1204,37,48,342,210,479,313,4097
"04019000500",1050,1134,48,70,353,273,380,282,3590
"04019000600",3203,1188,65,47,457,66,421,144,5591
"04019000700",3025,853,69,48,315,108,1376,466,6260
"04019000800",1003,164,11,46,369,194,607,240,2634
"04019000900",1219,867,61,15,258,305,536,917,4178
"04019001000",572,146,28,47,122,65,472,130,1582
"04019001100",1155,594,0,30,683,348,1624,848,5282
"04019001200",1430,854,197,155,732,521,1718,956,6563
"04019001302",671,577,23,57,295,364,552,333,2872
"04019001303",1466,580,178,60,435,176,1462,454,4811
"04019001304",1328,2336,98,30,698,535,1084,1419,7528
"04019001400",2000,1889,186,45,633,497,940,492,6682
"04019001500",2367,1730,0,13,200,398,532,264,5504
"04019001600",2715,664,32,0,382,77,705,124,4699
"04019001700",2154,517,26,8,211,25,516,116,3573
"04019001801",2428,1058,325,131,1095,508,635,307,6487
"04019001802",1452,422,11,5,405,101,680,91,3167
"04019001900",2720,790,42,7,277,82,601,169,4688
"04019002000",4273,875,210,52,1049,310,3780,785,11334
"04019002100",1819,1699,454,157,1166,403,2405,1981,10084
"04019002201",1150,690,196,0,833,360,1763,967,5959
"04019002202",1281,396,181,223,541,232,1542,562,4958
"04019002300",2116,1779,60,127,872,709,2609,2041,10313
"04019002400",2132,1669,169,8,1146,706,2940,2177,10947
"04019002501",2480,654,13,48,687,399,2776,609,7666
"04019002503",2339,957,22,0,879,401,2162,1135,7895
"04019002504",2128,1436,0,0,1115,647,2231,1849,9406
"04019002505",2963,1574,421,0,991,308,3085,1560,10902
"04019002506",4081,1139,164,0,1610,913,4216,1608,13731
"04019002602",2297,864,0,27,661,445,984,660,5938
"04019002603",1025,965,63,241,446,520,733,818,4811
"04019002604",1186,1272,180,142,407,586,791,924,5488
"04019002702",3380,865,170,0,438,130,945,407,6335
"04019002703",1811,1032,52,69,304,396,404,520,4588
"04019002704",1227,570,52,0,201,12,382,166,2610
"04019002801",899,477,69,10,61,46,425,126,2113
"04019002802",1888,1046,82,329,456,319,832,512,5464
"04019002803",1171,622,37,11,239,81,364,178,2703
"04019002901",3710,1290,815,177,640,135,506,427,7700
"04019002904",2683,310,1,0,143,113,294,194,3738
"04019002905",2498,1115,193,103,182,204,258,574,5127
"04019002906",1720,267,0,0,260,23,512,45,2827
"04019003002",2850,715,64,31,427,33,577,319,5016
"04019003003",2211,713,69,238,333,194,614,308,4680
"04019003004",1307,120,46,0,233,47,360,22,2135
"04019003101",3112,1979,167,230,562,203,1040,964,8257
"04019003102",2220,516,336,172,395,205,805,226,4875
"04019003200",3673,1380,228,0,609,197,1356,580,8023
"04019003302",2863,484,123,14,535,119,785,173,5096
"04019003303",2430,365,123,67,460,89,914,109,4557
"04019003304",1838,382,244,0,402,442,631,323,4262
"04019003400",3750,473,101,3,978,182,1869,237,7593
"04019003501",3249,1775,416,373,1124,969,2203,1711,11820
"04019003502",2056,908,43,75,691,682,1307,736,6498
"04019003503",1734,1146,75,111,571,1222,1081,1832,7772
"04019003504",1404,594,63,8,306,75,626,171,3247
"04019003600",3293,286,545,112,646,103,756,231,5972
"04019003702",2092,1608,122,15,1057,1829,2691,2780,12194
"04019003704",2068,1423,10,23,844,850,2525,1790,9533
"04019003705",2719,812,7,103,1254,733,3364,1541,10533
"04019003706",2319,1706,94,81,794,413,2554,2050,10011
"04019003707",1612,549,0,0,523,774,1646,1226,6330
"04019003801",1358,702,0,0,531,545,1815,1014,5965
"04019003802",2422,830,0,3,1373,738,3360,1426,10152
"04019003901",961,421,190,38,316,321,1139,726,4112
"04019003902",1455,615,0,6,578,264,1880,737,5535
"04019003903",2356,372,0,0,393,69,2554,379,6123
"04019004008",3206,497,156,30,622,236,1106,214,6067
"04019004010",1764,689,56,25,552,62,462,477,4087
"04019004011",4052,1377,469,19,1150,665,1465,988,10185
"04019004022",5053,331,170,63,748,113,935,160,7573
"04019004025",5652,340,14,0,332,73,408,28,6847
"04019004026",4102,363,345,0,327,11,719,46,5913
"04019004029",2820,629,220,28,502,174,1205,263,5841
"04019004030",1664,51,0,0,11,31,252,2,2011
"04019004031",3184,266,150,0,310,102,553,141,4706
"04019004032",3012,365,106,17,249,154,869,31,4803
"04019004033",2206,409,243,253,487,154,933,145,4830
"04019004034",1940,405,285,291,622,205,1004,332,5084
"04019004035",2478,528,308,102,157,157,505,229,4464
"04019004036",1837,541,180,0,299,21,521,268,3667
"04019004037",1845,294,151,227,450,14,540,121,3642
"04019004038",1660,327,161,0,420,52,510,52,3182
"04019004039",1931,366,73,2,172,51,298,194,3087
"04019004042",3437,466,176,38,574,92,665,16,5464
"04019004043",3206,92,303,1,605,23,726,25,4981
"04019004044",3237,341,73,13,315,35,403,153,4570
"04019004046",3597,554,47,48,204,92,946,58,5546
"04019004047",2412,225,23,0,162,12,296,47,3177
"04019004048",3611,163,105,0,229,58,583,65,4814
"04019004049",2067,213,116,1,88,57,329,65,2936
"04019004050",1718,192,0,1,134,0,174,1,2220
"04019004051",4215,304,44,0,390,3,309,142,5407
"04019004052",1709,48,25,0,161,22,146,16,2127
"04019004053",2654,33,0,0,189,0,207,0,3083
"04019004054",1205,69,4,0,124,22,181,0,1605
"04019004055",2719,113,79,36,345,106,490,61,3949
"04019004056",1713,236,44,31,130,88,566,111,2919
"04019004057",3371,322,291,54,363,81,693,245,5420
"04019004058",3332,363,383,0,513,102,780,234,5707
"04019004061",3574,330,83,26,307,86,614,154,5174
"04019004062",4125,102,167,18,644,110,1381,162,6709
"04019004063",4085,149,380,60,501,9,1238,37,6459
"04019004064",6484,446,34,1,597,81,1081,102,8826
"04019004065",3166,101,91,7,496,0,690,31,4582
"04019004066",2490,180,156,0,360,7,968,143,4304
"04019004067",1809,700,92,30,263,131,560,483,4068
"04019004068",3783,551,137,0,633,90,1374,164,6732
"04019004069",2385,562,139,123,513,257,673,403,5055
"04019004070",1944,383,144,21,564,32,997,172,4257
"04019004071",3183,453,209,66,638,153,624,161,5487
"04019004072",1798,344,66,9,374,37,261,233,3122
"04019004073",4292,158,96,0,455,16,905,16,5938
"04019004074",1624,107,16,3,221,1,333,67,2372
"04019004107",7936,294,845,2,712,18,1827,42,11676
"04019004109",4644,357,67,0,138,0,602,77,5885
"04019004110",2208,343,15,5,921,96,2861,412,6861
"04019004112",1447,530,59,24,612,208,1487,486,4853
"04019004113",0,0,0,0,0,0,0,0,0
"04019004114",1916,1917,0,0,713,179,1874,2011,8610
"04019004115",2575,2823,249,28,511,1182,2294,3849,13511
"04019004116",1072,446,81,129,722,153,1209,495,4307
"04019004117",2955,857,283,113,956,777,3150,1530,10621
"04019004118",2839,326,130,69,497,172,1413,311,5757
"04019004119",5597,228,262,0,233,0,1182,33,7535
"04019004120",858,72,5,0,43,0,419,0,1397
"04019004121",4669,453,329,0,1025,33,4367,295,11171
"04019004122",2492,961,13,9,734,512,2586,1401,8708
"04019004125",4202,98,283,11,581,30,1341,30,6576
"04019004307",2932,200,23,0,69,9,228,91,3552
"04019004310",1498,184,0,0,168,113,1183,203,3349
"04019004311",3203,450,0,0,703,59,2957,342,7714
"04019004312",3034,1116,41,0,868,400,2955,1067,9481
"04019004313",3023,1344,15,0,176,48,909,625,6140
"04019004316",2514,407,37,43,213,45,651,191,4101
"04019004317",2482,254,0,0,41,13,174,11,2975
"04019004320",1418,923,17,0,484,208,1307,808,5165
"04019004321",2560,546,75,3,875,312,2497,585,7453
"04019004322",4934,996,30,0,728,472,4187,873,12220
"04019004323",2741,137,50,128,965,21,1235,56,5333
"04019004324",2664,54,0,0,69,0,28,0,2815
"04019004325",1887,22,0,0,0,0,27,0,1936
"04019004326",2608,191,101,0,242,1,1256,71,4470
"04019004327",3329,659,118,20,423,9,1203,210,5971
"04019004328",3464,110,0,0,0,0,37,0,3611
"04019004329",8669,281,309,0,1039,78,3366,86,13828
"04019004330",1576,71,0,0,60,0,31,0,1738
"04019004331",3514,144,13,0,31,10,506,39,4257
"04019004332",1208,47,5,0,23,0,6,6,1295
"04019004333",2869,443,198,67,498,135,2673,389,7272
"04019004334",4412,728,306,15,2573,321,4834,842,14031
"04019004404",2773,259,0,17,238,15,241,25,3568
"04019004407",3138,688,548,143,1602,684,3630,1025,11458
"04019004411",4225,1748,42,98,1268,426,2871,915,11593
"04019004412",2183,520,33,41,657,104,1319,231,5088
"04019004413",2230,120,147,0,754,60,1454,94,4859
"04019004414",1969,368,94,218,327,111,1385,261,4733
"04019004415",1022,100,41,63,332,117,785,234,2694
"04019004418",2705,169,44,0,334,32,642,51,3977
"04019004419",3795,545,87,45,509,59,800,70,5910
"04019004421",5348,1036,144,30,1023,355,2328,593,10857
"04019004422",4415,224,105,0,742,106,2603,153,8348
"04019004423",3145,355,15,25,332,112,291,31,4306
"04019004424",2353,567,0,91,468,138,1409,168,5194
"04019004425",4761,853,14,0,275,30,1312,251,7496
"04019004426",2572,28,180,46,431,0,817,0,4074
"04019004427",6196,291,231,0,1167,0,1246,39,9170
"04019004428",2785,140,52,12,321,77,648,91,4126
"04019004429",4994,649,461,0,1213,2,1347,56,8722
"04019004430",1914,254,0,0,221,54,774,209,3426
"04019004431",2741,401,30,0,646,298,972,313,5401
"04019004504",3550,1961,82,96,716,255,2245,1432,10337
"04019004505",2182,816,18,46,556,199,1284,732,5833
"04019004506",3187,789,63,12,453,339,1535,450,6828
"04019004508",2791,404,27,41,907,141,1058,275,5644
"04019004510",937,1278,90,131,543,501,533,695,4708
"04019004511",2147,823,168,30,898,257,946,526,5795
"04019004512",2658,545,17,0,562,162,897,302,5143
"04019004513",1660,720,18,28,642,102,1105,496,4771
"04019004610",4174,693,54,29,749,97,1477,508,7781
"04019004613",3017,342,69,0,489,85,885,110,4997
"04019004614",2449,138,9,0,257,38,522,19,3432
"04019004615",2102,151,36,4,424,48,355,48,3168
"04019004616",2360,332,71,0,619,48,645,120,4195
"04019004617",2183,158,8,0,144,31,332,27,2883
"04019004618",2284,387,36,18,490,156,789,162,4322
"04019004619",2503,220,89,0,608,10,371,73,3874
"04019004620",1189,235,13,7,204,9,319,120,2096
"04019004621",1792,97,0,0,163,0,181,13,2246
"04019004622",2614,175,31,0,183,74,427,17,3521
"04019004623",3747,331,0,0,508,148,648,128,5510
"04019004624",4946,959,73,29,530,0,1687,0,8224
"04019004625",1322,230,15,0,185,71,392,99,2314
"04019004626",1854,453,207,10,842,206,684,156,4412
"04019004627",2335,182,26,16,249,113,675,60,3656
"04019004628",1169,32,12,1,79,7,162,8,1470
"04019004630",1546,242,97,0,166,84,510,152,2797
"04019004631",3151,187,68,0,141,26,655,98,4326
"04019004632",2139,216,24,0,278,1,360,33,3051
"04019004633",2514,71,7,0,219,32,359,32,3234
"04019004634",715,53,34,3,150,7,102,4,1068
"04019004635",4514,171,44,0,508,66,341,0,5644
"04019004636",6289,76,14,0,750,88,794,16,8027
"04019004638",8253,317,156,0,706,0,1230,30,10692
"04019004639",3257,29,234,0,308,0,855,19,4702
"04019004640",4116,168,175,0,404,13,513,10,5399
"04019004641",3098,113,58,1,417,171,1024,195,5077
"04019004642",2767,74,24,0,155,0,182,0,3202
"04019004643",4029,293,0,0,61,0,84,20,4487
"04019004644",2067,132,10,0,344,5,671,5,3234
"04019004645",3720,114,182,0,1204,88,1739,59,7106
"04019004646",3353,605,8,0,312,27,596,63,4964
"04019004647",3684,151,109,0,401,56,1377,82,5860
"04019004710",2650,271,153,0,366,163,888,77,4568
"04019004711",3547,378,153,0,477,0,301,74,4930
"04019004712",2287,208,217,39,329,77,246,33,3436
"04019004713",3106,318,0,10,172,20,303,129,4058
"04019004714",4154,256,178,29,674,7,486,97,5881
"04019004715",3069,405,0,0,666,179,1138,211,5668
"04019004716",5397,280,74,0,326,24,634,38,6773
"04019004717",1942,29,27,0,131,0,278,0,2407
"04019004718",1605,219,0,1,159,28,225,83,2320
"04019004719",4922,226,35,0,435,18,276,0,5912
"04019004720",1226,22,32,0,115,0,123,0,1518
"04019004721",2830,156,65,0,253,18,625,16,3963
"04019004722",2109,104,16,0,82,18,198,9,2536
"04019004723",3361,151,236,0,649,86,425,32,4940
"04019004724",2079,57,0,0,294,6,230,0,2666
"04019004725",1958,166,5,0,356,36,459,50,3030
"04019004726",3551,114,0,0,709,30,570,12,4986
"04019005200",2196,625,48,0,446,684,1192,429,5620
"04019005300",2780,140,53,24,217,68,587,54,3923
"04019940600",25,7,0,0,563,520,6,7,1128
"04019940700",22,0,0,49,507,851,7,60,1496
"04019940800",73,0,0,0,2199,1639,32,0,3943
"04019940900",378,108,13,0,807,723,313,130,2472
"04019941000",65,93,9,1,1973,1669,428,444,4682
"04021000201",4614,232,33,0,376,62,613,27,5957
"04021000204",5981,184,616,22,544,67,1254,0,8668
"04021000205",12496,2568,313,655,1839,258,3925,817,22871
"04021000206",3288,492,240,0,352,0,616,214,5202
"04021000207",7766,934,250,0,702,142,1797,368,11959
"04021000208",1763,114,28,0,171,0,714,0,2790
"04021000209",7614,624,718,35,856,126,1804,238,12015
"04021000210",7119,396,139,111,1545,1424,1852,329,12915
"04021000211",2978,248,69,3,531,500,1001,0,5330
"04021000212",3978,456,298,28,735,180,1491,47,7213
"04021000213",7966,1354,1016,0,1729,415,1283,642,14405
"04021000214",6421,524,273,170,1378,107,1541,268,10682
"04021000215",2402,337,0,0,325,0,1041,39,4144
"04021000307",1739,322,0,0,0,62,35,12,2170
"04021000308",3765,1692,0,0,64,19,649,639,6828
"04021000309",1376,657,0,0,71,9,8,24,2145
"04021000310",2300,605,67,0,86,34,115,212,3419
"04021000311",2361,190,0,0,36,0,108,11,2706
"04021000312",2433,1033,14,97,132,0,844,415,4968
"04021000313",3502,869,48,0,151,65,460,353,5448
"04021000314",3955,611,19,0,385,560,646,85,6261
"04021000315",2754,1557,0,0,383,310,296,906,6206
"04021000316",6566,264,50,0,263,0,298,144,7585
"04021000317",2054,69,50,19,54,0,91,0,2337
"04021000318",5184,408,140,136,567,0,456,90,6981
"04021000319",1034,84,0,0,22,0,5,0,1145
"04021000400",2033,419,3,16,324,154,1661,497,5107
"04021000603",4668,320,23,0,94,20,310,19,5454
"04021000604",4068,133,0,0,14,0,83,0,4298
"04021000700",3000,630,0,2,167,96,1683,399,5977
"04021000801",9488,1366,168,0,360,517,1671,521,14091
"04021000802",3296,342,0,0,71,20,315,91,4135
"04021000803",643,80,0,0,102,11,117,57,1010
"04021000901",850,93,17,30,30,129,440,47,1636
"04021000902",2013,625,115,0,286,186,1170,725,5120
"04021001000",2366,1507,125,114,360,324,1105,1051,6952
"04021001100",4234,1083,298,50,829,314,1639,643,9090
"04021001200",3082,851,75,0,531,180,1323,588,6630
"04021001301",5255,828,372,3,548,346,1927,1069,10348
"04021001303",730,180,9,3,396,0,476,158,1952
"04021001304",6174,623,509,5,1020,250,1867,375,10823
"04021001305",4415,250,110,0,1005,87,2850,84,8801
"04021001306",2768,674,384,47,522,37,1158,256,5846
"04021001403",2774,341,128,179,587,598,1447,520,6574
"04021001404",3060,591,0,0,418,10,1069,239,5387
"04021001405",3603,409,49,103,126,36,964,104,5394
"04021001406",1823,1934,238,69,1190,83,1980,1455,8772
"04021001407",1190,529,11,0,383,59,663,462,3297
"04021001408",1552,165,66,0,169,0,149,0,2101
"04021001500",1319,1021,117,122,559,814,1301,1094,6347
"04021001600",4105,578,124,40,540,86,2000,318,7791
"04021001701",490,195,0,0,34,51,131,201,1102
"04021001702",1699,169,103,43,522,0,631,154,3321
"04021001703",1552,112,6,6,146,0,652,11,2485
"04021001704",4915,243,530,79,931,103,1203,185,8189
"04021001705",4983,266,371,0,370,110,1051,180,7331
"04021001706",3090,166,567,16,636,0,652,40,5167
"04021001707",2920,205,1363,84,1475,112,1163,25,7347
"04021001708",4575,437,584,0,401,13,1088,132,7230
"04021001709",2021,167,270,0,811,11,931,0,4211
"04021001710",4900,323,300,57,68,0,699,23,6370
"04021001711",1597,81,360,0,310,4,724,13,3089
"04021001900",1646,546,77,63,391,87,926,530,4266
"04021002001",2314,1055,0,37,167,59,1169,830,5631
"04021002002",374,264,49,0,22,10,184,236,1139
"04021002003",1719,1485,11,107,688,292,2252,1578,8132
"04021002101",5046,685,545,3,544,339,2155,497,9814
"04021002102",842,23,145,0,17,27,300,39,1393
"04021002103",3035,494,171,0,483,38,1362,213,5796
"04021002200",3663,809,0,0,362,170,1839,454,7297
"04021002300",1988,590,0,0,341,22,1151,283,4375
"04021002400",1304,376,0,0,347,30,907,241,3205
"04021941200",120,99,19,2,2797,3634,133,316,7120
"04021941300",102,59,0,0,1646,1626,88,134,3655
"04021941400",4308,1394,19,0,2170,767,2128,1140,11926
"04023966000",2396,419,0,0,169,22,464,172,3642
"04023966101",1957,160,0,0,591,19,1085,38,3850
"04023966103",529,267,0,0,196,128,709,392,2221
"04023966104",6232,975,97,0,2029,619,6831,1436,18219
"04023966105",6031,1366,57,0,1871,157,7179,1387,18048
"04023966200",2399,929,0,0,769,626,2917,1506,9146
"04023966301",2599,693,0,0,584,457,2962,1109,8404
"04023966302",1307,1253,1,0,328,680,1414,1928,6911
"04023966401",2065,442,5,0,457,273,2364,643,6249
"04023966402",2212,1278,0,17,507,672,2563,1715,8964
"04025000202",6361,1174,11,0,409,22,374,314,8665
"04025000203",4773,594,0,0,421,12,458,80,6338
"04025000204",5133,1616,45,33,109,147,954,582,8619
"04025000300",4031,903,0,38,162,355,346,97,5932
"04025000401",4972,570,11,0,363,24,171,120,6231
"04025000402",4306,204,18,0,306,37,138,4,5013
"04025000500",4554,402,0,0,248,43,690,16,5953
"04025000604",4026,651,89,0,400,82,538,367,6153
"04025000605",5947,1775,52,0,1324,182,1278,877,11435
"04025000606",3565,1473,0,15,349,237,509,887,7035
"04025000607",5207,579,23,0,106,101,375,126,6517
"04025000608",3147,498,0,0,97,24,465,195,4426
"04025000609",3891,518,9,0,96,178,887,260,5839
"04025000610",3184,745,20,0,47,73,475,222,4766
"04025000700",2793,446,18,0,110,8,188,127,3690
"04025000801",3183,298,63,4,113,89,277,46,4073
"04025000802",2778,387,34,19,73,39,157,63,3550
"04025000900",2487,1120,0,17,217,143,384,166,4534
"04025001001",3257,824,0,0,149,27,177,149,4583
"04025001002",2541,556,0,0,82,41,275,273,3768
"04025001101",3281,374,8,0,74,4,60,19,3820
"04025001102",3144,367,0,31,111,27,258,87,4025
"04025001200",5461,678,0,1,253,40,294,13,6740
"04025001300",2177,67,27,0,161,0,428,0,2860
"04025001401",1985,205,0,0,22,48,57,9,2326
"04025001402",2508,431,6,1,73,0,256,30,3305
"04025001403",2553,620,14,0,86,57,233,196,3759
"04025001500",4914,1055,0,0,144,37,437,24,6611
"04025001601",3161,988,0,8,847,321,793,240,6358
"04025001602",2652,1054,0,0,149,100,289,6,4250
"04025001603",5056,1186,0,0,426,161,597,67,7493
"04025001701",5222,350,76,0,196,67,877,0,6788
"04025001702",3852,467,20,2,153,26,331,87,4938
"04025001703",2097,201,5,17,220,19,128,56,2743
"04025001801",2829,275,0,0,68,10,301,0,3483
"04025001802",3979,295,0,0,305,158,932,84,5753
"04025001900",12341,799,108,2,734,240,1142,191,15557
"04025002001",2667,917,0,2,626,346,858,812,6228
"04025002002",3207,1113,32,0,541,28,1109,241,6271
"04025002003",3495,688,44,0,156,527,720,615,6245
"04025002004",6651,903,74,0,680,91,1390,102,9891
"04025002100",1078,971,0,12,207,103,309,408,3088
"04027000100",1208,403,15,30,115,132,896,397,3196
"04027000200",1390,324,78,33,968,494,1876,770,5933
"04027000301",1474,748,103,0,759,660,1673,1207,6624
"04027000302",1124,824,158,26,1800,615,2794,1314,8655
"04027000402",1326,495,146,0,1008,221,2005,657,5858
"04027000403",601,206,13,23,473,308,712,371,2707
"04027000404",1235,600,83,0,880,730,1395,1154,6077
"04027000501",1424,190,13,0,777,209,1111,110,3834
"04027000502",1812,356,0,0,265,246,541,433,3653
"04027000600",3304,734,63,44,522,91,2523,592,7873
"04027000700",2306,823,0,27,471,321,2365,911,7224
"04027000800",3128,1261,186,0,359,12,1767,910,7623
"04027000901",1776,480,65,9,710,35,1139,426,4640
"04027000902",1858,302,13,34,220,155,1029,274,3885
"04027000903",1640,220,49,0,715,393,1069,532,4618
"04027000905",4217,275,196,37,3205,277,6013,519,14739
"04027000907",3524,769,208,104,1728,884,3306,1295,11818
"04027000908",1863,26,18,0,1137,135,1546,151,4876
"04027001001",2191,236,23,12,87,32,537,70,3188
"04027001003",723,127,11,21,294,122,670,197,2165
"04027001004",1073,453,71,66,579,108,1226,297,3873
"04027001100",2833,446,175,91,1121,122,2246,241,7275
"04027001200",2649,227,8,0,861,135,1456,250,5586
"04027010905",2215,203,6,18,485,457,612,438,4434
"04027010907",4078,326,0,0,859,15,1250,94,6622
"04027010910",1344,184,0,0,57,0,227,25,1837
"04027010911",4457,345,68,11,1225,332,2822,622,9882
"04027010913",412,62,0,0,345,141,561,198,1719
"04027010914",230,278,0,0,172,0,271,147,1098
"04027011000",1024,144,0,0,468,454,625,514,3229
"04027011104",2525,363,37,0,848,175,1357,305,5610
"04027011106",4421,274,196,0,783,358,1731,359,8122
"04027011107",1859,60,0,1,260,1,755,25,2961
"04027011108",2843,163,7,0,376,17,1113,17,4536
"04027011110",2370,258,0,0,40,12,163,0,2843
"04027011111",2298,881,26,0,414,0,456,103,4178
"04027011112",2226,92,10,0,19,0,98,0,2445
"04027011114",1326,203,24,0,245,34,214,90,2136
"04027011115",2955,139,0,0,28,62,106,0,3290
"04027011201",2529,261,35,165,946,73,1120,92,5221
"04027011202",770,207,0,0,680,83,815,131,2686
"04027011403",2924,1514,0,0,111,1,3035,1514,9099
"04027011405",3405,1902,0,0,41,120,3381,2022,10871
"04027011406",5498,3226,0,0,350,13,5772,3239,18098
"04027011501",1088,699,16,14,367,329,938,689,4140
"04027011503",3429,1629,0,0,194,135,3520,1555,10462
"04027011504",5638,2479,64,0,333,76,5907,2522,17019
"04027011600",6722,2279,0,0,2,0,6720,2275,17998
"04027011700",917,94,9,0,130,72,276,97,1595
"04027011800",3889,601,44,0,976,307,3450,871,10138
"04027012100",638,120,47,7,435,20,601,69,1937
"04027980003",0,0,0,0,0,0,0,0,0
"04027980004",0,0,0,0,0,0,0,0,0
"04027980005",0,0,0,0,0,0,0,0,0
"04027980006",1505,79,354,0,515,58,663,22,3196
"05001480100",1266,139,163,4,0,0,0,0,1572
"05001480200",1115,146,127,21,6,11,0,0,1426
"05001480300",1647,193,544,450,30,18,50,116,3048
"05001480400",562,74,1346,539,41,9,142,0,2713
"05001480500",3367,238,289,218,128,13,79,11,4343
"05001480600",1158,163,10,0,21,7,0,0,1359
"05001480700",1544,607,738,216,68,7,0,85,3265
"05001480800",1040,199,60,5,11,0,0,51,1366
"05003960100",1203,200,346,264,52,16,22,46,2149
"05003960200",1730,293,251,47,209,6,208,0,2744
"05003960300",2764,514,560,483,162,114,242,207,5046
"05003960400",970,187,248,126,24,0,12,0,1567
"05003960500",2177,255,126,268,103,9,105,0,3043
"05003960600",3091,390,1125,847,0,0,196,20,5669
"05003960700",1067,94,768,92,10,0,0,0,2031
"05005950100",3726,606,0,0,171,2,222,48,4775
"05005950200",3670,535,0,1,79,55,22,22,4384
"05005950300",3886,801,0,0,63,58,28,0,4836
"05005950400",2150,356,0,0,180,50,0,0,2736
"05005950500",4263,689,31,0,52,0,114,28,5177
"05005950600",3477,508,0,0,74,27,6,0,4092
"05005950700",2532,734,0,0,86,0,18,16,3386
"05005950800",5324,678,0,0,171,45,120,6,6344
"05005950900",4431,859,0,0,79,15,69,30,5483
"05007020101",4467,728,11,28,172,149,225,14,5794
"05007020102",4725,542,124,34,320,0,561,0,6306
"05007020201",3141,640,54,24,352,63,1040,334,5648
"05007020203",2818,329,13,12,358,0,453,64,4047
"05007020205",4037,718,0,0,996,188,2579,433,8951
"05007020206",4852,487,47,0,1310,237,3414,333,10680
"05007020301",1965,1238,41,31,534,83,1096,717,5705
"05007020302",2939,1048,61,0,157,31,827,858,5921
"05007020304",2210,741,37,66,504,9,307,491,4365
"05007020305",3082,540,13,0,394,33,885,392,5339
"05007020401",4917,1121,14,26,177,17,1336,280,7888
"05007020402",2944,382,0,0,734,218,1018,228,5524
"05007020404",4174,361,56,0,119,112,1870,389,7081
"05007020405",2941,86,129,32,306,0,267,0,3761
"05007020501",3779,602,258,7,959,41,429,33,6108
"05007020503",2269,557,60,0,939,0,400,0,4225
"05007020504",2341,528,15,0,40,31,516,94,3565
"05007020603",4177,240,192,27,1939,0,404,32,7011
"05007020604",3480,445,0,5,405,40,408,63,4846
"05007020605",3614,324,79,26,231,8,277,81,4640
"05007020606",3710,101,0,0,344,0,178,0,4333
"05007020701",5002,126,33,0,149,13,126,0,5449
"05007020703",4678,147,16,0,228,18,132,0,5219
"05007020704",3824,175,0,0,59,0,0,0,4058
"05007020801",3720,66,68,0,137,0,130,0,4121
"05007020803",3059,370,0,0,125,0,7,0,3561
"05007020805",4468,176,12,0,177,28,591,0,5452
"05007020806",4409,65,24,20,61,35,90,18,4722
"05007020901",5780,196,276,3,1311,0,896,0,8462
"05007020902",5332,475,60,0,425,224,258,29,6803
"05007021001",3281,1024,20,0,310,72,271,41,5019
"05007021002",4789,1457,0,5,402,86,579,413,7731
"05007021101",3081,512,2,2,472,297,866,141,5373
"05007021102",2409,757,140,0,460,85,471,308,4630
"05007021201",2387,552,39,38,654,62,370,155,4257
"05007021202",2219,423,6,0,466,0,441,195,3750
"05007021301",5251,676,0,3,535,132,474,194,7265
"05007021304",3905,268,118,33,823,147,315,72,5681
"05007021305",3833,428,56,0,375,77,422,87,5278
"05007021306",3344,97,9,0,340,11,338,0,4139
"05007021308",2928,45,40,0,261,0,132,0,3406
"05007021310",6783,282,0,0,219,0,805,84,8173
"05007021311",4067,307,56,0,501,120,189,138,5378
"05007021404",2859,312,4,11,385,17,343,9,3940
"05007021405",1543,182,59,0,82,0,2,0,1868
"05007021406",4337,479,20,0,624,498,1491,80,7529
"05007021407",4025,452,10,0,79,22,202,0,4790
"05007021408",3243,918,14,113,527,211,880,565,6471
"05007021409",1887,192,0,0,45,25,9,5,2163
"05009790100",5617,733,0,0,182,44,40,52,6668
"05009790200",4200,1271,0,0,123,57,142,77,5870
"05009790300",4472,857,4,0,83,29,12,24,5481
"05009790400",6063,346,0,0,113,4,18,0,6544
"05009790501",2793,435,0,0,295,0,13,0,3536
"05009790502",2401,1116,0,35,32,169,28,37,3818
"05009790600",4005,1025,0,0,56,56,288,31,5461
"05011950100",1393,257,286,188,200,9,181,25,2539
"05011950200",819,143,470,295,0,39,16,23,1805
"05011950300",1198,334,444,349,99,238,196,278,3136
"05011950400",706,87,358,196,335,77,364,86,2209
"05011950500",1233,576,193,404,147,97,157,225,3032
"05013480100",1840,84,608,210,19,6,14,3,2784
"05013480200",1424,483,370,68,23,9,28,0,2405
"05015950100",2137,473,13,0,98,23,32,20,2796
"05015950200",5470,765,0,154,116,96,33,67,6701
"05015950300",4984,1378,0,0,308,57,1400,416,8543
"05015950400",3869,515,0,0,243,56,134,42,4859
"05015950500",4634,1344,23,0,504,16,1178,477,8176
"05017080100",1802,177,542,50,60,92,46,148,2917
"05017080200",447,65,916,862,0,0,16,19,2325
"05017080300",1276,166,841,697,52,219,87,247,3585
"05017080400",360,108,981,1050,16,4,15,5,2539
"05019953601",2015,506,700,630,72,0,79,12,4014
"05019953602",1814,522,199,165,49,0,137,106,2992
"05019953700",3173,741,385,46,135,19,0,10,4509
"05019953800",1815,395,657,478,94,56,59,142,3696
"05019953900",2913,602,1132,546,111,29,274,115,5722
"05021950100",1601,302,0,0,30,6,22,0,1961
"05021950200",1678,317,0,0,21,0,7,0,2023
"05021950300",1644,328,0,0,54,52,4,0,2082
"05021950400",2408,741,0,0,56,0,44,0,3249
"05021950500",1748,554,0,0,28,12,63,0,2405
"05021950600",2878,749,3,0,116,84,107,0,3937
"05023480100",3744,588,0,0,91,0,131,0,4554
"05023480201",1026,182,0,0,6,0,18,0,1232
"05023480202",3411,353,0,30,49,0,86,0,3929
"05023480300",4125,1383,0,0,63,37,7,50,5665
"05023480400",3144,555,51,2,18,10,0,47,3827
"05023480501",2245,435,0,0,131,0,98,99,3008
"05023480502",3044,420,0,0,198,44,16,38,3760
"05025970100",3413,615,347,436,140,64,4,0,5019
"05025970200",2891,373,107,94,24,6,62,3,3560
"05027950100",2530,323,687,340,115,2,74,0,4071
"05027950200",2053,269,870,702,44,322,40,306,4606
"05027950300",3484,435,845,388,0,0,21,36,5209
"05027950400",3333,725,1047,534,144,250,29,0,6062
"05027950500",453,191,1082,1626,16,16,0,100,3484
"05029950100",4004,589,257,12,107,34,11,0,5014
"05029950200",2698,471,106,17,118,16,18,0,3444
"05029950300",3032,1215,412,481,74,0,170,341,5725
"05029950400",1243,485,86,205,32,8,76,33,2168
"05029950500",1378,662,755,111,8,0,50,31,2995
"05029950600",1818,299,0,45,34,87,44,12,2339
"05031000101",1788,823,320,764,113,136,0,0,3944
"05031000102",2620,363,311,184,65,31,153,0,3727
"05031000200",2186,815,977,152,16,5,132,397,4680
"05031000300",4242,914,707,773,257,72,62,86,7113
"05031000401",4055,848,699,45,33,119,200,106,6105
"05031000402",3886,1438,887,769,327,106,254,46,7713
"05031000501",5571,717,253,0,125,0,166,0,6832
"05031000502",2723,1423,356,184,131,166,1,78,5062
"05031000601",2430,577,840,820,104,233,39,143,5186
"05031000602",919,882,364,1438,197,377,579,458,5214
"05031000700",5681,986,593,378,135,0,519,246,8538
"05031000801",6201,192,130,0,317,19,0,0,6859
"05031000802",6277,364,310,192,178,0,145,0,7466
"05031000900",4298,684,110,11,153,0,134,58,5448
"05031001000",3323,636,0,9,39,3,123,7,4140
"05031001100",5757,1212,38,39,103,9,18,0,7176
"05031001200",4157,681,0,42,201,15,226,17,5339
"05033020100",4394,893,2,3,167,15,15,0,5489
"05033020201",4842,838,0,0,329,111,28,27,6175
"05033020203",6678,924,276,0,421,150,345,53,8847
"05033020204",3634,805,0,27,311,25,30,51,4883
"05033020301",2874,878,14,0,170,129,96,205,4366
"05033020302",3743,450,49,0,368,10,330,102,5052
"05033020401",3795,355,12,0,372,39,178,3,4754
"05033020402",3301,935,3,45,126,33,30,92,4565
"05033020501",1847,996,58,0,515,417,601,537,4971
"05033020502",2326,1645,57,28,154,107,484,291,5092
"05033020600",8493,1352,106,119,240,196,259,208,10973
"05035030101",73,18,1092,1766,5,10,0,0,2964
"05035030102",339,39,1370,1272,0,0,12,0,3032
"05035030201",3373,721,779,139,64,43,33,0,5152
"05035030202",2267,57,581,49,89,63,8,0,3114
"05035030301",662,42,1308,1112,16,0,0,0,3140
"05035030302",250,89,1114,878,32,9,40,9,2421
"05035030501",11,12,550,343,2,0,13,0,931
"05035030502",30,0,400,436,0,0,0,4,870
"05035030600",1576,187,1429,1163,109,2,226,0,4692
"05035030701",614,143,482,43,36,0,16,59,1393
"05035030702",174,6,470,495,3,94,20,0,1262
"05035030703",1329,434,153,17,69,47,177,32,2258
"05035030803",1636,0,532,0,42,0,34,0,2244
"05035030804",1662,131,597,201,174,0,0,0,2765
"05035030805",1811,124,950,98,199,89,227,89,3587
"05035030806",2448,90,651,56,143,0,58,0,3446
"05035030807",899,43,364,172,30,0,13,0,1521
"05035031000",763,6,307,199,20,12,24,0,1331
"05035031100",449,182,1225,1041,19,4,0,0,2920
"05035031200",0,25,852,600,0,32,0,0,1509
"05037950100",556,81,501,356,0,0,0,0,1494
"05037950200",2498,529,129,13,12,32,3,0,3216
"05037950300",1269,126,0,0,25,0,2,0,1422
"05037950400",2256,220,75,209,31,0,11,0,2802
"05037950500",1573,698,1450,842,57,19,15,0,4654
"05037950600",3084,180,257,50,209,0,234,0,4014
"05039970100",708,33,582,96,20,0,60,0,1499
"05039970200",1289,231,182,68,13,21,11,113,1928
"05039970300",1669,126,1771,513,159,0,0,0,4238
"05041950100",1036,107,348,55,12,0,0,1,1559
"05041950200",2161,198,1022,920,31,13,12,0,4357
"05041950300",71,101,659,687,29,125,39,215,1926
"05041950400",1039,112,643,1099,0,54,0,56,3003
"05041950500",1112,143,399,264,28,4,209,43,2202
"05043490100",1682,249,274,227,10,12,21,6,2481
"05043490200",969,132,743,858,12,100,50,0,2864
"05043490300",2836,1206,365,829,107,18,92,173,5626
"05043490400",1677,297,429,441,0,25,99,11,2979
"05043490500",2736,400,564,330,14,27,11,27,4109
"05045030101",2334,489,328,52,63,86,2,1,3355
"05045030102",4184,404,17,11,217,46,151,4,5034
"05045030103",3081,304,14,0,29,67,190,0,3685
"05045030104",4263,508,0,7,93,0,118,0,4989
"05045030200",4554,911,18,0,82,20,12,13,5610
"05045030301",4101,437,399,30,153,0,248,0,5368
"05045030302",4965,593,2,0,101,0,92,0,5753
"05045030303",3803,556,117,0,93,13,55,10,4647
"05045030401",2060,88,148,0,40,0,145,0,2481
"05045030402",2968,235,0,0,139,27,25,28,3422
"05045030403",1859,710,498,180,60,0,73,155,3535
"05045030404",1888,198,356,185,34,16,28,104,2809
"05045030501",9337,569,1078,269,695,172,389,63,12572
"05045030502",2720,513,715,113,127,74,71,166,4499
"05045030600",4185,123,336,207,106,0,121,0,5078
"05045030701",1461,305,543,355,40,19,62,9,2794
"05045030702",1819,431,460,545,73,120,6,24,3478
"05045030800",3076,552,551,70,113,46,87,35,4530
"05045030900",1102,967,316,489,230,83,318,139,3644
"05045031001",3015,531,442,23,144,85,107,179,4526
"05045031003",1464,418,162,180,121,27,248,27,2647
"05045031005",4821,868,691,218,515,100,174,235,7622
"05045031006",2392,810,505,76,79,18,66,0,3946
"05045031101",4067,776,381,191,155,0,297,0,5867
"05045031102",3980,389,644,89,113,59,38,13,5325
"05047950100",2758,892,28,75,134,3,2,53,3945
"05047950200",5225,1641,0,0,105,31,165,146,7313
"05047950300",5454,851,35,6,381,13,47,35,6822
"05049550100",4377,1274,0,0,233,3,0,0,5887
"05049550200",4826,1115,1,2,45,61,88,36,6174
"05051010300",3574,1175,256,68,168,169,186,157,5753
"05051010400",5403,1787,41,0,189,148,52,7,7627
"05051010500",5150,402,44,115,176,0,64,0,5951
"05051010600",1775,466,580,673,93,44,160,18,3809
"05051010700",857,628,123,213,112,173,80,94,2280
"05051010800",960,517,158,345,130,50,38,13,2211
"05051010900",1698,509,416,188,205,44,35,34,3129
"05051011000",2824,1041,27,17,238,48,127,0,4322
"05051011100",6642,1421,99,0,435,420,229,288,9534
"05051011200",6447,810,115,18,167,0,142,22,7721
"05051011300",2489,429,451,500,286,377,282,379,5193
"05051011400",1528,431,128,477,335,423,331,246,3899
"05051011500",791,468,626,272,41,11,77,67,2353
"05051011601",4302,794,351,244,131,158,184,134,6298
"05051011602",3470,358,121,3,117,248,132,264,4713
"05051011700",2886,1201,404,139,470,114,226,407,5847
"05051011800",2916,337,341,18,456,0,171,46,4285
"05051011900",4704,906,0,74,158,0,59,0,5901
"05051012001",4107,1051,0,0,85,0,16,17,5276
"05051012002",2963,331,8,22,18,0,10,0,3352
"05053470100",4270,418,159,113,58,0,0,0,5018
"05053470200",2862,169,0,0,44,0,0,0,3075
"05053470300",3353,576,131,23,187,99,251,149,4769
"05053470400",4615,574,0,3,91,12,0,0,5295
"05055480100",2245,760,0,0,23,0,9,0,3037
"05055480200",3733,520,0,0,40,0,149,9,4451
"05055480300",2584,605,2,0,166,0,79,0,3436
"05055480400",5461,1266,25,0,72,12,159,12,7007
"05055480500",4445,1355,140,19,90,0,262,29,6340
"05055480600",5774,1166,0,4,90,43,0,0,7077
"05055480700",1509,654,51,34,39,35,65,62,2449
"05055480801",4865,203,0,0,171,19,18,0,5276
"05055480802",3088,653,0,0,61,168,49,137,4156
"05057480100",3385,777,394,209,22,58,171,139,5155
"05057480200",1195,178,837,185,149,0,20,0,2564
"05057480300",1919,867,1585,847,107,115,385,640,6465
"05057480400",2920,701,418,28,101,29,14,300,4511
"05057480500",1973,694,1117,920,164,204,571,512,6155
"05059020100",6456,720,23,1,123,0,249,10,7582
"05059020200",1450,370,1202,282,17,16,46,0,3383
"05059020300",1092,268,473,34,45,52,78,0,2042
"05059020400",3194,651,921,330,10,24,54,103,5287
"05059020500",3387,467,28,0,90,13,74,113,4172
"05059020600",3409,388,0,0,63,0,13,9,3882
"05059020700",4679,921,29,6,122,0,129,0,5886
"05061950100",2960,456,144,23,73,177,19,107,3959
"05061950200",2996,365,1073,313,259,0,232,37,5275
"05061950300",1851,566,859,523,405,403,535,477,5619
"05063490100",4831,1543,0,24,128,0,31,49,6606
"05063490200",1775,624,33,1,101,17,126,137,2814
"05063490300",3810,904,132,315,15,0,205,298,5679
"05063490400",3241,956,31,14,110,48,17,72,4489
"05063490500",2198,223,26,0,34,0,110,18,2609
"05063490600",1610,599,90,49,137,120,363,131,3099
"05063490700",5259,1683,12,36,109,134,320,219,7772
"05063490800",3671,967,0,1,38,0,15,0,4692
"05065960100",2560,793,0,25,65,45,53,25,3566
"05065960200",3802,749,2,0,28,31,17,2,4631
"05065960300",1907,426,0,0,25,7,75,42,2482
"05065960400",1809,315,0,0,172,0,0,0,2296
"05067480100",2393,926,139,22,66,19,24,0,3589
"05067480200",1441,467,430,300,6,84,15,9,2752
"05067480300",1999,660,400,503,194,39,50,94,3939
"05067480400",1983,519,132,0,58,2,57,0,2751
"05067480500",1374,235,23,23,7,22,88,0,1772
"05069000102",9,8,8,0,0,0,0,0,25
"05069000301",2523,449,363,65,40,0,16,7,3463
"05069000302",4139,553,287,0,250,0,192,0,5421
"05069000303",1700,550,538,370,82,35,65,12,3352
"05069000502",0,60,1374,1141,0,0,0,51,2626
"05069000900",328,14,1962,524,24,0,15,0,2867
"05069001000",27,8,976,461,4,13,0,0,1489
"05069001200",86,55,749,1067,0,0,0,0,1957
"05069001300",18,17,997,746,3,31,0,0,1812
"05069001401",341,37,649,619,18,69,0,0,1733
"05069001402",124,0,1764,992,36,0,20,0,2936
"05069001501",648,8,2211,708,9,0,163,0,3747
"05069001502",441,83,2199,674,35,0,11,0,3443
"05069001600",163,115,1817,1422,15,59,0,18,3609
"05069001700",80,0,1673,735,0,13,0,13,2514
"05069001800",1081,147,1297,842,148,0,0,0,3515
"05069001901",535,76,417,381,35,0,26,7,1477
"05069001903",121,0,1330,792,107,0,21,0,2371
"05069002000",2745,223,2029,21,408,0,88,0,5514
"05069002103",2048,533,436,379,119,19,39,0,3573
"05069002104",2717,262,843,67,55,0,23,8,3975
"05069002300",1533,125,1065,430,32,0,261,0,3446
"05069002400",3054,440,135,99,32,20,20,0,3800
"05069002500",515,89,351,209,17,6,0,18,1205
"05071951700",3814,665,0,0,210,0,264,68,5021
"05071951800",3340,1049,0,0,99,149,36,97,4770
"05071951900",2437,542,0,0,173,13,161,179,3505
"05071952000",2557,631,119,175,418,133,918,188,5139
"05071952100",2254,904,82,0,140,67,589,285,4321
"05071952200",4063,992,18,0,28,0,343,95,5539
"05073470100",2107,404,1142,839,16,15,120,10,4653
"05073470200",1683,255,366,361,22,0,8,0,2695
"05075470100",1006,396,0,4,22,0,0,0,1428
"05075470200",3410,850,0,0,32,12,15,8,4327
"05075470300",1786,328,0,0,13,12,12,3,2154
"05075470400",1075,640,0,0,36,0,2,0,1753
"05075470501",1888,723,26,0,108,28,21,12,2806
"05075470502",3130,846,51,0,0,44,0,96,4167
"05077470100",677,163,445,95,17,0,46,0,1443
"05077470200",1062,134,471,216,0,61,53,61,2058
"05077470300",877,112,1675,1492,9,0,0,0,4165
"05077470400",561,98,275,221,35,1,33,0,1224
"05079960300",1614,467,290,249,7,0,0,0,2627
"05079960400",2205,883,139,19,167,11,165,73,3662
"05079960500",1596,437,304,139,16,7,53,0,2552
"05079960600",532,55,684,500,69,4,50,30,1924
"05081030101",1148,235,683,30,74,0,53,0,2223
"05081030102",2827,600,995,192,97,145,76,145,5077
"05081030200",1834,240,294,215,90,2,0,0,2675
"05081030300",2084,317,114,48,222,34,99,11,2929
"05083950100",3298,799,0,1,212,9,113,0,4432
"05083950200",2755,524,69,2,200,36,108,29,3723
"05083950300",2721,550,11,131,52,76,0,0,3541
"05083950400",2719,221,0,0,125,20,22,17,3124
"05083950500",3273,695,33,82,10,180,27,196,4496
"05083950600",2282,352,11,19,152,0,0,26,2842
"05085020101",6411,240,86,0,263,3,74,0,7077
"05085020102",4754,936,19,0,98,0,18,0,5825
"05085020103",4921,518,10,0,0,69,118,0,5636
"05085020104",6261,472,0,0,138,308,284,249,7712
"05085020201",3502,98,0,0,66,0,154,0,3820
"05085020202",3040,713,17,148,342,84,306,84,4734
"05085020204",4650,828,52,0,135,27,155,19,5866
"05085020205",3975,787,49,1,322,85,126,116,5461
"05085020206",3329,409,0,0,263,0,208,7,4216
"05085020301",2914,322,405,125,130,95,79,17,4087
"05085020302",2850,675,149,0,240,0,120,0,4034
"05085020400",2167,227,219,107,0,0,20,54,2794
"05085020500",2663,462,728,313,181,0,132,17,4496
"05085020600",1132,69,358,77,6,0,75,0,1717
"05085020700",1446,418,573,365,33,25,43,7,2910
"05085020800",999,54,275,99,15,7,74,1,1524
"05087960100",2676,879,0,0,227,0,31,0,3813
"05087960200",2398,689,41,0,87,101,265,91,3672
"05087960300",4259,999,0,14,58,35,156,114,5635
"05087960400",2373,543,0,0,147,26,107,20,3216
"05089960100",3627,710,0,0,131,56,40,87,4651
"05089960201",2382,638,0,28,64,20,48,3,3183
"05089960202",2602,897,8,0,116,9,54,40,3726
"05089960300",4238,691,0,0,98,17,65,12,5121
"05091020100",2096,516,783,337,81,1,100,36,3950
"05091020200",1553,235,788,352,86,32,67,0,3113
"05091020400",748,387,473,425,43,63,71,0,2210
"05091020500",902,250,735,483,72,202,103,12,2759
"05091020600",173,108,509,897,50,10,41,12,1800
"05091020701",2008,162,893,141,162,0,301,0,3667
"05091020702",1731,267,1538,480,29,0,0,0,4045
"05091020801",1417,213,610,170,60,112,28,105,2715
"05091020802",2252,403,54,7,6,9,0,0,2731
"05091020900",6273,647,401,229,146,0,277,0,7973
"05091021000",6861,1204,133,106,246,7,0,0,8557
"05091980000",0,0,0,0,0,0,0,0,0
"05093010100",411,64,800,319,43,0,0,35,1672
"05093010200",1670,908,2225,1159,130,48,20,136,6296
"05093010300",312,223,1386,1052,31,0,44,0,3048
"05093010600",3662,745,1605,667,0,0,281,0,6960
"05093010700",3266,286,324,0,115,0,84,5,4080
"05093010800",4529,1707,4,0,268,17,432,17,6974
"05093010900",1156,281,361,394,101,24,100,0,2417
"05093011000",1047,390,1358,1634,172,0,28,0,4629
"05093011100",1402,359,446,340,81,0,0,0,2628
"05093011200",1363,315,167,162,24,0,42,70,2143
"05093011300",1318,290,227,159,57,27,125,67,2270
"05093011400",1867,246,631,49,60,0,161,14,3028
"05095950100",1327,320,893,960,73,0,25,35,3633
"05095950200",1006,391,253,235,39,39,29,59,2051
"05095950300",1191,121,624,280,5,0,0,0,2221
"05097953000",2377,695,20,7,211,74,65,35,3484
"05097953100",1642,393,22,0,25,25,42,20,2169
"05097953200",2894,642,0,0,78,27,171,3,3815
"05099090100",1232,207,375,211,24,6,2,12,2069
"05099090200",2200,999,952,824,92,25,38,205,5335
"05099090300",1020,221,241,61,24,9,10,0,1586
"05101180100",3245,654,0,0,88,95,7,0,4089
"05101180200",2996,796,0,4,92,95,67,4,4054
"05103950100",3611,523,1075,276,92,74,80,0,5731
"05103950200",1411,257,564,335,59,11,0,0,2637
"05103950300",3361,420,1002,356,84,0,54,0,5277
"05103950400",1159,282,1365,779,73,0,6,0,3664
"05103950500",1826,339,1195,596,175,0,82,31,4244
"05103950600",879,245,1488,997,154,0,49,159,3971
"05105952700",4267,705,84,6,23,67,58,7,5217
"05105952800",2580,309,0,26,98,24,99,0,3136
"05105952900",1651,171,65,61,35,2,99,0,2084
"05107480100",1302,43,716,769,8,0,14,0,2852
"05107480200",2967,341,1512,795,56,53,17,22,5763
"05107480300",1194,177,2627,1619,0,31,23,0,5671
"05107480400",305,44,668,914,34,4,50,10,2029
"05107480500",302,65,737,1327,22,8,0,0,2461
"05107480600",589,161,530,557,17,91,166,10,2121
"05109953300",2585,1182,38,2,335,176,366,177,4861
"05109953400",1795,492,0,0,32,35,0,0,2354
"05109953500",3278,524,157,106,110,146,27,166,4514
"05111490100",2681,961,255,178,20,28,36,0,4159
"05111490200",1175,290,24,0,15,0,0,0,1504
"05111490300",2056,1320,31,181,14,139,13,171,3925
"05111490400",3276,362,133,199,47,0,0,0,4017
"05111490500",4787,1127,7,83,119,66,0,137,6326
"05111490600",1579,139,18,0,31,2,66,1,1836
"05111490700",1237,445,392,345,0,33,32,57,2541
"05113950100",3445,572,29,0,295,57,183,60,4641
"05113950200",4047,1261,0,0,142,118,100,0,5668
"05113950300",2093,669,0,0,99,64,7,21,2953
"05113950400",2450,418,0,0,97,40,82,11,3098
"05113950500",1289,634,9,0,70,29,19,13,2063
"05113950600",1574,365,0,0,197,248,393,352,3129
"05115950700",2940,675,0,0,103,28,39,0,3785
"05115950800",3370,637,49,2,59,7,54,0,4178
"05115950900",5017,848,87,2,619,14,199,41,6827
"05115951000",3605,820,0,0,154,0,117,0,4696
"05115951100",3391,532,71,0,50,5,45,6,4100
"05115951200",7358,1220,20,0,245,0,571,212,9626
"05115951300",4111,1816,120,53,263,397,514,530,7804
"05115951400",1746,553,54,66,58,38,70,120,2705
"05115951501",3191,97,15,0,249,0,33,0,3585
"05115951502",4397,1699,91,253,479,94,383,381,7777
"05115951600",5217,844,528,316,632,208,982,407,9134
"05117460100",2529,680,140,27,73,19,63,25,3556
"05117460200",1837,321,312,124,1,0,0,0,2595
"05117460300",1505,324,227,189,13,0,0,0,2258
"05119000200",268,33,552,186,15,0,75,0,1129
"05119000500",80,42,1748,963,0,207,15,0,3055
"05119001100",29,72,1338,562,23,78,0,0,2102
"05119001200",129,115,563,407,40,14,61,20,1349
"05119001300",117,295,1100,756,0,26,0,0,2294
"05119001501",3031,342,221,29,245,23,47,2,3940
"05119001502",2710,547,329,84,91,24,52,0,3837
"05119001600",5372,214,41,126,165,14,138,13,6083
"05119001800",574,143,1885,1640,26,7,13,0,4288
"05119001900",250,140,1590,717,31,87,15,25,2855
"05119002001",1603,464,2921,458,137,0,409,193,6185
"05119002002",1146,516,2085,847,362,2,836,423,6217
"05119002102",1522,198,1150,563,236,19,156,91,3935
"05119002103",1979,109,1077,300,215,0,112,0,3792
"05119002104",3839,96,272,0,654,200,221,0,5282
"05119002203",3125,306,1316,496,173,31,164,14,5625
"05119002204",5249,347,1138,428,178,19,36,0,7395
"05119002206",1951,144,973,80,290,50,62,46,3596
"05119002208",1615,62,725,69,149,0,372,0,2992
"05119002209",1401,94,1143,636,193,28,191,0,3686
"05119002403",539,121,2549,682,67,65,163,72,4258
"05119002405",1158,309,2338,324,411,46,223,185,4994
"05119002406",1028,277,1244,477,92,106,233,244,3701
"05119002407",1357,101,610,7,54,0,60,0,2189
"05119002408",976,123,3815,1739,45,18,0,0,6716
"05119002500",625,173,524,186,10,0,15,0,1533
"05119002600",144,93,668,352,0,0,17,0,1274
"05119002700",1592,133,3421,987,413,93,186,0,6825
"05119002800",7,2,1105,1544,0,69,0,0,2727
"05119002900",291,69,704,481,99,3,90,0,1737
"05119003001",661,625,1061,1003,47,0,25,258,3680
"05119003002",883,64,989,1565,21,54,42,0,3618
"05119003100",72,19,348,138,0,0,16,7,600
"05119003202",3492,1191,2008,382,409,0,703,639,8824
"05119003205",0,0,0,0,0,0,0,0,0
"05119003207",1062,322,458,13,15,38,28,38,1974
"05119003208",1962,1040,1803,476,34,0,555,847,6717
"05119003303",4039,214,249,21,32,51,0,1,4607
"05119003304",4648,184,1119,66,97,0,115,41,6270
"05119003305",2409,318,331,74,65,162,592,64,4015
"05119003306",1511,110,692,399,113,0,137,0,2962
"05119003402",4785,662,420,85,239,0,116,47,6354
"05119003403",1932,418,84,0,275,11,294,0,3014
"05119003404",4263,1033,90,12,276,31,174,0,5879
"05119003500",1619,117,194,0,351,41,302,42,2666
"05119003604",4164,451,1111,331,220,50,105,0,6432
"05119003605",2603,440,1886,492,336,62,280,21,6120
"05119003606",918,474,1042,422,98,46,87,36,3123
"05119003607",1893,301,1866,702,281,50,475,0,5568
"05119003608",2667,349,938,692,238,23,423,0,5330
"05119003609",2581,440,569,372,141,2,155,109,4369
"05119003703",5762,88,794,201,302,0,352,0,7499
"05119003704",2206,424,533,64,187,11,144,95,3664
"05119003706",853,59,26,102,48,0,20,0,1108
"05119003707",2783,87,745,362,193,0,143,0,4313
"05119003710",2528,229,369,20,89,18,518,0,3771
"05119003711",2833,233,957,125,236,86,309,86,4865
"05119003712",3335,121,671,0,79,66,101,0,4373
"05119003713",2866,283,259,16,102,0,153,21,3700
"05119003800",1038,457,1735,400,78,57,165,301,4231
"05119003900",2218,237,1063,42,70,55,49,18,3752
"05119004001",495,44,1842,552,0,0,47,1,2981
"05119004004",2447,175,649,12,9,23,33,91,3439
"05119004005",356,187,995,330,66,34,0,10,1978
"05119004006",2520,414,146,79,46,53,406,119,3783
"05119004007",508,119,1944,318,137,5,105,14,3150
"05119004103",778,416,1758,773,40,20,314,377,4476
"05119004104",1074,441,244,22,51,27,14,269,2142
"05119004105",1073,236,2970,848,168,124,274,353,6046
"05119004106",845,593,4050,877,121,36,188,357,7067
"05119004107",843,343,997,995,131,68,469,371,4217
"05119004108",857,719,1883,867,59,120,550,642,5697
"05119004201",2039,165,31,43,133,12,15,0,2438
"05119004202",3081,235,2,8,97,25,21,0,3469
"05119004205",2507,177,396,286,109,0,81,7,3563
"05119004207",5020,319,1043,36,786,143,61,53,7461
"05119004212",4692,180,466,41,674,128,38,28,6247
"05119004213",3665,181,0,0,442,0,142,0,4430
"05119004214",2240,254,378,192,121,0,157,69,3411
"05119004215",4430,24,1001,76,405,18,0,0,5954
"05119004216",3681,61,995,690,677,20,87,20,6231
"05119004218",1700,265,749,9,183,34,181,195,3316
"05119004219",4747,190,367,0,845,114,238,0,6501
"05119004220",2179,80,2323,574,250,0,471,0,5877
"05119004221",2572,239,1485,268,455,18,152,34,5223
"05119004302",3298,541,531,69,364,40,193,33,5069
"05119004303",6120,650,2980,254,420,109,161,0,10694
"05119004305",5677,136,920,207,27,0,222,0,7189
"05119004306",3448,253,745,329,340,0,56,0,5171
"05119004400",1194,125,95,147,74,0,54,0,1689
"05119004500",57,30,1190,713,27,71,0,0,2088
"05119004600",908,246,1595,618,13,34,23,0,3437
"05119004700",867,189,1156,561,33,27,113,0,2946
"05119004800",1524,350,501,109,77,23,7,29,2620
"05119004900",5671,142,273,294,161,53,178,0,6772
"05121960100",2749,1182,0,1,54,9,25,64,4084
"05121960200",5055,1058,22,4,129,36,0,68,6372
"05121960301",2804,700,12,1,95,72,29,23,3736
"05121960302",2692,626,27,18,6,86,0,86,3541
"05123960100",1122,294,1003,840,7,46,58,129,3499
"05123960200",3474,480,1283,480,18,8,73,8,5824
"05123960300",1557,252,512,160,63,6,41,9,2600
"05123960400",329,326,2419,1541,67,18,33,6,4739
"05123960500",1397,155,1020,591,240,105,123,0,3631
"05123960600",690,457,1897,822,143,8,68,28,4113
"05125010101",3284,148,314,126,251,3,380,0,4506
"05125010102",6870,818,254,0,259,284,162,150,8797
"05125010103",5570,635,548,129,356,66,71,16,7391
"05125010301",3232,150,153,37,78,47,371,0,4068
"05125010302",2924,255,74,0,50,0,12,0,3315
"05125010303",3427,113,42,0,7,0,60,0,3649
"05125010404",6496,229,706,33,228,0,169,0,7861
"05125010405",3687,205,325,0,82,13,0,0,4312
"05125010406",5445,355,86,0,457,29,298,1,6671
"05125010407",4026,287,51,0,172,0,283,0,4819
"05125010408",4588,542,773,179,104,0,235,92,6513
"05125010409",1860,377,224,20,98,4,62,18,2663
"05125010503",5030,951,32,18,25,0,77,187,6320
"05125010506",6721,214,92,0,119,0,32,15,7193
"05125010507",2598,88,12,0,50,0,26,0,2774
"05125010508",3752,194,49,0,43,22,39,33,4132
"05125010509",3373,308,9,0,41,16,64,0,3811
"05125010510",7821,768,377,0,190,0,698,247,10101
"05125010511",3846,426,413,0,204,34,61,0,4984
"05125010512",2857,67,41,0,93,0,27,0,3085
"05125010600",4790,1049,455,191,107,538,524,12,7666
"05127950100",3687,389,0,0,388,30,190,0,4684
"05127950200",2442,1147,0,0,468,113,438,113,4721
"05127950300",1635,427,0,0,125,5,31,40,2263
"05129970100",2040,339,1,0,69,0,0,0,2449
"05129970200",2609,879,0,4,44,108,64,79,3787
"05129970300",1300,486,0,0,25,38,2,0,1851
"05131000100",1058,1143,710,512,1228,374,916,737,6678
"05131000200",1806,1521,151,432,662,364,799,1134,6869
"05131000300",666,763,92,196,212,274,232,563,2998
"05131000400",1146,937,357,155,299,49,829,442,4214
"05131000501",1805,1857,502,242,634,190,1373,1399,8002
"05131000502",1358,698,303,13,462,176,499,506,4015
"05131000600",4211,340,221,12,193,47,473,0,5497
"05131000700",2810,1302,213,343,129,123,733,519,6172
"05131000800",2406,1173,113,118,430,239,576,608,5663
"05131001001",3089,900,105,453,526,125,205,361,5764
"05131001002",1776,58,71,0,46,123,31,12,2117
"05131001101",3027,324,214,62,335,59,85,18,4124
"05131001102",1796,426,96,5,554,45,63,22,3007
"05131001201",2490,417,130,27,149,299,76,121,3709
"05131001202",2124,1354,106,119,382,102,269,69,4525
"05131001301",1961,133,35,128,475,74,111,41,2958
"05131001302",6257,1446,129,121,1343,67,532,20,9915
"05131001303",4042,1241,217,157,516,205,467,54,6899
"05131001304",5937,523,239,109,285,257,144,93,7587
"05131001305",4198,319,58,1,494,23,31,0,5124
"05131010101",5547,461,34,0,339,59,348,36,6824
"05131010102",5307,1010,9,0,129,39,47,0,6541
"05131010201",3173,929,0,0,171,132,51,91,4547
"05131010202",3379,373,0,0,123,0,20,0,3895
"05131010301",5005,613,0,0,463,119,376,10,6586
"05131010302",5269,1055,0,0,254,18,14,45,6655
"05133080100",2842,358,0,0,715,235,606,295,5051
"05133080200",2376,587,23,32,375,488,402,538,4821
"05133080300",1807,609,399,23,2398,821,2579,1015,9651
"05133080400",1909,548,218,119,86,25,41,25,2971
"05135470100",1183,374,0,8,75,100,15,10,1765
"05135470200",4045,1039,4,0,147,56,208,4,5503
"05135470300",2665,1111,0,0,133,8,1,24,3942
"05135470400",4462,1194,8,16,112,12,39,23,5866
"05137950100",3279,696,0,0,2,73,49,0,4099
"05137950201",880,442,0,0,65,0,15,11,1413
"05137950202",4847,2111,0,0,22,0,69,48,7097
"05139950100",1485,256,993,320,9,0,0,54,3117
"05139950200",2688,543,571,70,95,87,59,26,4139
"05139950300",1776,178,255,195,109,19,18,5,2555
"05139950400",4066,752,747,289,186,7,312,375,6734
"05139950500",5171,671,297,84,0,0,86,0,6309
"05139950600",1500,199,877,846,21,5,148,46,3642
"05139950700",2539,562,1138,582,24,0,129,0,4974
"05139950800",2095,390,751,174,235,0,0,0,3645
"05139950900",542,129,907,825,71,10,133,10,2627
"05139951000",501,124,2099,1270,28,0,49,0,4071
"05141460100",2192,1047,0,0,45,71,6,15,3376
"05141460200",2499,1197,0,22,183,16,144,10,4071
"05141460301",1525,314,0,0,50,5,4,0,1898
"05141460302",2786,832,0,64,0,0,166,0,3848
"05141460400",2902,813,45,0,175,45,114,15,4109
"05143010101",2874,511,0,0,562,327,476,160,4910
"05143010102",6834,679,62,2,657,0,358,243,8835
"05143010104",4553,484,71,47,467,80,89,37,5828
"05143010105",6873,618,177,0,429,73,334,41,8545
"05143010106",4425,477,147,48,968,54,479,42,6640
"05143010107",4546,514,213,9,273,0,231,0,5786
"05143010200",2326,907,9,25,2158,1778,1893,1781,10877
"05143010301",4599,1142,148,96,1575,1490,2094,2116,13260
"05143010302",6435,1425,395,388,3913,2271,4627,1722,21176
"05143010401",3180,430,6,0,1637,739,1799,756,8547
"05143010402",2597,399,81,17,1351,226,1521,385,6577
"05143010403",3378,633,121,97,1454,1836,1439,965,9923
"05143010501",4372,536,0,0,209,138,62,93,5410
"05143010503",5991,415,178,187,740,109,531,33,8184
"05143010504",5340,731,0,78,904,122,364,86,7625
"05143010506",7630,1725,17,0,559,253,530,29,10743
"05143010507",5003,1028,205,201,235,44,101,67,6884
"05143010508",5050,622,540,10,312,115,257,81,6987
"05143010509",5383,560,39,0,1200,93,865,103,8243
"05143010510",3017,197,24,33,1111,144,1135,280,5941
"05143010600",3117,2039,343,83,731,257,234,114,6918
"05143010701",2598,2379,179,130,732,846,704,238,7806
"05143010702",3092,1352,337,83,290,175,307,270,5906
"05143011001",6193,934,24,0,459,66,416,82,8174
"05143011002",3422,812,8,0,474,135,64,8,4923
"05143011003",3976,583,21,268,190,95,52,28,5213
"05143011004",2671,460,1,1,208,4,91,0,3436
"05143011101",3047,1934,116,295,386,377,571,41,6767
"05143011102",5019,1120,107,134,459,98,607,193,7737
"05143011103",3194,756,14,0,61,13,78,39,4155
"05143011200",904,273,40,0,630,176,611,243,2877
"05143011300",1524,1077,36,13,130,130,49,80,3039
"05145070100",3763,768,8,12,96,107,79,64,4897
"05145070200",4043,595,0,0,34,15,168,15,4870
"05145070300",4267,466,5,138,233,66,214,31,5420
"05145070401",4324,551,312,28,141,1,32,34,5423
"05145070402",3418,870,18,22,170,23,74,48,4643
"05145070500",5027,971,248,18,189,48,228,122,6851
"05145070600",2956,1027,68,0,33,114,15,103,4316
"05145070700",2861,337,277,117,119,65,0,86,3862
"05145070800",2276,884,224,62,134,205,108,112,4005
"05145070900",7012,1113,541,135,169,15,360,134,9479
"05145071000",5672,625,84,2,265,74,49,24,6795
"05145071100",3728,1328,75,158,578,260,311,280,6718
"05145071200",7107,1955,226,282,195,32,3,349,10149
"05147490100",2603,599,493,306,50,29,8,10,4098
"05147490200",1277,364,636,475,82,45,17,6,2902
"05149952301",1656,984,61,34,383,83,678,416,4295
"05149952302",2304,636,14,0,452,42,561,211,4220
"05149952401",2127,446,16,0,446,79,462,141,3717
"05149952402",4631,331,0,39,31,57,22,61,5172
"05149952500",2253,571,33,8,974,507,968,635,5949
"05149952600",1919,458,0,14,12,10,0,10,2423
"06001400100",1872,127,119,0,624,10,100,0,2852
"06001400200",1431,56,34,0,396,22,121,13,2073
"06001400300",3350,199,543,172,1012,89,405,0,5770
"06001400400",2769,216,663,50,535,41,440,12,4726
"06001400500",1980,258,707,195,299,77,345,175,4036
"06001400600",613,70,592,29,385,44,201,37,1971
"06001400700",1450,357,1498,454,616,21,461,15,4872
"06001400800",1373,79,1057,104,495,60,469,0,3637
"06001400900",979,80,514,123,295,40,80,17,2128
"06001401000",1351,636,1385,871,1120,123,944,192,6622
"06001401100",2049,365,799,152,747,128,404,64,4708
"06001401200",1392,58,214,54,534,71,322,26,2671
"06001401300",852,356,588,576,868,277,418,226,4161
"06001401400",737,573,1179,745,559,453,370,434,5050
"06001401500",872,125,552,222,219,141,214,3,2348
"06001401600",341,258,571,332,236,181,92,141,2152
"06001401700",868,170,470,283,672,140,704,155,3462
"06001401800",410,109,623,308,190,154,267,86,2147
"06001402200",790,255,697,235,297,158,500,151,3083
"06001402400",448,91,1259,411,292,333,224,90,3148
"06001402500",132,71,603,599,225,279,138,232,2279
"06001402600",106,15,212,92,352,252,34,0,1063
"06001402700",335,127,595,263,276,19,155,49,1819
"06001402800",663,407,750,626,477,345,208,97,3573
"06001402900",302,35,106,66,565,249,127,14,1464
"06001403000",151,46,40,52,1533,649,18,30,2519
"06001403100",410,89,88,33,516,265,63,0,1464
"06001403300",1137,30,278,18,1532,770,173,63,4001
"06001403400",1407,206,782,82,1465,401,454,40,4837
"06001403501",1268,335,1092,296,995,509,420,23,4938
"06001403502",1003,110,233,240,383,49,184,45,2247
"06001403600",1554,34,816,101,1513,273,481,3,4775
"06001403701",1383,116,350,106,453,30,174,26,2638
"06001403702",1231,40,120,21,422,68,141,8,2051
"06001403800",2294,115,238,50,747,11,246,19,3720
"06001403900",1958,147,765,101,890,94,201,55,4211
"06001404000",1667,150,154,28,661,122,358,55,3195
"06001404101",2098,137,34,12,523,95,139,1,3039
"06001404102",1284,116,177,8,575,207,153,22,2542
"06001404200",2324,51,182,73,639,9,215,0,3493
"06001404300",2381,29,161,23,726,28,206,23,3577
"06001404400",3465,123,148,22,1254,87,342,0,5441
"06001404501",1278,47,54,0,361,0,84,0,1824
"06001404502",4297,118,222,0,708,36,272,0,5653
"06001404600",3053,119,275,14,993,14,147,0,4615
"06001404700",1611,26,135,0,279,20,71,0,2142
"06001404800",1140,80,565,82,859,168,284,29,3207
"06001404900",2295,112,508,57,1264,102,467,102,4907
"06001405000",2140,79,365,28,755,36,335,29,3767
"06001405100",2859,48,429,13,735,0,165,0,4249
"06001405200",2012,116,570,21,1654,148,583,3,5107
"06001405301",1290,25,490,145,643,66,421,0,3080
"06001405302",577,173,450,63,822,629,400,129,3243
"06001405401",618,276,691,232,1708,774,792,427,5518
"06001405402",383,176,430,181,1081,425,253,153,3082
"06001405500",881,216,491,114,1692,507,473,243,4617
"06001405600",724,144,737,101,1387,110,232,119,3554
"06001405700",449,207,1131,258,1121,134,378,145,3823
"06001405800",383,176,665,165,1603,932,374,416,4714
"06001405901",234,448,411,202,1542,973,748,474,5032
"06001405902",596,197,269,173,1556,718,700,489,4698
"06001406000",565,101,443,213,846,1090,189,343,3790
"06001406100",1540,509,320,55,2128,296,2581,591,8020
"06001406201",882,472,461,240,1533,600,1291,597,6076
"06001406202",1504,574,231,170,1034,819,1938,776,7046
"06001406300",761,373,508,365,1728,589,750,524,5598
"06001406400",500,113,448,221,784,80,297,80,2523
"06001406500",1702,524,781,251,2000,544,1884,757,8443
"06001406601",879,73,1194,608,1978,255,735,53,5775
"06001406602",605,274,322,96,1167,124,513,338,3439
"06001406700",3034,81,348,74,1244,218,522,60,5581
"06001406800",1601,41,479,129,1306,61,576,33,4226
"06001406900",1613,132,666,257,1004,180,578,17,4447
"06001407000",918,54,968,390,2430,803,1140,187,6890
"06001407101",746,819,344,90,1326,557,919,1040,5841
"06001407102",1858,330,762,206,958,374,1978,312,6778
"06001407200",1962,1135,220,225,1914,860,2998,1701,11015
"06001407300",803,271,219,59,1054,152,1019,304,3881
"06001407400",1245,232,469,206,1357,843,2177,880,7409
"06001407500",677,374,664,627,901,418,1136,598,5395
"06001407600",1064,238,1977,808,1297,370,1245,145,7144
"06001407700",1378,52,1887,390,583,25,461,23,4799
"06001407800",538,66,822,45,448,8,414,27,2368
"06001407900",1241,120,448,23,996,23,221,0,3072
"06001408000",1245,65,380,25,652,66,196,5,2634
"06001408100",2654,27,1739,82,1830,131,539,39,7041
"06001408200",826,26,1651,534,915,132,652,46,4782
"06001408300",1129,499,1597,322,1040,127,760,83,5557
"06001408400",442,265,1121,539,505,651,622,598,4743
"06001408500",567,206,1547,696,1408,1181,1579,1231,8415
"06001408600",1127,747,1373,1078,1485,628,1881,1261,9580
"06001408700",1423,812,2184,1113,1456,442,2500,1265,11195
"06001408800",957,290,698,1387,2124,676,2509,734,9375
"06001408900",675,549,613,498,469,430,984,777,4995
"06001409000",894,207,1148,346,984,399,1355,581,5914
"06001409100",600,58,513,385,424,243,706,256,3185
"06001409200",512,243,1048,189,1001,182,1107,273,4555
"06001409300",1381,317,1058,333,1452,544,2399,753,8237
"06001409400",1026,607,836,354,1266,402,1814,812,7117
"06001409500",820,492,533,445,1304,443,1750,673,6460
"06001409600",979,325,1194,360,1396,746,2225,951,8176
"06001409700",1388,273,1568,805,917,309,1941,492,7693
"06001409800",180,113,1379,327,858,26,496,7,3386
"06001409900",1068,62,1421,102,642,17,537,17,3866
"06001410000",1172,19,1131,152,553,185,394,0,3606
"06001410100",690,308,1292,326,392,20,324,80,3432
"06001410200",601,386,1065,345,547,10,967,336,4257
"06001410300",864,304,582,427,1078,268,1599,411,5533
"06001410400",987,138,1402,316,1147,76,1529,157,5752
"06001410500",94,84,707,685,473,282,120,71,2516
"06001420100",1669,87,77,0,485,38,180,0,2536
"06001420200",1659,101,192,42,1029,108,252,38,3421
"06001420300",1831,144,282,0,2219,224,465,52,5217
"06001420400",1108,393,93,58,1493,545,430,335,4455
"06001420500",1241,80,109,62,781,53,116,0,2442
"06001420600",1883,71,108,0,678,16,291,16,3063
"06001421100",1548,67,22,0,430,41,65,0,2173
"06001421200",2916,87,8,0,608,42,228,17,3906
"06001421300",3178,162,128,0,615,10,169,23,4285
"06001421400",1391,43,62,0,220,5,113,14,1848
"06001421500",3054,128,71,16,466,25,122,23,3905
"06001421600",2704,173,25,15,454,131,138,10,3650
"06001421700",2165,243,118,4,870,255,418,92,4165
"06001421800",1788,72,27,1,288,29,142,19,2366
"06001421900",2376,124,312,12,667,292,150,24,3957
"06001422000",801,315,170,148,228,132,168,144,2106
"06001422100",1472,102,141,62,495,12,437,60,2781
"06001422200",2026,255,202,1,718,124,304,63,3693
"06001422300",2197,428,140,60,759,304,255,55,4198
"06001422400",2034,224,41,20,1198,748,149,151,4565
"06001422500",1510,519,163,14,593,435,278,88,3600
"06001422600",29,0,0,0,0,0,0,0,29
"06001422700",1100,283,40,75,293,559,182,95,2627
"06001422800",898,450,65,81,579,812,110,118,3113
"06001422900",1185,812,255,154,952,908,150,33,4449
"06001423000",3009,355,74,375,1051,158,424,22,5468
"06001423100",1804,576,243,206,843,313,174,115,4274
"06001423200",1382,162,323,80,542,250,751,235,3725
"06001423300",1707,84,1219,123,593,197,597,107,4627
"06001423400",2300,505,626,187,1202,286,558,193,5857
"06001423500",1491,405,342,84,611,112,223,88,3356
"06001423601",1907,256,10,13,371,152,201,26,2936
"06001423602",1651,962,56,233,1260,1821,314,158,6455
"06001423700",1737,638,19,13,364,391,172,30,3364
"06001423800",2395,81,11,0,542,21,256,6,3312
"06001423901",1180,80,223,136,242,22,216,0,2099
"06001423902",997,180,34,5,147,12,135,20,1530
"06001424001",1260,363,914,476,824,143,592,161,4733
"06001424002",689,203,674,198,412,107,296,170,2749
"06001425101",813,116,123,0,431,36,21,0,1540
"06001425102",997,145,280,62,1116,154,183,0,2937
"06001425103",1415,91,317,6,1005,60,364,0,3258
"06001425104",1224,213,803,56,696,326,218,241,3777
"06001426100",4240,319,29,0,1502,75,345,35,6545
"06001426200",3487,72,46,0,1112,50,282,0,5049
"06001427100",2477,63,77,17,745,35,282,25,3721
"06001427200",1948,60,149,73,1282,593,722,112,4939
"06001427300",1912,14,534,24,1723,601,531,57,5396
"06001427600",991,484,627,471,2229,741,655,101,6299
"06001427700",2312,175,187,224,1666,143,335,68,5110
"06001427800",2805,341,392,49,1139,121,649,93,5589
"06001427900",2900,73,212,20,1538,116,580,51,5490
"06001428000",1200,119,99,55,1588,327,479,104,3971
"06001428100",2880,279,81,29,1696,19,787,11,5782
"06001428200",3685,80,363,81,2124,358,850,20,7561
"06001428301",2398,141,134,0,3364,171,202,16,6426
"06001428302",3113,63,178,2,3532,79,263,12,7242
"06001428400",2208,170,169,6,1442,242,600,99,4936
"06001428500",1338,179,170,11,1515,202,477,32,3924
"06001428600",1073,117,245,40,1338,48,177,0,3038
"06001428700",969,114,214,312,1747,210,272,88,3926
"06001430101",2448,335,301,0,3615,45,397,0,7141
"06001430102",1355,8,116,0,661,0,214,1,2355
"06001430200",4891,0,81,0,1650,74,857,19,7572
"06001430300",2064,209,736,1,763,4,359,9,4145
"06001430400",1373,13,59,0,670,13,389,0,2517
"06001430500",2666,465,553,88,1830,108,1355,393,7458
"06001430600",3196,118,168,1,2115,186,900,0,6684
"06001430700",2735,60,72,10,741,167,466,18,4269
"06001430800",3658,289,97,0,1717,217,1162,153,7293
"06001430900",2237,435,463,160,1247,158,1162,105,5967
"06001431000",1732,267,29,9,642,193,774,162,3808
"06001431100",1606,203,230,102,844,99,957,50,4091
"06001431200",2779,955,275,15,1108,341,850,591,6914
"06001432100",1785,41,610,78,1176,42,758,30,4520
"06001432200",1935,309,567,89,990,64,1058,184,5196
"06001432300",1385,397,453,18,2173,124,1282,376,6208
"06001432400",2200,481,606,140,1925,310,1367,344,7373
"06001432501",1617,384,147,31,2498,319,1118,434,6548
"06001432502",1260,258,653,10,2346,64,1119,187,5897
"06001432600",2538,166,833,265,3242,403,2231,204,9882
"06001432700",1611,73,95,34,681,7,594,11,3106
"06001432800",1691,186,204,0,933,27,716,0,3757
"06001433000",1980,31,327,3,1117,128,918,8,4512
"06001433102",1315,138,163,63,2011,46,864,159,4759
"06001433103",1915,219,697,122,1089,377,1704,434,6557
"06001433104",1415,284,664,76,1376,111,928,247,5101
"06001433200",2111,393,965,272,2723,546,1091,372,8473
"06001433300",2842,146,465,2,3138,469,1734,42,8838
"06001433400",1873,68,526,37,3367,510,945,15,7341
"06001433500",1939,182,132,11,2482,40,1700,163,6649
"06001433600",1919,196,218,77,2912,644,1153,38,7157
"06001433700",1681,226,369,52,801,201,1310,384,5024
"06001433800",3181,439,1014,93,2878,296,2598,240,10739
"06001433900",2392,921,1422,608,1090,435,2232,1058,10158
"06001434000",2160,320,463,512,1521,290,2185,486,7937
"06001435102",1992,111,347,54,1440,246,641,18,4849
"06001435103",2255,48,493,39,3491,159,609,0,7094
"06001435104",1521,453,505,110,2345,426,1392,391,7143
"06001435200",1612,427,1184,19,1122,52,1040,63,5519
"06001435300",1562,275,600,339,793,359,914,423,5265
"06001435400",2181,257,660,221,893,59,1346,190,5807
"06001435500",1627,330,119,71,990,145,1210,318,4810
"06001435601",1677,1126,240,61,1428,594,1891,1242,8259
"06001435602",2464,798,276,90,1067,680,1935,810,8120
"06001435700",1916,203,310,68,1867,47,1771,200,6382
"06001435800",2679,240,113,0,1857,302,1451,350,6992
"06001435900",2712,92,235,280,2013,200,1410,40,6982
"06001436000",2290,260,75,72,1700,82,1548,144,6171
"06001436100",2363,314,272,17,2801,277,2131,345,8520
"06001436200",1523,341,370,242,1290,192,2117,392,6467
"06001436300",2518,378,856,347,2768,535,2916,965,11283
"06001436401",3703,507,881,242,2008,459,1902,669,10371
"06001436402",1361,108,442,23,758,47,642,52,3433
"06001436500",1127,525,677,176,1620,411,1187,504,6227
"06001436601",2200,304,665,124,2360,485,2908,739,9785
"06001436602",1442,396,858,246,2029,375,1839,534,7719
"06001436700",938,156,236,124,1702,518,1331,516,5521
"06001436800",1307,172,663,0,1855,151,1427,126,5701
"06001436900",2520,576,171,66,2783,445,3521,716,10798
"06001437000",1414,67,587,13,1009,83,875,49,4097
"06001437101",1744,74,288,19,4102,56,1110,11,7404
"06001437102",1073,120,475,58,2079,429,1139,274,5647
"06001437200",2338,35,579,401,3326,640,1851,278,9448
"06001437300",911,175,406,98,1461,261,819,276,4407
"06001437400",1486,50,41,0,1544,66,1599,56,4842
"06001437500",1342,630,176,49,1452,680,1568,1122,7019
"06001437600",1517,181,296,50,1264,436,1617,376,5737
"06001437701",1017,473,325,50,1362,582,1393,837,6039
"06001437702",1533,852,260,96,1573,603,2305,1236,8458
"06001437800",999,98,436,63,2894,80,1901,54,6525
"06001437900",688,124,273,8,1032,100,1196,147,3568
"06001438000",1799,123,22,0,1239,86,1192,60,4521
"06001438100",2531,190,535,308,3495,178,2295,313,9845
"06001438201",2153,112,186,158,2238,224,2503,274,7848
"06001438203",853,124,382,13,2682,330,762,225,5371
"06001438204",1819,95,386,21,2785,213,1219,42,6580
"06001438300",1276,75,350,52,2231,136,1707,86,5913
"06001438400",983,16,249,69,1109,50,741,21,3238
"06001440100",918,85,105,8,1205,120,476,18,2935
"06001440200",1182,251,188,3,3828,651,3806,737,10646
"06001440301",2129,24,573,33,3561,538,1727,469,9054
"06001440304",765,10,210,19,3998,95,731,20,5848
"06001440305",740,54,260,55,2636,247,626,13,4631
"06001440306",439,100,142,72,2790,391,290,40,4264
"06001440307",1368,175,69,128,2106,182,648,52,4728
"06001440308",1079,216,248,13,3693,305,1641,131,7326
"06001440331",546,25,206,4,2660,178,569,64,4252
"06001440332",376,19,51,0,3053,66,294,7,3866
"06001440333",494,6,223,0,1969,96,231,7,3026
"06001440334",611,125,198,0,3212,287,660,101,5194
"06001440335",1081,154,101,0,5336,72,583,47,7374
"06001440336",999,179,475,109,2722,456,695,248,5883
"06001441100",1859,64,58,0,1852,243,785,151,5012
"06001441200",3125,213,218,257,3516,30,931,59,8349
"06001441301",838,101,178,141,1935,10,280,7,3490
"06001441302",1950,173,147,54,2896,215,675,0,6110
"06001441401",2076,124,279,8,4367,410,643,191,8098
"06001441402",1459,62,68,59,3415,166,632,116,5977
"06001441501",670,5,387,159,5204,208,414,2,7049
"06001441503",380,70,167,7,5371,178,82,6,6261
"06001441521",1155,69,256,3,4555,131,273,22,6464
"06001441522",1217,183,249,36,3291,181,626,37,5820
"06001441523",407,100,174,0,3148,179,162,0,4170
"06001441524",271,74,189,0,3574,228,162,31,4529
"06001441601",1751,257,191,0,2606,0,878,0,5683
"06001441602",1832,162,507,26,5021,327,1932,180,9987
"06001441700",2440,150,466,56,3952,519,2151,259,9993
"06001441800",2595,101,36,58,4145,89,1093,9,8126
"06001441921",1139,40,172,8,2462,13,1062,8,4904
"06001441923",704,310,153,112,3595,264,314,153,5605
"06001441924",2251,765,35,0,4097,126,619,382,8275
"06001441925",1229,97,169,0,4468,47,615,0,6625
"06001441926",856,90,145,56,3010,63,1508,55,5783
"06001441927",540,72,270,15,3163,197,240,68,4565
"06001442000",760,31,2,2,2314,117,57,0,3283
"06001442100",983,31,35,0,3836,103,171,7,5166
"06001442200",1467,145,36,0,5007,32,184,12,6883
"06001442301",1309,68,248,68,2521,338,633,70,5255
"06001442302",1419,209,394,33,3048,323,625,83,6134
"06001442400",2339,175,113,170,3559,567,1681,484,9088
"06001442500",2455,169,480,0,4079,142,1042,67,8434
"06001442601",1614,64,114,10,1766,26,571,25,4190
"06001442602",1840,237,146,108,2087,508,807,246,5979
"06001442700",1705,69,31,0,1318,35,652,47,3857
"06001442800",1418,90,65,71,1271,204,675,48,3842
"06001442900",2879,119,337,8,4279,171,1424,0,9217
"06001443001",1116,43,53,0,1749,10,1074,31,4076
"06001443002",1721,220,16,0,3965,212,1543,0,7677
"06001443102",952,23,16,0,4061,76,343,12,5483
"06001443103",310,79,89,0,3355,172,37,0,4042
"06001443104",1015,63,47,7,4412,155,336,22,6057
"06001443105",700,12,78,0,3551,19,0,0,4360
"06001443200",696,14,10,0,2710,92,95,9,3626
"06001443301",966,95,117,0,2776,173,194,11,4332
"06001443321",570,34,0,84,2359,78,152,0,3277
"06001443322",813,10,77,2,2340,81,108,13,3444
"06001444100",3833,109,83,18,3260,179,1834,113,9429
"06001444200",2290,155,287,11,3606,163,2289,49,8850
"06001444301",1593,34,95,0,2112,66,1086,53,5039
"06001444302",1107,376,127,0,2684,426,1765,647,7132
"06001444400",1363,130,90,81,3098,54,2237,94,7147
"06001444500",1883,451,411,202,3561,336,2177,496,9517
"06001444601",1797,266,317,0,2473,167,961,58,6039
"06001444602",1037,38,286,0,2736,140,528,0,4765
"06001450101",1740,81,301,0,2284,25,291,9,4731
"06001450102",1331,24,106,0,2441,33,849,0,4784
"06001450200",2865,134,205,25,1617,180,449,0,5475
"06001450300",2924,126,280,12,1585,109,603,146,5785
"06001450400",4062,121,67,12,1577,118,774,40,6771
"06001450501",2448,95,193,8,591,0,508,33,3876
"06001450502",3033,72,50,0,1986,11,419,11,5582
"06001450601",2195,50,142,0,934,83,165,0,3569
"06001450602",5978,236,130,150,2689,63,830,31,10107
"06001450603",2993,73,11,0,1496,53,505,8,5139
"06001450604",3596,179,71,0,1019,0,531,31,5427
"06001450605",2621,132,39,19,1169,4,296,17,4297
"06001450606",3695,93,168,8,1877,36,417,39,6333
"06001450607",3229,163,111,239,1368,13,779,215,6117
"06001450701",4958,392,16,11,2842,25,469,16,8729
"06001450741",3565,275,166,0,984,107,1050,228,6375
"06001450742",3423,32,79,0,1198,13,586,13,5344
"06001450743",2245,215,125,138,3114,50,605,56,6548
"06001450744",3034,111,82,0,1542,97,546,47,5459
"06001450745",2862,11,64,0,2882,10,302,0,6131
"06001450746",2693,186,29,0,337,32,502,12,3791
"06001450750",1882,213,137,51,1539,139,481,64,4506
"06001450751",1293,11,255,0,2461,17,229,0,4266
"06001450752",1947,32,221,0,3281,54,326,15,5876
"06001451101",4972,196,52,101,1579,0,733,63,7696
"06001451102",3194,50,14,14,717,42,322,0,4353
"06001451201",4624,284,203,102,1546,9,1341,54,8163
"06001451202",2950,154,32,3,789,0,803,0,4731
"06001451300",6063,181,92,29,677,74,1467,78,8661
"06001451401",4421,482,14,30,1178,154,1011,352,7642
"06001451403",1507,139,20,0,430,4,449,45,2594
"06001451404",4546,449,78,16,856,189,2676,357,9167
"06001451501",3586,158,71,0,693,16,768,0,5292
"06001451503",4071,156,0,0,1106,208,1374,17,6932
"06001451504",1339,53,40,0,228,0,88,0,1748
"06001451505",3050,37,0,0,206,21,225,11,3550
"06001451506",2379,423,154,76,521,0,991,355,4899
"06001451601",4127,99,0,7,804,8,530,18,5593
"06001451602",5329,246,21,12,978,33,858,13,7490
"06001451701",2307,101,50,0,437,0,405,2,3302
"06001451703",3172,104,141,0,1040,34,669,25,5185
"06001451704",3815,130,41,0,199,43,761,0,4989
"06001981900",28,0,0,0,0,0,0,0,28
"06001982000",65,0,0,0,18,0,16,0,99
"06001983200",289,15,44,20,216,7,84,7,682
"06001990000",0,0,0,0,0,0,0,0,0
"06003010000",734,113,0,0,271,66,48,38,1270
"06005000101",3629,236,36,11,90,168,142,39,4351
"06005000102",1237,188,0,0,226,27,226,40,1944
"06005000200",3648,518,0,2,483,79,576,39,5345
"06005000301",1622,92,74,0,26,0,79,8,1901
"06005000303",3591,555,1,2,440,75,317,50,5031
"06005000304",3054,551,0,0,251,172,348,288,4664
"06005000401",3648,463,8,0,187,51,458,130,4945
"06005000402",3582,842,2,0,386,28,226,27,5093
"06005000500",2342,210,0,0,92,7,153,15,2819
"06007000102",2858,515,16,0,503,102,535,201,4730
"06007000103",3326,194,31,0,525,29,644,65,4814
"06007000104",3851,823,160,10,820,144,666,324,6798
"06007000201",3235,761,0,0,296,163,552,348,5355
"06007000202",2171,546,156,0,326,168,340,69,3776
"06007000300",2688,716,38,41,589,304,740,383,5499
"06007000401",1761,202,11,0,207,159,469,136,2945
"06007000402",6020,536,7,24,534,108,948,82,8259
"06007000501",2283,778,69,10,461,175,363,292,4431
"06007000502",1297,1652,22,26,331,637,464,383,4812
"06007000601",2939,405,0,0,123,21,335,76,3899
"06007000603",1056,894,0,61,88,190,85,277,2651
"06007000604",1412,1662,0,205,192,521,142,644,4778
"06007000700",3449,837,127,16,419,171,169,167,5355
"06007000800",3915,669,0,3,965,53,725,202,6532
"06007000901",2241,111,0,0,94,6,185,0,2637
"06007000903",4089,714,99,91,856,418,772,391,7430
"06007000904",4580,368,55,105,549,27,467,65,6216
"06007001000",2480,1427,35,156,361,110,329,246,5144
"06007001100",1811,1293,29,76,103,344,65,440,4161
"06007001200",1697,928,53,0,254,227,392,178,3729
"06007001300",2041,1010,4,42,227,832,581,675,5412
"06007001400",4753,479,11,1,267,34,217,48,5810
"06007001500",4785,454,0,27,85,151,411,219,6132
"06007001600",4037,434,42,24,299,41,552,69,5498
"06007001702",3966,864,0,0,291,98,390,101,5710
"06007001703",2471,228,0,0,175,64,236,10,3184
"06007001704",2567,638,0,0,155,16,135,73,3584
"06007001800",4354,822,3,0,310,53,332,88,5962
"06007001900",2712,483,0,18,226,19,247,93,3798
"06007002000",4264,966,0,0,340,79,268,72,5989
"06007002100",3608,627,0,59,250,53,192,103,4892
"06007002200",3363,793,26,0,179,51,85,26,4523
"06007002300",3859,978,10,0,121,101,299,42,5410
"06007002400",3225,1155,39,3,500,115,341,187,5565
"06007002500",2621,468,54,188,818,338,305,75,4867
"06007002601",1666,270,48,0,442,9,217,0,2652
"06007002602",2972,285,31,0,258,0,117,16,3679
"06007002700",3353,705,9,5,780,329,377,20,5578
"06007002800",1809,820,263,17,680,538,512,191,4830
"06007002900",1426,710,0,3,626,432,125,117,3439
"06007003001",1425,697,49,13,531,934,285,373,4307
"06007003002",1805,711,0,14,609,362,588,270,4359
"06007003100",3256,270,104,1,671,65,321,35,4723
"06007003200",2142,971,13,0,621,144,751,383,5025
"06007003300",2955,562,149,0,734,76,398,172,5046
"06007003400",1962,461,28,15,446,59,711,311,3993
"06007003501",2027,353,8,0,665,15,859,130,4057
"06007003502",2434,768,0,12,1014,255,1655,822,6960
"06007003600",2222,350,6,0,481,297,646,358,4360
"06007003700",2786,796,0,0,722,581,290,153,5328
"06009000120",4571,349,18,0,187,88,494,47,5754
"06009000121",3489,567,0,0,137,62,462,94,4811
"06009000122",3326,524,0,0,154,0,132,209,4345
"06009000210",8090,1178,2,31,538,184,951,57,11031
"06009000220",4515,291,2,0,750,90,840,132,6620
"06009000300",4677,521,174,0,546,70,520,115,6623
"06009000400",2510,800,2,0,274,36,183,73,3878
"06009000501",2986,377,0,0,56,0,311,0,3730
"06009000503",1410,87,0,0,62,39,30,0,1628
"06009000504",343,52,0,0,52,6,38,1,492
"06011000100",3557,737,0,0,790,122,2767,514,8487
"06011000200",3432,516,59,50,955,166,2084,468,7730
"06011000300",4619,654,14,10,573,119,3459,667,10115
"06011000400",1964,178,24,2,64,51,589,117,2989
"06011000500",1317,304,1,34,746,125,1074,266,3867
"06013301000",2985,177,197,13,533,104,730,100,4839
"06013302005",3256,957,165,340,1754,255,2036,639,9402
"06013302006",3167,10,57,0,744,8,1434,10,5430
"06013302007",3860,230,397,172,1236,88,2175,251,8409
"06013302008",4880,349,1180,0,2165,196,3141,211,12122
"06013302009",1838,158,1358,171,2150,679,1248,570,8172
"06013302010",7692,540,361,30,1496,250,3115,130,13614
"06013303102",4949,623,491,36,1844,285,2379,520,11127
"06013303103",7566,482,454,30,1602,571,3717,386,14808
"06013303201",5014,299,1299,443,3303,215,2089,226,12888
"06013303202",5761,33,55,4,1232,204,1009,129,8427
"06013303203",5797,316,696,145,1799,0,1543,2,10298
"06013303204",4191,140,92,76,387,62,1772,62,6782
"06013303205",6268,277,67,0,1295,0,1486,58,9451
"06013304001",2502,296,107,0,1095,20,708,50,4778
"06013304002",1231,26,0,0,15,0,524,0,1796
"06013304003",3124,94,30,331,314,9,287,18,4207
"06013304004",3572,75,16,0,397,9,475,0,4544
"06013304005",5551,305,124,0,1057,15,851,132,8035
"06013305000",2745,953,509,502,1280,277,2057,709,9032
"06013306002",1857,86,169,0,632,151,731,132,3758
"06013306003",2180,846,581,128,1164,218,1449,420,6986
"06013306004",1559,381,525,28,359,141,775,469,4237
"06013307101",2665,281,328,109,743,190,1591,249,6156
"06013307102",2889,695,191,65,758,541,2073,983,8195
"06013307201",1599,286,322,219,745,159,1223,257,4810
"06013307202",583,569,990,218,1169,459,1010,632,5630
"06013307204",2062,443,320,165,940,173,1432,414,5949
"06013307205",2900,388,1051,238,1584,287,2104,80,8632
"06013308001",4041,415,526,234,1296,140,1729,199,8580
"06013308002",2279,64,497,113,1343,14,1097,23,5430
"06013309000",777,166,1084,324,607,113,640,164,3875
"06013310000",1780,354,882,318,2094,627,2682,714,9451
"06013311000",1289,223,804,219,2189,553,1956,570,7803
"06013312000",582,285,553,218,364,222,569,371,3164
"06013313101",2357,553,935,165,2411,1139,1300,1233,10093
"06013313102",1312,104,1259,132,800,97,858,65,4627
"06013313103",3204,51,1237,0,2723,818,2077,477,10587
"06013313203",1408,137,100,7,1370,152,1114,136,4424
"06013313204",1623,377,460,279,2474,197,2165,347,7922
"06013313205",629,248,89,0,1125,4,570,228,2893
"06013313206",1390,1157,1124,217,1772,422,2110,1354,9546
"06013314102",1727,450,468,168,2306,533,2301,755,8708
"06013314103",1317,614,818,455,1967,741,2149,1051,9112
"06013314104",2801,1022,511,628,1566,742,2591,1299,11160
"06013314200",2296,1249,160,23,2230,556,3292,1558,11364
"06013315000",1939,202,114,28,632,142,407,40,3504
"06013316000",524,138,44,11,57,14,154,0,942
"06013317000",1457,137,219,73,516,14,263,0,2679
"06013318000",2264,180,43,0,494,56,477,79,3593
"06013319000",5559,648,115,25,925,197,1224,372,9065
"06013320001",2262,612,132,22,917,111,1260,338,5654
"06013320003",2270,153,37,0,666,0,451,34,3611
"06013320004",5100,215,51,22,877,102,1154,18,7539
"06013321101",4792,202,224,26,1198,54,1034,0,7530
"06013321102",4861,171,0,27,1610,142,937,66,7814
"06013321103",3398,107,100,3,626,12,509,0,4755
"06013321200",2949,394,102,39,1250,695,566,147,6142
"06013322000",4560,351,195,42,871,443,860,54,7376
"06013323000",3829,174,0,0,683,88,663,41,5478
"06013324001",2943,312,124,25,1730,268,644,121,6167
"06013324002",3411,421,132,0,928,61,613,62,5628
"06013325000",4503,338,12,5,623,17,807,26,6331
"06013326000",2913,193,64,1,291,0,190,1,3653
"06013327000",5086,410,53,2,1485,425,2656,402,10519
"06013328000",1113,269,231,61,524,180,325,87,2790
"06013329000",4119,722,345,16,1454,128,1639,443,8866
"06013330000",3545,715,156,55,1164,154,1310,397,7496
"06013331000",4641,415,206,154,1812,339,1188,295,9050
"06013332000",5448,810,9,0,1565,247,1900,594,10573
"06013333101",2868,125,55,54,884,1,752,1,4740
"06013333102",2820,145,154,17,518,24,442,78,4198
"06013333200",4496,154,36,32,1196,11,1287,89,7301
"06013334001",2540,258,227,3,883,42,744,114,4811
"06013334004",4308,546,412,32,1770,164,1305,0,8537
"06013334006",2967,168,119,0,1309,126,419,47,5155
"06013334200",5835,208,123,12,1256,0,967,0,8401
"06013335000",2459,98,84,5,468,218,761,100,4193
"06013336101",2407,765,309,18,1120,429,2081,848,7977
"06013336102",3266,1189,214,344,2129,334,3485,1195,12156
"06013336201",2483,265,0,0,1090,279,1954,418,6489
"06013336202",2119,1342,330,16,1431,807,2022,1552,9619
"06013337100",2292,260,53,5,792,0,859,106,4367
"06013337200",5166,496,201,217,1268,143,1511,270,9272
"06013337300",4216,45,192,5,1169,0,668,26,6321
"06013338101",2139,737,160,119,1058,513,1236,770,6732
"06013338102",2551,172,61,0,933,0,701,22,4440
"06013338201",2545,172,8,0,643,67,331,18,3784
"06013338203",3196,245,110,0,1171,78,220,0,5020
"06013338204",4343,129,10,30,1525,30,319,0,6386
"06013338301",2266,102,0,5,548,23,325,0,3269
"06013338302",4575,178,112,31,1029,175,765,4,6869
"06013339001",2335,138,143,2,672,95,641,22,4048
"06013339002",3838,726,502,0,982,31,421,293,6793
"06013340001",3910,584,60,25,1076,37,764,179,6635
"06013340002",5819,183,0,0,1157,32,383,45,7619
"06013341000",3707,518,61,0,804,19,376,3,5488
"06013343001",3806,296,37,1,565,228,366,110,5409
"06013343002",3719,99,0,7,698,60,714,7,5304
"06013343003",3497,33,11,1,491,0,156,0,4189
"06013345101",3498,104,262,20,1615,40,706,21,6266
"06013345102",2465,286,0,1,1067,14,474,27,4334
"06013345103",3422,42,8,0,1259,100,328,29,5188
"06013345105",5263,240,50,0,800,350,532,71,7306
"06013345108",4091,54,211,0,2783,18,585,18,7760
"06013345111",2181,82,74,0,3109,9,527,0,5982
"06013345112",3322,16,83,0,3229,113,845,34,7642
"06013345113",3210,39,166,0,878,32,279,9,4613
"06013345114",5717,110,13,1,642,17,374,4,6878
"06013345115",3620,26,25,0,2081,71,366,27,6216
"06013345116",1759,48,0,0,1082,16,189,19,3113
"06013345202",5200,193,186,0,2679,0,594,0,8852
"06013345203",5404,26,38,0,887,0,237,0,6592
"06013345204",3708,42,0,0,61,0,125,0,3936
"06013346101",2925,40,0,0,514,24,169,0,3672
"06013346102",4733,43,29,4,645,6,239,8,5707
"06013346201",5835,567,32,0,715,64,170,0,7383
"06013346203",3184,188,0,1,349,0,140,0,3862
"06013346204",5807,238,0,18,1499,14,570,0,8146
"06013347000",4763,125,81,0,1206,26,489,0,6690
"06013348000",3854,107,11,1,659,14,273,7,4926
"06013349000",3466,443,196,26,713,132,452,248,5676
"06013350000",4669,235,316,44,969,45,499,21,6798
"06013351101",2106,49,8,0,297,9,46,0,2515
"06013351102",2700,209,0,0,609,35,120,62,3735
"06013351103",1695,116,0,0,150,1,323,12,2297
"06013351200",4916,58,0,0,808,0,407,0,6189
"06013352101",1662,47,41,0,358,44,49,4,2205
"06013352102",4303,37,0,0,860,15,267,14,5496
"06013352201",4211,304,0,0,1211,34,510,0,6270
"06013352202",1743,128,48,0,530,18,116,20,2603
"06013353001",2866,15,224,0,621,0,44,0,3770
"06013353002",3253,77,39,1,843,2,504,13,4732
"06013354001",1609,24,25,0,246,0,37,4,1945
"06013354002",4855,122,5,0,1314,0,313,1,6610
"06013355107",2913,128,468,10,1502,55,1480,40,6596
"06013355108",4226,135,3171,287,5433,499,3776,152,17679
"06013355109",3148,374,1569,170,1988,781,1609,535,10174
"06013355110",1251,27,869,109,1594,73,1142,0,5065
"06013355111",3449,49,1013,414,1616,296,1739,128,8704
"06013355112",4137,202,41,38,462,86,337,0,5303
"06013355113",3025,42,137,0,1433,27,229,0,4893
"06013355114",5358,104,235,59,5049,165,627,0,11597
"06013355115",1539,473,419,166,2483,247,397,343,6067
"06013355116",1308,0,68,0,5477,93,283,0,7229
"06013355117",1538,105,87,0,5324,77,137,0,7268
"06013355200",1848,99,975,31,4385,543,1573,74,9528
"06013355301",5063,411,398,1,1877,139,834,71,8794
"06013355302",2779,11,61,0,734,13,103,15,3716
"06013355304",6086,236,195,31,1269,120,720,82,8739
"06013355306",4358,57,17,2,509,20,444,8,5415
"06013356001",1500,178,474,134,1837,82,952,23,5180
"06013356002",2116,166,979,38,2215,63,833,26,6436
"06013357000",2549,247,22,0,514,42,628,63,4065
"06013358000",3013,231,587,120,1549,200,965,150,6815
"06013359102",2224,242,886,89,1904,381,1509,88,7323
"06013359103",2081,201,556,125,1766,142,656,142,5669
"06013359104",553,38,173,158,884,69,280,0,2155
"06013359105",1376,21,677,0,2389,79,601,0,5143
"06013359202",3398,224,358,0,1942,49,1225,157,7353
"06013359203",1892,335,1475,182,3175,129,928,276,8392
"06013359204",1059,84,592,36,2995,7,670,34,5477
"06013360101",2265,149,591,63,2124,82,1157,14,6445
"06013360102",2089,102,304,11,1757,94,794,2,5153
"06013360200",2281,375,608,34,1363,167,957,85,5870
"06013361000",1924,249,542,87,1608,272,920,112,5714
"06013362000",1655,159,279,73,694,100,557,75,3592
"06013363000",3015,194,1714,101,1951,137,1749,19,8880
"06013364002",2454,344,468,204,1540,245,1702,177,7134
"06013365002",1635,734,842,464,1812,464,2503,1094,9548
"06013365003",1663,195,1305,99,1651,70,929,59,5971
"06013366001",2180,423,306,54,1367,156,2228,213,6927
"06013366002",2693,562,684,276,1546,171,3034,549,9515
"06013367100",1081,333,1520,559,1190,220,990,207,6100
"06013367200",1913,482,727,23,1429,560,1771,654,7559
"06013368001",2867,751,260,175,944,161,3273,850,9281
"06013368002",1345,530,167,58,810,80,1535,358,4883
"06013369001",2355,642,1006,657,1424,718,2232,603,9637
"06013369002",1193,117,357,174,618,21,820,39,3339
"06013370000",1585,54,158,148,744,40,440,0,3169
"06013371000",2297,212,820,68,1756,519,1702,387,7761
"06013372000",3328,560,870,94,2472,53,3647,551,11575
"06013373000",1473,453,556,100,861,153,2168,576,6340
"06013374000",2092,272,499,158,1262,359,1982,587,7211
"06013375000",1557,342,340,277,1843,423,3148,694,8624
"06013376000",1684,872,972,593,1102,734,2296,1224,9477
"06013377000",2189,949,509,503,2348,286,3706,1080,11570
"06013378000",2237,209,201,10,396,30,404,89,3576
"06013379000",1273,518,1749,377,1704,499,2612,932,9664
"06013380000",2165,488,1315,342,1374,214,980,401,7279
"06013381000",1935,455,2159,344,1521,652,2597,971,10634
"06013382000",1643,273,2017,1006,1688,344,2103,305,9379
"06013383000",2251,243,443,182,1619,275,416,45,5474
"06013384000",2181,98,257,11,1135,132,343,32,4189
"06013385100",1631,23,216,0,726,72,253,2,2923
"06013385200",649,11,47,0,512,46,67,0,1332
"06013386000",1243,143,515,50,1131,352,594,27,4055
"06013387000",1540,53,232,0,816,111,144,20,2916
"06013388000",1619,62,70,8,961,176,372,18,3286
"06013389100",1160,130,52,0,666,71,320,66,2465
"06013389200",492,59,99,54,704,156,206,50,1820
"06013390100",1485,66,96,9,519,69,249,0,2493
"06013390200",1205,44,22,1,392,15,61,0,1740
"06013391000",2000,119,23,1,382,41,56,14,2636
"06013392000",1961,83,42,0,575,47,112,0,2820
"06013392200",3820,737,1576,209,3794,445,2842,680,14103
"06013392300",539,24,255,42,1971,69,293,32,3225
"06013990000",0,0,0,0,0,0,0,0,0
"06015000101",2204,960,150,11,337,218,105,183,4168
"06015000102",2263,650,0,14,482,252,200,100,3961
"06015000104",1244,571,0,6,243,365,238,230,2897
"06015000105",4382,666,116,0,1193,242,621,309,7529
"06015000201",2602,204,0,86,266,162,128,87,3535
"06015000202",2147,583,0,0,451,73,405,313,3972
"06015000203",461,264,0,5,362,136,63,32,1323
"06015990000",0,0,0,0,0,0,0,0,0
"06017030200",2856,491,24,53,939,206,1514,390,6473
"06017030301",1397,283,0,0,515,0,586,66,2847
"06017030302",1635,476,7,0,254,282,421,325,3400
"06017030401",3405,204,0,0,448,113,774,73,5017
"06017030402",2123,760,65,0,483,38,515,297,4281
"06017030502",2189,118,0,0,22,0,134,0,2463
"06017030504",1916,281,0,0,317,15,217,146,2892
"06017030505",1982,146,0,23,130,7,214,34,2536
"06017030601",4767,213,11,0,176,0,131,0,5298
"06017030602",5629,505,0,17,313,15,598,88,7165
"06017030603",2516,306,0,1,248,1,122,9,3203
"06017030701",5904,107,34,0,495,0,581,0,7121
"06017030704",4365,671,284,7,923,182,538,129,7099
"06017030706",4903,86,142,0,467,25,409,16,6048
"06017030709",4356,12,0,0,590,1,466,0,5425
"06017030710",4210,68,240,0,937,0,331,7,5793
"06017030801",3567,145,6,0,518,49,278,4,4567
"06017030803",6720,302,25,1,171,72,611,14,7916
"06017030804",5202,1027,38,17,267,232,278,573,7634
"06017030807",3544,269,11,28,333,35,403,54,4677
"06017030808",6256,33,0,0,1054,55,1012,0,8410
"06017030809",2132,292,11,0,124,0,265,34,2858
"06017030810",2302,473,0,0,225,72,490,170,3732
"06017030901",2648,215,0,0,79,6,80,5,3033
"06017030902",3953,382,18,0,384,21,410,0,5168
"06017031000",3553,1277,32,0,458,24,275,674,6293
"06017031100",4147,491,15,0,772,99,668,250,6442
"06017031200",3644,474,0,0,487,8,514,11,5138
"06017031301",3097,342,4,0,92,0,225,0,3760
"06017031302",4043,699,0,0,44,55,205,88,5134
"06017031402",4282,536,15,0,270,4,308,14,5429
"06017031404",1996,253,8,0,64,0,137,23,2481
"06017031405",1851,235,0,1,272,5,39,14,2417
"06017031406",4863,484,0,3,100,3,397,14,5864
"06017031502",4725,487,33,110,606,403,509,414,7287
"06017031503",2474,301,0,0,145,0,282,0,3202
"06017031504",4347,619,0,0,294,71,680,54,6065
"06017031600",1376,468,62,85,1715,358,1508,405,5977
"06017031700",2316,40,10,18,475,24,90,0,2973
"06017031800",4261,626,252,0,1907,370,431,94,7941
"06017031900",58,22,0,0,4,0,2,6,92
"06017032000",542,63,0,0,53,0,3,0,661
"06017990000",0,0,0,0,0,0,0,0,0
"06019000100",78,233,28,56,36,114,47,201,793
"06019000200",456,714,386,150,429,1000,700,1525,5360
"06019000300",338,411,595,485,908,869,783,1185,5574
"06019000400",1084,1154,125,362,1705,1441,2561,2222,10654
"06019000501",437,290,16,175,619,1117,846,1063,4563
"06019000502",452,857,9,90,1146,360,1353,1070,5337
"06019000600",1094,1523,171,292,534,1874,1012,2882,9382
"06019000700",701,481,786,435,834,429,1142,768,5576
"06019000800",155,186,58,42,234,410,231,434,1750
"06019000901",459,436,260,217,949,610,774,748,4453
"06019000902",632,558,542,451,749,1853,1103,1445,7333
"06019001000",627,377,578,453,831,908,983,1080,5837
"06019001100",806,707,302,159,406,661,1142,1256,5439
"06019001201",958,1116,87,430,1451,1464,2022,2027,9555
"06019001202",822,239,114,280,2054,1069,2176,973,7727
"06019001301",1224,1280,12,171,1093,1570,2121,2481,9952
"06019001303",332,412,144,55,782,516,922,642,3805
"06019001304",478,797,276,222,2000,1878,1478,1893,9022
"06019001407",578,513,585,654,738,1002,944,1049,6063
"06019001408",835,137,154,67,610,388,750,308,3249
"06019001409",939,98,125,21,525,223,318,130,2379
"06019001410",1983,632,227,189,5829,2145,4489,2135,17629
"06019001411",1578,316,148,206,1822,1412,1359,1139,7980
"06019001412",1383,43,120,0,1135,149,821,117,3768
"06019001413",2099,200,62,0,2345,426,1269,506,6907
"06019001414",3001,112,233,36,3271,949,2251,382,10235
"06019001500",908,269,0,4,187,657,757,742,3524
"06019001600",2528,611,9,0,1427,614,2553,994,8736
"06019001700",2362,500,55,0,1968,915,2592,1059,9451
"06019001800",2441,494,67,22,1074,384,2229,588,7299
"06019001900",1480,404,56,63,567,173,1225,372,4340
"06019002000",1285,1521,293,374,1499,1070,1781,1840,9663
"06019002100",2693,1329,153,1,843,331,2048,1167,8565
"06019002200",1818,473,45,45,387,569,759,642,4738
"06019002300",1425,526,65,432,502,347,1134,659,5090
"06019002400",1282,828,33,160,1088,1048,1684,1217,7340
"06019002501",1044,769,53,0,1193,1963,1655,1780,8457
"06019002502",592,656,0,169,1647,2443,1182,2361,9050
"06019002601",1105,1025,0,250,1280,1796,2209,2761,10426
"06019002602",1035,395,62,7,1410,595,1756,923,6183
"06019002701",1058,587,85,47,1718,1026,2210,1350,8081
"06019002702",1049,1189,85,49,1653,1569,2391,1947,9932
"06019002800",531,874,89,336,1485,1760,1540,1910,8525
"06019002903",686,622,125,142,1250,1769,1142,1698,7434
"06019002904",741,295,142,200,1115,914,1149,916,5472
"06019002905",852,287,165,163,992,508,922,580,4469
"06019002906",1502,511,124,283,1687,1629,1904,961,8601
"06019003001",681,266,107,170,1203,723,991,658,4799
"06019003003",819,555,116,158,1373,1109,1175,983,6288
"06019003004",890,226,155,19,959,478,1060,434,4221
"06019003102",3714,940,230,155,1774,757,2397,468,10435
"06019003103",2639,1184,101,98,956,503,1666,726,7873
"06019003104",1915,266,227,48,878,509,865,430,5138
"06019003201",1471,661,305,112,1454,991,1512,1137,7643
"06019003202",1527,445,515,166,1746,1454,1695,1252,8800
"06019003301",1014,106,53,115,904,1123,1031,711,5057
"06019003302",1411,1159,109,44,1328,882,1812,1564,8309
"06019003400",1174,955,129,184,1286,1216,1207,1621,7772
"06019003500",1698,1619,225,99,1218,554,1846,1700,8959
"06019003600",2200,734,59,22,638,102,961,520,5236
"06019003701",1259,314,65,154,912,738,1262,640,5344
"06019003702",1198,451,735,181,1395,804,1347,714,6825
"06019003803",4622,292,394,65,3033,431,3773,283,12893
"06019003804",2334,621,628,111,1890,185,2144,472,8385
"06019003805",2583,1209,263,85,1313,1507,2573,1813,11346
"06019003807",1647,166,118,14,938,212,1534,71,4700
"06019003808",2083,608,280,37,2017,404,2335,686,8450
"06019003809",2055,547,332,27,1014,519,2140,498,7132
"06019003810",2639,667,357,21,1381,813,2302,570,8750
"06019003900",2817,1516,0,23,297,325,1673,1562,8213
"06019004001",4062,1095,0,0,1735,584,3884,1617,12977
"06019004002",3539,1636,0,1,1652,497,3364,1933,12622
"06019004100",1548,436,24,0,330,220,992,261,3811
"06019004205",2423,1163,596,143,968,1182,1655,1576,9706
"06019004207",3476,884,290,520,2665,266,2621,1032,11754
"06019004208",4422,625,208,36,2333,0,1118,0,8742
"06019004210",1905,263,189,94,676,404,851,271,4653
"06019004211",3682,378,382,167,1083,109,1992,186,7979
"06019004212",5195,993,643,821,2751,973,3538,1119,16033
"06019004213",2431,246,101,20,760,47,1567,77,5249
"06019004214",3525,285,34,39,1192,68,1407,54,6604
"06019004215",2387,44,505,0,1788,106,1558,47,6435
"06019004216",1418,110,220,140,329,315,671,189,3392
"06019004301",3222,147,162,27,534,41,754,25,4912
"06019004302",4030,72,17,0,802,348,564,339,6172
"06019004303",3015,126,62,34,544,8,719,65,4573
"06019004404",1153,906,10,23,1051,698,1483,1002,6326
"06019004405",2869,264,64,1,796,72,982,0,5048
"06019004406",3433,539,121,0,714,66,1288,159,6320
"06019004408",2323,243,86,0,719,94,666,70,4201
"06019004409",2490,350,40,0,851,31,1223,183,5168
"06019004503",3343,133,32,0,795,87,797,89,5276
"06019004504",3277,461,86,48,915,232,1838,164,7021
"06019004505",1810,858,104,277,717,979,973,1045,6763
"06019004506",2313,193,0,0,529,40,486,72,3633
"06019004601",1976,469,96,138,183,144,633,466,4105
"06019004602",1557,571,43,0,167,78,289,241,2946
"06019004701",2766,634,660,370,1664,845,2801,612,10352
"06019004703",1340,617,322,171,1149,727,1774,938,7038
"06019004704",1638,1070,279,404,705,764,1261,1569,7690
"06019004801",1521,1351,363,204,783,609,1603,1774,8208
"06019004802",2229,953,52,259,1088,704,1777,1140,8202
"06019004901",1308,748,75,65,882,607,926,1004,5615
"06019004902",839,237,0,0,405,426,472,283,2662
"06019005000",1884,945,89,280,558,295,1176,744,5971
"06019005100",1739,846,510,340,1708,671,1850,1035,8699
"06019005202",1106,517,122,29,1463,689,1522,719,6167
"06019005203",1708,450,169,96,1469,595,2105,696,7288
"06019005204",2072,936,201,83,476,605,976,731,6080
"06019005301",2150,693,391,140,1536,793,2182,906,8791
"06019005302",2154,731,126,265,1581,859,1522,855,8093
"06019005304",1835,423,208,422,2068,875,1632,985,8448
"06019005305",1610,601,0,25,1058,173,1344,398,5209
"06019005403",941,993,674,494,525,657,746,1086,6116
"06019005405",2724,347,266,53,610,49,1082,178,5309
"06019005406",2493,279,289,19,701,162,1054,212,5209
"06019005407",2314,83,83,0,558,188,769,58,4053
"06019005408",410,615,14,236,18,160,155,218,1826
"06019005409",1591,862,156,99,637,738,607,632,5322
"06019005410",1649,502,56,60,987,116,1262,115,4747
"06019005503",3681,246,25,0,835,37,702,34,5560
"06019005504",1823,98,41,0,547,14,346,15,2884
"06019005505",3976,21,185,0,1803,491,1213,295,7984
"06019005507",3192,245,230,0,1725,103,1350,26,6871
"06019005508",3643,170,196,0,1639,81,914,14,6657
"06019005509",3139,423,143,0,1058,260,1206,246,6475
"06019005510",3134,573,59,0,649,301,495,236,5447
"06019005512",3569,100,70,8,1053,17,1063,33,5913
"06019005513",1961,137,34,0,677,30,553,96,3488
"06019005514",2720,277,0,0,773,11,587,49,4417
"06019005515",1203,70,0,0,288,0,90,0,1651
"06019005516",3453,355,66,0,1261,143,1335,53,6666
"06019005517",6212,365,116,0,1217,0,1433,0,9343
"06019005518",2484,81,222,0,467,21,589,30,3894
"06019005520",1941,74,20,0,706,0,488,10,3239
"06019005522",2948,213,257,0,908,101,529,101,5057
"06019005524",3319,211,139,0,851,29,924,19,5492
"06019005525",940,123,0,3,116,25,44,76,1327
"06019005602",2950,657,0,0,1102,217,1166,232,6324
"06019005605",847,1,138,2,367,35,296,8,1694
"06019005606",2192,212,192,5,1076,449,1124,0,5250
"06019005607",1898,760,117,46,449,590,686,506,5052
"06019005608",2068,313,40,0,461,100,693,163,3838
"06019005701",2047,585,31,0,528,308,982,290,4771
"06019005702",3989,173,46,0,590,106,852,83,5839
"06019005703",3580,301,200,0,769,284,878,311,6323
"06019005704",2905,446,52,0,1389,1017,1484,1082,8375
"06019005801",3324,568,141,13,740,286,1441,203,6716
"06019005802",2600,207,168,12,936,23,752,56,4754
"06019005804",2977,1279,200,6,1322,815,1786,540,8925
"06019005805",2266,162,122,20,1357,220,902,78,5127
"06019005904",2488,209,33,0,1587,2,1080,124,5523
"06019005905",5305,304,13,0,999,284,791,192,7888
"06019005906",1613,152,20,12,491,0,600,93,2981
"06019005907",2178,111,66,30,893,25,788,27,4118
"06019005909",3347,294,267,0,2095,45,1279,53,7380
"06019005911",2275,154,21,0,1338,0,548,0,4336
"06019005912",2687,85,0,0,276,92,591,13,3744
"06019006000",5043,1133,59,30,2351,440,5225,1293,15574
"06019006100",3810,754,160,0,2307,1012,4793,1739,14575
"06019006201",1193,371,0,0,555,359,1584,718,4780
"06019006202",2879,1657,19,0,1598,785,3881,2371,13190
"06019006300",4726,778,51,0,1911,140,3148,636,11390
"06019006402",2425,97,0,8,616,160,137,58,3501
"06019006403",4067,358,0,14,913,230,847,225,6654
"06019006404",3964,270,158,0,313,411,209,20,5345
"06019006405",3497,506,0,0,290,0,729,235,5257
"06019006501",1910,1977,34,41,1716,1048,3257,3036,13019
"06019006502",1252,1505,32,16,956,746,1884,2175,8566
"06019006602",1670,1040,28,18,1299,1459,2576,2458,10548
"06019006603",1321,123,4,21,442,30,1148,77,3166
"06019006604",3313,1252,8,3,2629,1467,5308,2586,16566
"06019006700",3992,288,15,0,1492,535,2953,685,9960
"06019006802",1398,750,0,5,841,913,1650,1552,7109
"06019006900",1118,262,13,0,1062,562,1710,796,5523
"06019007002",2169,727,0,4,970,464,2427,1071,7832
"06019007003",4199,1355,42,30,2300,695,4526,1839,14986
"06019007004",2533,350,40,0,1996,488,2732,718,8857
"06019007100",2634,1774,87,29,1919,1345,3824,2993,14605
"06019007201",5241,449,0,2,1431,786,2285,505,10699
"06019007202",2975,857,0,0,1146,138,2322,645,8083
"06019007300",2206,561,98,4,1224,639,1797,969,7498
"06019007400",1331,554,11,0,1028,225,1521,551,5221
"06019007500",1754,765,65,0,1861,867,2414,1374,9100
"06019007600",1696,921,47,9,1135,1059,1679,1733,8279
"06019007700",2292,228,106,128,2283,1494,3250,1627,11408
"06019007801",1581,291,0,16,842,294,2352,569,5945
"06019007802",1296,931,0,82,1303,1287,2534,2135,9568
"06019007901",0,0,0,0,0,0,0,0,0
"06019007902",1223,682,61,80,1246,540,1733,711,6276
"06019008000",3656,621,86,0,685,711,1864,1008,8631
"06019008100",3284,925,35,171,1792,545,2721,1146,10619
"06019008200",3215,2950,0,0,512,153,3299,2857,12986
"06019008301",3004,1854,60,10,566,278,3472,2142,11386
"06019008302",2361,3196,8,90,473,210,2747,3440,12525
"06019008401",4239,2330,51,5,909,748,4669,2891,15842
"06019008402",800,353,6,0,117,68,544,394,2282
"06019008501",1697,1477,0,0,772,649,2292,2055,8942
"06019008502",2998,1498,73,0,2002,1114,4833,2595,15113
"06021010100",5049,1645,37,9,1120,300,3002,967,12129
"06021010200",3504,997,0,3,208,72,1173,592,6549
"06021010300",1454,180,0,3,147,91,160,5,2040
"06021010400",5158,1011,73,20,876,285,1803,481,9707
"06021010501",2649,447,17,27,318,279,1792,553,6082
"06021010502",1402,119,0,0,91,29,231,8,1880
"06023000100",2199,1070,61,61,346,244,307,275,4563
"06023000200",3990,607,7,158,959,415,425,84,6645
"06023000300",3394,1173,81,0,935,528,455,189,6755
"06023000400",2575,725,0,11,450,188,491,278,4718
"06023000500",2145,807,82,25,481,206,380,62,4188
"06023000600",3305,550,51,35,448,399,222,13,5023
"06023000700",4499,417,53,20,372,148,310,40,5859
"06023000800",3993,337,0,2,707,123,448,19,5629
"06023000900",3947,668,55,9,248,161,434,225,5747
"06023001000",2281,1799,69,55,531,314,350,198,5597
"06023001101",3620,1472,0,82,663,488,743,199,7267
"06023001200",2824,1021,44,36,235,237,153,234,4784
"06023001300",924,349,3,4,120,11,54,90,1555
"06023010102",1136,444,42,0,419,364,216,12,2633
"06023010200",1676,324,14,1,284,103,69,11,2482
"06023010300",2652,531,21,12,360,14,69,83,3742
"06023010400",2612,277,10,12,386,133,394,12,3836
"06023010501",5675,844,132,12,895,193,649,49,8449
"06023010502",4287,668,0,0,495,136,290,7,5883
"06023010600",1629,103,3,0,186,0,146,3,2070
"06023010700",4867,832,24,28,799,315,434,52,7351
"06023010800",2657,537,14,29,402,110,295,175,4219
"06023010901",2503,822,0,0,684,516,709,630,5864
"06023010902",3159,416,40,0,400,22,323,22,4382
"06023011000",3606,409,24,0,488,91,377,77,5072
"06023011100",3857,518,34,0,303,87,509,27,5335
"06023011200",2851,316,13,4,132,9,282,118,3725
"06023011500",2716,764,0,0,294,90,163,81,4108
"06023011600",2342,1048,18,18,190,75,172,0,3863
"06023940000",277,89,0,1,1688,1053,109,44,3261
"06023990100",0,0,0,0,0,0,0,0,0
"06025010101",169,12,0,0,9,0,74,0,264
"06025010102",4177,1631,116,5,989,626,4584,2103,14231
"06025010200",1156,652,14,33,235,73,1184,694,4041
"06025010300",795,47,0,0,70,98,499,123,1632
"06025010400",3656,2279,220,179,849,251,4326,2287,14047
"06025010500",4737,836,18,15,732,269,4174,1046,11827
"06025010600",5487,494,0,0,490,52,3751,325,10599
"06025010700",2324,1142,27,0,694,432,2885,1530,9034
"06025010800",1035,20,34,0,412,38,593,58,2190
"06025010900",3760,1041,8,11,834,1110,3019,2102,11885
"06025011000",8272,952,320,0,1929,560,7542,1300,20875
"06025011100",2040,475,109,9,478,37,1799,411,5358
"06025011201",4554,656,116,0,910,145,4192,750,11323
"06025011202",2626,824,4,130,1109,723,3166,1503,10085
"06025011300",5140,901,0,0,2573,679,7092,1546,17931
"06025011400",1499,855,192,35,1369,805,2715,1654,9124
"06025011500",2330,1408,197,31,1204,810,3285,2097,11362
"06025011600",2733,1319,0,3,1429,763,3445,1897,11589
"06025011700",3112,408,28,0,952,501,3396,890,9287
"06025011801",2449,56,101,0,851,13,2015,59,5544
"06025011802",2776,731,53,69,1418,220,3318,877,9462
"06025011803",3718,174,216,0,2146,186,4356,286,11082
"06025011900",6844,697,50,0,2731,1103,9287,1724,22436
"06025012001",1801,1070,0,21,1250,442,3044,1491,9119
"06025012002",5062,1015,26,0,2402,647,7177,1498,17827
"06025012100",1888,2700,0,0,1403,836,3182,3529,13538
"06025012200",4005,1234,0,0,1913,509,5702,1686,15049
"06025012301",554,187,25,0,195,146,228,172,1507
"06025012302",2280,1339,29,0,970,429,2075,1120,8242
"06025012400",394,86,0,18,7,0,17,0,522
"06025940000",651,206,3,3,989,423,472,229,2976
"06027000100",2240,228,0,0,63,0,474,69,3074
"06027000200",1361,69,0,2,146,46,196,2,1822
"06027000300",2432,91,82,0,129,20,398,24,3176
"06027000400",3356,834,10,0,1141,315,1113,235,7004
"06027000500",1630,149,9,0,448,161,206,45,2648
"06027000800",2141,405,29,2,244,123,613,163,3720
"06029000101",9463,1456,229,100,1067,174,2237,328,15054
"06029000102",2123,520,0,1,271,229,174,0,3318
"06029000200",3520,3448,62,76,392,341,577,756,9172
"06029000300",1926,1711,0,57,342,345,515,521,5417
"06029000400",1996,1836,0,44,313,306,546,508,5549
"06029000503",5353,371,141,0,1233,42,1142,40,8322
"06029000504",3115,953,20,113,252,49,895,536,5933
"06029000505",3040,137,31,53,300,75,457,26,4119
"06029000506",1767,176,144,71,555,59,472,129,3373
"06029000507",3052,129,9,0,478,28,1138,57,4891
"06029000600",2429,1128,388,893,619,721,1596,1402,9176
"06029000700",3158,813,6,8,844,82,1787,565,7263
"06029000800",2736,1091,15,56,675,134,1956,666,7329
"06029000902",2425,560,181,0,823,106,1673,349,6117
"06029000903",2203,339,2,35,1073,498,1553,787,6490
"06029000904",2261,443,46,31,1088,426,1900,357,6552
"06029000905",1315,657,0,51,466,64,1151,558,4262
"06029000906",2668,132,17,0,907,139,2349,217,6429
"06029000907",1610,202,29,12,594,332,1534,479,4792
"06029000908",3111,391,167,221,1450,181,2400,336,8257
"06029000909",1779,40,14,0,458,0,781,0,3072
"06029000910",6060,1415,283,229,2027,417,3579,1288,15298
"06029001000",6180,1905,0,2,1918,242,5410,1377,17034
"06029001101",2616,1229,1,175,497,250,2294,1296,8358
"06029001102",2436,2156,190,157,1127,388,3013,2176,11643
"06029001103",1582,2000,105,4,1104,784,2493,2416,10488
"06029001201",1043,1067,0,41,434,316,1225,1156,5282
"06029001202",1513,2326,42,246,881,830,2032,2764,10634
"06029001300",2156,1593,341,292,1479,1329,3233,2713,13136
"06029001400",2417,3275,114,153,1015,1571,2984,4202,15731
"06029001500",796,799,156,167,412,334,1045,1006,4715
"06029001600",511,192,196,87,270,263,421,306,2246
"06029001700",2391,607,93,13,861,110,1004,145,5224
"06029001801",3273,1176,462,26,1102,94,1849,702,8684
"06029001802",3669,543,240,7,594,51,1654,187,6945
"06029001901",2247,522,74,0,785,158,1366,332,5484
"06029001902",2100,735,330,318,815,620,1549,778,7245
"06029002000",1548,1796,1350,472,759,1282,1887,2220,11314
"06029002100",931,800,282,215,482,616,1393,1402,6121
"06029002200",811,2382,538,644,741,643,1393,3012,10164
"06029002301",4443,2135,716,366,2069,522,5796,2320,18367
"06029002302",1364,846,0,16,671,547,1999,1397,6840
"06029002400",3264,1366,589,9,2356,870,4108,2024,14586
"06029002500",2841,2882,646,301,1234,673,3401,3178,15156
"06029002600",1372,567,289,298,664,268,1743,659,5860
"06029002700",2558,1460,102,125,1492,415,2540,1551,10243
"06029002804",2064,188,57,10,141,128,595,18,3201
"06029002806",1311,71,78,0,315,44,433,0,2252
"06029002807",2965,53,74,19,403,37,875,21,4447
"06029002808",4832,499,448,136,1550,78,1731,380,9654
"06029002811",2640,23,89,0,717,25,382,0,3876
"06029002812",2508,1375,232,623,368,446,1384,1311,8247
"06029002813",2194,527,326,181,683,375,1541,390,6217
"06029002814",2273,768,285,42,803,112,1551,711,6545
"06029002815",2815,519,445,307,397,391,1589,558,7021
"06029002816",3739,681,526,331,608,169,2738,440,9232
"06029002817",2032,967,551,55,860,378,1265,861,6969
"06029002818",2443,452,288,63,510,40,790,356,4942
"06029002819",2711,649,250,80,829,67,1445,257,6288
"06029002820",4277,243,292,19,1668,56,2051,69,8675
"06029002821",3613,285,118,87,642,3,1390,107,6245
"06029002900",3387,1134,509,171,817,721,2729,1065,10533
"06029003000",3160,2440,226,397,1310,485,3394,2722,14134
"06029003103",1811,740,56,2,838,351,1998,896,6692
"06029003112",2878,567,604,162,1168,263,2281,405,8328
"06029003113",2219,770,523,77,1086,514,2237,743,8169
"06029003114",2947,897,869,382,1966,346,2653,963,11023
"06029003115",2345,1224,310,245,1335,473,2549,1311,9792
"06029003121",3908,2412,402,360,630,407,3111,2384,13614
"06029003122",4426,1210,339,450,1578,586,4941,1617,15147
"06029003123",9293,741,1390,37,5531,179,6962,515,24648
"06029003124",3473,436,281,49,948,106,1815,222,7330
"06029003202",8004,1753,331,382,5316,1241,10156,2666,29849
"06029003203",1750,56,50,1,333,43,612,1,2846
"06029003204",5694,169,364,0,2436,218,1857,237,10975
"06029003205",5186,829,645,103,2759,617,5104,1209,16452
"06029003206",6707,1437,525,258,3893,988,5525,1408,20741
"06029003303",903,401,2,0,130,50,103,159,1748
"06029003304",1660,247,0,0,110,19,473,62,2571
"06029003305",2692,419,0,0,192,21,413,0,3737
"06029003306",4039,631,16,0,405,37,737,230,6095
"06029003400",2112,1620,0,0,373,48,808,1113,6074
"06029003500",4366,1084,0,0,553,245,1396,225,7869
"06029003600",3366,972,75,11,379,22,916,329,6070
"06029003700",2434,660,32,56,461,156,1606,753,6158
"06029003803",4038,277,18,5,652,85,1244,9,6328
"06029003804",11099,607,353,12,2082,203,2969,201,17526
"06029003805",7966,83,120,0,1311,27,2968,30,12505
"06029003806",2934,70,236,79,1126,102,924,51,5522
"06029003807",2106,202,42,25,431,19,357,19,3201
"06029003808",2931,369,111,0,743,38,1198,257,5647
"06029003809",8529,721,520,3,1383,40,2612,172,13980
"06029003810",1972,126,94,8,339,10,373,15,2937
"06029003811",2335,145,0,0,160,61,430,60,3191
"06029003812",3200,237,428,9,1074,57,1145,52,6202
"06029003813",6030,244,112,0,1359,29,1617,193,9584
"06029003900",508,273,6,6,25,5,261,203,1287
"06029004000",5291,1138,0,21,892,183,5237,1144,13906
"06029004101",3604,696,40,23,413,217,2562,777,8332
"06029004102",3185,1389,0,0,638,318,3336,1524,10390
"06029004200",748,310,12,22,68,119,433,431,2143
"06029004301",4405,1724,334,1,928,371,4601,1935,14299
"06029004302",0,0,0,0,0,0,0,0,0
"06029004401",4516,1576,9,123,952,234,4418,1666,13494
"06029004402",2392,2036,82,137,159,338,2246,2352,9742
"06029004500",2518,1071,18,0,199,32,2492,1075,7405
"06029004601",0,0,0,0,0,0,0,0,0
"06029004603",0,0,0,0,0,0,0,0,0
"06029004604",6621,2201,6,0,2800,520,7801,2317,22266
"06029004701",4424,2800,0,9,954,232,5122,2901,16442
"06029004702",2318,1018,0,0,573,168,2868,1005,7950
"06029004800",3707,4307,28,131,1705,538,4587,4380,19383
"06029004901",2490,932,1,5,1000,592,2635,1122,8777
"06029004902",4135,1184,15,0,2676,869,4789,1478,15146
"06029005003",1446,933,95,132,521,122,1562,989,5800
"06029005004",3511,1367,41,0,1658,331,3777,1551,12236
"06029005103",1876,212,0,0,175,29,280,0,2572
"06029005104",2977,194,53,0,364,0,478,0,4066
"06029005201",4317,952,7,0,85,0,208,32,5601
"06029005203",3146,873,0,0,249,212,103,0,4583
"06029005204",3434,1775,14,0,276,95,358,389,6341
"06029005300",1082,539,83,0,157,6,338,147,2352
"06029005401",4236,635,86,26,936,78,859,197,7053
"06029005402",4090,224,113,8,490,58,547,105,5635
"06029005403",5288,611,364,114,1292,667,769,230,9335
"06029005404",4515,680,356,380,1338,27,883,318,8497
"06029005501",4201,887,62,0,504,113,260,151,6178
"06029005506",3484,669,58,11,875,43,1319,362,6821
"06029005507",4001,782,814,848,692,205,1085,607,9034
"06029005508",2774,682,181,126,702,228,935,547,6175
"06029005600",1222,368,34,351,145,116,210,154,2600
"06029005700",1601,136,178,77,307,0,248,20,2567
"06029005801",4330,397,485,47,1146,170,1954,249,8778
"06029005802",2931,1272,564,463,2103,522,1887,1352,11094
"06029005900",1494,604,228,395,754,192,1581,539,5787
"06029006002",279,94,0,0,0,0,75,57,505
"06029006003",4266,842,0,26,516,79,1829,368,7926
"06029006004",1049,508,6,0,174,16,104,219,2076
"06029006006",2826,124,90,0,259,24,344,125,3792
"06029006007",5085,317,0,7,159,55,1191,172,6986
"06029006008",4869,304,61,0,451,0,516,0,6201
"06029006100",6292,1333,90,2,496,151,1813,911,11088
"06029006201",1897,589,15,0,489,249,1778,663,5680
"06029006202",4141,1295,123,7,988,312,4976,1414,13256
"06029006301",2452,939,33,50,547,145,2796,788,7750
"06029006303",3651,2088,111,9,749,160,4228,1860,12856
"06029006304",2545,992,98,0,290,109,2625,1062,7721
"06029006401",4317,2477,49,11,1033,784,5148,3199,17018
"06029006403",3430,1677,0,0,1222,175,4393,1713,12610
"06029006404",1601,1143,7,0,307,252,1719,1391,6420
"06029006500",1215,576,52,77,273,82,264,213,2752
"06031000100",2285,523,15,0,266,84,717,479,4369
"06031000200",1551,135,26,9,300,68,570,128,2787
"06031000300",2886,301,315,287,1274,88,967,142,6260
"06031000402",3466,538,539,74,589,260,1506,509,7481
"06031000403",2981,630,215,30,1051,484,1399,603,7393
"06031000404",6055,641,479,10,2465,221,3240,509,13620
"06031000405",2489,408,307,26,2034,565,2527,823,9179
"06031000500",2752,633,110,103,1025,448,2185,787,8043
"06031000601",5871,1265,209,102,2300,673,2931,842,14193
"06031000602",4304,270,43,0,355,90,755,262,6079
"06031000701",4240,560,203,0,863,10,1346,96,7318
"06031000702",3284,730,83,14,378,0,1596,344,6429
"06031000800",3332,994,115,17,259,194,1904,922,7737
"06031000900",3747,2560,489,109,691,498,2219,2195,12508
"06031001001",2922,186,72,1,750,47,1588,95,5661
"06031001002",2507,1296,96,158,529,188,2300,1047,8121
"06031001003",3799,1144,64,0,684,125,2899,1058,9773
"06031001100",2449,1259,491,458,1114,389,2769,1561,10490
"06031001200",2145,163,22,8,339,30,1106,98,3911
"06031001300",2301,1383,286,160,217,238,2155,1306,8046
"06031001401",2003,727,12,2,319,96,2151,759,6069
"06031001402",855,821,27,7,392,71,1021,605,3799
"06031001500",2817,857,9,46,395,95,2271,723,7213
"06031001601",1958,982,29,6,1074,625,2197,1265,8136
"06031001602",0,0,0,0,0,0,0,0,0
"06031001701",2880,3078,46,10,2956,936,5341,3787,19034
"06031981800",0,0,0,0,0,0,0,0,0
"06033000100",1912,484,12,0,422,155,331,141,3457
"06033000300",2214,424,0,0,347,86,324,125,3520
"06033000400",3521,693,48,22,533,282,470,335,5904
"06033000501",1804,801,0,0,301,555,411,96,3968
"06033000502",1362,456,30,8,104,68,116,65,2209
"06033000600",2064,1050,56,43,121,136,64,84,3618
"06033000701",3076,642,278,284,184,112,214,179,4969
"06033000702",2041,947,17,80,535,381,712,219,4932
"06033000801",951,612,194,43,278,488,272,460,3298
"06033000802",1555,1027,113,31,629,606,558,716,5235
"06033000900",4879,1247,18,15,592,19,808,51,7629
"06033001000",3583,505,54,33,1191,1034,1316,933,8649
"06033001100",2847,459,7,6,272,88,194,118,3991
"06033001200",2625,351,0,0,481,96,451,95,4099
"06033001300",5793,1007,0,0,860,19,1255,209,9143
"06035040100",944,98,0,0,69,17,63,17,1208
"06035040200",1773,428,0,2,104,24,40,24,2395
"06035040302",3138,524,71,26,243,43,208,55,4308
"06035040303",1976,901,19,97,94,77,34,73,3271
"06035040304",819,434,31,13,213,10,148,30,1698
"06035040305",2971,440,76,0,397,131,280,25,4320
"06035040400",923,72,9,0,83,15,126,12,1240
"06035040500",2863,275,0,0,93,8,69,18,3326
"06035040600",1303,184,177,37,321,0,79,5,2106
"06037101110",2889,442,59,11,1100,317,1252,261,6331
"06037101122",2432,59,27,0,885,81,446,81,4011
"06037101210",3028,988,176,196,1289,533,1907,1020,9137
"06037101220",1539,281,88,10,728,173,572,104,3495
"06037101300",3428,242,17,0,485,48,580,8,4808
"06037101400",2730,516,104,38,774,131,705,125,5123
"06037102103",1625,124,0,0,193,5,348,85,2380
"06037102104",2466,103,14,0,523,0,392,28,3526
"06037102105",1095,154,8,29,483,111,1045,239,3164
"06037102107",2431,411,9,61,557,183,785,322,4759
"06037103101",2291,219,5,1,394,54,814,146,3924
"06037103102",3236,401,29,0,1028,24,1143,120,5981
"06037103200",4044,683,238,5,709,405,1743,629,8456
"06037103300",2416,499,9,10,337,39,264,313,3887
"06037103400",4564,866,137,33,1149,101,992,396,8238
"06037104103",2087,94,420,103,959,58,2549,125,6395
"06037104105",2324,1089,346,85,1353,640,3083,1688,10608
"06037104108",2575,525,321,190,1009,448,3274,890,9232
"06037104124",2222,334,393,43,902,82,1946,285,6207
"06037104201",2611,301,517,72,555,398,3172,699,8325
"06037104203",1718,1119,256,9,1394,286,2870,1340,8992
"06037104204",1538,628,128,103,591,107,1751,645,5491
"06037104310",2264,714,228,18,1502,194,3708,891,9519
"06037104320",1958,588,291,24,2696,304,4520,744,11125
"06037104401",1858,696,7,0,892,28,2726,718,6925
"06037104403",1168,527,15,0,837,283,1933,745,5508
"06037104404",1589,508,26,0,542,180,1992,674,5511
"06037104500",1706,568,0,0,526,69,2145,607,5621
"06037104610",1545,763,0,0,903,325,2417,1052,7005
"06037104620",1708,414,0,0,988,311,2623,717,6761
"06037104701",1286,1052,252,112,717,417,1998,1472,7306
"06037104703",876,675,29,28,392,138,1216,813,4167
"06037104704",1971,613,308,106,1274,85,2580,691,7628
"06037104810",2443,873,29,7,1973,382,4252,1199,11158
"06037104821",1946,432,83,25,644,153,2429,597,6309
"06037104822",1030,495,0,5,487,203,1356,625,4201
"06037106010",1669,416,35,8,748,41,1574,367,4858
"06037106020",3291,460,66,278,2244,134,4592,503,11568
"06037106111",2843,311,88,2,1155,183,2309,337,7228
"06037106112",3435,736,33,0,1449,224,3600,831,10308
"06037106113",2040,88,88,69,856,260,2236,297,5934
"06037106114",2711,1241,97,164,1246,181,3468,1111,10219
"06037106403",2409,131,0,2,655,50,2690,170,6107
"06037106405",1757,576,110,68,687,179,1912,675,5964
"06037106406",2588,295,197,101,2062,46,3136,270,8695
"06037106407",1370,410,147,43,417,81,1397,372,4237
"06037106408",2026,552,96,6,702,366,2522,808,7078
"06037106510",2626,464,203,44,1512,23,3045,423,8340
"06037106520",3735,997,20,6,622,266,3545,1236,10427
"06037106603",2151,46,108,7,955,25,497,11,3800
"06037106604",2697,972,54,0,869,155,3118,1025,8890
"06037106641",1524,30,17,1,587,17,269,3,2448
"06037106642",2329,125,45,0,811,5,785,73,4173
"06037106643",2718,71,447,0,1199,17,361,8,4821
"06037106645",2391,184,131,0,723,68,325,66,3888
"06037106646",2247,190,63,6,873,29,1050,27,4485
"06037106648",2288,936,22,16,632,444,2733,1346,8417
"06037106649",1484,152,20,0,840,109,1407,173,4185
"06037107010",1935,309,0,0,616,291,2269,558,5978
"06037107020",3185,568,34,0,1074,277,3590,835,9563
"06037108101",1629,37,124,2,521,17,343,18,2691
"06037108102",2130,47,76,1,1265,203,506,15,4243
"06037108103",2214,22,76,0,948,29,274,0,3563
"06037108104",1165,156,9,0,516,15,176,6,2043
"06037108201",2336,48,399,42,2701,169,457,62,6214
"06037108202",2689,199,106,18,2777,102,735,18,6644
"06037109100",1284,83,0,0,774,25,1255,62,3483
"06037109200",1455,232,6,16,954,10,1067,170,3910
"06037109300",1884,88,240,11,1247,35,1652,30,5187
"06037109400",1922,16,94,4,1140,377,2323,365,6241
"06037109500",3339,343,8,0,909,208,3941,476,9224
"06037109601",2817,261,113,0,1704,336,3051,497,8779
"06037109603",2036,213,126,0,1311,299,2107,449,6541
"06037109604",1343,270,26,30,1180,105,1665,323,4942
"06037109700",1698,259,171,6,2377,166,1821,274,6772
"06037109800",2522,239,72,8,1321,223,1930,182,6497
"06037111100",1513,157,214,8,1037,88,1054,83,4154
"06037111201",2369,135,1,0,731,137,962,88,4423
"06037111202",3012,139,162,1,1609,205,1270,175,6573
"06037111204",3708,212,228,0,1882,133,953,0,7116
"06037111205",1352,154,437,71,1751,73,587,0,4425
"06037111206",2842,215,175,22,1435,98,679,93,5559
"06037111301",3322,828,502,97,2182,348,1964,160,9403
"06037111302",2793,413,229,86,1279,159,931,206,6096
"06037111400",3806,1153,412,13,2163,371,1886,927,10731
"06037113101",2531,157,31,2,815,123,478,3,4140
"06037113102",2111,86,30,0,636,105,391,37,3396
"06037113211",2513,177,136,8,1098,41,602,17,4592
"06037113212",1870,61,72,0,1113,43,742,22,3923
"06037113213",2508,301,46,43,1357,274,1073,338,5940
"06037113231",1335,53,185,0,576,37,270,20,2476
"06037113232",2624,161,3,17,1143,36,491,33,4508
"06037113233",2255,597,26,14,3777,808,3614,1188,12279
"06037113234",1519,315,107,64,1745,928,1359,1071,7108
"06037113235",1197,180,70,14,134,24,214,0,1833
"06037113237",2379,158,155,0,1161,167,637,167,4824
"06037113301",1462,75,96,0,727,6,561,35,2962
"06037113303",2456,154,52,12,1359,75,1198,44,5350
"06037113321",2285,284,367,44,2037,562,1485,571,7635
"06037113322",2878,77,64,29,794,71,920,73,4906
"06037113401",3010,296,272,0,1877,216,2098,195,7964
"06037113421",2084,447,324,30,2424,1548,2447,1692,10996
"06037113422",2727,206,392,117,2342,625,2331,422,9162
"06037115101",3523,67,258,0,1238,40,774,5,5905
"06037115103",31,65,0,0,54,12,0,8,170
"06037115104",1466,578,444,190,1054,524,668,359,5283
"06037115201",2483,863,400,180,2467,460,1889,416,9158
"06037115202",2341,509,244,41,1300,363,1427,480,6705
"06037115301",2135,345,174,37,1153,216,894,113,5067
"06037115302",887,557,149,48,1989,604,2202,1018,7454
"06037115401",2831,398,473,10,1443,592,1716,622,8085
"06037115403",1411,468,229,14,946,473,1344,767,5652
"06037115404",1355,246,60,92,674,583,817,609,4436
"06037117101",1781,331,129,0,2582,270,2096,588,7777
"06037117102",1315,110,33,4,1153,62,1496,141,4314
"06037117201",1406,780,74,15,1218,949,1559,1528,7529
"06037117202",1281,67,106,0,922,11,882,15,3284
"06037117301",2592,57,165,48,995,71,1106,94,5128
"06037117302",3172,204,127,28,1557,214,1272,176,6750
"06037117303",2046,110,209,0,1062,62,1554,40,5083
"06037117404",2358,235,63,22,1167,141,1316,209,5511
"06037117405",949,929,0,1,1148,782,1962,1645,7416
"06037117407",986,755,41,0,999,714,1792,1424,6711
"06037117408",828,772,150,114,776,564,1489,1289,5982
"06037117510",1200,700,143,57,1085,803,2017,1401,7406
"06037117520",970,578,130,96,1177,669,1871,1203,6694
"06037117530",1633,1165,83,63,2084,787,2701,1785,10301
"06037119001",2343,277,0,0,1303,37,2634,245,6839
"06037119002",4060,604,113,41,1604,750,4897,1171,13240
"06037119201",2741,169,9,2,944,147,3299,289,7600
"06037119202",1749,367,90,4,2001,315,3366,592,8484
"06037119310",1838,564,129,36,913,113,1996,502,6091
"06037119320",1023,909,184,49,1854,701,1909,1540,8169
"06037119340",1189,1015,11,5,1112,392,2213,1394,7331
"06037119341",1061,311,34,19,1013,200,1097,341,4076
"06037119342",1077,458,9,22,1275,625,1974,901,6341
"06037119400",3662,512,41,0,892,182,3800,632,9721
"06037119700",1882,318,88,0,1889,603,1385,633,6798
"06037119800",2970,209,33,2,2838,150,4926,175,11303
"06037119900",2965,249,9,0,1807,56,3352,230,8668
"06037120010",1169,256,27,72,1160,212,1701,440,5037
"06037120020",1310,547,0,20,2188,772,2597,1247,8681
"06037120030",842,554,0,72,775,481,1422,1018,5164
"06037120103",702,717,141,49,786,823,1449,1546,6213
"06037120104",586,718,100,69,915,199,1078,831,4496
"06037120105",989,167,90,10,1086,568,1336,597,4843
"06037120106",1412,627,54,17,1253,1046,2182,1448,8039
"06037120107",749,800,79,115,1212,689,1796,1377,6817
"06037120108",1611,763,0,95,1343,815,2448,1315,8390
"06037120300",2594,141,0,2,2339,512,2972,334,8894
"06037120400",1768,865,148,71,3221,846,2730,1126,10775
"06037121010",2576,694,26,2,1387,182,2143,658,7668
"06037121020",1641,396,16,0,1267,273,1855,532,5980
"06037121101",1596,899,67,3,605,115,1519,753,5557
"06037121102",1778,290,9,1,409,39,1195,211,3932
"06037121210",1269,481,44,12,687,249,1388,608,4738
"06037121221",1492,129,97,13,399,97,1749,169,4145
"06037121222",2707,1058,271,0,499,220,2771,1071,8597
"06037121600",1429,221,92,4,804,68,777,54,3449
"06037121801",1437,493,119,103,918,393,1594,666,5723
"06037121802",1853,399,38,177,623,182,1820,234,5326
"06037121900",2013,553,41,0,1597,68,2818,512,7602
"06037122000",2527,612,97,11,2073,147,2113,218,7798
"06037122120",3379,542,65,6,506,165,3408,595,8666
"06037122121",1658,560,8,14,638,72,1852,517,5319
"06037122122",1035,490,27,169,434,61,1297,324,3837
"06037122200",2771,876,1,0,768,217,2910,1058,8601
"06037122410",1219,343,114,62,1159,776,1972,942,6587
"06037122420",1867,1054,82,13,1812,425,3015,1450,9718
"06037123010",2227,857,40,41,794,328,2583,1146,8016
"06037123020",1940,525,5,5,746,215,2301,625,6362
"06037123103",2704,129,98,75,1366,235,2622,279,7508
"06037123104",2021,163,71,40,1491,502,2401,565,7254
"06037123203",1310,469,86,92,1271,469,1918,859,6474
"06037123204",1242,382,45,13,1112,504,1522,837,5657
"06037123205",772,389,42,28,1219,358,1453,701,4962
"06037123206",814,251,63,6,1078,627,1622,801,5262
"06037123301",1775,274,441,69,1545,425,1389,547,6465
"06037123303",1479,353,27,63,1098,272,1554,293,5139
"06037123304",1995,843,89,228,1201,162,1522,618,6658
"06037123410",1674,668,209,38,1094,321,1419,802,6225
"06037123420",2162,976,66,66,1076,291,1640,1039,7316
"06037123510",2076,399,71,61,1659,549,1506,550,6871
"06037123520",1075,328,248,165,561,166,1069,191,3803
"06037123601",3004,514,87,187,1234,269,1666,399,7360
"06037123602",1929,380,170,138,440,339,662,441,4499
"06037123700",2357,524,101,13,1028,56,1159,112,5350
"06037123800",3293,495,496,377,799,82,1231,141,6914
"06037123901",1914,363,61,60,1605,360,2025,515,6903
"06037123902",1546,190,77,0,456,264,434,210,3177
"06037124000",3669,279,115,54,704,76,737,99,5733
"06037124102",1946,471,343,26,691,265,1287,372,5401
"06037124103",370,597,44,0,902,287,798,845,3843
"06037124104",753,202,308,51,853,459,1249,446,4321
"06037124105",1148,644,46,0,411,339,826,737,4151
"06037124201",1692,261,156,32,1086,74,1771,226,5298
"06037124203",1071,465,130,68,641,282,1358,598,4613
"06037124204",1465,670,115,54,550,357,1011,736,4958
"06037124300",2410,384,58,9,832,116,2338,128,6275
"06037124400",2949,533,181,30,208,112,504,185,4702
"06037124500",1851,185,158,0,954,32,979,31,4190
"06037124600",2548,175,124,0,559,29,639,46,4120
"06037124700",3436,211,247,15,681,107,545,2,5244
"06037124902",1697,482,196,0,483,16,422,247,3543
"06037124903",1983,751,160,121,251,35,715,155,4171
"06037125100",3977,430,553,105,786,90,1336,51,7328
"06037125200",2445,461,95,16,613,329,1112,541,5612
"06037125310",2223,878,417,169,775,349,1331,648,6790
"06037125320",2724,846,438,98,1014,403,1191,499,7213
"06037125401",1721,320,536,69,815,103,659,200,4423
"06037125402",2512,264,338,60,643,34,877,43,4771
"06037125501",1765,362,328,8,647,47,804,190,4151
"06037125502",1654,556,276,89,427,390,323,434,4149
"06037125600",1860,126,184,0,361,13,277,7,2828
"06037127102",2026,602,181,47,2143,366,2787,533,8685
"06037127103",784,344,34,49,1421,595,1622,548,5397
"06037127104",1417,83,224,46,1423,563,1292,540,5588
"06037127210",1828,485,252,58,2033,835,2035,1073,8599
"06037127220",1311,536,114,90,1754,1078,2002,1339,8224
"06037127300",1512,438,341,91,1602,425,1653,363,6425
"06037127400",1630,659,229,77,2357,1086,2956,1415,10409
"06037127520",541,254,253,53,1836,1029,1964,1118,7048
"06037127603",944,229,106,26,1040,544,1523,647,5059
"06037127604",1026,382,335,25,709,345,1029,230,4081
"06037127605",748,432,132,48,1766,444,1734,815,6119
"06037127606",1321,362,125,17,1437,412,1599,561,5834
"06037127711",1880,151,360,0,715,433,1315,435,5289
"06037127712",723,440,109,0,903,674,1074,699,4622
"06037127803",1225,687,60,0,1587,398,1565,674,6196
"06037127804",1427,290,237,7,1566,415,1617,494,6053
"06037127805",1310,570,84,22,1946,486,1869,885,7172
"06037127806",1690,493,180,59,548,249,1560,532,5311
"06037127910",1264,244,200,112,1807,1142,1810,1061,7640
"06037127920",1752,496,49,5,1155,194,1433,476,5560
"06037128101",1698,373,44,35,1039,94,1196,330,4809
"06037128102",1177,531,191,80,1601,1046,1838,1368,7832
"06037128210",1072,558,269,80,1677,1885,2315,2340,10196
"06037128220",1344,240,138,90,1120,204,1176,192,4504
"06037128302",2012,1035,107,108,997,673,2317,1318,8567
"06037128303",1283,1239,76,77,443,216,1365,1380,6079
"06037128400",2970,286,152,0,732,39,1435,42,5656
"06037128500",2961,386,357,15,657,105,1063,89,5633
"06037128601",1657,635,55,114,1049,698,1080,1061,6349
"06037128602",2261,271,97,7,323,0,327,157,3443
"06037128702",3871,463,176,0,916,88,598,262,6374
"06037128801",2225,251,223,25,474,90,444,101,3833
"06037128802",3487,200,111,0,664,24,894,10,5390
"06037128910",2886,187,138,1,500,23,265,17,4017
"06037131010",3033,1539,112,1,1535,350,2655,1515,10740
"06037131020",3133,505,54,43,1453,332,2848,561,8929
"06037131100",1698,150,121,0,1189,267,1102,86,4613
"06037131200",1631,322,349,0,846,96,1036,62,4342
"06037131300",2914,510,31,0,1017,274,2406,420,7572
"06037131400",3123,691,504,96,1699,124,2275,538,9050
"06037131600",3049,437,94,1,1593,82,2265,328,7849
"06037131701",2646,394,155,56,1115,476,1648,309,6799
"06037131702",1296,926,123,64,1104,17,1204,732,5466
"06037131800",3223,722,35,0,1700,316,3013,784,9793
"06037131900",3133,437,65,0,1080,325,2348,488,7876
"06037132001",1865,243,64,12,1214,24,1022,47,4491
"06037132002",1525,50,17,10,1416,187,915,200,4320
"06037132101",2219,273,211,80,1292,322,2133,399,6929
"06037132102",2283,677,146,9,1966,249,1940,449,7719
"06037132300",3685,1534,49,59,1296,398,2647,1365,11033
"06037132501",2407,273,49,31,496,26,1720,80,5082
"06037132502",2103,549,194,0,614,469,1261,588,5778
"06037132700",2924,1382,0,0,821,136,2026,1012,8301
"06037132900",2932,296,56,3,409,147,831,254,4928
"06037133000",2917,455,25,71,1210,19,2537,408,7642
"06037133100",3730,828,97,11,907,85,1975,387,8020
"06037134001",1740,663,44,35,952,407,2160,1017,7018
"06037134002",1531,469,74,32,1609,209,1951,509,6384
"06037134101",1968,453,126,102,2547,769,2031,853,8849
"06037134103",1631,466,240,7,1606,377,1305,727,6359
"06037134104",1095,167,247,109,2045,507,1040,440,5650
"06037134201",1674,166,176,11,2176,191,2107,175,6676
"06037134302",2595,78,42,3,972,2,878,2,4572
"06037134303",3399,393,331,0,1318,87,1858,315,7701
"06037134304",1233,98,109,57,947,419,656,378,3897
"06037134305",597,603,48,17,2132,1315,2253,1525,8490
"06037134306",1196,215,141,11,1504,284,1028,102,4481
"06037134421",2707,175,84,1,698,7,393,0,4065
"06037134422",3156,499,165,14,1093,50,398,130,5505
"06037134423",2520,208,181,5,677,28,344,66,4029
"06037134424",1955,18,159,0,552,0,139,0,2823
"06037134520",2464,943,202,0,1069,471,2785,1129,9063
"06037134521",1573,324,69,24,601,129,1793,445,4958
"06037134522",1568,728,49,22,1369,181,2349,711,6977
"06037134710",1082,339,89,59,2799,1502,2826,1679,10375
"06037134720",1608,237,183,26,2338,401,2139,197,7129
"06037134800",2507,330,361,46,2779,189,2413,351,8976
"06037134901",2384,298,115,20,139,140,799,144,4039
"06037134903",3079,351,248,31,1251,248,2081,160,7449
"06037134904",2134,312,183,0,1903,229,2321,400,7482
"06037134905",2080,170,195,2,839,70,385,19,3760
"06037135102",2536,289,63,0,855,121,419,64,4347
"06037135111",2071,109,133,43,669,34,617,21,3697
"06037135113",1397,138,456,37,970,42,187,54,3281
"06037135114",1917,701,78,117,1933,116,468,74,5404
"06037135201",1788,149,144,64,537,16,349,15,3062
"06037135202",3333,191,30,3,880,24,461,20,4942
"06037135203",4312,468,84,234,1872,83,1494,17,8564
"06037137000",3915,116,207,48,630,42,387,12,5357
"06037137103",2567,276,135,16,1388,0,857,0,5239
"06037137104",2195,102,175,0,141,191,181,14,2999
"06037137201",3405,366,325,26,1530,133,821,66,6672
"06037137301",1535,59,9,3,536,94,210,30,2476
"06037137302",3641,258,137,0,426,0,198,11,4671
"06037137401",2971,191,273,19,768,121,341,7,4691
"06037137402",4117,501,363,50,857,0,842,0,6730
"06037137501",2420,257,132,0,876,127,580,66,4458
"06037137502",2916,140,490,28,624,16,693,54,4961
"06037137504",1706,46,12,0,59,0,12,8,1843
"06037138000",3754,302,125,0,354,9,353,20,4917
"06037139001",3273,301,111,33,854,171,925,166,5834
"06037139200",3605,495,329,27,872,89,1044,358,6819
"06037139301",3757,431,34,24,731,18,577,0,5572
"06037139302",2092,588,444,170,1194,179,1128,202,5997
"06037139303",1989,760,139,50,1299,350,1085,414,6086
"06037139401",1607,252,61,60,789,207,871,256,4103
"06037139402",2485,252,8,12,137,8,177,41,3120
"06037139502",2195,193,0,4,425,104,198,0,3119
"06037139503",2920,1048,286,106,862,88,385,32,5727
"06037139504",2640,440,107,0,260,129,230,0,3806
"06037139600",3913,417,256,15,315,74,261,48,5299
"06037139701",4328,192,59,1,587,0,181,1,5349
"06037139702",5475,373,44,0,248,51,116,20,6327
"06037139703",2194,163,9,2,333,7,100,42,2850
"06037139801",2693,102,46,0,363,0,218,0,3422
"06037139802",3219,109,0,0,456,55,221,26,4086
"06037141101",3257,465,140,12,645,52,574,138,5283
"06037141102",2200,172,259,0,384,41,204,64,3324
"06037141201",2728,375,84,0,566,127,805,86,4771
"06037141202",2431,232,42,0,300,0,150,0,3155
"06037141302",3566,624,417,19,909,70,582,75,6262
"06037141303",2445,409,60,0,370,6,186,77,3553
"06037141304",2300,177,175,47,541,66,348,9,3663
"06037141400",3164,505,106,0,656,40,318,63,4852
"06037141500",2529,60,0,30,500,0,179,0,3298
"06037141600",3364,86,86,47,367,0,177,0,4127
"06037141700",2725,106,66,0,283,10,152,10,3352
"06037143100",3612,160,175,95,271,87,475,65,4940
"06037143200",2612,370,265,1,792,50,925,25,5040
"06037143300",4591,408,512,41,872,16,996,0,7436
"06037143400",4754,353,179,52,742,41,680,90,6891
"06037143500",3273,287,472,102,418,13,368,115,5048
"06037143602",2978,324,135,0,468,115,372,0,4392
"06037143603",1490,168,155,17,392,7,402,23,2654
"06037143604",1898,209,274,74,501,68,352,54,3430
"06037143700",2592,142,237,0,595,23,146,0,3735
"06037143800",4272,232,324,17,544,52,550,20,6011
"06037143901",3754,110,0,6,282,80,166,3,4401
"06037143902",2289,95,79,13,357,30,270,29,3162
"06037181000",3180,344,81,2,2366,99,1760,149,7981
"06037181300",1651,246,11,0,1510,187,1149,288,5042
"06037181400",1994,465,64,0,1720,202,1430,269,6144
"06037181500",1780,176,48,1,1694,15,1391,116,5221
"06037181600",1715,113,8,0,1132,107,1470,117,4662
"06037183101",2130,108,38,30,1136,148,2286,179,6055
"06037183103",1272,291,205,30,1786,572,2150,744,7050
"06037183104",1196,98,36,4,708,101,857,179,3179
"06037183220",1853,484,33,0,1590,372,2303,791,7426
"06037183221",1549,283,12,2,770,289,1368,525,4798
"06037183222",1556,469,90,14,977,104,1145,339,4694
"06037183300",1378,262,31,0,1320,380,1713,427,5511
"06037183401",740,130,16,17,1259,153,1273,112,3700
"06037183402",1349,307,0,1,1055,350,1095,318,4475
"06037183510",1347,147,7,0,978,184,1817,271,4751
"06037183520",1671,413,48,92,843,462,2014,830,6373
"06037183610",1126,509,38,74,1184,443,1852,865,6091
"06037183620",1408,217,43,5,1204,341,1867,526,5611
"06037183701",1491,469,187,33,798,514,1842,959,6293
"06037183702",1105,213,104,0,1567,254,1687,393,5323
"06037183810",1864,493,0,17,995,777,2341,1121,7608
"06037183820",1119,464,57,18,1447,815,2366,1146,7432
"06037185100",2975,913,105,30,1628,490,2100,898,9139
"06037185202",1316,120,156,61,1294,946,1660,965,6518
"06037185203",1229,260,18,0,1389,216,2173,364,5649
"06037185204",796,232,56,0,862,34,605,217,2802
"06037185310",1340,228,43,0,1322,766,2274,982,6955
"06037185320",1006,238,0,1,1294,221,2076,324,5160
"06037186100",2064,310,28,0,2109,134,1330,207,6182
"06037186201",1699,80,0,0,1513,253,1548,38,5131
"06037186202",727,182,15,0,997,118,581,134,2754
"06037186203",1695,293,10,0,619,229,837,255,3938
"06037186301",911,327,33,0,1098,480,1479,709,5037
"06037186302",1629,332,140,63,1823,523,1497,738,6745
"06037186401",1029,386,26,4,1413,698,1865,950,6371
"06037186403",912,133,37,26,1552,337,1862,240,5099
"06037186404",878,199,4,15,950,554,1428,688,4716
"06037187101",1374,256,31,2,1189,16,685,120,3673
"06037187102",1138,102,0,0,1802,65,1705,114,4926
"06037187200",890,228,27,22,1340,402,1690,555,5154
"06037187300",1872,151,93,1,1201,78,506,24,3926
"06037188100",1396,421,79,2,1615,265,1782,580,6140
"06037188201",1958,216,52,0,929,100,435,45,3735
"06037188202",1488,73,108,0,653,42,228,59,2651
"06037188300",1745,152,24,0,1416,133,1142,225,4837
"06037189101",1711,359,40,0,595,55,401,79,3240
"06037189102",1899,244,45,0,593,235,475,158,3649
"06037189201",2179,346,60,73,713,56,431,21,3879
"06037189202",1993,148,30,18,383,13,294,13,2892
"06037189300",2320,151,27,0,608,41,96,6,3249
"06037189400",2528,275,109,0,434,165,119,0,3630
"06037189500",2909,397,291,0,590,88,553,100,4928
"06037189600",2115,303,364,34,600,193,407,68,4084
"06037189701",2492,566,94,0,645,54,421,140,4412
"06037189702",1587,150,40,11,177,61,107,21,2154
"06037189800",2767,371,248,103,555,147,404,96,4691
"06037189902",3619,578,141,0,629,158,481,66,5672
"06037189903",1252,272,79,66,389,28,143,12,2241
"06037189904",1592,417,89,26,373,83,78,26,2684
"06037189905",1788,209,89,0,358,18,180,16,2658
"06037190100",2563,695,382,75,695,378,704,261,5753
"06037190201",1125,549,0,21,457,274,653,211,3290
"06037190202",1491,401,105,188,504,470,353,289,3801
"06037190301",2956,629,120,111,819,236,782,260,5913
"06037190401",1543,701,107,27,882,75,409,93,3837
"06037190402",928,835,121,8,215,154,223,184,2668
"06037190510",1235,716,178,87,1833,765,1290,750,6854
"06037190520",1107,680,57,28,1443,468,1142,524,5449
"06037190700",1375,664,116,4,686,367,1125,484,4821
"06037190801",642,428,50,216,716,291,578,373,3294
"06037190802",1192,228,17,23,935,273,1058,219,3945
"06037190901",1046,518,95,150,1435,893,2087,915,7139
"06037190902",1047,397,122,128,1890,712,1889,668,6853
"06037191000",1489,232,39,220,1138,623,1328,589,5658
"06037191110",1735,535,95,0,811,234,529,296,4235
"06037191120",1481,701,50,79,1361,452,1583,757,6464
"06037191201",1654,808,135,62,1043,567,673,674,5616
"06037191203",691,458,66,17,1047,376,529,529,3713
"06037191204",1073,209,54,32,401,140,775,137,2821
"06037191301",938,222,86,53,1012,230,1194,259,3994
"06037191302",652,235,59,6,1059,422,787,458,3678
"06037191410",978,561,80,68,2171,997,2205,1329,8389
"06037191420",1162,404,123,24,1413,841,1664,914,6545
"06037191500",1135,721,21,23,2440,1084,1836,1559,8819
"06037191610",1593,190,67,21,1722,831,2164,914,7502
"06037191620",554,412,51,8,1380,518,1373,640,4936
"06037191710",487,517,42,27,1329,454,1332,652,4840
"06037191720",691,393,63,106,1714,1040,1627,1272,6906
"06037191810",648,337,167,37,1433,1120,1280,1240,6262
"06037191820",950,218,184,0,1166,170,1038,171,3897
"06037191901",1955,433,154,22,614,210,646,215,4249
"06037191902",2059,302,119,3,584,53,599,54,3773
"06037192001",1423,333,109,18,304,144,166,106,2603
"06037192002",1919,214,86,93,275,18,229,30,2864
"06037192300",1640,106,64,25,853,87,395,28,3198
"06037192410",1753,359,41,58,1196,169,876,79,4531
"06037192420",755,348,195,12,2158,658,955,906,5987
"06037192510",415,296,13,16,2561,600,1416,516,5833
"06037192520",1072,471,81,17,2178,1413,2447,1537,9216
"06037192610",1266,619,70,167,1863,964,2341,1212,8502
"06037192620",625,495,44,0,1926,700,1471,972,6233
"06037192700",782,381,44,109,1415,594,1250,562,5137
"06037194101",2080,175,154,14,511,165,242,173,3514
"06037194102",2798,188,63,0,450,0,125,0,3624
"06037194200",2824,149,75,10,460,51,155,0,3724
"06037194300",2866,333,39,0,371,74,165,52,3900
"06037194401",1596,77,87,0,516,18,399,13,2706
"06037194402",2225,543,27,7,475,265,279,158,3979
"06037194500",1439,164,69,0,233,55,115,7,2082
"06037195100",3348,316,133,2,890,82,569,107,5447
"06037195201",1809,200,21,0,863,76,404,68,3441
"06037195202",2487,112,78,0,618,16,363,14,3688
"06037195300",1757,190,10,2,1226,333,936,250,4704
"06037195400",2869,252,51,100,646,101,720,115,4854
"06037195500",2809,649,231,0,1155,49,1309,486,6688
"06037195600",1488,765,29,1,744,212,1034,844,5117
"06037195710",2123,955,248,92,887,425,2318,1145,8193
"06037195720",1496,160,12,8,393,137,1359,202,3767
"06037195802",937,400,58,32,1044,226,1177,472,4346
"06037195803",1511,438,47,11,712,160,607,421,3907
"06037195804",1326,342,84,15,416,172,1021,300,3676
"06037195901",1148,296,16,95,729,224,704,379,3591
"06037195902",1195,320,41,0,247,173,115,316,2407
"06037195903",1212,270,103,40,731,102,635,151,3244
"06037197200",817,182,0,23,2738,153,1782,196,5891
"06037197300",2266,585,28,11,847,254,1569,480,6040
"06037197410",2319,350,46,9,962,267,889,429,5271
"06037197420",1654,415,95,43,993,110,1458,315,5083
"06037197500",2430,523,118,0,871,101,1979,454,6476
"06037197600",1307,251,4,0,821,140,916,261,3700
"06037197700",1023,503,113,0,2078,1428,993,535,6673
"06037199000",1391,688,8,10,1819,1254,1991,1218,8379
"06037199110",1142,264,85,59,731,225,1624,505,4635
"06037199120",1115,542,58,61,944,1272,1600,1525,7117
"06037199201",1205,494,0,0,1859,754,2020,803,7135
"06037199202",1075,396,4,0,897,363,1554,708,4997
"06037199300",1337,379,115,0,1462,454,1795,714,6256
"06037199400",985,336,27,66,2349,954,2490,845,8052
"06037199700",1244,523,12,30,881,630,1502,911,5733
"06037199800",771,618,2,0,2840,852,2084,1054,8221
"06037199900",997,198,0,53,822,831,1494,869,5264
"06037201110",1493,185,12,0,1310,151,2465,230,5846
"06037201120",1481,679,89,46,1639,493,2578,1094,8099
"06037201200",1495,350,6,0,432,270,1726,620,4899
"06037201301",968,356,95,1,1405,285,2002,539,5651
"06037201302",1153,93,477,0,1468,269,762,206,4428
"06037201401",1780,257,72,117,1766,1041,2879,1252,9164
"06037201402",2353,330,41,0,1525,317,2814,604,7984
"06037201501",2357,383,12,0,2024,579,3580,908,9843
"06037201503",1459,568,0,1,777,482,2108,896,6291
"06037201504",586,102,4,0,835,306,1113,391,3337
"06037201601",1022,123,11,0,814,305,1574,373,4222
"06037201602",1383,138,28,0,1389,173,2337,292,5740
"06037201700",1903,640,9,11,1451,487,2533,920,7954
"06037203100",1590,1021,0,0,868,962,2390,1741,8572
"06037203200",1700,1089,10,14,1541,493,3204,1558,9609
"06037203300",455,336,88,6,372,81,629,352,2319
"06037203500",1275,578,15,0,1294,371,1902,905,6340
"06037203600",1705,977,0,4,1510,487,3098,1464,9245
"06037203710",1381,675,44,27,810,292,2155,957,6341
"06037203720",1703,1384,53,0,901,496,2603,1880,9020
"06037203800",2120,946,40,0,1538,227,3587,1173,9631
"06037203900",1113,594,0,0,858,291,1961,839,5656
"06037204110",937,513,66,10,1388,293,2312,793,6312
"06037204120",919,246,0,11,1216,315,2063,569,5339
"06037204200",1127,762,0,0,940,357,1884,1041,6111
"06037204300",1629,1235,0,0,1499,647,3059,1782,9851
"06037204410",517,467,0,0,416,601,907,1056,3964
"06037204420",634,666,47,63,601,725,1188,1327,5251
"06037204600",1536,507,0,0,2060,704,3497,1203,9507
"06037204700",1939,529,8,163,1752,399,3345,1075,9210
"06037204810",1510,391,119,9,1650,786,3093,1160,8718
"06037204820",1273,325,0,0,666,181,1804,474,4723
"06037204910",1059,555,0,1,724,582,1709,1070,5700
"06037204920",1178,524,0,0,671,178,1776,672,4999
"06037205110",1176,702,9,59,721,889,1883,1525,6964
"06037205120",1194,560,7,23,934,775,2061,1286,6840
"06037206010",319,301,0,143,1136,697,588,775,3959
"06037206020",146,10,62,0,186,37,48,27,516
"06037206031",1078,207,147,108,1306,305,141,96,3388
"06037206032",1945,790,37,60,1434,854,2530,1386,9036
"06037206050",875,588,15,86,276,460,970,984,4254
"06037206200",319,392,116,435,1042,729,251,386,3670
"06037206300",304,1017,568,2073,189,911,170,1089,6321
"06037207101",491,241,53,88,1258,1020,221,349,3721
"06037207102",95,37,14,29,1189,986,159,154,2663
"06037207103",63,16,38,1,1071,883,131,12,2215
"06037207301",1619,626,310,585,922,363,464,363,5252
"06037207302",1770,249,556,234,883,195,482,43,4412
"06037207400",1,7,0,0,1,20,1,4,34
"06037207501",784,128,84,0,1013,102,217,28,2356
"06037207502",509,87,45,12,1023,715,114,67,2572
"06037207710",1376,158,204,36,606,547,229,177,3333
"06037207900",1131,495,190,140,1749,543,516,479,5243
"06037208000",2474,1145,150,25,1848,1122,2958,1750,11472
"06037208301",1316,676,0,0,170,101,1456,739,4458
"06037208302",2412,522,101,329,585,344,2366,806,7465
"06037208401",640,374,48,46,2210,1521,2157,1538,8534
"06037208402",1301,627,43,0,1036,154,1621,760,5542
"06037208501",823,234,6,2,1307,238,929,379,3918
"06037208502",450,448,150,1,1797,976,1588,1318,6728
"06037208610",589,194,55,51,2595,581,1362,386,5813
"06037208620",666,272,112,262,2530,719,1668,466,6695
"06037208710",400,176,135,55,2354,732,813,219,4884
"06037208720",420,696,129,105,1700,1314,1755,1847,7966
"06037208801",302,521,103,86,1694,715,1226,1045,5692
"06037208802",431,118,187,33,1391,851,1222,726,4959
"06037208902",449,246,9,0,601,852,1030,1088,4275
"06037208903",554,460,27,115,1679,686,1980,1010,6511
"06037208904",341,541,54,0,674,1803,848,2133,6394
"06037209102",476,693,98,114,1479,1925,1358,2308,8451
"06037209103",376,654,16,10,799,1535,1045,2175,6610
"06037209104",369,528,60,54,618,676,807,1060,4172
"06037209200",573,303,85,107,1096,591,683,516,3954
"06037209300",844,693,98,357,1694,1042,1752,1326,7806
"06037209401",485,491,148,174,1354,972,1345,1292,6261
"06037209402",526,525,32,46,1598,1084,1926,1568,7305
"06037209403",161,312,78,86,1040,1783,685,1715,5860
"06037209510",427,175,27,38,1310,601,1213,596,4387
"06037209520",197,126,51,9,1352,687,1281,743,4446
"06037209810",382,261,41,19,1034,565,1139,758,4199
"06037209820",415,462,34,21,1270,666,1553,1085,5506
"06037210010",702,131,39,81,1401,1095,1656,1034,6139
"06037211000",2649,107,81,21,1360,75,199,49,4541
"06037211120",578,216,198,78,3365,829,739,451,6454
"06037211121",509,34,94,20,1089,525,586,351,3208
"06037211122",393,338,119,154,1583,258,855,446,4146
"06037211201",535,310,31,26,1650,473,1750,686,5461
"06037211202",709,255,70,13,1196,436,1264,577,4520
"06037211310",420,668,165,1,2171,967,1666,1464,7522
"06037211320",560,265,137,50,1576,474,1286,645,4993
"06037211410",364,341,126,9,1718,226,559,378,3721
"06037211420",636,229,100,62,1792,380,1078,445,4722
"06037211500",1814,86,38,64,2385,472,883,95,5837
"06037211701",789,65,70,1,1871,245,183,46,3270
"06037211703",1035,100,186,33,2899,724,1680,438,7095
"06037211704",377,121,140,0,1597,530,457,123,3345
"06037211802",630,364,156,23,2360,674,802,686,5695
"06037211803",475,84,235,62,2022,891,445,244,4458
"06037211804",345,160,135,22,1751,623,336,124,3496
"06037211910",972,451,231,35,2427,803,2265,858,8042
"06037211921",287,351,75,13,1243,209,623,368,3169
"06037211922",683,269,214,16,2095,329,1960,342,5908
"06037212101",368,337,135,28,1073,387,282,399,3009
"06037212102",342,76,75,0,1140,634,567,414,3248
"06037212202",188,237,22,23,1974,1224,1609,1395,6672
"06037212203",344,71,22,0,1312,1036,1421,798,5004
"06037212204",367,422,75,22,1689,1068,1631,1225,6499
"06037212303",458,278,74,126,1619,720,1582,802,5659
"06037212304",406,153,43,6,949,337,922,443,3259
"06037212305",402,185,84,28,1444,850,1454,906,5353
"06037212306",170,292,2,15,2324,430,844,544,4621
"06037212410",525,271,140,36,1983,838,1002,700,5495
"06037212420",220,265,31,88,1769,962,1139,984,5458
"06037212501",727,174,99,23,863,197,848,234,3165
"06037212502",534,56,134,30,1766,209,882,119,3730
"06037212610",508,84,154,25,2274,859,644,390,4938
"06037212620",510,211,139,58,2775,993,1194,942,6822
"06037212701",534,125,46,17,1486,177,649,150,3184
"06037212702",962,38,148,0,2296,246,382,76,4148
"06037212800",932,715,306,115,1502,311,1124,821,5826
"06037212900",890,641,365,144,2101,560,1905,993,7599
"06037213100",442,278,184,32,1650,392,640,510,4128
"06037213201",258,128,48,34,2939,1169,1333,889,6798
"06037213202",382,186,100,34,2008,1236,1439,1094,6479
"06037213310",233,69,47,24,2505,1037,1926,1040,6881
"06037213320",349,38,111,34,1277,424,1008,275,3516
"06037213401",292,160,45,9,4147,1130,3559,1056,10398
"06037213402",319,197,143,91,3132,924,2603,977,8386
"06037214000",3251,183,11,0,306,32,97,3,3883
"06037214100",3456,216,40,0,306,20,269,0,4307
"06037214400",1966,393,49,10,496,95,275,57,3341
"06037214501",1587,205,41,16,808,248,139,13,3057
"06037214502",1874,1028,202,0,1534,445,256,349,5688
"06037214503",1306,192,58,0,1746,67,138,0,3507
"06037214600",1978,211,28,11,386,15,147,7,2783
"06037214700",1883,137,32,0,332,66,194,14,2658
"06037214800",2293,160,115,0,347,60,195,35,3205
"06037214901",1568,355,78,0,638,53,122,17,2831
"06037214902",2034,179,49,0,466,116,182,15,3041
"06037215101",1255,274,69,8,682,121,386,53,2848
"06037215102",1662,424,164,36,817,137,212,108,3560
"06037216100",1139,75,593,23,613,118,234,118,2913
"06037216200",1532,489,925,208,1517,47,571,206,5495
"06037216300",2863,425,432,6,1117,61,394,22,5320
"06037216401",3108,513,46,0,929,185,299,139,5219
"06037216402",1992,330,55,0,487,102,248,12,3226
"06037216700",1293,178,978,313,1023,102,769,13,4669
"06037216800",2140,397,284,9,425,140,387,278,4060
"06037216900",2067,115,1127,134,1465,244,1205,270,6627
"06037217001",1927,342,70,2,456,14,157,7,2975
"06037217002",3053,556,732,119,1066,56,738,63,6383
"06037217100",1971,232,1859,344,1007,155,1166,293,7027
"06037217200",1105,533,737,89,1147,200,1012,636,5459
"06037218110",695,184,761,94,1340,407,1366,508,5355
"06037218120",1497,484,260,268,1819,694,2456,938,8416
"06037218210",1415,506,476,127,814,477,2071,932,6818
"06037218220",1027,446,1163,348,1482,246,1866,559,7137
"06037218300",1549,337,1500,671,1419,315,2158,559,8508
"06037218400",947,536,774,506,1268,186,2119,669,7005
"06037218500",489,97,661,359,1086,369,1380,394,4835
"06037218600",726,83,845,261,1126,343,1615,349,5348
"06037218701",361,79,1070,30,478,365,447,410,3240
"06037218702",274,55,672,251,604,278,646,294,3074
"06037218800",441,250,511,101,1068,202,1358,390,4321
"06037218900",480,482,1662,714,2165,493,2146,792,8934
"06037219010",568,187,806,181,736,471,1190,653,4792
"06037219020",760,345,1053,60,1580,362,2126,667,6953
"06037219300",556,239,890,608,1540,379,1795,527,6534
"06037219500",299,4,583,74,675,28,500,0,2163
"06037219700",1011,76,1326,248,1305,145,2040,161,6312
"06037219800",931,241,431,331,756,325,1713,559,5287
"06037219901",967,624,533,342,1439,780,2253,1467,8405
"06037219902",1288,382,922,122,1013,190,2114,472,6503
"06037220000",1266,1058,1907,476,1243,210,2083,1212,9455
"06037220100",420,27,968,295,158,412,292,307,2879
"06037221110",571,213,47,0,1757,1050,2029,1046,6713
"06037221120",532,282,30,23,1591,759,2019,1041,6277
"06037221210",406,154,110,104,1678,536,1846,619,5453
"06037221220",554,307,51,17,2185,497,2393,635,6639
"06037221302",663,1166,448,170,2096,672,2119,1598,8932
"06037221303",176,289,138,157,1036,717,847,955,4315
"06037221304",940,370,313,295,1215,683,1585,974,6375
"06037221401",452,96,851,409,526,571,749,594,4248
"06037221402",278,196,324,300,1092,377,953,346,3866
"06037221500",550,31,702,523,847,1057,1228,1098,6036
"06037221601",465,162,301,123,1568,862,1809,944,6234
"06037221602",672,280,21,28,1248,695,1798,876,5618
"06037221710",239,161,147,63,1222,981,1255,844,4912
"06037221810",264,473,82,145,639,1005,525,574,3707
"06037221820",433,671,45,246,638,1005,187,184,3409
"06037221900",327,356,179,32,435,1194,545,459,3527
"06037222001",539,56,509,550,1186,307,1569,319,5035
"06037222002",941,42,990,165,1751,419,2480,456,7244
"06037222100",481,192,720,382,1694,505,1851,593,6418
"06037222200",367,315,616,302,1743,778,1862,955,6938
"06037222500",437,346,689,435,2061,1018,2240,1242,8468
"06037222600",682,514,787,441,1832,1177,2141,818,8392
"06037222700",77,197,25,33,17,298,12,11,670
"06037224010",215,231,201,165,673,649,715,698,3547
"06037224020",353,480,20,108,1025,505,1249,936,4676
"06037224200",450,364,22,0,1337,333,1717,697,4920
"06037224310",372,250,39,0,891,601,1064,768,3985
"06037224320",292,508,23,245,1543,557,1748,1057,5973
"06037224410",419,368,49,14,1508,1053,1320,692,5423
"06037224420",266,151,21,54,758,780,959,902,3891
"06037224600",651,214,21,60,1025,1255,1633,1434,6293
"06037224700",340,921,21,84,264,1025,90,206,2951
"06037226001",608,180,100,25,862,281,1511,461,4028
"06037226002",423,233,60,101,428,255,419,421,2340
"06037226410",933,612,12,34,1201,730,2077,1245,6844
"06037226420",1245,603,139,114,1638,1303,2680,1872,9594
"06037226700",1145,706,60,225,2131,1729,3243,2401,11640
"06037227010",730,381,120,82,1288,1962,2018,2343,8924
"06037227020",725,520,98,54,1124,820,1811,1314,6466
"06037228100",730,680,318,142,1971,1507,2697,2172,10217
"06037228210",498,276,310,230,1174,1387,1626,1719,7220
"06037228220",907,499,320,238,1027,1078,1892,1540,7501
"06037228310",564,600,157,60,1770,1083,2276,1617,8127
"06037228320",520,286,172,136,1337,806,1835,1090,6182
"06037228410",963,240,10,53,1288,823,2218,1054,6649
"06037228420",626,291,162,144,986,1084,1576,1384,6253
"06037228500",739,405,380,301,1491,1519,2212,1942,8989
"06037228600",541,427,154,112,1509,1999,1844,2426,9012
"06037228710",707,398,206,128,939,1676,1626,2063,7743
"06037228720",1151,358,249,138,1420,1322,2527,1685,8850
"06037228800",1305,713,407,279,1529,1495,2889,2178,10795
"06037228900",589,354,119,175,672,1299,1021,1712,5941
"06037229100",845,383,134,202,1927,1057,2753,1304,8605
"06037229200",617,660,478,258,1270,705,1863,1377,7228
"06037229300",901,672,238,254,1654,2195,2502,2867,11283
"06037229410",551,350,178,303,984,888,1538,1191,5983
"06037229420",813,300,262,118,1651,1650,2423,1942,9159
"06037231100",434,362,189,531,492,792,840,1027,4667
"06037231210",373,255,542,304,1540,547,1912,769,6242
"06037231220",455,226,343,258,1540,1421,1723,1460,7426
"06037231300",369,427,822,599,1587,1309,1900,1708,8721
"06037231400",709,731,738,198,2261,376,2930,1083,9026
"06037231500",641,45,1611,423,1416,307,1778,304,6525
"06037231600",513,470,1274,648,2473,1492,2881,1742,11493
"06037231710",361,133,473,536,1230,1749,1583,1838,7903
"06037231720",723,201,299,94,2335,1534,2963,1560,9709
"06037231800",902,399,370,169,1112,1943,1989,2190,9074
"06037231900",763,583,409,198,1765,1921,2438,2459,10536
"06037232110",473,178,301,412,801,680,1230,856,4931
"06037232120",755,337,519,618,1692,1311,2381,1639,9252
"06037232200",429,101,551,421,604,490,919,567,4082
"06037232300",531,104,1086,217,955,757,1412,844,5906
"06037232400",625,230,1744,1112,2697,502,3091,696,10697
"06037232500",572,249,1576,437,1013,852,1521,1067,7287
"06037232600",840,207,1138,648,2103,1147,2739,1353,10175
"06037232700",1121,289,613,486,2644,960,3634,1226,10973
"06037232800",265,301,428,251,1895,872,2156,1129,7297
"06037234000",577,143,2812,943,1154,96,1548,260,7533
"06037234200",97,2,1510,454,355,29,66,19,2532
"06037234300",40,0,2649,1084,371,170,228,31,4573
"06037234501",338,79,1092,332,480,127,795,176,3419
"06037234502",395,47,1106,404,133,37,395,34,2551
"06037234600",715,171,1959,814,895,497,1205,652,6908
"06037234700",685,290,1515,438,362,368,1025,640,5323
"06037234800",1250,77,1133,178,713,160,1828,85,5424
"06037234901",158,166,1017,417,455,730,613,793,4349
"06037234902",427,37,1219,746,765,414,1008,447,5063
"06037235100",195,0,3104,315,882,80,670,46,5292
"06037235201",452,164,1361,290,165,90,535,226,3283
"06037235202",284,166,1548,1005,968,219,996,295,5481
"06037236000",823,18,2474,177,813,39,458,0,4802
"06037236100",578,89,2369,1185,839,316,724,288,6388
"06037236202",631,417,1352,858,840,1060,1287,1412,7857
"06037236203",293,386,2074,485,325,68,538,419,4588
"06037236204",120,582,1298,658,399,141,408,668,4274
"06037236400",248,72,3228,350,387,110,193,70,4658
"06037237101",1328,412,450,368,552,620,1880,1022,6632
"06037237102",639,379,663,136,499,662,1167,1020,5165
"06037237201",699,391,597,211,1095,496,1756,841,6086
"06037237202",1194,236,727,599,1856,85,3044,331,8072
"06037237300",905,0,2263,793,693,219,1447,209,6529
"06037237401",885,302,522,334,1435,163,2320,465,6426
"06037237402",1170,140,941,420,557,146,1718,276,5368
"06037237500",687,182,627,107,439,544,1109,729,4424
"06037237600",1048,266,522,330,1122,451,2138,694,6571
"06037237710",912,566,484,208,636,578,1471,1040,5895
"06037237720",824,293,313,251,549,869,1370,1065,5534
"06037237800",492,64,2072,641,926,128,1468,154,5945
"06037237900",218,51,2535,683,277,29,566,80,4439
"06037238000",443,422,3735,649,435,27,711,434,6856
"06037238100",551,98,2697,829,646,46,969,94,5930
"06037238200",381,2,2990,975,624,96,671,53,5792
"06037238310",693,1012,393,401,1144,1062,1795,2068,8568
"06037238320",777,416,705,389,739,636,1516,1052,6230
"06037238400",305,217,3439,402,421,86,582,257,5709
"06037239201",387,173,485,99,1154,1211,1553,1380,6442
"06037239202",806,160,432,460,1796,923,2570,1060,8207
"06037239310",771,247,370,141,1728,747,2387,979,7370
"06037239320",453,306,363,357,1677,509,2106,833,6604
"06037239330",370,209,258,229,1581,493,1951,702,5793
"06037239501",814,574,375,231,1025,393,1819,967,6198
"06037239502",768,319,534,323,486,865,1247,1229,5771
"06037239601",798,318,303,453,834,838,1632,1127,6303
"06037239602",792,106,147,335,1274,941,2028,1061,6684
"06037239701",995,735,388,667,961,1007,1924,1742,8419
"06037239702",282,209,772,664,1248,561,1509,773,6018
"06037239801",417,462,276,584,1048,595,1465,1076,5923
"06037239802",1198,266,599,327,1246,960,2273,1226,8095
"06037240010",922,528,276,528,907,614,1825,1140,6740
"06037240020",1166,598,980,410,1658,677,2787,1264,9540
"06037240200",500,457,753,683,1961,1191,2377,1658,9580
"06037240300",1317,401,915,462,1208,745,2507,1052,8607
"06037240401",754,727,821,349,1472,712,2196,1405,8436
"06037240402",705,549,767,487,767,442,1411,977,6105
"06037240500",718,212,1213,1191,1402,1137,2147,1320,9340
"06037240600",442,158,817,389,1624,903,2066,1053,7452
"06037240700",1694,674,1446,543,1111,440,2752,932,9592
"06037240800",1385,375,1138,745,810,594,2147,882,8076
"06037240900",1778,572,767,594,1051,1276,2809,1839,10686
"06037241001",719,249,650,1049,869,516,1558,765,6375
"06037241002",745,636,1123,323,1430,227,2178,914,7576
"06037241110",803,329,355,522,696,392,1458,723,5278
"06037241120",853,552,898,568,922,1064,1698,1477,8032
"06037241201",791,219,737,435,394,187,1137,406,4306
"06037241202",1097,145,1178,673,961,861,1905,1001,7821
"06037241300",390,63,615,392,410,254,708,283,3115
"06037241400",866,364,924,442,539,189,1341,541,5206
"06037242000",894,838,927,505,507,221,1405,1043,6340
"06037242100",499,1048,204,509,128,430,633,1475,4926
"06037242200",1770,761,810,488,882,1193,2619,1963,10486
"06037242300",1684,480,580,786,1057,247,2730,635,8199
"06037242600",675,725,415,1313,379,1058,1050,1747,7362
"06037242700",1454,906,580,430,728,497,2166,1362,8123
"06037243000",3270,827,407,836,706,248,3833,1073,11200
"06037243100",2042,1428,539,794,766,760,2796,2193,11318
"06037261101",3316,224,69,10,282,22,180,22,4125
"06037261102",2894,418,35,0,808,0,336,0,4491
"06037261200",3123,133,69,10,533,12,320,53,4253
"06037262100",2558,137,19,0,182,6,73,0,2975
"06037262200",3620,75,83,28,609,59,316,10,4800
"06037262301",1800,149,13,0,332,31,45,15,2385
"06037262302",2836,46,12,0,172,0,141,23,3230
"06037262303",2591,122,0,0,294,10,130,33,3180
"06037262400",2736,49,0,14,300,45,132,43,3319
"06037262501",3363,141,33,0,227,7,128,10,3909
"06037262601",3076,217,36,0,440,47,228,8,4052
"06037262604",5342,184,0,28,736,28,206,13,6537
"06037262704",2902,192,23,0,331,4,137,9,3598
"06037262706",3026,135,127,0,267,0,160,20,3735
"06037262802",3066,29,70,23,244,0,89,8,3529
"06037264000",2719,247,0,0,272,0,147,0,3385
"06037264102",2272,263,12,0,209,46,149,35,2986
"06037264103",1641,265,0,0,324,28,189,0,2447
"06037264301",3873,249,60,0,860,86,425,40,5593
"06037264302",4478,203,0,0,789,117,274,49,5910
"06037265100",1977,247,48,0,259,41,11,0,2583
"06037265201",1421,129,23,0,328,238,99,0,2238
"06037265202",2498,278,127,0,493,402,151,33,3982
"06037265301",0,0,0,0,0,0,0,0,0
"06037265303",824,1692,87,141,387,2099,251,876,6357
"06037265304",389,1274,0,51,226,751,45,277,3013
"06037265305",804,1143,16,150,628,888,101,101,3831
"06037265410",1231,46,25,18,156,5,67,0,1548
"06037265420",1334,135,29,0,373,131,68,0,2070
"06037265510",1684,374,23,1,763,967,105,40,3957
"06037265520",2818,244,0,0,795,401,146,15,4419
"06037265601",2110,76,57,0,576,0,68,8,2895
"06037265602",2091,217,0,0,498,119,146,0,3071
"06037265700",3751,366,54,0,832,0,67,12,5082
"06037267100",4395,414,120,65,1148,152,406,88,6788
"06037267200",3584,257,33,0,1298,82,359,18,5631
"06037267300",1885,516,44,1,1766,626,658,351,5847
"06037267402",2664,299,87,21,1402,139,457,26,5095
"06037267403",1552,244,91,0,976,235,339,10,3447
"06037267404",1808,285,70,13,771,170,358,161,3636
"06037267501",2954,674,74,19,2784,166,2831,382,9884
"06037267502",1821,208,35,0,953,60,453,28,3558
"06037267600",1544,37,30,0,982,164,652,0,3409
"06037267700",1380,169,31,14,1683,94,780,46,4197
"06037267800",1994,34,69,25,795,22,246,24,3209
"06037267901",1807,154,0,0,359,38,24,8,2390
"06037267902",2618,194,46,0,501,128,86,8,3581
"06037269000",4212,126,91,83,644,48,282,19,5505
"06037269100",3097,418,28,0,642,0,268,26,4479
"06037269300",3576,150,101,0,541,0,197,0,4565
"06037269500",2984,205,82,0,733,27,68,0,4099
"06037269601",1362,576,608,211,279,35,1163,503,4737
"06037269602",1540,297,260,223,456,370,858,587,4591
"06037269700",2420,228,320,53,695,67,1389,192,5364
"06037269800",1611,425,225,0,1079,194,574,192,4300
"06037269903",1611,361,270,102,1264,120,830,248,4806
"06037269904",1660,449,467,56,803,304,722,253,4714
"06037269905",1902,97,189,26,640,117,1329,0,4300
"06037269906",1300,190,93,76,940,164,423,53,3239
"06037269907",1306,401,304,32,532,59,585,224,3443
"06037270100",2426,423,384,31,972,264,686,286,5472
"06037270200",2255,625,247,0,692,164,1925,657,6565
"06037270300",654,143,673,80,717,143,679,253,3342
"06037271100",1360,274,20,0,712,93,307,147,2913
"06037271200",1388,140,131,0,736,171,768,114,3448
"06037271300",2521,280,225,0,1257,147,969,120,5519
"06037271400",2669,354,17,0,650,33,506,45,4274
"06037271500",2264,173,26,30,684,31,397,73,3678
"06037271600",2196,289,228,204,1259,283,363,47,4869
"06037271701",3373,382,37,1,1736,201,772,14,6516
"06037271702",1645,388,55,14,1670,724,350,239,5085
"06037271801",1805,650,99,17,868,365,937,325,5066
"06037271802",3058,921,449,14,1835,337,1375,433,8422
"06037271901",1674,96,222,82,896,214,928,140,4252
"06037271902",2568,266,143,2,1059,32,780,48,4898
"06037272100",3069,343,17,0,801,127,880,157,5394
"06037272201",1192,115,278,12,939,141,1005,154,3836
"06037272202",1925,317,174,76,919,137,987,180,4715
"06037272301",1747,206,223,0,822,204,873,229,4304
"06037272302",2188,241,261,0,988,429,1531,424,6062
"06037273100",1648,164,10,0,274,27,365,6,2494
"06037273200",2180,493,160,126,356,171,634,522,4642
"06037273300",2347,346,428,35,493,85,715,250,4699
"06037273402",2260,345,94,0,315,106,178,111,3409
"06037273502",2000,257,149,27,497,87,271,7,3295
"06037273600",1820,237,34,56,210,11,110,94,2572
"06037273700",2141,285,36,0,391,10,506,181,3550
"06037273800",2214,260,173,30,585,105,407,158,3932
"06037273902",2852,212,53,64,292,144,339,85,4041
"06037274100",3114,430,230,100,510,32,354,71,4841
"06037274202",3165,273,24,40,297,25,227,10,4061
"06037275101",749,21,85,0,400,13,409,10,1687
"06037275102",2392,247,56,0,1641,165,3074,311,7886
"06037275200",1560,358,113,22,1502,546,1641,626,6368
"06037275302",3332,339,55,245,670,198,549,76,5464
"06037275311",2949,248,122,0,2608,137,1801,139,8004
"06037275400",2296,62,120,33,799,69,749,60,4188
"06037275500",2197,727,133,223,1464,396,2623,950,8713
"06037275602",3275,277,820,132,2360,309,669,211,8053
"06037275603",1726,226,52,0,896,115,1016,221,4252
"06037276000",3922,148,148,49,1218,85,819,29,6418
"06037276100",1540,241,2536,531,1010,131,418,75,6482
"06037276400",2961,289,30,34,785,56,455,11,4621
"06037276500",1339,136,16,8,254,6,220,25,2004
"06037276601",2440,260,124,17,995,66,378,26,4306
"06037276603",3162,190,512,60,1330,147,944,64,6409
"06037276604",2161,314,621,101,501,290,420,13,4421
"06037277000",4388,178,59,0,990,21,991,0,6627
"06037277100",2034,234,25,2,738,29,648,128,3838
"06037277200",599,101,759,56,832,248,771,259,3625
"06037277400",163,63,584,270,434,99,331,44,1988
"06037278001",1599,254,78,20,372,48,479,94,2944
"06037278102",2277,42,131,9,437,62,344,24,3326
"06037291110",138,262,1753,404,588,194,603,490,4432
"06037291120",267,177,553,191,600,406,790,558,3542
"06037291130",916,90,634,322,1328,290,1849,349,5778
"06037291210",1232,414,926,180,1738,844,1842,1151,8327
"06037291220",1021,394,272,66,1325,516,1556,902,6052
"06037291300",905,37,87,4,1145,122,540,20,2860
"06037292000",1578,417,537,287,2775,1043,2528,1155,10320
"06037293201",1776,189,251,282,4011,261,3765,284,10819
"06037293202",974,607,301,274,2686,1474,2006,1825,10147
"06037293301",1136,194,67,25,1412,63,564,14,3475
"06037293302",2506,599,315,8,1785,252,2129,717,8311
"06037293304",1783,462,195,48,1667,305,2186,512,7158
"06037293306",1355,226,135,0,577,65,805,212,3375
"06037293307",956,90,347,108,937,324,1253,320,4335
"06037294110",2665,560,46,0,1035,193,3112,693,8304
"06037294120",1230,390,81,21,603,51,1792,384,4552
"06037294200",3371,636,8,0,1251,279,3878,844,10267
"06037294301",1721,226,24,0,675,96,2004,259,5005
"06037294302",2900,872,158,0,981,365,3672,1166,10114
"06037294410",1930,348,536,154,1227,787,1532,642,7156
"06037294421",1492,457,207,37,676,237,1717,671,5494
"06037294510",2333,1278,1,0,725,233,2788,1454,8812
"06037294520",1955,631,9,0,752,295,2542,912,7096
"06037294610",1969,1086,117,29,611,340,2496,1416,8064
"06037294620",2538,785,127,0,1043,180,3497,955,9125
"06037294701",1551,807,96,46,447,200,1876,944,5967
"06037294810",1703,1554,141,33,682,405,2348,1931,8797
"06037294820",1649,1326,0,3,514,278,2101,1573,7444
"06037294830",1460,1176,71,9,734,336,2083,1479,7348
"06037294900",1335,1485,79,15,451,127,1573,1555,6620
"06037295103",3658,134,59,0,1061,45,1098,62,6117
"06037296210",1220,726,114,143,281,351,1263,880,4978
"06037296220",1613,855,192,198,832,721,1687,1228,7326
"06037296300",2618,97,70,0,1148,283,1310,188,5714
"06037296401",2189,62,42,29,808,136,728,28,4022
"06037296402",1711,313,164,9,571,0,950,231,3949
"06037296500",1735,880,314,75,945,211,1963,1000,7123
"06037296600",2476,949,302,41,747,743,2492,1127,8877
"06037296901",1960,306,155,36,1273,244,2243,407,6624
"06037296902",2441,459,90,82,642,165,1647,466,5992
"06037297000",3894,85,118,0,788,35,1346,44,6310
"06037297110",2135,961,439,356,640,509,1959,1058,8057
"06037297120",2063,619,175,37,688,267,2073,679,6601
"06037297201",1951,592,364,35,656,64,1601,418,5681
"06037297202",2502,76,157,0,857,413,1030,366,5401
"06037297300",1694,91,65,0,255,74,563,27,2769
"06037297400",2806,248,60,2,545,33,575,154,4423
"06037297500",3493,255,290,49,686,355,1353,328,6809
"06037297601",2083,195,118,0,239,0,417,122,3174
"06037297602",2409,262,182,49,770,119,1106,245,5142
"06037300100",4038,147,73,0,1540,56,588,32,6474
"06037300200",3090,181,14,0,2214,211,538,104,6352
"06037300301",4723,257,0,0,1581,99,517,23,7200
"06037300400",3205,164,16,2,1973,110,988,1,6459
"06037300501",1748,192,0,0,916,142,401,11,3410
"06037300502",3209,418,67,1,2485,178,816,252,7426
"06037300600",4912,407,33,0,3374,455,911,54,10146
"06037300701",5447,222,3,10,730,0,799,21,7232
"06037300702",4038,452,0,0,797,0,89,165,5541
"06037300800",4433,832,93,0,1535,295,470,105,7763
"06037300901",3700,98,53,0,2157,77,567,0,6652
"06037300902",1344,205,0,0,499,30,359,18,2455
"06037301000",3690,228,60,0,1038,135,706,139,5996
"06037301100",4625,569,0,7,1287,139,856,49,7532
"06037301203",3046,223,20,0,1229,70,485,62,5135
"06037301204",3354,750,113,0,722,185,287,46,5457
"06037301205",1677,28,42,9,441,18,254,0,2469
"06037301206",2968,978,0,2,1161,308,434,36,5887
"06037301300",1695,73,8,0,293,28,195,0,2292
"06037301400",3319,67,0,4,446,0,288,0,4124
"06037301501",1605,40,0,0,168,6,146,0,1965
"06037301502",4402,1375,25,0,1044,119,615,70,7650
"06037301601",4059,919,258,0,1092,113,982,91,7514
"06037301602",2134,251,89,0,1026,300,1315,332,5447
"06037301701",1973,243,39,0,422,88,506,79,3350
"06037301702",3838,629,31,0,1077,181,1094,135,6985
"06037301801",2588,320,16,0,1281,27,860,64,5156
"06037301802",1744,686,16,0,932,81,367,13,3839
"06037301900",4776,1175,115,18,1506,290,822,197,8899
"06037302002",2356,600,31,0,502,313,590,61,4453
"06037302003",2690,401,12,0,563,30,333,29,4058
"06037302004",2620,590,8,17,1334,25,804,31,5429
"06037302102",3585,688,23,0,1226,162,904,337,6925
"06037302103",3087,967,31,1,1302,216,1125,91,6820
"06037302104",1770,334,112,16,1381,176,883,188,4860
"06037302201",2199,989,136,54,459,80,295,101,4313
"06037302202",3056,1216,0,10,958,122,772,213,6347
"06037302301",2106,544,30,0,1207,164,456,207,4714
"06037302302",2655,766,30,0,1337,113,1964,268,7133
"06037302401",2960,868,78,39,1188,345,1588,419,7485
"06037302503",2300,920,19,0,1093,147,660,157,5296
"06037302504",2130,1298,79,51,735,43,986,560,5882
"06037302505",2033,924,236,0,929,195,1589,445,6351
"06037302506",2254,633,118,24,416,13,948,108,4514
"06037310100",4452,299,11,0,926,0,463,29,6180
"06037310201",3700,275,150,0,1289,66,1258,23,6761
"06037310202",3290,462,120,49,731,185,459,200,5496
"06037310300",2106,166,0,0,543,25,250,0,3090
"06037310400",2400,276,7,7,592,121,458,193,4054
"06037310501",2137,214,108,14,899,34,1718,106,5230
"06037310601",3089,589,73,11,2317,364,2077,265,8785
"06037310602",1512,115,54,11,675,13,579,22,2981
"06037310701",1408,594,40,1,424,34,329,75,2905
"06037310702",4350,882,70,0,1983,123,1158,30,8596
"06037310703",3584,1094,171,0,412,165,720,233,6379
"06037310800",3382,237,117,0,1366,128,1370,127,6727
"06037310900",4339,202,12,4,1615,36,2124,144,8476
"06037311000",2764,123,13,1,1082,49,1430,26,5488
"06037311100",2324,329,47,12,1270,20,1384,135,5521
"06037311200",2368,162,53,0,428,7,974,69,4061
"06037311300",2815,157,92,0,661,123,822,145,4815
"06037311400",1798,111,6,35,292,16,268,15,2541
"06037311500",4007,227,67,6,1084,65,1083,46,6585
"06037311600",4878,378,213,9,1611,200,1148,176,8613
"06037311700",3959,365,221,2,1223,33,858,107,6768
"06037311801",2123,436,32,0,793,91,1379,269,5123
"06037311802",1484,711,142,7,1269,67,1438,621,5739
"06037320000",0,0,0,0,0,0,0,0,0
"06037320100",4975,621,143,9,1815,387,6121,976,15047
"06037320201",2039,402,29,0,622,366,2283,768,6509
"06037320202",3082,238,328,0,1862,421,4610,568,11109
"06037320300",3306,1408,26,0,1296,534,4341,1890,12801
"06037400204",4543,197,234,0,1295,27,1313,94,7703
"06037400205",1707,117,120,11,1102,104,318,27,3506
"06037400206",4267,74,41,10,1007,23,990,5,6417
"06037400207",3668,185,51,17,647,33,891,30,5522
"06037400302",1745,102,88,3,837,168,908,56,3907
"06037400304",4235,246,334,0,1203,574,1333,107,8032
"06037400402",3095,316,72,0,908,11,1066,14,5482
"06037400403",2586,105,308,2,1028,67,1182,40,5318
"06037400404",3831,44,91,2,377,10,410,41,4806
"06037400501",1763,30,27,3,281,7,407,14,2532
"06037400602",1640,245,12,0,1365,807,1899,873,6841
"06037400603",1909,221,282,20,2212,204,2089,293,7230
"06037400604",1007,153,112,15,1249,645,1057,685,4923
"06037400800",1089,210,19,18,656,107,304,13,2416
"06037400900",2762,129,121,38,1050,282,1256,239,5877
"06037401001",2718,61,5,0,468,0,680,0,3932
"06037401002",2700,475,67,151,554,31,922,15,4915
"06037401101",3769,464,71,1,631,94,844,225,6099
"06037401102",1779,310,27,0,574,127,785,371,3973
"06037401201",2526,41,41,0,661,0,830,10,4109
"06037401202",2736,315,8,8,1407,288,1621,280,6663
"06037401203",3570,496,200,0,1124,59,1764,373,7586
"06037401303",1589,22,94,0,757,58,527,6,3053
"06037401304",3605,206,60,0,1784,113,1452,23,7243
"06037401311",3923,304,358,1,1629,164,1694,324,8397
"06037401312",3368,322,97,0,1452,46,2273,184,7742
"06037401500",3511,562,311,30,862,96,1951,400,7723
"06037401601",3615,159,118,3,1170,203,1818,98,7184
"06037401602",3685,541,332,86,943,189,2015,532,8323
"06037401603",2217,257,30,8,250,5,659,11,3437
"06037401701",2923,265,220,62,694,3,1002,53,5222
"06037401703",2555,515,359,156,666,99,1587,283,6220
"06037401704",3020,638,350,114,1325,232,2573,406,8658
"06037401800",5955,417,60,4,838,170,1581,123,9148
"06037401901",272,16,0,0,72,10,150,10,530
"06037401902",3841,190,215,1,869,29,626,66,5837
"06037402001",1466,236,290,25,1004,287,993,294,4595
"06037402002",2128,386,270,11,1106,249,1049,152,5351
"06037402101",2426,546,671,128,1047,26,2945,515,8304
"06037402102",3020,493,239,99,899,204,2986,453,8393
"06037402200",2607,543,597,81,1917,757,2896,1139,10537
"06037402301",1824,596,218,34,2558,418,3360,882,9890
"06037402303",1737,555,250,71,878,1019,2220,1293,8023
"06037402304",715,463,139,95,1542,1170,2062,1587,7773
"06037402402",3393,799,485,41,1804,176,3443,628,10769
"06037402403",2009,191,152,0,1716,62,2981,149,7260
"06037402404",13,0,0,0,0,0,0,0,13
"06037402405",1014,268,272,72,1120,136,1976,356,5214
"06037402406",1163,235,324,35,2127,624,2886,826,8220
"06037402501",3301,1223,32,32,623,190,3366,1321,10088
"06037402502",3844,1155,12,114,1327,226,4350,1071,12099
"06037402600",4337,1404,281,312,914,157,3379,1312,12096
"06037402702",2653,1985,276,177,565,688,2911,2473,11728
"06037402703",2770,458,483,184,596,273,2736,549,8049
"06037402705",2079,465,223,33,708,21,2071,355,5955
"06037402706",2424,270,307,86,1024,112,2820,267,7310
"06037402801",2657,1264,0,25,737,557,3202,1785,10227
"06037402803",1853,741,21,0,673,205,2155,918,6566
"06037402804",1943,1187,98,57,682,348,2135,1380,7830
"06037402902",3157,1248,309,55,871,499,3440,1441,11020
"06037402903",2641,441,290,143,889,105,2842,479,7830
"06037402904",1897,584,93,0,560,192,2184,685,6195
"06037403000",4109,1564,297,60,1110,205,3987,1476,12808
"06037403200",53,68,14,41,77,39,8,35,335
"06037403303",991,19,52,7,1509,76,856,23,3533
"06037403304",1163,67,79,0,3408,267,682,38,5704
"06037403305",420,0,18,0,1597,148,150,13,2346
"06037403312",1611,302,366,0,2522,149,1573,254,6777
"06037403316",3227,61,370,0,3596,244,2014,54,9566
"06037403317",1974,47,543,11,1615,213,1132,164,5699
"06037403318",2644,124,698,106,2247,228,1771,96,7914
"06037403319",1402,118,380,31,2273,170,885,22,5281
"06037403320",1243,103,20,0,3751,212,892,45,6266
"06037403321",2212,93,162,81,3561,90,1621,37,7857
"06037403322",1331,71,60,35,2053,236,734,21,4541
"06037403323",1384,150,25,0,3187,391,522,130,5789
"06037403324",1691,116,176,0,4422,261,710,16,7392
"06037403325",1653,35,191,0,2928,202,879,7,5895
"06037403401",1499,147,105,1,3412,309,1414,338,7225
"06037403402",791,0,103,1,2609,196,796,1,4497
"06037403403",980,0,183,0,3602,199,703,0,5667
"06037403404",522,20,49,0,1785,167,254,14,2811
"06037403405",426,1,0,0,1381,5,238,1,2052
"06037403406",840,57,73,0,1635,315,512,38,3470
"06037403407",523,36,32,0,1217,256,284,36,2384
"06037403408",1068,30,238,0,4734,236,1154,32,7492
"06037403500",931,49,61,0,560,17,529,17,2164
"06037403600",4250,338,262,3,2209,87,3329,78,10556
"06037403702",1915,125,167,34,1338,0,1699,80,5358
"06037403703",2935,164,96,73,1459,64,1922,142,6855
"06037403721",2717,233,119,5,1790,124,2363,212,7563
"06037403722",1935,372,94,126,2515,628,3055,788,9513
"06037403801",2867,536,360,0,2132,116,2409,183,8603
"06037403802",2898,360,53,55,2130,254,2799,351,8900
"06037403901",2286,137,85,9,793,47,1629,53,5039
"06037403902",3055,510,133,13,766,91,1657,270,6495
"06037404000",1662,315,17,73,2590,202,2563,348,7770
"06037404100",2547,648,95,0,2400,232,4130,765,10817
"06037404201",966,284,24,32,1495,1083,1900,1184,6968
"06037404202",644,308,57,24,1277,357,1296,412,4375
"06037404301",1537,361,160,6,3026,881,3906,1171,11048
"06037404302",829,179,18,0,909,67,1443,193,3638
"06037404401",1436,336,13,10,1710,379,2637,666,7187
"06037404402",1725,45,0,9,2553,443,2945,483,8203
"06037404501",715,107,67,25,1524,179,1951,255,4823
"06037404503",1101,36,0,23,1789,166,2021,199,5335
"06037404504",1450,241,8,101,2549,540,3342,699,8930
"06037404600",631,140,27,8,687,37,1269,175,2974
"06037404701",1738,526,14,0,2794,459,3613,937,10081
"06037404702",1220,360,65,66,3399,1486,3721,1548,11865
"06037404703",819,255,82,0,1717,454,2309,687,6323
"06037404801",1916,345,282,0,4041,880,4349,1022,12835
"06037404802",986,359,165,4,2902,320,2683,431,7850
"06037404803",288,63,14,0,1016,235,1042,242,2900
"06037404901",1806,315,71,2,3322,300,3985,560,10361
"06037404902",1381,315,12,0,2100,470,2273,686,7237
"06037404903",1197,232,17,12,843,341,1509,416,4567
"06037405001",2243,390,36,2,3412,283,4878,642,11886
"06037405002",1138,174,0,0,1823,398,2650,559,6742
"06037405101",1516,379,4,18,2339,412,2822,728,8218
"06037405102",1453,160,78,0,2132,811,2803,806,8243
"06037405201",1507,156,18,22,2757,804,3368,835,9467
"06037405202",1587,213,27,89,3131,236,3689,461,9433
"06037405203",1158,83,6,0,1684,272,1955,166,5324
"06037405301",1380,157,116,13,1589,328,1978,440,6001
"06037405302",1824,101,103,25,3280,705,3670,732,10440
"06037405400",2039,367,0,0,2932,380,3911,710,10339
"06037405500",2562,348,202,73,2892,463,3613,353,10506
"06037405600",2276,143,121,0,2770,110,3365,108,8893
"06037405701",1848,155,39,15,1546,43,2422,180,6248
"06037405702",1634,394,47,31,2366,499,2737,572,8280
"06037405800",2518,746,151,0,2247,203,3389,831,10085
"06037405900",1888,70,191,76,1494,135,2229,178,6261
"06037406000",2629,365,110,42,1850,357,2782,500,8635
"06037406101",1383,153,240,24,1394,160,1808,148,5310
"06037406102",3094,341,143,14,1534,412,2686,496,8720
"06037406200",1900,551,188,125,2140,782,2481,987,9154
"06037406300",1699,445,185,14,3086,166,1796,395,7786
"06037406402",1355,17,45,1,692,10,1117,6,3243
"06037406411",952,85,4,0,932,63,1063,55,3154
"06037406412",830,52,149,0,1502,0,1298,10,3841
"06037406500",2417,249,431,32,2916,327,3687,390,10449
"06037406601",2021,136,328,124,2546,218,3088,62,8523
"06037406602",1916,147,60,0,2858,478,3049,506,9014
"06037406701",1425,74,124,5,1881,31,2291,70,5901
"06037406702",1984,436,213,35,3026,362,3026,483,9565
"06037406800",2015,41,129,0,2344,529,2687,532,8277
"06037406901",1869,539,48,0,1661,323,2959,729,8128
"06037406902",1504,125,50,39,1668,66,2600,155,6207
"06037407001",2001,457,19,46,2836,289,4264,655,10567
"06037407002",1405,96,40,2,2027,266,2902,323,7061
"06037407101",2327,202,19,0,1963,541,3959,723,9734
"06037407102",1713,597,51,12,3044,197,4157,645,10416
"06037407200",3814,336,13,59,2550,394,5880,646,13692
"06037407301",2846,224,24,1,1603,61,3739,247,8745
"06037407302",1891,284,130,0,1139,287,2462,512,6705
"06037407400",457,142,58,7,1273,110,960,171,3178
"06037407501",2584,379,220,1,971,283,2780,577,7795
"06037407502",1839,454,0,0,1738,228,2920,635,7814
"06037407601",1817,285,28,12,1689,434,2885,642,7792
"06037407602",2448,353,26,4,1227,185,3303,392,7938
"06037407701",2167,860,62,189,1457,382,3145,1129,9391
"06037407702",3150,227,83,16,2710,307,4562,494,11549
"06037407801",2343,266,33,7,1917,349,3367,487,8769
"06037407802",2042,149,66,5,1491,49,2916,143,6861
"06037407900",2194,497,258,15,3004,350,3187,611,10116
"06037408003",2039,345,162,0,2079,159,2499,429,7712
"06037408004",809,5,26,16,1334,180,823,159,3352
"06037408005",1746,44,392,0,2664,231,1889,190,7156
"06037408006",731,186,205,201,2284,210,1391,195,5403
"06037408133",961,604,144,20,3755,527,2283,1038,9332
"06037408134",538,152,306,27,1531,54,715,135,3458
"06037408135",498,71,453,12,2942,347,1267,344,5934
"06037408136",1080,234,112,0,2092,111,1572,254,5455
"06037408137",1233,159,361,29,2182,181,1873,240,6258
"06037408138",3153,1165,170,0,1271,670,3815,1661,11905
"06037408139",2256,475,4,0,1328,62,3427,470,8022
"06037408140",1763,337,41,0,1403,561,2936,873,7914
"06037408141",2475,389,47,2,2120,354,3793,716,9896
"06037408202",825,34,14,0,733,196,1182,209,3193
"06037408211",1510,385,0,2,3262,1137,1955,515,8766
"06037408212",1208,165,11,0,3217,456,1352,57,6466
"06037408301",2422,350,0,0,2066,713,3747,981,10279
"06037408302",1798,208,9,48,1690,48,2833,231,6865
"06037408303",2222,219,24,0,1789,92,3298,287,7931
"06037408401",2324,225,29,0,1908,79,2575,251,7391
"06037408402",2549,163,72,75,2380,177,2329,287,8032
"06037408501",1665,390,58,0,1093,72,2114,380,5772
"06037408503",2705,17,31,0,3133,334,2041,0,8261
"06037408504",2713,102,0,8,2031,282,2853,219,8208
"06037408505",1348,58,11,22,1559,76,1327,15,4416
"06037408623",1037,0,32,0,1797,291,919,54,4130
"06037408624",1055,7,32,0,1931,353,956,7,4341
"06037408625",1664,36,0,0,2344,90,1617,20,5771
"06037408626",993,47,10,4,3063,520,979,89,5705
"06037408627",948,35,17,25,1848,189,767,0,3829
"06037408628",1265,58,22,8,3295,487,1011,42,6188
"06037408629",836,23,121,0,1716,119,498,11,3324
"06037408630",1323,257,0,0,1068,34,1794,257,4733
"06037408631",2470,360,16,14,2098,509,2719,360,8546
"06037408703",954,107,20,0,5430,179,554,9,7253
"06037408704",744,30,47,120,1877,498,1003,23,4342
"06037408705",987,132,34,15,3960,375,1273,176,6952
"06037408706",560,13,7,0,1208,96,285,9,2178
"06037408722",1594,132,24,1,2620,319,1621,104,6415
"06037408723",580,141,0,0,2148,93,675,97,3734
"06037408724",847,164,0,27,3471,989,2562,873,8933
"06037408800",1514,785,176,162,533,629,1409,1052,6260
"06037430002",3452,527,527,37,1758,862,2045,691,9899
"06037430003",2421,132,223,0,1630,14,860,20,5300
"06037430101",2232,355,165,297,1508,202,1753,323,6835
"06037430102",1622,506,219,1,2262,364,2963,746,8683
"06037430200",557,73,24,0,302,38,82,45,1121
"06037430301",3438,198,110,0,663,39,712,13,5173
"06037430302",4492,162,235,1,1335,57,1443,131,7856
"06037430400",2144,48,81,11,2192,244,716,4,5440
"06037430501",3101,129,17,17,1047,12,690,9,5022
"06037430502",4815,327,135,0,1122,336,579,306,7620
"06037430600",1954,73,0,0,2379,172,805,37,5420
"06037430701",2023,87,204,0,2647,195,614,10,5780
"06037430721",981,79,26,2,1963,216,388,20,3675
"06037430723",938,121,0,0,3251,380,627,121,5438
"06037430724",976,159,116,2,3261,453,541,90,5598
"06037430801",1421,223,21,0,4532,560,949,203,7909
"06037430802",1134,23,0,0,2686,232,80,0,4155
"06037430803",1681,50,12,12,3214,410,642,170,6191
"06037430901",1764,88,310,65,1467,405,1649,241,5989
"06037430902",2043,174,374,34,1619,247,1545,222,6258
"06037431001",3721,852,152,128,2115,471,2722,1128,11289
"06037431002",1867,275,223,40,667,34,817,126,4049
"06037431100",3014,179,592,155,2737,334,3512,387,10910
"06037431200",2189,700,424,49,2293,514,3480,988,10637
"06037431300",1716,35,43,8,1049,38,858,23,3770
"06037431400",1412,61,41,0,2204,231,795,81,4825
"06037431501",1302,226,163,0,1770,1004,1174,548,6187
"06037431502",1568,294,15,0,2300,170,1004,286,5637
"06037431600",987,39,11,0,2615,161,200,10,4023
"06037431700",1830,96,22,0,3771,670,298,0,6687
"06037431800",1588,430,207,50,3234,509,927,312,7257
"06037431900",796,108,9,0,2860,393,1095,63,5324
"06037432000",1934,79,22,0,5103,321,894,15,8368
"06037432101",1122,114,0,30,2813,200,848,139,5266
"06037432102",1545,199,6,0,3299,358,948,76,6431
"06037432201",932,82,28,0,2715,625,560,99,5041
"06037432202",938,224,0,0,2420,806,1125,650,6163
"06037432300",1589,148,0,0,2173,288,1957,117,6272
"06037432401",1035,901,29,0,1707,422,1359,974,6427
"06037432402",2142,591,70,63,2600,945,2893,839,10143
"06037432500",2921,748,114,0,4190,716,3615,940,13244
"06037432601",2034,985,5,15,3048,751,2518,1120,10476
"06037432602",1020,330,0,13,2820,459,1815,585,7042
"06037432700",2361,637,14,0,1871,234,3080,858,9055
"06037432801",1098,315,0,0,1289,343,1623,388,5056
"06037432802",1784,803,22,13,2055,528,2732,989,8926
"06037432901",834,78,0,7,3358,660,1000,206,6143
"06037432902",877,114,0,0,2246,270,1368,234,5109
"06037433101",872,140,0,4,1348,157,917,142,3580
"06037433102",1333,709,13,0,1948,643,1734,1024,7404
"06037433200",2568,741,19,0,2407,586,3632,1006,10959
"06037433302",469,240,0,0,794,393,861,587,3344
"06037433304",1514,320,19,0,2487,370,2678,365,7753
"06037433305",1341,1037,0,6,2159,629,2306,1585,9063
"06037433306",1007,363,31,22,1371,481,1600,571,5446
"06037433307",1258,443,25,0,1190,198,1290,490,4894
"06037433401",1274,380,0,0,848,219,1503,368,4592
"06037433402",1447,881,0,0,1813,259,1962,954,7316
"06037433403",1845,1057,0,0,907,632,2291,1537,8269
"06037433501",731,730,0,0,413,101,1075,764,3814
"06037433503",1979,252,0,0,664,202,2158,371,5626
"06037433504",2378,620,3,2,1148,467,2680,886,8184
"06037433601",738,457,0,0,3320,571,654,724,6464
"06037433602",366,74,0,0,1324,830,463,295,3352
"06037433700",2587,154,9,0,780,150,2861,272,6813
"06037433801",3076,1445,0,3,1066,503,3802,1832,11727
"06037433802",1971,134,0,7,799,10,2390,100,5411
"06037433901",1841,938,15,17,1972,1039,2650,1535,10007
"06037433902",1793,638,0,13,1246,112,2415,696,6913
"06037434001",2309,710,14,0,1318,118,3085,776,8330
"06037434003",2532,546,0,5,1048,321,2865,560,7877
"06037434004",1835,572,6,0,436,14,2104,586,5553
"06037460000",3279,387,150,0,844,49,424,39,5172
"06037460100",4252,392,469,72,804,62,730,102,6883
"06037460200",2559,92,2001,171,818,22,657,61,6381
"06037460301",2059,132,1244,139,908,28,841,125,5476
"06037460302",2128,383,1007,515,611,77,1751,330,6802
"06037460401",281,163,404,26,155,5,64,149,1247
"06037460501",3772,93,0,0,1793,24,295,2,5979
"06037460502",2663,168,0,2,1639,1,347,1,4821
"06037460600",3265,0,0,0,1163,52,326,8,4814
"06037460700",3530,44,41,0,1283,93,300,11,5302
"06037460800",2476,57,41,10,466,14,283,0,3347
"06037460900",2995,457,1591,427,1027,271,3144,664,10576
"06037461000",2638,551,1527,66,1161,349,3021,792,10105
"06037461100",1977,500,1042,194,1014,183,1311,459,6680
"06037461200",3419,211,512,61,419,43,831,89,5585
"06037461300",4798,295,268,15,1201,229,1283,333,8422
"06037461400",1826,179,415,29,569,138,576,216,3948
"06037461501",2349,221,678,209,652,185,1743,300,6337
"06037461502",3229,884,972,446,900,409,3272,906,11018
"06037461600",2537,588,1063,421,1039,525,2409,1049,9631
"06037461700",1043,63,156,0,199,4,293,4,1762
"06037461901",1941,762,705,78,1040,357,2160,895,7938
"06037461902",792,162,157,52,176,191,252,122,1904
"06037462001",2008,365,469,139,759,258,2054,422,6474
"06037462002",1714,450,507,9,1158,251,2436,531,7056
"06037462100",2814,931,529,88,797,54,2335,826,8374
"06037462201",1771,598,141,102,756,207,889,305,4769
"06037462202",1532,318,296,0,573,491,96,23,3329
"06037462301",2516,611,304,69,1083,198,2268,437,7486
"06037462302",1069,152,194,48,875,257,403,51,3049
"06037462400",2935,384,162,49,737,84,1366,186,5903
"06037462500",4029,444,412,4,1138,62,888,49,7026
"06037462600",1824,90,110,11,314,43,461,5,2858
"06037462700",2604,403,361,69,1803,123,2064,171,7598
"06037462800",1289,171,210,100,797,79,769,39,3454
"06037462900",2276,177,280,16,941,79,881,79,4729
"06037463000",1365,77,170,0,556,11,374,56,2609
"06037463101",1399,90,27,11,875,114,865,153,3534
"06037463102",1525,411,21,12,1545,79,801,324,4718
"06037463200",1750,299,222,9,917,81,756,141,4175
"06037463300",1433,39,143,0,518,10,325,0,2468
"06037463400",2767,245,298,23,1828,281,933,67,6442
"06037463500",2597,209,100,44,1786,391,806,43,5976
"06037463601",2792,309,235,114,2316,161,819,88,6834
"06037463602",2367,513,357,150,1393,466,732,120,6098
"06037463700",1430,191,161,36,570,74,299,100,2861
"06037463800",2641,68,148,0,943,40,479,40,4359
"06037463900",2369,62,60,3,544,202,450,120,3810
"06037464000",3893,107,161,0,1375,222,996,15,6769
"06037464100",3345,193,0,17,3465,309,833,34,8196
"06037464200",2033,109,0,0,3414,409,334,98,6397
"06037480002",1207,62,0,1,2188,66,635,8,4167
"06037480011",1134,90,118,0,3630,422,1427,58,6879
"06037480012",1575,53,9,0,3036,362,735,44,5814
"06037480101",860,81,1,0,2997,400,879,128,5346
"06037480102",1046,59,0,1,3077,375,1213,142,5913
"06037480201",1938,8,0,9,2016,39,1300,0,5310
"06037480202",1295,0,34,0,1354,29,715,0,3427
"06037480302",1285,137,278,37,2147,356,1408,129,5777
"06037480303",696,126,78,36,2527,651,1342,377,5833
"06037480304",456,138,110,11,2469,761,857,212,5014
"06037480400",1827,137,20,0,2779,441,1166,343,6713
"06037480500",3072,72,56,0,2062,160,884,60,6366
"06037480600",4123,347,231,14,2422,470,1491,403,9501
"06037480702",2413,107,35,26,1991,111,1075,56,5814
"06037480703",1861,160,75,0,1189,27,694,0,4006
"06037480704",1810,160,31,25,2348,336,794,57,5561
"06037480802",947,54,38,11,1938,200,1573,86,4847
"06037480803",1713,79,0,0,1980,110,1875,93,5850
"06037480804",875,141,59,7,3512,763,1937,423,7717
"06037480901",852,83,80,1,3018,479,1228,121,5862
"06037480902",659,219,6,0,2691,551,1494,294,5914
"06037480903",499,5,37,0,1700,656,963,111,3971
"06037481001",787,37,29,0,2424,565,1216,168,5226
"06037481002",673,106,0,49,4313,528,2226,76,7971
"06037481101",591,100,0,0,2498,380,1211,102,4882
"06037481102",455,52,58,0,2354,574,824,252,4569
"06037481103",890,82,8,0,3523,511,1775,163,6952
"06037481201",557,47,67,0,2682,237,523,17,4130
"06037481202",1091,104,56,26,3577,737,1674,308,7573
"06037481300",493,86,0,1,2243,639,746,350,4558
"06037481401",520,107,0,0,4353,831,916,111,6838
"06037481402",1178,105,43,3,5025,1068,1127,128,8677
"06037481500",633,123,0,0,2777,762,676,96,5067
"06037481603",444,96,8,16,2609,579,543,84,4379
"06037481604",762,17,71,0,2621,579,1054,46,5150
"06037481605",545,40,0,0,2032,458,723,78,3876
"06037481606",737,90,52,0,2901,1139,940,288,6147
"06037481711",198,38,19,0,2934,893,210,27,4319
"06037481712",252,216,0,7,3363,1357,638,459,6292
"06037481713",66,0,0,0,2132,590,242,118,3148
"06037481714",150,54,55,0,1667,705,241,93,2965
"06037481800",798,20,8,0,1747,258,626,32,3489
"06037481901",1838,220,22,11,3896,198,2422,161,8768
"06037481902",1106,15,28,0,2205,179,2013,69,5615
"06037482001",385,73,0,0,2135,142,245,0,2980
"06037482002",1016,45,0,0,4573,960,2002,494,9090
"06037482101",1143,15,0,0,3068,673,1599,114,6612
"06037482102",689,33,50,0,1708,349,844,149,3822
"06037482201",331,51,0,0,3266,466,1011,43,5168
"06037482202",559,46,34,0,3411,800,861,150,5861
"06037482301",970,174,0,0,2977,1208,687,409,6425
"06037482303",877,424,0,0,3692,1023,1539,632,8187
"06037482304",450,367,0,0,2199,362,1274,355,5007
"06037482401",769,179,0,0,2680,437,1696,181,5942
"06037482402",1456,216,0,0,5110,385,2000,235,9402
"06037482502",350,68,0,0,1821,900,502,202,3843
"06037482503",566,258,0,0,2478,914,925,342,5483
"06037482521",1070,276,45,50,3319,279,1753,277,7069
"06037482522",1568,78,24,3,2402,368,1499,220,6162
"06037482600",1622,356,64,1,4460,215,1697,354,8769
"06037482701",1234,199,51,0,2778,393,2454,359,7468
"06037482702",731,96,2,0,1411,159,980,123,3502
"06037482800",1070,181,15,0,2761,526,1834,464,6851
"06037500100",2821,75,24,8,859,10,773,13,4583
"06037500201",4418,273,0,0,1446,36,2492,36,8701
"06037500202",3006,53,38,0,1626,136,2214,151,7224
"06037500300",1589,220,10,8,1375,102,1779,141,5224
"06037500402",1709,423,31,14,1871,337,3419,774,8578
"06037500403",2556,248,77,0,1255,340,3402,538,8416
"06037500404",2258,207,167,0,1877,512,3623,693,9337
"06037500500",1132,155,55,0,1362,196,2213,297,5410
"06037500600",1986,838,41,0,2656,938,4314,1757,12530
"06037500700",3511,245,0,0,2264,330,5378,512,12240
"06037500800",2544,550,163,26,2213,267,4400,723,10886
"06037500900",1992,448,19,54,2130,654,3653,1033,9983
"06037501001",1166,63,0,0,1686,351,2801,404,6471
"06037501002",2252,296,149,0,2197,106,3585,337,8922
"06037501200",2496,277,98,48,1898,339,3577,464,9197
"06037501300",3626,106,32,36,2751,700,4548,673,12472
"06037501400",1265,398,9,0,2030,386,2876,725,7689
"06037501501",1486,91,38,0,708,12,1270,36,3641
"06037501503",2128,355,182,0,1726,346,2692,619,8048
"06037501504",1330,320,0,31,1422,496,2160,617,6376
"06037501600",4132,217,0,0,2068,451,3345,506,10719
"06037501700",2790,383,24,0,647,72,1974,416,6306
"06037501802",1980,127,7,0,1337,193,2394,247,6285
"06037501803",999,661,72,50,1825,928,2412,1475,8422
"06037501804",903,333,13,0,546,179,1155,414,3543
"06037501900",2328,165,0,0,1566,65,2626,131,6881
"06037502003",1242,61,7,20,1293,396,2170,451,5640
"06037502004",1311,265,114,15,1766,471,2844,699,7485
"06037502005",2089,174,79,0,1937,179,2872,241,7571
"06037502100",2943,232,51,0,1855,208,4117,371,9777
"06037502200",3146,336,0,9,2699,232,4992,462,11876
"06037502301",2731,547,15,1,2813,199,5165,744,12215
"06037502302",901,356,22,8,1193,450,1905,748,5583
"06037502401",1937,289,37,0,2501,150,4206,439,9559
"06037502402",1670,232,0,6,1444,243,2866,463,6924
"06037502500",1605,213,34,8,1392,529,2651,742,7174
"06037502601",3745,368,0,0,3192,78,6493,370,14246
"06037502602",1758,111,9,0,2406,325,3826,396,8831
"06037502700",3341,453,80,7,2468,84,5080,446,11959
"06037502801",3848,390,389,2,2063,148,4799,475,12114
"06037502802",738,202,106,16,598,211,993,231,3095
"06037502901",2528,141,111,0,2546,157,4198,120,9801
"06037502902",1620,785,13,11,1391,579,2683,1257,8339
"06037503000",2553,670,0,0,1816,742,3988,1376,11145
"06037503103",2677,408,12,0,2077,183,3886,539,9782
"06037503104",1067,392,43,0,988,200,1762,557,5009
"06037503105",2332,300,7,0,903,237,2396,429,6604
"06037503106",2045,153,34,8,1105,77,2400,130,5952
"06037503201",2758,226,38,0,1101,8,2660,57,6848
"06037503202",2255,288,69,0,1685,421,2777,634,8129
"06037503301",1747,274,0,0,890,76,1748,156,4891
"06037503302",3175,318,25,11,2395,266,3819,534,10543
"06037503401",4186,309,140,9,1947,247,3284,271,10393
"06037503402",2824,175,42,0,1265,63,2247,105,6721
"06037503501",3360,660,54,5,2051,474,3762,767,11133
"06037503502",2555,272,0,0,1117,175,2274,227,6620
"06037503601",2767,94,21,0,1022,34,1774,47,5759
"06037503602",2329,161,90,1,1120,167,1411,219,5498
"06037503701",3750,217,15,0,1236,127,2884,136,8365
"06037503702",3109,219,1,0,1515,188,2294,311,7637
"06037503703",2935,158,198,0,4071,361,1608,35,9366
"06037503801",2283,279,24,0,1512,47,1700,151,5996
"06037503802",2378,212,223,13,1906,242,1728,275,6977
"06037503901",1406,56,54,0,1250,50,1290,55,4161
"06037503902",2306,114,84,0,2065,39,1569,54,6231
"06037504001",2125,195,51,0,1030,19,1318,48,4786
"06037504002",3291,117,106,0,1635,160,2244,122,7675
"06037504101",2376,214,95,34,2270,470,3033,515,9007
"06037504102",0,0,0,0,0,0,0,0,0
"06037530003",1888,111,8,0,941,90,1688,76,4802
"06037530004",2269,588,0,0,1137,68,2227,539,6828
"06037530005",1868,84,40,0,2751,154,1512,102,6511
"06037530006",2496,326,0,0,932,56,2198,334,6342
"06037530101",2547,776,50,53,1849,427,3958,976,10636
"06037530102",3272,470,7,13,936,223,3379,352,8652
"06037530202",2270,167,65,0,1385,179,3074,260,7400
"06037530203",1733,123,5,1,942,221,2089,248,5362
"06037530204",2256,640,27,0,771,158,2701,789,7342
"06037530301",1445,337,0,0,450,117,1864,434,4647
"06037530302",3468,903,0,9,2039,498,5295,1378,13590
"06037530400",1386,859,8,92,1305,224,1943,979,6796
"06037530500",2039,661,9,0,1235,576,3161,1222,8903
"06037530601",1655,267,0,0,1526,486,3016,753,7703
"06037530602",565,46,0,0,613,273,1099,319,2915
"06037530700",790,202,0,0,744,504,1442,684,4366
"06037530801",1318,842,0,0,2327,1086,3401,1874,10848
"06037530802",843,411,26,2,1845,345,2660,757,6889
"06037530901",1057,139,0,0,1867,881,2898,999,7841
"06037530902",968,404,8,3,1884,1082,2753,1397,8499
"06037531000",2704,458,0,0,1793,444,4403,847,10649
"06037531101",1758,341,36,0,1401,857,3072,1128,8593
"06037531102",970,260,0,0,1336,617,2238,862,6283
"06037531201",1943,360,66,0,1974,853,3900,1213,10309
"06037531202",1239,740,0,0,1668,593,2899,1299,8438
"06037531301",1676,1057,20,6,1679,1063,3329,2099,10929
"06037531302",2283,1150,57,0,2527,1132,4740,2282,14171
"06037531502",1493,686,0,0,1127,304,2580,976,7166
"06037531503",1259,841,0,47,916,471,2169,1321,7024
"06037531504",2082,774,0,0,1210,596,3227,1370,9259
"06037531602",2557,906,60,0,1434,250,3992,1148,10347
"06037531603",1866,577,0,13,1137,180,2929,728,7430
"06037531604",1711,683,0,9,836,503,2504,1195,7441
"06037531701",2793,1039,33,0,986,497,3663,1536,10547
"06037531702",2834,758,0,0,475,438,3274,1186,8965
"06037531800",2399,1138,0,0,1217,232,3578,1312,9876
"06037531901",4298,1355,48,0,890,341,5043,1696,13671
"06037531902",2429,427,0,0,752,223,3149,631,7611
"06037532001",2210,342,154,23,400,74,2469,363,6035
"06037532002",1882,426,0,0,594,172,2203,520,5797
"06037532101",3504,1025,80,0,1070,656,4384,1635,12354
"06037532102",2570,257,39,1,920,62,2909,263,7021
"06037532200",4173,719,92,89,1077,249,4829,970,12198
"06037532302",2628,494,0,0,1042,265,3579,748,8756
"06037532303",2872,395,47,0,873,266,3541,653,8647
"06037532304",2408,796,97,237,708,412,3005,1040,8703
"06037532400",10,2,0,0,46,1,45,3,107
"06037532500",1710,710,100,0,936,428,2603,945,7432
"06037532603",1382,501,0,25,837,477,2215,990,6427
"06037532604",1360,408,0,0,734,356,2060,753,5671
"06037532605",1944,787,31,0,788,607,2672,1263,8092
"06037532606",2179,1324,23,0,1026,232,3154,1545,9483
"06037532700",1246,412,48,0,903,346,2109,748,5812
"06037532800",1490,1212,145,77,1003,514,2461,1726,8628
"06037532900",2019,1768,306,113,1554,1089,3589,2862,13300
"06037533001",1043,518,51,24,1597,636,2640,1103,7612
"06037533002",1228,410,0,0,823,158,2019,564,5202
"06037533103",1130,953,0,0,929,513,2035,1414,6974
"06037533104",1385,1447,9,0,1060,736,2386,2176,9199
"06037533105",1120,727,0,0,189,283,1279,994,4592
"06037533106",991,409,8,0,216,73,1209,482,3388
"06037533107",1989,858,87,11,533,163,2516,1032,7189
"06037533201",1384,462,0,0,690,258,2036,714,5544
"06037533202",1221,400,0,0,764,66,1954,456,4861
"06037533203",691,436,0,0,503,88,1126,523,3367
"06037533300",1904,749,0,0,430,318,2257,1050,6708
"06037533401",3327,1445,10,0,489,100,3770,1545,10686
"06037533402",2485,913,0,0,770,41,3255,954,8418
"06037533403",1491,728,0,10,561,62,1990,792,5634
"06037533501",1882,671,0,0,373,352,2252,1013,6543
"06037533502",1299,322,0,0,567,61,1837,383,4469
"06037533503",1239,332,0,0,275,229,1504,548,4127
"06037533601",2047,1036,0,18,896,474,2863,1481,8815
"06037533602",2698,1275,12,0,1054,348,3492,1517,10396
"06037533603",3352,963,21,72,1657,741,4783,1676,13265
"06037533701",2119,950,12,40,648,225,2717,1170,7881
"06037533702",1696,870,13,0,733,255,2399,1115,7081
"06037533703",2325,1049,7,21,501,151,2771,1198,8023
"06037533803",2973,1240,91,0,1580,323,4280,1367,11854
"06037533804",2223,722,11,2,1073,343,3032,1041,8447
"06037533805",2062,751,0,0,739,283,2583,1019,7437
"06037533806",2173,905,0,0,437,406,2539,1311,7771
"06037533901",3305,1194,15,0,987,564,4228,1758,12051
"06037533902",2093,632,0,46,1165,250,3188,922,8296
"06037534001",2238,1592,0,10,1129,311,3296,1858,10434
"06037534002",2097,709,69,30,1266,104,3245,835,8355
"06037534101",1227,346,11,17,440,134,1510,464,4149
"06037534102",3168,1428,8,127,1341,545,4407,1968,12992
"06037534201",2176,1116,10,0,750,384,2894,1398,8728
"06037534202",2914,1293,0,9,1203,457,4020,1698,11594
"06037534203",1919,735,0,42,524,150,2352,907,6629
"06037534301",1435,1451,0,26,1146,650,2462,2086,9256
"06037534302",1963,899,0,0,638,366,2583,1265,7714
"06037534403",1651,330,25,51,689,145,2313,526,5730
"06037534404",1493,866,21,0,808,244,2099,1104,6635
"06037534405",1759,573,21,0,1197,327,2880,894,7651
"06037534406",2491,1445,12,0,737,484,3202,1892,10263
"06037534501",3048,524,5,1,1069,264,3975,759,9645
"06037534502",2511,883,0,0,593,328,3068,1211,8594
"06037534700",3226,616,7,0,801,88,3988,633,9359
"06037534802",1530,216,0,0,853,191,2282,392,5464
"06037534803",2011,964,0,0,1085,445,2983,1382,8870
"06037534804",1869,878,4,0,1008,150,2844,1004,7757
"06037534900",2848,1001,18,15,1441,949,4275,1926,12473
"06037535001",1339,585,208,111,1389,806,2728,1332,8498
"06037535002",1326,549,209,121,487,596,1800,1080,6168
"06037535101",2509,655,1165,275,1815,1295,4211,1958,13883
"06037535102",1331,592,793,423,791,752,2150,1291,8123
"06037535200",2410,928,491,332,1155,548,3526,1400,10790
"06037535300",2836,1258,191,90,1445,370,4263,1620,12073
"06037535400",1444,791,142,192,522,398,1910,1182,6581
"06037535501",1383,454,40,0,1596,570,2948,1021,8012
"06037535502",1204,376,0,74,2422,667,3550,1082,9375
"06037535503",998,339,0,0,567,614,1537,929,4984
"06037535603",1092,251,47,14,1349,489,2441,740,6423
"06037535604",1198,549,0,0,2076,701,3256,1250,9030
"06037535605",1650,345,46,19,1714,670,3309,1011,8764
"06037535606",488,148,10,0,728,555,1186,703,3818
"06037535607",1770,214,37,11,1992,377,3737,593,8731
"06037535701",3007,851,0,0,2200,372,5003,1223,12656
"06037535702",1428,537,88,0,1553,904,2851,1434,8795
"06037535802",2805,499,54,0,2544,989,5200,1472,13563
"06037535803",1432,564,0,0,1607,756,2961,1320,8640
"06037535804",1730,657,13,17,2269,537,3833,1194,10250
"06037535901",2017,362,73,0,2744,424,4753,768,11141
"06037535902",4271,230,0,0,3211,247,7165,471,15595
"06037536000",1406,292,48,4,1967,373,3304,661,8055
"06037536102",1833,399,103,0,617,128,2117,419,5616
"06037536103",2684,432,16,2,1927,486,4400,918,10865
"06037536104",1918,451,26,50,1386,335,3069,779,8014
"06037536200",3618,719,83,8,2259,929,4984,1537,14137
"06037540000",2166,656,151,188,3488,779,5598,1513,14539
"06037540101",2804,740,468,28,1983,349,4577,1065,12014
"06037540102",2160,272,464,131,2807,313,4990,566,11703
"06037540201",558,385,7,25,471,471,1008,790,3715
"06037540202",2099,983,131,182,1915,1551,3900,2352,13113
"06037540203",1821,431,274,23,2045,917,3801,1332,10644
"06037540300",2031,476,0,27,2061,577,3984,1051,10207
"06037540400",693,297,133,348,667,319,1281,607,4345
"06037540501",1410,361,343,7,2208,1426,3535,1786,11076
"06037540502",1964,749,514,158,2318,1055,4258,1692,12708
"06037540600",1239,240,1040,452,835,366,2001,478,6651
"06037540700",585,102,1326,235,635,256,1138,309,4586
"06037540800",561,125,2994,347,1178,241,1606,354,7406
"06037540901",964,263,1109,477,1225,265,2112,478,6893
"06037540902",1253,240,2469,463,384,135,1554,375,6873
"06037541001",171,42,362,73,333,87,320,117,1505
"06037541002",1109,13,1355,94,914,138,1378,138,5139
"06037541100",505,50,1175,314,602,137,988,156,3927
"06037541200",1003,646,3436,566,470,44,1329,690,8184
"06037541300",1890,349,1506,610,1402,348,3105,678,9888
"06037541400",1410,1615,638,637,2085,1043,3434,2658,13520
"06037541500",2627,799,424,136,854,574,3332,1328,10074
"06037541603",833,543,278,225,612,663,1422,1235,5811
"06037541604",1580,1175,571,610,1155,1016,2691,2212,11010
"06037541605",1529,562,963,239,1747,510,3271,1057,9878
"06037541606",700,506,134,86,773,198,1341,698,4436
"06037541700",1698,373,642,115,2464,952,4115,1320,11679
"06037541801",863,821,497,426,1949,533,2735,1333,9157
"06037541802",1126,521,384,88,2472,547,3569,1075,9782
"06037542000",932,668,1243,215,1876,563,2808,1082,9387
"06037542103",1270,700,467,137,1221,332,2459,1020,7606
"06037542104",1220,269,458,18,1362,307,2444,576,6654
"06037542105",1930,799,183,202,1241,538,3001,1316,9210
"06037542106",1263,334,289,151,847,454,2099,739,6176
"06037542200",1821,879,1261,309,2138,571,3906,1413,12298
"06037542401",1308,468,1999,282,843,187,2005,665,7757
"06037542402",1079,139,1157,46,652,198,1708,341,5320
"06037542501",775,385,1704,729,643,551,1300,827,6914
"06037542502",935,385,1105,371,560,765,1457,1150,6728
"06037542601",984,280,200,285,797,415,1678,722,5361
"06037542602",1382,1066,1051,398,1683,303,3074,1291,10248
"06037542700",1735,1001,1174,179,1052,445,2752,1425,9763
"06037542800",1024,48,1375,179,602,45,1438,100,4811
"06037542900",798,190,494,222,832,260,1624,412,4832
"06037543000",743,140,2272,135,1061,69,1652,206,6278
"06037543100",2062,339,2816,291,948,500,2784,677,10417
"06037543201",829,464,1150,461,873,152,1617,592,6138
"06037543202",1624,369,673,292,998,622,2591,862,8031
"06037543304",437,19,4225,432,1130,168,774,49,7234
"06037543305",1028,402,866,36,614,166,859,376,4347
"06037543306",1851,77,1091,98,3340,343,1855,0,8655
"06037543321",674,236,2905,212,1340,130,472,322,6291
"06037543322",366,34,3960,484,1493,39,743,38,7157
"06037543400",1348,168,554,77,1800,308,2083,362,6700
"06037543501",1222,457,306,173,4042,522,1652,376,8750
"06037543502",1693,238,112,33,1756,99,1623,169,5723
"06037543503",1512,50,520,85,2636,158,1106,12,6079
"06037543601",1468,93,399,28,2081,120,1646,126,5961
"06037543602",1819,461,702,12,3873,576,2005,699,10147
"06037543603",1465,98,883,38,1113,34,587,20,4238
"06037543604",1841,648,137,0,3085,196,2305,544,8756
"06037543701",834,58,4,0,1844,165,1069,89,4063
"06037543702",2134,394,139,13,4023,634,3219,607,11163
"06037543703",1431,50,89,1,1446,245,1694,117,5073
"06037543801",1627,363,74,26,3251,264,2600,335,8540
"06037543802",1236,156,723,69,4130,426,1756,254,8750
"06037543903",1232,334,63,41,1999,159,1356,339,5523
"06037543905",1553,366,552,222,1487,197,2479,496,7352
"06037544001",1937,570,141,23,1328,330,2334,636,7299
"06037544002",1559,37,105,0,1074,15,1804,7,4601
"06037550000",238,289,137,41,149,57,191,103,1205
"06037550100",4592,261,218,13,2309,392,5833,259,13877
"06037550201",1814,94,61,0,629,192,1816,180,4786
"06037550202",2938,537,282,8,1713,48,3604,488,9618
"06037550300",3077,511,15,0,3651,184,5134,500,13072
"06037550400",928,41,0,0,523,11,855,50,2408
"06037550500",5691,551,301,0,1198,33,5049,392,13215
"06037550601",3175,386,228,0,1511,387,3509,715,9911
"06037550602",3018,37,16,0,1503,0,3095,0,7669
"06037550700",5384,143,50,3,1264,119,4798,142,11903
"06037550800",3548,418,145,1,2708,139,4663,481,12103
"06037550901",1998,324,184,46,1371,171,2527,382,7003
"06037550902",3027,471,174,0,1931,116,3851,402,9972
"06037551000",3874,344,0,0,2305,251,3869,521,11164
"06037551101",1207,545,247,62,1532,675,2308,1055,7631
"06037551102",1661,860,381,35,1751,453,2919,1246,9306
"06037551201",2593,19,129,60,1150,12,2718,88,6769
"06037551202",3951,490,365,141,1777,320,4585,614,12243
"06037551300",2964,667,247,62,1123,313,3069,875,9320
"06037551401",3162,543,33,41,774,273,2865,777,8468
"06037551402",2645,70,125,0,1446,232,2902,100,7520
"06037551501",2013,206,281,24,2100,357,3026,353,8360
"06037551502",2078,609,0,23,1499,202,2384,388,7183
"06037551600",0,0,0,0,0,0,0,0,0
"06037551700",3067,219,278,0,2258,476,4458,581,11337
"06037551800",2807,456,362,35,3316,449,4118,841,12384
"06037551900",2437,514,150,102,1763,218,2893,677,8754
"06037552001",1917,367,119,2,1457,52,2314,372,6600
"06037552002",1470,144,266,14,1462,481,2143,532,6512
"06037552100",2582,186,194,32,2631,568,3779,328,10300
"06037552200",2214,446,360,90,2362,763,3971,1169,11375
"06037552301",1849,546,258,18,2084,55,2612,564,7986
"06037552302",1148,135,242,35,1596,225,1449,273,5103
"06037552400",1556,90,30,0,1017,109,2317,149,5268
"06037552601",2915,543,0,3,1772,254,4317,636,10440
"06037552602",1054,730,46,0,2237,503,1313,1132,7015
"06037552700",3965,607,109,24,1842,319,4276,722,11864
"06037552800",2690,797,168,36,1723,639,3200,1222,10475
"06037552900",2876,626,113,205,2727,392,3379,841,11159
"06037553000",2994,69,437,0,1439,235,3324,240,8738
"06037553100",2819,311,808,214,2353,405,2821,507,10238
"06037553200",2950,396,347,123,3490,236,4325,530,12397
"06037553300",1402,142,94,4,1086,558,1521,638,5445
"06037553400",1845,151,72,13,1277,301,2690,225,6574
"06037553502",1775,614,297,40,870,519,2445,1104,7664
"06037553503",978,187,193,161,1194,114,1824,287,4938
"06037553504",2468,896,243,198,1531,688,3621,1373,11018
"06037553601",2066,245,349,144,1763,344,3547,414,8872
"06037553602",1437,293,736,165,1862,414,2728,634,8269
"06037553701",1420,469,41,0,1556,596,2867,1043,7992
"06037553702",1091,509,223,75,2414,480,3431,979,9202
"06037553801",1297,311,653,114,1014,615,1990,968,6962
"06037553802",1281,797,668,253,1869,1232,2484,1821,10405
"06037553901",2547,654,369,80,2493,542,4260,1095,12040
"06037553902",1574,537,362,187,2400,834,3380,1332,10606
"06037554001",1639,100,71,31,1536,343,1811,426,5957
"06037554002",1555,340,481,11,2420,668,2663,600,8738
"06037554101",1398,671,34,20,1416,453,2028,1050,7070
"06037554103",537,7,156,16,1087,27,1041,27,2898
"06037554104",1237,103,369,164,430,71,801,131,3306
"06037554105",992,624,803,602,1362,181,1802,393,6759
"06037554201",1361,205,434,54,1421,395,1540,524,5934
"06037554203",1530,487,431,27,1225,146,1396,507,5749
"06037554204",1402,481,435,91,1245,624,1845,616,6739
"06037554301",1450,146,364,139,1093,314,2092,338,5936
"06037554302",802,135,929,60,1322,603,1412,665,5928
"06037554403",826,416,1014,219,2194,749,1883,816,8117
"06037554404",815,186,688,181,1915,487,1550,430,6252
"06037554405",995,280,785,87,928,152,1106,272,4605
"06037554406",2348,242,610,24,1414,171,1495,89,6393
"06037554511",639,38,303,0,3050,73,235,0,4338
"06037554512",1142,10,216,27,4392,56,291,9,6143
"06037554513",299,2,301,1,1885,66,231,0,2785
"06037554514",1315,19,440,111,2740,149,893,17,5684
"06037554515",1094,11,182,0,2457,83,394,0,4221
"06037554516",723,85,430,0,2359,169,455,47,4268
"06037554517",646,33,220,3,3452,175,299,43,4871
"06037554518",990,85,226,0,3908,147,618,22,5996
"06037554519",760,52,120,0,2454,142,330,0,3858
"06037554521",1987,128,576,4,3076,202,908,11,6892
"06037554522",1151,104,396,42,3463,75,986,120,6337
"06037554600",1663,464,88,178,1903,336,1606,628,6866
"06037554700",2229,493,189,0,1801,275,3379,651,9017
"06037554801",1532,206,31,3,1451,262,2508,450,6443
"06037554802",2151,87,219,108,3046,366,1575,172,7724
"06037554900",2256,153,115,18,3572,677,1402,134,8327
"06037555001",1408,743,434,5,2695,360,1769,768,8182
"06037555002",1350,244,277,43,1101,176,1118,244,4553
"06037555102",1630,389,595,48,3280,952,2337,1056,10287
"06037555103",1261,22,432,54,2355,380,1326,214,6044
"06037555104",1688,314,224,0,1756,73,1231,237,5523
"06037555202",2476,138,123,1,639,64,748,3,4192
"06037555211",2621,1090,26,0,1289,450,3499,1400,10375
"06037555212",1903,1382,74,25,1178,320,2183,1446,8511
"06037570001",2443,169,144,1,1717,48,1135,76,5733
"06037570002",1335,179,135,24,1246,25,1207,46,4197
"06037570003",2111,242,418,0,1924,93,1483,82,6353
"06037570100",920,182,741,305,1093,94,342,32,3709
"06037570202",1716,441,664,187,2533,833,3106,947,10427
"06037570203",595,263,643,442,1422,236,1604,377,5582
"06037570204",971,155,618,158,1137,719,1262,636,5656
"06037570301",2567,761,686,124,2754,501,4086,919,12398
"06037570303",1072,406,336,334,1726,386,2156,659,7075
"06037570304",973,550,618,496,1698,719,1873,1095,8022
"06037570402",642,65,1136,181,1116,298,1278,368,5084
"06037570403",805,1103,825,59,1914,403,2553,1399,9061
"06037570404",1017,271,566,267,1000,174,1749,383,5427
"06037570501",3066,350,990,161,3106,258,4040,417,12388
"06037570502",1726,409,639,150,2887,621,2745,595,9772
"06037570601",1538,179,656,364,1890,526,2352,367,7872
"06037570602",1940,588,439,321,2723,673,2791,757,10232
"06037570603",527,225,1462,1010,989,614,1047,458,6332
"06037570701",2109,261,830,61,2706,382,1366,505,8220
"06037570702",1209,111,171,39,905,0,1025,65,3525
"06037570800",3530,254,168,0,1843,46,1872,13,7726
"06037570901",3458,99,209,24,1754,93,1580,47,7264
"06037570902",2468,61,231,0,986,200,1084,115,5145
"06037571000",4056,190,269,0,1197,52,1662,53,7479
"06037571101",2867,65,174,7,1362,311,1098,311,6195
"06037571102",2724,156,0,0,709,33,709,38,4369
"06037571200",4599,267,577,21,2498,67,2281,105,10415
"06037571300",2592,191,360,39,1091,27,1086,15,5401
"06037571400",2748,82,529,38,1286,42,1531,51,6307
"06037571502",1307,159,764,232,1957,150,1139,94,5802
"06037571503",1479,110,397,146,1242,246,949,296,4865
"06037571504",1576,140,769,216,1980,120,1331,228,6360
"06037571600",191,97,345,717,256,327,239,322,2494
"06037571701",1951,292,429,731,2656,403,3310,673,10445
"06037571703",634,245,728,112,1487,376,1475,512,5569
"06037571704",711,270,428,324,1425,596,1412,600,5766
"06037571800",1935,65,214,23,817,25,451,7,3537
"06037571900",2734,362,900,29,1787,19,1449,213,7493
"06037572001",3045,163,360,1,1746,110,1422,121,6968
"06037572002",1821,188,1222,110,1607,109,808,18,5883
"06037572100",415,7,79,0,549,20,318,0,1388
"06037572201",1880,152,1151,54,3704,157,2505,149,9752
"06037572202",1060,194,430,106,1602,76,1012,133,4613
"06037572301",1089,605,222,90,1589,273,1643,721,6232
"06037572302",1144,397,380,0,1686,308,1523,429,5867
"06037572400",223,10,215,89,546,19,236,0,1338
"06037572500",367,635,387,340,1088,498,226,630,4171
"06037572600",1768,112,464,147,2757,140,2314,161,7863
"06037572700",1521,102,555,212,2828,229,1632,124,7203
"06037572800",102,200,161,251,224,162,74,86,1260
"06037572900",1817,1045,422,159,1598,238,2533,1148,8960
"06037573002",1244,1343,231,190,620,295,1337,1522,6782
"06037573003",716,313,373,14,278,360,358,516,2928
"06037573004",1474,1141,503,301,865,525,1534,1231,7574
"06037573100",2266,430,1881,132,2221,554,3005,767,11256
"06037573201",1707,978,834,221,1166,318,2167,1019,8410
"06037573202",1569,665,374,304,2196,1219,2204,1222,9753
"06037573300",563,466,213,145,1835,1054,1210,618,6104
"06037573401",687,122,65,7,437,28,304,102,1752
"06037573402",2927,191,648,361,1847,834,1981,607,9396
"06037573403",1622,85,329,28,1008,103,531,26,3732
"06037573601",4460,87,462,10,1145,88,1544,47,7843
"06037573700",3478,69,177,9,1067,78,1017,33,5928
"06037573800",3252,272,80,8,842,57,945,68,5524
"06037573902",1449,12,240,0,453,11,288,0,2453
"06037574000",4185,161,63,2,1078,37,1067,62,6655
"06037574100",4098,307,56,0,981,2,1036,10,6490
"06037574201",2150,141,49,6,653,21,682,43,3745
"06037574202",1402,96,63,2,336,48,512,36,2495
"06037574300",4218,215,124,148,1184,11,955,1,6856
"06037574400",4228,170,90,7,870,24,1064,21,6474
"06037574500",4136,531,383,5,949,68,899,0,6971
"06037574601",0,0,0,0,0,0,0,0,0
"06037574602",830,13,65,0,306,0,209,0,1423
"06037574700",0,10,0,0,0,0,0,0,10
"06037574800",1872,240,187,0,585,26,356,0,3266
"06037574901",3073,299,0,0,401,70,611,36,4490
"06037574902",1996,852,317,83,715,449,744,235,5391
"06037575001",1970,261,393,67,1003,305,860,101,4960
"06037575002",2666,213,120,89,1178,252,1016,86,5620
"06037575101",1600,954,354,44,742,683,1595,1077,7049
"06037575102",1199,990,122,156,1159,678,1355,1002,6661
"06037575103",2088,714,928,291,615,388,1420,612,7056
"06037575201",1212,546,450,230,1606,521,1599,811,6975
"06037575202",1777,953,95,75,1419,606,1893,1288,8106
"06037575300",1347,722,370,301,1717,814,2165,933,8369
"06037575401",1843,1377,323,284,898,510,2353,1750,9338
"06037575402",1640,983,391,63,622,369,1972,1308,7348
"06037575500",11,0,0,0,22,0,22,0,55
"06037575801",966,748,173,29,94,486,950,1085,4531
"06037575802",1549,1476,312,185,1063,406,1914,1616,8521
"06037575803",1233,750,226,65,370,382,1343,874,5243
"06037575901",779,410,502,245,525,589,755,837,4642
"06037575902",1693,845,905,324,655,363,889,703,6377
"06037576001",2525,350,398,172,1646,78,778,193,6140
"06037576200",2073,1021,342,356,1395,331,1851,840,8209
"06037576301",1868,489,522,348,728,398,1614,708,6675
"06037576302",930,758,333,107,1854,346,2007,941,7276
"06037576401",1187,1246,259,129,1304,1008,1722,1980,8835
"06037576402",1578,831,312,65,1328,603,2296,948,7961
"06037576403",1814,1113,618,342,1021,695,1975,1155,8733
"06037576501",1442,273,317,206,705,210,1340,249,4742
"06037576502",1621,477,726,437,1300,376,1781,528,7246
"06037576503",1497,970,510,90,636,244,844,971,5762
"06037576601",2770,484,574,137,517,163,946,323,5914
"06037576602",2201,420,437,69,781,41,695,114,4758
"06037576700",3020,212,178,0,513,34,818,35,4810
"06037576801",2024,914,172,257,635,79,1208,732,6021
"06037576802",2256,341,145,95,674,159,677,282,4629
"06037576901",2171,1505,323,317,1522,510,2883,1623,10854
"06037576903",1735,449,468,214,1190,326,1981,458,6821
"06037576904",1708,294,272,292,282,150,918,98,4014
"06037577000",3997,709,524,118,1067,210,1823,414,8862
"06037577100",5311,250,329,46,754,169,1587,43,8489
"06037577200",3850,359,122,0,693,37,973,50,6084
"06037577300",4194,547,43,35,454,140,801,83,6297
"06037577400",2205,202,6,0,280,57,314,78,3142
"06037577501",2888,291,11,0,303,99,215,34,3841
"06037577504",1056,47,47,0,90,11,212,0,1463
"06037577602",2477,217,122,62,518,34,336,30,3796
"06037577603",6039,511,146,0,998,312,810,256,9072
"06037577604",1004,44,60,0,80,17,176,3,1384
"06037599000",2633,364,15,0,505,26,2301,311,6155
"06037599100",278,8,0,0,50,21,116,11,484
"06037600100",1241,779,1848,1146,701,1130,1898,1602,10345
"06037600201",874,593,616,464,1180,565,2054,1143,7489
"06037600202",667,320,2401,1385,996,780,1647,995,9191
"06037600302",290,126,1463,496,305,90,454,194,3418
"06037600303",292,76,981,903,764,383,1084,450,4933
"06037600304",563,342,762,752,527,123,1139,358,4566
"06037600400",366,39,2531,524,290,0,409,25,4184
"06037600501",138,74,1917,147,347,106,321,156,3206
"06037600502",466,15,1142,79,665,49,1080,52,3548
"06037600601",49,8,2012,164,137,49,124,0,2543
"06037600602",282,199,480,222,609,745,791,877,4205
"06037600702",567,181,2907,303,359,63,519,195,5094
"06037600703",140,7,1593,56,191,5,108,0,2100
"06037600704",113,4,2534,398,249,21,244,16,3579
"06037600801",423,12,2432,178,108,0,453,0,3606
"06037600802",46,0,1965,264,288,48,210,31,2852
"06037600902",836,510,2622,721,1553,544,2069,1081,9936
"06037600911",1451,359,840,43,477,352,1728,645,5895
"06037600912",1947,444,1019,124,1451,557,3167,1011,9720
"06037601001",305,176,1139,153,146,2,177,149,2247
"06037601002",746,98,2196,842,1091,452,1614,547,7586
"06037601100",1144,635,1507,458,1470,842,2326,1294,9676
"06037601202",1646,803,141,10,885,402,2308,1205,7400
"06037601211",500,248,836,269,769,373,1149,595,4739
"06037601212",1633,395,1137,346,2081,1059,3461,1419,11531
"06037601301",405,54,1006,59,189,31,277,20,2041
"06037601302",872,260,4527,445,655,287,912,477,8435
"06037601303",931,288,2048,685,728,151,1093,306,6230
"06037601401",1553,363,1235,378,1082,396,2245,615,7867
"06037601402",2139,445,235,46,1735,179,3605,569,8953
"06037601501",967,494,145,245,1464,702,2272,1145,7434
"06037601502",1124,360,52,110,1514,777,2488,1102,7527
"06037601600",1130,506,51,7,1610,681,2628,1187,7800
"06037601700",1220,713,134,119,1764,1737,2911,2167,10765
"06037601801",1286,538,138,5,961,651,2252,1189,7020
"06037601802",1216,757,381,25,1164,734,2719,1471,8467
"06037601900",1095,520,658,253,1984,1058,2924,1557,10049
"06037602002",1425,320,275,98,541,365,1709,634,5367
"06037602003",1420,887,582,137,1371,647,2646,1513,9203
"06037602004",1435,157,676,189,1033,478,2508,691,7167
"06037602103",2191,525,1244,172,1685,612,3490,910,10829
"06037602104",1841,729,1115,580,1295,460,2419,1116,9555
"06037602105",1901,507,628,225,813,134,2350,601,7159
"06037602106",2112,82,1101,221,2074,107,2654,89,8440
"06037602200",4379,443,868,86,1815,317,3419,665,11992
"06037602301",3929,316,317,19,1561,269,3001,358,9770
"06037602302",2624,116,90,0,944,14,812,50,4650
"06037602402",2884,905,649,70,1132,343,2535,1012,9530
"06037602403",2268,516,675,207,1470,283,2736,570,8725
"06037602404",2544,526,1227,329,1355,122,2922,508,9533
"06037602504",927,358,1077,369,1182,229,1267,540,5949
"06037602505",778,442,892,410,978,645,1410,871,6426
"06037602506",892,289,1468,465,986,141,1388,278,5907
"06037602507",604,624,1194,543,778,248,757,799,5547
"06037602508",2098,647,1668,351,1941,222,2720,701,10348
"06037602509",1679,264,362,315,981,415,2148,506,6670
"06037602600",671,75,4987,523,1844,430,1391,394,10315
"06037602700",463,35,2246,187,192,524,561,508,4716
"06037602801",671,307,604,489,1202,780,1731,778,6562
"06037602802",906,50,1864,280,458,502,1259,551,5870
"06037602900",979,168,514,30,1715,547,2135,694,6782
"06037603001",1328,84,1304,607,2666,985,2271,962,10207
"06037603004",126,29,295,19,832,127,289,120,1837
"06037603005",912,145,1267,713,1699,475,1670,433,7314
"06037603006",262,131,387,7,1027,274,170,248,2506
"06037603101",933,139,1170,73,1506,566,1104,267,5758
"06037603102",770,181,327,186,2116,409,1033,489,5511
"06037603200",733,37,448,0,1659,173,892,77,4019
"06037603301",443,13,95,31,2568,218,580,52,4000
"06037603302",1141,78,138,31,2312,496,1590,299,6085
"06037603400",1090,477,609,36,1886,120,1049,483,5750
"06037603500",1133,93,356,8,1470,108,1202,101,4471
"06037603600",1692,102,295,0,1917,232,1246,76,5560
"06037603702",2416,356,202,3,2072,352,1509,360,7270
"06037603703",1600,168,184,0,880,9,1301,156,4298
"06037603704",1184,405,1456,378,2434,799,2962,1019,10637
"06037603801",1573,495,553,133,1707,307,2423,596,7787
"06037603802",1966,532,115,192,1206,244,2317,623,7195
"06037603900",3817,536,343,53,2125,448,4014,836,12172
"06037604001",2391,821,347,15,1027,421,2752,931,8705
"06037604002",2358,335,391,2,1301,187,2298,348,7220
"06037604100",2920,463,344,53,2696,662,3699,851,11688
"06037609900",1442,73,43,13,268,53,1121,72,3085
"06037620001",3157,215,83,17,481,50,574,59,4636
"06037620002",2824,235,62,3,371,7,533,168,4203
"06037620101",3737,649,40,0,956,58,1140,51,6631
"06037620102",2914,80,8,10,725,64,456,17,4274
"06037620201",1091,128,30,17,239,7,180,0,1692
"06037620301",4114,62,23,0,797,102,634,0,5732
"06037620303",3962,86,35,0,513,20,206,2,4824
"06037620305",5145,206,0,0,533,0,542,0,6426
"06037620400",3725,101,17,0,1209,66,255,46,5419
"06037620501",4505,102,381,1,1098,24,1003,1,7115
"06037620521",2412,276,162,0,1148,26,913,40,4977
"06037620522",2812,134,228,0,1214,80,669,13,5150
"06037620601",3587,235,229,0,1396,453,1265,395,7560
"06037620602",3754,204,16,0,1382,37,1163,59,6615
"06037620701",5080,152,173,0,1406,0,1145,0,7956
"06037620702",4808,222,194,0,1609,72,826,89,7820
"06037620800",5928,158,98,1,1825,67,843,23,8943
"06037620901",2281,41,2,1,415,0,159,10,2909
"06037620904",2150,131,0,0,137,0,14,0,2432
"06037621001",3934,83,24,0,593,42,525,0,5201
"06037621002",828,43,34,0,115,5,29,0,1054
"06037621004",3946,365,0,0,284,32,193,14,4834
"06037621102",2548,122,75,0,286,55,182,27,3295
"06037621104",5270,84,124,0,785,16,698,21,6998
"06037621201",4494,162,134,0,1342,65,1177,104,7478
"06037621204",1911,122,24,0,790,32,721,16,3616
"06037621301",4988,268,242,7,1488,84,1055,57,8189
"06037621324",2978,193,209,3,437,75,471,48,4414
"06037621326",2401,93,38,0,551,16,215,19,3333
"06037621400",3384,256,56,0,778,128,519,57,5178
"06037650001",2012,160,61,0,3510,236,755,123,6857
"06037650003",1028,75,215,36,1302,327,774,61,3818
"06037650004",1070,218,331,49,1924,283,533,103,4511
"06037650101",1422,133,166,5,3955,106,631,31,6449
"06037650102",1072,67,59,0,857,60,306,42,2463
"06037650200",3128,152,43,9,2566,204,1429,20,7551
"06037650300",2855,276,282,4,3243,167,1704,48,8579
"06037650401",2186,186,46,0,1923,31,612,50,5034
"06037650501",1887,164,17,4,994,68,342,103,3579
"06037650502",2397,205,131,0,1457,101,350,151,4792
"06037650602",2662,257,84,115,4087,414,889,23,8531
"06037650603",1843,172,24,0,1697,150,307,9,4202
"06037650604",1946,322,588,21,2134,381,1007,36,6435
"06037650605",1264,139,124,3,1316,103,233,42,3224
"06037650701",1359,61,5,0,911,46,177,8,2567
"06037650702",3157,40,37,0,1441,26,417,37,5155
"06037650800",1690,90,187,28,4843,196,490,0,7524
"06037650901",3836,108,126,0,1584,413,1649,373,8089
"06037650902",2755,274,132,0,3483,248,2049,128,9069
"06037651001",2959,390,296,0,2180,98,1668,235,7826
"06037651002",1968,47,133,19,2327,106,918,56,5574
"06037651101",2447,174,16,0,2563,121,572,23,5916
"06037651102",1989,97,109,2,1485,217,556,77,4532
"06037651201",3431,51,0,0,1174,33,316,19,5024
"06037651221",1339,314,123,10,1154,63,328,17,3348
"06037651222",3217,98,11,0,3079,65,979,0,7449
"06037651302",4585,202,174,2,1174,105,629,58,6929
"06037651304",3704,178,17,0,518,35,237,62,4751
"06037651401",1648,126,47,0,531,40,170,12,2574
"06037651402",3496,100,71,0,2711,385,652,0,7415
"06037670001",1927,224,15,13,1007,175,1171,189,4721
"06037670002",2438,362,23,26,1191,89,1427,174,5730
"06037670003",2855,391,20,60,1690,464,1777,359,7616
"06037670100",3065,754,269,54,2432,330,1469,540,8913
"06037670201",2682,21,56,0,941,71,165,0,3936
"06037670202",1909,95,64,0,682,21,252,12,3035
"06037670324",3853,171,120,2,839,0,245,2,5232
"06037670326",2274,67,45,11,1306,13,190,5,3911
"06037670328",3416,98,72,1,1160,111,242,0,5100
"06037670403",1494,89,20,0,1001,31,149,6,2790
"06037670405",1421,21,266,0,1127,115,97,21,3068
"06037670406",1049,16,12,0,839,47,87,0,2050
"06037670407",2896,46,186,0,2359,440,368,0,6295
"06037670411",2665,105,21,0,1464,14,191,14,4474
"06037670413",2536,144,48,91,2192,132,322,16,5481
"06037670416",2220,172,122,2,1504,65,168,35,4288
"06037670500",1157,29,4,6,490,0,59,3,1748
"06037670602",4751,166,424,16,2006,50,288,0,7701
"06037670701",4449,114,125,54,2063,0,1388,0,8193
"06037670702",4138,99,0,56,955,0,615,13,5876
"06037700101",3531,1029,57,78,636,256,476,382,6445
"06037700102",2006,836,135,15,547,59,381,77,4056
"06037700200",4622,826,35,73,1017,113,457,172,7315
"06037700300",4219,403,204,0,599,54,627,0,6106
"06037700400",4012,475,160,19,679,82,479,129,6035
"06037700501",2561,281,142,43,889,45,656,0,4617
"06037700502",2826,531,171,1,725,57,550,82,4943
"06037700600",4183,224,20,0,358,17,334,17,5153
"06037700700",3087,146,57,0,353,0,217,2,3862
"06037700801",4026,676,85,0,628,180,314,70,5979
"06037700802",2629,295,0,17,517,132,71,85,3746
"06037700901",2888,511,81,0,602,6,179,6,4273
"06037700902",4801,551,213,58,1114,205,455,18,7415
"06037701000",4296,314,78,0,1088,99,408,50,6333
"06037701100",189,135,88,197,19,96,17,79,820
"06037701201",3217,204,18,0,472,18,122,54,4105
"06037701202",2687,200,98,8,312,39,426,17,3787
"06037701302",3705,389,55,2,488,51,259,58,5007
"06037701304",5126,438,100,17,571,43,461,16,6772
"06037701402",4864,722,208,0,584,129,251,76,6834
"06037701501",3803,287,22,14,704,70,312,54,5266
"06037701502",2353,221,71,94,793,109,444,44,4129
"06037701601",3718,104,127,13,773,63,276,37,5111
"06037701602",2932,509,112,0,611,79,435,157,4835
"06037701701",2400,228,75,2,487,69,630,36,3927
"06037701702",2195,393,88,39,458,108,758,237,4276
"06037701801",3047,685,493,67,1321,241,1620,445,7919
"06037701802",1989,553,442,71,992,161,984,264,5456
"06037701902",2622,566,123,55,479,121,521,122,4609
"06037702002",4129,635,471,3,545,111,714,128,6736
"06037702102",4647,535,181,15,1060,13,517,158,7126
"06037702201",3499,461,66,17,670,127,896,47,5783
"06037702202",2982,221,21,0,378,116,523,79,4320
"06037702300",4705,373,249,41,1043,440,897,19,7767
"06037702400",2748,133,225,25,860,30,1080,93,5194
"06037702501",3468,256,226,71,966,68,1083,22,6160
"06037702502",2778,110,558,18,885,70,573,26,5018
"06037702600",3454,220,525,14,1591,124,876,47,6851
"06037702700",2646,37,29,31,920,30,829,19,4541
"06037702801",3276,848,276,14,934,64,1336,541,7289
"06037702802",1253,131,104,11,727,41,866,78,3211
"06037702803",1693,173,139,16,794,150,931,178,4074
"06037702901",6496,714,361,0,1443,143,903,0,10060
"06037703001",2405,195,765,164,1687,371,408,45,6040
"06037703002",924,19,5158,583,852,87,336,35,7994
"06037703100",345,287,3839,303,529,7,223,271,5804
"06037703200",528,28,4386,291,633,53,521,16,6456
"06037800101",4622,76,45,0,636,0,208,0,5587
"06037800102",6123,367,101,0,401,149,482,73,7696
"06037800202",4381,536,256,0,946,11,279,11,6420
"06037800203",4227,259,0,0,580,207,439,26,5738
"06037800204",3564,288,138,0,746,13,251,0,5000
"06037800324",4977,278,294,1,1140,57,535,15,7297
"06037800325",2856,256,0,7,216,4,162,16,3517
"06037800326",3912,313,28,0,719,1,435,28,5436
"06037800327",3797,507,0,2,675,463,1115,462,7021
"06037800328",2254,295,46,11,287,18,127,0,3038
"06037800329",5506,296,50,0,874,189,796,0,7711
"06037800330",812,164,0,0,23,4,132,37,1172
"06037800331",679,3,5,0,94,24,67,19,891
"06037800332",5749,32,25,0,768,18,519,18,7129
"06037800406",1944,113,13,0,230,36,165,50,2551
"06037800408",5454,694,89,24,571,90,483,48,7453
"06037800410",1362,18,26,25,250,4,114,0,1799
"06037800504",1876,206,0,18,150,30,71,12,2363
"06037800506",2516,121,17,4,398,109,69,61,3295
"06037900102",240,251,15,14,28,132,93,215,988
"06037900103",3138,1389,210,230,821,283,2013,1306,9390
"06037900104",2030,910,525,273,1351,791,2015,1136,9031
"06037900201",721,269,6,0,77,16,200,128,1417
"06037900300",1982,323,572,22,755,71,1463,112,5300
"06037900501",2438,841,1449,451,668,308,1675,911,8741
"06037900504",3112,203,1111,301,928,186,2276,337,8454
"06037900505",1881,592,473,401,548,115,1373,416,5799
"06037900506",1932,838,1048,780,341,49,1349,572,6909
"06037900507",3563,1131,1350,376,714,179,2552,521,10386
"06037900508",1928,438,368,214,513,236,1410,395,5502
"06037900602",2552,1222,443,377,689,262,2414,1051,9010
"06037900605",4210,1585,1176,234,681,116,2489,883,11374
"06037900606",1501,784,730,395,243,311,1004,916,5884
"06037900607",1549,515,288,882,44,312,929,397,4916
"06037900608",1907,388,548,318,120,179,1279,390,5129
"06037900609",2664,985,529,707,644,101,2155,728,8513
"06037900701",1999,862,522,358,699,102,1064,479,6085
"06037900703",1907,626,239,193,470,433,782,598,5248
"06037900704",1179,493,542,95,312,173,755,184,3733
"06037900705",2662,585,653,239,357,21,803,149,5469
"06037900803",3912,1196,1361,706,1905,359,2872,875,13186
"06037900804",1437,542,612,484,408,33,1401,459,5376
"06037900805",2410,250,203,325,729,74,1172,159,5322
"06037900806",1462,680,745,576,164,246,758,466,5097
"06037900900",2454,345,160,111,453,30,640,38,4231
"06037901003",0,0,0,0,0,0,0,0,0
"06037901004",7369,643,1945,679,1725,191,3332,277,16161
"06037901007",1730,240,58,0,66,32,605,71,2802
"06037901008",1628,180,361,43,716,55,890,63,3936
"06037901009",3621,772,1091,1,274,68,1289,335,7451
"06037901010",2968,1348,617,671,516,118,1269,768,8275
"06037901011",3191,250,415,402,732,38,1133,92,6253
"06037901101",3592,690,300,106,248,105,1379,283,6703
"06037901102",3625,803,433,119,476,114,1266,755,7591
"06037901205",6660,640,608,381,2212,79,2395,197,13172
"06037901209",882,171,77,1,34,5,174,1,1345
"06037901210",1306,120,0,0,77,4,183,0,1690
"06037901213",3014,70,215,0,361,43,429,0,4132
"06037910001",2079,497,443,66,2898,85,3991,490,10549
"06037910002",2690,598,618,38,2097,973,2734,1403,11151
"06037910101",330,180,150,0,450,383,584,491,2568
"06037910201",1691,182,282,138,906,786,1368,786,6139
"06037910202",3880,259,556,12,984,42,1529,77,7339
"06037910205",763,65,0,0,261,146,235,142,1612
"06037910206",1251,213,490,16,1301,56,1231,60,4618
"06037910207",2855,286,376,38,2068,302,2094,126,8145
"06037910208",2802,447,673,43,2427,72,3177,234,9875
"06037910209",2529,141,304,18,1023,76,793,141,5025
"06037910210",4063,78,1078,143,1652,24,1896,0,8934
"06037910301",3030,433,100,107,695,50,705,141,5261
"06037910302",4283,162,279,0,1009,162,869,0,6764
"06037910401",3265,319,518,59,2618,104,3161,165,10209
"06037910402",487,481,294,376,1207,904,1431,1179,6359
"06037910403",150,123,103,21,566,1158,671,1151,3943
"06037910404",1175,566,256,109,1204,472,1600,939,6321
"06037910501",458,606,519,1238,624,2029,514,2400,8388
"06037910502",816,415,266,415,1228,597,1576,707,6020
"06037910504",771,568,210,246,2218,995,2575,1348,8931
"06037910505",1041,162,133,113,1136,323,1299,445,4652
"06037910601",2095,805,195,182,2433,1159,3577,1416,11862
"06037910602",884,364,228,626,1406,403,1657,643,6211
"06037910603",2185,501,599,160,2530,1125,3402,1409,11911
"06037910605",1415,447,519,28,1404,810,2023,1163,7809
"06037910606",904,244,485,237,1170,297,1741,473,5551
"06037910705",4064,592,2366,91,4252,840,6352,1223,19780
"06037910706",1605,285,373,386,2967,386,4030,673,10705
"06037910707",1438,285,543,158,1360,368,1854,556,6562
"06037910709",950,6,156,0,389,233,549,221,2504
"06037910711",3058,434,685,562,2562,1247,4426,1079,14053
"06037910712",1345,102,217,199,559,102,1244,183,3951
"06037910713",1958,257,615,123,2543,745,3759,841,10841
"06037910714",1282,277,266,34,1856,363,2585,570,7233
"06037910715",2133,130,388,611,2403,376,3357,416,9814
"06037910716",1941,112,681,301,2269,485,2546,656,8991
"06037910804",2480,200,17,0,325,44,447,23,3536
"06037910805",3265,244,90,29,635,189,845,34,5331
"06037910807",4000,249,298,29,1183,134,1515,153,7561
"06037910808",2647,10,57,0,683,55,618,1,4071
"06037910809",1795,84,25,0,262,138,295,138,2737
"06037910810",1879,110,93,7,734,35,814,101,3773
"06037910811",83,14,0,0,18,0,0,0,115
"06037910812",363,32,0,0,39,6,82,6,528
"06037910813",2285,128,0,0,589,73,592,22,3689
"06037911001",2412,301,131,1,726,308,916,344,5139
"06037920011",122,38,0,0,9,0,17,4,190
"06037920012",792,73,0,0,145,11,45,21,1087
"06037920013",3449,92,95,19,924,22,1201,6,5808
"06037920015",4728,224,156,2,1212,10,1322,148,7802
"06037920016",3627,217,68,0,1141,10,869,0,5932
"06037920017",3588,94,18,0,662,150,1510,59,6081
"06037920018",1745,147,5,41,449,12,543,72,3014
"06037920020",5551,417,54,6,1270,41,1786,134,9259
"06037920023",1830,218,2,8,769,81,1508,175,4591
"06037920026",303,26,0,0,9,0,28,6,372
"06037920028",3912,240,161,54,1605,65,1579,87,7703
"06037920029",2455,134,92,15,770,17,1249,15,4747
"06037920030",3092,432,328,35,1766,212,1540,326,7731
"06037920031",3623,218,147,26,1055,58,664,4,5795
"06037920032",2165,39,48,0,749,0,601,27,3629
"06037920033",381,80,3,7,114,25,227,41,878
"06037920034",1866,662,165,14,738,88,774,321,4628
"06037920035",5431,818,0,1,1698,136,3431,629,12144
"06037920036",2352,171,51,63,473,214,1283,279,4886
"06037920037",3057,1594,433,16,1834,491,2978,1716,12119
"06037920038",1879,806,300,17,1123,143,1730,565,6563
"06037920039",1522,58,7,0,425,6,539,36,2593
"06037920040",1586,194,234,0,1251,220,602,249,4336
"06037920041",1681,186,314,40,790,63,845,155,4074
"06037920042",4294,547,414,58,1463,205,1786,395,9162
"06037920043",3280,93,186,0,2382,9,1530,53,7533
"06037920044",2168,53,0,2,914,0,532,14,3683
"06037920045",3580,258,155,0,1030,0,994,18,6035
"06037920102",3412,813,342,21,657,242,1368,535,7390
"06037920104",2083,375,28,0,341,76,400,172,3475
"06037920106",1883,475,136,0,597,122,1472,423,5108
"06037920107",2317,48,493,39,1669,55,677,13,5311
"06037920108",2283,106,68,0,1426,44,464,0,4391
"06037920109",2784,99,129,0,1309,28,890,10,5249
"06037920110",3696,142,8,0,902,79,596,0,5423
"06037920111",2339,133,148,13,582,70,701,13,3999
"06037920112",3199,175,119,12,275,43,498,37,4358
"06037920114",4053,281,354,0,1909,57,1230,18,7902
"06037920115",3089,90,47,9,757,90,1087,84,5253
"06037920116",3269,93,134,0,1361,0,682,0,5539
"06037920118",4315,100,19,26,1447,113,1756,105,7881
"06037920119",1319,16,0,0,545,44,573,0,2497
"06037920200",0,0,0,0,0,0,0,0,0
"06037920303",586,34,22,40,462,113,75,64,1396
"06037920312",3710,285,77,86,1175,138,1698,260,7429
"06037920313",4390,383,20,14,977,139,1638,361,7922
"06037920314",1910,58,5,0,815,18,680,28,3514
"06037920322",2245,0,104,0,461,28,658,0,3496
"06037920326",4008,368,222,0,2106,127,1283,81,8195
"06037920328",1389,184,11,0,374,12,204,0,2174
"06037920329",3831,174,15,16,1686,99,1142,39,7002
"06037920330",4046,366,17,0,1142,23,1278,194,7066
"06037920331",3381,169,55,0,479,88,738,7,4917
"06037920332",1075,114,33,0,513,4,507,102,2348
"06037920334",4153,412,33,7,714,153,1062,151,6685
"06037920336",2835,1082,118,16,1651,479,3248,1347,10776
"06037920337",3421,1516,486,24,1905,378,3763,1847,13340
"06037920338",4375,64,367,82,1252,89,933,11,7173
"06037920339",4375,96,259,0,2188,0,982,0,7900
"06037930101",128,0,0,0,42,0,50,0,220
"06037930200",377,34,0,15,189,31,283,29,958
"06037930301",444,74,0,3,104,14,53,14,706
"06037980001",0,0,0,0,0,0,0,0,0
"06037980002",0,0,0,0,0,0,0,0,0
"06037980003",0,0,0,0,0,0,0,0,0
"06037980004",0,0,0,0,0,12,0,12,24
"06037980005",0,0,0,0,0,0,0,0,0
"06037980006",0,0,0,0,0,0,0,0,0
"06037980007",0,0,0,0,0,0,0,0,0
"06037980008",32,43,0,0,38,9,38,33,193
"06037980009",0,0,0,0,0,0,0,0,0
"06037980010",36,15,0,2,17,97,14,40,221
"06037980013",0,0,0,0,0,0,0,0,0
"06037980014",71,33,0,0,0,0,0,0,104
"06037980015",110,92,88,35,60,16,50,91,542
"06037980018",0,0,0,0,1,0,0,0,1
"06037980019",201,0,7,0,20,0,38,0,266
"06037980020",0,0,0,0,0,0,0,0,0
"06037980021",0,0,0,0,0,0,0,0,0
"06037980022",0,0,0,0,0,0,0,0,0
"06037980023",0,0,0,0,10,0,10,0,20
"06037980024",99,0,11,0,106,0,14,0,230
"06037980025",0,0,0,0,0,0,0,0,0
"06037980026",26,0,0,0,8,0,4,0,38
"06037980028",0,0,0,0,0,0,0,0,0
"06037980030",0,0,0,0,0,0,0,0,0
"06037980031",0,0,50,0,0,0,0,0,50
"06037980033",0,0,0,0,0,0,0,0,0
"06037990100",0,0,0,0,0,0,0,0,0
"06037990200",0,0,0,0,0,0,0,0,0
"06037990300",0,0,0,0,0,0,0,0,0
"06039000102",2651,594,41,0,457,133,244,49,4169
"06039000103",4023,868,26,0,242,0,188,251,5598
"06039000104",3523,280,0,0,239,44,281,0,4367
"06039000106",3870,538,12,0,247,10,521,87,5285
"06039000108",4926,1114,25,0,656,12,430,52,7215
"06039000109",1561,68,0,0,148,76,253,27,2133
"06039000201",1082,238,20,23,262,300,1097,104,3126
"06039000202",4253,622,188,13,794,59,2132,299,8360
"06039000300",4448,2859,101,205,859,137,1964,1634,12207
"06039000400",722,206,0,0,206,5,646,205,1990
"06039000502",6525,2503,83,191,1654,349,6449,2703,20457
"06039000503",6126,892,156,182,1992,90,5065,513,15016
"06039000506",4619,1216,30,107,598,20,3556,1161,11307
"06039000507",6989,1927,335,290,978,322,5246,1902,17989
"06039000508",4176,1437,73,0,1023,177,2876,1127,10889
"06039000509",4324,779,154,0,443,19,1333,503,7555
"06039000602",2802,1616,12,10,524,140,3148,1666,9918
"06039000603",2541,2001,73,93,337,79,2593,1858,9575
"06039000604",3090,2138,86,51,441,333,3172,2462,11773
"06039000700",8585,622,587,104,1601,225,5744,707,18175
"06039000800",3710,2267,28,31,294,276,3392,2253,12251
"06039000900",4761,2387,96,77,911,815,4961,2898,16906
"06039001000",3799,1002,0,35,339,83,1929,1029,8216
"06041101100",2343,29,0,0,388,0,33,0,2793
"06041101200",2008,410,7,0,387,14,507,88,3421
"06041102100",1904,78,0,0,263,11,180,9,2445
"06041102202",4624,352,75,0,1116,65,1395,232,7859
"06041102203",3038,111,294,21,1293,236,1540,181,6714
"06041103100",6556,378,0,79,674,20,393,29,8129
"06041103200",4775,431,55,0,866,84,770,166,7147
"06041104101",5921,728,189,0,1137,118,1070,317,9480
"06041104102",3389,209,106,160,1447,136,1384,182,7013
"06041104200",4175,217,24,13,904,337,858,340,6868
"06041104300",1382,41,0,0,218,6,136,0,1783
"06041105000",4227,413,219,8,812,542,766,655,7642
"06041106001",2538,209,182,19,687,179,337,130,4281
"06041106002",3733,436,44,40,1521,225,1102,388,7489
"06041107000",4990,233,9,23,846,21,360,29,6511
"06041108100",5485,147,26,0,899,132,543,159,7391
"06041108200",4768,372,98,66,1157,194,761,196,7612
"06041109001",2204,289,42,0,909,220,717,226,4607
"06041109002",3399,317,218,0,142,18,213,17,4324
"06041110100",4060,305,173,18,467,125,241,40,5429
"06041110200",4618,160,9,0,529,0,278,41,5635
"06041111000",3848,396,205,66,1214,313,1287,306,7635
"06041112100",3135,542,47,0,1072,430,1406,620,7252
"06041112201",1076,1086,183,325,3573,1213,4344,2216,14016
"06041112202",1685,223,29,0,1918,423,2215,548,7041
"06041113000",3541,167,110,0,330,6,410,0,4564
"06041114100",4373,295,33,71,286,151,372,38,5619
"06041114200",2720,141,8,0,283,35,181,30,3398
"06041115000",6166,129,56,0,831,68,446,0,7696
"06041116000",2545,173,0,5,205,86,87,0,3101
"06041117000",3831,446,12,14,372,54,128,54,4911
"06041118100",1897,183,0,0,145,0,127,0,2352
"06041119100",4348,140,9,0,279,35,161,0,4972
"06041119201",2474,153,80,8,526,44,316,26,3627
"06041119202",2870,112,97,56,120,27,139,0,3421
"06041120000",5283,165,69,3,613,15,290,0,6438
"06041121100",4244,194,17,0,998,0,632,0,6085
"06041121200",4466,73,94,0,563,244,233,52,5725
"06041122000",0,0,0,0,0,0,0,0,0
"06041123000",1764,56,4,0,196,19,135,0,2174
"06041124100",4293,206,23,0,547,118,406,19,5612
"06041124200",5233,221,0,22,322,90,329,125,6342
"06041125000",3012,285,59,0,671,170,112,12,4321
"06041126100",5144,154,58,0,538,0,188,0,6082
"06041126200",3634,196,23,0,460,39,454,17,4823
"06041127000",4055,48,0,0,370,24,389,0,4886
"06041128100",5300,202,114,0,824,120,282,0,6842
"06041128200",3564,173,62,0,484,0,268,9,4560
"06041129000",672,160,385,406,365,521,289,465,3263
"06041130201",3384,128,22,2,101,23,228,18,3906
"06041130202",3243,233,104,0,290,57,196,0,4123
"06041131100",832,51,10,0,93,23,18,0,1027
"06041132100",1491,235,76,0,59,8,49,48,1966
"06041132200",1382,251,5,44,136,41,177,45,2081
"06041133000",2248,256,6,2,589,28,639,65,3833
"06041990100",0,0,0,0,0,0,0,0,0
"06043000101",2402,602,24,0,270,268,177,338,4081
"06043000102",1842,504,24,0,147,67,37,73,2694
"06043000200",2594,383,0,0,197,0,385,23,3582
"06043000301",2858,495,0,0,529,0,238,2,4122
"06043000302",2125,189,8,0,175,81,137,81,2796
"06043000400",1555,221,20,34,107,58,162,39,2196
"06045010100",1071,437,10,0,744,272,254,185,2973
"06045010200",2076,673,10,1,421,276,285,74,3816
"06045010300",3208,563,0,0,235,117,446,55,4624
"06045010400",1860,397,0,29,434,489,612,572,4393
"06045010500",3109,724,6,0,444,72,1303,256,5914
"06045010600",5085,976,0,0,366,52,404,163,7046
"06045010700",3834,1435,4,0,833,244,610,508,7468
"06045010801",4714,783,50,1,839,279,1046,264,7976
"06045010802",1721,382,0,5,150,19,437,136,2850
"06045010900",3283,353,49,2,727,256,1093,247,6010
"06045011001",1111,266,0,3,88,30,68,19,1585
"06045011002",3869,627,0,0,350,90,381,58,5375
"06045011102",2448,272,29,2,435,146,584,130,4046
"06045011200",1977,510,35,0,196,156,817,420,4111
"06045011300",3773,1450,32,77,796,503,1253,1244,9128
"06045011400",3094,212,4,0,472,123,292,0,4197
"06045011500",4003,1259,13,50,771,222,1250,377,7945
"06045011600",3563,1140,11,22,793,602,1711,1034,8876
"06045011700",3019,359,102,7,756,96,952,11,5302
"06045011800",1263,205,0,0,440,129,405,76,2518
"06045990100",0,0,0,0,0,0,0,0,0
"06047000201",2003,427,49,3,787,291,1477,589,5626
"06047000202",1138,297,0,0,283,168,852,407,3145
"06047000203",4136,695,275,0,2891,891,5821,989,15698
"06047000301",1591,308,64,19,2475,535,2681,669,8342
"06047000303",1133,386,57,0,267,212,767,452,3274
"06047000304",2830,1165,0,0,4438,941,5105,1885,16364
"06047000401",1100,299,0,0,216,178,633,260,2686
"06047000402",6557,726,17,0,746,57,1307,173,9583
"06047000503",1239,329,0,0,330,119,591,316,2924
"06047000504",2507,974,50,0,2468,880,4085,1406,12370
"06047000505",3190,760,226,11,2041,835,3123,1017,11203
"06047000601",2206,847,74,24,1484,544,2346,974,8499
"06047000602",1875,737,82,25,648,228,1092,361,5048
"06047000603",2678,1638,273,35,828,729,1689,1640,9510
"06047000701",1279,740,9,10,665,355,1203,666,4927
"06047000702",3236,158,26,0,1404,136,1644,56,6660
"06047000801",2707,551,285,30,1583,161,2331,259,7907
"06047000802",2050,522,115,1,1348,183,1348,429,5996
"06047000901",1993,366,86,34,704,203,1043,379,4808
"06047000902",4275,1221,385,0,2112,1121,3115,1543,13772
"06047001002",6670,1239,506,270,4231,522,3329,614,17381
"06047001003",1138,799,191,140,1091,596,1332,876,6163
"06047001004",1936,809,222,80,616,243,1152,532,5590
"06047001005",801,298,58,181,575,359,807,335,3414
"06047001101",3535,969,9,49,819,349,1257,484,7471
"06047001200",3146,282,128,101,1104,361,1433,450,7005
"06047001301",1398,522,132,29,341,299,954,605,4280
"06047001302",1368,906,58,59,245,548,530,948,4662
"06047001401",1942,695,60,53,830,454,1191,414,5639
"06047001402",2385,489,143,138,1014,722,1357,664,6912
"06047001501",1195,462,67,0,822,557,1191,701,4995
"06047001502",749,714,182,12,780,518,1417,888,5260
"06047001503",1152,942,110,246,1195,1098,1517,1659,7919
"06047001601",383,593,126,69,998,1441,1100,1953,6663
"06047001602",2273,1180,162,314,2907,1322,3862,1624,13644
"06047001700",2350,977,51,136,1377,1309,1938,1429,9567
"06047001801",2094,85,19,0,585,127,448,0,3358
"06047001901",2330,1013,101,0,1286,809,3234,1643,10416
"06047001902",1258,515,0,5,551,199,1248,624,4400
"06047002000",5223,2067,7,32,677,65,3365,1405,12841
"06047002100",2468,681,34,9,255,142,1611,385,5585
"06047002201",2993,1697,25,111,271,469,2130,1932,9628
"06047002202",6264,1832,138,0,1734,353,5950,2028,18299
"06047002301",4159,689,53,0,1142,324,2483,707,9557
"06047002302",8345,2255,261,357,2364,811,7500,2785,24678
"06047002401",1051,311,0,0,66,0,469,199,2096
"06047002402",4563,2288,174,130,724,484,3861,2440,14664
"06047002500",1329,171,30,1,466,101,478,101,2677
"06047002600",2911,677,383,0,1279,186,1712,694,7842
"06049000100",2262,756,0,0,98,95,217,179,3607
"06049000200",1409,319,0,7,32,36,242,112,2157
"06049000300",2154,366,0,37,256,126,275,151,3365
"06049000400",847,106,0,2,73,42,51,12,1133
"06051000101",3000,149,0,6,134,11,259,6,3565
"06051000102",1854,58,15,0,615,79,340,42,3003
"06051000200",6729,140,0,21,1030,240,2923,248,11331
"06053000101",1526,135,0,0,470,25,1485,104,3745
"06053000102",5407,566,191,3,3436,243,6069,674,16589
"06053000103",1736,342,171,14,1412,61,1999,375,6110
"06053000104",2504,300,58,0,937,29,2365,273,6466
"06053000200",3997,928,134,0,1367,404,4183,1168,12181
"06053000300",2716,262,223,0,1186,110,2589,215,7301
"06053000400",3889,1657,129,3,1488,698,3545,2273,13682
"06053000501",2263,1463,0,0,716,240,2699,1686,9067
"06053000502",2447,602,0,0,1175,197,3166,769,8356
"06053000600",3817,1594,0,0,1042,156,4478,1718,12805
"06053000701",3016,2232,13,0,553,292,3399,2517,12022
"06053000702",2724,2240,0,0,744,279,3448,2510,11945
"06053000800",3063,955,5,6,779,171,3768,1113,9860
"06053000900",2916,1644,0,0,629,39,3312,1618,10158
"06053001200",2126,386,41,0,288,158,549,289,3837
"06053001300",955,816,113,0,358,130,1084,839,4295
"06053001400",1681,254,69,10,375,32,753,262,3436
"06053001500",4666,286,16,0,695,281,2352,356,8652
"06053001600",2059,327,54,0,335,15,779,236,3805
"06053001700",2369,470,77,14,725,24,2056,202,5937
"06053001801",1790,648,95,6,1473,183,1987,534,6716
"06053001802",2392,960,0,26,1209,213,2388,982,8170
"06053010101",2696,1211,11,8,644,248,2946,1352,9116
"06053010102",2765,156,0,0,598,11,1480,129,5139
"06053010202",3042,394,8,15,729,240,1783,500,6711
"06053010305",3504,116,33,0,1010,115,1646,143,6567
"06053010306",872,181,0,0,220,46,542,92,1953
"06053010400",3172,969,48,3,1667,367,4365,1271,11862
"06053010501",4805,553,28,0,702,91,2043,454,8676
"06053010504",2744,675,15,87,1352,164,2924,465,8426
"06053010505",3061,792,42,0,1545,145,3662,892,10139
"06053010506",2855,1036,50,12,670,344,2801,1196,8964
"06053010603",4667,24,68,197,1988,333,4264,122,11663
"06053010604",3644,771,43,17,1409,68,4090,775,10817
"06053010605",3010,524,28,0,750,163,3240,684,8399
"06053010606",4814,952,58,1,1522,114,4728,975,13164
"06053010607",2622,1184,42,6,408,121,2847,1303,8533
"06053010608",1670,431,47,0,434,29,1958,445,5014
"06053010701",5149,121,143,0,652,69,1011,15,7160
"06053010702",3258,119,0,0,390,0,307,0,4074
"06053010804",3696,1688,13,0,152,8,3482,1696,10735
"06053010900",15,6,0,0,33,0,24,0,78
"06053011000",4937,526,40,0,469,15,317,303,6607
"06053011101",2970,1206,47,11,483,183,3059,1366,9325
"06053011102",6913,1713,96,6,2577,184,8457,1890,21836
"06053011202",4072,1346,6,1,1029,797,4406,2093,13750
"06053011203",3860,1391,63,0,790,499,4161,1671,12435
"06053011204",1735,359,64,0,1481,148,2360,462,6609
"06053011302",3239,1590,0,0,188,176,2909,1689,9791
"06053011303",2821,677,72,0,714,143,2238,647,7312
"06053011304",4717,948,9,37,1241,197,5422,1149,13720
"06053011400",2326,497,11,1,253,103,661,350,4202
"06053011502",934,301,1,12,47,15,61,111,1482
"06053011602",5382,178,19,0,140,14,414,0,6147
"06053011604",1542,102,0,0,123,0,50,0,1817
"06053011700",3109,315,7,44,293,55,269,25,4117
"06053011801",1568,198,0,0,189,1,33,17,2006
"06053011802",1478,100,0,0,264,0,312,0,2154
"06053011900",3460,289,9,9,386,8,240,4,4405
"06053012000",2530,304,88,17,532,81,406,12,3970
"06053012100",1855,89,7,0,218,6,315,10,2500
"06053012200",2111,190,0,0,191,17,152,33,2694
"06053012302",1492,148,28,0,130,19,155,30,2002
"06053012401",1519,85,54,64,171,0,227,9,2129
"06053012402",2550,177,28,0,539,0,516,19,3829
"06053012502",3975,387,54,59,802,38,777,47,6139
"06053012600",120,11,0,0,38,3,41,0,213
"06053012700",2404,422,14,17,429,199,320,31,3836
"06053012800",4439,267,14,0,703,89,679,57,6248
"06053013000",2533,250,252,0,497,164,571,73,4340
"06053013100",1554,66,81,0,266,69,152,0,2188
"06053013200",3262,139,0,0,504,0,329,36,4270
"06053013300",3914,346,255,6,1564,278,1711,177,8251
"06053013400",1319,56,0,3,301,48,222,31,1980
"06053013500",1653,684,452,73,1323,517,617,922,6241
"06053013600",2001,558,177,43,1364,175,1953,670,6941
"06053013700",1869,891,109,255,1506,272,2331,1059,8292
"06053013800",2386,511,633,201,1942,188,2087,389,8337
"06053013900",1141,359,167,16,979,203,1019,338,4222
"06053014000",1416,332,71,3,691,87,1045,245,3890
"06053014102",827,431,125,20,406,323,443,222,2797
"06053014104",0,0,0,0,0,0,0,0,0
"06053014105",1398,401,224,21,318,136,340,176,3014
"06053014107",4017,324,534,134,1865,376,1339,168,8757
"06053014201",2473,647,108,65,2317,407,1675,614,8306
"06053014202",1309,268,413,121,1540,329,632,278,4890
"06053014301",2119,104,283,9,780,90,796,9,4190
"06053014302",1731,243,202,18,1747,201,1031,26,5199
"06053014500",3118,545,51,0,646,41,1617,473,6491
"06053014601",3339,769,0,0,1301,112,3769,788,10078
"06053014700",4838,828,86,0,1138,145,3294,818,11147
"06053014800",4588,802,2,0,547,20,4281,765,11005
"06053980000",0,0,0,0,0,37,0,37,74
"06053990000",0,0,0,0,0,0,0,0,0
"06055200201",2412,198,0,12,329,72,1137,72,4232
"06055200202",1735,432,7,23,345,85,1073,194,3894
"06055200203",1876,127,24,17,250,25,737,41,3097
"06055200301",3340,705,60,0,836,159,2184,620,7904
"06055200302",2050,204,58,0,432,8,1023,104,3879
"06055200400",2989,120,71,2,567,2,1015,2,4768
"06055200501",3943,336,58,0,971,63,2516,271,8158
"06055200503",1200,226,41,0,199,35,721,199,2621
"06055200504",5035,515,28,1,882,112,2791,493,9857
"06055200505",1917,264,0,5,279,160,923,326,3874
"06055200601",3688,184,0,0,793,152,1580,201,6598
"06055200602",3327,236,30,0,632,13,1019,44,5301
"06055200703",2630,44,0,1,197,0,268,9,3149
"06055200704",3480,583,0,0,838,214,1990,542,7647
"06055200705",2148,684,6,0,303,23,965,570,4699
"06055200706",2458,277,5,0,585,9,847,78,4259
"06055200707",2435,184,22,0,392,12,554,70,3669
"06055200802",3769,251,145,3,781,173,800,70,5992
"06055200803",1653,113,2,1,153,178,395,241,2736
"06055200804",3656,875,32,28,1075,130,3397,703,9896
"06055200900",41,286,0,60,35,45,18,54,539
"06055201003",887,299,321,0,2967,132,756,128,5490
"06055201004",2281,236,448,195,3153,202,1728,72,8315
"06055201005",1336,110,26,0,768,19,612,77,2948
"06055201006",1390,343,213,34,964,61,683,87,3775
"06055201007",2132,150,322,28,1492,179,1176,208,5687
"06055201101",1759,4,11,0,246,3,168,0,2191
"06055201102",1629,149,0,0,38,0,131,14,1961
"06055201200",3427,464,0,0,636,109,1276,219,6131
"06055201300",2144,149,51,7,116,0,184,10,2661
"06055201401",3012,82,0,0,49,22,163,31,3359
"06055201402",2337,239,6,0,506,4,274,106,3472
"06055201403",698,13,0,0,98,0,113,0,922
"06055201500",1676,76,0,0,521,51,829,51,3204
"06055201601",1551,267,0,0,647,43,925,114,3547
"06055201602",2905,139,19,0,174,64,385,58,3744
"06055201700",3533,321,141,21,592,86,902,80,5676
"06055201800",1394,72,0,0,186,10,463,3,2128
"06055201900",947,122,3,8,202,0,332,0,1614
"06055202000",3711,644,104,0,609,124,1232,471,6895
"06057000102",6182,184,0,0,340,0,275,16,6997
"06057000103",6937,453,0,0,283,0,419,0,8092
"06057000104",2576,282,0,0,204,0,77,14,3153
"06057000105",2081,258,0,1,144,85,131,85,2785
"06057000200",2358,189,0,0,154,10,122,10,2843
"06057000300",1937,187,5,0,54,26,72,39,2320
"06057000401",5041,494,42,0,531,5,609,56,6778
"06057000402",5741,1014,47,0,740,66,387,246,8241
"06057000501",3847,1459,0,0,471,0,646,306,6729
"06057000502",3469,626,0,0,280,287,335,247,5244
"06057000600",4077,1841,0,3,189,133,202,314,6759
"06057000701",6097,537,8,4,472,162,259,40,7579
"06057000702",3313,295,80,0,200,14,125,0,4027
"06057000801",3981,634,0,0,245,34,181,59,5134
"06057000802",5352,407,25,2,437,0,479,4,6706
"06057000900",2537,876,18,64,209,144,60,31,3939
"06057001203",2422,499,0,0,112,0,164,24,3221
"06057001204",2343,172,0,0,14,0,129,0,2658
"06057001205",4354,290,0,0,119,0,156,0,4919
"06057001206",4922,424,1,2,575,0,2071,203,8198
"06059001101",2826,511,16,0,801,170,1442,599,6365
"06059001102",1510,103,21,0,1178,273,1255,272,4612
"06059001103",1696,621,133,0,1733,168,2310,546,7207
"06059001201",3341,696,0,19,1122,455,3559,1070,10262
"06059001202",1722,151,12,0,1307,742,2450,838,7222
"06059001301",3894,344,60,0,2271,129,2620,252,9570
"06059001303",2764,453,23,8,2012,320,2981,519,9080
"06059001304",1606,172,0,0,1698,253,2466,337,6532
"06059001401",3011,438,136,17,1690,289,2955,563,9099
"06059001402",3268,596,28,2,1429,248,2753,498,8822
"06059001403",2620,35,12,0,327,78,1010,78,4160
"06059001404",1837,281,62,0,1709,130,2793,309,7121
"06059001501",4319,367,0,0,1693,53,1134,131,7697
"06059001503",3651,925,30,0,865,217,1126,877,7691
"06059001504",3393,151,87,0,1058,58,1885,75,6707
"06059001505",4453,386,112,82,1979,61,1253,255,8581
"06059001506",2775,159,7,0,927,149,938,77,5032
"06059001507",3076,71,28,0,1364,73,1195,23,5830
"06059001601",4404,308,88,0,2760,3,1245,132,8940
"06059001602",2905,129,112,0,1264,74,521,1,5006
"06059001704",1843,104,60,0,4537,892,523,28,7987
"06059001705",2037,436,110,0,1432,462,1567,744,6788
"06059001706",2395,184,26,0,858,75,430,13,3981
"06059001707",1712,29,281,0,5140,436,1112,0,8710
"06059001708",1664,53,51,1,1473,202,555,32,4031
"06059001801",1599,738,142,162,1727,986,1963,1218,8535
"06059001802",2078,1260,447,104,2650,1616,2830,2436,13421
"06059001901",1729,96,54,0,1247,0,1572,32,4730
"06059001902",1515,237,42,8,1104,138,1239,194,4477
"06059001903",1856,300,48,0,1012,204,1486,452,5358
"06059011000",3846,136,59,0,1734,254,1626,59,7714
"06059011101",1734,306,38,138,1588,638,1815,864,7121
"06059011102",2451,493,68,0,1396,34,2078,358,6878
"06059011200",2256,324,16,27,1021,237,1247,252,5380
"06059011300",2831,448,174,16,886,217,927,161,5660
"06059011401",1505,150,7,0,224,15,237,60,2198
"06059011402",1922,96,28,0,291,8,354,7,2706
"06059011403",3048,772,52,0,1469,921,2135,986,9383
"06059011502",2022,331,21,21,1309,199,1567,338,5808
"06059011503",1104,87,36,0,381,18,204,30,1860
"06059011504",2048,991,51,0,1068,627,794,480,6059
"06059011601",2375,943,300,57,2949,1173,3920,1956,13673
"06059011602",2885,966,41,0,1260,202,3033,1005,9392
"06059011707",3579,494,106,0,1893,152,1005,172,7401
"06059011708",1944,532,132,66,904,360,760,252,4950
"06059011709",3489,29,0,0,676,51,963,0,5208
"06059011710",2691,61,8,0,691,30,599,0,4080
"06059011711",3383,1312,64,94,1875,960,1521,1558,10767
"06059011712",2806,279,131,4,1414,73,1954,137,6798
"06059011714",628,42,4,0,164,33,487,15,1373
"06059011715",4669,340,105,24,1112,111,1415,95,7871
"06059011716",2204,609,0,0,2549,159,1078,542,7141
"06059011717",2316,125,61,4,441,0,688,72,3707
"06059011718",2711,105,10,0,758,31,878,3,4496
"06059011720",3561,2305,72,23,653,108,3796,2167,12685
"06059011721",2860,1168,35,0,801,184,2494,1193,8735
"06059011722",1833,212,108,0,500,0,786,97,3536
"06059021802",5496,502,0,0,1187,66,1473,306,9030
"06059021807",3045,127,120,0,552,94,1172,131,5241
"06059021809",2293,79,9,0,471,23,585,2,3462
"06059021810",3345,116,45,0,464,70,1223,61,5324
"06059021812",4784,136,123,12,1051,11,888,0,7005
"06059021813",41,0,0,0,66,0,56,0,163
"06059021814",4830,139,95,0,1893,29,1539,59,8584
"06059021815",4453,188,196,0,3031,259,1496,120,9743
"06059021816",3977,149,0,0,786,19,906,47,5884
"06059021817",2979,224,0,0,536,74,999,91,4903
"06059021820",2941,81,15,0,1285,119,794,0,5235
"06059021821",3975,312,189,1,1677,319,1794,334,8601
"06059021822",5162,86,289,0,3063,102,730,33,9465
"06059021823",2601,65,0,0,766,72,564,0,4068
"06059021824",2160,66,78,0,260,14,294,11,2883
"06059021825",2597,40,0,0,586,0,464,13,3700
"06059021826",1986,65,14,0,571,0,626,2,3264
"06059021827",1889,150,29,0,1015,33,419,121,3656
"06059021828",3067,0,31,0,1280,11,579,0,4968
"06059021829",3672,99,160,0,1350,26,481,18,5806
"06059021830",4251,19,16,0,1483,0,1098,0,6867
"06059021903",2903,336,104,4,751,54,1339,243,5734
"06059021905",4320,109,51,0,1115,18,1092,0,6705
"06059021912",2944,137,35,0,1529,0,504,0,5149
"06059021913",4518,192,50,116,3147,1282,4819,1411,15535
"06059021914",2250,424,52,0,1301,42,1065,298,5432
"06059021915",2905,84,0,28,1005,17,668,56,4763
"06059021916",2556,50,50,0,786,1,249,0,3692
"06059021917",2474,63,0,0,405,2,399,0,3343
"06059021918",2644,213,0,0,1551,318,1065,243,6034
"06059021919",1936,29,34,0,507,113,530,4,3153
"06059021920",4432,110,34,0,2012,86,781,45,7500
"06059021921",3400,0,48,0,1105,8,654,0,5215
"06059021922",3451,87,13,0,1325,90,760,24,5750
"06059021923",4504,134,236,18,1883,0,724,15,7514
"06059021924",2597,154,20,0,1487,0,805,105,5168
"06059032002",4905,280,137,17,947,60,1225,64,7635
"06059032003",4185,217,0,0,616,0,601,74,5693
"06059032011",1428,29,0,1,125,6,99,1,1689
"06059032012",3243,136,41,23,393,0,562,0,4398
"06059032013",4080,279,124,0,618,128,570,17,5816
"06059032014",3021,514,260,0,1566,616,2506,905,9388
"06059032015",4503,585,22,9,1319,42,1086,83,7649
"06059032020",5044,35,0,0,635,22,800,0,6536
"06059032022",4447,584,24,74,1914,58,2950,450,10501
"06059032023",10550,386,223,0,1872,305,1450,315,15101
"06059032027",3599,397,204,8,2464,259,2605,407,9943
"06059032028",2632,135,13,0,446,68,709,43,4046
"06059032029",3050,191,37,20,1132,178,1149,0,5757
"06059032030",3085,154,123,0,407,1,603,54,4427
"06059032031",2417,413,0,0,645,13,646,1,4135
"06059032032",2438,153,10,0,451,0,328,0,3380
"06059032033",2576,184,110,0,676,234,476,220,4476
"06059032034",4928,60,48,0,902,13,500,0,6451
"06059032035",1837,76,17,18,339,11,224,12,2534
"06059032036",2669,255,0,0,627,9,580,85,4225
"06059032037",4612,168,73,0,372,49,221,0,5495
"06059032038",4822,141,0,0,1198,90,358,68,6677
"06059032039",5451,159,268,0,1326,0,1184,42,8430
"06059032040",2269,76,37,0,224,50,168,43,2867
"06059032041",746,74,12,0,80,3,14,0,929
"06059032042",5322,175,50,0,506,0,862,48,6963
"06059032043",3244,21,96,0,510,40,307,11,4229
"06059032044",4817,132,26,10,750,32,384,86,6237
"06059032045",2573,56,0,0,289,0,363,0,3281
"06059032046",5028,216,73,0,629,10,455,0,6411
"06059032047",2303,185,131,9,998,15,955,18,4614
"06059032048",4070,145,78,0,1099,60,717,27,6196
"06059032049",7097,319,60,3,2060,88,1062,135,10824
"06059032050",3994,67,17,0,811,0,836,8,5733
"06059032051",2844,279,127,0,1220,18,1454,47,5989
"06059032053",6408,143,189,0,1315,127,1063,0,9245
"06059032054",4069,273,44,0,808,29,911,28,6162
"06059032055",2616,267,0,14,1028,0,1268,169,5362
"06059032056",5898,228,125,0,1368,61,1347,0,9027
"06059032057",6231,309,26,0,1430,44,1232,0,9272
"06059032058",4787,165,160,0,1467,40,1099,47,7765
"06059032059",8588,173,106,0,1861,0,1524,0,12252
"06059032061",3432,77,15,0,86,0,193,13,3816
"06059042103",5837,325,14,30,1023,160,1212,0,8601
"06059042106",1129,194,0,0,13,6,47,0,1389
"06059042107",2242,403,16,4,835,1071,1433,1243,7247
"06059042108",3650,578,0,0,875,0,1570,151,6824
"06059042109",3473,409,40,21,1037,65,741,63,5849
"06059042111",5114,340,98,0,619,0,539,22,6732
"06059042112",5037,249,36,0,1167,86,843,86,7504
"06059042113",3546,326,64,0,416,130,454,97,5033
"06059042114",3651,48,0,0,695,55,892,46,5387
"06059042201",3975,417,87,0,427,284,516,290,5996
"06059042203",5949,594,0,0,576,62,776,26,7983
"06059042205",5064,257,68,0,1117,291,949,336,8082
"06059042206",2632,231,28,0,181,0,315,9,3396
"06059042305",3247,162,0,0,213,17,170,11,3820
"06059042307",4447,478,189,0,1836,198,1287,54,8489
"06059042310",5617,959,0,0,1972,194,2373,463,11578
"06059042311",4461,159,0,0,934,260,733,243,6790
"06059042312",3188,559,0,111,4059,2084,5106,2193,17300
"06059042313",5225,491,46,16,543,584,1272,579,8756
"06059042315",4788,242,213,7,452,21,1136,0,6859
"06059042317",2666,137,44,0,257,8,181,36,3329
"06059042319",2409,80,29,0,806,10,515,0,3849
"06059042320",3219,461,296,0,1248,253,1042,101,6620
"06059042323",3686,155,0,0,320,26,187,0,4374
"06059042324",3550,405,55,0,452,72,509,30,5073
"06059042325",2422,175,132,0,760,43,401,0,3933
"06059042326",3238,154,165,0,599,428,355,406,5345
"06059042327",3599,205,24,0,857,12,316,13,5026
"06059042328",1970,58,0,0,217,0,201,0,2446
"06059042329",3051,232,19,0,578,0,548,35,4463
"06059042330",3625,492,591,0,1857,104,1582,264,8515
"06059042331",3738,315,26,0,1174,95,837,56,6241
"06059042332",4748,255,20,0,520,130,426,12,6111
"06059042333",2735,9,38,0,1033,0,162,0,3977
"06059042334",3582,171,102,0,1150,343,967,156,6471
"06059042335",3766,192,12,0,1865,96,1093,0,7024
"06059042336",3836,48,50,19,712,72,346,13,5096
"06059042337",3010,139,70,0,422,91,391,0,4123
"06059042338",4085,208,0,0,672,48,786,18,5817
"06059042339",2666,189,60,0,690,27,644,37,4313
"06059052404",42,0,0,5,256,0,5,0,308
"06059052408",4718,228,19,18,1135,17,474,45,6654
"06059052410",3245,74,133,0,1983,113,1508,81,7137
"06059052411",2484,319,99,51,1868,97,1417,265,6600
"06059052415",3135,70,353,0,619,32,510,12,4731
"06059052416",2599,42,125,6,1133,178,1114,145,5342
"06059052417",3908,103,49,16,4376,180,675,0,9307
"06059052418",5023,354,178,198,7566,977,1301,125,15722
"06059052419",1989,65,17,0,1376,46,219,46,3758
"06059052420",8852,258,326,70,11844,1298,1312,0,23960
"06059052421",2878,383,64,0,1968,179,530,10,6012
"06059052422",3103,64,0,0,1348,12,648,24,5199
"06059052423",3061,399,100,0,2113,165,999,339,7176
"06059052424",2517,420,172,0,1389,108,834,121,5561
"06059052425",3805,225,65,0,838,311,754,323,6321
"06059052426",5347,283,0,51,3103,355,643,68,9850
"06059052427",3617,33,24,0,1427,18,564,18,5701
"06059052428",4668,59,70,0,1806,45,1017,45,7710
"06059052502",4243,179,71,0,1967,65,1585,59,8169
"06059052505",2268,161,16,0,2071,325,663,90,5594
"06059052506",1636,72,96,0,700,72,232,36,2844
"06059052511",3812,156,69,42,1425,222,281,72,6079
"06059052513",3757,379,90,14,1596,268,268,62,6434
"06059052514",3299,662,0,29,1838,172,633,56,6689
"06059052515",2981,372,211,11,4849,664,966,138,10192
"06059052517",5061,151,810,0,4055,794,823,70,11764
"06059052518",2213,359,29,8,1322,130,305,12,4378
"06059052519",2325,268,99,0,1372,167,216,9,4456
"06059052520",2018,85,0,0,1184,97,285,0,3669
"06059052521",2054,550,171,0,2175,329,496,229,6004
"06059052522",1586,111,170,20,2196,245,438,19,4785
"06059052523",1801,300,39,0,1786,160,236,71,4393
"06059052524",4316,418,150,17,2668,1249,1418,608,10844
"06059052525",6487,397,458,20,8532,463,1603,93,18053
"06059052526",2286,235,92,0,1781,75,584,53,5106
"06059052527",3937,339,251,0,4334,104,785,50,9800
"06059052528",1916,62,64,0,1416,425,699,158,4740
"06059062604",8604,492,22,0,5255,477,910,0,15760
"06059062605",2670,292,0,0,211,20,264,29,3486
"06059062610",3439,439,100,0,1950,908,657,39,7532
"06059062611",1592,718,68,288,1194,807,385,156,5208
"06059062612",5044,435,0,0,1903,695,520,47,8644
"06059062614",3556,1494,61,0,2099,2600,833,525,11168
"06059062619",3713,225,48,5,143,13,375,16,4538
"06059062620",4317,240,33,12,444,0,255,14,5315
"06059062621",3626,275,22,0,1448,119,982,17,6489
"06059062622",3043,349,52,0,724,68,320,14,4570
"06059062625",2430,247,23,19,1176,549,1251,581,6276
"06059062626",906,384,51,0,383,1423,210,187,3544
"06059062627",1103,384,0,0,787,1229,217,313,4033
"06059062628",1219,8,0,0,1351,196,159,12,2945
"06059062629",1742,139,28,0,752,51,50,43,2805
"06059062630",1084,25,6,0,456,26,4,0,1601
"06059062631",2242,51,44,0,842,34,104,0,3317
"06059062632",3253,232,6,0,407,34,172,22,4126
"06059062633",4406,300,0,0,1299,80,298,31,6414
"06059062634",3698,82,317,0,1448,62,717,18,6342
"06059062635",3182,176,9,0,1189,0,816,19,5391
"06059062636",2175,41,227,20,1100,0,347,0,3910
"06059062637",2972,240,71,0,1182,66,787,15,5333
"06059062638",4066,98,157,0,1931,0,1295,0,7547
"06059062639",5150,150,288,116,1785,93,645,35,8262
"06059062640",2703,117,44,0,669,81,634,53,4301
"06059062641",3057,131,44,0,1652,132,1296,194,6506
"06059062642",2209,97,0,0,234,161,69,101,2871
"06059062643",5074,107,0,0,1465,114,184,60,7004
"06059062644",6619,718,0,0,1121,143,813,57,9471
"06059062645",5181,160,0,0,1283,176,392,0,7192
"06059062646",2424,445,28,0,457,36,91,13,3494
"06059062647",2135,211,36,0,1616,58,619,42,4717
"06059062648",2153,223,0,0,295,9,69,10,2759
"06059062649",2289,258,70,0,450,34,227,23,3351
"06059062701",2263,225,0,0,400,16,307,49,3260
"06059062702",4175,275,0,0,288,0,379,14,5131
"06059062800",2873,384,0,6,259,166,221,48,3957
"06059062900",1457,54,0,0,73,14,106,9,1713
"06059063004",4877,356,53,39,387,18,220,44,5994
"06059063005",1048,29,10,0,86,20,10,0,1203
"06059063006",2886,63,20,0,48,0,147,0,3164
"06059063007",5266,157,0,0,1165,122,435,26,7171
"06059063008",609,81,0,0,132,11,57,0,890
"06059063009",1376,33,0,0,136,19,212,0,1776
"06059063010",6526,327,109,0,643,69,679,3,8356
"06059063101",2187,68,44,7,342,188,364,180,3380
"06059063102",4648,401,38,3,938,258,817,254,7357
"06059063103",2165,362,0,0,148,42,252,20,2989
"06059063201",2756,156,8,0,734,37,598,24,4313
"06059063202",3067,149,11,0,450,141,613,153,4584
"06059063301",2108,268,0,8,485,135,360,129,3493
"06059063302",3311,309,31,0,412,15,335,32,4445
"06059063400",4004,278,0,0,449,15,260,0,5006
"06059063500",5661,595,22,60,877,104,489,15,7823
"06059063601",2562,131,23,0,1087,210,1147,210,5370
"06059063603",4179,608,26,0,893,74,902,76,6758
"06059063604",1526,412,0,0,1488,686,1608,944,6664
"06059063605",1355,242,0,18,1846,1604,2102,1610,8777
"06059063701",1368,628,77,0,2566,859,2945,1235,9678
"06059063702",1908,306,46,10,1794,913,1669,929,7575
"06059063802",2586,89,34,0,205,0,469,13,3396
"06059063803",2902,342,17,14,1187,113,1193,167,5935
"06059063805",1843,156,0,0,248,131,180,63,2621
"06059063806",3285,81,158,0,409,35,817,9,4794
"06059063807",2784,472,192,47,1025,157,1000,138,5815
"06059063808",2128,372,26,0,2107,1335,3000,1560,10528
"06059063902",4477,768,111,160,1161,277,2070,189,9213
"06059063903",2562,173,128,0,978,78,1330,164,5413
"06059063904",3047,253,76,0,1028,591,1279,603,6877
"06059063905",3434,399,8,0,698,146,948,134,5767
"06059063906",2656,657,27,0,2124,707,2283,1186,9640
"06059063907",4764,277,122,81,3175,313,944,108,9784
"06059063908",3181,183,118,20,1651,167,1556,27,6903
"06059074003",1293,349,15,11,1879,334,2213,420,6514
"06059074004",2276,177,340,0,5529,326,4789,410,13847
"06059074005",2624,603,39,0,3608,480,5106,825,13285
"06059074006",2308,335,281,10,2491,415,3377,606,9823
"06059074102",3042,185,40,0,2323,470,4587,577,11224
"06059074103",2047,214,12,0,2326,706,3944,827,10076
"06059074106",3210,456,67,0,2029,280,3221,580,9843
"06059074107",3507,357,296,0,1222,96,1372,234,7084
"06059074108",2500,518,132,44,1288,532,3494,1009,9517
"06059074109",1862,340,0,0,1539,257,3150,504,7652
"06059074110",1640,159,79,33,1998,209,1438,267,5823
"06059074111",3367,341,64,0,1990,93,3486,293,9634
"06059074200",2908,265,36,0,4449,1345,6768,1573,17344
"06059074300",1099,437,27,2,1985,634,2978,1011,8173
"06059074403",2265,1041,0,0,1910,814,4037,1855,11922
"06059074405",1740,1481,25,15,1268,674,2686,2099,9988
"06059074406",1862,468,0,25,605,322,2321,669,6272
"06059074407",2771,1361,136,113,1646,877,3868,2184,12956
"06059074408",2224,552,161,9,2397,512,3907,877,10639
"06059074501",1999,1871,88,0,1710,1362,3266,3130,13426
"06059074502",1746,348,0,0,2823,981,4296,1245,11439
"06059074601",3802,785,0,4,3042,956,6352,1667,16608
"06059074602",3565,1393,45,0,2539,1483,5984,2876,17885
"06059074701",4321,659,117,0,2137,398,5953,1032,14617
"06059074702",2533,945,14,0,2229,586,4444,1493,12244
"06059074801",1514,442,64,0,3076,1037,4370,1456,11959
"06059074802",2630,1099,29,0,2223,599,4535,1537,12652
"06059074803",3634,255,154,165,3504,1200,5239,930,15081
"06059074805",2107,1319,40,3,1718,187,3597,1462,10433
"06059074806",1588,942,65,0,1873,687,3254,1601,10010
"06059074901",2836,1227,17,0,4251,1277,6984,2271,18863
"06059074902",2176,1238,3,0,2546,762,4596,1970,13291
"06059075002",2940,1245,78,16,2508,1483,4957,2407,15634
"06059075003",1812,1103,24,0,2261,1991,3909,3070,14170
"06059075004",978,1227,0,0,1887,1259,2740,2422,10513
"06059075100",1621,508,0,0,4084,1632,4692,2024,14561
"06059075201",1367,271,0,0,3723,834,4526,1099,11820
"06059075202",1496,369,61,0,3264,591,4511,788,11080
"06059075301",1972,419,63,0,3223,492,3171,730,10070
"06059075302",1687,201,11,0,1571,661,2591,791,7513
"06059075303",1962,135,0,0,810,160,1076,223,4366
"06059075401",1940,458,23,13,1289,77,1632,386,5818
"06059075403",3916,788,138,0,2312,291,4141,886,12472
"06059075404",3593,471,26,0,860,414,2595,747,8706
"06059075405",2028,161,40,0,794,27,1542,124,4716
"06059075504",3112,164,159,0,874,49,1266,95,5719
"06059075505",2180,111,84,0,1304,144,1454,90,5367
"06059075506",2318,136,45,0,815,44,885,36,4279
"06059075507",2509,461,143,0,2102,493,2141,538,8387
"06059075512",1188,283,202,3,1684,227,1756,355,5698
"06059075513",2422,300,170,79,2647,125,2974,271,8988
"06059075514",1269,706,36,87,1335,567,2107,1147,7254
"06059075515",6039,829,324,95,7356,942,4960,1118,21663
"06059075603",2980,253,10,0,641,36,537,70,4527
"06059075604",6033,95,0,5,1258,130,707,21,8249
"06059075605",3364,179,60,0,1744,16,686,11,6060
"06059075606",4980,71,0,5,2101,87,533,26,7803
"06059075607",3059,380,125,0,2204,117,654,31,6570
"06059075701",4948,375,283,155,1563,180,3226,141,10871
"06059075702",2738,113,24,0,434,18,439,24,3790
"06059075703",3038,96,32,0,890,9,377,0,4442
"06059075805",2072,742,6,0,1166,278,1394,737,6395
"06059075806",3377,298,25,0,2132,436,3249,403,9920
"06059075807",2258,418,58,10,744,279,1065,623,5455
"06059075808",3063,172,48,0,278,28,1124,65,4778
"06059075809",2361,53,13,0,609,23,171,9,3239
"06059075810",2221,52,82,0,795,34,226,13,3423
"06059075811",1847,422,34,0,472,381,927,743,4826
"06059075812",3379,1021,93,0,1230,810,1813,1606,9952
"06059075813",3304,338,61,0,1321,64,1057,227,6372
"06059075814",2217,109,37,0,712,116,299,0,3490
"06059075815",3096,441,38,0,1279,129,1750,268,7001
"06059075816",2232,311,38,0,1025,97,1473,249,5425
"06059075901",2289,702,46,15,579,395,945,430,5401
"06059075902",4330,431,49,0,1436,464,2444,540,9694
"06059076000",3994,300,151,5,3450,518,3646,486,12550
"06059076101",3750,390,66,32,5398,657,4579,427,15299
"06059076102",1481,254,43,33,2236,416,1863,266,6592
"06059076103",4050,424,100,0,3354,737,4533,739,13937
"06059076201",3779,450,155,31,2144,31,1679,157,8426
"06059076202",4272,675,169,14,993,96,1754,480,8453
"06059076204",1836,422,18,0,1375,577,2213,791,7232
"06059076205",3120,365,35,0,1238,415,2002,389,7564
"06059076206",3594,237,0,10,512,51,1296,103,5803
"06059076208",3678,348,30,24,1146,139,1433,300,7098
"06059086301",4855,1024,51,10,1100,15,4468,1009,12532
"06059086303",3538,503,261,14,2187,143,2564,330,9540
"06059086304",2821,371,112,24,1253,115,2102,315,7113
"06059086305",3090,314,82,0,643,187,1881,88,6285
"06059086306",2269,257,80,5,1301,67,1833,221,6033
"06059086402",3544,1098,133,0,1058,122,2978,1018,9951
"06059086404",4535,906,3,7,1291,573,4538,1247,13100
"06059086405",4162,1563,214,133,778,78,4249,1523,12700
"06059086406",2885,556,44,13,602,128,1998,575,6801
"06059086407",4246,545,40,40,1342,260,3262,419,10154
"06059086501",2940,870,54,16,430,58,2638,858,7864
"06059086502",3968,1305,0,153,898,409,4389,1635,12757
"06059086601",2832,2328,158,91,2940,1106,4597,3237,17289
"06059086602",2603,1288,145,28,1867,544,2940,1452,10867
"06059086701",4391,817,54,27,3382,529,3615,1115,13930
"06059086702",2654,502,222,0,2343,784,3380,1095,10980
"06059086801",1948,68,9,0,1122,161,1198,142,4648
"06059086802",2726,545,119,78,2064,466,2565,754,9317
"06059086803",3448,493,672,0,2838,1109,2025,517,11102
"06059086901",2943,898,324,284,2473,1259,2565,1352,12098
"06059086902",2378,423,74,36,2040,504,1677,299,7431
"06059086903",3443,672,59,10,2790,301,3947,542,11764
"06059087001",1827,551,207,131,1958,428,2040,721,7863
"06059087002",2764,629,144,12,3590,365,3201,462,11167
"06059087101",1677,161,227,64,2191,391,1558,177,6446
"06059087102",1974,722,134,188,1865,485,2090,1023,8481
"06059087103",3828,200,114,0,2981,782,2846,84,10835
"06059087105",2174,285,10,0,1837,210,1746,148,6410
"06059087106",3461,492,13,0,900,142,3014,390,8412
"06059087200",5016,1129,193,0,1507,267,3737,830,12679
"06059087300",5263,1970,201,0,1493,409,4594,1969,15899
"06059087401",2669,389,124,16,822,108,2248,389,6765
"06059087403",1641,836,56,0,338,252,1793,1005,5921
"06059087404",2555,624,0,27,382,240,2705,827,7360
"06059087405",3411,1588,20,0,784,250,3727,1669,11449
"06059087503",4022,1108,49,0,1075,79,2823,1029,10185
"06059087504",3680,2112,75,10,1276,419,3852,2400,13824
"06059087505",2848,728,117,134,1247,468,2580,884,9006
"06059087601",2445,692,67,31,1353,366,1672,795,7421
"06059087602",3743,746,130,90,2286,294,2768,946,11003
"06059087701",3241,171,27,10,1913,310,2558,81,8311
"06059087703",1988,712,101,0,2564,647,2378,806,9196
"06059087704",2055,369,75,0,2220,218,1508,341,6786
"06059087801",2372,808,196,1,2045,197,1871,542,8032
"06059087802",2704,1007,372,0,3301,425,2487,1050,11346
"06059087803",1670,1138,116,0,2220,827,2625,1656,10252
"06059087805",1953,745,158,0,2677,689,2646,839,9707
"06059087806",1598,654,5,0,2564,562,2043,649,8075
"06059087901",1182,460,29,14,1696,282,956,597,5216
"06059087902",1942,805,75,10,2311,992,2529,1278,9942
"06059088001",1881,568,25,26,1813,277,1370,526,6486
"06059088002",1728,241,86,3,1421,191,883,157,4710
"06059088101",1281,23,78,5,653,101,714,77,2932
"06059088104",1869,388,160,0,2096,301,1124,311,6249
"06059088105",1379,235,26,0,2021,324,1006,0,4991
"06059088106",2132,438,87,0,2124,504,1593,597,7475
"06059088107",1610,506,5,0,3352,720,1241,391,7825
"06059088201",1675,730,21,0,1230,432,1184,560,5832
"06059088202",1349,199,18,0,1658,173,819,29,4245
"06059088203",2357,511,13,35,1913,327,1378,554,7088
"06059088301",3250,327,26,0,2807,665,2430,623,10128
"06059088302",2774,208,32,0,2970,293,1229,127,7633
"06059088401",3164,146,44,0,1575,486,1991,348,7754
"06059088402",2433,307,156,5,1201,616,2220,579,7517
"06059088403",3770,448,100,71,2856,430,3863,633,12171
"06059088501",2574,1004,22,14,2410,427,2613,904,9968
"06059088502",1063,394,27,38,2518,443,1509,439,6431
"06059088601",2460,261,98,17,3012,511,1805,160,8324
"06059088602",1913,259,139,41,2326,303,1691,149,6821
"06059088701",1661,548,0,0,3106,1035,1613,817,8780
"06059088702",1241,407,6,0,3339,956,1162,371,7482
"06059088801",1483,826,88,0,4810,930,1690,868,10695
"06059088802",990,816,88,0,2870,912,1044,972,7692
"06059088901",1088,237,34,7,4031,1136,454,438,7425
"06059088902",1135,338,0,0,2310,864,925,346,5918
"06059088903",1639,147,25,0,5759,1262,1817,312,10961
"06059088904",734,265,0,0,3209,1193,193,172,5766
"06059088905",1325,66,1,0,3488,868,1156,91,6995
"06059089001",1308,99,7,0,4375,1387,2374,454,10004
"06059089003",1188,358,5,0,1731,615,1677,613,6187
"06059089004",2136,517,13,11,3646,1338,3152,1520,12333
"06059089102",2048,275,9,0,4237,341,4490,382,11782
"06059089104",1170,873,41,0,2114,1093,2560,1403,9254
"06059089105",1602,241,108,0,2834,1452,3960,1521,11718
"06059089106",1075,289,58,0,1660,585,1891,615,6173
"06059089107",2065,51,0,19,2880,462,2769,130,8376
"06059099202",2980,836,32,14,3108,1123,3017,1310,12420
"06059099203",1525,154,70,0,3583,653,1130,152,7267
"06059099204",1173,72,7,6,2486,422,209,83,4458
"06059099212",2868,639,41,0,983,337,824,462,6154
"06059099214",2587,214,0,0,382,0,395,15,3593
"06059099215",3793,204,26,24,1081,27,748,39,5942
"06059099216",2951,111,108,0,603,93,546,19,4431
"06059099217",2069,61,25,21,271,13,262,9,2731
"06059099220",4337,209,0,0,637,66,683,61,5993
"06059099222",1396,321,34,0,2715,839,760,161,6226
"06059099223",1103,256,19,0,2911,769,700,247,6005
"06059099224",1587,34,0,0,1624,86,307,22,3660
"06059099225",1496,58,0,0,1569,131,230,22,3506
"06059099226",1565,137,17,0,2512,161,537,19,4948
"06059099227",2681,229,5,0,3236,598,1626,436,8811
"06059099229",3124,155,169,0,2660,232,960,146,7446
"06059099230",2880,194,101,0,1253,111,613,0,5152
"06059099231",3604,69,9,0,1743,124,499,0,6048
"06059099232",3574,332,0,0,1333,19,458,101,5817
"06059099233",1778,102,0,0,1343,44,288,0,3555
"06059099234",1870,102,28,0,1321,87,602,0,4010
"06059099235",3107,306,26,16,848,149,857,90,5399
"06059099237",2712,152,39,0,805,87,472,0,4267
"06059099238",2858,100,0,0,813,190,168,41,4170
"06059099239",2838,194,8,0,826,40,308,30,4244
"06059099240",4114,314,38,0,820,13,621,15,5935
"06059099241",2349,253,120,29,1495,167,650,123,5186
"06059099242",2332,206,0,0,1233,24,1577,52,5424
"06059099243",3142,137,87,0,963,0,618,0,4947
"06059099244",2777,154,0,0,567,0,209,14,3721
"06059099245",2456,138,0,0,438,0,276,0,3308
"06059099246",2911,96,0,0,638,2,482,18,4147
"06059099247",671,248,10,0,1895,586,1063,387,4860
"06059099248",1449,450,50,14,2573,850,2539,962,8887
"06059099249",866,923,0,0,2039,668,2255,1480,8231
"06059099250",1543,50,59,0,1036,232,288,7,3215
"06059099251",1957,411,243,0,2841,333,1903,42,7730
"06059099305",5276,392,30,26,1553,551,2160,634,10622
"06059099306",4767,260,178,0,660,255,650,276,7046
"06059099307",2065,88,0,0,329,66,292,0,2840
"06059099308",4876,27,16,0,838,33,519,0,6309
"06059099309",4045,356,146,0,720,25,371,87,5750
"06059099310",2961,398,0,0,1151,59,815,45,5429
"06059099311",2964,292,22,0,449,23,470,64,4284
"06059099402",3713,1347,0,0,2195,1760,4110,2794,15919
"06059099404",3599,148,103,0,604,181,440,48,5123
"06059099405",3204,264,17,0,881,43,692,66,5167
"06059099406",3133,233,90,16,1037,104,681,32,5326
"06059099407",1673,153,7,19,642,44,331,26,2895
"06059099408",2941,247,54,0,958,34,490,95,4819
"06059099410",2318,574,83,0,1194,128,703,348,5348
"06059099411",3377,426,40,0,1182,385,1362,387,7159
"06059099412",3337,310,21,0,1073,135,630,135,5641
"06059099413",4851,889,0,0,1765,343,788,427,9063
"06059099415",4538,130,19,0,816,5,559,3,6070
"06059099416",3405,449,27,0,781,85,850,156,5753
"06059099417",3044,189,15,0,685,185,456,69,4643
"06059099502",311,4,88,0,143,0,195,0,741
"06059099504",2175,138,0,0,480,11,370,19,3193
"06059099506",768,46,28,0,130,38,174,22,1206
"06059099508",2965,519,123,0,773,136,705,339,5560
"06059099509",2665,242,0,0,504,95,257,52,3815
"06059099510",2973,698,0,1,469,97,184,46,4468
"06059099511",2428,172,0,0,537,17,609,7,3770
"06059099512",2017,371,63,0,467,58,465,36,3477
"06059099513",1762,161,0,0,440,0,242,0,2605
"06059099514",3787,143,24,0,1039,0,386,22,5401
"06059099601",2220,428,86,114,3058,1381,1687,739,9713
"06059099602",2165,243,0,0,759,131,600,19,3917
"06059099603",4360,238,41,0,1941,86,918,0,7584
"06059099604",2991,51,0,0,536,43,536,25,4182
"06059099605",2720,125,0,0,869,2,613,0,4329
"06059099701",1446,164,0,0,3909,795,564,66,6944
"06059099702",3007,508,0,13,3324,1242,1995,379,10468
"06059099703",2121,282,26,0,2464,244,452,29,5618
"06059099801",1695,514,28,0,2618,974,1290,688,7807
"06059099802",1544,205,8,0,2035,844,1013,169,5818
"06059099803",1791,314,44,0,2708,475,1269,183,6784
"06059099902",2182,273,73,0,1797,347,714,193,5579
"06059099903",1769,419,79,0,2964,767,1598,636,8232
"06059099904",2003,242,7,0,3096,1320,1962,548,9178
"06059099905",1971,272,36,0,1259,278,1231,293,5340
"06059099906",3132,101,84,0,1887,43,783,0,6030
"06059110001",3010,318,102,0,831,28,498,109,4896
"06059110003",2397,175,33,0,727,57,890,75,4354
"06059110004",3636,61,256,0,972,7,652,0,5584
"06059110005",2528,84,0,0,640,34,501,8,3795
"06059110006",2377,108,88,0,593,12,324,14,3516
"06059110007",3866,128,0,0,765,13,713,11,5496
"06059110008",3501,82,0,0,965,9,485,7,5049
"06059110010",3056,136,142,0,1467,201,843,21,5866
"06059110011",1698,16,61,0,982,213,298,31,3299
"06059110012",3845,130,18,9,1028,18,691,0,5739
"06059110014",2611,237,120,122,1396,218,1139,221,6064
"06059110015",2873,153,0,0,527,22,426,9,4010
"06059110102",2397,227,92,0,2559,493,806,107,6681
"06059110104",2933,108,59,70,2337,247,1139,76,6969
"06059110106",2328,84,224,0,1353,58,794,8,4849
"06059110108",1482,184,120,24,920,76,513,9,3328
"06059110109",2780,210,197,0,1976,47,773,67,6050
"06059110110",3164,407,99,0,1990,385,1691,101,7837
"06059110111",2926,169,88,10,2474,162,1027,75,6931
"06059110113",1284,137,32,36,819,71,302,34,2715
"06059110114",3309,250,19,34,1356,70,985,52,6075
"06059110115",1301,0,293,0,1804,37,526,0,3961
"06059110116",1721,84,226,78,2407,341,493,71,5421
"06059110117",3524,98,305,0,1822,334,897,0,6980
"06059110118",948,5,42,0,1561,81,236,5,2878
"06059110201",3976,635,434,0,2515,413,2141,412,10526
"06059110202",2875,499,85,155,2981,557,1996,535,9683
"06059110203",3473,117,53,45,1330,351,1031,323,6723
"06059110301",3673,634,244,0,2566,161,1635,556,9469
"06059110302",3136,297,6,24,1880,162,2157,226,7888
"06059110303",3203,91,68,0,1705,176,1837,108,7188
"06059110304",2396,55,119,0,1708,87,1106,42,5513
"06059110401",3434,43,37,20,1654,38,1893,15,7134
"06059110402",2898,815,40,11,1423,80,2005,745,8017
"06059110500",4140,1243,358,218,1445,760,3226,1113,12503
"06059110603",4334,1013,788,0,2266,450,4304,991,14146
"06059110604",2602,242,210,23,4420,308,1127,160,9092
"06059110605",1567,21,3,10,3720,1080,298,56,6755
"06059110606",1693,990,319,186,1546,17,1766,986,7503
"06059110607",1860,153,128,0,2253,182,1130,90,5796
"06059980000",0,0,0,0,0,0,0,0,0
"06059990100",0,0,0,0,0,0,0,0,0
"06061020104",930,176,28,0,0,1,115,25,1275
"06061020105",1069,114,0,0,0,0,206,15,1404
"06061020106",1397,124,0,0,59,21,524,11,2136
"06061020107",2223,502,7,0,348,22,1540,389,5031
"06061020200",4990,706,0,21,203,42,264,87,6313
"06061020300",3121,481,17,20,580,71,370,71,4731
"06061020401",1217,397,85,59,189,73,141,25,2186
"06061020402",3087,246,0,0,126,0,66,11,3536
"06061020501",2513,317,28,4,228,25,378,12,3505
"06061020502",3552,349,9,45,277,19,109,18,4378
"06061020601",6662,66,0,1,833,90,487,24,8163
"06061020602",5894,310,90,45,544,57,618,34,7592
"06061020604",4792,248,84,25,783,267,439,0,6638
"06061020605",4903,158,75,3,938,7,304,0,6388
"06061020606",3220,30,23,0,951,0,217,9,4450
"06061020710",3693,202,0,4,559,7,509,0,4974
"06061020711",3523,209,10,0,550,48,409,10,4759
"06061020712",2918,493,31,16,291,0,724,156,4629
"06061020713",2202,423,14,61,382,16,340,149,3587
"06061020714",3068,304,142,0,471,20,275,17,4297
"06061020715",2407,219,7,3,331,89,190,76,3322
"06061020717",2074,96,0,0,908,42,582,0,3702
"06061020805",3304,320,25,0,677,148,456,144,5074
"06061020806",2741,163,31,0,393,191,713,190,4422
"06061020901",1262,428,33,39,483,301,590,377,3513
"06061020908",4776,506,42,9,1119,451,1517,515,8935
"06061021003",4641,490,0,49,739,86,980,230,7215
"06061021034",3216,225,0,0,983,10,470,0,4904
"06061021035",5282,146,115,0,1552,368,913,68,8444
"06061021037",1628,50,27,5,429,15,104,0,2258
"06061021038",5736,101,18,94,748,264,902,230,8093
"06061021039",1497,17,16,0,102,0,15,0,1647
"06061021040",2832,218,0,0,136,0,135,0,3321
"06061021043",2730,70,70,0,487,17,300,37,3711
"06061021044",4729,449,127,0,742,320,794,0,7161
"06061021045",2040,333,0,2,688,12,656,68,3799
"06061021046",3360,218,0,0,737,51,493,53,4912
"06061021103",2927,194,24,12,335,30,494,19,4035
"06061021106",1655,126,7,9,102,11,57,29,1996
"06061021108",2082,231,0,0,202,40,223,29,2807
"06061021109",3962,297,124,61,464,0,323,0,5231
"06061021122",3042,87,40,10,233,9,264,9,3694
"06061021123",6674,162,28,3,939,36,714,11,8567
"06061021128",2167,104,274,17,536,21,300,21,3440
"06061021129",2272,232,29,0,329,241,268,150,3521
"06061021130",1986,245,8,14,504,202,431,59,3449
"06061021131",3569,554,17,23,847,67,288,14,5379
"06061021203",5860,235,30,2,458,24,318,0,6927
"06061021204",2066,365,0,0,300,0,351,5,3087
"06061021304",4164,640,0,8,324,119,690,114,6059
"06061021309",7572,283,0,0,2101,433,1206,550,12145
"06061021322",7957,1117,112,112,3178,199,980,354,14009
"06061021401",1937,355,3,0,117,41,345,138,2936
"06061021403",4502,1701,0,0,1305,265,2371,1008,11152
"06061021501",4642,692,69,9,501,63,605,491,7072
"06061021502",3231,311,14,0,257,48,341,56,4258
"06061021603",3193,734,0,1,593,207,943,634,6305
"06061021604",3242,379,0,38,198,0,323,23,4203
"06061021801",3914,317,33,0,223,52,280,46,4865
"06061021802",4834,485,184,16,548,75,890,0,7032
"06061021901",2048,254,18,3,234,20,124,23,2724
"06061021902",4101,111,0,0,287,0,314,0,4813
"06061022002",5888,779,50,34,351,34,542,18,7696
"06061022011",1722,107,0,0,0,0,144,52,2025
"06061022013",2063,351,0,0,74,30,66,21,2605
"06061022014",1015,98,0,0,14,21,46,21,1215
"06061022100",856,53,0,0,66,0,58,0,1033
"06061022200",985,32,2,0,0,42,233,30,1324
"06061022300",618,76,0,0,42,0,32,0,768
"06061022400",3010,366,29,0,843,49,505,20,4822
"06061022500",2834,116,86,0,913,8,371,0,4328
"06061022600",3656,404,48,50,559,29,505,66,5317
"06061022800",2604,160,26,33,999,85,469,22,4398
"06061022900",3187,380,195,0,1717,60,699,335,6573
"06061023000",2403,207,44,104,512,58,251,158,3737
"06061023100",5427,146,299,0,1479,21,387,21,7780
"06061023200",3840,27,78,1,1240,125,963,123,6397
"06061023300",3262,228,109,48,698,12,496,65,4918
"06061023400",3725,84,73,2,450,0,619,0,4953
"06061023500",4106,156,55,0,1003,77,689,56,6142
"06061023600",3950,238,0,0,309,0,202,14,4713
"06061023700",2878,198,66,0,213,45,102,0,3502
"06061023800",3049,278,41,0,77,6,161,0,3612
"06061023900",2397,222,27,26,542,0,829,4,4047
"06061990000",0,0,0,0,0,0,0,0,0
"06063000100",3725,922,51,38,325,148,102,58,5369
"06063000201",1240,79,0,3,95,12,74,12,1515
"06063000202",744,177,17,0,33,0,73,0,1044
"06063000300",3333,645,17,0,373,137,780,124,5409
"06063000400",1961,410,0,0,231,63,174,30,2869
"06063000501",1578,223,0,2,156,0,42,35,2036
"06063000502",1909,108,0,0,125,39,19,13,2213
"06065030101",847,102,15,17,110,49,728,133,2001
"06065030103",1620,236,38,25,153,395,1221,392,4080
"06065030104",3705,757,381,48,1448,1655,3424,1568,12986
"06065030200",2527,502,224,21,992,133,1350,346,6095
"06065030300",1436,965,206,97,475,142,942,503,4766
"06065030400",2180,1862,500,190,1545,473,3415,2153,12318
"06065030501",1141,1320,670,104,892,440,1697,1503,7767
"06065030502",1317,409,10,40,619,81,1867,414,4757
"06065030503",1567,1135,72,136,468,253,1894,1206,6731
"06065030601",3884,53,213,44,1020,6,956,0,6176
"06065030602",2649,132,89,0,567,0,595,79,4111
"06065030603",2366,252,82,113,135,64,308,111,3431
"06065030700",3896,1660,260,103,373,276,1490,1342,9400
"06065030800",5179,717,170,22,1102,251,2848,548,10837
"06065030900",2487,254,339,8,302,28,1803,199,5420
"06065031001",3898,459,243,121,800,110,1925,249,7805
"06065031002",2481,864,197,43,491,424,2118,1199,7817
"06065031100",3149,431,146,88,358,243,1396,221,6032
"06065031200",4629,666,248,0,848,242,2400,494,9527
"06065031300",1099,695,42,110,546,202,1630,892,5216
"06065031401",4019,1244,228,363,878,404,2739,1193,11068
"06065031402",5178,308,335,154,630,167,3059,280,10111
"06065031501",2791,857,165,3,1563,292,2345,780,8796
"06065031502",3745,1247,125,39,2756,527,3328,1507,13274
"06065031601",1524,689,70,79,1802,461,2225,521,7371
"06065031602",2316,781,208,58,2300,442,2964,1115,10184
"06065031701",1623,525,152,33,338,146,965,601,4383
"06065031702",1646,64,105,4,709,9,1035,61,3633
"06065031703",2517,141,51,13,995,226,1916,238,6097
"06065031704",3196,470,235,68,986,84,1905,265,7209
"06065040101",1601,408,279,93,1495,371,2584,765,7596
"06065040102",1848,277,14,0,1675,525,2289,621,7249
"06065040201",2422,481,129,171,2930,394,3572,742,10841
"06065040202",1990,292,221,7,929,33,1859,195,5526
"06065040203",1040,797,13,91,1423,573,2232,1267,7436
"06065040204",964,192,193,32,1382,562,2134,733,6192
"06065040301",2436,559,111,47,3504,1576,4874,1844,14951
"06065040302",5171,203,159,46,2118,11,2900,90,10698
"06065040303",1588,211,46,0,1031,336,1849,498,5559
"06065040402",1702,140,0,0,1418,963,2380,996,7599
"06065040403",3147,428,155,0,1853,286,3715,569,10153
"06065040404",1609,174,68,0,1238,13,1831,43,4976
"06065040405",3698,217,264,2,986,0,2255,60,7482
"06065040501",3450,881,70,10,2251,728,4046,1361,12797
"06065040502",2179,728,169,38,2313,926,3745,1521,11619
"06065040503",2392,172,299,65,936,128,1968,197,6157
"06065040603",1381,170,18,0,672,84,1405,237,3967
"06065040604",3919,513,0,0,870,325,2596,637,8860
"06065040605",1256,192,0,18,1040,231,1930,281,4948
"06065040606",1130,313,20,0,1465,181,2098,374,5581
"06065040607",4497,122,537,171,2915,303,4273,288,13106
"06065040609",4606,200,786,72,4740,172,3722,111,14409
"06065040611",3455,42,404,102,2864,249,2558,135,9809
"06065040613",5636,264,1213,75,5393,132,4710,215,17638
"06065040615",4266,404,854,84,3204,167,3425,353,12757
"06065040616",2737,165,1061,0,4067,108,2486,78,10702
"06065040701",1734,79,45,0,364,19,480,2,2723
"06065040702",2412,145,22,2,201,30,805,52,3669
"06065040703",2588,196,10,20,299,35,782,95,4025
"06065040806",1944,47,81,0,622,11,705,16,3426
"06065040807",2257,340,98,15,568,9,1020,250,4557
"06065040808",4070,975,376,75,1218,251,2565,429,9959
"06065040809",1481,323,330,7,1138,36,1380,291,4986
"06065040812",2930,231,17,0,386,8,994,8,4574
"06065040813",3900,145,362,0,1935,236,1973,233,8784
"06065040814",2443,334,276,209,1407,68,1191,185,6113
"06065040815",1876,97,357,6,1244,31,1461,36,5108
"06065040816",1983,87,276,85,745,17,878,0,4071
"06065040821",3025,259,373,104,1741,124,2439,193,8258
"06065040901",4254,448,632,36,1810,290,3213,538,11221
"06065040902",2912,812,508,16,707,195,1364,766,7280
"06065040903",1479,519,28,12,292,152,741,528,3751
"06065040904",2047,893,87,0,791,51,1994,760,6623
"06065041001",1482,476,198,99,461,284,1499,627,5126
"06065041002",1462,648,80,0,1038,267,1807,815,6117
"06065041003",1870,216,57,48,495,13,1269,131,4099
"06065041004",2161,743,67,0,1272,483,2184,817,7727
"06065041101",2146,1633,11,260,1560,300,3279,1787,10976
"06065041102",2412,474,5,29,589,287,2345,665,6806
"06065041201",2090,524,70,36,906,383,1864,659,6532
"06065041202",2471,550,6,0,1761,269,3738,802,9597
"06065041203",1607,326,170,10,1263,565,2276,715,6932
"06065041301",2111,356,6,0,774,193,2411,382,6233
"06065041302",2589,1015,18,0,954,206,2989,1116,8887
"06065041403",1516,105,123,33,1007,95,1457,120,4456
"06065041404",1882,292,175,0,1651,209,2072,441,6722
"06065041405",1886,518,0,0,1657,281,2045,525,6912
"06065041406",3909,547,720,43,829,105,2626,376,9155
"06065041407",2995,947,169,31,839,301,2667,908,8857
"06065041408",2301,108,294,116,900,52,1795,122,5688
"06065041409",10359,731,677,240,4801,743,4782,626,22959
"06065041410",1422,665,0,0,480,362,1711,978,5618
"06065041411",1863,821,83,2,492,128,1877,819,6085
"06065041412",2153,552,216,0,1357,356,1722,676,7032
"06065041500",1364,572,75,9,269,169,1379,699,4536
"06065041600",3302,1353,177,8,622,682,3078,1644,10866
"06065041702",3562,571,0,0,863,31,2423,479,7929
"06065041703",3033,1695,138,89,663,254,2667,1727,10266
"06065041704",2215,960,0,0,540,403,2407,1251,7776
"06065041803",4368,76,204,0,1886,2,1593,3,8132
"06065041804",2504,213,199,0,923,112,1179,182,5312
"06065041805",3953,465,139,22,1291,30,2241,192,8333
"06065041806",3048,145,382,0,1027,50,1379,123,6154
"06065041807",1976,149,0,12,400,0,1010,142,3689
"06065041808",4163,206,347,135,1483,190,1622,76,8222
"06065041809",3711,419,603,0,809,105,1585,87,7319
"06065041810",3939,62,456,45,1325,54,1191,8,7080
"06065041812",2294,124,101,0,521,163,1272,103,4578
"06065041813",4554,1590,24,53,1108,98,3640,1485,12552
"06065041904",3388,239,24,17,1322,162,1815,250,7217
"06065041905",1705,324,203,0,629,87,1139,241,4328
"06065041906",4289,784,340,8,992,52,3451,650,10566
"06065041909",4198,179,96,0,856,188,2279,199,7995
"06065041910",4255,873,207,0,1326,112,2096,468,9337
"06065041911",7445,420,1125,40,2606,133,2941,207,14917
"06065041912",3663,197,10,163,1689,57,1244,25,7048
"06065041913",3635,319,85,0,1538,36,1579,174,7366
"06065042003",4081,857,236,0,972,167,1669,232,8214
"06065042004",2642,260,34,0,453,20,808,175,4392
"06065042005",3815,76,376,0,1020,93,1457,103,6940
"06065042007",3004,360,137,0,601,218,810,277,5407
"06065042008",4974,174,459,29,1368,10,2235,11,9260
"06065042009",3967,671,478,56,1814,1371,3839,1548,13744
"06065042010",2153,692,337,48,1822,1499,3086,1851,11488
"06065042012",3457,1276,500,70,1236,203,2038,112,8892
"06065042013",4763,337,972,0,2175,85,2131,270,10733
"06065042014",6660,188,1157,54,1928,296,3218,27,13528
"06065042206",2466,756,435,158,920,515,1049,754,7053
"06065042207",2511,168,66,10,285,0,755,32,3827
"06065042208",2098,113,75,1,318,0,326,5,2936
"06065042209",1229,834,199,206,410,582,936,643,5039
"06065042210",1437,672,279,155,680,717,1018,695,5653
"06065042212",4049,366,702,156,1066,401,2552,637,9929
"06065042213",2178,324,72,12,1033,546,735,236,5136
"06065042214",3549,534,646,79,1323,307,2221,578,9237
"06065042217",3688,133,266,56,1106,284,1104,132,6769
"06065042300",3747,1224,71,5,1910,291,3846,1206,12300
"06065042401",1313,77,18,27,368,27,903,29,2762
"06065042402",1988,450,761,11,1185,558,1507,865,7325
"06065042403",2699,596,195,82,743,75,1908,525,6823
"06065042404",786,542,218,190,561,60,893,507,3757
"06065042405",1654,697,792,986,933,148,1792,643,7645
"06065042406",2160,257,509,125,1098,136,2177,318,6780
"06065042407",1465,303,102,169,1046,96,1659,122,4962
"06065042408",1458,440,302,0,837,130,1477,522,5166
"06065042409",1489,120,252,378,613,326,1412,314,4904
"06065042410",2857,312,1111,19,819,232,1711,479,7540
"06065042411",1306,182,507,126,430,13,902,167,3633
"06065042412",3660,231,627,84,727,22,1600,223,7174
"06065042505",1272,963,39,157,867,445,1713,1314,6770
"06065042506",3158,594,1914,786,2194,532,2859,551,12588
"06065042507",2264,207,459,759,1341,9,2594,156,7789
"06065042508",2028,642,357,110,867,600,2427,1121,8152
"06065042509",1481,449,426,69,608,61,1654,348,5096
"06065042510",2362,919,252,368,1337,235,2805,783,9061
"06065042511",1255,546,266,75,930,605,1829,837,6343
"06065042512",1380,406,346,260,667,302,1692,553,5606
"06065042513",1743,249,441,33,527,243,1722,403,5361
"06065042514",1262,355,136,103,472,455,1075,627,4485
"06065042515",1648,1075,227,77,553,674,2054,1735,8043
"06065042516",1914,395,432,87,1122,294,2562,569,7375
"06065042517",1605,455,127,13,781,177,1718,317,5193
"06065042518",1331,285,297,257,1113,504,1770,664,6221
"06065042519",575,302,139,180,182,38,552,328,2296
"06065042520",1841,579,325,111,870,630,2195,1072,7623
"06065042521",1628,764,434,302,1006,303,1840,908,7185
"06065042617",2837,1467,702,721,4279,1727,6218,3090,21041
"06065042618",3250,1178,290,207,2992,1227,5459,1770,16373
"06065042619",4131,293,1408,202,4975,236,6635,353,18233
"06065042620",2827,918,1114,487,5306,1044,5872,1812,19380
"06065042621",2622,352,1198,154,1678,111,2865,353,9333
"06065042622",1553,225,789,16,1299,262,1267,349,5760
"06065042623",2198,57,688,150,654,250,1301,304,5602
"06065042624",2122,271,767,28,978,277,1587,242,6272
"06065042706",2393,890,520,495,2876,1373,4565,2105,15217
"06065042708",3021,550,176,11,953,213,1554,314,6792
"06065042709",3237,467,150,26,388,247,1332,315,6162
"06065042711",3652,244,242,13,423,124,546,178,5422
"06065042714",2947,271,21,0,43,0,268,52,3602
"06065042715",8489,310,826,51,3617,746,4495,193,18727
"06065042716",4680,250,0,0,286,255,723,456,6650
"06065042717",2577,553,174,69,1527,417,2003,519,7839
"06065042719",3207,991,111,81,887,298,1947,1177,8699
"06065042720",3434,808,0,1,669,81,2276,578,7847
"06065042723",2918,1726,111,0,685,223,1229,1513,8405
"06065042724",2481,89,322,9,517,18,725,50,4211
"06065042726",4045,393,444,0,1441,106,1720,152,8301
"06065042728",1391,405,29,0,276,98,743,69,3011
"06065042729",6274,1305,606,27,1803,218,2628,713,13574
"06065042730",3275,783,214,0,876,107,2474,838,8567
"06065042731",3635,460,177,59,1154,295,2399,692,8871
"06065042732",3958,117,374,22,1254,52,2198,79,8054
"06065042733",3704,301,389,0,724,32,1286,209,6645
"06065042737",1695,40,91,36,398,47,388,59,2754
"06065042738",4313,434,349,74,1387,15,1582,37,8191
"06065042739",4866,430,759,15,1727,126,2801,203,10927
"06065042740",1660,147,59,92,88,27,127,27,2227
"06065042741",1536,258,155,0,122,12,172,37,2292
"06065042742",3267,78,318,4,1061,8,1412,39,6187
"06065042743",1607,48,11,0,377,71,585,45,2744
"06065042744",2486,221,31,0,834,144,1710,193,5619
"06065042745",3617,497,117,0,965,178,1357,355,7086
"06065042800",1975,1155,423,193,2750,1836,4054,2859,15245
"06065042901",2850,759,439,270,2543,1547,4486,2101,14995
"06065042902",1546,794,255,53,945,1184,1562,1823,8162
"06065042903",1791,846,453,83,1558,1219,2323,1757,10030
"06065042904",2189,1698,208,251,3636,1064,4874,2339,16259
"06065043001",1700,962,204,38,2100,450,2765,837,9056
"06065043003",2817,758,8,193,1934,722,3190,1055,10677
"06065043005",2706,495,17,52,1834,500,2971,751,9326
"06065043006",1247,950,63,13,2015,918,2276,1640,9122
"06065043007",4727,367,588,18,1215,77,1651,178,8821
"06065043008",3482,569,154,80,1465,670,2359,939,9718
"06065043009",2579,245,115,0,1656,130,1878,233,6836
"06065043010",3948,162,194,30,1392,68,2663,192,8649
"06065043206",4416,524,491,0,2220,413,1769,520,10353
"06065043211",3932,451,280,0,709,109,1337,118,6936
"06065043216",4936,901,157,123,1193,84,1957,287,9638
"06065043217",2768,72,133,0,487,50,1298,15,4823
"06065043218",4572,225,96,5,1245,84,1394,136,7757
"06065043220",2260,467,162,72,586,286,1088,306,5227
"06065043222",2982,275,113,0,345,61,624,155,4555
"06065043227",4029,262,680,0,2204,246,2126,280,9827
"06065043228",2652,301,295,99,950,19,1360,194,5870
"06065043229",4263,205,352,0,361,0,585,41,5807
"06065043235",3124,200,384,0,1302,40,866,185,6101
"06065043239",4547,463,4,0,812,0,1198,201,7225
"06065043240",6771,297,385,0,2338,25,2148,83,12047
"06065043242",6103,290,346,0,2368,148,2758,225,12238
"06065043244",4790,108,434,0,2139,88,1962,14,9535
"06065043246",4125,440,62,0,1003,31,924,56,6641
"06065043247",4963,531,590,48,2376,38,2079,208,10833
"06065043248",3435,83,98,0,834,110,906,9,5475
"06065043250",6075,155,322,40,1888,457,1352,350,10639
"06065043252",4940,190,296,20,2217,428,1253,65,9409
"06065043254",3247,400,201,0,1132,151,1377,180,6688
"06065043256",1934,124,161,0,1106,104,1157,38,4624
"06065043257",5225,105,501,52,1596,157,484,87,8207
"06065043262",3824,254,38,48,681,31,653,31,5560
"06065043264",5420,292,274,0,1466,259,1604,197,9512
"06065043265",4832,151,97,0,1371,50,1434,67,8002
"06065043266",2876,481,401,34,1264,230,1554,255,7095
"06065043267",5128,313,69,0,1094,0,1202,0,7806
"06065043270",3627,317,471,18,793,104,1199,40,6569
"06065043271",2659,268,104,0,514,333,1329,418,5625
"06065043272",4080,153,29,2,764,80,1206,87,6401
"06065043274",1243,144,17,7,497,175,584,292,2959
"06065043276",1560,230,804,0,792,58,538,58,4040
"06065043278",4882,566,354,68,1090,62,1616,0,8638
"06065043279",3829,439,258,0,469,8,1716,9,6728
"06065043291",5212,298,177,0,1944,197,1714,35,9577
"06065043304",5463,704,4,0,626,56,1259,36,8148
"06065043306",3165,465,318,165,612,51,1257,324,6357
"06065043307",2995,1204,411,263,813,571,1464,935,8656
"06065043308",1362,477,173,132,415,160,712,234,3665
"06065043309",1543,454,150,66,435,163,907,325,4043
"06065043310",1701,512,169,63,637,409,940,495,4926
"06065043311",1380,533,14,0,251,144,563,301,3186
"06065043312",2808,387,139,187,762,138,1992,332,6745
"06065043313",1919,421,29,190,702,238,1454,392,5345
"06065043314",2421,673,0,82,363,117,951,455,5062
"06065043315",1412,145,0,0,347,68,395,99,2466
"06065043316",2379,175,294,0,1078,129,362,156,4573
"06065043317",4628,1141,423,443,1479,330,2332,966,11742
"06065043401",2123,1343,37,135,865,838,1985,1407,8733
"06065043403",887,635,250,299,704,195,968,379,4317
"06065043404",1702,476,36,87,225,117,316,226,3185
"06065043405",1877,1174,120,406,508,253,922,792,6052
"06065043503",2100,741,88,142,394,120,854,203,4642
"06065043504",4771,777,324,65,1629,200,2614,403,10783
"06065043505",2241,436,58,20,291,120,758,67,3991
"06065043506",3353,899,64,51,1040,343,1527,796,8073
"06065043507",3005,1290,547,230,1206,639,2342,1482,10741
"06065043508",3749,994,320,2,1457,370,2089,563,9544
"06065043509",3245,412,10,129,967,230,2146,298,7437
"06065043512",3719,553,614,77,1374,512,2690,440,9979
"06065043513",1385,142,102,96,877,142,1280,101,4125
"06065043517",4224,578,470,169,1750,197,3287,519,11194
"06065043601",1680,803,27,168,926,447,1813,869,6733
"06065043602",1003,623,23,162,1721,427,2218,754,6931
"06065043701",2144,1067,62,34,41,110,805,348,4611
"06065043702",3129,935,90,26,735,191,899,729,6734
"06065043703",1589,350,6,0,593,573,548,419,4078
"06065043802",4189,808,0,0,381,222,1216,441,7257
"06065043807",3523,622,202,0,1063,378,1859,733,8380
"06065043809",2461,314,0,7,207,63,411,123,3586
"06065043810",2912,221,138,27,1267,39,1275,45,5924
"06065043811",3566,346,0,45,478,92,1197,242,5966
"06065043812",5316,355,134,0,286,0,233,0,6324
"06065043813",2353,720,58,0,1485,477,1561,767,7421
"06065043814",849,14,0,0,24,6,65,0,958
"06065043818",2271,85,358,17,1254,82,1266,80,5413
"06065043820",2285,168,328,140,1515,131,1476,152,6195
"06065043821",1732,387,185,75,519,241,850,480,4469
"06065043822",1440,192,21,5,998,25,736,36,3453
"06065043823",5730,189,487,0,2157,28,2426,49,11066
"06065043900",4013,604,49,32,696,343,2247,480,8464
"06065044000",886,413,39,0,377,183,832,373,3103
"06065044101",1226,737,196,62,445,231,1108,890,4895
"06065044102",1467,313,103,62,681,234,1139,450,4449
"06065044103",3818,566,450,0,600,189,1192,446,7261
"06065044104",2010,527,0,2,375,100,1092,334,4440
"06065044200",1991,1063,398,511,727,700,1534,1433,8357
"06065044300",2160,428,308,88,1042,119,1734,253,6132
"06065044402",4381,265,13,0,591,139,1635,162,7186
"06065044403",2455,503,22,3,588,45,1002,5,4623
"06065044404",1148,277,0,0,50,19,226,37,1757
"06065044405",1394,95,0,0,25,20,67,20,1621
"06065044505",4209,464,167,1,1576,258,3784,486,10945
"06065044507",2772,2021,39,102,1235,955,2557,2424,12105
"06065044509",1439,866,34,345,869,789,1007,1365,6714
"06065044510",1614,1015,130,376,1851,812,2190,1358,9346
"06065044515",1143,572,31,1,1553,195,2008,363,5866
"06065044516",3336,969,440,40,1618,343,3498,801,11045
"06065044517",1744,197,20,11,271,53,298,74,2668
"06065044518",2766,848,135,232,1303,219,1783,434,7720
"06065044520",835,94,33,0,552,188,691,227,2620
"06065044521",460,99,10,159,26,29,178,17,978
"06065044522",2229,517,183,32,1183,485,1478,691,6798
"06065044602",1988,632,143,26,352,26,855,269,4291
"06065044604",2926,492,122,14,1163,187,1741,171,6816
"06065044605",2709,680,364,290,553,230,1496,589,6911
"06065044606",1551,268,107,0,183,205,424,280,3018
"06065044701",1999,251,296,21,624,184,770,54,4199
"06065044702",1233,315,26,11,269,296,1317,575,4042
"06065044804",1366,547,18,0,906,40,895,483,4255
"06065044805",1138,233,0,103,191,22,110,43,1840
"06065044806",1551,331,17,0,115,50,288,148,2500
"06065044807",1046,121,47,0,195,38,240,52,1739
"06065044904",3192,286,82,184,1099,118,2088,175,7224
"06065044907",2877,1127,160,97,814,147,3419,1135,9776
"06065044911",3573,387,65,0,918,242,1114,237,6536
"06065044915",2952,1690,28,26,1260,831,3851,2427,13065
"06065044916",2804,840,154,262,516,221,1418,905,7120
"06065044917",3701,345,0,0,186,0,78,18,4328
"06065044918",2377,172,0,0,59,36,73,11,2728
"06065044919",3607,250,42,0,167,0,218,0,4284
"06065044921",1624,124,48,0,281,36,249,70,2432
"06065044922",3657,151,87,0,1139,71,597,63,5765
"06065044923",2179,399,100,170,848,25,1560,323,5604
"06065044924",2718,540,21,0,1191,63,2677,491,7701
"06065044925",2117,398,48,11,660,159,1872,410,5675
"06065044926",2254,1601,166,6,922,91,2009,1528,8577
"06065044927",2413,315,14,0,582,123,551,91,4089
"06065044928",2739,127,0,0,224,19,247,31,3387
"06065044929",3722,552,125,0,421,0,952,76,5848
"06065044930",1984,392,0,0,323,66,782,245,3792
"06065044931",1598,371,56,9,543,116,1365,390,4448
"06065044932",2209,145,29,15,609,2,979,128,4116
"06065045000",1891,665,8,29,308,270,878,697,4746
"06065045103",3017,731,0,0,125,36,440,429,4778
"06065045108",3965,163,147,17,1393,293,3115,375,9468
"06065045109",2734,329,67,0,440,61,1356,197,5184
"06065045110",3432,323,290,0,1083,69,2468,182,7847
"06065045114",1503,187,17,0,29,0,140,17,1893
"06065045115",1691,47,0,0,114,0,69,0,1921
"06065045116",1121,150,0,0,71,24,144,14,1524
"06065045117",3374,392,25,0,274,100,695,141,5001
"06065045118",1174,743,48,0,725,83,572,306,3651
"06065045119",1946,167,0,13,562,49,1074,83,3894
"06065045120",2707,653,190,0,1127,186,2075,647,7585
"06065045121",4705,485,90,35,637,192,874,493,7511
"06065045122",1306,91,19,0,44,0,15,0,1475
"06065045123",1821,153,39,12,325,15,405,15,2785
"06065045124",1170,99,0,0,76,14,82,11,1452
"06065045125",2365,86,0,0,206,38,390,72,3157
"06065045207",1531,643,226,21,2154,1070,3202,1658,10505
"06065045209",1739,840,132,52,1652,1011,2863,1744,10033
"06065045212",1564,115,93,0,346,0,322,0,2440
"06065045213",2770,451,127,0,1415,1034,3142,972,9911
"06065045214",4100,405,3,0,858,2,791,69,6228
"06065045215",7271,595,185,72,1090,136,2818,545,12712
"06065045216",1599,84,5,0,150,64,159,0,2061
"06065045217",2841,404,74,110,2918,764,4524,1104,12739
"06065045222",1121,33,181,11,367,1,209,5,1928
"06065045224",2508,482,21,33,1532,206,2373,276,7431
"06065045226",2472,319,157,0,3236,444,5451,720,12799
"06065045228",3001,95,69,20,1223,110,1703,174,6395
"06065045233",3298,447,417,51,562,82,2249,235,7341
"06065045302",1500,777,8,29,1361,816,2654,1506,8651
"06065045303",626,742,75,0,900,760,1419,1427,5949
"06065045304",4634,99,241,4,3385,577,5014,582,14536
"06065045501",1039,543,190,0,1972,1372,2712,1711,9539
"06065045502",1364,738,24,19,1404,989,2464,1588,8590
"06065045604",3056,2458,156,17,4644,3257,7519,5674,26781
"06065045605",2423,1368,14,58,3021,2531,3989,3799,17203
"06065045606",1816,144,13,0,452,173,996,174,3768
"06065045608",2767,139,73,0,161,0,120,0,3260
"06065045609",958,509,133,0,1897,2109,2855,2584,11045
"06065045703",1197,459,33,0,3089,1623,4218,2049,12668
"06065045704",422,499,79,7,1403,441,1888,947,5686
"06065045705",1360,821,25,0,3145,3705,4515,4526,18097
"06065045706",1428,754,53,71,1479,756,2876,1500,8917
"06065045707",2494,308,30,0,2388,1073,4606,1373,12272
"06065045900",655,207,53,6,515,141,836,289,2702
"06065046101",2037,383,368,13,415,299,1171,526,5212
"06065046102",832,264,56,191,378,343,929,504,3497
"06065046103",1660,148,83,0,933,7,1496,7,4334
"06065046200",1151,446,146,393,1108,568,1792,865,6469
"06065046401",2722,209,98,0,418,300,1162,287,5196
"06065046402",2127,785,31,92,916,364,1166,568,6049
"06065046403",4299,453,210,0,1929,319,3114,387,10711
"06065046404",3173,559,311,85,1318,514,1819,904,8683
"06065046405",2339,487,49,0,515,220,1109,297,5016
"06065046500",549,659,131,228,581,986,358,626,4118
"06065046601",479,20,0,0,28,26,195,23,771
"06065046602",2500,242,88,1,824,211,863,240,4969
"06065046700",1519,688,513,275,785,281,1592,826,6479
"06065046800",3543,287,951,193,865,434,3228,431,9932
"06065046900",1130,165,19,86,330,122,712,178,2742
"06065047000",1015,268,63,40,277,48,315,199,2225
"06065047201",1651,323,0,0,83,216,350,289,2912
"06065047202",1071,435,45,0,187,23,456,160,2377
"06065047900",8579,45,628,4,2956,190,2974,27,15403
"06065048100",4666,412,184,0,1541,48,1806,87,8744
"06065048200",3170,55,243,51,1146,15,1592,53,6325
"06065048300",2344,311,1428,595,1918,239,2633,490,9958
"06065048700",2001,21,516,150,1321,14,1700,17,5740
"06065048800",1469,157,592,322,1545,327,2278,475,7165
"06065048901",3368,402,330,6,720,363,2299,579,8067
"06065048902",3020,980,714,461,1977,389,4083,1026,12650
"06065049000",2926,442,3118,42,1581,848,3139,326,12422
"06065049100",2745,255,2,0,1500,47,1654,96,6299
"06065049400",2274,477,19,0,359,156,981,522,4788
"06065049500",3461,322,88,6,3112,1892,6349,1867,17097
"06065049600",4070,308,276,67,2505,48,1865,0,9139
"06065049700",7242,300,46,0,1622,23,2091,0,11324
"06065049800",2109,543,239,9,707,312,1045,144,5108
"06065050300",4673,446,1325,18,3667,0,2195,89,12413
"06065050400",6831,445,379,160,2289,192,3466,452,14214
"06065050500",7352,723,847,339,4526,717,4626,432,19562
"06065050600",4968,432,201,0,992,432,907,485,8417
"06065050700",6043,118,1457,0,3764,163,2961,50,14556
"06065050900",2690,431,361,194,976,93,1273,207,6225
"06065051100",2112,406,1660,283,1784,196,2721,599,9761
"06065051200",2687,356,97,0,377,57,1152,241,4967
"06065051300",5280,529,315,113,2168,308,3033,512,12258
"06065051400",6004,545,36,0,155,36,165,0,6941
"06065940100",118,10,0,0,20,0,0,0,148
"06065940400",1796,618,18,0,2561,1158,4261,1764,12176
"06065940500",1784,190,14,0,102,8,121,5,2224
"06065940600",2722,115,20,0,257,34,223,30,3401
"06065940700",2216,180,30,9,227,29,392,79,3162
"06065940800",2232,301,38,2,116,37,150,33,2909
"06065940900",1490,182,32,0,80,8,100,19,1911
"06065941000",2699,673,48,6,184,55,237,195,4097
"06065941100",1588,200,8,0,51,7,69,30,1953
"06065941200",1557,150,33,56,226,55,329,32,2438
"06065941300",2316,487,77,73,357,31,453,164,3958
"06065941400",2005,684,157,48,279,237,623,580,4613
"06065941500",2854,486,123,54,861,162,1157,179,5876
"06065980004",0,0,0,0,0,0,0,0,0
"06065981000",0,0,0,0,0,0,0,0,0
"06067000100",3184,192,0,23,341,41,367,35,4183
"06067000200",3219,85,74,6,284,0,554,13,4235
"06067000300",2281,176,9,0,526,53,255,10,3310
"06067000400",2848,379,136,12,490,98,853,125,4941
"06067000500",1768,911,147,140,410,198,493,377,4444
"06067000600",466,289,79,236,133,51,133,130,1517
"06067000700",121,57,57,38,214,138,33,0,658
"06067000800",939,208,60,0,322,9,125,12,1675
"06067001101",1012,747,70,55,164,76,138,106,2368
"06067001200",1735,381,128,140,430,166,291,63,3334
"06067001300",1822,375,59,148,548,141,374,145,3612
"06067001400",1470,342,63,29,366,52,275,41,2638
"06067001500",3731,207,54,32,372,33,422,2,4853
"06067001600",4591,503,109,0,673,36,377,128,6417
"06067001700",3180,632,39,313,615,585,511,413,6288
"06067001800",2219,592,686,85,763,639,641,270,5895
"06067001900",1830,328,229,45,299,181,517,107,3536
"06067002000",1161,132,40,20,582,350,248,57,2590
"06067002100",976,341,51,20,632,433,333,347,3133
"06067002200",1708,571,141,819,440,398,591,537,5205
"06067002300",2532,53,38,0,518,93,252,35,3521
"06067002400",3550,213,0,0,565,133,357,34,4852
"06067002500",1388,31,52,4,191,0,143,4,1813
"06067002600",1735,400,119,50,259,123,294,440,3420
"06067002700",1316,477,721,459,679,270,741,407,5070
"06067002800",750,400,489,245,508,726,661,604,4383
"06067002900",3065,663,367,183,842,144,1122,276,6662
"06067003000",3612,510,294,90,1125,323,1642,322,7918
"06067003101",1687,168,102,88,984,280,1320,299,4928
"06067003102",1349,334,175,63,836,255,1041,422,4475
"06067003202",1443,444,448,31,1586,1088,1050,449,6539
"06067003203",329,212,216,85,1876,568,622,334,4242
"06067003204",1525,388,60,157,1912,1490,1442,545,7519
"06067003300",2267,155,196,8,1115,185,528,26,4480
"06067003400",2331,327,307,272,1233,136,1063,155,5824
"06067003501",1611,367,80,57,366,162,631,268,3542
"06067003502",1440,162,45,136,791,125,742,75,3516
"06067003600",1468,327,79,51,648,218,1184,318,4293
"06067003700",841,547,626,228,1128,617,1081,753,5821
"06067003800",1919,569,1170,282,1453,233,1317,385,7328
"06067003900",2060,73,245,15,1110,39,763,13,4318
"06067004001",2255,153,519,87,1693,151,747,87,5692
"06067004004",3217,163,360,0,2392,63,832,43,7070
"06067004005",2289,248,519,107,1072,181,691,58,5165
"06067004006",1924,287,1022,61,1412,147,671,268,5792
"06067004008",1928,17,275,12,1123,306,466,60,4187
"06067004009",1919,42,906,57,2078,111,656,0,5769
"06067004010",1469,137,1257,255,1546,166,548,152,5530
"06067004011",1210,54,383,97,1382,61,249,0,3436
"06067004012",1518,69,270,13,1444,56,387,45,3802
"06067004100",1062,942,374,195,1286,886,776,743,6264
"06067004201",1909,654,953,279,1264,294,1251,526,7130
"06067004202",1200,726,652,272,1725,590,1269,677,7111
"06067004203",784,1255,586,456,1482,747,727,1099,7136
"06067004300",2459,691,1413,395,3330,1194,2190,328,12000
"06067004401",1205,279,347,401,989,514,1244,460,5439
"06067004402",1190,750,214,331,1043,1338,1279,1129,7274
"06067004501",619,550,108,97,909,882,734,530,4429
"06067004502",1097,746,879,398,783,618,847,792,6160
"06067004601",2296,1209,251,614,1930,1152,2861,965,11278
"06067004602",1615,912,347,220,1135,398,1364,964,6955
"06067004701",883,920,171,198,623,812,633,1221,5461
"06067004702",1621,527,477,431,1268,781,1840,584,7529
"06067004801",1308,203,502,118,2049,1441,840,283,6744
"06067004802",1056,462,492,205,1418,1047,790,695,6165
"06067004903",1550,419,906,761,1699,1546,1194,271,8346
"06067004904",2495,443,656,159,1812,459,1422,399,7845
"06067004905",1870,1580,1415,400,1251,623,1712,1714,10565
"06067004906",749,206,598,289,863,335,513,191,3744
"06067005001",3105,592,777,632,2690,986,2345,967,12094
"06067005002",1874,701,934,408,1296,893,1096,521,7723
"06067005101",1770,573,351,436,912,829,1130,449,6450
"06067005102",1870,470,520,105,1683,350,951,321,6270
"06067005201",509,361,69,96,441,249,440,265,2430
"06067005202",2193,529,152,48,514,105,661,134,4336
"06067005204",3343,98,126,12,604,290,747,184,5404
"06067005205",922,480,106,244,145,167,93,303,2460
"06067005301",83,320,138,152,80,190,76,275,1314
"06067005402",1202,530,149,115,384,213,355,192,3140
"06067005403",1710,67,62,35,117,277,86,203,2557
"06067005404",3844,416,109,12,599,282,498,165,5925
"06067005502",2202,485,210,358,1108,754,1439,655,7211
"06067005505",1619,616,374,428,1086,791,863,700,6477
"06067005506",800,407,496,101,615,317,610,408,3754
"06067005508",1676,484,162,159,704,121,339,154,3799
"06067005509",584,274,188,94,506,60,407,157,2270
"06067005510",2131,243,528,291,506,365,793,303,5160
"06067005601",2839,387,98,550,533,175,508,76,5166
"06067005605",1554,223,61,42,684,708,731,578,4581
"06067005606",2964,212,58,182,721,64,308,173,4682
"06067005701",2019,126,23,37,596,24,405,47,3277
"06067005702",3913,103,50,0,762,0,505,0,5333
"06067005801",4388,240,117,0,610,79,314,4,5752
"06067005803",2893,60,0,6,580,5,336,2,3882
"06067005804",2145,54,26,0,386,8,124,16,2759
"06067005901",4177,486,236,38,772,49,590,0,6348
"06067005903",1091,401,185,9,443,23,226,54,2432
"06067005904",3539,540,108,0,695,18,405,74,5379
"06067006002",2814,772,139,28,395,141,792,246,5327
"06067006003",2683,789,213,37,662,258,689,403,5734
"06067006004",1882,225,96,5,203,63,124,32,2630
"06067006101",2545,1015,90,418,341,287,322,310,5328
"06067006102",1819,566,490,207,619,83,303,160,4247
"06067006201",2093,714,375,819,605,1088,737,928,7359
"06067006202",1411,985,121,252,239,528,479,770,4785
"06067006300",1692,1365,292,299,1233,478,1285,773,7417
"06067006400",1997,813,241,220,983,562,851,738,6405
"06067006500",1098,1024,693,574,1931,973,1254,982,8529
"06067006600",2052,764,405,755,1386,885,1496,800,8543
"06067006701",2081,641,785,119,4502,1140,3306,752,13326
"06067006702",1013,1209,785,471,1848,1186,1216,1109,8837
"06067006800",1648,1102,536,435,2553,1996,2667,2258,13195
"06067006900",2008,576,459,342,390,350,445,450,5020
"06067007001",1302,807,89,39,1435,1012,1456,1334,7474
"06067007004",1861,893,992,409,1905,677,1679,1176,9592
"06067007007",2428,820,411,117,1303,388,2513,643,8623
"06067007010",1646,357,310,56,1011,253,669,182,4484
"06067007011",1837,784,886,66,2033,530,1482,717,8335
"06067007012",1384,348,477,176,798,166,985,341,4675
"06067007013",1271,255,424,51,696,127,814,255,3893
"06067007014",2910,891,1005,336,1800,179,2352,691,10164
"06067007015",1597,463,756,51,1266,252,613,173,5171
"06067007016",1907,169,521,299,2002,303,1019,195,6415
"06067007017",1149,105,277,7,1163,61,619,0,3381
"06067007018",1747,126,183,22,2632,165,653,173,5701
"06067007019",342,45,125,105,200,159,271,27,1274
"06067007020",2530,199,207,17,1409,351,970,63,5746
"06067007101",152,0,8,0,0,0,0,0,160
"06067007102",3609,132,885,25,2498,509,870,0,8528
"06067007103",1565,49,550,49,2349,126,1284,72,6044
"06067007104",4039,106,1035,34,2698,386,1754,126,10178
"06067007105",2698,384,614,177,2543,405,1828,31,8680
"06067007106",2616,51,600,0,4777,274,1352,210,9880
"06067007107",1476,27,650,0,975,152,600,1,3881
"06067007202",1849,406,65,0,1543,112,892,144,5011
"06067007204",2588,318,335,143,1027,307,912,275,5905
"06067007206",3143,194,26,45,704,190,524,81,4907
"06067007207",3012,231,56,5,632,74,639,74,4723
"06067007208",2382,704,179,129,586,210,469,119,4778
"06067007209",2205,647,31,0,470,268,469,258,4348
"06067007301",1962,991,519,244,1223,277,1173,365,6754
"06067007402",3535,1042,603,70,812,426,943,743,8174
"06067007403",2055,671,337,297,1202,291,829,301,5983
"06067007406",4857,896,371,145,1615,332,1743,313,10272
"06067007413",3077,977,648,165,551,453,712,619,7202
"06067007414",2082,577,283,130,845,217,501,283,4918
"06067007415",1881,150,167,47,379,386,572,241,3823
"06067007416",2965,316,59,102,608,150,799,116,5115
"06067007417",2167,153,235,8,598,130,330,107,3728
"06067007421",5987,384,411,76,2051,99,1352,73,10433
"06067007422",1316,547,60,15,550,182,447,255,3372
"06067007423",1277,746,480,601,911,952,760,909,6636
"06067007424",1625,632,340,283,587,243,530,282,4522
"06067007426",1288,171,70,87,484,309,221,76,2706
"06067007427",3990,1312,356,78,1498,158,965,24,8381
"06067007428",2090,229,314,66,691,272,387,239,4288
"06067007429",2672,961,285,180,984,142,898,335,6457
"06067007430",3915,940,616,121,1826,396,1191,462,9467
"06067007431",1760,73,242,0,1088,52,276,77,3568
"06067007432",3680,290,693,0,848,48,846,59,6464
"06067007433",3520,728,1016,2,2960,128,676,16,9046
"06067007501",2848,814,169,170,1186,680,1170,473,7510
"06067007503",2590,841,336,401,542,360,620,108,5798
"06067007504",1225,220,41,21,264,81,361,20,2233
"06067007601",4434,766,392,90,869,259,826,414,8050
"06067007602",2861,775,138,170,695,175,395,134,5343
"06067007701",3926,1098,208,255,468,278,378,184,6795
"06067007702",3193,119,76,9,576,121,233,10,4337
"06067007801",3741,904,367,0,656,123,390,207,6388
"06067007802",3479,439,288,265,566,117,530,26,5710
"06067007903",3502,498,80,153,445,7,584,150,5419
"06067007904",4116,464,34,101,242,34,405,50,5446
"06067007905",3440,204,72,52,448,89,384,102,4791
"06067007906",2820,222,22,24,420,29,288,86,3911
"06067008005",3896,248,20,25,313,11,429,14,4956
"06067008006",4772,209,100,39,480,43,328,14,5985
"06067008007",1867,582,139,0,173,230,262,226,3479
"06067008008",3622,449,60,14,432,204,342,187,5310
"06067008009",3569,415,58,27,410,94,402,67,5042
"06067008010",3678,415,18,3,434,334,293,23,5198
"06067008111",4905,385,12,0,754,230,803,134,7223
"06067008113",2857,397,8,0,305,181,486,263,4497
"06067008117",1644,72,153,13,212,0,176,0,2270
"06067008119",4251,343,0,14,535,311,611,451,6516
"06067008120",3200,379,117,60,699,75,675,93,5298
"06067008122",2941,243,65,14,270,20,493,86,4132
"06067008124",3312,557,56,19,231,34,389,50,4648
"06067008125",3573,689,0,0,844,107,868,73,6154
"06067008127",3472,1204,36,19,616,165,997,325,6834
"06067008128",1806,144,87,0,181,32,373,8,2631
"06067008129",2146,700,74,4,434,128,221,440,4147
"06067008130",2058,462,145,77,565,377,378,146,4208
"06067008131",3123,807,193,14,473,169,449,142,5370
"06067008132",2961,30,58,0,600,30,309,0,3988
"06067008133",1632,632,93,13,116,107,265,56,2914
"06067008134",3222,425,198,314,736,35,460,266,5656
"06067008135",2949,170,179,0,486,381,597,193,4955
"06067008136",1666,153,72,0,249,39,73,29,2281
"06067008137",1738,473,4,30,224,25,210,14,2718
"06067008138",2468,441,55,2,504,65,728,261,4524
"06067008139",2579,374,39,42,256,95,528,280,4193
"06067008140",1644,249,60,33,322,26,275,28,2637
"06067008141",4071,1497,214,346,821,431,1381,482,9243
"06067008142",2304,341,257,14,309,38,422,90,3775
"06067008143",2658,379,185,27,489,175,741,177,4831
"06067008144",2264,109,37,9,255,0,406,8,3088
"06067008145",6433,556,59,11,929,18,734,0,8740
"06067008203",3753,538,77,0,376,107,336,107,5294
"06067008204",3362,275,216,7,466,46,507,40,4919
"06067008206",4683,347,20,4,371,28,366,28,5847
"06067008207",3745,352,0,8,326,93,289,46,4859
"06067008208",3241,542,63,0,397,16,348,186,4793
"06067008209",3283,120,56,26,365,27,320,37,4234
"06067008210",4533,338,183,0,406,118,363,14,5955
"06067008211",2535,62,0,0,197,8,227,9,3038
"06067008402",4472,493,47,0,478,127,756,15,6388
"06067008403",3415,365,15,63,1579,18,336,77,5868
"06067008404",2148,129,0,0,254,116,355,31,3033
"06067008501",4529,91,117,0,1495,0,757,0,6989
"06067008504",3297,133,58,1,1000,4,162,2,4657
"06067008505",1723,38,12,0,436,9,112,0,2330
"06067008506",1643,188,9,9,614,38,141,23,2665
"06067008507",2532,237,29,0,804,20,633,65,4320
"06067008508",4763,28,257,0,2480,20,1552,6,9106
"06067008509",3210,55,34,1,1469,1,485,1,5256
"06067008510",3658,23,74,0,764,4,401,0,4924
"06067008512",2280,12,0,0,1506,56,223,0,4077
"06067008513",1593,25,64,0,1432,0,271,0,3385
"06067008600",5620,178,236,4,873,71,824,0,7806
"06067008702",2341,32,0,0,460,24,168,13,3038
"06067008703",3052,214,191,0,1446,44,218,60,5225
"06067008704",1968,130,197,9,1434,70,333,130,4271
"06067008705",2735,320,299,0,2368,79,897,76,6774
"06067008801",2140,368,430,204,1375,107,587,126,5337
"06067008905",2714,444,127,27,834,150,516,246,5058
"06067008907",2741,846,308,148,865,331,966,337,6542
"06067008908",3130,752,261,26,654,139,788,382,6132
"06067008909",1183,368,88,192,274,282,287,301,2975
"06067008910",2039,413,175,109,404,177,461,319,4097
"06067008911",722,375,138,295,420,269,261,290,2770
"06067008912",2032,223,243,0,459,93,429,28,3507
"06067008913",3010,276,105,77,620,334,578,244,5244
"06067009004",2257,221,416,30,496,75,415,31,3941
"06067009005",1598,507,471,58,583,226,409,153,4005
"06067009006",2703,603,677,75,970,120,874,140,6162
"06067009007",1084,380,419,233,665,70,571,124,3546
"06067009008",2186,638,306,101,1002,347,991,397,5968
"06067009010",1989,185,451,159,1548,230,988,159,5709
"06067009011",2082,61,220,38,1701,65,463,34,4664
"06067009103",1665,191,349,70,489,258,307,100,3429
"06067009105",1439,735,142,350,521,108,516,240,4051
"06067009106",2573,344,244,170,559,184,621,182,4877
"06067009107",2043,301,145,111,405,94,300,166,3565
"06067009108",2138,189,184,161,728,75,400,170,4045
"06067009109",2880,467,551,41,1068,161,708,170,6046
"06067009110",461,261,191,237,144,134,238,183,1849
"06067009111",3012,521,445,136,1410,179,946,375,7024
"06067009112",2166,316,352,97,517,258,708,200,4614
"06067009201",1275,479,68,27,881,184,420,174,3508
"06067009307",3402,529,76,46,979,113,457,306,5908
"06067009308",3598,256,118,0,1718,234,1213,163,7300
"06067009309",1950,159,29,8,338,25,338,60,2907
"06067009310",5038,593,223,5,1072,118,1312,391,8752
"06067009311",2892,462,353,77,2338,418,1115,454,8109
"06067009312",2433,151,664,239,2289,677,1036,76,7565
"06067009314",2431,162,421,553,2137,459,449,126,6738
"06067009316",805,67,540,191,2555,354,634,28,5174
"06067009317",1758,203,1107,216,2407,254,998,112,7055
"06067009318",615,49,268,215,1095,245,565,41,3093
"06067009319",1285,381,460,63,2456,661,807,343,6456
"06067009320",1836,275,456,88,1654,698,1281,376,6664
"06067009321",2018,179,997,67,2244,529,1188,164,7386
"06067009322",3329,385,1177,565,6990,1197,2113,516,16272
"06067009323",2454,147,244,53,2085,66,672,9,5730
"06067009324",1874,82,74,0,790,7,481,9,3317
"06067009325",841,46,0,0,21,50,111,34,1103
"06067009326",2599,104,186,21,1952,103,598,0,5563
"06067009328",1808,240,554,2,2099,79,618,30,5430
"06067009329",682,75,265,82,926,214,565,51,2860
"06067009330",1753,123,423,0,1336,177,561,34,4407
"06067009331",2501,383,1531,102,2849,108,768,135,8377
"06067009332",592,22,16,0,521,92,202,4,1449
"06067009403",1435,149,0,0,307,206,378,206,2681
"06067009404",3335,495,129,2,889,285,875,101,6111
"06067009406",1832,83,55,0,262,9,379,24,2644
"06067009407",5959,914,170,14,2143,851,2955,1427,14433
"06067009408",1274,53,34,63,301,19,482,12,2238
"06067009501",1230,461,2,1,625,366,1203,669,4557
"06067009502",4888,671,47,342,1540,301,2458,455,10702
"06067009503",1619,392,7,11,496,318,808,501,4152
"06067009504",1039,454,68,0,318,143,665,224,2911
"06067009601",1436,508,987,395,2391,743,1460,566,8486
"06067009606",1292,402,1607,696,1809,1141,1186,711,8844
"06067009608",1326,334,1024,474,3217,777,809,223,8184
"06067009609",1378,126,975,99,2035,531,1161,150,6455
"06067009610",1228,310,924,424,2399,670,1275,443,7673
"06067009611",1344,360,311,119,1070,120,638,212,4174
"06067009612",2087,208,465,46,2071,371,1111,13,6372
"06067009614",2459,399,678,468,2716,400,1037,162,8319
"06067009615",3608,206,848,466,2654,737,1842,370,10731
"06067009616",3187,173,316,79,1512,297,1079,291,6934
"06067009617",2160,101,400,25,644,136,466,109,4041
"06067009618",2122,258,550,12,1539,269,839,121,5710
"06067009619",3245,492,435,259,3364,48,1396,137,9376
"06067009622",3461,63,843,32,2929,144,1220,0,8692
"06067009630",2986,391,964,174,5205,373,1328,311,11732
"06067009632",1780,240,726,161,3927,182,1000,47,8063
"06067009633",1053,253,535,314,915,329,973,229,4601
"06067009634",828,575,576,377,1164,481,765,547,5313
"06067009635",2041,33,1331,61,2807,137,1202,0,7612
"06067009636",2647,108,727,510,3573,305,1410,112,9392
"06067009637",1960,52,463,39,4132,69,517,0,7232
"06067009638",1592,123,235,117,1774,70,837,81,4829
"06067009639",1159,229,470,58,1389,282,632,63,4282
"06067009800",1077,257,8,0,216,11,322,109,2000
"06067009900",2319,300,0,47,1171,191,1349,221,5598
"06067988300",38,0,0,0,0,0,10,0,48
"06069000100",4455,467,19,39,363,77,2174,303,7897
"06069000200",4459,1191,0,0,529,4,1784,517,8484
"06069000300",2563,433,30,0,1019,60,3065,451,7621
"06069000400",4158,786,58,19,910,177,3928,895,10931
"06069000501",3846,127,38,0,726,4,2173,4,6918
"06069000502",5057,504,106,0,716,191,4289,647,11510
"06069000600",5858,1212,24,4,939,27,3349,1023,12436
"06069000701",2561,818,24,0,650,65,2512,798,7428
"06069000702",3798,237,150,0,867,60,2539,264,7915
"06069000801",3061,163,21,24,283,6,856,15,4429
"06069000802",1977,129,9,0,414,40,819,95,3483
"06071000103",2250,134,94,71,2174,164,1330,36,6253
"06071000104",2407,176,280,0,2762,253,1432,175,7485
"06071000105",2271,214,176,35,3811,66,1231,14,7818
"06071000107",1978,56,79,0,818,68,1038,27,4064
"06071000108",2802,23,198,0,1803,287,1180,43,6336
"06071000109",4602,421,193,246,1235,101,1531,262,8591
"06071000111",1751,48,42,0,913,20,685,27,3486
"06071000113",5522,539,313,0,4478,889,5382,1154,18277
"06071000115",3398,68,512,0,3198,81,1822,149,9228
"06071000116",4757,185,588,0,5700,154,2003,25,13412
"06071000117",3153,108,275,23,2878,216,1502,0,8155
"06071000118",1983,40,76,0,2266,128,1015,52,5560
"06071000201",1538,210,196,9,1708,495,2597,523,7276
"06071000203",1919,580,104,0,1586,161,2210,542,7102
"06071000205",2195,328,318,223,1430,518,2209,679,7900
"06071000207",2177,495,0,0,1945,222,3466,405,8710
"06071000208",2067,37,20,9,2193,341,2863,327,7857
"06071000301",1728,659,310,92,4094,2186,4336,2634,16039
"06071000303",2589,899,187,20,2906,763,4451,1339,13154
"06071000304",2124,359,222,126,3167,165,3503,487,10153
"06071000401",4173,241,79,0,1505,195,3585,319,10097
"06071000403",2778,222,61,4,1021,213,2127,247,6673
"06071000404",2346,316,217,14,1338,307,2228,372,7138
"06071000501",3356,103,161,0,2860,550,3907,530,11467
"06071000503",2499,389,92,68,1500,225,2414,381,7568
"06071000504",2702,519,345,22,1279,89,1862,393,7211
"06071000603",2509,379,51,54,2042,254,2692,390,8371
"06071000604",3126,453,57,9,1603,475,3297,688,9708
"06071000605",1807,452,0,0,1728,159,3309,525,7980
"06071000606",2715,421,61,0,1010,86,2906,432,7631
"06071000804",2145,56,0,1,703,22,575,22,3524
"06071000808",2811,409,154,182,2224,486,1902,412,8580
"06071000812",2984,124,63,33,501,25,1312,66,5108
"06071000813",2790,147,161,0,542,64,730,38,4472
"06071000814",3082,152,0,0,610,13,754,12,4623
"06071000815",2350,220,173,0,901,0,883,11,4538
"06071000816",3447,61,115,0,612,27,952,2,5216
"06071000817",2319,57,134,25,663,305,931,239,4673
"06071000818",3513,408,80,34,794,161,1348,125,6463
"06071000819",3095,123,259,0,1444,116,904,0,5941
"06071000820",2772,293,72,27,611,10,785,84,4654
"06071000821",1428,224,563,33,1166,462,1039,232,5147
"06071000823",2184,607,141,34,2443,1453,2309,1219,10390
"06071000824",1884,403,369,114,1390,602,1425,760,6947
"06071000825",1572,357,247,128,1341,370,1948,521,6484
"06071000826",2030,131,452,103,1410,89,1674,130,6019
"06071000901",2003,417,118,27,1149,333,1715,397,6159
"06071000903",1541,454,178,95,1548,384,2335,524,7059
"06071000904",1528,266,38,91,1027,487,1678,631,5746
"06071001001",2182,585,211,94,1472,483,2266,701,7994
"06071001002",2590,733,248,9,1813,527,3620,1179,10719
"06071001101",1642,546,0,105,883,181,1875,610,5842
"06071001103",2209,457,354,37,1363,182,1969,376,6947
"06071001104",2811,349,315,48,1472,334,2849,380,8558
"06071001200",2734,525,84,0,1515,174,2594,607,8233
"06071001305",2122,775,70,4,1035,678,2684,1395,8763
"06071001307",2295,424,171,0,1030,120,2598,513,7151
"06071001308",2769,555,146,0,1208,976,3636,1388,10678
"06071001309",2668,423,114,52,788,698,2785,967,8495
"06071001310",3048,556,210,7,1529,259,3480,710,9799
"06071001311",1728,263,406,2,1208,144,1195,320,5266
"06071001312",2606,239,366,74,1502,404,2592,493,8276
"06071001400",1049,259,215,6,1038,326,1338,478,4709
"06071001501",1333,606,42,0,1151,486,2279,1029,6926
"06071001503",1323,723,13,8,981,560,2123,1119,6850
"06071001504",1921,1508,387,104,994,559,2250,1906,9629
"06071001600",1915,1555,9,0,1844,994,3583,2485,12385
"06071001702",2507,255,203,35,1192,400,2109,577,7278
"06071001703",3125,390,102,17,1926,474,2815,761,9610
"06071001704",1864,792,306,20,1618,211,2338,448,7597
"06071001706",1988,322,417,280,2844,508,4066,785,11210
"06071001707",2635,4,300,21,2347,586,3511,516,9920
"06071001803",1554,92,125,26,999,9,1786,38,4629
"06071001804",3469,135,241,20,1498,55,3140,187,8745
"06071001806",2575,34,420,413,1483,48,2112,255,7340
"06071001808",2747,83,360,49,1388,17,3104,99,7847
"06071001809",1830,513,205,21,1599,609,2388,1107,8272
"06071001810",1893,282,247,0,2595,47,3989,262,9315
"06071001812",1303,718,21,0,1424,740,2478,1427,8111
"06071001813",1957,798,380,17,1464,312,3370,866,9164
"06071001901",2721,229,438,2,1918,16,2572,59,7955
"06071001903",3216,179,248,40,3390,274,2154,228,9729
"06071001905",3319,447,311,0,1879,159,2474,365,8954
"06071001906",5339,328,466,98,1956,186,5033,317,13723
"06071002010",5613,266,1393,12,2916,121,3622,195,14138
"06071002011",2931,186,169,0,749,43,1002,4,5084
"06071002013",3653,420,83,27,430,102,1121,265,6101
"06071002014",3811,189,54,0,599,2,1508,0,6163
"06071002015",3228,501,320,0,685,237,1287,491,6749
"06071002016",3081,428,179,0,565,58,1229,332,5872
"06071002017",3855,234,49,0,1284,39,1573,135,7169
"06071002018",3472,254,345,24,1381,197,1738,216,7627
"06071002019",2759,75,450,22,1380,66,1759,11,6522
"06071002021",2941,134,646,0,1665,0,1612,56,7054
"06071002022",7331,97,979,0,4099,91,4090,11,16698
"06071002023",3167,578,642,130,863,197,1487,400,7464
"06071002025",3881,209,333,5,774,9,1870,17,7098
"06071002027",3670,649,138,123,983,373,1967,632,8535
"06071002028",3379,108,531,49,1025,1,2055,119,7267
"06071002029",3715,172,182,14,1484,282,1834,83,7766
"06071002031",3553,0,588,0,1916,142,1712,42,7953
"06071002033",5193,117,787,60,1850,138,3194,0,11339
"06071002034",7688,185,1454,1,5585,35,4704,13,19665
"06071002035",3804,26,760,29,1832,129,2053,22,8655
"06071002036",6168,618,1625,104,2722,89,2996,319,14641
"06071002037",3757,377,888,134,2646,150,3295,120,11367
"06071002038",2502,85,1296,63,1864,18,2357,8,8193
"06071002101",2150,293,524,0,1455,111,2705,317,7555
"06071002103",2649,293,548,142,762,77,1272,152,5895
"06071002105",2881,678,473,2,705,266,2206,449,7660
"06071002107",2403,965,459,18,926,64,1802,507,7144
"06071002109",1650,245,1169,57,1322,155,1813,169,6580
"06071002110",3391,139,293,216,2356,845,2502,284,10026
"06071002204",2277,759,232,73,2804,317,4181,970,11613
"06071002206",3630,72,574,50,2104,222,3666,206,10524
"06071002207",874,253,300,80,312,115,553,215,2702
"06071002301",3618,124,799,87,3613,1213,5060,1296,15810
"06071002304",11287,166,3390,90,4650,74,9299,9,28965
"06071002305",5052,875,1021,90,2901,471,5474,1070,16954
"06071002306",1822,498,443,8,1446,95,2712,514,7538
"06071002307",2794,587,277,154,1082,354,3150,838,9236
"06071002401",4293,912,177,33,3408,1009,7293,1506,18631
"06071002402",3504,1033,318,70,2822,797,5793,1706,16043
"06071002501",2577,575,327,19,1891,663,3855,1197,11104
"06071002502",4085,874,120,0,3221,359,6035,1201,15895
"06071002601",5421,1070,771,3,3234,562,6727,1220,19008
"06071002602",3224,606,695,13,2382,440,4485,1018,12863
"06071002604",2481,767,359,28,1761,107,3033,813,9349
"06071002606",3288,389,719,96,2607,292,4992,551,12934
"06071002607",3337,157,1159,132,2820,34,4807,113,12559
"06071002703",2974,111,802,305,1536,20,3084,84,8916
"06071002704",4270,254,978,116,4235,551,4438,499,15341
"06071002705",2717,180,906,34,1529,67,3473,215,9121
"06071002706",3346,346,1202,52,1562,163,3276,239,10186
"06071002801",2598,930,342,197,1159,412,3414,999,10051
"06071002803",1468,528,154,21,1325,536,2364,947,7343
"06071002804",1624,1438,258,158,1297,670,2667,2004,10116
"06071002901",1689,525,92,0,1301,329,2513,817,7266
"06071002902",3476,570,405,48,1653,610,4146,841,11749
"06071003000",1224,537,290,71,870,253,1605,762,5612
"06071003101",2148,432,246,95,1324,805,2908,1192,9150
"06071003102",2443,929,34,38,826,1012,2926,1839,10047
"06071003200",3686,1477,184,196,2642,566,4879,1849,15479
"06071003301",2568,787,148,51,1094,499,3302,1052,9501
"06071003302",2576,1036,117,32,1930,451,3741,1077,10960
"06071003401",3109,656,164,92,2686,796,4382,1354,13239
"06071003403",2148,719,134,47,1511,357,2577,858,8351
"06071003404",2018,1210,429,38,887,434,2453,1371,8840
"06071003405",1356,528,588,255,1312,497,2318,978,7832
"06071003503",2298,596,1007,6,1379,255,2859,750,9150
"06071003505",2856,956,389,417,871,589,3324,1559,10961
"06071003506",2427,501,803,417,806,145,2719,661,8479
"06071003507",2869,403,453,330,1342,86,3059,431,8973
"06071003509",2621,733,135,12,832,398,2882,1103,8716
"06071003510",1101,515,444,599,801,628,1722,1177,6987
"06071003603",1957,401,330,100,1304,234,2810,545,7681
"06071003605",2528,136,114,106,1752,176,3054,281,8147
"06071003606",2313,367,110,0,1881,1072,3838,1298,10879
"06071003607",3553,676,190,196,740,37,3625,695,9712
"06071003609",3402,594,409,93,649,152,3467,692,9458
"06071003611",1660,594,596,205,1736,142,2795,645,8373
"06071003612",2054,302,294,48,1051,197,2847,483,7276
"06071003700",1636,1036,354,239,404,389,1733,1275,7066
"06071003801",2147,144,1140,47,494,159,2412,254,6797
"06071003803",2332,640,308,320,751,498,2659,1047,8555
"06071003804",2417,917,1033,249,441,6,2388,909,8360
"06071003900",3615,954,234,39,679,430,3817,1264,11032
"06071004001",1811,396,151,63,1521,447,2771,598,7758
"06071004003",3246,941,241,79,1318,473,4241,1440,11979
"06071004004",3146,663,18,144,1361,343,3702,938,10315
"06071004101",2732,1113,228,62,955,473,3037,1294,9894
"06071004103",2020,1274,211,76,1513,571,3251,1704,10620
"06071004104",2564,1122,251,45,959,876,3064,1779,10660
"06071004201",1247,1027,1449,1135,1427,486,2162,1333,10266
"06071004202",1925,1019,906,401,805,525,2227,1482,9290
"06071004301",2078,653,427,465,1472,282,3210,817,9404
"06071004302",2090,867,200,132,977,124,2602,1042,8034
"06071004401",2134,1345,106,133,449,170,1968,1382,7687
"06071004403",2782,466,328,53,1088,1004,3228,1433,10382
"06071004404",1759,1501,420,84,1412,390,2609,1677,9852
"06071004503",2543,90,361,0,579,25,1582,12,5192
"06071004504",4819,352,834,22,1549,355,3244,338,11513
"06071004505",2608,565,345,175,795,222,1625,692,7027
"06071004507",1918,969,244,622,1117,366,1863,1252,8351
"06071004509",2807,518,411,112,779,211,1863,698,7399
"06071004510",1459,417,509,159,683,401,1606,240,5474
"06071004601",3267,555,552,131,1532,212,2472,307,9028
"06071004603",2218,717,1209,234,1041,276,1789,466,7950
"06071004604",2317,1475,278,130,1077,364,2537,1569,9747
"06071004700",1793,874,168,147,1701,774,3103,1528,10088
"06071004800",1371,571,105,38,446,857,1785,1368,6541
"06071004900",2286,1554,41,105,1984,1374,3873,2754,13971
"06071005100",5041,1215,688,171,1357,163,3574,795,13004
"06071005200",1681,664,240,56,919,177,1450,478,5665
"06071005300",1901,690,710,241,1568,550,2634,1047,9341
"06071005400",1860,1837,726,538,1267,543,2416,2009,11196
"06071005500",1929,2684,755,739,953,1717,2588,3500,14865
"06071005600",1457,1517,439,459,810,1981,2065,3145,11873
"06071005701",241,605,92,148,409,558,404,848,3305
"06071005800",851,650,419,436,539,375,1208,902,5380
"06071006100",3385,648,448,497,3361,1114,3410,1543,14406
"06071006201",1966,307,105,35,1026,254,1860,505,6058
"06071006203",1468,734,719,600,451,418,1321,815,6526
"06071006204",961,843,363,671,829,579,1360,1086,6692
"06071006301",1884,982,155,172,878,832,2163,1604,8670
"06071006302",3208,1058,344,550,2231,1320,3532,2063,14306
"06071006401",641,904,99,214,469,956,1016,1600,5899
"06071006402",966,693,226,483,1439,757,1987,1220,7771
"06071006500",1451,1074,497,241,1405,1158,2219,1793,9838
"06071006601",2706,540,20,27,877,383,3117,814,8484
"06071006603",2690,673,277,18,1909,186,3813,756,10322
"06071006604",1660,862,265,177,1123,148,2533,878,7646
"06071006700",2138,839,0,33,1302,208,3042,988,8550
"06071007000",2952,1485,92,70,1406,631,3712,2058,12406
"06071007104",2644,90,396,5,1070,21,1462,59,5747
"06071007105",1563,284,450,103,512,150,679,302,4043
"06071007106",2896,324,227,137,700,114,1741,277,6416
"06071007107",1299,451,234,320,717,340,1397,578,5336
"06071007108",833,307,454,97,542,142,1070,297,3742
"06071007109",2890,916,705,17,1686,359,2887,710,10170
"06071007110",2885,557,299,36,1943,71,2105,462,8358
"06071007200",2171,1346,170,12,2114,1267,2137,1966,11183
"06071007302",4621,334,439,112,3640,273,1269,85,10773
"06071007303",1253,653,739,248,969,748,754,447,5811
"06071007305",1091,880,702,254,1347,218,753,838,6083
"06071007306",1917,252,549,9,2579,29,1147,86,6568
"06071007403",3504,635,940,154,1934,40,3019,374,10600
"06071007404",2724,174,399,113,737,145,1168,145,5605
"06071007407",638,502,201,358,504,718,819,1033,4773
"06071007408",1008,697,499,314,951,515,1281,1054,6319
"06071007409",3717,367,588,105,1363,358,2763,586,9847
"06071007410",2013,734,792,250,1323,82,1790,524,7508
"06071007601",2418,1502,692,315,1495,1190,3186,2213,13011
"06071007603",1462,523,712,270,1552,187,1662,556,6924
"06071007604",1465,441,119,56,1639,361,1278,647,6006
"06071007800",2466,905,443,52,975,179,1080,450,6550
"06071007901",5592,242,716,54,1835,176,2126,77,10818
"06071007903",3130,44,711,27,748,87,1143,4,5894
"06071007904",4976,193,94,84,1191,289,2204,176,9207
"06071008001",3667,791,347,146,1766,202,3006,313,10238
"06071008002",2527,1740,459,161,1483,941,3042,2378,12731
"06071008100",1781,269,113,335,737,146,745,229,4355
"06071008200",4299,413,453,60,504,94,676,165,6664
"06071008301",4673,336,74,23,718,43,1229,0,7096
"06071008302",2257,262,148,0,386,9,468,57,3587
"06071008401",5193,748,422,4,1823,495,2637,314,11636
"06071008402",5120,282,89,74,567,0,1239,87,7458
"06071008403",4539,228,38,23,901,81,824,75,6709
"06071008404",1263,401,155,40,418,154,645,327,3403
"06071008500",6295,427,225,0,949,85,645,124,8750
"06071008601",4337,439,388,59,881,118,1623,212,8057
"06071008602",2468,236,171,4,617,52,1003,111,4662
"06071008703",6157,135,122,0,780,88,1461,106,8849
"06071008704",5786,971,189,12,1144,372,1786,804,11064
"06071008705",2872,657,80,19,824,242,1522,511,6727
"06071008706",9461,684,93,0,2155,289,2922,392,15996
"06071008708",2921,615,14,3,508,10,569,290,4930
"06071008709",2688,813,0,113,336,174,893,415,5432
"06071008710",2398,1271,0,0,850,323,1170,875,6887
"06071008800",3962,1647,0,10,415,57,1533,929,8553
"06071008901",1489,501,48,45,91,27,204,62,2467
"06071009107",5149,1265,56,0,130,0,1156,647,8403
"06071009108",4318,983,43,20,681,315,1310,564,8234
"06071009109",4380,347,401,0,283,168,1028,123,6730
"06071009110",6885,1079,2512,702,3541,1653,6294,2372,25038
"06071009112",3465,1478,560,837,1499,435,3395,1602,13271
"06071009114",4754,768,1386,897,1660,900,4337,1268,15970
"06071009116",1881,1884,341,1339,768,914,1629,1812,10568
"06071009117",2390,1534,99,432,310,585,1643,1663,8656
"06071009118",14439,2268,1530,1837,2844,1143,11737,2027,37825
"06071009119",4270,464,11,55,702,29,1881,157,7569
"06071009201",3799,429,0,0,104,93,487,204,5116
"06071009202",1925,162,29,5,266,32,558,28,3005
"06071009300",696,269,0,98,134,66,335,206,1804
"06071009400",932,1082,401,459,197,477,589,961,5098
"06071009500",3589,807,326,885,744,614,2457,585,10007
"06071009707",4749,371,210,173,570,56,1180,80,7389
"06071009708",3304,1153,49,0,322,17,729,354,5928
"06071009709",4079,1056,329,0,489,146,1205,351,7655
"06071009710",3976,1711,162,437,642,215,1954,670,9767
"06071009711",6948,760,396,0,1134,70,2402,255,11965
"06071009712",3639,1288,268,227,380,295,1731,1110,8938
"06071009713",5121,818,455,170,542,77,1995,236,9414
"06071009714",2075,802,183,29,448,78,581,336,4532
"06071009715",6303,494,438,337,871,7,1474,7,9931
"06071009716",2960,2036,619,554,319,273,827,1540,9128
"06071009717",3454,536,236,3,508,18,878,300,5933
"06071009800",2245,1027,249,142,487,615,2158,1007,7930
"06071009904",5376,2313,828,989,1197,558,4297,2193,17751
"06071009905",2326,1109,608,902,1330,1430,2071,2347,12123
"06071009906",2011,617,470,38,1299,147,1909,676,7167
"06071009908",2691,519,780,51,639,159,1325,631,6795
"06071009910",2837,433,548,130,895,89,2455,178,7565
"06071009911",3597,878,985,256,871,210,2784,810,10391
"06071009912",2393,728,411,774,321,120,1095,676,6518
"06071009913",2557,1439,370,77,547,323,1931,1453,8697
"06071010004",6375,500,290,191,324,0,1271,56,9007
"06071010009",2108,255,228,0,604,60,1395,214,4864
"06071010010",3387,1136,166,329,1239,262,2848,1010,10377
"06071010011",2106,1121,243,268,922,153,1707,1020,7540
"06071010012",3248,814,132,74,381,145,1512,445,6751
"06071010013",3764,1222,465,143,1818,520,2876,1330,12138
"06071010014",2328,1666,263,52,655,345,2035,1535,8879
"06071010015",3186,975,300,101,516,369,1961,833,8241
"06071010016",3360,1185,454,116,726,230,2437,989,9497
"06071010017",10173,1035,1064,525,1444,459,5764,813,21277
"06071010018",4073,1454,603,153,1139,407,2381,1513,11723
"06071010019",3221,963,117,314,904,63,2258,724,8564
"06071010020",3946,1242,818,237,796,414,1967,1106,10526
"06071010021",4466,1388,0,0,615,179,1649,1153,9450
"06071010022",2559,839,88,0,399,80,820,492,5277
"06071010023",4321,612,92,30,667,233,2199,527,8681
"06071010024",4058,987,39,14,267,175,1309,421,7270
"06071010025",3370,827,572,760,1161,444,2138,1049,10321
"06071010026",5865,1084,772,824,1361,1854,3357,1345,16462
"06071010300",2034,430,15,73,510,13,868,122,4065
"06071010402",3598,496,289,77,1355,151,1357,350,7673
"06071010409",1920,380,149,0,315,143,397,148,3452
"06071010410",2252,337,53,0,163,61,239,164,3269
"06071010411",4425,415,356,282,585,619,624,506,7812
"06071010412",4921,1162,104,60,828,220,977,175,8447
"06071010413",4389,921,112,85,746,331,889,423,7896
"06071010415",3539,712,406,24,704,93,498,254,6230
"06071010416",1925,830,57,0,542,67,585,67,4073
"06071010417",2222,567,0,0,421,78,614,262,4164
"06071010419",2931,684,88,0,466,308,440,402,5319
"06071010420",2759,492,84,0,527,106,611,128,4707
"06071010421",3592,465,238,617,701,614,1298,351,7876
"06071010422",1025,109,4,0,137,0,143,13,1431
"06071010423",2106,978,0,0,315,215,279,183,4076
"06071010424",1163,435,0,0,67,35,89,61,1850
"06071010700",2531,782,151,0,408,166,501,409,4948
"06071010802",3250,848,87,1,497,63,466,117,5329
"06071010803",1860,319,65,0,222,29,211,88,2794
"06071010804",2022,662,38,0,183,189,623,384,4101
"06071010901",3683,269,15,0,596,361,786,361,6071
"06071010902",2754,213,0,0,371,0,688,20,4046
"06071011001",1522,315,0,0,195,183,473,331,3019
"06071011002",1133,167,82,0,263,89,530,189,2453
"06071011101",2983,296,24,6,125,42,528,19,4023
"06071011102",1541,279,12,11,248,49,326,0,2466
"06071011203",1051,125,0,0,119,0,203,27,1525
"06071011204",993,156,19,2,91,0,54,0,1315
"06071011205",1031,139,6,0,144,157,395,173,2045
"06071011206",843,154,20,19,65,5,190,14,1310
"06071011300",1349,48,0,0,119,0,254,1,1771
"06071011401",2700,1120,0,0,317,23,541,209,4910
"06071011403",2577,642,0,0,100,8,369,138,3834
"06071011404",2893,789,3,0,340,52,575,101,4753
"06071011500",1354,135,0,0,95,0,174,2,1760
"06071011600",5447,880,688,21,364,78,1003,289,8770
"06071011700",801,311,23,46,346,42,550,201,2320
"06071011800",3560,855,365,83,1224,320,2079,827,9313
"06071011900",2583,594,57,33,493,54,859,429,5102
"06071012001",3013,703,307,127,1828,112,2208,552,8850
"06071012002",2563,749,407,207,1036,319,1529,569,7379
"06071012101",3541,183,591,0,998,26,1437,64,6840
"06071012103",2788,689,0,0,408,45,911,68,4909
"06071012104",2988,1257,90,58,1048,111,1233,357,7142
"06071012200",585,22,149,32,1171,127,470,27,2583
"06071012300",60,1052,59,492,95,688,122,649,3217
"06071012400",1612,410,156,14,905,404,1953,733,6187
"06071012500",1842,927,35,208,1192,439,2939,1316,8898
"06071012700",2558,55,140,72,868,551,1446,584,6274
"06071025000",4568,311,1004,250,1263,252,1948,124,9720
"06071025100",415,140,24,3,565,176,222,33,1578
"06071940100",943,178,0,0,98,16,142,5,1382
"06071980100",0,0,0,0,0,0,0,0,0
"06071980200",0,0,0,0,0,0,0,0,0
"06073000100",2517,97,0,0,69,11,305,14,3013
"06073000201",1947,105,32,0,187,0,325,0,2596
"06073000202",3793,209,43,0,386,0,510,95,5036
"06073000300",3233,441,22,58,405,162,318,195,4834
"06073000400",2314,338,29,0,689,71,414,13,3868
"06073000500",2122,188,104,0,354,85,333,37,3223
"06073000600",2138,275,129,19,315,23,526,54,3479
"06073000700",3198,524,125,0,339,26,388,8,4608
"06073000800",2435,471,274,139,281,48,392,182,4222
"06073000900",3090,663,401,153,740,134,1205,204,6590
"06073001000",3769,585,109,43,563,139,746,310,6264
"06073001100",2375,442,199,18,361,69,1011,166,4641
"06073001200",3535,592,192,227,1184,177,1936,389,8232
"06073001300",3403,603,686,174,1307,298,1558,284,8313
"06073001400",2211,332,156,18,369,14,540,118,3758
"06073001500",2520,389,147,160,465,51,1170,198,5100
"06073001600",2535,844,560,396,707,288,1999,666,7995
"06073001700",2653,495,294,44,779,135,1337,498,6235
"06073001800",3001,901,906,55,918,88,1446,426,7741
"06073001900",2245,303,35,29,318,66,361,147,3504
"06073002001",2905,52,100,0,239,0,306,0,3602
"06073002002",1950,164,166,113,130,80,310,15,2928
"06073002100",2591,531,303,261,674,549,1305,524,6738
"06073002201",1185,686,497,259,424,656,1292,1016,6015
"06073002202",1815,1757,203,52,941,591,1864,1861,9084
"06073002301",1142,313,370,356,625,262,840,353,4261
"06073002302",2178,1068,307,584,1776,898,2748,976,10535
"06073002401",2355,918,323,179,863,194,1697,840,7369
"06073002402",2558,913,426,239,761,264,2616,895,8672
"06073002501",2908,871,485,29,904,618,3017,934,9766
"06073002502",3047,1004,430,271,1331,203,2409,851,9546
"06073002601",1813,1440,169,10,1252,1159,2025,2049,9917
"06073002602",1737,754,498,65,996,223,1775,775,6823
"06073002702",2153,520,837,273,787,340,877,364,6151
"06073002703",3374,635,857,289,1548,385,1535,593,9216
"06073002705",1453,118,479,389,1938,380,1260,318,6335
"06073002707",1554,982,339,284,1800,731,1855,1317,8862
"06073002708",1621,1319,930,629,937,763,1715,1434,9348
"06073002709",1073,768,264,277,594,473,1058,884,5391
"06073002710",1169,519,483,328,1353,235,1208,472,5767
"06073002711",1179,141,623,136,1147,334,963,9,4532
"06073002712",1534,413,865,200,1489,342,1452,433,6728
"06073002801",945,699,55,37,202,251,214,174,2577
"06073002803",2509,787,961,21,746,318,628,449,6419
"06073002804",2423,908,85,15,398,228,496,266,4819
"06073002902",3631,839,365,230,1023,208,1986,98,8380
"06073002903",2591,391,389,113,550,193,1366,208,5801
"06073002904",2011,2126,39,90,595,736,413,579,6589
"06073002905",1920,240,569,722,701,201,965,196,5514
"06073003001",656,184,1082,141,1255,712,1514,881,6425
"06073003003",1752,843,1588,17,1104,287,1664,448,7703
"06073003004",1226,383,794,73,2079,812,2789,1063,9219
"06073003101",775,271,1211,238,1393,73,1680,152,5793
"06073003103",1346,393,1985,322,2423,679,2127,864,10139
"06073003105",1069,201,749,77,2100,243,2605,398,7442
"06073003107",1760,247,941,111,2696,434,1685,538,8412
"06073003108",2019,292,182,60,859,177,1655,321,5565
"06073003109",269,42,32,214,2660,230,218,80,3745
"06073003111",922,298,1191,263,2526,1525,1842,1527,10094
"06073003112",769,144,676,121,1672,694,801,697,5574
"06073003113",692,136,559,69,3522,340,575,205,6098
"06073003114",214,87,495,123,2532,168,462,77,4158
"06073003115",1107,443,402,297,3951,618,1679,639,9136
"06073003201",1707,520,604,70,2103,412,1042,472,6930
"06073003202",2710,607,146,56,1518,52,3108,585,8782
"06073003204",2130,469,103,0,660,127,1573,393,5455
"06073003207",4199,879,582,0,962,437,2683,968,10710
"06073003208",1561,973,1015,26,2859,376,1955,987,9752
"06073003209",1598,240,820,410,2422,169,1475,265,7399
"06073003211",1793,163,95,65,1089,64,1650,116,5035
"06073003212",1970,416,142,8,1574,70,1454,41,5675
"06073003213",570,322,543,0,2496,21,621,292,4865
"06073003214",2162,168,650,315,1722,38,1785,31,6871
"06073003301",655,85,804,265,780,661,1215,764,5229
"06073003303",988,352,248,194,1536,1126,2172,1298,7914
"06073003304",1434,1107,289,239,846,251,1518,1086,6770
"06073003305",577,509,1016,680,1823,1225,1683,1657,9170
"06073003401",2492,291,1685,293,1342,132,1828,80,8143
"06073003403",1882,739,459,87,706,226,2046,905,7050
"06073003404",2430,926,311,197,797,341,2885,1098,8985
"06073003501",1143,720,214,190,1404,717,2373,1392,8153
"06073003502",1017,546,278,359,1479,1251,2202,1715,8847
"06073003601",786,223,47,0,886,1085,1462,1288,5777
"06073003602",856,210,178,74,1455,756,2108,885,6522
"06073003603",787,544,175,10,1934,1130,2453,1514,8547
"06073003800",33,0,0,0,48,0,0,0,81
"06073003901",590,509,173,153,1398,1594,1903,2052,8372
"06073003902",921,515,314,36,1786,1335,2532,1796,9235
"06073004000",2475,1372,382,146,731,167,2970,1450,9693
"06073004100",3510,1567,441,100,835,186,2477,1154,10270
"06073004200",4765,278,69,22,502,317,966,338,7257
"06073004300",2928,154,67,55,485,55,697,35,4476
"06073004400",2617,430,202,0,554,59,1014,154,5030
"06073004501",2003,326,33,0,379,234,1389,372,4736
"06073004600",1115,316,83,46,311,24,352,147,2394
"06073004700",798,704,97,41,124,103,728,757,3352
"06073004800",1416,1201,97,255,472,273,1744,1479,6937
"06073004900",1109,840,120,214,1216,1737,2116,2521,9873
"06073005000",660,238,94,0,756,809,1375,975,4907
"06073005100",2499,2334,456,533,498,589,562,1632,9103
"06073005200",2487,1260,333,247,569,275,636,439,6246
"06073005300",2225,523,344,87,400,133,274,247,4233
"06073005400",4831,521,175,114,1236,389,1000,91,8357
"06073005500",0,0,0,0,0,0,0,0,0
"06073005600",2551,358,242,0,542,24,453,66,4236
"06073005700",749,431,45,155,213,131,235,130,2089
"06073005800",2181,345,68,9,166,90,407,52,3318
"06073005900",1952,162,67,65,194,26,371,24,2861
"06073006000",3008,287,35,0,267,85,338,94,4114
"06073006100",1602,260,64,33,303,120,373,221,2976
"06073006200",0,0,0,0,0,0,0,0,0
"06073006300",48,0,0,0,0,0,0,0,48
"06073006500",1624,501,150,106,311,70,480,185,3427
"06073006600",1043,44,311,12,447,59,499,9,2424
"06073006801",1873,299,62,0,207,0,274,20,2735
"06073006802",3926,682,64,84,671,77,1224,346,7074
"06073006900",4043,684,168,1,572,66,612,278,6424
"06073007002",2742,87,0,0,273,0,291,41,3434
"06073007100",4217,192,23,0,216,53,462,15,5178
"06073007200",3674,187,20,0,120,44,55,5,4105
"06073007301",3678,354,0,0,203,0,412,25,4672
"06073007302",1849,185,0,0,86,0,87,0,2207
"06073007400",5109,851,88,0,491,115,762,194,7610
"06073007501",2931,460,60,0,250,0,388,77,4166
"06073007502",2245,291,62,0,192,18,367,39,3214
"06073007600",3086,890,21,0,81,118,116,21,4333
"06073007701",3534,484,0,0,104,62,335,94,4613
"06073007702",2998,366,32,51,167,86,547,111,4358
"06073007800",4335,641,44,0,772,134,1078,34,7038
"06073007903",3656,575,56,0,214,156,274,24,4955
"06073007905",1479,679,1,0,109,11,130,55,2464
"06073007907",2301,616,0,0,116,50,310,111,3504
"06073007908",2269,359,0,0,164,63,254,25,3134
"06073007910",2375,413,11,0,164,36,159,25,3183
"06073008002",2105,154,9,0,210,9,161,9,2657
"06073008003",2755,293,83,0,314,8,384,35,3872
"06073008006",3614,262,36,0,168,63,161,91,4395
"06073008101",2945,403,14,0,257,42,227,35,3923
"06073008102",2824,90,14,0,277,11,325,11,3552
"06073008200",2140,156,8,13,254,35,75,39,2720
"06073008301",2400,180,0,0,194,20,183,12,2989
"06073008303",2868,214,27,0,110,13,97,15,3344
"06073008305",970,178,47,18,568,385,310,125,2601
"06073008306",2664,132,0,31,374,63,183,0,3447
"06073008307",2931,117,16,15,590,72,395,27,4163
"06073008310",4433,384,2,0,771,0,404,150,6144
"06073008311",2612,33,0,2,294,37,164,2,3144
"06073008312",2778,196,17,0,559,47,198,40,3835
"06073008313",1692,74,0,0,328,0,108,5,2207
"06073008324",5721,131,306,0,720,18,667,0,7563
"06073008327",4353,207,87,0,1203,40,577,31,6498
"06073008328",3419,234,139,0,1398,183,325,42,5740
"06073008329",3701,831,25,0,1860,284,622,161,7484
"06073008330",3132,41,280,0,2086,63,475,0,6077
"06073008331",1836,28,5,15,561,23,156,13,2637
"06073008333",8043,607,112,0,5389,362,1098,49,15660
"06073008335",6328,170,155,65,4570,59,844,0,12191
"06073008336",1658,0,25,0,547,19,281,0,2530
"06073008337",2600,72,108,0,1514,148,287,62,4791
"06073008339",765,341,6,27,693,416,280,142,2670
"06073008340",4017,710,341,38,2643,582,778,33,9142
"06073008341",2680,1070,128,0,1878,1684,497,88,8025
"06073008343",1905,469,15,34,1391,1389,495,178,5876
"06073008344",2508,106,31,0,558,106,349,13,3671
"06073008345",2851,63,93,0,613,117,566,13,4316
"06073008346",2096,38,65,0,2950,37,615,11,5812
"06073008347",2350,58,137,22,3746,187,520,139,7159
"06073008348",2234,34,2,3,3179,134,729,0,6315
"06073008349",994,211,99,0,2029,138,299,67,3837
"06073008350",1913,97,50,14,4134,124,391,0,6723
"06073008351",1310,180,71,152,2594,179,676,148,5310
"06073008352",1151,80,172,8,2369,218,441,58,4497
"06073008353",2101,244,67,0,2383,422,687,106,6010
"06073008354",1817,86,517,0,3851,181,902,40,7394
"06073008355",1035,118,350,87,2289,79,558,10,4526
"06073008356",1509,59,74,11,2076,209,347,22,4307
"06073008357",864,89,61,0,3479,376,355,0,5224
"06073008358",2305,362,280,18,4175,529,1248,18,8935
"06073008359",1674,231,131,50,1841,213,718,217,5075
"06073008360",2079,154,468,9,3167,454,831,85,7247
"06073008361",1354,523,0,49,432,341,114,232,3045
"06073008362",2165,374,66,27,455,215,175,89,3566
"06073008363",1297,566,155,0,1841,1234,324,39,5456
"06073008364",2867,449,0,87,1151,691,332,62,5639
"06073008365",1732,28,19,0,1221,63,140,0,3203
"06073008366",3277,180,151,2,2450,86,509,43,6698
"06073008501",4300,632,6,3,505,69,700,115,6330
"06073008502",4806,307,71,0,849,111,1106,122,7372
"06073008503",4933,728,58,41,1056,36,1157,133,8142
"06073008504",3863,508,9,39,1069,12,832,153,6485
"06073008505",3729,255,162,0,1676,369,1126,79,7396
"06073008506",3143,326,25,8,1028,39,1230,46,5845
"06073008507",4418,613,506,87,1932,458,1082,291,9387
"06073008509",4736,339,447,83,1485,361,1365,20,8836
"06073008510",4189,504,293,9,1436,500,1267,80,8278
"06073008511",1417,182,172,0,956,304,288,221,3540
"06073008512",3320,241,78,1,547,34,507,27,4755
"06073008513",2406,137,0,0,430,92,453,32,3550
"06073008600",3124,1112,271,147,1929,476,2330,1092,10481
"06073008701",2019,99,184,0,824,170,898,45,4239
"06073008702",1945,252,329,89,1477,163,878,142,5275
"06073008800",1595,442,195,308,3068,1179,980,628,8395
"06073008901",2566,875,274,16,926,290,1248,603,6798
"06073008902",1566,133,120,13,244,132,189,81,2478
"06073009000",1570,553,83,105,775,453,1037,678,5254
"06073009101",4033,258,178,16,1083,37,712,1,6318
"06073009102",2032,536,54,24,602,293,723,356,4620
"06073009103",2716,218,69,0,368,21,462,12,3866
"06073009104",2327,167,43,0,351,0,240,0,3128
"06073009106",1280,184,0,6,341,95,264,90,2260
"06073009107",2297,728,110,64,651,102,631,81,4664
"06073009201",2647,135,709,209,1484,250,1080,190,6704
"06073009202",3157,173,167,0,922,197,441,59,5116
"06073009301",2547,200,289,112,1555,225,1268,108,6304
"06073009304",4882,783,715,33,1329,452,975,375,9544
"06073009305",3043,458,29,17,1086,41,1238,160,6072
"06073009306",3322,135,475,75,1341,541,1091,165,7145
"06073009400",1342,21,252,0,231,89,513,89,2537
"06073009502",2368,104,341,14,1017,30,513,0,4387
"06073009504",4592,134,76,0,1690,6,433,0,6931
"06073009505",4430,175,352,17,1664,83,750,108,7579
"06073009506",2948,207,157,0,654,101,374,52,4493
"06073009507",2851,134,100,1,542,29,611,4,4272
"06073009509",2288,169,115,23,899,41,523,0,4058
"06073009510",3044,234,498,0,846,144,789,162,5717
"06073009511",3127,174,177,140,559,61,973,0,5211
"06073009602",2607,185,177,12,671,18,673,0,4343
"06073009603",2828,227,240,257,1109,149,918,44,5772
"06073009604",2401,142,42,0,700,120,856,34,4295
"06073009703",2928,166,136,0,142,7,490,0,3869
"06073009704",4643,111,421,6,699,82,870,1,6833
"06073009705",2489,281,122,49,408,34,446,115,3944
"06073009706",5859,146,38,11,650,59,1115,13,7891
"06073009801",3463,306,43,7,728,77,566,19,5209
"06073009802",4260,726,120,40,1100,47,1178,400,7871
"06073009804",4092,72,87,9,373,0,720,0,5353
"06073009805",4282,94,265,0,570,144,671,20,6046
"06073009901",32,0,0,0,0,0,0,0,32
"06073009902",0,0,0,0,0,0,0,0,0
"06073010001",1905,323,29,0,1299,73,2023,304,5956
"06073010003",3393,702,311,55,1653,132,3283,766,10295
"06073010004",3166,482,59,12,781,55,3051,423,8029
"06073010005",4116,2460,109,105,953,170,4664,2568,15145
"06073010009",4112,1303,100,16,944,306,4774,1508,13063
"06073010010",3082,1281,149,10,1159,218,2990,1207,10096
"06073010011",2192,376,42,101,1015,219,2283,356,6584
"06073010012",3264,1197,89,0,375,25,3491,1216,9657
"06073010013",3628,1979,0,11,474,177,4032,1973,12274
"06073010014",8951,147,694,501,5594,299,8444,296,24926
"06073010015",1480,310,165,0,568,90,1821,394,4828
"06073010103",4483,924,425,61,1093,141,4507,967,12601
"06073010104",2263,152,139,1,728,6,1668,47,5004
"06073010106",3682,1049,104,0,714,281,3994,1260,11084
"06073010107",4600,445,437,89,1283,139,4509,481,11983
"06073010109",2287,501,320,9,1129,119,2557,564,7486
"06073010110",4650,1107,114,29,1848,253,4240,1203,13444
"06073010111",2001,726,67,2,371,43,2060,757,6027
"06073010112",2987,1242,223,124,383,124,2897,1351,9331
"06073010200",4391,1002,40,155,894,193,1755,749,9179
"06073010300",2705,383,68,12,1231,83,1563,281,6326
"06073010401",1221,321,92,60,392,216,875,463,3640
"06073010402",3100,808,183,216,1287,424,2557,1052,9627
"06073010501",1142,92,0,0,312,30,410,53,2039
"06073010502",3129,751,71,90,1257,454,2703,938,9393
"06073010601",2401,134,31,0,127,74,791,76,3634
"06073010800",2472,189,0,0,234,0,91,13,2999
"06073010900",1870,74,7,0,97,0,120,16,2184
"06073011000",2870,136,44,0,148,8,514,16,3736
"06073011100",3642,214,43,0,283,49,512,93,4836
"06073011300",88,16,0,0,28,0,4,0,136
"06073011601",2925,998,109,57,1321,557,3748,1428,11143
"06073011602",1357,817,176,51,574,317,1479,1049,5820
"06073011700",2249,1125,88,77,1917,793,2343,1585,10177
"06073011801",1858,701,123,7,718,402,2148,914,6871
"06073011802",3195,1119,387,137,1616,842,4068,1793,13157
"06073011902",2780,514,120,95,1863,229,2779,616,8996
"06073012002",836,356,69,64,1979,383,822,428,4937
"06073012003",1210,345,59,3,1479,273,1413,490,5272
"06073012101",1900,73,21,0,356,207,1582,240,4379
"06073012102",1731,605,122,21,952,313,2165,833,6742
"06073012200",1732,531,168,48,834,118,1772,615,5818
"06073012302",839,207,120,0,325,195,800,240,2726
"06073012303",2167,434,104,59,489,128,1693,397,5471
"06073012304",2668,187,48,24,411,61,1862,187,5448
"06073012401",1513,916,109,108,661,347,1271,1017,5942
"06073012402",2796,950,273,75,926,185,2652,911,8768
"06073012501",1775,439,110,44,366,231,1416,402,4783
"06073012502",2113,1046,163,39,567,144,2231,1110,7413
"06073012600",2879,936,74,54,604,23,2743,929,8242
"06073012700",2814,973,161,97,603,384,2704,1177,8913
"06073012800",2537,283,190,10,705,127,2154,240,6246
"06073012900",2420,89,30,0,592,122,1732,120,5105
"06073013000",3573,882,254,0,1203,95,3479,838,10324
"06073013102",4208,835,249,36,857,172,4222,818,11397
"06073013103",1453,300,50,15,635,67,1740,297,4557
"06073013104",3564,1074,205,70,606,183,3320,1143,10165
"06073013203",3676,2017,225,80,571,381,3620,2177,12747
"06073013204",2807,684,43,0,623,231,3097,760,8245
"06073013205",1335,452,36,54,365,40,1536,419,4237
"06073013206",4447,1366,87,25,1081,378,4269,1611,13264
"06073013301",3852,530,35,0,1088,25,3179,144,8853
"06073013302",3172,502,51,0,925,73,2736,426,7885
"06073013303",3913,314,87,0,1076,113,4065,378,9946
"06073013306",2714,278,175,82,1004,81,2802,259,7395
"06073013307",2917,479,126,22,701,3,2835,400,7483
"06073013308",2720,341,35,0,705,143,2924,395,7263
"06073013309",4849,346,220,56,1863,127,3566,351,11378
"06073013310",12470,1699,1523,150,11049,681,10930,1845,40347
"06073013311",6360,297,421,0,2794,197,3914,370,14353
"06073013312",2062,197,122,22,525,58,1550,199,4735
"06073013313",4747,375,783,0,5138,178,3747,333,15301
"06073013314",9715,1076,1191,0,4736,21,7351,1006,25096
"06073013401",3308,223,46,8,742,39,2227,144,6737
"06073013409",3485,342,157,37,1376,96,2688,261,8442
"06073013410",4162,241,303,0,2716,46,2809,18,10295
"06073013411",3464,153,51,0,1622,62,1914,54,7320
"06073013412",3526,151,45,0,1279,37,2548,120,7706
"06073013414",5258,434,139,0,1744,279,3069,220,11143
"06073013415",1141,57,65,0,262,32,757,30,2344
"06073013416",2226,158,310,2,1143,14,1492,55,5400
"06073013417",1516,39,48,0,565,0,935,21,3124
"06073013418",3616,552,441,74,1792,50,3452,436,10413
"06073013419",4520,172,618,0,2693,282,3389,252,11926
"06073013420",1726,257,378,0,1636,62,1561,137,5757
"06073013421",2686,83,212,0,1808,79,2155,74,7097
"06073013503",3745,650,380,94,443,308,1268,202,7090
"06073013504",2431,216,437,11,491,120,973,42,4721
"06073013505",3123,359,629,10,591,82,880,265,5939
"06073013506",2795,491,598,24,452,108,1030,270,5768
"06073013601",3693,831,210,23,385,11,1002,463,6618
"06073013604",4530,364,178,184,861,27,1414,78,7636
"06073013605",5386,614,63,10,307,24,1351,62,7817
"06073013606",4070,732,286,12,1585,0,1665,139,8489
"06073013701",1864,86,78,0,176,16,462,31,2713
"06073013702",3316,745,556,311,623,250,1619,650,8070
"06073013801",3579,208,244,39,752,59,1649,177,6707
"06073013802",1763,372,338,15,316,106,1206,286,4402
"06073013903",2675,316,369,23,902,111,1741,204,6341
"06073013905",2553,103,576,156,489,49,1248,81,5255
"06073013906",2712,296,616,205,883,155,1473,158,6498
"06073013907",2059,676,236,63,762,327,2026,747,6896
"06073013908",2705,242,329,143,594,42,2097,184,6336
"06073013909",2542,533,128,31,862,76,2112,331,6615
"06073014001",2423,516,210,18,1246,710,1723,865,7711
"06073014002",2544,254,494,56,1225,110,1681,175,6539
"06073014101",2349,142,403,10,656,426,1370,405,5761
"06073014102",611,191,983,218,1481,216,1009,154,4863
"06073014200",3215,218,496,60,1624,295,2105,303,8316
"06073014300",1928,141,291,12,951,309,1559,335,5526
"06073014400",1218,288,300,324,513,633,1061,452,4789
"06073014500",1806,193,543,133,910,86,922,79,4672
"06073014601",2645,488,275,15,1128,404,1248,403,6606
"06073014602",3173,154,232,30,882,241,891,141,5744
"06073014700",5807,482,268,210,1289,203,1649,331,10239
"06073014803",3108,377,79,30,821,175,1465,314,6369
"06073014804",2919,231,71,168,473,41,666,14,4583
"06073014805",2845,426,117,77,785,168,911,254,5583
"06073014806",1295,129,90,222,235,169,403,174,2717
"06073014901",3238,292,486,0,489,131,879,203,5718
"06073014902",2470,185,318,0,296,59,765,62,4155
"06073015000",4245,480,373,44,1085,310,1729,84,8350
"06073015100",3350,317,322,38,1007,82,911,105,6132
"06073015200",3405,157,51,0,222,17,539,7,4398
"06073015301",1324,593,239,7,765,249,649,75,3901
"06073015302",2557,142,383,14,511,98,665,65,4435
"06073015403",2067,191,78,0,196,66,247,7,2852
"06073015404",4730,1538,318,101,860,568,788,43,8946
"06073015405",5011,175,157,0,665,103,1208,101,7420
"06073015406",2003,77,103,0,367,37,237,40,2864
"06073015501",4360,361,33,0,464,59,767,21,6065
"06073015502",1998,154,7,0,405,86,683,110,3443
"06073015601",3781,1008,158,28,1122,233,1926,237,8493
"06073015602",2059,136,0,0,205,5,351,25,2781
"06073015701",2559,2157,642,62,644,322,1677,1437,9500
"06073015703",2990,2221,163,165,924,677,1669,605,9414
"06073015704",2212,828,118,41,1168,330,1450,577,6724
"06073015801",1254,1308,266,6,696,338,1064,632,5564
"06073015802",2049,941,101,65,800,406,1299,575,6236
"06073015901",1163,735,257,232,702,593,991,635,5308
"06073015902",2257,1198,166,148,1021,380,1355,303,6828
"06073016000",1833,206,44,0,404,5,522,198,3212
"06073016100",4391,316,187,2,1204,225,801,66,7192
"06073016201",4731,268,85,8,462,0,426,232,6212
"06073016202",1891,362,291,24,432,54,662,128,3844
"06073016301",2723,1285,191,237,564,135,1340,584,7059
"06073016302",2701,908,262,137,867,345,1217,502,6939
"06073016401",4051,510,16,40,451,24,881,293,6266
"06073016402",5012,1140,236,67,804,370,1370,737,9736
"06073016502",3716,1325,272,73,1161,853,1730,852,9982
"06073016503",1587,598,114,71,390,58,422,449,3689
"06073016504",4002,878,362,255,637,292,2031,552,9009
"06073016605",5537,368,44,0,1061,134,1257,14,8415
"06073016606",2942,74,0,0,845,50,849,10,4770
"06073016607",4851,455,41,0,446,20,688,138,6639
"06073016608",2366,51,5,3,275,0,261,0,2961
"06073016609",3938,452,82,110,535,42,592,73,5824
"06073016610",3253,221,50,0,551,2,451,32,4560
"06073016612",5058,192,62,1,480,170,983,217,7163
"06073016613",1624,33,5,7,317,12,212,12,2222
"06073016614",2939,258,44,0,951,12,754,16,4974
"06073016615",1872,85,13,0,323,29,443,10,2775
"06073016616",2919,535,104,0,567,55,891,31,5102
"06073016617",2288,267,53,8,540,79,632,22,3889
"06073016701",7420,1068,147,0,1098,101,1545,180,11559
"06073016702",5555,304,100,0,675,0,1612,58,8304
"06073016802",6542,561,26,0,426,83,549,83,8270
"06073016804",5042,1630,0,136,538,183,1358,1011,9898
"06073016806",2969,615,122,12,436,62,903,159,5278
"06073016807",5875,487,0,32,463,144,1062,200,8263
"06073016809",4122,203,58,2,433,58,837,88,5801
"06073016810",2301,295,15,39,267,56,302,17,3292
"06073016811",3261,321,42,10,184,7,786,177,4788
"06073016901",5162,232,419,0,846,38,823,0,7520
"06073016902",1820,198,32,0,620,118,436,47,3271
"06073017006",2123,47,0,0,440,30,126,31,2797
"06073017009",3104,243,54,0,735,73,733,175,5117
"06073017010",2302,123,63,0,412,0,396,38,3334
"06073017014",2066,117,0,0,97,24,117,8,2429
"06073017015",5779,185,338,38,1591,132,1107,14,9184
"06073017018",1861,124,183,0,1898,143,454,0,4663
"06073017019",5012,168,60,0,870,0,566,12,6688
"06073017020",3071,192,74,11,246,36,295,79,4004
"06073017021",2379,74,20,0,295,0,104,21,2893
"06073017022",4109,311,173,0,856,42,593,0,6084
"06073017029",7070,448,21,0,1139,0,933,142,9753
"06073017030",10464,292,414,170,7239,126,1248,155,20108
"06073017031",2736,201,71,0,1109,101,707,65,4990
"06073017032",6064,193,420,1,6700,56,958,61,14453
"06073017033",2511,36,44,2,2168,79,670,40,5550
"06073017034",3408,103,284,0,1103,198,532,117,5745
"06073017035",1337,418,43,197,735,147,160,102,3139
"06073017036",2017,34,121,0,1227,143,348,25,3915
"06073017037",3046,159,298,63,1719,481,571,187,6524
"06073017039",4087,104,33,10,3039,82,837,0,8192
"06073017040",2891,137,70,0,1436,85,619,7,5245
"06073017041",5150,271,62,0,941,0,1034,47,7505
"06073017042",4333,257,89,0,3225,91,448,54,8497
"06073017043",3299,119,45,0,2418,125,596,21,6623
"06073017044",3075,26,82,68,2275,129,518,0,6173
"06073017045",1699,19,27,0,934,29,140,0,2848
"06073017046",2497,134,41,0,1024,75,193,15,3979
"06073017047",2918,76,35,0,835,73,526,16,4479
"06073017048",4207,263,253,0,2375,53,1969,94,9214
"06073017049",1869,483,45,0,611,63,400,269,3740
"06073017050",2123,133,38,0,655,24,665,23,3661
"06073017051",2920,88,208,0,1525,91,275,0,5107
"06073017052",3006,223,76,0,1375,195,579,83,5537
"06073017053",2724,153,72,1,335,2,251,4,3542
"06073017054",4183,229,50,13,1125,146,720,61,6527
"06073017055",3383,58,48,0,1763,0,569,0,5821
"06073017056",2316,189,136,0,1236,82,248,83,4290
"06073017104",3258,299,13,3,318,0,382,106,4379
"06073017106",3638,628,0,0,425,56,475,0,5222
"06073017107",2185,266,21,0,283,0,170,34,2959
"06073017108",4124,74,45,0,504,27,639,56,5469
"06073017109",4893,804,0,0,822,374,221,34,7148
"06073017110",8071,1465,403,43,1217,49,1231,364,12843
"06073017200",4040,128,0,0,39,20,553,0,4780
"06073017303",2667,127,16,0,123,0,333,10,3276
"06073017304",4178,283,18,0,1451,276,2142,237,8585
"06073017305",2286,94,0,0,350,0,69,0,2799
"06073017306",2249,92,27,0,346,0,193,0,2907
"06073017401",4893,531,0,0,367,37,313,0,6141
"06073017403",4300,342,36,0,554,0,808,113,6153
"06073017404",5609,426,7,37,689,114,711,281,7874
"06073017501",2768,127,0,0,251,0,359,10,3515
"06073017502",2247,617,69,0,412,75,852,420,4692
"06073017601",4318,212,0,16,690,115,539,0,5890
"06073017603",1899,150,16,7,275,9,316,49,2721
"06073017604",5132,561,0,0,986,56,1126,35,7896
"06073017701",4246,613,0,0,259,45,479,300,5942
"06073017702",2557,282,0,0,69,41,222,0,3171
"06073017801",4967,443,57,0,1005,1,1492,36,8001
"06073017808",4870,516,14,0,553,44,614,0,6611
"06073017809",1662,442,1,0,184,9,299,133,2730
"06073017810",4323,283,48,2,246,0,320,126,5348
"06073017811",5795,651,84,0,868,40,781,98,8317
"06073017813",3471,264,11,0,611,10,437,20,4824
"06073017900",4411,1199,36,0,866,119,2261,387,9279
"06073018000",2628,274,129,0,140,8,190,8,3377
"06073018100",4261,695,123,11,825,256,1241,274,7686
"06073018200",4816,1392,71,155,1304,195,3212,1088,12233
"06073018300",1820,273,0,0,209,27,351,25,2705
"06073018400",1806,394,35,113,531,303,1079,255,4516
"06073018504",5094,535,400,6,786,503,1658,167,9149
"06073018507",4299,782,443,19,3414,407,3515,661,13540
"06073018509",2472,750,225,71,1199,430,2066,886,8099
"06073018510",1700,576,188,1,701,27,1121,167,4481
"06073018511",2670,359,19,116,1022,142,1468,275,6071
"06073018512",2564,284,120,22,385,26,900,122,4423
"06073018513",5872,534,426,143,1375,84,1549,147,10130
"06073018514",4445,691,522,63,1990,293,1359,340,9703
"06073018515",3582,153,266,0,679,92,787,114,5673
"06073018516",1894,448,103,47,1227,86,1134,226,5165
"06073018517",2325,620,415,1,1347,63,1509,217,6497
"06073018518",1406,220,58,21,1281,127,1657,244,5014
"06073018519",2899,702,100,33,1353,596,2760,1156,9599
"06073018601",3134,352,111,25,1359,23,1516,86,6606
"06073018603",3242,676,408,102,1403,588,2955,1002,10376
"06073018608",2078,229,112,29,886,76,845,134,4389
"06073018609",3324,366,271,50,1815,169,3022,352,9369
"06073018610",3377,769,280,77,2619,717,3511,1029,12379
"06073018611",4082,882,371,52,1997,77,1195,462,9118
"06073018612",2419,181,39,92,687,33,1132,137,4720
"06073018613",1487,223,573,0,1051,129,885,30,4378
"06073018614",3646,510,459,14,1465,323,1908,512,8837
"06073018700",13555,1747,2332,173,4581,464,5037,786,28675
"06073018801",3194,410,0,11,304,22,516,62,4519
"06073018802",7003,682,70,0,631,119,902,15,9422
"06073018803",3164,312,42,5,924,37,1047,126,5657
"06073018903",3022,969,39,0,577,4,1337,494,6442
"06073018904",3854,775,87,0,1241,415,2868,829,10069
"06073018905",3974,825,109,48,1040,594,2852,1022,10464
"06073018906",3588,788,113,63,1036,525,1926,739,8778
"06073019001",4734,742,29,14,1318,224,1145,350,8556
"06073019002",1039,181,0,0,123,8,311,113,1775
"06073019101",4063,730,24,28,1806,394,1303,578,8926
"06073019103",4399,769,0,0,581,0,645,248,6642
"06073019105",5242,422,26,38,785,0,529,2,7044
"06073019106",5900,449,2,8,2024,580,1968,466,11397
"06073019107",1234,237,0,38,255,102,235,91,2192
"06073019203",1876,208,60,0,419,19,568,21,3171
"06073019205",4631,449,230,0,928,144,3093,275,9750
"06073019206",4292,586,54,32,432,119,3478,557,9550
"06073019207",5970,1283,122,46,842,80,3147,735,12225
"06073019208",2828,170,4,0,257,19,565,55,3898
"06073019301",4555,353,415,1,1380,139,1225,30,8098
"06073019302",5079,596,147,93,1265,121,1978,131,9410
"06073019303",4612,839,265,0,1560,344,2760,542,10922
"06073019403",4133,534,270,14,941,69,2653,247,8861
"06073019404",2087,584,73,0,582,45,2155,431,5957
"06073019405",2422,630,137,25,615,35,1789,413,6066
"06073019406",3104,611,127,0,1126,89,1959,250,7266
"06073019501",2249,509,68,35,497,45,2376,479,6258
"06073019502",3771,861,3,0,554,329,3710,1061,10289
"06073019503",2596,1115,61,0,850,191,2445,731,7989
"06073019601",3929,983,129,25,715,69,1467,394,7711
"06073019602",3305,1018,134,11,571,180,1340,664,7223
"06073019701",3331,694,178,13,1269,49,1520,174,7228
"06073019702",3491,735,102,12,694,66,1477,410,6987
"06073019803",3295,317,19,0,717,94,704,54,5200
"06073019804",3978,396,0,0,286,59,544,25,5288
"06073019805",2425,530,64,232,813,166,1188,337,5755
"06073019806",8600,1088,52,41,2081,158,1001,193,13214
"06073019808",3466,444,33,0,544,17,438,12,4954
"06073019809",3316,177,23,11,547,41,369,59,4543
"06073019902",2938,565,38,0,388,14,1161,306,5410
"06073019903",3042,421,131,0,637,125,1145,128,5629
"06073019904",3842,763,420,46,1290,207,1138,248,7954
"06073019905",3036,550,98,0,483,118,525,193,5003
"06073020013",10177,810,393,0,1851,446,1642,89,15408
"06073020014",5163,627,47,0,1253,147,596,117,7950
"06073020015",3193,370,17,0,453,0,183,34,4250
"06073020016",7236,1212,27,160,853,21,578,19,10106
"06073020017",2280,705,131,18,252,63,1249,223,4921
"06073020018",5234,1071,199,0,1633,419,4979,1116,14651
"06073020019",5080,893,27,72,926,168,1860,427,9453
"06073020020",3951,640,18,9,2274,681,1264,251,9088
"06073020021",3383,826,124,31,1661,370,2968,763,10126
"06073020022",4280,1027,197,62,1941,167,1717,453,9844
"06073020023",3434,338,40,0,406,0,1520,51,5789
"06073020024",2762,394,126,39,849,40,1371,97,5678
"06073020025",3099,432,209,27,949,134,1170,149,6169
"06073020026",2873,181,0,0,1171,33,792,21,5071
"06073020027",10642,1419,147,2,2146,113,2030,206,16705
"06073020028",1996,560,42,0,692,436,2221,897,6844
"06073020029",2754,528,165,0,739,706,2003,698,7593
"06073020103",7485,1102,112,9,2176,60,2963,120,14027
"06073020105",2352,945,89,0,528,200,750,359,5223
"06073020106",3010,329,0,82,421,54,1749,203,5848
"06073020107",2941,617,62,0,543,33,1516,425,6137
"06073020108",3921,857,109,1,612,307,3527,777,10111
"06073020109",3746,881,95,4,774,17,2507,657,8681
"06073020202",2836,1735,267,38,858,195,3167,1719,10815
"06073020206",3551,882,101,98,502,340,2960,983,9417
"06073020207",2791,843,160,20,991,34,2563,597,7999
"06073020208",1743,399,29,0,300,76,1201,409,4157
"06073020209",2945,1025,170,52,748,187,2118,704,7949
"06073020210",2958,731,20,0,1639,202,2510,476,8536
"06073020211",4457,1207,167,0,1230,61,3865,984,11971
"06073020213",2235,1319,0,0,298,123,1877,1244,7096
"06073020214",1992,1954,103,56,546,432,2023,1610,8716
"06073020304",4273,905,20,0,630,13,743,54,6638
"06073020305",3940,1063,232,9,966,151,1152,631,8144
"06073020306",5374,1317,308,71,1171,146,1023,226,9636
"06073020307",5482,1218,132,24,917,39,2071,276,10159
"06073020308",3608,863,154,109,576,84,1750,266,7410
"06073020309",3046,528,0,0,570,103,1587,291,6125
"06073020401",2130,184,29,2,121,3,142,3,2614
"06073020403",3051,282,1,0,729,55,1392,179,5689
"06073020404",3339,405,211,8,729,179,996,130,5997
"06073020405",2475,269,7,2,370,70,119,25,3337
"06073020500",3556,893,0,0,149,48,2036,323,7005
"06073020601",3014,1422,91,21,839,115,2896,906,9304
"06073020602",3891,1178,99,25,838,264,2249,977,9521
"06073020705",3242,511,118,0,671,28,981,319,5870
"06073020706",5230,311,72,78,648,22,850,26,7237
"06073020707",2504,881,170,0,418,60,1128,677,5838
"06073020708",2640,287,149,0,454,9,688,18,4245
"06073020709",5700,691,239,17,1357,107,1812,365,10288
"06073020710",1384,93,24,0,109,5,243,40,1898
"06073020801",4485,289,51,0,158,60,524,76,5643
"06073020805",2766,429,120,0,249,0,814,307,4685
"06073020806",4309,627,22,0,774,176,1457,312,7677
"06073020807",2110,117,27,0,88,10,335,32,2719
"06073020809",6110,724,20,0,1210,58,2731,314,11167
"06073020810",4670,209,0,0,211,5,543,102,5740
"06073020811",4610,359,153,0,429,2,685,122,6360
"06073020902",1643,126,13,0,90,40,52,17,1981
"06073020903",1415,241,11,3,488,225,353,61,2797
"06073020904",2036,276,0,6,168,7,278,0,2771
"06073021000",2445,570,0,1,299,12,689,185,4201
"06073021100",5017,751,103,9,687,297,2148,249,9261
"06073021202",1969,386,14,0,319,165,163,81,3097
"06073021204",4706,279,90,0,313,29,662,0,6079
"06073021205",5767,733,42,46,743,22,1817,99,9269
"06073021206",2245,103,34,14,256,28,188,32,2900
"06073021302",3816,669,136,9,127,49,760,587,6153
"06073021303",5891,267,255,0,2259,65,2578,181,11496
"06073021304",2223,100,36,9,159,0,655,39,3221
"06073021400",4386,367,242,11,1145,75,1210,74,7510
"06073021500",5770,109,128,0,3054,113,901,22,10097
"06073021600",2330,225,74,0,254,0,567,36,3486
"06073021800",2322,161,0,9,56,7,80,13,2648
"06073021900",881,315,34,58,470,73,1079,366,3276
"06073022000",1374,476,140,0,1902,370,1467,460,6189
"06073022100",6267,766,46,0,1367,363,1448,318,10575
"06073990100",0,0,0,0,0,0,0,0,0
"06075010100",1756,262,28,39,1476,246,238,175,4220
"06075010200",3418,211,21,0,494,76,39,63,4322
"06075010300",2407,250,0,0,1164,525,269,74,4689
"06075010400",2865,274,0,0,1912,203,430,35,5719
"06075010500",1605,47,43,0,777,134,76,36,2718
"06075010600",1045,119,9,27,1435,1029,269,45,3978
"06075010700",1010,142,151,0,3051,957,97,38,5446
"06075010800",2073,166,0,0,1817,723,309,0,5088
"06075010900",3028,250,47,13,1175,227,265,0,5005
"06075011000",2513,71,49,21,2438,211,296,17,5616
"06075011100",2674,216,112,58,1686,282,374,123,5525
"06075011200",1547,139,40,1,1063,288,187,0,3265
"06075011300",588,3,31,66,1737,604,27,0,3056
"06075011700",368,130,45,69,784,99,110,53,1658
"06075011800",58,72,0,2,1063,545,79,13,1832
"06075011901",1134,166,164,0,684,149,146,40,2483
"06075011902",1217,245,29,26,860,248,433,51,3109
"06075012000",1583,244,306,52,945,398,199,89,3816
"06075012100",1759,317,36,43,965,220,358,92,3790
"06075012201",1326,357,190,148,2003,552,917,68,5561
"06075012202",957,414,425,138,769,376,491,230,3800
"06075012301",433,292,118,134,416,397,148,182,2120
"06075012302",867,215,152,67,832,341,120,31,2625
"06075012401",1584,523,146,170,1649,538,1409,362,6381
"06075012402",994,344,70,106,1100,441,107,146,3308
"06075012501",724,347,44,387,1282,685,164,170,3803
"06075012502",695,291,108,349,1435,1062,523,443,4906
"06075012601",2121,51,0,0,327,0,270,0,2769
"06075012602",2606,95,0,0,356,44,102,0,3203
"06075012700",2869,291,180,0,405,13,80,0,3838
"06075012800",3877,116,16,77,755,67,403,99,5410
"06075012901",2003,58,1,1,515,0,69,9,2656
"06075012902",2601,104,41,0,511,119,233,16,3625
"06075013000",3498,389,0,0,615,33,269,0,4804
"06075013101",2699,60,101,2,811,44,190,45,3952
"06075013102",2268,121,0,1,180,62,86,45,2763
"06075013200",3774,104,82,0,682,29,190,0,4861
"06075013300",3197,303,24,54,719,143,328,39,4807
"06075013400",3220,76,11,34,366,112,312,36,4167
"06075013500",1986,94,10,33,399,70,187,12,2791
"06075015100",1254,87,0,0,674,56,163,0,2234
"06075015200",2329,326,69,63,944,39,127,16,3913
"06075015300",1280,79,173,5,306,61,167,20,2091
"06075015400",3596,193,172,45,1758,155,316,48,6283
"06075015500",1870,325,167,57,989,419,445,66,4338
"06075015600",1398,290,73,0,1087,157,64,76,3145
"06075015700",3154,404,309,43,1657,420,456,8,6451
"06075015801",1701,71,835,275,633,158,303,113,4089
"06075015802",1803,161,146,84,532,86,259,95,3166
"06075015900",1396,253,520,65,1251,517,334,0,4336
"06075016000",1304,92,56,63,871,166,242,30,2824
"06075016100",773,658,1127,546,1158,795,238,56,5351
"06075016200",1557,137,32,74,583,221,323,84,3011
"06075016300",2314,231,807,498,714,169,817,15,5565
"06075016400",2650,303,260,127,505,99,350,128,4422
"06075016500",3139,579,657,46,1090,138,680,172,6501
"06075016600",3679,493,248,16,876,225,322,67,5926
"06075016700",3849,316,122,0,488,149,382,31,5337
"06075016801",1794,259,500,25,679,57,251,14,3579
"06075016802",1611,214,104,172,673,181,226,43,3224
"06075016900",2235,122,85,24,470,53,344,9,3342
"06075017000",2954,213,124,0,506,60,168,27,4052
"06075017101",2931,123,91,16,379,17,259,17,3833
"06075017102",2786,276,110,7,605,74,288,89,4235
"06075017601",1449,689,384,555,3318,801,191,225,7612
"06075017700",714,181,31,3,633,92,487,125,2266
"06075017801",635,174,87,84,1289,785,57,31,3142
"06075017802",1574,397,72,296,1813,146,538,129,4965
"06075017902",655,360,308,364,456,693,369,384,3589
"06075018000",1105,245,163,112,726,249,155,197,2952
"06075020100",2110,564,52,176,1703,598,1339,557,7099
"06075020200",3442,428,224,130,1604,134,1507,28,7497
"06075020300",2009,234,61,0,566,172,341,106,3489
"06075020401",2429,39,96,28,469,6,152,0,3219
"06075020402",3047,103,83,36,818,41,345,12,4485
"06075020500",2071,137,62,0,268,77,211,22,2848
"06075020600",3404,248,61,26,755,113,542,38,5187
"06075020700",3598,422,18,32,1274,83,628,100,6155
"06075020800",2981,949,110,85,1792,265,2253,889,9324
"06075020900",2193,561,42,13,1585,321,1861,480,7056
"06075021000",3261,104,0,25,990,127,542,51,5100
"06075021100",2797,267,75,0,782,56,397,170,4544
"06075021200",2174,148,28,0,408,74,226,23,3081
"06075021300",2048,65,0,0,494,19,227,0,2853
"06075021400",2606,109,9,0,726,9,419,33,3911
"06075021500",3681,277,180,16,943,32,982,86,6197
"06075021600",2389,196,241,48,1445,16,634,0,4969
"06075021700",2438,98,349,155,886,153,236,97,4412
"06075021800",3109,213,51,24,793,48,466,14,4718
"06075022600",1123,22,149,5,554,13,154,0,2020
"06075022702",1634,64,55,1,448,47,196,1,2446
"06075022704",2331,120,32,0,823,8,236,6,3556
"06075022801",2745,378,90,100,1530,112,1508,99,6562
"06075022802",700,287,47,6,646,169,580,290,2725
"06075022803",2459,474,70,27,1729,135,2475,452,7821
"06075022901",2338,243,76,123,1723,521,2523,573,8120
"06075022902",1376,259,126,91,566,42,1017,144,3621
"06075022903",1416,270,16,41,1025,297,1049,398,4512
"06075023001",720,37,661,41,2322,1040,510,88,5419
"06075023003",605,53,1278,221,1952,228,449,94,4880
"06075023102",283,179,1962,1254,711,481,110,310,5290
"06075023103",124,249,811,674,602,474,352,277,3563
"06075023200",933,175,1309,657,919,326,1028,181,5528
"06075023300",470,24,306,20,2227,311,464,0,3822
"06075023400",433,32,506,305,1810,613,1198,538,5435
"06075025100",2071,198,217,13,839,64,597,112,4111
"06075025200",3566,305,213,13,1699,147,1705,139,7787
"06075025300",2818,180,142,20,1224,235,1241,174,6034
"06075025401",1604,153,165,130,1173,52,1101,106,4484
"06075025402",1780,27,67,0,1356,56,950,34,4270
"06075025403",2044,302,363,95,2048,245,1917,266,7280
"06075025500",2918,127,65,4,5201,319,3392,127,12153
"06075025600",1323,234,140,3,3666,212,908,96,6582
"06075025701",1123,300,229,62,3055,301,575,97,5742
"06075025702",858,102,28,129,3447,263,1281,95,6203
"06075025800",419,77,94,14,1004,377,467,165,2617
"06075025900",989,83,338,19,2434,126,746,12,4747
"06075026001",1553,213,153,10,2918,601,1973,465,7886
"06075026002",1009,96,145,0,1897,126,977,145,4395
"06075026003",1690,93,35,0,3102,133,2022,40,7115
"06075026004",1473,164,41,37,2612,331,1643,138,6439
"06075026100",1427,311,57,24,4835,343,1501,381,8879
"06075026200",1501,347,84,5,5589,312,1398,387,9623
"06075026301",1191,91,16,31,2908,420,1348,83,6088
"06075026302",1580,27,118,0,3296,274,1242,100,6637
"06075026303",1460,208,106,0,3125,403,1484,211,6997
"06075026401",324,24,277,215,2674,288,492,78,4372
"06075026402",619,23,445,69,2843,114,572,8,4693
"06075026403",265,124,137,0,2740,499,442,98,4305
"06075026404",256,155,345,117,1466,137,360,163,2999
"06075030101",2617,484,52,12,1231,157,355,25,4933
"06075030102",3100,115,52,18,1228,210,367,11,5101
"06075030201",2305,211,8,0,1492,168,123,12,4319
"06075030202",2259,262,74,10,1413,278,556,36,4888
"06075030301",2716,235,33,2,2414,189,399,75,6063
"06075030302",1598,209,18,10,1923,178,232,8,4176
"06075030400",2430,163,111,0,2220,487,164,0,5575
"06075030500",1412,101,83,48,674,53,181,8,2560
"06075030600",1475,71,14,0,791,2,230,6,2589
"06075030700",3936,101,53,9,2492,314,744,184,7833
"06075030800",3256,65,76,15,2134,49,607,19,6221
"06075030900",3221,35,157,21,2882,283,493,1,7093
"06075031000",1887,65,151,9,1509,123,601,16,4361
"06075031100",3221,338,468,0,2372,203,747,90,7439
"06075031201",1351,218,353,22,4424,774,759,229,8130
"06075031202",440,56,543,0,1540,379,417,14,3389
"06075031301",881,92,857,116,2232,184,387,17,4766
"06075031302",860,516,777,127,3357,614,596,473,7320
"06075031400",1295,270,674,315,3442,531,1328,255,8110
"06075032601",1522,224,33,2,2813,172,168,11,4945
"06075032602",1458,306,12,0,2447,278,219,0,4720
"06075032700",2468,142,1,0,4158,349,224,96,7438
"06075032801",1009,138,15,0,2514,282,207,0,4165
"06075032802",724,101,14,70,2595,471,114,26,4115
"06075032901",1631,168,7,29,3300,377,556,165,6233
"06075032902",1149,93,67,0,2264,410,177,37,4197
"06075033000",3300,346,54,0,4245,756,656,143,9500
"06075033100",1625,105,1,0,2808,118,243,0,4900
"06075033201",373,233,101,82,298,361,89,175,1712
"06075033203",1507,377,237,36,1235,539,353,43,4327
"06075033204",1264,420,176,127,958,791,450,203,4389
"06075035100",2788,170,57,27,4494,425,474,23,8458
"06075035201",1821,193,0,0,3086,318,377,9,5804
"06075035202",1801,256,19,0,2250,225,369,109,5029
"06075035300",1831,218,0,94,5265,451,364,83,8306
"06075035400",2000,431,50,38,3556,241,334,162,6812
"06075040100",2543,192,31,20,1164,326,178,27,4481
"06075040200",2360,197,90,45,2151,183,346,20,5392
"06075042601",1567,279,63,70,1847,285,401,10,4522
"06075042602",1770,144,47,0,1441,46,218,0,3666
"06075042700",2238,455,135,4,2111,423,560,233,6159
"06075042800",1632,84,10,0,535,96,136,8,2501
"06075045100",2320,294,74,57,1781,527,315,156,5524
"06075045200",3352,293,21,0,2330,889,601,70,7556
"06075047600",2132,174,54,1,3042,183,166,0,5752
"06075047701",1552,48,26,0,2174,216,158,0,4174
"06075047702",1607,118,52,2,2269,173,121,9,4351
"06075047801",1161,228,23,15,2394,156,248,44,4269
"06075047802",1189,140,0,0,2302,266,258,18,4173
"06075047901",3077,413,119,16,2808,114,802,66,7415
"06075047902",1554,288,31,21,1502,273,205,46,3920
"06075060100",2682,195,50,0,510,6,192,0,3635
"06075060400",905,216,45,0,553,135,324,54,2232
"06075060502",356,207,179,383,1443,583,809,317,4277
"06075060700",3451,346,251,206,4619,577,912,66,10428
"06075061000",797,29,550,1,2936,161,830,28,5332
"06075061100",130,100,11,11,2622,1614,213,22,4723
"06075061200",675,177,819,115,1839,347,1180,371,5523
"06075061400",3756,106,33,257,1245,228,773,30,6428
"06075061500",6827,563,227,12,4037,483,1503,168,13820
"06075980200",75,12,0,0,27,0,5,0,119
"06075980300",40,0,0,0,5,0,0,0,45
"06075980401",0,0,0,0,0,0,0,0,0
"06075980501",83,17,17,138,382,213,44,27,921
"06075980600",97,0,151,75,39,39,74,0,475
"06075980900",90,34,6,26,69,21,13,41,300
"06075990100",0,0,0,0,0,0,0,0,0
"06077000100",690,881,188,459,846,481,962,824,5331
"06077000300",533,453,112,128,332,356,536,657,3107
"06077000401",1716,262,235,320,432,239,765,176,4145
"06077000402",1283,659,238,624,513,427,976,913,5633
"06077000500",866,532,0,25,578,694,1178,1099,4972
"06077000600",619,500,16,48,487,448,898,872,3888
"06077000700",652,866,103,154,1596,1319,1568,1882,8140
"06077000801",2304,802,563,276,2479,974,3142,1388,11928
"06077000900",2573,1007,248,369,1238,700,2059,922,9116
"06077001000",2949,502,145,26,913,335,1453,342,6665
"06077001101",2992,462,237,86,1248,442,2148,485,8100
"06077001102",2103,800,161,11,940,394,1537,613,6559
"06077001200",2317,476,47,34,548,55,763,183,4423
"06077001300",2729,1176,212,80,881,440,1605,1114,8237
"06077001400",2377,247,54,287,1394,490,1810,293,6952
"06077001500",1634,2015,182,52,2631,1491,2635,1827,12467
"06077001600",820,747,8,6,565,145,991,567,3849
"06077001700",1568,551,55,25,1125,618,1988,1080,7010
"06077001800",1604,416,57,0,985,378,2034,589,6063
"06077001900",1401,1386,349,194,1385,615,2303,1749,9382
"06077002000",1164,548,594,149,1110,459,1999,825,6848
"06077002100",1937,796,414,254,1298,765,2855,1263,9582
"06077002201",454,759,424,294,539,291,947,988,4696
"06077002202",1532,1130,465,707,1181,818,2318,1705,9856
"06077002300",1239,671,59,114,1556,1303,2346,1742,9030
"06077002401",627,793,152,120,2029,721,1437,1269,7148
"06077002402",561,232,43,83,813,379,1009,660,3780
"06077002503",335,283,191,179,905,583,656,394,3526
"06077002504",876,628,352,48,2222,683,1523,1116,7448
"06077002701",2447,875,77,0,2401,754,3567,1146,11267
"06077002702",2143,584,97,0,958,830,2581,1124,8317
"06077002800",1629,384,562,245,2743,495,3273,610,9941
"06077003106",2437,243,59,45,551,259,669,163,4426
"06077003108",2534,474,180,192,647,342,927,165,5461
"06077003109",3025,360,327,55,1155,422,1152,350,6846
"06077003110",1205,276,231,381,873,408,867,479,4720
"06077003111",1335,307,606,19,1118,274,983,220,4862
"06077003112",1649,255,203,106,922,330,655,434,4554
"06077003113",1689,311,584,683,1358,559,1459,372,7015
"06077003114",5913,314,584,46,2672,138,1715,53,11435
"06077003203",2371,338,48,16,900,18,904,70,4665
"06077003205",2423,86,161,158,956,80,897,27,4788
"06077003208",5242,599,1207,502,5000,503,2803,145,16001
"06077003209",1746,317,240,29,904,60,791,215,4302
"06077003210",1396,214,104,156,763,49,547,136,3365
"06077003213",1718,236,511,47,1449,719,1238,515,6433
"06077003214",1772,186,150,8,963,67,1078,117,4341
"06077003215",1837,344,233,128,977,133,1106,188,4946
"06077003216",1181,191,375,141,910,391,787,327,4303
"06077003217",916,246,311,290,914,622,967,375,4641
"06077003305",2155,227,75,206,1175,121,1434,145,5538
"06077003306",1463,466,442,244,1852,320,1493,362,6642
"06077003307",1455,1111,319,257,891,1040,623,1485,7181
"06077003308",593,140,86,91,397,126,505,95,2033
"06077003310",1299,478,414,135,1307,482,805,511,5431
"06077003311",1347,383,233,116,722,456,886,155,4298
"06077003312",374,452,136,190,712,908,751,1021,4544
"06077003313",620,349,140,173,1045,556,713,414,4010
"06077003403",897,290,168,467,2653,566,1004,307,6352
"06077003404",1449,281,495,292,2478,1572,1553,296,8416
"06077003405",988,424,153,74,1567,656,820,304,4986
"06077003406",865,525,259,617,1065,563,668,643,5205
"06077003407",996,281,236,176,669,557,960,319,4194
"06077003409",1063,712,297,42,2126,492,1292,772,6796
"06077003410",1582,330,480,296,2340,887,1559,443,7917
"06077003500",6208,570,1013,480,10240,2108,3785,727,25131
"06077003601",2151,361,11,10,819,67,838,197,4454
"06077003602",1997,650,0,0,450,321,839,709,4966
"06077003700",1523,512,0,9,516,419,973,749,4701
"06077003801",3537,601,2272,319,5429,628,4848,254,17888
"06077003802",1959,142,1074,354,2504,213,1999,234,8479
"06077003803",1500,788,279,161,1153,365,1445,780,6471
"06077003900",870,411,40,11,169,83,605,335,2524
"06077004001",1361,356,13,0,227,69,772,315,3113
"06077004002",4480,683,1201,103,4053,1072,2399,462,14453
"06077004102",3524,332,145,0,2923,557,1625,282,9388
"06077004104",2937,113,22,0,424,0,576,32,4104
"06077004105",3616,467,13,0,470,18,1178,332,6094
"06077004106",1509,110,12,0,248,12,564,100,2555
"06077004201",4523,573,27,0,873,58,1182,210,7446
"06077004202",1339,63,0,0,107,0,195,4,1708
"06077004203",2201,603,42,16,505,344,859,634,5204
"06077004204",2359,334,0,0,165,93,428,122,3501
"06077004302",3939,647,0,0,928,0,1423,20,6957
"06077004303",3814,409,28,0,829,37,905,283,6305
"06077004305",4667,470,19,98,907,21,1077,339,7598
"06077004307",1971,327,238,1,794,243,513,244,4331
"06077004308",1373,614,7,0,1415,533,1254,953,6149
"06077004402",2997,731,108,0,1020,335,1304,452,6947
"06077004403",1027,604,0,153,1458,930,1908,1012,7092
"06077004404",1664,595,5,15,575,549,1365,818,5586
"06077004501",1414,708,0,0,426,91,510,590,3739
"06077004502",1524,1157,25,0,1182,601,1890,1582,7961
"06077004600",4777,727,10,0,1303,22,2246,109,9194
"06077004701",1896,490,0,0,226,57,558,276,3503
"06077004703",2711,309,6,0,495,58,703,206,4488
"06077004704",3406,240,0,0,446,481,815,591,5979
"06077004800",3546,417,8,42,1204,262,1754,336,7569
"06077004901",5898,814,0,0,446,162,1275,265,8860
"06077004902",4599,553,16,0,726,312,1659,574,8439
"06077005001",4117,818,48,0,430,22,789,432,6656
"06077005003",4520,289,61,2,643,40,859,201,6615
"06077005004",4516,504,0,50,474,101,1212,225,7082
"06077005106",3375,274,323,16,1551,282,1602,218,7641
"06077005108",2779,450,78,0,906,184,1972,519,6888
"06077005109",2520,425,63,20,471,323,1355,539,5716
"06077005110",4653,704,78,180,1854,162,2417,683,10731
"06077005113",4015,303,260,0,1129,333,1862,333,8235
"06077005114",5477,383,597,0,2083,286,2734,112,11672
"06077005119",2307,221,585,243,2578,126,1908,168,8136
"06077005122",2874,495,140,18,1095,162,1587,305,6676
"06077005123",2514,192,146,136,1438,192,1777,89,6484
"06077005124",1972,291,75,0,805,114,1151,203,4611
"06077005125",1280,82,65,0,328,36,598,79,2468
"06077005126",2344,594,135,0,923,389,1410,466,6261
"06077005127",2428,155,386,73,2162,190,2081,175,7650
"06077005129",1862,259,75,17,1116,25,1853,140,5347
"06077005130",1198,468,49,12,1028,229,1097,298,4379
"06077005131",2812,317,0,0,598,263,1348,337,5675
"06077005132",1856,608,18,3,498,84,1155,598,4820
"06077005133",3045,300,29,0,674,43,1640,31,5762
"06077005134",2705,298,122,73,1455,113,1435,344,6545
"06077005135",4477,130,42,3,1347,78,1226,84,7387
"06077005202",5286,217,65,57,2116,98,2279,124,10242
"06077005206",8545,597,1812,39,8405,675,4220,370,24663
"06077005207",6384,311,1184,2,6601,370,3921,435,19208
"06077005208",3474,119,184,122,1543,64,1662,50,7218
"06077005209",3322,72,689,152,2457,406,2206,450,9754
"06077005210",6747,255,795,25,3283,340,3231,373,15049
"06077005302",4239,755,8,0,1657,188,3067,733,10647
"06077005303",2329,599,20,20,1230,379,1970,681,7228
"06077005305",3821,607,417,54,1341,364,2599,550,9753
"06077005307",1376,359,230,1,1054,83,1026,273,4402
"06077005308",2155,236,231,7,1190,130,1204,244,5397
"06077005403",3256,301,618,113,1360,191,1627,311,7777
"06077005405",1713,276,268,0,1136,141,1620,324,5478
"06077005406",1728,403,102,9,566,362,1106,701,4977
"06077005501",1309,119,0,0,125,4,323,13,1893
"06077005502",1301,48,101,10,436,7,388,15,2306
"06079010002",2604,82,31,0,211,17,438,0,3383
"06079010016",3472,612,0,0,1002,353,1463,451,7353
"06079010101",1598,156,0,0,54,0,154,82,2044
"06079010102",4073,1160,183,0,1298,454,2920,1253,11341
"06079010201",5501,438,78,0,885,17,1198,126,8243
"06079010202",4118,605,187,0,632,172,1875,493,8082
"06079010204",3982,468,120,100,807,81,1540,400,7498
"06079010205",3002,239,314,0,450,209,1308,341,5863
"06079010300",7544,740,184,0,1137,88,1781,229,11703
"06079010403",3565,232,0,0,220,32,589,95,4733
"06079010404",1719,175,8,0,257,11,513,115,2798
"06079010503",4199,639,0,0,186,0,473,244,5741
"06079010504",2072,306,0,0,154,20,256,54,2862
"06079010602",3517,265,0,0,222,11,661,53,4729
"06079010603",837,311,0,0,114,37,198,223,1720
"06079010701",3933,382,33,6,636,93,502,62,5647
"06079010703",2396,280,0,9,502,35,459,0,3681
"06079010707",4804,474,0,0,575,89,469,49,6460
"06079010901",263,1075,0,0,13,244,44,241,1880
"06079010902",1112,2436,48,23,171,261,299,323,4673
"06079011001",3385,598,359,0,580,134,352,79,5487
"06079011002",1541,1118,0,0,278,235,247,212,3631
"06079011101",1817,791,30,13,322,171,259,204,3607
"06079011102",3231,827,79,213,416,213,647,321,5947
"06079011103",1951,306,15,0,171,145,584,125,3297
"06079011200",3449,3023,37,117,197,474,263,609,8169
"06079011300",5535,1184,96,93,927,393,1531,378,10137
"06079011400",0,0,0,0,0,0,0,0,0
"06079011501",1135,249,0,9,262,6,482,93,2236
"06079011503",2735,399,108,43,248,16,274,30,3853
"06079011504",478,110,0,4,29,5,62,86,774
"06079011600",3680,291,10,0,290,3,137,0,4411
"06079011701",4433,141,54,2,123,60,112,2,4927
"06079011704",2333,235,19,0,270,67,206,9,3139
"06079011800",6063,399,0,1,816,26,763,43,8111
"06079011901",2277,458,0,0,343,41,221,102,3442
"06079011902",6580,437,189,22,903,62,1698,96,9987
"06079012000",5023,1087,306,6,1080,10,1619,553,9684
"06079012102",4043,555,44,0,911,86,1390,122,7151
"06079012200",4599,843,0,0,1239,491,2928,868,10968
"06079012302",4104,374,0,0,485,2,774,132,5871
"06079012304",8174,554,56,10,974,35,1341,18,11162
"06079012401",4917,860,39,30,777,23,2396,423,9465
"06079012402",6892,1039,96,0,1376,339,2533,546,12821
"06079012502",3946,457,82,29,399,133,537,181,5764
"06079012503",3800,771,0,0,435,441,893,481,6821
"06079012505",4408,314,17,0,330,48,469,141,5727
"06079012600",6847,461,34,137,336,18,1087,112,9032
"06079012702",5564,806,0,10,485,14,524,199,7602
"06079012704",7325,592,129,0,681,81,869,95,9772
"06079012800",16,21,1,0,2,26,2,33,101
"06079012900",4544,442,0,0,518,153,1007,343,7007
"06079013000",1888,215,0,3,411,34,623,151,3325
"06079990000",0,0,0,0,0,0,0,0,0
"06081600100",2362,95,62,36,2330,108,1024,77,6094
"06081600200",413,43,83,93,3080,623,959,315,5609
"06081600300",820,34,120,0,2765,279,582,277,4877
"06081600401",1070,0,200,0,2143,114,844,17,4388
"06081600402",960,77,63,0,3036,510,1349,341,6336
"06081600500",1359,109,181,0,5605,325,1739,316,9634
"06081600600",1442,61,111,9,3640,149,2163,131,7706
"06081600700",1761,236,217,120,4874,498,2024,225,9955
"06081600800",1328,316,302,40,4092,766,1145,270,8259
"06081600900",1696,60,0,0,1927,265,575,34,4557
"06081601000",1595,69,358,10,4822,97,934,21,7906
"06081601100",1345,93,44,3,3932,411,483,21,6332
"06081601200",1872,89,49,23,3954,249,1589,74,7899
"06081601300",1823,822,148,14,5106,755,3203,558,12429
"06081601400",937,52,322,9,4825,731,455,320,7651
"06081601501",533,45,23,0,4149,201,217,11,5179
"06081601502",660,455,109,20,3717,609,1348,364,7282
"06081601601",1133,103,33,35,1413,108,1140,113,4078
"06081601603",1016,57,65,0,4611,212,489,122,6572
"06081601604",1037,140,88,0,1532,42,443,21,3303
"06081601605",597,82,301,0,4915,376,564,31,6866
"06081601700",1614,137,24,19,2745,80,1579,34,6232
"06081601800",3125,299,94,18,2602,150,1926,173,8387
"06081601901",2031,114,71,0,2136,25,1477,43,5897
"06081601902",1845,103,85,0,2837,396,1278,210,6754
"06081602000",2713,16,55,0,4986,348,2313,332,10763
"06081602100",1190,132,91,0,1495,195,1706,295,5104
"06081602200",3147,302,266,42,3425,564,4855,280,12881
"06081602300",1513,295,120,0,1832,112,1612,293,5777
"06081602400",3303,152,184,12,3569,313,1530,113,9176
"06081602500",1146,80,264,0,3956,116,699,17,6278
"06081602600",1246,326,144,18,6453,298,790,509,9784
"06081602700",2038,144,276,71,2995,261,937,177,6899
"06081602800",1464,59,257,7,2492,71,611,17,4978
"06081602900",2209,113,92,0,1200,95,567,134,4410
"06081603000",3282,194,43,8,959,63,782,40,5371
"06081603100",2404,68,35,0,800,213,300,213,4033
"06081603200",2863,234,53,0,663,0,551,0,4364
"06081603300",4794,275,48,0,1618,25,1052,152,7964
"06081603400",4212,94,70,19,1311,70,1265,46,7087
"06081603700",2120,24,67,0,3105,196,1011,7,6530
"06081603801",875,107,0,0,1024,105,334,86,2531
"06081603802",2733,199,89,0,1735,25,1012,0,5793
"06081603900",3381,44,125,22,1730,93,1574,12,6981
"06081604000",1913,184,58,0,1003,79,511,84,3832
"06081604101",3330,630,130,20,3865,109,3325,537,11946
"06081604102",1184,47,86,20,1290,145,497,8,3277
"06081604200",2376,200,23,0,1579,68,2378,182,6806
"06081604400",1728,192,21,1,2693,153,1080,70,5938
"06081604500",1777,167,82,0,1304,105,317,37,3789
"06081604600",1190,33,0,0,1413,25,221,0,2882
"06081604700",1333,34,10,3,1201,77,278,9,2945
"06081604800",2531,88,86,1,2291,175,995,25,6192
"06081604900",1392,71,12,0,1567,117,159,25,3343
"06081605000",4801,140,75,30,3046,260,623,62,9037
"06081605100",2167,32,26,0,782,87,352,64,3510
"06081605200",2622,309,61,0,908,42,330,36,4308
"06081605300",3177,251,51,5,1136,49,430,28,5127
"06081605400",3792,147,23,0,1531,286,927,272,6978
"06081605500",3341,162,55,6,1204,69,663,89,5589
"06081605600",3837,50,61,6,1685,64,277,0,5980
"06081605700",3537,43,0,0,1694,171,258,14,5717
"06081605800",1956,67,47,0,617,13,166,30,2896
"06081605900",3782,660,136,35,1354,213,1736,343,8259
"06081606000",3413,119,270,0,1613,90,2143,40,7688
"06081606100",1492,437,50,26,1741,343,1143,429,5661
"06081606200",4005,740,386,0,3345,87,4657,661,13881
"06081606300",2280,221,142,0,1458,49,1266,22,5438
"06081606400",3123,304,43,25,1314,87,645,21,5562
"06081606500",2798,42,16,0,702,1,61,0,3620
"06081606600",2410,83,25,0,1045,58,700,10,4331
"06081606700",1553,55,0,0,732,32,216,0,2588
"06081606800",2115,61,9,2,1257,94,63,14,3615
"06081606900",1467,84,0,2,575,71,83,0,2282
"06081607000",2112,42,6,0,1025,72,312,34,3603
"06081607100",2208,59,48,0,792,35,391,0,3533
"06081607200",2266,175,46,17,1284,151,837,89,4865
"06081607300",2760,50,0,0,724,30,433,0,3997
"06081607400",2426,154,67,13,1595,173,553,36,5017
"06081607500",2138,66,121,30,1412,61,694,38,4560
"06081607600",1945,357,85,18,976,0,676,310,4367
"06081607701",2094,250,46,65,1677,347,1497,217,6193
"06081607702",1441,238,65,9,1192,5,1292,88,4330
"06081607800",1624,145,37,0,1216,48,640,115,3825
"06081607900",1727,65,52,0,1308,84,219,34,3489
"06081608001",1459,42,9,0,2011,66,265,18,3870
"06081608002",1650,13,39,0,1704,8,144,0,3558
"06081608004",2818,228,315,0,3060,93,296,0,6810
"06081608013",2073,33,19,0,1776,459,165,2,4527
"06081608023",1134,49,10,0,1401,32,74,5,2705
"06081608100",1691,20,105,40,1996,15,304,5,4176
"06081608200",1597,56,21,0,2043,18,190,30,3955
"06081608300",1486,43,31,19,1962,8,243,3,3795
"06081608400",3078,174,55,0,2107,41,1190,16,6661
"06081608501",3359,290,25,0,1193,128,1192,93,6280
"06081608502",1707,37,56,0,817,24,805,0,3446
"06081608600",2130,279,116,9,1700,272,756,228,5490
"06081608700",4453,232,57,38,1811,93,667,0,7351
"06081608800",4277,38,98,0,1508,18,386,0,6325
"06081608900",3928,126,198,16,2107,315,891,40,7621
"06081609000",1490,56,93,0,891,17,313,13,2873
"06081609100",1016,81,7,18,525,69,450,64,2230
"06081609201",2924,45,0,20,618,12,363,14,3996
"06081609202",2592,130,78,16,864,295,483,285,4743
"06081609300",2832,58,37,0,477,18,333,0,3755
"06081609400",3066,140,21,12,299,0,203,22,3763
"06081609500",4117,8,0,0,847,0,505,0,5477
"06081609601",1893,190,66,0,625,43,142,33,2992
"06081609602",1145,33,4,0,396,27,107,0,1712
"06081609603",4016,189,6,19,973,9,408,18,5638
"06081609700",3597,102,25,4,661,8,308,0,4705
"06081609800",3701,114,22,12,697,21,777,13,5357
"06081609900",2457,57,2,0,524,3,383,13,3439
"06081610000",3524,71,65,8,813,33,1005,25,5544
"06081610100",1763,106,14,0,561,19,1201,109,3773
"06081610201",2670,1090,185,0,1650,165,3538,1098,10396
"06081610202",757,124,22,10,279,79,475,118,1864
"06081610203",1355,556,79,34,1175,136,2139,631,6105
"06081610302",1338,110,39,10,533,127,856,116,3129
"06081610303",3851,114,109,0,3459,39,486,23,8081
"06081610304",2018,110,133,9,1679,63,356,75,4443
"06081610400",3280,431,86,265,1811,282,3679,617,10451
"06081610500",2771,612,45,34,916,753,2762,991,8884
"06081610601",3095,1143,21,0,1483,746,3707,1786,11981
"06081610602",2654,315,31,0,470,70,1333,269,5142
"06081610700",3461,279,50,2,1170,24,1840,2,6828
"06081610800",3027,371,65,0,1364,264,3060,503,8654
"06081610900",5143,458,77,7,1781,647,3867,829,12809
"06081611000",4380,172,202,14,966,11,2059,41,7845
"06081611100",4986,68,17,0,1343,94,932,107,7547
"06081611200",2466,107,0,0,413,24,731,28,3769
"06081611300",3675,90,11,2,958,40,848,22,5646
"06081611400",3405,140,0,0,494,12,81,27,4159
"06081611500",1996,100,0,0,478,6,91,6,2677
"06081611600",1701,77,79,33,383,41,144,0,2458
"06081611700",1981,218,1059,171,1593,311,2879,367,8579
"06081611800",1254,313,924,88,1391,170,1877,401,6418
"06081611900",3873,658,1101,213,3880,499,4748,870,15842
"06081612000",3012,514,757,289,2802,268,4757,606,13005
"06081612100",3294,1167,547,168,2043,471,3215,1293,12198
"06081612500",3524,195,11,0,826,7,219,15,4797
"06081612600",3103,113,54,0,940,77,138,0,4425
"06081612700",1815,53,0,0,140,16,69,0,2093
"06081612800",2730,124,0,5,352,0,227,86,3524
"06081612900",3565,122,25,1,776,56,168,38,4751
"06081613000",2663,109,0,21,569,24,148,2,3536
"06081613200",5692,139,0,0,813,64,178,6,6892
"06081613300",2084,120,20,0,343,0,88,0,2655
"06081613400",2942,71,0,0,231,41,169,41,3495
"06081613501",3047,83,281,31,764,68,1361,58,5693
"06081613502",4856,309,0,0,555,19,815,67,6621
"06081613600",4837,115,0,3,1115,134,1451,134,7789
"06081613700",6650,182,0,21,1677,169,2631,173,11503
"06081613800",3199,471,5,0,209,55,603,365,4907
"06081613900",4068,367,163,21,1414,75,608,148,6864
"06081614000",1770,188,348,0,3197,288,785,256,6832
"06081984300",0,0,0,0,0,0,0,0,0
"06081990100",0,0,0,0,0,0,0,0,0
"06083000101",4063,412,103,42,872,60,1318,310,7180
"06083000102",3832,338,0,2,1061,165,1340,152,6890
"06083000103",2624,229,10,0,186,38,316,33,3436
"06083000200",2952,191,0,0,484,178,649,250,4704
"06083000301",1710,226,33,20,521,745,755,797,4807
"06083000302",2326,526,56,12,961,71,1408,391,5751
"06083000400",3590,133,10,0,235,374,268,341,4951
"06083000501",2976,235,51,0,211,10,203,32,3718
"06083000502",4840,431,61,35,325,48,539,0,6279
"06083000600",3521,168,45,0,609,49,825,15,5232
"06083000700",3580,391,87,0,827,233,1015,300,6433
"06083000801",1952,499,18,0,1867,398,3212,692,8638
"06083000804",3868,820,121,32,1672,777,4108,1149,12547
"06083000900",1813,549,42,28,597,245,979,359,4612
"06083001000",3442,748,151,30,997,217,2029,554,8168
"06083001101",2972,888,0,0,523,274,1758,949,7364
"06083001102",2686,716,48,0,1312,565,2953,890,9170
"06083001203",2280,261,0,0,626,125,630,66,3988
"06083001206",2880,295,0,1,1763,336,3251,421,8947
"06083001208",3196,423,16,1,452,197,476,64,4825
"06083001304",5638,307,68,46,1247,88,1634,136,9164
"06083001306",2767,66,70,7,403,8,465,0,3786
"06083001402",3012,218,34,1,146,3,113,29,3556
"06083001500",2913,205,0,7,144,0,175,0,3444
"06083001601",3659,318,0,0,981,126,1779,240,7103
"06083001604",3834,402,0,0,711,104,1888,151,7090
"06083001704",2257,169,27,0,656,0,1780,77,4966
"06083001706",3309,157,82,7,784,86,901,41,5367
"06083001800",717,192,0,0,73,89,363,183,1617
"06083001901",5029,449,104,20,1062,298,1805,391,9158
"06083001903",4433,466,0,0,700,285,1127,553,7564
"06083001905",2242,173,4,60,104,29,400,33,3045
"06083001906",4953,284,0,61,785,166,881,146,7276
"06083002005",4221,380,57,12,661,46,878,107,6362
"06083002006",1807,155,0,0,309,18,354,36,2679
"06083002007",7563,655,304,36,1342,0,2804,381,13085
"06083002008",4743,420,209,6,1066,0,1770,160,8374
"06083002009",3237,292,0,0,488,17,1081,51,5166
"06083002010",3621,144,128,0,549,90,840,78,5450
"06083002011",3387,244,56,18,1198,64,2643,167,7777
"06083002012",2703,261,9,0,146,1,382,1,3503
"06083002013",2417,62,0,0,250,40,442,12,3223
"06083002101",1829,1051,18,11,494,312,1411,1013,6139
"06083002102",1774,114,7,4,640,32,1345,95,4011
"06083002103",2027,722,59,0,888,400,1988,787,6871
"06083002205",2515,770,59,12,1617,237,2682,882,8774
"06083002206",2590,667,31,49,927,344,2508,889,8005
"06083002209",1935,443,23,35,711,243,1915,608,5913
"06083002210",3256,286,178,31,1492,292,2542,275,8352
"06083002211",3627,338,96,67,1519,27,2372,318,8364
"06083002303",3770,670,0,8,1269,262,4426,857,11262
"06083002304",2812,889,0,0,1635,655,3989,1485,11465
"06083002305",4255,1283,232,14,1021,523,4879,1604,13811
"06083002306",5470,418,127,0,2017,257,5035,418,13742
"06083002402",6231,2969,276,8,2559,696,6160,3185,22084
"06083002403",2793,1823,61,43,1411,722,4049,2432,13334
"06083002404",4214,1784,8,79,1548,1106,5204,2720,16663
"06083002502",4287,1004,14,46,1537,479,4965,1279,13611
"06083002604",74,0,12,0,22,0,0,0,108
"06083002606",2005,79,255,8,541,179,569,164,3800
"06083002702",3093,1625,143,94,2473,547,4364,1744,14083
"06083002703",1970,703,236,0,744,395,1458,540,6046
"06083002705",1968,641,119,22,772,582,1541,891,6536
"06083002706",2939,1311,82,256,1133,726,3068,1830,11345
"06083002707",1496,272,69,4,393,74,701,203,3212
"06083002708",1941,174,0,0,297,94,776,51,3333
"06083002802",4059,458,281,0,1734,452,1737,668,9389
"06083002806",1498,146,53,14,452,16,708,61,2948
"06083002808",5574,201,156,23,980,193,1396,166,8689
"06083002809",2946,265,388,9,1135,79,1017,184,6023
"06083002906",3126,202,71,0,462,15,628,46,4550
"06083002907",3383,128,0,0,807,65,941,58,5382
"06083002909",4137,229,18,0,1260,73,2455,113,8285
"06083002913",2820,103,18,0,685,12,505,8,4151
"06083002914",2183,46,2,0,800,39,560,0,3630
"06083002915",177,35,0,0,202,76,69,32,591
"06083002922",1113,206,63,3,876,42,562,43,2908
"06083002924",1236,2762,1,36,150,1021,341,794,6341
"06083002926",1461,2525,50,145,445,1257,670,1077,7630
"06083002928",865,2865,57,26,262,813,306,476,5670
"06083002930",3566,557,28,2,2342,420,2470,269,9654
"06083002932",1346,138,17,8,622,96,604,72,2903
"06083003001",3401,149,25,1,1558,405,3343,378,9260
"06083003004",3893,110,154,11,775,11,1264,11,6229
"06083003005",3223,258,97,13,1737,101,1842,46,7317
"06083003007",2872,150,0,0,328,110,278,15,3753
"06083003102",2411,106,198,0,547,71,1005,98,4436
"06083980000",8,0,0,0,0,0,0,0,8
"06083980100",0,0,0,0,0,0,0,0,0
"06083990000",0,0,0,0,0,0,0,0,0
"06085500100",2396,436,113,0,3061,875,3096,996,10973
"06085500200",2440,366,21,81,1554,389,1270,243,6364
"06085500300",1779,443,115,84,925,147,1066,144,4703
"06085500400",1394,101,38,0,610,248,900,195,3486
"06085500500",3223,278,51,0,1666,120,988,131,6457
"06085500600",2911,104,125,0,1434,173,1342,87,6176
"06085500800",1603,232,336,37,900,193,767,117,4185
"06085500901",1198,470,194,171,1396,525,436,444,4834
"06085500902",248,209,31,87,466,570,292,225,2128
"06085501000",1492,427,47,114,1913,424,1931,465,6813
"06085501101",1373,612,158,89,2064,135,1347,648,6426
"06085501102",2387,407,15,15,1906,138,2617,384,7869
"06085501200",1580,503,124,30,1875,386,2081,622,7201
"06085501300",1843,465,151,61,810,678,901,266,5175
"06085501401",1425,324,71,5,994,515,1869,696,5899
"06085501402",1151,291,29,11,1361,251,1816,460,5370
"06085501501",1546,492,60,0,1963,565,2213,863,7702
"06085501502",1517,547,0,60,1590,449,2075,812,7050
"06085501600",2103,911,504,422,1461,952,1587,1007,8947
"06085501700",2143,714,43,0,1632,383,3051,889,8855
"06085501800",2065,200,24,0,2506,291,2272,369,7727
"06085501900",2119,374,396,3,2441,390,1199,500,7422
"06085502001",2671,430,273,1,2132,370,2486,525,8888
"06085502002",1533,599,28,86,2415,850,2815,1270,9596
"06085502101",3270,318,29,10,1304,173,1036,140,6280
"06085502102",3241,653,431,150,2217,698,3090,1003,11483
"06085502201",2597,464,465,124,2691,746,2300,574,9961
"06085502202",2028,119,43,0,867,73,466,84,3680
"06085502301",2492,120,131,4,474,69,423,40,3753
"06085502302",2465,81,17,0,489,100,1138,48,4338
"06085502400",5038,183,391,6,1228,169,1548,29,8592
"06085502500",4743,180,54,15,1328,60,1062,102,7544
"06085502601",2117,156,0,0,582,8,327,50,3240
"06085502603",1808,26,30,0,552,22,364,13,2815
"06085502604",2696,393,267,0,727,14,759,127,4983
"06085502701",2829,382,178,5,1107,80,771,150,5502
"06085502702",4679,576,163,16,1904,101,881,31,8351
"06085502800",3151,163,0,0,986,58,769,85,5212
"06085502901",4607,134,47,0,1824,33,1478,76,8199
"06085502902",4877,402,23,7,1931,34,1413,169,8856
"06085502903",3962,147,260,2,750,39,767,63,5990
"06085502906",2517,195,290,0,1132,143,836,19,5132
"06085502907",2645,112,62,0,864,105,594,42,4424
"06085502908",4439,393,175,0,1670,52,701,330,7760
"06085502909",3640,314,103,8,1189,172,1624,248,7298
"06085502910",2158,92,55,0,1087,34,713,34,4173
"06085503001",3253,194,28,19,643,77,404,125,4743
"06085503002",2658,144,25,0,706,23,894,22,4472
"06085503003",3720,182,169,0,1428,52,1149,5,6705
"06085503105",411,36,10,0,1294,674,452,77,2954
"06085503108",2796,507,178,94,4241,87,2303,491,10697
"06085503110",1213,604,29,31,2192,858,2063,873,7863
"06085503111",1326,274,37,110,3185,373,1630,445,7380
"06085503112",1095,376,107,66,1884,222,1476,407,5633
"06085503113",1752,609,153,92,1592,844,2703,1440,9185
"06085503115",3325,86,79,0,2437,119,1361,20,7427
"06085503116",2192,209,140,0,2290,139,673,89,5732
"06085503117",508,160,84,0,1691,987,1473,227,5130
"06085503118",1674,115,204,12,2673,898,2360,591,8527
"06085503121",1738,337,128,185,1587,460,1979,233,6647
"06085503122",381,172,48,219,1622,360,641,208,3651
"06085503123",1406,206,316,79,1508,365,1638,300,5818
"06085503204",2856,343,126,244,3969,512,3688,445,12183
"06085503207",922,85,76,51,2775,251,782,108,5050
"06085503208",1953,344,26,9,1681,137,2030,372,6552
"06085503210",1453,102,62,24,2096,526,1560,415,6238
"06085503211",1749,429,100,7,2819,223,1650,412,7389
"06085503212",1126,128,80,0,2693,181,1279,93,5580
"06085503213",873,446,0,0,2773,214,1025,348,5679
"06085503214",1927,1096,68,24,3631,1397,2577,1565,12285
"06085503217",1245,560,118,0,2152,356,2023,635,7089
"06085503218",2476,542,71,0,1368,206,3008,670,8341
"06085503304",1608,518,193,71,3376,671,2074,776,9287
"06085503305",1958,75,116,11,3904,678,2912,289,9943
"06085503306",1798,53,60,4,2096,275,2515,152,6953
"06085503312",1597,68,417,0,1557,41,1296,55,5031
"06085503313",1220,20,76,0,2723,167,772,0,4978
"06085503315",1286,393,441,30,5157,711,2404,421,10843
"06085503321",418,159,87,0,3959,150,393,150,5316
"06085503322",870,29,196,80,2418,428,969,256,5246
"06085503323",922,91,143,0,3112,382,1353,201,6204
"06085503324",511,42,21,0,2799,100,485,26,3984
"06085503325",1110,89,73,2,3285,269,1112,192,6132
"06085503326",1062,65,175,0,5592,334,802,231,8261
"06085503327",1501,179,219,112,3049,167,1327,298,6852
"06085503329",733,15,32,8,2556,105,488,57,3994
"06085503330",1060,262,0,2,6675,101,487,241,8828
"06085503331",1863,156,100,7,1339,90,983,10,4548
"06085503332",3856,185,9,0,1368,38,429,0,5885
"06085503333",1624,469,85,0,2185,47,737,290,5437
"06085503334",3009,43,125,0,5660,95,811,25,9768
"06085503336",687,74,19,29,2630,194,1116,94,4843
"06085503337",887,65,73,0,2420,353,926,81,4805
"06085503401",1402,286,150,0,2337,265,2871,517,7828
"06085503402",1680,573,96,103,1991,1020,2689,969,9121
"06085503504",2700,307,47,0,2303,555,3959,635,10506
"06085503506",2318,213,97,15,2690,727,3312,651,10023
"06085503507",855,238,35,24,1037,131,1399,307,4026
"06085503508",2085,263,142,18,3095,1076,3714,982,11375
"06085503509",1149,199,50,0,2297,348,1857,343,6243
"06085503510",1465,263,115,130,2751,1156,2780,1288,9948
"06085503511",571,161,35,0,2658,425,1004,446,5300
"06085503601",1080,323,18,0,1111,380,1269,453,4634
"06085503602",1598,559,218,35,2166,614,2487,783,8460
"06085503703",1203,390,244,0,1570,673,2040,844,6964
"06085503707",996,478,208,31,3256,485,1776,739,7969
"06085503708",253,144,77,14,1743,295,428,117,3071
"06085503709",770,341,55,11,2869,1703,1288,850,7887
"06085503710",642,425,21,0,2186,585,1665,902,6426
"06085503711",1833,422,154,10,1887,564,2909,826,8605
"06085503712",906,153,136,18,1966,501,1233,348,5261
"06085503713",696,161,0,0,1534,539,1183,382,4495
"06085503802",2276,150,257,13,4948,86,3007,71,10808
"06085503803",981,63,39,76,3321,217,846,45,5588
"06085503804",1784,280,113,26,3035,335,1811,434,7818
"06085503902",1323,288,139,27,3264,942,3275,815,10073
"06085503903",945,74,17,0,2411,304,1917,220,5888
"06085504001",2162,118,133,27,3073,416,3902,440,10271
"06085504002",1318,460,97,50,3656,524,2791,690,9586
"06085504101",1175,492,26,80,2143,666,2148,759,7489
"06085504102",1888,110,93,9,3373,449,3695,372,9989
"06085504201",2615,101,82,22,2259,119,1849,86,7133
"06085504202",3020,139,43,2,1488,47,1686,7,6432
"06085504307",1126,202,176,16,3608,524,373,135,6160
"06085504308",1495,82,59,0,2560,256,712,40,5204
"06085504311",886,66,55,0,5804,474,492,0,7777
"06085504314",846,11,156,31,2906,722,680,281,5633
"06085504315",1220,50,448,26,4767,210,970,0,7691
"06085504316",917,59,115,0,3832,311,881,18,6133
"06085504317",841,51,146,0,3399,200,352,150,5139
"06085504318",659,296,33,31,3491,539,1284,383,6716
"06085504319",1390,99,106,32,5694,372,1298,72,9063
"06085504320",656,17,26,0,2071,191,319,50,3330
"06085504321",808,44,62,0,4201,291,822,181,6409
"06085504322",1000,0,119,106,3754,277,455,0,5711
"06085504323",587,121,12,0,5067,513,888,385,7573
"06085504410",838,167,100,17,3445,297,874,139,5877
"06085504411",1465,66,10,0,3784,401,762,59,6547
"06085504412",972,144,124,0,3752,222,892,155,6261
"06085504413",250,6,29,0,1385,106,79,0,1855
"06085504414",733,52,140,0,4602,236,191,12,5966
"06085504415",981,40,34,11,4028,99,585,18,5796
"06085504416",661,37,36,8,2683,126,429,107,4087
"06085504417",161,103,0,0,84,0,9,97,454
"06085504418",641,174,53,18,3647,815,1315,450,7113
"06085504420",955,67,75,0,3453,260,534,11,5355
"06085504421",819,90,65,0,3398,249,710,60,5391
"06085504422",920,68,116,8,2464,269,734,51,4630
"06085504423",700,40,177,0,1515,125,459,68,3084
"06085504504",892,199,37,9,6285,225,399,155,8201
"06085504505",891,84,63,23,3863,244,863,125,6156
"06085504506",954,65,133,0,4209,345,555,55,6316
"06085504507",1075,78,141,26,4044,368,1020,219,6971
"06085504601",618,21,33,4,148,23,316,23,1186
"06085504602",949,104,0,23,653,106,853,192,2880
"06085504700",383,43,192,0,51,0,143,0,812
"06085504802",2061,202,22,0,2966,170,1145,197,6763
"06085504803",1770,184,225,0,3366,248,584,79,6456
"06085504805",3873,634,70,34,1665,62,894,248,7480
"06085504806",1153,79,22,72,1341,82,655,61,3465
"06085504901",1973,96,162,164,7010,406,485,43,10339
"06085505001",2963,104,503,23,5763,501,1203,318,11378
"06085505006",1198,39,44,0,2808,93,255,0,4437
"06085505007",1459,58,205,132,1864,84,701,28,4531
"06085505008",1404,256,83,0,3371,233,295,96,5738
"06085505009",2370,227,625,0,3652,390,2192,172,9628
"06085505100",966,324,62,0,1369,341,628,275,3965
"06085505202",2733,631,181,1,2881,287,2442,688,9844
"06085505203",1358,551,216,0,1097,257,677,183,4339
"06085505301",1745,353,314,1,1949,241,869,300,5772
"06085505302",2245,95,83,1,1385,95,819,52,4775
"06085505303",2922,357,306,0,2569,167,1973,309,8603
"06085505304",1547,39,0,0,1512,39,752,1,3890
"06085505305",2742,72,98,0,2769,496,854,135,7166
"06085505401",1329,300,174,0,4347,60,475,0,6685
"06085505402",1045,132,5,0,1570,99,559,44,3454
"06085505403",2265,254,206,1,3087,88,1185,141,7227
"06085505500",2203,114,109,68,1479,78,878,92,5021
"06085505600",1335,634,105,67,528,338,474,137,3618
"06085505700",3431,768,16,157,1693,412,1295,185,7957
"06085505800",2600,113,9,98,722,248,651,171,4612
"06085505900",4365,272,275,146,2001,176,1290,278,8803
"06085506000",2573,115,112,0,1376,52,828,6,5062
"06085506101",2475,134,333,4,1718,61,709,26,5460
"06085506102",2054,52,22,0,1383,225,447,0,4183
"06085506103",2032,102,24,35,2388,226,378,42,5227
"06085506202",2840,97,200,0,3684,119,714,43,7697
"06085506203",980,193,59,0,4913,357,873,37,7412
"06085506204",2468,111,63,39,2905,206,644,12,6448
"06085506301",2718,156,354,84,1823,404,656,267,6462
"06085506302",3504,323,274,12,2050,90,1041,38,7332
"06085506304",2679,424,150,0,2166,278,1379,254,7330
"06085506305",4077,475,412,0,2200,402,3055,358,10979
"06085506401",2399,113,280,0,1771,204,1350,95,6212
"06085506402",3030,448,487,34,1536,562,1024,797,7918
"06085506501",3574,1335,261,179,2377,474,3109,1368,12677
"06085506502",3191,170,281,2,592,22,462,29,4749
"06085506503",3778,282,62,10,1515,341,1375,219,7582
"06085506601",2319,461,75,102,1558,226,803,374,5918
"06085506603",2564,130,17,0,1366,163,573,124,4937
"06085506604",4139,175,23,0,3026,0,645,40,8048
"06085506605",1831,89,61,0,1921,129,1128,32,5191
"06085506606",2346,138,18,0,1517,79,901,32,5031
"06085506701",2456,87,0,0,925,43,449,34,3994
"06085506702",3899,233,75,0,1875,96,1539,80,7797
"06085506703",2459,159,90,18,889,62,356,116,4149
"06085506801",4624,166,153,0,977,53,408,20,6401
"06085506802",3467,142,88,2,1210,39,539,1,5488
"06085506803",4430,149,222,141,2291,73,734,17,8057
"06085506804",2729,55,0,0,829,36,246,0,3895
"06085506900",5867,116,16,0,1233,19,391,19,7661
"06085507001",5848,272,17,7,570,61,261,6,7042
"06085507002",2260,184,53,19,462,7,148,0,3133
"06085507100",2093,222,34,52,281,61,121,39,2903
"06085507203",2199,48,0,0,825,23,86,0,3181
"06085507205",3813,134,0,0,658,0,141,0,4746
"06085507206",2379,46,22,0,408,50,110,6,3021
"06085507301",3545,154,22,0,3228,42,290,20,7301
"06085507302",1611,195,0,0,855,13,132,35,2841
"06085507401",2184,61,36,1,3149,43,52,16,5542
"06085507402",2264,252,14,0,1482,0,149,105,4266
"06085507500",2087,90,0,0,3523,0,44,0,5744
"06085507600",2936,144,53,0,2525,148,152,29,5987
"06085507701",1254,26,0,0,2553,80,156,13,4082
"06085507702",2126,18,0,0,4727,78,181,0,7130
"06085507703",2777,189,0,0,4652,113,65,0,7796
"06085507805",2097,152,122,67,3368,173,377,98,6454
"06085507806",928,72,75,0,4338,108,59,20,5600
"06085507807",632,50,0,0,2293,97,21,0,3093
"06085507808",1342,46,34,0,4061,208,58,0,5749
"06085507903",1251,35,41,0,3544,227,165,64,5327
"06085507904",870,18,67,0,2428,0,53,9,3445
"06085507905",1124,54,25,0,4820,444,314,0,6781
"06085507906",1057,141,0,2,3349,128,105,2,4784
"06085508001",2502,263,15,0,5194,76,731,0,8781
"06085508003",791,89,0,0,1229,233,90,62,2494
"06085508004",2038,65,47,0,4011,132,676,0,6969
"06085508101",1980,45,0,0,4480,79,149,0,6733
"06085508102",797,53,0,0,2425,67,52,0,3394
"06085508202",3171,116,146,6,3782,211,752,185,8369
"06085508203",1968,128,51,1,2851,101,268,28,5396
"06085508204",1611,36,7,0,2400,174,375,1,4604
"06085508301",2369,65,14,0,1645,58,170,9,4330
"06085508303",1429,61,11,0,990,19,42,2,2554
"06085508304",2983,196,144,101,3875,766,669,48,8782
"06085508401",3756,103,1,0,3017,59,1002,19,7957
"06085508403",1622,18,19,0,1243,23,159,10,3094
"06085508404",3476,83,0,0,2548,55,557,63,6782
"06085508503",2085,200,60,0,3946,201,406,113,7011
"06085508504",2141,712,199,21,4414,491,932,662,9572
"06085508505",2050,17,39,0,2101,55,427,0,4689
"06085508507",723,72,76,0,1985,194,275,9,3334
"06085508508",2267,254,127,0,2490,332,911,105,6486
"06085508601",1762,189,80,9,1465,155,524,273,4457
"06085508602",3182,82,137,0,1239,111,982,2,5735
"06085508703",2451,330,145,11,4543,170,919,25,8594
"06085508704",2194,183,134,39,2641,285,994,142,6612
"06085508800",1557,725,87,21,1675,150,1070,741,6026
"06085508900",1926,428,90,0,2733,728,1845,463,8213
"06085509000",4771,478,190,152,2610,98,3689,460,12448
"06085509102",1656,36,157,0,3032,19,468,0,5368
"06085509105",3496,341,359,0,2714,302,1541,400,9153
"06085509106",1954,135,128,11,2047,77,874,93,5319
"06085509107",2280,207,34,26,2000,264,800,122,5733
"06085509108",2950,172,18,15,1465,77,1344,112,6153
"06085509109",2395,87,8,0,1836,19,504,0,4849
"06085509201",2701,115,54,0,1489,164,594,15,5132
"06085509202",2537,105,32,21,1899,114,839,28,5575
"06085509302",2367,85,60,0,616,106,497,71,3802
"06085509303",1775,313,90,14,1117,194,569,111,4183
"06085509304",1284,110,72,0,1574,31,604,29,3704
"06085509401",1466,78,29,54,1531,132,181,41,3512
"06085509403",2412,538,145,67,1359,95,1417,350,6383
"06085509404",2317,582,133,0,3066,398,1757,198,8451
"06085509500",2583,847,101,0,1700,75,1094,589,6989
"06085509600",2006,41,0,7,603,37,339,7,3040
"06085509700",1741,191,45,0,986,30,454,118,3565
"06085509801",3753,47,119,3,1759,33,761,0,6475
"06085509802",1663,175,117,0,858,15,390,145,3363
"06085509901",1376,15,3,0,422,43,26,20,1905
"06085509902",3144,356,12,5,1430,99,467,4,5517
"06085510001",4203,85,15,0,1612,12,259,4,6190
"06085510002",2390,165,0,9,1189,41,107,9,3910
"06085510100",2195,36,0,0,940,0,108,0,3279
"06085510200",3026,40,152,0,1092,9,134,0,4453
"06085510300",3085,87,0,0,1082,12,48,1,4315
"06085510400",2057,69,0,0,1119,9,200,15,3469
"06085510500",3133,89,0,1,1417,12,197,0,4849
"06085510600",3553,176,0,0,2663,0,1202,0,7594
"06085510700",2195,199,212,0,2290,167,388,82,5533
"06085510801",2990,62,8,0,2572,14,216,3,5865
"06085510802",1289,30,22,1,630,0,125,0,2097
"06085510803",1321,55,26,0,1102,59,162,0,2725
"06085510900",2742,230,35,0,2366,66,383,0,5822
"06085511000",3550,249,175,6,2797,80,559,1,7417
"06085511100",3350,190,33,4,1813,182,364,2,5938
"06085511200",3837,29,70,1,1206,45,165,13,5366
"06085511301",2475,317,64,0,793,9,207,86,3951
"06085511302",2557,237,6,0,844,284,242,17,4187
"06085511400",2497,101,82,0,701,27,191,39,3638
"06085511500",4775,111,161,21,1486,224,478,0,7256
"06085511608",40,9,0,0,44,14,0,4,111
"06085511609",2005,164,95,0,835,40,77,81,3297
"06085511701",2914,3,0,1,1220,46,129,1,4314
"06085511702",2125,56,5,0,781,75,68,0,3110
"06085511704",2879,240,0,0,1512,48,100,0,4779
"06085511705",551,24,0,0,249,0,49,0,873
"06085511707",2128,32,0,0,492,143,363,20,3178
"06085511800",3753,229,11,11,503,47,140,10,4704
"06085511905",1655,103,37,0,1037,90,224,51,3197
"06085511907",2544,0,42,0,1520,9,473,0,4588
"06085511909",4438,80,0,0,3887,92,507,21,9025
"06085511910",2359,58,12,0,798,0,74,8,3309
"06085511911",3318,132,243,0,1228,8,436,39,5404
"06085511912",2630,41,23,10,2568,35,178,1,5486
"06085511913",3120,71,0,0,1160,0,576,11,4938
"06085511914",3946,148,8,0,1642,35,583,47,6409
"06085511915",1428,325,80,183,1291,309,1216,329,5161
"06085511916",2846,119,38,64,1332,124,637,8,5168
"06085512001",3263,70,166,19,3298,84,1660,2,8562
"06085512005",3679,367,217,0,1971,353,1303,612,8502
"06085512017",3384,1005,141,126,3641,550,3602,820,13269
"06085512019",2109,117,139,0,2047,166,1409,87,6074
"06085512020",2684,137,194,112,3337,431,2060,305,9260
"06085512021",2904,183,194,0,2518,323,842,117,7081
"06085512022",3235,98,236,39,2095,214,2707,118,8742
"06085512023",2954,181,381,107,1921,360,2660,272,8836
"06085512024",2444,54,144,51,1533,120,979,13,5338
"06085512025",1940,127,102,0,1100,4,789,13,4075
"06085512026",2072,32,124,55,1403,265,1273,88,5312
"06085512027",2527,213,99,29,1283,146,1207,136,5640
"06085512029",4111,106,171,0,2302,44,1761,48,8543
"06085512030",1900,54,63,0,845,63,556,61,3542
"06085512031",2788,198,51,0,1193,15,888,149,5282
"06085512032",1989,216,107,0,1009,177,1218,254,4970
"06085512033",3526,507,214,137,2049,30,1892,420,8775
"06085512034",1779,39,14,0,1214,37,966,0,4049
"06085512035",2517,285,74,0,1256,32,1326,196,5686
"06085512036",2325,266,228,0,2175,48,1064,149,6255
"06085512037",1800,63,40,3,1144,51,616,28,3745
"06085512038",1460,96,213,33,1022,16,817,48,3705
"06085512039",2081,61,136,19,2205,238,1289,153,6182
"06085512042",709,211,86,38,1619,134,652,210,3659
"06085512043",2451,984,716,0,2224,383,3371,967,11096
"06085512045",3576,143,142,0,1692,6,1484,48,7091
"06085512047",3457,376,59,0,1563,148,1508,173,7284
"06085512052",2424,205,60,0,1298,84,775,91,4937
"06085512053",2730,193,325,0,1405,273,1587,272,6785
"06085512100",854,190,0,0,523,96,706,253,2622
"06085512200",3421,228,45,0,681,0,1014,10,5399
"06085512305",2709,119,101,0,1059,28,859,17,4892
"06085512307",4746,354,39,0,1304,1,1353,151,7948
"06085512308",4871,191,46,183,2140,209,1882,21,9543
"06085512309",3901,12,98,11,884,387,1027,345,6665
"06085512310",1768,569,83,0,1385,127,1374,578,5884
"06085512311",1730,197,120,31,733,66,469,109,3455
"06085512312",1869,33,75,0,929,21,909,17,3853
"06085512313",2089,669,71,143,869,102,1253,688,5884
"06085512314",2830,794,108,117,2170,411,2377,848,9655
"06085512401",3286,196,72,0,1072,209,1951,173,6959
"06085512402",3148,44,185,0,1629,239,1803,70,7118
"06085512503",5908,83,194,2,1386,226,2309,84,10192
"06085512505",5002,834,299,0,1197,157,3769,850,12108
"06085512506",3081,812,128,147,2173,710,3500,1260,11811
"06085512508",5565,757,8,28,1640,396,4055,970,13419
"06085512509",2530,321,34,10,1174,114,2208,388,6779
"06085512510",3984,528,83,24,1564,84,2378,450,9095
"06085512602",1780,247,15,41,423,136,1333,270,4245
"06085512603",1582,788,74,0,908,432,1899,1160,6843
"06085512604",2059,1028,0,0,891,722,2507,1693,8900
"06085513000",1576,667,53,0,1164,603,236,31,4330
"06085513500",684,83,0,8,66,8,115,24,988
"06087100100",1700,96,58,0,224,18,285,40,2421
"06087100200",4364,799,156,164,706,227,1380,211,8007
"06087100300",2236,352,6,16,165,327,83,114,3299
"06087100400",394,135,0,25,328,107,125,68,1182
"06087100500",3639,1760,71,0,553,286,556,97,6962
"06087100600",2664,367,28,0,274,176,456,93,4058
"06087100700",1097,170,46,1,340,47,246,46,1993
"06087100800",3891,1856,149,31,1227,506,1298,912,9870
"06087100900",3402,275,0,0,356,70,796,2,4901
"06087101000",3693,2015,54,65,1081,1167,1235,1342,10652
"06087101100",3897,913,69,0,519,203,740,131,6472
"06087101200",2268,467,27,11,235,167,282,39,3496
"06087110100",4351,808,0,4,2346,84,4704,704,13001
"06087110200",5070,1129,36,0,1550,727,4873,1693,15078
"06087110300",3294,1219,28,7,1398,1447,4455,2538,14386
"06087110400",3841,1450,17,8,2567,358,4888,1746,14875
"06087110501",3805,636,0,0,1290,733,3790,1182,11436
"06087110502",3860,482,0,0,1519,353,4444,794,11452
"06087110600",5235,388,0,0,1217,574,5347,824,13585
"06087110700",1431,318,50,0,945,676,1663,809,5892
"06087120200",3256,390,17,0,228,258,335,279,4763
"06087120301",4902,227,0,0,369,1,272,15,5786
"06087120302",2146,246,0,0,286,29,328,33,3068
"06087120400",4094,623,16,0,268,41,291,0,5333
"06087120500",4627,275,23,0,437,15,207,1,5585
"06087120600",3921,405,0,0,257,20,334,71,5008
"06087120700",3591,145,0,0,247,0,369,0,4352
"06087120800",5069,151,38,0,384,107,404,0,6153
"06087120900",6347,479,60,3,1219,104,711,42,8965
"06087121000",2894,131,0,0,307,11,72,11,3426
"06087121100",2317,340,29,0,372,27,531,172,3788
"06087121200",5243,587,34,0,463,7,430,21,6785
"06087121300",3629,240,0,48,403,168,1045,213,5746
"06087121401",1462,371,47,1,288,103,351,160,2783
"06087121402",2997,843,0,0,692,100,1000,579,6211
"06087121403",2778,402,0,45,275,17,590,147,4254
"06087121500",3849,487,88,0,319,373,639,389,6144
"06087121600",4606,683,183,0,655,226,1192,340,7885
"06087121700",5385,358,8,0,1310,27,2041,13,9142
"06087121800",3569,309,43,15,588,113,727,101,5465
"06087122001",4457,386,0,3,438,60,451,152,5947
"06087122002",3099,158,35,0,316,49,101,9,3767
"06087122003",4525,773,90,0,966,53,1159,106,7672
"06087122100",2548,277,9,0,464,75,672,122,4167
"06087122201",5436,671,61,0,337,187,748,412,7852
"06087122202",2039,172,12,0,257,23,333,15,2851
"06087122203",2963,134,41,0,185,34,152,9,3518
"06087122300",2984,285,22,0,477,7,607,7,4389
"06087122400",5626,435,17,0,1052,37,1912,95,9174
"06087122500",4182,673,74,19,1346,161,4243,807,11505
"06087123100",1575,284,0,0,556,50,1190,268,3923
"06087123300",1056,231,0,2,251,242,741,423,2946
"06087990100",0,0,0,0,0,0,0,0,0
"06089010100",750,272,3,6,45,55,22,28,1181
"06089010200",1563,360,0,0,74,76,67,53,2193
"06089010300",2620,505,82,57,503,211,269,169,4416
"06089010400",2504,1118,0,11,323,110,189,68,4323
"06089010500",2918,826,130,32,757,347,449,109,5568
"06089010601",2354,201,6,16,237,23,65,9,2911
"06089010602",4197,516,48,0,591,149,597,47,6145
"06089010603",1191,76,0,0,185,26,81,1,1560
"06089010702",2950,493,29,0,423,28,194,48,4165
"06089010703",2194,1124,10,0,218,46,141,62,3795
"06089010704",2663,1194,35,1,113,143,208,98,4455
"06089010803",3790,347,149,28,587,253,338,57,5549
"06089010804",1925,215,0,0,68,29,88,9,2334
"06089010805",4167,494,33,80,510,45,209,62,5600
"06089010806",2268,379,0,0,28,149,105,79,3008
"06089010807",3266,283,8,0,263,141,288,56,4305
"06089010900",2361,568,28,13,834,172,259,175,4410
"06089011001",1344,99,1,2,137,18,163,8,1772
"06089011002",4153,605,40,0,307,341,228,208,5882
"06089011100",2263,225,28,2,416,58,149,0,3141
"06089011209",3142,1708,0,0,705,252,271,346,6424
"06089011300",3237,527,31,141,617,444,343,346,5686
"06089011401",3167,409,16,0,281,97,268,46,4284
"06089011402",2600,108,50,19,462,0,344,0,3583
"06089011403",2223,234,0,0,270,0,375,8,3110
"06089011500",4340,618,0,0,629,53,126,97,5863
"06089011600",2537,639,0,0,316,158,179,149,3978
"06089011701",1971,331,0,0,140,0,260,13,2715
"06089011702",1934,823,0,1,461,176,346,127,3868
"06089011703",2302,496,0,0,286,113,366,30,3593
"06089011801",2023,429,13,1,166,59,84,85,2860
"06089011802",2119,121,0,0,161,24,84,69,2578
"06089011803",2036,474,0,30,97,14,186,85,2922
"06089011900",3802,315,0,70,428,91,163,27,4896
"06089012000",2491,1160,26,37,431,375,585,210,5315
"06089012101",3652,506,0,0,98,123,249,137,4765
"06089012102",1290,405,0,0,101,49,91,0,1936
"06089012200",4238,895,0,21,427,481,676,482,7220
"06089012301",1964,713,24,0,197,46,201,437,3582
"06089012302",4404,822,0,0,311,65,300,58,5960
"06089012303",3206,566,0,36,124,17,20,145,4114
"06089012400",3057,646,20,0,275,64,137,4,4203
"06089012500",882,377,0,0,86,78,51,2,1476
"06089012601",3727,564,27,6,544,78,272,62,5280
"06089012603",2725,329,48,0,588,119,247,12,4068
"06089012604",1881,241,0,1,145,75,85,19,2447
"06089012701",3184,622,0,33,69,132,252,7,4299
"06089012702",2541,366,0,0,181,25,346,129,3588
"06091010000",2384,382,0,2,119,103,164,119,3273
"06093000100",1032,253,0,0,69,56,464,213,2087
"06093000200",1439,281,15,0,107,134,459,161,2596
"06093000300",3274,718,12,0,269,86,213,191,4763
"06093000400",566,143,0,0,55,11,12,14,801
"06093000500",988,393,8,0,374,257,94,87,2201
"06093000600",1415,260,0,0,135,19,143,12,1984
"06093000701",2536,668,1,0,310,110,101,31,3757
"06093000702",1946,1011,2,87,506,432,190,193,4367
"06093000703",1927,815,108,0,390,186,174,234,3834
"06093000800",2260,551,0,0,330,167,163,32,3503
"06093000900",4698,1190,165,59,466,172,692,123,7565
"06093001000",5259,1019,0,0,497,32,308,176,7291
"06093001100",1329,455,60,4,134,36,82,87,2187
"06093001200",1008,302,0,0,89,38,78,73,1588
"06095250103",1251,279,708,196,1657,220,608,223,5142
"06095250104",818,184,294,2,907,56,148,34,2443
"06095250105",863,55,1492,201,4320,220,503,47,7701
"06095250106",1171,118,510,0,2839,393,472,4,5507
"06095250200",1456,417,499,238,524,498,706,399,4737
"06095250300",1397,470,415,478,673,226,716,209,4584
"06095250400",1065,87,232,166,656,45,599,57,2907
"06095250501",1112,201,108,0,480,116,373,60,2450
"06095250502",1552,62,391,211,573,184,721,28,3722
"06095250601",2308,331,1068,294,934,228,1369,142,6674
"06095250604",1275,306,433,69,1579,30,403,0,4095
"06095250605",1675,59,731,0,2112,17,669,3,5266
"06095250701",1238,300,588,203,810,188,1197,343,4867
"06095250801",1522,289,546,196,586,54,505,77,3775
"06095250900",378,212,232,686,253,226,176,236,2399
"06095251000",1278,57,395,251,439,131,469,60,3080
"06095251100",1342,1135,217,31,588,141,980,1067,5501
"06095251200",1451,231,321,341,511,102,1148,294,4399
"06095251300",1764,123,236,75,454,30,677,30,3389
"06095251400",2486,306,781,88,1473,281,939,348,6702
"06095251500",1495,597,575,216,636,156,940,473,5088
"06095251600",1001,365,392,312,300,265,523,248,3406
"06095251701",1262,324,298,107,1059,174,396,209,3829
"06095251702",602,119,545,464,717,224,138,195,3004
"06095251802",740,269,203,360,519,362,285,202,2940
"06095251803",1382,384,447,223,2317,250,1247,307,6557
"06095251804",1071,198,370,219,1941,71,864,183,4917
"06095251901",1794,531,1161,496,1020,184,1528,368,7082
"06095251902",1638,446,1175,354,1895,336,1459,427,7730
"06095251903",1302,149,1209,611,1793,304,1216,346,6930
"06095252000",3345,132,142,111,487,78,559,0,4854
"06095252102",2651,150,239,26,637,19,585,20,4327
"06095252103",1319,132,1137,267,2457,119,423,13,5867
"06095252104",3482,13,279,23,1722,286,701,38,6544
"06095252105",2209,97,134,9,816,10,393,19,3687
"06095252106",2956,264,218,0,953,85,981,37,5494
"06095252107",2446,75,165,0,690,57,435,20,3888
"06095252108",2195,84,235,8,500,49,286,28,3385
"06095252201",4478,15,890,225,3071,53,1429,1,10162
"06095252202",4078,231,941,173,4628,0,1960,220,12231
"06095252305",2894,233,330,0,1452,32,621,157,5719
"06095252306",2220,175,314,49,572,71,667,0,4068
"06095252310",1991,143,176,0,644,9,102,0,3065
"06095252311",2146,32,673,62,1483,0,581,14,4991
"06095252312",1432,384,439,22,808,77,404,267,3833
"06095252313",2464,165,322,46,2222,250,1444,50,6963
"06095252314",1552,169,410,38,1549,139,830,90,4777
"06095252315",1855,105,629,28,1666,42,468,1,4794
"06095252316",1626,63,789,44,849,129,769,99,4368
"06095252317",3031,0,1123,12,3025,35,1242,24,8492
"06095252401",1684,351,381,42,1440,212,1580,376,6066
"06095252402",1532,475,528,248,1698,651,1239,796,7167
"06095252501",797,331,205,46,989,371,827,493,4059
"06095252502",577,227,165,50,366,111,405,136,2037
"06095252604",883,339,657,196,553,330,746,193,3897
"06095252605",1619,582,455,382,2030,686,2035,724,8513
"06095252606",1562,676,676,312,1572,515,1534,577,7424
"06095252607",1353,300,548,182,974,739,1490,689,6275
"06095252608",1327,115,812,155,1291,513,1098,573,5884
"06095252610",1436,58,570,112,932,23,872,0,4003
"06095252611",999,131,544,90,1156,183,855,176,4134
"06095252702",2153,157,980,326,2870,554,1008,368,8416
"06095252703",993,131,911,81,1641,215,818,166,4956
"06095252704",1652,130,1097,120,1709,210,1040,194,6152
"06095252705",1876,301,1042,228,1996,453,793,668,7357
"06095252706",2143,31,443,16,1456,72,1098,72,5331
"06095252707",1677,185,592,615,1628,276,1060,351,6384
"06095252801",1900,204,129,45,624,37,408,36,3383
"06095252802",398,20,35,0,14,0,31,0,498
"06095252903",3694,103,0,0,760,0,671,0,5228
"06095252904",3363,245,381,8,1445,40,1301,22,6805
"06095252908",2396,235,131,10,874,19,613,45,4323
"06095252909",2330,126,137,30,537,22,684,40,3906
"06095252910",3901,332,362,9,1253,71,1141,42,7111
"06095252911",3476,448,97,0,570,0,336,75,5002
"06095252912",3927,138,370,0,1170,218,642,79,6544
"06095252913",3417,75,326,19,1012,10,802,0,5661
"06095252914",3241,182,489,39,1549,379,1062,439,7380
"06095252915",1876,0,657,0,1489,0,690,0,4712
"06095253000",0,0,0,0,0,0,0,0,0
"06095253101",3638,629,206,0,634,108,1205,365,6785
"06095253105",2849,638,449,33,1363,277,1519,242,7370
"06095253106",2117,185,279,14,513,60,807,93,4068
"06095253107",3336,225,212,87,1484,537,1469,437,7787
"06095253108",2418,156,381,44,737,37,615,57,4445
"06095253201",3530,192,196,0,548,42,666,72,5246
"06095253203",2981,340,108,10,567,162,1331,208,5707
"06095253204",3440,868,363,194,1781,120,1972,574,9312
"06095253205",1848,48,45,59,933,689,700,281,4603
"06095253206",2433,63,39,0,523,0,479,0,3537
"06095253300",2002,252,15,15,758,46,1043,229,4360
"06095253402",4300,1101,62,4,1346,22,2323,489,9647
"06095253403",3405,114,172,0,1253,121,1827,103,6995
"06095253404",3880,1002,327,0,1355,208,1807,786,9365
"06095253500",6107,772,460,0,1307,195,1254,123,10218
"06095980000",0,0,0,0,0,0,0,0,0
"06097150100",2126,201,0,0,166,29,330,0,2852
"06097150202",4120,304,0,0,1181,82,1338,54,7079
"06097150203",3959,233,0,0,468,188,723,188,5759
"06097150204",3231,292,0,0,196,13,153,0,3885
"06097150303",3807,225,0,27,272,4,425,4,4764
"06097150304",4400,559,14,0,912,501,2148,739,9273
"06097150305",4149,313,17,13,731,1281,3317,1219,11040
"06097150306",3242,314,2,0,403,255,1035,297,5548
"06097150500",3565,710,41,41,387,73,248,143,5208
"06097150601",2762,361,0,0,921,86,1269,220,5619
"06097150602",3187,205,12,0,504,79,586,187,4760
"06097150603",4928,547,0,0,923,335,1445,326,8504
"06097150607",4271,21,15,0,918,64,474,64,5827
"06097150609",3210,284,7,0,832,25,734,176,5268
"06097150610",3183,161,15,0,614,267,505,202,4947
"06097150611",2436,585,159,0,754,189,735,516,5374
"06097150612",3392,123,0,0,586,12,548,0,4661
"06097150701",2863,495,48,29,1155,234,1109,248,6181
"06097150702",4115,155,31,0,569,0,857,18,5745
"06097150800",3674,223,18,0,448,627,523,460,5973
"06097150901",3389,856,71,3,1094,134,1505,655,7707
"06097150902",2766,304,3,0,231,18,321,87,3730
"06097151000",3070,228,63,0,300,2,540,110,4313
"06097151100",4163,299,37,0,687,68,685,118,6057
"06097151201",4665,492,103,69,1396,223,1523,195,8666
"06097151203",3705,502,39,0,608,120,540,161,5675
"06097151204",2318,333,231,8,486,82,530,73,4061
"06097151301",3026,487,92,14,949,175,1511,275,6529
"06097151305",2993,805,204,0,1224,268,1605,184,7283
"06097151306",2356,349,22,0,569,8,469,34,3807
"06097151307",3689,304,48,0,957,143,818,168,6127
"06097151308",3537,326,80,52,381,430,523,311,5640
"06097151309",4002,509,95,0,556,63,799,198,6222
"06097151310",2451,254,104,0,1033,230,1023,88,5183
"06097151311",4107,1621,0,29,1246,76,1093,34,8206
"06097151401",3681,620,0,0,2513,404,3018,737,10973
"06097151402",4303,1126,244,0,2603,861,3001,1334,13472
"06097151502",5050,484,131,31,1073,121,929,162,7981
"06097151503",3256,73,0,0,137,14,141,4,3625
"06097151504",2785,109,72,0,366,35,506,35,3908
"06097151601",2226,112,0,0,89,18,0,0,2445
"06097151602",3014,103,0,0,88,0,45,18,3268
"06097151700",4992,350,72,22,1074,85,1105,227,7927
"06097151800",4411,359,0,0,410,61,676,109,6026
"06097151900",1958,325,43,6,636,176,879,164,4187
"06097152000",1061,343,13,36,342,79,363,113,2350
"06097152100",1584,290,47,6,503,118,528,35,3111
"06097152201",2441,524,105,12,594,33,391,73,4173
"06097152202",4313,486,131,0,913,296,665,510,7314
"06097152203",2735,284,128,33,137,64,226,57,3664
"06097152300",3709,230,40,0,408,32,391,21,4831
"06097152400",7299,400,63,24,1807,70,923,0,10586
"06097152501",3235,363,54,13,475,11,462,77,4690
"06097152502",2643,305,15,3,387,91,535,223,4202
"06097152600",6489,487,30,0,929,25,760,69,8789
"06097152701",4290,244,44,0,446,234,427,49,5734
"06097152702",3323,632,146,0,896,93,937,266,6293
"06097152801",3990,278,36,8,1029,31,1100,75,6547
"06097152802",4080,842,138,395,1296,166,2663,189,9769
"06097152903",2856,539,158,11,1322,275,2431,521,8113
"06097152904",3877,253,214,0,486,252,876,241,6199
"06097152905",2976,178,17,0,935,88,1410,103,5707
"06097152906",3896,321,126,1,988,61,825,6,6224
"06097153001",4528,868,105,34,1055,268,2563,500,9921
"06097153002",3615,1340,171,39,572,375,1967,1435,9514
"06097153003",3321,547,140,22,1428,253,1785,436,7932
"06097153005",5343,744,53,24,1228,323,1923,778,10416
"06097153006",4824,685,0,17,980,268,1410,282,8466
"06097153102",2846,663,178,8,1371,441,2858,653,9018
"06097153103",2817,470,64,0,726,454,1896,561,6988
"06097153104",1362,725,34,0,1206,625,1641,1033,6626
"06097153200",3552,1414,217,0,3106,498,2699,1482,12968
"06097153300",6087,918,389,55,3806,594,3239,729,15817
"06097153401",4915,751,113,0,780,75,824,48,7506
"06097153403",3043,323,59,0,390,32,427,85,4359
"06097153404",3652,313,21,0,296,53,290,11,4636
"06097153501",3341,487,8,6,408,107,365,158,4880
"06097153502",3279,227,169,0,159,169,56,147,4206
"06097153600",3851,475,0,16,820,187,706,176,6231
"06097153703",2213,550,32,0,152,133,112,105,3297
"06097153704",2199,791,74,65,307,52,152,297,3937
"06097153705",2775,383,91,61,204,106,255,116,3991
"06097153706",3467,243,15,0,400,5,255,5,4390
"06097153801",6952,419,55,0,2883,240,3001,339,13889
"06097153804",2769,40,0,0,455,31,808,31,4134
"06097153806",2459,105,0,0,700,0,625,20,3909
"06097153807",3797,157,0,0,101,0,496,41,4592
"06097153808",2579,319,0,21,1304,63,1748,130,6164
"06097153809",3034,70,0,0,983,156,1250,152,5645
"06097153901",3460,234,0,15,1024,195,1121,209,6258
"06097153902",2664,274,23,0,1045,187,1637,276,6106
"06097153903",3166,277,32,0,404,320,628,355,5182
"06097154000",1963,288,0,28,363,105,421,138,3306
"06097154100",2463,399,7,18,979,47,1024,117,5054
"06097154201",2186,673,30,15,895,4,1393,155,5351
"06097154202",4791,234,49,0,897,0,1387,59,7417
"06097154302",2847,416,0,0,182,43,140,12,3640
"06097154303",1154,86,3,0,65,18,61,13,1400
"06097154304",1528,172,11,1,195,60,207,10,2184
"06097990100",0,0,0,0,0,0,0,0,0
"06099000101",4179,388,17,0,281,38,398,96,5397
"06099000102",3368,568,0,0,254,77,804,412,5483
"06099000201",4733,382,9,101,253,31,930,68,6507
"06099000202",4840,1049,65,56,677,248,1425,295,8655
"06099000203",6084,1736,90,24,979,123,1973,1021,12030
"06099000301",1226,352,30,0,299,86,867,332,3192
"06099000302",1996,262,45,68,273,23,1106,145,3918
"06099000303",3708,757,113,0,936,174,2784,431,8903
"06099000304",3439,976,10,53,767,84,2983,793,9105
"06099000402",7662,470,120,4,2116,443,3355,681,14851
"06099000403",3522,275,37,8,269,135,818,171,5235
"06099000404",3237,578,181,0,666,286,402,162,5512
"06099000501",5572,300,52,0,1766,116,2690,85,10581
"06099000503",3062,726,95,57,1330,198,1193,489,7150
"06099000504",5071,373,305,0,3350,347,2525,193,12164
"06099000505",2581,777,177,0,1547,249,1298,387,7016
"06099000506",2709,692,94,42,671,299,637,518,5662
"06099000510",6427,938,178,0,1169,314,3518,894,13438
"06099000601",3116,390,97,61,963,35,1585,178,6425
"06099000602",1797,286,18,61,797,67,1188,240,4454
"06099000801",4149,967,78,18,831,62,1302,298,7705
"06099000803",2000,842,169,19,482,601,1312,1015,6440
"06099000805",3515,914,153,152,989,424,1524,859,8530
"06099000806",2681,442,140,52,842,175,1054,278,5664
"06099000807",2473,426,25,9,524,152,998,282,4889
"06099000905",4206,257,197,396,568,213,966,42,6845
"06099000906",4657,212,206,69,920,64,1631,142,7901
"06099000907",2475,127,0,34,179,22,401,22,3260
"06099000908",3142,741,340,180,639,176,1450,480,7148
"06099000909",2543,1001,58,85,788,219,940,647,6281
"06099000910",3912,914,194,66,989,219,1935,763,8992
"06099000911",3398,610,113,98,718,206,1413,328,6884
"06099000912",11597,722,560,0,5028,646,3639,950,23142
"06099001001",3818,826,152,143,281,284,700,604,6808
"06099001002",1841,448,50,22,316,124,616,205,3622
"06099001100",2633,818,48,0,497,191,967,497,5651
"06099001200",2149,518,112,8,559,196,759,234,4535
"06099001300",4028,534,45,2,403,199,642,408,6261
"06099001400",2910,1158,90,150,1186,1063,1505,794,8856
"06099001500",4154,881,133,10,958,664,2629,1088,10517
"06099001601",2025,1067,93,73,1359,589,2415,1214,8835
"06099001603",2429,1517,51,98,1036,1006,2214,1781,10132
"06099001604",1386,812,119,59,862,708,1804,1218,6968
"06099001700",1057,721,95,29,507,303,1345,642,4699
"06099001800",883,408,64,43,115,112,212,165,2002
"06099001900",2948,691,130,146,682,64,1169,259,6089
"06099002002",2313,1196,59,0,576,369,1465,941,6919
"06099002004",3098,1382,485,265,1014,289,1671,699,8903
"06099002005",1624,538,126,20,870,88,1285,267,4818
"06099002006",1590,527,158,7,1242,291,1036,323,5174
"06099002100",1502,1378,0,39,649,149,1635,1029,6381
"06099002200",2292,1696,59,187,1000,919,2143,2213,10509
"06099002301",2972,1932,200,113,1476,973,3155,2210,13031
"06099002302",1555,995,0,0,993,261,2045,863,6712
"06099002401",1760,542,149,0,790,244,1992,558,6035
"06099002402",1689,1110,10,0,1483,1137,2690,1988,10107
"06099002501",3278,570,133,0,2197,237,4186,620,11221
"06099002503",2273,854,31,2,272,359,1707,743,6241
"06099002504",2567,425,85,0,1147,330,2550,606,7710
"06099002602",2542,1134,57,30,621,155,1508,849,6896
"06099002603",1817,123,1,2,414,228,828,219,3632
"06099002604",2100,1300,158,107,524,247,1636,848,6920
"06099002605",2537,519,0,54,400,92,1447,193,5242
"06099002701",2301,426,0,0,903,119,1630,182,5561
"06099002702",4143,1049,23,0,1745,1003,3818,1750,13531
"06099002801",3633,742,0,43,800,239,1510,522,7489
"06099002802",3385,1211,0,77,1221,442,2283,737,9356
"06099002803",1931,458,16,0,307,105,605,342,3764
"06099002901",3340,570,0,1,233,213,689,477,5523
"06099002902",4866,1487,118,0,858,2,1986,943,10260
"06099003001",5933,567,25,0,3548,170,4816,451,15510
"06099003002",3566,1667,36,0,1443,790,2597,1733,11832
"06099003100",2728,757,0,2,280,67,1033,509,5376
"06099003201",2860,1283,117,22,807,216,2653,1432,9390
"06099003202",9494,1309,1222,221,2903,779,6925,1362,24215
"06099003300",3444,1440,156,17,647,68,2261,1349,9382
"06099003400",836,390,0,17,21,25,539,367,2195
"06099003500",6378,2490,126,35,1212,288,4729,2453,17711
"06099003603",2892,949,0,0,204,93,869,559,5566
"06099003604",6904,1237,0,69,560,57,2181,530,11538
"06099003605",6076,673,0,2,773,656,1491,322,9993
"06099003606",8067,262,217,156,2444,171,2752,215,14284
"06099003700",3019,555,138,0,681,161,1849,462,6865
"06099003802",2923,1661,5,142,431,273,2476,1413,9324
"06099003803",1404,509,0,0,593,66,1223,415,4210
"06099003804",4081,1432,76,75,545,485,2106,1401,10201
"06099003805",2033,286,36,43,267,106,1039,152,3962
"06099003904",3283,518,0,0,481,258,1754,332,6626
"06099003905",3336,118,1,0,141,38,507,29,4170
"06099003906",2369,1319,125,123,436,310,1127,907,6716
"06099003907",5618,273,119,205,883,69,1459,83,8709
"06099003908",1402,460,15,39,355,123,795,182,3371
"06099003909",4103,726,41,0,812,109,1237,202,7230
"06099004000",2825,256,0,0,598,101,938,201,4919
"06101050101",3759,842,129,53,1354,604,1655,721,9117
"06101050102",2513,558,42,9,719,310,876,205,5232
"06101050201",1038,925,32,94,721,334,588,831,4563
"06101050202",2083,1113,21,31,366,199,882,762,5457
"06101050301",1819,227,13,0,343,19,441,100,2962
"06101050302",3121,1268,43,95,879,863,2084,1731,10084
"06101050401",3321,172,52,20,1559,187,1185,80,6576
"06101050402",2631,286,94,0,932,135,568,122,4768
"06101050403",2030,129,90,0,1122,114,833,56,4374
"06101050501",3042,458,27,0,2391,612,1038,326,7894
"06101050503",3602,110,194,0,2523,781,1999,105,9314
"06101050504",3746,77,227,9,2213,360,1143,17,7792
"06101050601",2904,687,202,10,1287,232,636,198,6156
"06101050603",3900,295,89,5,668,49,207,114,5327
"06101050604",2655,263,86,32,802,122,582,64,4606
"06101050701",1905,862,0,4,1159,232,1505,830,6497
"06101050702",3752,354,25,0,1424,514,2419,472,8960
"06101050800",2931,225,0,0,202,54,326,88,3826
"06101050900",964,253,0,19,250,60,362,210,2118
"06101051000",1354,199,36,13,385,102,591,136,2816
"06101051100",1904,185,43,0,376,59,403,107,3077
"06103000100",3147,512,12,7,364,65,522,25,4654
"06103000200",6323,758,0,0,574,241,541,87,8524
"06103000300",3329,982,0,0,345,376,595,522,6149
"06103000400",4810,500,3,0,329,3,279,64,5988
"06103000500",3363,901,0,0,581,81,620,271,5817
"06103000600",3379,548,1,7,537,122,1093,136,5823
"06103000700",5248,1925,0,13,850,278,1420,460,10194
"06103000800",3107,603,12,0,509,42,1205,184,5662
"06103000900",2544,586,0,0,481,68,745,262,4686
"06103001000",4513,846,93,0,805,25,1745,265,8292
"06103001100",4843,1516,5,109,590,490,2242,917,10712
"06105000101",2055,662,0,0,153,128,68,147,3213
"06105000102",3218,383,0,0,479,149,293,19,4541
"06105000200",1788,304,34,0,81,35,111,26,2379
"06105000300",2106,663,16,0,244,40,170,55,3294
"06105000400",555,81,1,0,90,44,21,0,792
"06107000100",4008,331,17,0,434,124,1088,135,6137
"06107000201",3789,2376,15,65,2480,559,5084,2936,17304
"06107000202",1268,819,0,0,426,246,1215,908,4882
"06107000301",4277,1338,0,61,593,317,2282,1470,10338
"06107000302",1851,1144,4,0,299,359,1812,1329,6798
"06107000401",3382,1565,0,0,940,96,3769,1441,11193
"06107000402",4317,1184,16,0,1416,459,4081,1525,12998
"06107000501",2835,1836,0,0,950,665,3530,2412,12228
"06107000502",2396,479,0,0,895,252,3016,667,7705
"06107000600",2591,2532,0,30,429,542,2681,3064,11869
"06107000701",1724,515,38,0,184,103,1342,472,4378
"06107000702",3336,1265,0,33,924,217,3713,1306,10794
"06107000800",4317,2074,1,2,669,338,2772,1860,12033
"06107000900",4697,1647,10,183,779,245,3532,1679,12772
"06107001003",13533,3113,253,102,3237,667,7994,2399,31298
"06107001004",3680,1878,70,57,1550,821,4405,2010,14471
"06107001005",1912,105,80,0,533,20,765,79,3494
"06107001006",4051,556,172,0,766,96,1319,407,7367
"06107001100",2340,2803,10,213,934,514,2159,2941,11914
"06107001200",749,263,31,14,108,28,442,171,1806
"06107001301",5352,790,136,16,945,769,3390,1020,12418
"06107001302",5062,1804,112,26,972,245,3060,810,12091
"06107001400",4222,972,46,0,607,27,2878,698,9450
"06107001501",3562,998,0,19,564,101,852,768,6864
"06107001502",3534,1681,76,48,522,88,1845,1065,8859
"06107001601",2427,1900,0,245,708,192,2732,1828,10032
"06107001602",3254,1461,0,0,477,38,2489,1384,9103
"06107001701",2398,1644,256,226,882,489,2189,1563,9647
"06107001703",4569,901,102,122,835,39,1576,568,8712
"06107001704",4496,620,230,0,1044,92,2310,386,9178
"06107001800",3677,330,10,40,387,246,1278,310,6278
"06107001901",2682,255,11,3,535,128,1202,209,5025
"06107001902",3171,311,0,0,643,54,1212,165,5556
"06107002002",3361,894,6,31,455,108,1363,612,6830
"06107002003",3611,1272,220,112,523,145,1499,967,8349
"06107002004",3859,474,38,0,422,142,1764,315,7014
"06107002006",3683,100,38,0,517,43,1052,75,5508
"06107002007",6258,691,247,0,1238,200,2898,570,12102
"06107002008",1674,815,0,90,93,193,650,548,4063
"06107002009",3124,493,193,58,279,39,1289,406,5881
"06107002100",1770,360,2,14,269,93,952,281,3741
"06107002202",2625,2077,108,214,644,393,2520,2161,10742
"06107002203",3502,1038,24,39,483,118,2940,802,8946
"06107002204",3438,1549,74,92,887,70,3088,1338,10536
"06107002302",3418,244,189,35,397,322,1348,442,6395
"06107002303",5089,266,0,0,468,183,1580,275,7861
"06107002304",1135,497,20,6,40,63,540,176,2477
"06107002400",8799,1009,207,27,1994,179,4697,735,17647
"06107002500",3249,591,34,0,443,98,2306,586,7307
"06107002601",1915,1176,0,21,754,388,2438,1466,8158
"06107002602",3018,1583,0,2,640,599,2861,2014,10717
"06107002700",3640,323,6,23,972,520,876,76,6436
"06107002800",1086,1993,31,0,299,239,1109,2022,6779
"06107002901",1613,981,253,29,337,169,1438,890,5710
"06107002903",3794,827,94,129,581,227,2327,665,8644
"06107002904",3340,645,155,59,404,192,1933,730,7458
"06107003001",2409,790,146,18,581,139,2346,743,7172
"06107003002",2159,899,44,78,294,98,1789,870,6231
"06107003100",2038,781,101,0,282,60,1132,635,5029
"06107003200",4170,2110,0,0,224,164,3336,2086,12090
"06107003300",4742,2589,4,5,649,450,3454,2531,14424
"06107003400",3617,2370,13,24,737,363,2086,2297,11507
"06107003501",1907,556,13,0,253,7,635,418,3789
"06107003502",7323,1702,72,18,1575,621,5208,1835,18354
"06107003601",4235,1015,60,22,1111,138,2732,666,9979
"06107003602",3280,1922,0,0,1110,507,1726,1804,10349
"06107003700",3883,1216,45,0,554,402,2600,1245,9945
"06107003801",1747,1090,0,0,241,214,1263,970,5525
"06107003802",1966,1412,0,72,385,434,1792,1411,7472
"06107003901",3872,1662,64,0,1177,303,3430,1745,12253
"06107003902",3443,1601,0,0,429,437,2384,1659,9953
"06107004000",24,45,0,25,2,25,13,46,180
"06107004101",4175,2723,30,25,1002,568,4562,2915,16000
"06107004102",999,757,0,76,281,121,842,864,3940
"06107004200",2679,3168,157,118,413,529,2879,3099,13042
"06107004300",3034,2696,18,54,1071,827,3552,3316,14568
"06107004400",2623,3129,20,46,832,507,3036,3322,13515
"06107004500",2890,1982,204,0,702,561,2576,2369,11284
"06109001100",2695,280,82,7,335,27,335,35,3796
"06109001200",2221,1042,63,56,576,141,143,216,4458
"06109002100",3532,566,0,0,307,197,413,37,5052
"06109002200",6634,505,68,3,202,18,689,10,8129
"06109003100",5542,792,0,0,421,35,471,38,7299
"06109003200",4116,918,0,3,519,85,505,151,6297
"06109004100",4318,391,0,1,101,137,395,123,5466
"06109004200",2826,513,0,0,71,69,187,65,3731
"06109005100",6299,1421,0,0,546,159,501,261,9187
"06109005201",1565,78,22,0,209,0,95,0,1969
"06109985202",0,0,0,0,0,0,0,0,0
"06111000100",497,105,0,0,16,24,71,38,751
"06111000200",1710,265,0,32,623,163,2088,384,5265
"06111000302",3831,1032,2,0,1728,465,3647,1436,12141
"06111000303",3347,599,0,0,723,292,2888,849,8698
"06111000304",2692,1228,0,0,519,183,2389,1340,8351
"06111000400",4246,627,7,0,1730,165,4944,698,12417
"06111000500",868,496,0,0,524,75,949,489,3401
"06111000600",2404,1428,12,10,1393,772,3229,2108,11356
"06111000701",3320,1255,0,0,1192,194,3747,1344,11052
"06111000702",2308,369,4,0,937,106,2345,430,6499
"06111000800",5750,550,12,0,1503,302,4575,615,13307
"06111000901",2199,157,0,0,165,3,196,8,2728
"06111000902",1422,255,0,2,143,31,110,37,2000
"06111000903",3954,869,0,19,385,162,702,369,6460
"06111001001",2070,382,19,0,283,62,462,38,3316
"06111001002",5511,931,19,0,607,192,1637,582,9479
"06111001101",4105,315,0,0,271,79,1215,43,6028
"06111001102",2862,586,0,0,323,8,500,48,4327
"06111001201",3062,497,8,9,558,154,1244,391,5923
"06111001202",5365,238,149,31,831,152,1126,152,8044
"06111001204",1704,485,108,6,385,47,1102,310,4147
"06111001206",620,52,0,0,162,11,133,24,1002
"06111001301",5483,894,97,0,1526,11,1834,537,10382
"06111001302",975,466,33,0,353,134,561,546,3068
"06111001401",3498,250,34,3,684,67,1252,78,5866
"06111001402",4188,309,75,2,1042,70,1591,168,7445
"06111001502",6381,868,256,161,1128,138,2980,523,12435
"06111001503",2829,323,119,0,1042,253,1499,332,6397
"06111001506",4282,150,69,2,789,36,1926,15,7269
"06111001507",2793,330,108,0,1017,242,1320,392,6202
"06111001601",738,76,27,7,232,0,353,39,1472
"06111001602",1838,136,0,0,385,41,337,76,2813
"06111001700",3200,101,0,0,308,10,402,0,4021
"06111001800",3723,70,165,0,459,0,572,13,5002
"06111001900",2899,259,49,9,367,153,594,138,4468
"06111002000",2016,177,114,18,226,8,272,23,2854
"06111002102",1062,195,19,0,177,8,196,31,1688
"06111002200",3799,1045,0,0,1364,324,2997,944,10473
"06111002300",3764,827,0,0,1998,448,4439,999,12475
"06111002400",1921,433,70,0,221,64,548,49,3306
"06111002500",4151,142,0,0,182,72,239,37,4823
"06111002600",2292,344,7,0,232,56,648,172,3751
"06111002700",3574,161,54,0,317,57,761,89,5013
"06111002800",4653,876,37,45,755,116,1347,737,8566
"06111002901",4108,253,279,17,1060,60,2501,269,8547
"06111002905",3542,478,258,16,1271,67,3211,384,9227
"06111003010",1972,268,91,9,678,186,1973,383,5560
"06111003011",4088,922,122,27,671,71,4094,931,10926
"06111003012",251,0,0,0,53,9,285,9,607
"06111003013",3573,188,240,0,1205,36,3133,153,8528
"06111003100",10095,1224,370,0,3941,751,10602,1848,28831
"06111003201",2057,1302,1,3,563,108,2594,1324,7952
"06111003300",5829,1139,148,140,1151,0,5073,1090,14570
"06111003605",5806,703,657,37,1840,120,4410,734,14307
"06111003608",2429,319,200,0,1079,10,2462,268,6767
"06111003609",4509,399,167,0,694,166,506,210,6651
"06111003612",3256,8,103,0,298,12,264,0,3941
"06111003700",3817,738,243,8,1320,289,4679,991,12085
"06111003801",3465,460,105,33,898,271,4242,759,10233
"06111003802",1573,631,121,0,351,129,1770,760,5335
"06111003900",4326,1568,71,141,1324,153,4974,1660,14217
"06111004000",3847,617,29,94,1203,595,4417,1022,11824
"06111004101",5060,767,78,0,1223,97,5374,702,13301
"06111004200",3136,289,40,13,1533,123,3257,367,8758
"06111004304",4227,1482,285,0,703,251,2961,1288,11197
"06111004305",839,149,143,0,282,19,210,77,1719
"06111004400",3735,921,502,50,1747,551,2936,1086,11528
"06111004503",2036,631,128,9,1245,186,2446,814,7495
"06111004504",2996,934,87,22,1534,259,3203,1062,10097
"06111004505",1179,308,152,9,420,121,1050,257,3496
"06111004506",3139,1930,90,97,1650,111,4044,1951,13012
"06111004600",814,201,83,15,395,25,226,51,1810
"06111004704",972,239,0,0,229,50,986,228,2704
"06111004710",3011,469,70,0,1116,151,3035,564,8416
"06111004711",1737,191,53,9,1051,187,1480,265,4973
"06111004715",3387,482,89,0,1123,165,3585,408,9239
"06111004716",2456,669,68,0,915,110,2859,732,7809
"06111004717",2551,793,91,5,962,78,3188,876,8544
"06111004901",4308,133,245,0,2051,174,3949,61,10921
"06111004902",3258,1284,5,7,444,101,3700,1385,10184
"06111005002",1957,561,9,0,292,155,2066,706,5746
"06111005003",5267,1227,0,26,833,312,5374,1405,14444
"06111005004",3677,617,20,137,1367,176,2663,721,9378
"06111005100",2166,101,56,0,565,145,1123,135,4291
"06111005202",2069,131,56,0,452,214,601,230,3753
"06111005203",4222,254,103,25,598,47,959,70,6278
"06111005204",2695,131,0,0,499,0,371,0,3696
"06111005205",3953,520,52,0,1162,54,971,222,6934
"06111005303",6741,310,114,9,1888,46,1547,63,10718
"06111005304",3964,213,15,0,837,0,449,0,5478
"06111005305",4657,253,73,0,661,0,787,35,6466
"06111005306",3951,245,19,0,852,0,954,25,6046
"06111005401",2870,203,100,1,989,14,1233,34,5444
"06111005403",1749,130,57,0,394,90,1158,100,3678
"06111005404",3134,39,115,0,494,17,1402,23,5224
"06111005502",2979,347,206,65,1702,22,1867,168,7356
"06111005503",2373,92,132,0,1057,0,1054,9,4717
"06111005504",3080,214,77,0,693,142,885,238,5329
"06111005600",5992,208,361,49,2716,241,2384,317,12268
"06111005700",1105,73,37,13,316,6,291,14,1855
"06111005801",3890,123,67,0,984,34,488,12,5598
"06111005802",7418,54,166,0,1998,0,966,14,10616
"06111005901",5382,439,53,0,1029,100,519,87,7609
"06111005906",5436,117,96,10,704,0,394,0,6757
"06111005907",3151,208,44,0,332,9,203,9,3956
"06111005908",2050,42,30,0,299,129,407,0,2957
"06111005909",2774,63,32,75,464,0,317,25,3750
"06111005910",1400,75,0,0,242,5,151,5,1878
"06111005911",2916,142,60,0,752,222,684,182,4958
"06111006000",3615,414,32,14,686,100,1109,117,6087
"06111006100",4597,419,80,0,2615,746,2162,1072,11691
"06111006200",2663,13,0,0,489,0,206,0,3371
"06111006301",5306,148,0,0,988,60,710,24,7236
"06111006302",1747,224,0,137,385,45,216,72,2826
"06111006400",5741,184,0,0,1582,81,1609,190,9387
"06111006500",2262,343,0,0,787,246,1460,247,5345
"06111006600",3348,261,0,0,601,13,416,16,4655
"06111006700",2093,189,0,0,690,78,418,15,3483
"06111006800",3061,370,1,0,741,18,1067,290,5548
"06111006900",2377,820,18,0,576,91,309,479,4670
"06111007000",2074,475,46,19,1180,179,1196,227,5396
"06111007100",3345,954,143,61,955,39,1649,479,7625
"06111007201",2993,74,0,1,228,5,254,1,3556
"06111007202",3782,70,39,0,564,17,272,0,4744
"06111007300",1476,40,0,0,106,47,41,40,1750
"06111007402",5066,192,67,0,938,175,542,0,6980
"06111007403",4265,287,24,0,1072,53,334,12,6047
"06111007405",5507,297,20,0,994,101,584,27,7530
"06111007406",1845,73,0,0,379,15,70,8,2390
"06111007505",2621,67,0,0,506,0,768,0,3962
"06111007506",6613,178,57,1,612,0,1144,71,8676
"06111007507",5788,30,32,0,1388,0,664,0,7902
"06111007508",2873,179,35,0,409,12,540,27,4075
"06111007509",3198,18,174,0,957,0,513,9,4869
"06111007510",4610,61,29,0,1417,52,485,25,6679
"06111007511",1663,94,0,0,525,4,150,4,2440
"06111007512",4308,114,26,71,740,0,1182,26,6467
"06111007513",1358,18,95,2,115,2,138,0,1728
"06111007514",4944,149,31,0,1159,32,799,32,7146
"06111007606",1438,38,43,0,262,38,487,60,2366
"06111007607",5039,54,4,20,981,0,675,0,6773
"06111007609",2381,18,8,0,271,13,399,5,3095
"06111007610",4145,192,44,0,809,0,911,0,6101
"06111007611",2317,723,10,0,905,495,2364,1195,8009
"06111007612",3266,202,9,0,986,225,1653,259,6600
"06111007613",2938,148,93,0,644,2,715,123,4663
"06111007614",5317,282,57,0,1698,142,1827,217,9540
"06111007700",3937,193,156,0,1096,397,1609,424,7812
"06111007800",2095,518,94,12,1229,40,1218,323,5529
"06111007901",4456,174,131,0,949,54,2327,72,8163
"06111007903",3568,70,0,0,1058,17,650,37,5400
"06111007904",4483,194,70,7,1291,49,1877,109,8080
"06111008001",2326,380,23,0,612,130,1007,298,4776
"06111008002",3640,388,0,4,913,166,1730,269,7110
"06111008004",3735,83,89,13,1088,68,1888,89,7053
"06111008005",1759,165,10,2,572,127,918,210,3763
"06111008101",2518,244,0,2,468,23,560,134,3949
"06111008201",2873,267,87,13,880,75,1064,182,5441
"06111008202",3127,328,44,9,929,135,1017,99,5688
"06111008302",3918,638,37,0,1018,42,1012,299,6964
"06111008303",2604,253,52,0,794,310,685,213,4911
"06111008304",3839,175,38,0,1317,113,848,69,6399
"06111008305",2391,66,84,0,1292,67,506,0,4406
"06111008306",2665,232,18,0,866,114,918,64,4877
"06111008401",3633,437,38,0,841,428,780,543,6700
"06111008402",4493,202,71,0,575,11,679,63,6094
"06111008500",6747,517,214,0,1250,5,1148,27,9908
"06111008600",4952,1825,180,131,1058,194,4906,2046,15292
"06111008700",4171,755,33,35,1087,206,4180,831,11298
"06111008800",3182,232,48,29,1367,0,3173,167,8198
"06111008900",2518,219,21,0,630,57,2662,198,6305
"06111009100",2288,1307,142,18,758,260,2937,1482,9192
"06111980000",0,0,0,0,0,0,0,0,0
"06111990100",0,0,0,0,0,0,0,0,0
"06113010101",3347,1345,301,194,1283,1266,2467,897,11100
"06113010102",3295,1163,233,18,1714,468,2081,306,9278
"06113010201",1896,287,20,90,413,198,708,141,3753
"06113010203",2167,1065,87,130,866,969,1551,1044,7879
"06113010204",2604,767,10,48,756,914,958,1004,7061
"06113010302",4504,302,344,45,1773,279,1451,382,9080
"06113010310",3393,61,122,38,1813,158,1369,26,6980
"06113010312",3642,140,102,12,1202,57,1055,21,6231
"06113010401",2991,424,35,1,607,284,655,431,5428
"06113010402",1945,12,412,16,1381,266,630,54,4716
"06113010501",735,593,0,0,668,607,201,153,2957
"06113010505",3315,205,31,0,1078,159,449,70,5307
"06113010508",1440,385,86,34,355,196,221,70,2787
"06113010509",1914,420,10,88,579,395,474,70,3950
"06113010510",2380,598,60,12,859,1196,283,123,5511
"06113010511",1962,188,8,7,740,456,170,63,3594
"06113010512",1480,620,17,42,1070,328,420,177,4154
"06113010513",1349,630,0,0,521,349,136,132,3117
"06113010602",2374,1001,235,145,954,790,812,295,6606
"06113010605",2195,162,5,0,1227,61,410,137,4197
"06113010606",4408,716,59,114,1192,491,845,335,8160
"06113010607",2708,115,57,1,1174,122,492,7,4676
"06113010608",2127,721,80,37,1046,2093,426,308,6838
"06113010701",2621,922,23,3,658,533,225,109,5094
"06113010703",1496,631,19,24,675,1411,115,483,4854
"06113010704",1281,358,0,27,340,281,314,101,2702
"06113010800",2298,493,0,54,591,291,1505,525,5757
"06113010901",3463,610,67,12,1190,479,2704,668,9193
"06113010902",3404,529,78,237,1893,279,2948,707,10075
"06113011001",2802,1261,26,0,1306,248,1876,867,8386
"06113011002",2595,228,13,0,437,20,831,35,4159
"06113011101",1879,227,11,0,732,300,1414,399,4962
"06113011102",2605,690,77,13,992,231,2461,734,7803
"06113011103",1860,232,16,8,845,232,1497,245,4935
"06113011203",2077,0,28,0,339,0,526,0,2970
"06113011204",3798,460,0,0,991,79,1664,419,7411
"06113011205",4539,607,33,0,2724,190,3173,425,11691
"06113011206",4835,131,27,0,1779,59,1954,79,8864
"06113011300",5583,369,27,0,2027,374,3559,415,12354
"06113011400",2391,292,42,35,867,254,1465,379,5725
"06113011500",3119,366,468,0,1182,159,2122,328,7744
"06115040100",2287,958,154,151,458,258,639,314,5219
"06115040200",4476,1486,257,0,929,592,1093,831,9664
"06115040301",1360,886,131,105,792,498,1162,552,5486
"06115040302",983,530,0,37,395,177,656,229,3007
"06115040303",3416,393,64,28,2071,994,1428,618,9012
"06115040400",2014,1262,15,81,944,725,1068,591,6700
"06115040500",1434,690,0,0,1388,293,1371,434,5610
"06115040600",2843,1308,62,0,1816,162,1651,246,8088
"06115040700",8074,426,488,258,2442,266,2885,290,15129
"06115040800",2489,333,0,76,810,298,605,173,4784
"06115040901",1841,401,0,8,752,148,742,11,3903
"06115040902",713,102,147,9,285,33,151,11,1451
"06115041000",5072,729,113,0,930,76,580,73,7573
"06115041100",3006,872,5,32,420,245,232,214,5026
"08001007801",1016,1204,139,325,572,893,962,1306,6417
"08001007802",1282,1197,232,440,450,616,1418,1680,7315
"08001007900",2128,1513,445,597,1164,558,2323,1763,10491
"08001008000",2956,448,771,344,1093,271,2395,462,8740
"08001008100",437,244,22,13,138,70,114,47,1085
"08001008200",3129,370,785,68,527,60,1610,292,6841
"08001008308",2264,800,372,1205,820,291,1682,999,8433
"08001008309",1607,664,185,112,512,621,1351,1027,6079
"08001008353",3369,224,1052,80,815,10,1822,142,7514
"08001008401",3525,297,15,0,266,48,487,51,4689
"08001008402",3854,416,0,0,288,0,255,0,4813
"08001008505",5240,718,134,0,501,185,1416,442,8636
"08001008506",3822,1235,61,64,304,56,1361,653,7556
"08001008507",5342,476,0,0,955,219,1864,451,9307
"08001008508",4422,373,211,0,542,7,1221,235,7011
"08001008523",6053,311,246,15,427,0,1001,25,8078
"08001008524",6532,186,109,0,846,0,1632,0,9305
"08001008526",6033,65,172,12,717,0,1050,27,8076
"08001008529",6232,360,265,19,888,213,1482,87,9546
"08001008533",6515,547,99,42,274,44,1895,123,9539
"08001008534",3898,48,0,0,620,0,1423,18,6007
"08001008535",3162,35,21,0,205,145,1175,11,4754
"08001008536",2290,82,67,0,251,0,508,49,3247
"08001008537",4320,390,31,0,1021,0,1811,309,7882
"08001008538",4798,76,384,0,833,13,959,18,7081
"08001008539",6528,118,658,0,1528,0,2937,22,11791
"08001008540",5795,75,227,0,879,0,1519,30,8525
"08001008541",3642,127,190,0,392,24,192,0,4567
"08001008542",5877,312,218,0,647,0,1250,9,8313
"08001008543",6486,221,8,0,681,99,2207,207,9909
"08001008544",3757,17,9,0,503,0,408,10,4704
"08001008545",5877,359,69,0,738,32,1030,0,8105
"08001008546",2083,241,15,0,434,0,571,50,3394
"08001008547",3379,61,0,0,149,0,581,61,4231
"08001008548",1141,155,0,0,175,0,354,13,1838
"08001008549",3831,81,0,0,484,20,1224,0,5640
"08001008550",5997,399,59,0,1046,127,997,77,8702
"08001008551",875,45,21,0,236,0,209,0,1386
"08001008603",1588,437,25,0,311,56,1370,373,4160
"08001008604",2486,513,27,0,605,72,1785,284,5772
"08001008605",3157,157,0,0,303,32,980,11,4640
"08001008606",4749,819,0,2,888,35,3437,619,10549
"08001008705",2822,1057,104,39,435,195,1759,866,7277
"08001008706",3341,789,0,1,559,491,2737,981,8899
"08001008709",4538,2462,40,57,1049,751,3236,2703,14836
"08001008801",2893,1204,48,55,982,101,2617,971,8871
"08001008802",2508,800,82,0,892,152,1755,642,6831
"08001008901",1414,480,137,4,438,14,1170,396,4053
"08001009001",3491,453,53,200,709,148,2540,361,7955
"08001009002",6664,1279,305,0,1388,78,5374,841,15929
"08001009101",3413,469,42,0,357,108,1978,440,6807
"08001009103",2486,434,0,0,312,40,1636,212,5120
"08001009104",3707,1035,112,0,573,33,1976,901,8337
"08001009202",3197,460,52,0,602,77,1978,444,6810
"08001009203",2253,675,42,0,457,167,1451,581,5626
"08001009204",5088,266,191,15,1394,91,2362,266,9673
"08001009206",1603,50,0,0,485,0,643,6,2787
"08001009207",3134,170,28,0,491,211,1446,185,5665
"08001009304",4227,840,90,0,571,610,2100,939,9377
"08001009306",2366,680,0,0,702,81,1463,697,5989
"08001009307",2674,657,36,0,243,68,1504,473,5655
"08001009308",3134,508,0,0,694,278,2748,656,8018
"08001009309",2298,380,9,166,719,27,1395,190,5184
"08001009310",4131,1345,12,39,531,90,2692,1165,10005
"08001009316",4759,500,8,2,1023,268,3184,503,10247
"08001009318",3933,1292,177,28,546,388,3115,1353,10832
"08001009319",1577,493,36,4,244,90,1090,388,3922
"08001009320",1549,857,44,6,305,119,850,798,4528
"08001009321",2550,372,0,6,519,200,1327,324,5298
"08001009322",2649,659,9,6,615,125,1194,492,5749
"08001009323",2881,424,132,26,438,39,1094,171,5205
"08001009325",3904,299,126,38,427,34,524,77,5429
"08001009326",1969,10,87,45,302,0,199,0,2612
"08001009327",2892,290,8,48,645,507,451,438,5279
"08001009401",3423,405,79,0,1060,53,1446,230,6696
"08001009406",3553,546,62,74,471,29,842,358,5935
"08001009407",3603,888,9,35,706,327,1617,670,7855
"08001009408",3542,50,108,22,577,0,546,10,4855
"08001009409",4492,119,45,20,570,208,306,205,5965
"08001009410",2758,56,29,0,240,41,479,31,3634
"08001009411",2608,92,49,0,327,0,646,0,3722
"08001009501",1745,783,11,12,532,220,1209,938,5450
"08001009502",3097,535,0,0,641,94,2393,495,7255
"08001009553",1934,397,0,0,514,182,1427,343,4797
"08001009603",4243,791,49,48,346,171,1429,149,7226
"08001009604",3005,899,34,10,365,200,972,670,6155
"08001009606",1491,604,8,0,306,354,1110,800,4673
"08001009607",2933,424,33,0,970,298,1660,552,6870
"08001009608",2290,139,25,0,534,8,774,81,3851
"08001009751",2439,933,1,1,416,17,1484,446,5737
"08001009752",1985,216,16,0,820,58,1875,97,5067
"08001015000",1907,436,0,0,208,51,792,318,3712
"08001060000",4074,233,50,0,472,0,538,0,5367
"08001060100",4854,375,166,0,1376,0,705,133,7609
"08001060200",2607,436,15,22,550,61,638,162,4491
"08001061200",1257,0,4,0,48,0,147,0,1456
"08001988700",0,0,0,0,0,0,0,0,0
"08003960000",1097,267,0,0,215,10,258,101,1948
"08003960100",1928,518,1,0,256,5,806,304,3818
"08003960200",4056,1876,21,112,472,177,1539,914,9167
"08003960300",2111,1128,31,55,645,44,1961,972,6947
"08005004951",961,598,93,0,257,53,523,176,2661
"08005004952",1256,455,304,0,434,153,317,174,3093
"08005005551",1320,582,0,404,962,273,1432,626,5599
"08005005552",1231,511,45,0,401,191,604,389,3372
"08005005553",2596,299,199,94,351,243,883,370,5035
"08005005611",4082,381,35,0,254,68,267,51,5138
"08005005612",3068,206,8,0,455,34,392,42,4205
"08005005614",2949,119,0,22,159,0,176,0,3425
"08005005619",4241,213,0,0,149,0,598,0,5201
"08005005620",2276,235,8,7,151,0,319,28,3024
"08005005621",2958,200,0,0,78,0,267,1,3504
"08005005622",1988,153,18,0,169,0,75,0,2403
"08005005623",3506,253,1,0,167,33,119,12,4091
"08005005624",1957,101,137,27,215,0,137,0,2574
"08005005625",2488,342,17,3,98,2,328,208,3486
"08005005626",3310,162,0,0,142,32,277,0,3923
"08005005627",4026,116,15,0,352,14,87,0,4610
"08005005628",5091,273,31,0,307,206,221,144,6273
"08005005629",2290,28,13,0,51,0,0,0,2382
"08005005630",4774,130,0,40,114,0,220,0,5278
"08005005631",2993,87,15,0,128,9,322,9,3563
"08005005632",2741,50,187,0,268,0,232,0,3478
"08005005633",2730,121,25,0,215,0,196,9,3296
"08005005634",2577,92,38,0,167,11,132,11,3028
"08005005635",4446,246,59,18,133,0,86,14,5002
"08005005636",1792,23,6,0,57,6,84,0,1968
"08005005700",2661,655,36,10,187,256,637,483,4925
"08005005800",1928,72,23,0,200,0,234,7,2464
"08005005951",2889,830,93,42,429,58,157,139,4637
"08005005952",2494,315,159,0,154,11,275,67,3475
"08005006000",1950,212,10,0,166,291,124,353,3106
"08005006100",2233,366,31,12,79,39,202,55,3017
"08005006200",2572,46,0,7,249,39,176,16,3105
"08005006300",1997,215,33,0,191,0,259,0,2695
"08005006400",2085,193,14,17,315,422,399,399,3844
"08005006501",1405,363,21,17,200,81,192,23,2302
"08005006502",2648,440,0,32,207,50,375,141,3893
"08005006601",3770,641,44,9,429,170,1032,345,6440
"08005006603",2897,286,0,18,124,26,352,9,3712
"08005006604",3176,528,43,0,139,80,331,143,4440
"08005006704",3767,49,147,56,388,0,104,0,4511
"08005006705",1706,22,5,0,94,0,38,0,1865
"08005006706",4380,160,0,0,423,121,272,11,5367
"08005006707",3831,549,41,70,425,33,147,6,5102
"08005006708",4285,207,82,10,326,26,350,19,5305
"08005006709",4562,154,16,0,598,0,260,20,5610
"08005006711",3456,66,25,0,385,40,134,0,4106
"08005006712",1271,0,0,0,105,0,109,0,1485
"08005006713",888,14,30,0,410,0,159,0,1501
"08005006808",5123,239,36,0,264,0,146,2,5810
"08005006815",2995,237,124,0,1042,82,669,1,5150
"08005006854",1891,149,144,0,171,0,85,73,2513
"08005006855",3586,271,0,0,1393,88,302,137,5777
"08005006856",5130,176,304,78,1060,229,708,80,7765
"08005006857",1986,0,0,0,179,0,58,0,2223
"08005006858",3327,417,84,0,602,71,758,0,5259
"08005007101",4258,359,40,0,288,87,238,122,5392
"08005007103",1367,131,7,0,156,8,148,33,1850
"08005007104",2954,163,634,0,1134,50,628,51,5614
"08005007105",2369,105,354,0,543,196,592,210,4369
"08005007106",3885,100,72,54,546,0,544,0,5201
"08005007107",4420,169,365,0,797,26,648,8,6433
"08005007201",1319,594,593,128,607,279,1014,442,4976
"08005007202",1932,678,397,281,766,405,1790,621,6870
"08005007301",1022,135,398,118,345,250,925,183,3376
"08005007302",2237,917,496,263,757,649,2356,1061,8736
"08005007400",2832,647,347,55,973,758,2429,1225,9266
"08005007500",1105,439,307,103,420,109,803,478,3764
"08005007600",1907,401,341,237,356,134,1251,239,4866
"08005007702",2137,329,344,190,778,157,1353,312,5600
"08005007703",1735,448,739,343,605,901,852,972,6595
"08005007704",1568,392,1375,457,526,327,965,564,6174
"08005015100",2209,124,39,31,153,0,201,14,2771
"08005080000",1448,283,449,349,703,159,570,372,4333
"08005080100",2097,460,821,407,575,0,1023,345,5728
"08005080200",3110,257,622,129,1062,119,1216,94,6609
"08005080300",3458,309,800,0,892,95,387,120,6061
"08005080400",3333,315,619,136,278,40,370,27,5118
"08005080500",2222,140,330,61,632,54,408,62,3909
"08005080600",1810,324,317,75,444,201,521,234,3926
"08005080700",2629,434,918,73,926,250,1263,549,7042
"08005080800",1550,323,275,287,667,228,1146,477,4953
"08005080900",2600,366,272,62,767,265,1153,512,5997
"08005081000",2194,1058,892,183,869,1007,2012,1365,9580
"08005081100",1857,188,1890,684,855,325,972,348,7119
"08005081200",1558,226,1011,303,785,242,739,143,5007
"08005081300",1314,156,626,77,436,497,538,472,4116
"08005081400",2576,427,325,44,720,0,619,174,4885
"08005081500",2764,198,15,0,53,24,31,24,3109
"08005081600",3468,58,248,59,608,28,577,13,5059
"08005081700",2026,204,154,0,476,6,77,165,3108
"08005081800",2262,1061,491,59,930,431,2129,1270,8633
"08005081900",2717,725,994,462,1316,387,2194,813,9608
"08005082000",1238,385,977,232,694,67,938,247,4778
"08005082100",3094,400,1159,138,1597,462,1883,518,9251
"08005082200",3355,107,1251,44,935,148,1112,164,7116
"08005082300",1803,381,576,130,433,542,482,646,4993
"08005082400",2333,183,518,157,1046,129,1234,137,5737
"08005082500",1586,148,404,17,177,7,435,35,2809
"08005082600",1889,106,1145,306,1122,421,821,476,6286
"08005082700",1728,158,880,0,529,23,334,17,3669
"08005082800",2802,92,729,105,988,112,950,111,5889
"08005082900",2999,229,575,241,537,19,1057,178,5835
"08005083000",2260,189,574,0,459,35,528,35,4080
"08005083100",4377,178,740,205,1225,0,1301,0,8026
"08005083200",6203,190,950,178,1400,189,955,0,10065
"08005083300",3040,315,731,19,671,11,679,140,5606
"08005083400",4115,355,492,140,1554,15,1500,119,8290
"08005083500",2527,393,741,182,1280,572,904,274,6873
"08005083600",2094,447,476,81,368,35,263,81,3845
"08005083700",3174,223,467,66,262,111,425,27,4755
"08005083800",1746,147,629,79,237,0,449,0,3287
"08005083900",2153,144,153,32,463,0,381,5,3331
"08005084000",2150,151,28,0,216,0,587,0,3132
"08005084100",2878,139,412,107,674,27,805,22,5064
"08005084200",2846,121,316,33,599,87,721,108,4831
"08005084300",2304,227,229,128,452,54,338,129,3861
"08005084400",1656,144,220,0,792,240,377,155,3584
"08005084500",1608,119,299,72,391,108,552,85,3234
"08005084600",3531,278,725,0,843,149,820,180,6526
"08005084700",3503,205,520,115,362,79,439,150,5373
"08005084800",2857,164,227,155,487,0,327,92,4309
"08005084900",2551,27,168,0,449,0,109,0,3304
"08005085000",1203,19,52,0,402,4,202,0,1882
"08005085100",4753,188,750,0,1160,259,410,0,7520
"08005085200",2595,9,21,1,396,12,201,0,3235
"08005085300",1871,70,185,20,389,23,226,0,2784
"08005085400",3367,155,324,26,566,73,551,20,5082
"08005085500",4028,119,140,0,901,103,621,0,5912
"08005085600",2629,97,124,0,634,29,556,49,4118
"08005085700",3133,128,417,10,850,74,829,57,5498
"08005085800",1339,64,73,0,219,11,118,0,1824
"08005085900",2110,74,490,29,776,11,462,11,3963
"08005086000",5414,281,739,146,1174,143,628,244,8769
"08005086100",3102,146,277,38,971,0,825,0,5359
"08005086200",4818,195,362,144,597,17,321,0,6454
"08005086300",2563,217,86,81,796,168,801,18,4730
"08005086400",2092,60,0,0,168,0,100,0,2420
"08005086500",3919,84,60,0,969,0,411,0,5443
"08005086600",4226,224,123,0,231,56,138,0,4998
"08005086700",3168,13,114,0,839,0,108,0,4242
"08005086800",2692,788,588,970,578,32,305,206,6159
"08005086900",1084,304,658,370,471,219,224,16,3346
"08005087000",2186,557,1016,242,619,101,878,183,5782
"08005087100",1507,193,413,76,243,47,548,61,3088
"08005087200",2160,269,609,391,678,33,217,23,4380
"08005087300",4041,816,880,268,1327,310,1876,530,10048
"08007940400",947,154,10,0,155,8,219,8,1501
"08007974200",4468,280,7,5,475,177,742,245,6399
"08007974300",2642,294,22,0,184,184,505,172,4003
"08007974400",1572,153,21,0,158,72,214,71,2261
"08009964600",1430,195,0,0,13,24,190,30,1882
"08009964700",1528,325,13,29,43,15,116,12,2081
"08011966700",2923,660,0,0,202,43,956,364,5148
"08013012101",4122,471,0,0,206,38,106,0,4943
"08013012102",5511,812,0,9,302,288,514,256,7692
"08013012103",3082,316,28,63,276,45,131,63,4004
"08013012104",2055,290,0,0,184,50,214,40,2833
"08013012105",4320,597,31,0,631,14,1024,313,6930
"08013012201",2620,944,7,0,57,10,50,20,3708
"08013012202",3193,2207,40,84,702,86,623,140,7075
"08013012203",3890,1337,16,0,788,227,767,663,7688
"08013012204",1745,1549,29,20,82,63,114,67,3669
"08013012300",523,272,18,34,559,185,61,12,1664
"08013012401",1844,3211,23,0,231,175,120,415,6019
"08013012501",1892,289,14,0,222,89,102,96,2704
"08013012505",3358,437,0,0,244,32,124,11,4206
"08013012507",2538,1124,0,16,255,138,196,22,4289
"08013012508",2219,458,0,68,250,59,86,32,3172
"08013012509",2813,237,79,0,253,37,142,12,3573
"08013012510",4093,272,0,0,338,7,66,0,4776
"08013012511",2709,634,13,15,385,302,212,174,4444
"08013012603",2802,400,0,0,88,8,48,202,3548
"08013012605",710,567,0,0,307,102,97,10,1793
"08013012607",1815,1974,67,73,588,265,180,138,5100
"08013012608",1914,395,61,0,124,19,320,36,2869
"08013012701",5205,133,12,0,235,0,72,15,5672
"08013012705",2982,274,68,12,333,44,180,126,4019
"08013012707",1555,333,0,0,38,4,172,177,2279
"08013012708",4587,283,54,0,269,0,184,61,5438
"08013012709",1758,28,9,0,36,0,138,0,1969
"08013012710",3242,192,0,0,62,270,229,259,4254
"08013012800",9955,292,152,0,863,15,716,0,11993
"08013012903",2050,56,11,0,209,6,163,7,2502
"08013012904",4739,203,27,0,593,49,179,0,5790
"08013012905",1733,350,26,0,299,52,441,96,2997
"08013012907",2367,101,34,0,423,50,261,81,3317
"08013013003",4547,507,41,0,208,51,133,0,5487
"08013013004",3005,159,0,0,364,18,87,56,3689
"08013013005",2824,419,12,0,82,11,242,126,3716
"08013013006",4626,149,0,0,341,14,288,0,5418
"08013013201",1273,157,0,3,85,0,133,1,1652
"08013013202",1249,145,23,0,50,10,43,52,1572
"08013013205",5167,184,0,26,218,26,221,0,5842
"08013013207",3592,429,16,0,318,54,303,251,4963
"08013013208",4478,443,0,81,348,102,231,0,5683
"08013013210",3745,512,48,57,406,244,1541,509,7062
"08013013211",4545,889,0,5,200,648,652,1150,8089
"08013013212",3830,224,7,4,523,36,636,16,5276
"08013013213",6050,717,61,72,1110,13,481,482,8986
"08013013302",3820,244,38,11,358,63,308,65,4907
"08013013305",3495,461,6,0,544,19,959,176,5660
"08013013306",3367,585,6,0,392,348,1334,615,6647
"08013013307",2259,428,36,0,344,165,389,296,3917
"08013013308",2370,514,42,0,246,210,376,333,4091
"08013013401",1854,866,0,9,439,301,733,778,4980
"08013013402",5974,421,24,0,1287,95,2071,248,10120
"08013013503",2892,1156,137,17,1084,375,1846,1029,8536
"08013013505",2337,923,142,12,764,690,1378,1252,7498
"08013013506",3304,288,0,0,503,19,470,252,4836
"08013013507",2497,216,0,46,478,29,900,157,4323
"08013013508",5552,212,164,0,541,56,821,0,7346
"08013013601",3403,380,31,0,199,17,184,54,4268
"08013013602",920,19,2,0,46,0,0,0,987
"08013013701",5862,427,52,13,292,16,152,45,6859
"08013013702",4825,647,0,3,79,96,209,1,5860
"08013060600",3876,301,16,0,1123,132,395,24,5867
"08013060700",2734,109,0,0,301,4,147,13,3308
"08013060800",3964,1057,35,0,1081,82,1368,580,8167
"08013060900",3862,269,0,0,266,85,471,102,5055
"08013061300",2661,5,67,0,856,0,457,0,4046
"08013061400",3131,46,32,0,611,0,44,0,3864
"08014030000",2709,180,20,0,336,101,437,35,3818
"08014030100",1824,214,29,0,294,0,227,33,2621
"08014030200",1533,185,0,0,38,10,127,0,1893
"08014030300",2737,436,25,0,324,51,360,174,4107
"08014030400",3195,113,0,0,223,0,350,0,3881
"08014030500",4146,192,81,0,1133,73,550,0,6175
"08014030600",5016,261,109,0,1090,38,1375,0,7889
"08014030700",2431,247,33,7,308,51,357,0,3434
"08014030800",5038,193,0,12,449,62,734,70,6558
"08014030900",4991,259,29,0,768,15,363,59,6484
"08014031000",4382,147,43,119,416,0,408,13,5528
"08014031100",2121,224,0,0,260,18,188,0,2811
"08014031200",3173,168,27,26,417,226,562,117,4716
"08014031300",2009,42,0,0,72,0,30,11,2164
"08014031400",2733,47,30,0,350,0,143,14,3317
"08014980100",0,0,0,0,0,0,0,0,0
"08014980200",0,0,0,0,0,0,0,0,0
"08014980300",0,0,0,0,0,0,0,0,0
"08015000100",2185,143,0,0,174,13,221,82,2818
"08015000200",3650,477,15,0,196,0,396,66,4800
"08015000300",3166,209,8,0,53,3,204,37,3680
"08015000401",3926,361,0,0,134,79,158,44,4702
"08015000402",1897,195,54,0,42,0,80,0,2268
"08017960600",1864,174,3,0,50,8,234,88,2421
"08019014700",4104,430,53,0,249,0,124,0,4960
"08019014800",1545,120,7,46,22,48,60,101,1949
"08019014900",2095,182,3,0,38,2,127,0,2447
"08021974800",2530,836,3,0,377,111,1656,787,6300
"08021974900",3443,555,0,5,303,15,1709,296,6326
"08023972600",1256,511,0,0,180,41,611,407,3006
"08023972700",1115,325,0,0,134,16,1041,261,2892
"08025969600",2667,985,4,0,204,152,792,364,5168
"08027970100",3390,670,34,57,50,19,87,43,4350
"08029964600",3196,545,0,0,141,86,267,48,4283
"08029964700",3092,559,0,4,161,19,252,105,4192
"08029964800",2750,372,0,0,80,12,484,190,3888
"08029964900",4161,962,0,0,123,0,769,236,6251
"08029965000",4046,554,0,0,64,12,404,136,5216
"08029965100",2960,638,0,4,203,140,477,285,4707
"08029965200",3329,776,33,3,94,52,372,97,4756
"08031000102",2485,206,16,15,293,37,761,72,3885
"08031000201",2928,311,7,4,518,90,2122,232,6212
"08031000202",2576,764,17,37,309,282,1573,798,6356
"08031000301",4377,498,0,19,400,11,1440,254,6999
"08031000302",3673,49,63,238,136,26,500,33,4718
"08031000303",3894,455,14,0,173,16,601,230,5383
"08031000401",2217,558,96,23,520,155,781,536,4886
"08031000402",3855,714,103,25,162,114,702,461,6136
"08031000501",1615,146,25,0,106,39,271,53,2255
"08031000502",3417,850,85,571,753,0,1150,597,7423
"08031000600",1358,522,87,30,501,71,973,365,3907
"08031000701",2318,753,51,150,282,271,1353,659,5837
"08031000702",2314,1593,142,407,440,448,1343,1408,8095
"08031000800",109,471,51,283,61,436,87,621,2119
"08031000902",3138,877,119,0,712,500,2533,1126,9005
"08031000903",3676,1664,97,0,508,365,3221,1846,11377
"08031000904",2689,1560,15,74,543,115,2322,1376,8694
"08031000905",2237,975,45,25,436,128,2047,847,6740
"08031001000",2096,538,137,58,397,418,1818,918,6380
"08031001101",1441,546,46,97,514,116,1258,531,4549
"08031001102",2480,346,22,210,246,17,923,124,4368
"08031001301",2675,480,1,38,1108,612,2716,960,8590
"08031001302",2395,576,38,0,790,158,2124,606,6687
"08031001401",3422,813,38,30,828,983,2922,1573,10609
"08031001402",1746,535,337,13,837,718,1657,876,6719
"08031001403",1911,274,115,179,390,141,596,222,3828
"08031001500",1613,649,52,38,197,560,1212,1014,5335
"08031001600",5832,1655,297,630,429,232,990,807,10872
"08031001701",3593,640,24,40,327,71,315,102,5112
"08031001702",2117,509,156,136,244,61,226,74,3523
"08031001800",2019,652,35,56,316,77,817,308,4280
"08031001901",975,564,230,231,178,391,541,602,3712
"08031001902",58,9,0,0,13,0,0,1,81
"08031002000",1503,134,53,50,140,0,112,7,1999
"08031002100",3191,1232,91,58,544,522,720,1421,7779
"08031002300",3549,577,1091,770,287,195,803,669,7941
"08031002402",888,195,277,139,130,110,60,182,1981
"08031002403",1801,537,345,282,394,68,560,135,4122
"08031002601",2033,586,67,135,166,62,162,77,3288
"08031002602",1698,346,76,40,199,120,63,142,2684
"08031002701",3011,725,86,66,747,111,692,130,5568
"08031002702",4203,666,106,25,503,123,355,3,5984
"08031002703",3819,567,32,275,226,59,258,242,5478
"08031002801",2411,298,24,0,215,0,263,51,3262
"08031002802",3646,550,14,40,108,103,430,228,5119
"08031002803",3572,385,82,0,209,13,109,54,4424
"08031002901",2288,297,62,18,148,116,146,42,3117
"08031002902",3674,106,38,1,251,0,287,9,4366
"08031003001",4581,371,78,0,377,99,229,35,5770
"08031003002",2058,257,32,11,128,7,105,71,2669
"08031003003",1594,373,0,0,53,77,76,105,2278
"08031003004",3341,830,194,18,604,217,273,65,5542
"08031003101",873,47,206,84,109,1,121,7,1448
"08031003102",1513,618,130,334,200,61,211,211,3278
"08031003201",4041,516,82,139,375,70,346,50,5619
"08031003202",2198,397,114,13,115,22,155,10,3024
"08031003203",2792,77,0,0,220,0,71,9,3169
"08031003300",3029,111,36,0,108,50,128,13,3475
"08031003401",2137,143,20,0,41,0,23,14,2378
"08031003402",4087,307,9,0,335,8,269,123,5138
"08031003500",3034,1482,180,216,1007,647,3328,2028,11922
"08031003601",2695,934,355,278,416,179,1867,943,7667
"08031003602",1847,594,909,383,621,159,1527,485,6525
"08031003603",1502,95,937,208,175,52,391,39,3399
"08031003701",2226,239,70,30,111,29,201,123,3029
"08031003702",3234,612,219,75,295,68,254,147,4904
"08031003703",2063,139,108,88,190,50,167,55,2860
"08031003800",5052,544,11,12,346,23,246,43,6277
"08031003901",4421,123,33,0,47,0,143,29,4796
"08031003902",3881,367,36,3,294,0,313,19,4913
"08031004002",3099,153,23,5,100,8,102,5,3495
"08031004003",3563,202,405,0,237,15,180,8,4610
"08031004004",1750,43,57,0,61,14,23,0,1948
"08031004005",1686,739,87,0,359,125,116,88,3200
"08031004006",3385,575,37,25,214,277,191,33,4737
"08031004101",1459,402,850,883,783,103,1017,356,5853
"08031004102",793,323,1654,549,633,124,848,108,5032
"08031004103",3567,35,1194,314,86,296,140,319,5951
"08031004104",1847,222,1587,270,416,135,549,145,5171
"08031004106",7543,166,144,53,726,0,390,0,9022
"08031004107",3543,238,450,52,517,7,326,10,5143
"08031004201",3867,310,207,46,232,66,549,79,5356
"08031004202",2849,140,347,15,319,15,315,13,4013
"08031004301",2953,582,358,49,436,0,413,63,4854
"08031004302",1875,200,110,0,216,22,175,36,2634
"08031004303",3603,177,78,0,179,0,77,23,4137
"08031004304",4745,434,176,68,330,51,663,93,6560
"08031004306",4163,198,237,17,244,61,103,21,5044
"08031004403",1942,846,593,247,478,176,636,718,5636
"08031004404",2281,950,617,1254,964,901,971,750,8688
"08031004405",6045,581,516,290,640,112,536,384,9104
"08031004503",2310,1496,0,0,741,395,2435,1818,9195
"08031004504",1922,418,16,0,847,688,2103,884,6878
"08031004505",1845,1451,1,3,668,475,2051,1652,8146
"08031004506",1308,834,62,176,893,291,1694,966,6224
"08031004601",3392,692,0,11,1259,488,2879,964,9685
"08031004602",3651,671,13,26,2483,522,4558,995,12919
"08031004603",3451,407,14,38,1032,847,2596,939,9324
"08031004700",3955,769,0,0,1573,260,2871,893,10321
"08031004801",2173,235,0,0,663,90,1087,199,4447
"08031005001",1572,242,67,332,340,0,149,83,2785
"08031005002",3511,705,1178,636,1066,137,612,101,7946
"08031005102",3149,122,87,23,111,165,467,165,4289
"08031005104",2017,528,133,18,365,206,763,179,4209
"08031005200",2462,194,222,0,262,104,301,29,3574
"08031005300",825,144,91,68,213,0,115,63,1519
"08031005502",1095,126,11,89,384,31,562,129,2427
"08031005503",3529,291,17,19,576,135,1238,141,5946
"08031006701",2189,286,44,0,177,17,95,15,2823
"08031006804",1915,61,71,0,136,9,134,0,2326
"08031006809",4682,447,796,75,919,42,708,0,7669
"08031006810",3804,60,662,71,459,75,490,31,5652
"08031006811",3999,261,619,32,962,59,566,42,6540
"08031006812",2679,109,72,13,251,18,165,10,3317
"08031006813",2362,568,610,278,395,125,338,68,4744
"08031006814",3043,216,469,95,433,0,1122,59,5437
"08031006901",2282,633,402,161,798,595,730,438,6039
"08031007006",1645,941,472,74,1178,192,806,567,5875
"08031007013",2250,265,501,15,243,24,346,10,3654
"08031007037",1466,646,691,531,557,200,998,707,5796
"08031007088",2886,382,330,260,467,118,689,85,5217
"08031007089",3397,316,509,46,283,264,232,300,5347
"08031008304",2100,381,451,351,483,110,2085,475,6436
"08031008305",1700,589,767,300,474,466,1713,1007,7016
"08031008306",1637,1148,1121,679,1270,493,2433,1694,10475
"08031008312",2460,1190,1015,681,1276,560,2536,1523,11241
"08031008386",2094,510,783,130,841,277,2311,768,7714
"08031008387",2975,719,986,521,1354,52,3314,515,10436
"08031008388",4046,279,1773,131,898,41,3137,190,10495
"08031008389",4883,187,2388,158,1308,38,2977,111,12050
"08031008390",3559,326,2044,620,2286,257,3111,427,12630
"08031008391",3891,85,1883,249,1963,0,3611,85,11767
"08031011902",5445,530,18,214,838,156,2902,487,10590
"08031011903",2104,323,0,0,133,0,770,229,3559
"08031012001",1468,165,91,15,299,41,335,70,2484
"08031012010",3910,262,35,0,573,0,808,37,5625
"08031012014",4700,473,0,0,993,0,1149,62,7377
"08031015300",2267,316,306,25,396,94,360,65,3829
"08031015400",2714,332,59,2,256,322,886,215,4786
"08031015500",2058,523,108,55,511,110,682,193,4240
"08031015600",2112,1409,1,184,1795,874,2444,2047,10866
"08031015700",3041,467,49,0,1532,313,2561,402,8365
"08031980000",569,63,335,62,136,76,205,49,1495
"08031980100",0,0,0,0,0,0,0,0,0
"08033000100",1314,327,0,0,67,20,108,11,1847
"08035013901",6265,173,26,0,302,14,149,0,6929
"08035013904",3511,363,53,7,176,39,382,84,4615
"08035013905",3494,58,119,0,136,27,148,28,4010
"08035013907",4379,376,13,32,429,33,401,24,5687
"08035013908",6160,142,0,0,184,0,173,0,6659
"08035013909",5829,191,15,0,356,13,235,118,6757
"08035013910",5740,149,76,0,237,0,358,34,6594
"08035013911",5419,320,11,0,746,33,540,33,7102
"08035014001",6018,77,0,0,433,40,1176,0,7744
"08035014005",4241,128,0,0,349,115,347,0,5180
"08035014006",5191,64,126,8,445,53,306,9,6202
"08035014007",1675,255,57,0,212,17,165,0,2381
"08035014008",5511,252,19,0,404,22,526,0,6734
"08035014009",3185,85,23,0,232,71,226,0,3822
"08035014010",4848,38,62,21,525,0,331,0,5825
"08035014011",1537,37,24,0,394,24,96,0,2112
"08035014012",6663,421,130,0,797,133,1004,133,9281
"08035014013",3654,43,152,0,447,0,232,1,4529
"08035014107",3280,111,0,0,142,0,154,9,3696
"08035014108",4698,94,0,0,181,46,247,0,5266
"08035014109",2328,100,33,0,67,5,109,0,2642
"08035014110",4621,376,0,0,352,95,339,165,5948
"08035014112",3787,63,80,0,158,0,281,0,4369
"08035014113",2886,66,23,0,229,0,198,9,3411
"08035014114",3093,31,38,0,320,76,373,0,3931
"08035014115",3695,322,0,0,413,28,211,64,4733
"08035014116",3557,167,119,0,1128,207,445,84,5707
"08035014122",6455,183,53,0,375,16,362,16,7460
"08035014123",2227,413,42,0,111,66,219,261,3339
"08035014124",4922,91,41,0,240,0,454,0,5748
"08035014125",2361,123,0,0,105,0,35,0,2624
"08035014126",1199,29,0,0,221,85,142,3,1679
"08035014127",4948,0,42,0,459,36,485,0,5970
"08035014128",4225,80,8,0,442,0,444,0,5199
"08035014129",3280,248,91,0,220,0,149,0,3988
"08035014130",7496,51,173,0,494,87,635,0,8936
"08035014131",3149,52,0,0,290,0,197,0,3688
"08035014132",5092,63,40,22,700,0,126,0,6043
"08035014133",5819,274,96,0,626,0,433,47,7295
"08035014134",4872,167,54,0,959,40,536,32,6660
"08035014135",2672,43,0,0,169,0,192,0,3076
"08035014136",7268,198,104,0,662,383,1052,14,9681
"08035014137",7682,201,110,0,1615,55,360,24,10047
"08035014138",2969,169,20,19,412,0,441,0,4030
"08035014139",3446,53,19,0,396,0,278,0,4192
"08035014140",5184,169,45,0,427,29,276,0,6130
"08035014202",1651,139,0,0,52,0,46,33,1921
"08035014203",6058,75,139,0,464,0,643,0,7379
"08035014204",2609,35,86,0,179,4,398,11,3322
"08035014300",705,29,0,0,17,0,46,0,797
"08035014403",4523,197,35,0,243,0,488,23,5509
"08035014404",2283,125,44,0,87,0,77,57,2673
"08035014405",7122,335,9,0,557,42,757,119,8941
"08035014406",8018,63,143,8,576,0,548,0,9356
"08035014503",5146,175,75,0,168,0,779,48,6391
"08035014504",3354,789,27,13,277,78,410,42,4990
"08035014505",3911,81,30,26,167,0,340,0,4555
"08035014506",3122,201,7,0,174,0,159,83,3746
"08035014602",2200,65,25,0,61,0,59,0,2410
"08035014603",6941,203,15,0,163,0,663,32,8017
"08035014604",3460,440,0,0,185,11,321,245,4662
"08037000100",1241,194,0,0,32,122,716,277,2582
"08037000200",5654,437,0,0,602,0,2570,325,9588
"08037000301",4943,185,46,0,666,128,2506,157,8631
"08037000302",1871,159,0,0,244,0,375,45,2694
"08037000401",4259,385,0,0,123,561,1111,796,7235
"08037000402",2764,422,28,0,579,0,979,350,5122
"08037000403",7578,268,0,20,282,0,870,179,9197
"08037000501",642,91,4,1,124,0,80,24,966
"08037000502",3141,458,100,0,76,0,226,280,4281
"08037000503",4644,842,171,1,351,333,1825,1115,9282
"08037000600",1079,88,71,0,136,38,357,55,1824
"08037000701",1031,8,0,0,0,0,0,0,1039
"08037000702",1284,35,53,39,65,3,32,0,1511
"08037000703",2455,348,0,0,338,0,244,10,3395
"08039961100",1523,198,22,0,48,35,16,18,1860
"08039961204",6523,245,27,0,292,2,519,5,7613
"08039961205",1486,252,0,0,51,14,44,69,1916
"08039961206",2960,88,0,32,127,65,166,0,3438
"08039961207",3606,46,23,0,26,27,238,7,3973
"08039961208",2837,574,12,0,68,0,144,69,3704
"08039961209",1895,134,0,0,150,0,64,0,2243
"08041000101",3635,453,196,132,763,213,815,117,6324
"08041000102",2867,288,10,0,307,18,335,48,3873
"08041000202",3514,649,184,26,272,130,445,223,5443
"08041000203",2847,471,21,43,231,190,231,183,4217
"08041000301",2305,322,26,0,209,310,360,349,3881
"08041000302",2319,844,111,0,313,111,522,170,4390
"08041000400",1930,166,29,75,112,36,154,77,2579
"08041000500",1649,367,0,0,56,36,88,34,2230
"08041000600",2736,699,152,0,19,0,388,225,4219
"08041000700",1819,625,120,137,318,153,287,263,3722
"08041000800",2024,235,29,0,292,116,193,102,2991
"08041000900",1830,403,21,1,176,3,108,6,2548
"08041001000",1992,111,10,35,128,10,75,43,2404
"08041001101",899,162,0,11,30,26,108,71,1307
"08041001104",2236,308,8,49,438,42,579,115,3775
"08041001301",1808,378,0,5,139,0,196,97,2623
"08041001302",3839,735,91,0,218,68,287,200,5438
"08041001400",2660,593,25,2,272,39,296,47,3934
"08041001500",1673,226,43,12,205,7,187,28,2381
"08041001600",1081,246,47,0,182,50,184,44,1834
"08041001700",1183,442,104,17,234,138,183,123,2424
"08041001800",1598,183,18,48,125,22,164,32,2190
"08041001900",2753,611,247,63,407,103,521,228,4933
"08041002000",4014,963,230,210,961,655,901,845,8779
"08041002101",2166,453,119,36,429,156,509,205,4073
"08041002102",2561,569,457,88,830,461,1120,616,6702
"08041002200",1684,265,163,89,334,106,304,72,3017
"08041002300",671,545,73,46,152,95,184,105,1871
"08041002400",3238,683,91,270,215,370,400,558,5825
"08041002501",2893,192,35,0,88,8,119,83,3418
"08041002502",2907,322,141,7,468,50,545,76,4516
"08041002700",1684,555,199,50,338,82,542,198,3648
"08041002800",2835,404,547,117,1402,234,1834,456,7829
"08041002900",2928,1396,566,513,344,529,1222,1064,8562
"08041003000",3455,511,141,50,403,75,425,139,5199
"08041003100",3771,135,62,7,177,33,171,33,4389
"08041003303",3359,1413,150,119,542,62,887,408,6940
"08041003305",6251,147,106,64,605,16,437,60,7686
"08041003306",2621,420,49,0,116,39,60,132,3437
"08041003307",2608,221,96,258,402,6,471,9,4071
"08041003308",3762,260,519,28,1435,94,1177,87,7362
"08041003400",2904,334,59,10,184,151,190,62,3894
"08041003701",6753,179,15,0,398,167,602,166,8280
"08041003702",4270,202,102,0,417,6,307,6,5310
"08041003705",4261,224,116,1,750,81,340,66,5839
"08041003706",4187,234,20,120,232,9,308,21,5131
"08041003707",3514,187,157,41,230,43,275,0,4447
"08041003708",2258,72,81,71,273,110,371,0,3236
"08041003709",4843,434,131,57,400,130,348,182,6525
"08041003801",1036,125,206,0,172,40,205,9,1793
"08041003802",0,0,0,0,0,0,0,0,0
"08041003902",9019,329,513,12,1068,10,1383,0,12334
"08041003905",2784,229,103,0,194,0,397,37,3744
"08041003906",5653,86,216,21,394,127,454,83,7034
"08041003909",5556,717,155,46,199,42,329,61,7105
"08041004008",935,34,24,0,157,10,367,5,1532
"08041004009",829,208,294,68,260,95,358,112,2224
"08041004100",3405,532,268,61,697,84,524,259,5830
"08041004200",2915,370,127,34,531,73,784,157,4991
"08041004300",3892,711,447,106,1093,285,1313,310,8157
"08041004401",5511,1371,789,67,1194,176,1007,463,10578
"08041004402",156,128,123,0,0,0,18,0,425
"08041004403",267,30,193,0,204,0,129,0,823
"08041004501",2168,761,89,163,777,269,1020,328,5575
"08041004502",3517,165,511,20,561,195,718,50,5737
"08041004503",7993,571,1573,32,1728,125,1962,156,14140
"08041004506",3005,508,297,0,681,93,701,119,5404
"08041004507",2187,151,389,0,365,23,630,25,3770
"08041004508",4148,690,274,206,429,52,794,46,6639
"08041004510",5708,367,803,53,1244,49,1244,30,9498
"08041004511",5891,513,428,2,1003,131,1351,41,9360
"08041004601",3178,429,14,0,168,0,319,93,4201
"08041004602",2872,512,40,0,276,37,125,99,3961
"08041004603",3646,454,429,0,707,97,532,226,6091
"08041004701",3810,233,87,40,255,152,483,62,5122
"08041004702",2042,51,55,0,295,11,192,11,2657
"08041004703",5365,93,122,62,487,11,637,0,6777
"08041004705",6073,172,394,0,768,26,626,0,8059
"08041004706",4205,208,88,140,512,25,526,79,5783
"08041004800",4038,523,192,42,465,153,866,220,6499
"08041004901",2436,217,102,0,898,42,1058,14,4767
"08041004902",4559,332,230,0,504,12,532,1,6170
"08041005000",3541,699,296,0,836,79,781,147,6379
"08041005104",5872,442,419,84,486,0,1113,77,8493
"08041005105",5246,433,182,188,858,0,680,17,7604
"08041005106",7812,635,336,28,1021,555,872,403,11662
"08041005107",5915,387,526,0,932,0,1411,16,9187
"08041005108",6669,372,476,0,1102,102,879,44,9644
"08041005109",5479,632,337,16,1067,70,897,17,8515
"08041005110",2821,324,261,25,564,62,789,108,4954
"08041005111",4454,354,645,29,863,163,1129,21,7658
"08041005201",1431,807,423,161,781,400,1000,686,5689
"08041005202",1182,323,408,162,273,97,278,50,2773
"08041005300",1781,661,607,308,725,577,558,656,5873
"08041005400",1713,770,563,69,1882,905,1543,851,8296
"08041005501",3484,261,126,0,638,187,471,187,5354
"08041005502",2850,331,305,124,482,714,617,729,6152
"08041005601",4151,381,128,0,293,25,385,116,5479
"08041005602",2478,212,99,72,118,0,326,1,3306
"08041005700",4073,680,385,48,965,16,760,90,7017
"08041005800",2615,207,92,37,127,57,314,49,3498
"08041005900",4824,403,841,0,749,47,758,181,7803
"08041006000",3571,830,178,78,1055,773,1033,766,8284
"08041006100",1378,721,168,284,711,953,1029,1177,6421
"08041006200",2577,1108,575,60,972,655,1117,1169,8233
"08041006301",3083,433,612,115,625,209,1566,290,6933
"08041006302",2436,1030,413,543,957,304,1340,940,7963
"08041006400",3617,868,1056,578,1281,117,1936,553,10006
"08041006501",2030,317,370,121,573,268,943,394,5016
"08041006502",3161,654,786,69,1015,505,1434,721,8345
"08041006600",2199,196,0,0,102,40,109,67,2713
"08041006700",4578,811,31,29,250,28,214,116,6057
"08041006801",3340,403,73,11,347,0,501,11,4686
"08041006802",3154,36,201,0,301,122,327,28,4169
"08041006901",4493,325,233,80,433,12,523,39,6138
"08041006902",4377,149,86,36,646,24,394,32,5744
"08041007000",3679,71,108,12,473,0,203,9,4555
"08041007101",4550,353,323,0,779,27,670,70,6772
"08041007102",7381,412,419,0,1020,0,625,185,10042
"08041007201",5573,281,105,0,839,215,632,41,7686
"08041007202",8364,92,67,22,638,26,326,26,9561
"08041007300",8720,457,94,1,548,56,339,1,10216
"08041007400",7554,206,58,0,509,0,501,0,8828
"08041007500",7211,263,0,0,385,25,187,14,8085
"08041007601",5361,367,125,0,362,13,557,4,6789
"08041007602",2777,271,29,0,355,16,306,16,3770
"08041007700",4237,463,146,54,454,81,689,62,6186
"08041007800",3114,319,145,11,226,60,215,0,4090
"08041007900",1954,87,87,0,160,0,98,19,2405
"08041008000",2949,664,72,82,336,96,401,226,4826
"08043978100",2889,634,0,0,179,13,160,95,3970
"08043978200",2542,752,0,1,303,7,418,128,4151
"08043978300",3840,1041,35,0,149,15,246,7,5333
"08043978400",1488,318,2,2,80,5,188,92,2175
"08043978500",3909,937,0,0,120,21,136,45,5168
"08043978600",1760,844,0,4,105,29,130,25,2897
"08043978800",2017,603,0,0,42,0,130,78,2870
"08043979000",3337,282,0,0,61,0,43,0,3723
"08043979100",2452,442,0,3,218,76,64,140,3395
"08043979200",1767,10,0,0,64,52,17,0,1910
"08043979400",1914,169,5,0,158,14,120,4,2384
"08043980100",0,0,0,0,0,0,0,0,0
"08043980200",0,0,0,0,0,0,0,0,0
"08043980300",0,0,0,0,0,0,0,0,0
"08045951600",3076,308,0,2,414,0,1098,31,4929
"08045951701",3140,171,58,139,156,184,730,320,4898
"08045951702",2780,548,0,0,192,212,619,328,4679
"08045951802",3491,97,2,0,340,22,1182,51,5185
"08045951803",4268,980,0,0,659,1,1718,630,8256
"08045951804",3031,227,0,0,675,0,851,0,4784
"08045951901",3331,495,13,0,572,0,1129,162,5702
"08045951902",5814,562,21,1,458,41,1673,354,8924
"08045952001",3439,495,46,0,549,468,1352,653,7002
"08045952002",6387,700,0,0,575,0,1134,149,8945
"08045952100",5258,763,34,0,323,87,1063,355,7883
"08047013800",4600,496,14,0,324,72,410,30,5946
"08049000100",2195,361,0,0,324,154,444,90,3568
"08049000201",4244,293,77,0,170,5,150,62,5001
"08049000202",5224,896,14,0,411,27,326,18,6916
"08051963600",3275,350,0,0,33,59,59,165,3941
"08051963700",3386,1782,0,0,148,0,504,349,6169
"08051963800",4145,259,8,0,168,8,101,1,4690
"08051963900",753,95,14,0,51,17,31,4,965
"08053973100",793,61,0,0,13,4,19,0,890
"08055960600",1413,324,0,0,660,383,1180,505,4465
"08055960900",2756,453,0,0,123,64,359,125,3880
"08057955600",1159,121,0,0,15,82,163,84,1624
"08059009806",3241,145,23,4,171,46,97,11,3738
"08059009807",1333,112,5,0,31,0,157,0,1638
"08059009808",4694,266,0,0,430,0,476,14,5880
"08059009815",4757,144,0,0,213,28,274,92,5508
"08059009823",4209,231,0,0,226,0,488,34,5188
"08059009824",4086,375,13,7,534,0,652,10,5677
"08059009827",4860,289,45,0,1030,0,546,0,6770
"08059009828",4759,258,0,0,491,7,960,109,6584
"08059009829",1786,23,4,0,82,20,140,0,2055
"08059009830",1760,115,3,33,221,0,200,34,2366
"08059009831",1623,198,104,7,87,110,289,60,2478
"08059009832",2229,182,43,0,170,0,527,16,3167
"08059009833",4510,555,53,9,268,147,795,169,6506
"08059009834",3687,602,46,7,343,0,509,180,5374
"08059009835",3284,187,0,0,64,32,293,24,3884
"08059009836",3697,98,7,0,169,0,188,21,4180
"08059009837",2406,35,13,0,60,2,102,15,2633
"08059009838",4084,60,0,11,215,12,145,23,4550
"08059009839",2206,48,0,12,162,0,176,25,2629
"08059009840",3380,184,22,0,78,0,252,0,3916
"08059009841",2173,114,19,0,70,0,310,59,2745
"08059009842",2432,191,0,0,284,30,157,8,3102
"08059009843",7294,287,0,0,329,15,362,4,8291
"08059009845",3758,81,0,0,230,0,44,0,4113
"08059009846",4387,97,0,0,70,12,117,0,4683
"08059009847",2702,207,0,0,92,0,56,12,3069
"08059009848",1905,163,22,0,84,0,67,46,2287
"08059009849",4627,775,0,13,350,231,494,27,6517
"08059009850",2408,84,2,0,134,2,181,0,2811
"08059009851",3383,136,10,0,267,0,145,33,3974
"08059009852",3234,260,0,0,325,6,132,54,4011
"08059009900",1905,258,0,12,91,26,275,24,2591
"08059010000",1701,691,0,41,205,123,103,62,2926
"08059010100",3384,442,79,0,161,44,272,76,4458
"08059010205",2171,201,1,0,69,0,54,64,2560
"08059010206",3496,360,0,0,307,14,342,206,4725
"08059010208",4350,359,0,0,889,349,1260,180,7387
"08059010209",4653,351,184,0,795,147,1179,335,7644
"08059010210",2945,260,0,9,262,18,261,0,3755
"08059010211",2694,380,43,0,150,20,472,70,3829
"08059010212",3760,658,49,0,227,11,512,409,5626
"08059010213",3358,599,72,54,490,111,868,271,5823
"08059010303",4803,291,14,0,216,22,560,3,5909
"08059010304",2654,64,0,0,145,18,190,0,3071
"08059010305",2962,503,89,1,107,79,384,215,4340
"08059010306",2420,122,13,8,194,2,301,22,3082
"08059010307",4271,438,0,0,276,44,905,63,5997
"08059010308",5032,359,2,0,135,60,470,101,6159
"08059010402",3714,743,48,0,375,199,832,292,6203
"08059010403",3507,1080,0,0,463,127,723,579,6479
"08059010405",1375,407,85,15,122,33,262,88,2387
"08059010406",1524,571,5,0,331,35,899,424,3789
"08059010502",4261,575,0,23,390,37,952,288,6526
"08059010503",3940,485,0,0,303,68,843,74,5713
"08059010504",2702,7,0,0,89,0,167,0,2965
"08059010603",2596,320,1,9,293,30,710,134,4093
"08059010604",1909,226,18,0,124,21,547,51,2896
"08059010701",3614,237,0,0,175,22,660,47,4755
"08059010702",3232,1238,14,0,443,146,1095,958,7126
"08059010801",2311,114,0,0,74,34,329,99,2961
"08059010901",3653,504,18,0,246,0,400,19,4840
"08059010902",1652,483,24,21,251,33,618,262,3344
"08059011000",3614,870,30,0,311,245,946,168,6184
"08059011100",4301,1038,52,2,511,71,1444,375,7794
"08059011202",3434,322,27,0,447,25,597,9,4861
"08059011300",2410,361,0,21,114,74,453,178,3611
"08059011401",2031,506,532,6,229,45,1235,414,4998
"08059011402",2508,471,66,2,366,222,1005,273,4913
"08059011550",3507,1792,49,20,292,245,1094,935,7934
"08059011601",1910,1307,54,0,333,64,538,1136,5342
"08059011602",2655,1041,14,0,467,94,1120,854,6245
"08059011701",4083,441,46,6,311,0,845,154,5886
"08059011702",4628,458,43,15,518,10,984,163,6819
"08059011708",3351,142,2,0,411,38,694,38,4676
"08059011709",2993,166,62,0,174,25,599,9,4028
"08059011710",2904,191,19,0,348,0,332,0,3794
"08059011711",3423,252,21,0,299,13,381,0,4389
"08059011712",3614,247,43,0,241,6,423,0,4574
"08059011720",4185,282,0,35,443,0,268,18,5231
"08059011721",2319,115,0,0,184,25,220,0,2863
"08059011723",2682,297,35,0,379,46,254,8,3701
"08059011724",4156,154,32,0,409,0,246,0,4997
"08059011725",1413,48,26,0,179,1,117,17,1801
"08059011726",5115,203,25,0,402,0,399,0,6144
"08059011727",3227,125,10,0,194,0,388,28,3972
"08059011728",2315,82,55,0,114,125,241,1,2933
"08059011729",3002,469,0,1,254,63,615,299,4703
"08059011730",2787,328,152,0,148,128,665,226,4434
"08059011731",3367,127,54,0,304,83,729,68,4732
"08059011732",3523,666,119,0,538,63,678,54,5641
"08059011733",932,256,9,27,241,0,218,51,1734
"08059011803",4109,519,65,132,684,86,2032,282,7909
"08059011804",3085,252,23,0,439,53,1041,41,4934
"08059011805",3836,430,136,36,498,41,1564,41,6582
"08059011806",3535,806,117,0,68,40,1330,452,6348
"08059011904",1590,120,40,0,244,0,325,0,2319
"08059011951",2373,307,14,73,216,21,578,114,3696
"08059012022",5410,179,73,0,193,0,610,0,6465
"08059012023",2810,152,62,0,284,0,311,0,3619
"08059012024",4702,232,40,0,218,0,581,0,5773
"08059012026",3062,336,14,0,129,0,120,6,3667
"08059012027",2541,127,9,0,42,0,257,13,2989
"08059012030",3653,123,7,6,30,19,132,0,3970
"08059012031",3503,179,30,0,192,0,449,0,4353
"08059012032",2320,141,0,0,33,4,75,4,2577
"08059012033",2828,29,0,0,83,0,83,0,3023
"08059012034",3406,31,0,0,154,0,274,13,3878
"08059012035",5020,150,21,0,188,42,257,0,5678
"08059012036",3813,16,0,0,194,0,161,0,4184
"08059012037",3152,39,0,0,66,0,148,11,3416
"08059012038",3077,145,73,17,209,0,278,75,3874
"08059012039",4939,152,45,2,412,0,976,0,6526
"08059012041",4434,362,37,1,785,39,866,38,6562
"08059012042",3459,41,24,0,550,28,426,28,4556
"08059012043",4793,208,150,0,217,32,484,0,5884
"08059012044",3125,235,51,0,326,0,480,24,4241
"08059012045",5287,95,7,0,607,0,321,0,6317
"08059012046",1863,68,13,0,183,11,268,17,2423
"08059012047",3425,238,43,0,456,17,646,9,4834
"08059012048",2150,78,0,0,149,19,264,0,2660
"08059012049",2997,44,69,0,521,32,313,4,3980
"08059012050",3076,192,36,0,496,0,347,0,4147
"08059012051",3132,125,24,0,175,23,146,17,3642
"08059012052",4754,392,90,0,276,0,418,0,5930
"08059012053",3451,158,99,86,197,18,481,10,4500
"08059012054",3814,128,0,0,265,9,276,8,4500
"08059012055",3203,56,42,3,135,9,259,12,3719
"08059012057",5256,105,6,0,380,52,431,46,6276
"08059012058",3537,259,8,0,50,0,102,0,3956
"08059012059",2947,208,101,2,40,9,182,0,3489
"08059012060",2842,163,22,0,100,0,236,24,3387
"08059015800",2606,320,0,20,675,35,721,29,4406
"08059015900",2586,199,22,0,184,99,694,85,3869
"08059060300",3726,56,53,0,466,34,392,11,4738
"08059060400",3397,182,24,0,403,0,641,48,4695
"08059060500",3531,165,92,0,650,17,264,18,4737
"08059980000",0,0,0,0,0,0,0,0,0
"08059980400",0,0,0,0,0,0,0,0,0
"08061960100",1122,187,5,0,50,16,78,7,1465
"08063962100",3991,641,0,0,163,58,739,302,5894
"08063962200",1088,248,0,0,28,21,124,152,1661
"08063962300",897,162,2,0,3,5,42,26,1137
"08065961700",4184,368,0,0,258,0,709,43,5562
"08065961900",1437,367,33,0,379,137,1083,307,3743
"08067940300",3657,288,4,2,1647,370,1244,162,7374
"08067940400",4945,392,20,0,266,64,530,44,6261
"08067970600",7665,635,10,0,315,30,636,22,9313
"08067970701",4131,367,12,0,171,11,486,11,5189
"08067970703",4289,315,0,14,839,39,588,55,6139
"08067970704",3197,342,30,0,128,72,192,55,4016
"08067970800",3879,639,0,7,381,135,618,134,5793
"08067970900",3401,405,0,0,213,61,397,0,4477
"08067971000",2454,256,6,2,177,56,33,56,3040
"08067971100",2727,1059,44,0,346,48,541,195,4960
"08069000100",1493,641,16,13,22,44,126,62,2417
"08069000201",1826,1206,9,37,30,88,45,14,3255
"08069000202",1780,504,62,0,147,84,228,103,2908
"08069000300",2495,308,5,13,58,53,100,22,3054
"08069000401",1529,331,5,9,34,72,111,66,2157
"08069000402",1763,637,32,20,128,190,136,230,3136
"08069000503",1499,1974,134,53,356,325,120,231,4692
"08069000504",1475,1205,8,73,319,57,447,114,3698
"08069000505",1356,1635,0,58,197,158,219,325,3948
"08069000506",1870,961,49,15,306,12,277,115,3605
"08069000600",419,457,14,29,86,112,66,76,1259
"08069000700",1799,595,0,0,131,86,62,70,2743
"08069000801",1134,564,0,4,66,15,57,173,2013
"08069000802",926,138,15,0,130,6,235,0,1450
"08069000901",3887,873,0,8,94,14,310,98,5284
"08069000902",2473,521,43,8,177,80,221,177,3700
"08069001003",3990,687,137,0,298,100,294,51,5557
"08069001004",2715,252,0,0,128,0,157,0,3252
"08069001007",2410,573,17,17,334,81,600,122,4154
"08069001008",1490,242,0,0,240,0,220,0,2192
"08069001009",5110,676,0,1,437,10,391,28,6653
"08069001010",2375,57,0,0,45,0,62,0,2539
"08069001104",4512,761,93,0,326,26,857,76,6651
"08069001106",3771,703,152,0,315,66,206,219,5432
"08069001107",4073,735,20,0,358,235,778,89,6288
"08069001109",3989,557,53,0,268,65,389,28,5349
"08069001110",3121,1860,0,0,249,297,477,161,6165
"08069001111",1149,569,18,0,236,125,12,131,2240
"08069001112",3576,384,0,0,357,40,543,172,5072
"08069001113",3055,222,0,10,274,12,253,33,3859
"08069001114",2166,38,25,0,131,10,110,0,2480
"08069001301",3452,503,0,0,225,24,125,196,4525
"08069001304",1447,504,0,0,291,277,918,661,4098
"08069001305",1471,489,0,24,143,111,296,276,2810
"08069001306",1059,374,0,104,238,193,567,148,2683
"08069001307",3578,136,35,0,243,40,505,27,4564
"08069001308",4206,118,17,0,418,25,558,11,5353
"08069001601",1353,242,0,0,115,239,267,146,2362
"08069001602",3791,326,27,0,348,8,370,92,4962
"08069001603",4028,517,63,0,653,24,885,221,6391
"08069001605",2242,164,60,12,247,0,207,39,2971
"08069001606",2367,70,95,0,489,71,126,0,3218
"08069001607",3351,139,10,0,270,0,256,40,4066
"08069001608",4477,136,0,0,743,11,443,0,5810
"08069001704",6315,900,0,0,721,333,1120,291,9680
"08069001706",5357,412,35,0,638,150,826,150,7568
"08069001707",3842,781,14,0,430,142,446,78,5733
"08069001708",2953,114,9,11,225,0,229,0,3541
"08069001709",12723,423,23,0,648,69,881,4,14771
"08069001804",3057,539,0,0,223,73,313,154,4359
"08069001806",6188,511,59,0,627,0,1029,22,8436
"08069001807",4806,159,23,0,317,160,363,160,5988
"08069001808",4461,101,0,0,353,24,110,0,5049
"08069001809",10068,644,171,17,659,44,1061,12,12676
"08069001901",3092,563,0,0,109,140,175,122,4201
"08069001902",3756,251,7,0,232,253,285,40,4824
"08069001903",3437,228,0,0,8,68,56,37,3834
"08069002005",4364,308,23,0,239,161,382,161,5638
"08069002007",2516,418,47,0,31,129,110,152,3403
"08069002008",2908,187,0,0,333,40,369,74,3911
"08069002010",2739,59,8,0,27,0,147,0,2980
"08069002011",4927,142,0,0,130,9,272,0,5480
"08069002300",2856,276,16,0,353,111,308,24,3944
"08069002401",899,341,0,0,10,3,138,0,1391
"08069002402",2242,100,115,0,121,3,124,0,2705
"08069002501",7200,453,16,0,377,126,234,444,8850
"08069002502",7045,427,79,12,698,67,1087,128,9543
"08069002503",2641,524,11,0,159,0,261,373,3969
"08069002600",5817,420,18,0,289,59,417,101,7121
"08069002700",4517,343,44,0,239,52,413,13,5621
"08069002801",2743,479,4,19,38,0,129,39,3451
"08069002802",4993,368,0,10,130,15,281,0,5797
"08069002803",69,11,0,0,0,15,0,15,110
"08071000100",2477,557,60,0,447,56,1468,234,5299
"08071000200",1630,297,34,7,383,30,857,159,3397
"08071000300",1516,309,0,8,317,7,500,128,2785
"08071000400",1317,311,0,0,201,92,808,302,3031
"08071000500",1273,270,0,0,174,116,756,194,2783
"08071000800",1908,200,0,0,158,63,537,122,2988
"08073961700",1719,331,11,0,13,0,89,0,2163
"08073961800",1425,279,0,4,18,6,61,1,1794
"08075965900",1071,70,2,0,13,0,83,14,1253
"08075966000",1884,293,7,0,26,12,94,6,2322
"08075966100",5391,1636,0,0,724,54,912,859,9576
"08075966200",2789,662,0,5,100,37,627,249,4469
"08075966300",3977,662,98,0,424,13,496,26,5696
"08075966400",1351,184,23,0,18,2,7,0,1585
"08077000200",1530,441,0,10,160,98,340,146,2725
"08077000300",1048,266,0,24,133,5,317,18,1811
"08077000400",2604,495,0,0,276,55,359,99,3888
"08077000500",828,452,0,12,5,31,91,25,1444
"08077000601",2950,724,7,69,54,257,282,124,4467
"08077000602",3304,1145,31,14,419,78,606,311,5908
"08077000700",2526,867,45,0,468,368,648,359,5281
"08077000800",6324,1453,38,4,484,56,775,412,9546
"08077000900",1861,347,27,24,109,46,367,47,2828
"08077001001",3885,287,0,0,126,1,156,122,4577
"08077001002",5103,510,0,0,771,86,692,14,7176
"08077001101",6225,1282,7,42,168,85,639,670,9118
"08077001102",4117,472,27,0,143,24,373,168,5324
"08077001200",1902,127,8,0,97,22,132,25,2313
"08077001301",5705,2424,34,8,496,176,1246,659,10748
"08077001302",3814,416,0,0,217,49,582,0,5078
"08077001402",5749,363,0,0,343,0,234,0,6689
"08077001403",3069,257,58,0,180,172,132,164,4032
"08077001404",4177,290,0,0,151,0,333,0,4951
"08077001501",9577,1785,43,0,1028,39,1637,17,14126
"08077001502",6406,424,41,0,151,21,269,21,7333
"08077001600",2846,287,0,0,118,26,249,0,3526
"08077001702",3591,437,13,0,297,39,316,122,4815
"08077001703",3936,694,0,0,156,207,525,295,5813
"08077001705",3795,786,146,0,360,313,1460,371,7231
"08077001706",3807,1651,0,0,367,0,704,648,7177
"08077001707",5232,570,37,0,240,0,856,201,7136
"08077001800",2529,377,0,42,88,57,142,47,3282
"08077001900",4634,332,10,48,78,157,90,2,5351
"08079973600",634,42,3,2,19,4,19,0,723
"08081000300",2722,200,0,0,84,9,68,26,3109
"08081000400",3127,511,0,0,214,146,565,153,4716
"08081000500",3766,328,0,6,160,49,622,115,5046
"08081000600",1290,143,0,0,137,124,126,126,1946
"08083941100",101,25,1,0,768,357,19,39,1310
"08083969000",2596,578,0,0,68,18,107,18,3385
"08083969100",2615,271,0,0,168,89,200,78,3421
"08083969200",2448,421,0,0,79,53,134,169,3304
"08083969300",3834,630,0,4,555,151,408,421,6003
"08083969400",2534,803,0,6,593,454,508,141,5039
"08083969600",3555,609,30,0,642,167,599,118,5720
"08085966100",1823,338,0,0,106,52,101,15,2435
"08085966201",2341,270,71,0,65,0,432,0,3179
"08085966202",3081,778,51,6,261,88,957,320,5542
"08085966300",4083,1170,0,8,248,324,1192,1030,8055
"08085966400",4396,1020,14,9,328,255,729,178,6929
"08085966501",2718,446,0,0,31,0,118,128,3441
"08085966502",2940,519,0,18,183,18,282,150,4110
"08085966503",2523,629,18,0,365,0,592,96,4223
"08085966601",3162,540,12,0,471,112,1327,279,5903
"08085966602",3969,286,0,0,125,29,103,0,4512
"08087000100",2501,43,3,0,2,0,179,0,2728
"08087000200",2208,286,0,0,138,6,352,100,3090
"08087000300",1483,247,0,0,87,21,827,118,2783
"08087000400",3269,652,229,79,301,15,1044,264,5853
"08087000500",1366,367,96,37,187,202,428,388,3071
"08087000600",5346,607,195,0,337,7,3182,515,10189
"08087000700",4362,575,15,0,635,40,1911,178,7716
"08087000800",1434,123,0,2,56,95,111,50,1871
"08089968000",1129,243,0,0,25,25,164,51,1637
"08089968100",1532,1040,6,8,145,105,953,861,4650
"08089968200",2189,441,24,6,174,0,1022,338,4194
"08089968300",3032,651,4,3,95,114,716,377,4992
"08089968400",640,214,0,0,50,12,178,126,1220
"08089968500",1227,130,0,0,64,17,144,73,1655
"08089968600",2661,1260,0,4,384,388,1232,1191,7120
"08091967600",4121,289,0,0,66,45,229,41,4791
"08093000100",5046,331,0,0,230,105,494,33,6239
"08093000200",3542,76,0,0,183,0,115,0,3916
"08093000300",2649,273,0,0,6,13,118,7,3066
"08093000400",948,298,0,0,0,14,0,0,1260
"08093000500",2046,202,0,0,76,17,43,28,2412
"08095967600",2136,601,0,13,169,50,630,449,4048
"08095967700",1147,130,0,0,63,8,9,0,1357
"08097000100",6746,923,0,0,240,3,594,363,8869
"08097000401",3859,185,113,85,132,0,102,0,4476
"08097000402",2441,129,82,0,107,0,367,0,3126
"08097000500",1878,190,5,0,113,0,148,75,2409
"08099000100",1119,88,0,0,92,3,55,38,1395
"08099000200",1396,714,27,0,118,34,727,450,3466
"08099000300",3731,999,0,0,129,58,1313,618,6848
"08099000600",1007,261,0,0,90,4,303,145,1810
"08099000700",1583,452,0,5,83,0,484,243,2850
"08101000100",1851,227,30,2,344,315,746,448,3963
"08101000200",759,518,46,6,562,45,955,371,3262
"08101000300",0,8,0,0,0,0,0,0,8
"08101000400",1827,249,22,7,376,226,999,305,4011
"08101000500",1649,148,68,0,399,56,622,83,3025
"08101000600",798,483,25,0,474,250,793,466,3289
"08101000800",1537,681,24,5,336,376,1187,832,4978
"08101000902",3077,832,50,8,1458,504,2409,1055,9393
"08101000903",0,4,0,3,0,4,0,0,11
"08101000904",2879,827,26,0,284,134,1060,428,5638
"08101000905",978,369,37,22,411,102,606,187,2712
"08101001000",1703,1137,14,54,1023,1244,1685,1781,8641
"08101001100",854,583,9,1,302,557,867,806,3979
"08101001200",948,484,16,0,207,290,853,622,3420
"08101001400",587,264,0,0,253,65,382,209,1760
"08101001500",1385,538,5,2,135,65,492,251,2873
"08101001600",1481,128,0,0,98,0,458,30,2195
"08101001700",3652,198,30,4,306,132,1091,249,5662
"08101001800",1670,305,0,3,317,75,706,171,3247
"08101001900",753,207,8,30,353,60,627,158,2196
"08101002000",1626,561,22,96,435,446,1064,853,5103
"08101002100",838,233,33,47,362,209,894,357,2973
"08101002200",1041,199,13,34,181,84,620,137,2309
"08101002300",1859,592,65,40,539,268,1638,775,5776
"08101002400",1138,282,18,8,243,111,798,205,2803
"08101002500",1833,468,145,23,361,290,1184,429,4733
"08101002600",1521,629,12,51,365,561,916,963,5018
"08101002700",3711,765,11,30,948,194,2331,766,8756
"08101002801",3107,795,79,0,768,298,1867,649,7563
"08101002802",2686,338,151,0,460,170,935,250,4990
"08101002804",3277,453,5,2,141,103,170,24,4175
"08101002806",3039,182,24,0,291,14,902,14,4466
"08101002807",3042,156,37,6,977,125,1763,203,6309
"08101002808",2496,224,0,0,362,109,937,109,4237
"08101002901",1468,455,117,84,733,382,1343,541,5123
"08101002903",3592,817,271,14,859,414,1994,679,8640
"08101002906",3816,134,0,27,344,37,934,34,5326
"08101002911",2015,250,0,0,386,0,433,107,3191
"08101002912",1053,256,94,7,494,67,723,217,2911
"08101002913",3218,48,20,0,279,62,799,48,4474
"08101002914",2530,279,5,5,752,73,1303,120,5067
"08101002915",1859,350,2,6,173,11,729,57,3187
"08101002916",2095,414,24,10,359,20,503,25,3450
"08101002917",2313,283,7,0,166,0,497,0,3266
"08101002918",5434,389,246,0,324,7,871,168,7439
"08101003001",706,321,74,0,86,8,351,67,1613
"08101003004",1856,46,61,84,297,61,496,10,2911
"08101003103",1545,233,18,18,138,116,829,289,3186
"08101003104",1933,200,0,0,162,30,591,60,2976
"08101003105",2773,123,0,0,138,35,746,43,3858
"08101003106",915,113,1,0,120,10,264,31,1454
"08101003200",2619,237,0,0,166,236,498,355,4111
"08101003500",674,471,5,50,336,197,622,393,2748
"08101003600",940,295,3,42,587,242,866,343,3318
"08101980100",0,0,0,0,0,0,0,0,0
"08103951100",3093,686,0,12,120,87,244,248,4490
"08103951200",2082,300,0,0,83,0,149,20,2634
"08105976700",2916,781,16,3,986,177,2465,498,7842
"08105976800",1199,433,0,0,207,155,755,343,3092
"08105977000",3449,615,17,0,378,147,678,222,5506
"08107000100",2004,110,0,0,6,0,20,0,2140
"08107000200",1596,203,0,0,80,31,215,27,2152
"08107000300",1769,208,6,0,20,40,69,14,2126
"08107000400",2753,182,75,0,290,13,314,85,3712
"08107000500",3307,298,33,0,83,150,241,112,4224
"08107000600",2939,76,0,0,41,34,181,34,3305
"08107000700",3772,757,0,0,219,31,16,107,4902
"08107000800",1652,224,1,0,77,40,97,0,2091
"08109977600",2477,629,5,3,201,54,446,49,3864
"08109977700",1644,540,0,0,298,321,1132,788,4723
"08111972600",500,108,0,0,45,0,112,30,795
"08113968101",1646,198,0,0,12,0,164,0,2020
"08113968102",1487,200,16,0,128,15,299,92,2237
"08113968103",2040,135,0,0,58,0,58,0,2291
"08113968200",1361,239,0,0,33,0,92,0,1725
"08115968300",1813,315,10,0,137,47,335,68,2725
"08117000100",6067,531,116,0,642,301,823,211,8691
"08117000200",5556,1215,15,28,283,802,922,845,9666
"08117000300",2853,298,0,0,181,13,107,0,3452
"08117000401",3847,508,0,0,387,96,1045,31,5914
"08117000402",4232,211,30,0,157,0,111,10,4751
"08119010103",6808,241,0,0,272,0,493,0,7814
"08119010104",1597,466,0,0,61,15,31,0,2170
"08119010105",4881,351,60,0,16,18,85,17,5428
"08119010106",4291,229,126,0,459,0,279,0,5384
"08119010201",2095,281,18,0,260,6,356,26,3042
"08119010202",499,52,0,0,2,5,11,0,569
"08121924100",1759,267,0,0,13,7,22,80,2148
"08121924200",2099,283,0,1,36,22,211,45,2697
"08123000100",908,722,53,147,104,228,406,355,2923
"08123000200",556,950,105,139,183,204,361,429,2927
"08123000300",0,0,0,0,0,0,0,0,0
"08123000401",2073,390,0,7,370,56,322,148,3366
"08123000402",2033,660,91,103,540,118,1126,475,5146
"08123000501",1732,788,4,0,612,406,2007,988,6537
"08123000502",1227,629,0,1,757,432,1274,739,5059
"08123000600",484,60,0,0,193,66,588,121,1512
"08123000701",731,292,12,0,371,86,805,319,2616
"08123000703",3304,1544,158,20,1282,830,3173,1806,12117
"08123000704",469,56,13,0,14,0,277,56,885
"08123000705",738,214,0,0,264,140,254,256,1866
"08123000800",989,1167,33,116,309,339,498,558,4009
"08123000900",1977,564,14,0,366,83,470,122,3596
"08123001003",1990,1192,94,517,1099,447,2108,1022,8469
"08123001004",2173,1326,26,1,682,312,1792,1133,7445
"08123001005",5170,990,12,17,535,0,2272,407,9403
"08123001006",3473,756,0,0,557,78,2034,297,7195
"08123001100",2819,314,154,1,682,158,923,195,5246
"08123001201",2867,568,0,0,392,147,1128,341,5443
"08123001202",1991,190,9,5,472,107,599,99,3472
"08123001300",4749,1080,71,0,901,369,3054,807,11031
"08123001404",2267,830,0,0,192,6,624,577,4496
"08123001405",3515,87,10,0,330,16,1575,19,5552
"08123001406",4421,513,48,0,483,23,1004,0,6492
"08123001407",2039,25,0,0,75,0,61,0,2200
"08123001408",1719,121,0,0,154,109,251,78,2432
"08123001409",2299,528,23,0,309,0,370,18,3547
"08123001410",2708,189,30,0,117,0,59,1,3104
"08123001411",2354,106,0,0,112,30,295,62,2959
"08123001412",2002,105,0,0,167,64,174,94,2606
"08123001413",2627,196,21,0,141,45,1138,9,4177
"08123001414",1877,261,0,49,148,0,468,38,2841
"08123001415",3693,70,0,0,184,0,630,0,4577
"08123001416",2061,73,0,0,120,0,357,0,2611
"08123001417",1177,259,3,0,473,58,431,137,2538
"08123001500",5685,211,30,6,211,0,1313,0,7456
"08123001600",3828,520,11,2,253,90,957,341,6002
"08123001700",3890,695,0,0,288,28,1133,452,6486
"08123001800",3493,664,3,0,328,6,1173,383,6050
"08123001902",4911,731,0,0,1221,139,2204,711,9917
"08123001905",3171,626,26,0,615,80,2186,498,7202
"08123001906",1202,122,11,0,377,19,626,53,2410
"08123001907",2126,172,19,0,403,56,963,90,3829
"08123001908",1662,377,11,1,368,12,771,241,3443
"08123002004",3305,196,83,0,316,79,1366,73,5418
"08123002005",550,0,0,0,201,0,161,0,912
"08123002006",232,0,0,0,134,0,73,0,439
"08123002007",4717,192,20,0,799,5,560,16,6309
"08123002008",4253,101,34,0,508,0,415,36,5347
"08123002009",1246,58,0,0,38,0,59,0,1401
"08123002010",1530,506,0,0,324,13,501,101,2975
"08123002011",301,0,0,0,46,0,15,0,362
"08123002012",887,18,0,0,59,0,176,0,1140
"08123002013",2754,78,10,0,226,24,306,32,3430
"08123002014",1088,116,0,0,101,0,139,18,1462
"08123002015",623,26,0,0,83,0,61,0,793
"08123002016",2864,161,35,0,244,0,735,41,4080
"08123002017",773,25,0,0,0,9,186,0,993
"08123002018",912,193,4,0,116,0,148,0,1373
"08123002019",3458,213,19,0,369,128,583,117,4887
"08123002020",4617,53,28,0,317,59,560,75,5709
"08123002021",325,3,0,0,24,0,19,0,371
"08123002101",6094,220,57,0,422,24,1836,16,8669
"08123002102",10232,306,0,0,646,59,1489,156,12888
"08123002103",6957,467,0,0,579,68,808,69,8948
"08123002203",1018,23,0,0,4,0,35,23,1103
"08123002204",1954,48,0,0,73,0,96,8,2179
"08123002205",3851,512,41,0,325,15,353,95,5192
"08123002206",2801,155,0,0,224,0,273,37,3490
"08123002207",2002,150,0,0,174,0,73,0,2399
"08123002208",4528,63,36,0,223,11,372,22,5255
"08123002209",1280,40,0,0,4,0,38,0,1362
"08123002210",695,21,22,0,40,0,58,0,836
"08123002300",3501,583,3,0,353,41,706,100,5287
"08123002501",3939,694,9,11,244,78,321,155,5451
"08123002502",6164,551,0,0,86,50,1451,222,8524
"08125963100",3969,510,4,0,123,22,611,146,5385
"08125963200",4092,380,0,100,767,0,1251,134,6724
"09001010101",3576,246,0,23,152,106,189,0,4292
"09001010102",3541,259,103,6,218,3,85,6,4221
"09001010201",2736,54,145,15,225,14,106,30,3325
"09001010202",4363,83,9,0,610,0,626,0,5691
"09001010300",3770,67,0,28,332,0,334,24,4555
"09001010400",4828,140,57,3,591,82,466,9,6176
"09001010500",3790,356,209,5,1039,0,1013,142,6554
"09001010600",1376,145,32,0,198,0,307,20,2078
"09001010700",3269,206,81,18,230,66,283,82,4235
"09001010800",2803,141,83,5,337,16,288,69,3742
"09001010900",4016,285,49,53,860,0,810,67,6140
"09001011000",4551,91,26,9,483,0,221,0,5381
"09001011100",4368,77,40,0,294,0,220,0,4999
"09001011200",1574,82,0,0,81,16,142,0,1895
"09001011300",2433,274,112,51,914,83,1291,198,5356
"09001020100",1706,346,553,732,690,72,935,98,5132
"09001020200",3426,63,98,0,208,10,270,17,4092
"09001020300",6107,132,179,0,576,29,241,53,7317
"09001020400",3280,81,98,0,336,0,613,0,4408
"09001020500",4246,25,113,0,266,13,500,0,5163
"09001020600",3624,99,266,0,873,0,670,12,5544
"09001020700",4045,55,42,0,227,33,377,33,4812
"09001020800",2421,35,80,0,295,0,266,0,3097
"09001020900",3255,251,306,197,750,44,671,165,5639
"09001021000",2429,78,381,0,302,0,371,0,3561
"09001021100",3874,168,386,206,844,43,959,35,6515
"09001021200",3345,56,333,48,764,5,608,23,5182
"09001021300",2664,61,571,20,1160,49,1278,54,5857
"09001021400",1992,165,1377,157,2279,603,2774,586,9933
"09001021500",1286,501,1491,412,1952,755,2333,970,9700
"09001021600",3092,210,474,391,2769,258,1195,304,8693
"09001021700",3045,237,944,74,2217,375,1452,367,8711
"09001021801",2067,147,533,201,1108,37,697,95,4885
"09001021802",2197,68,1348,157,878,313,1121,114,6196
"09001021900",3585,442,460,102,984,339,1468,419,7799
"09001022000",1305,56,393,137,1038,28,944,35,3936
"09001022100",2372,187,1088,69,3941,417,4243,474,12791
"09001022200",1137,378,629,200,1492,548,1793,774,6951
"09001022300",2322,26,1294,324,1459,942,1844,884,9095
"09001022400",1998,62,38,0,262,1,308,5,2674
"09001030100",3464,109,2,13,96,6,100,8,3798
"09001030200",3146,254,0,0,115,213,24,31,3783
"09001030300",3634,356,0,0,142,10,49,10,4201
"09001030400",3378,250,36,0,461,9,163,0,4297
"09001030500",4840,233,20,6,340,7,82,37,5565
"09001035100",6755,263,165,9,451,34,449,2,8128
"09001035200",3152,55,15,0,80,0,108,0,3410
"09001035300",3572,76,0,0,200,0,199,11,4058
"09001035400",4752,115,12,0,276,0,78,8,5241
"09001042500",3303,112,67,1,575,0,506,16,4580
"09001042600",3260,203,210,9,449,0,611,0,4742
"09001042700",3678,38,388,19,609,46,326,0,5104
"09001042800",3801,197,460,34,462,0,489,35,5478
"09001042900",1556,40,28,0,122,0,145,0,1891
"09001043000",2433,77,413,1,176,34,288,0,3422
"09001043100",4020,71,190,23,485,95,453,77,5414
"09001043200",1911,133,433,54,446,0,611,107,3695
"09001043300",2797,105,644,47,118,0,1059,30,4800
"09001043400",2091,245,1014,283,535,82,1024,134,5408
"09001043500",2302,75,248,33,129,15,282,5,3089
"09001043600",2400,68,211,110,346,20,419,30,3604
"09001043700",1093,246,418,76,216,86,600,258,2993
"09001043800",4666,295,908,452,1890,106,1949,75,10341
"09001043900",4498,178,615,54,598,0,1670,95,7708
"09001044000",3033,344,972,178,732,56,2180,330,7825
"09001044100",1634,418,675,345,234,20,830,207,4363
"09001044200",2240,326,560,53,336,0,851,90,4456
"09001044300",3137,148,150,34,244,0,583,59,4355
"09001044400",1647,330,971,150,201,224,1022,478,5023
"09001044500",631,17,1343,351,445,43,964,53,3847
"09001044600",3102,197,20,12,73,0,64,16,3484
"09001045101",3947,110,13,0,230,13,51,6,4370
"09001045102",4746,311,38,13,625,35,161,17,5946
"09001045200",2197,44,11,0,103,0,80,0,2435
"09001045300",2247,67,6,0,188,15,18,0,2541
"09001045400",2850,40,62,0,395,14,85,9,3455
"09001050100",3497,54,14,0,493,0,147,11,4216
"09001050200",3514,40,25,6,489,6,123,0,4203
"09001050300",7216,315,1,1,674,0,393,18,8618
"09001050400",2023,116,0,72,179,5,170,41,2606
"09001050500",4029,329,49,8,287,22,127,107,4958
"09001050600",2902,138,22,0,248,33,88,0,3431
"09001055100",5291,120,112,13,332,64,178,42,6152
"09001055200",4079,34,12,0,248,0,157,0,4530
"09001060100",2400,22,54,0,197,0,324,0,2997
"09001060200",3879,107,10,0,365,38,254,0,4653
"09001060300",3563,84,95,0,231,0,310,77,4360
"09001060400",3959,323,20,1,199,1,115,1,4619
"09001060500",2582,39,0,0,103,0,104,0,2828
"09001060600",2059,106,21,0,179,0,9,0,2374
"09001060700",4761,192,0,0,121,14,288,0,5376
"09001060800",1939,26,0,0,70,0,70,0,2105
"09001060900",2482,29,0,0,125,0,149,0,2785
"09001061000",3157,244,80,0,341,0,170,0,3992
"09001061100",3365,79,27,27,249,29,52,38,3866
"09001061200",1674,59,6,0,330,47,104,0,2220
"09001061300",2275,203,12,0,679,73,71,21,3334
"09001061400",1640,196,311,55,444,184,318,0,3148
"09001061500",4007,298,27,0,178,52,134,157,4853
"09001061600",4878,88,0,9,228,0,9,0,5212
"09001070100",3627,143,67,0,655,21,634,0,5147
"09001070200",1109,83,1355,411,935,276,1090,277,5536
"09001070300",111,205,126,339,181,193,318,362,1835
"09001070400",358,92,112,45,275,38,104,34,1058
"09001070500",274,193,474,399,399,410,586,474,3209
"09001070600",419,339,564,136,338,126,554,249,2725
"09001070900",585,313,535,240,441,392,950,668,4124
"09001071000",721,143,1061,462,1169,369,1525,488,5938
"09001071100",995,410,1044,693,944,194,1260,397,5937
"09001071200",1108,403,1783,584,953,866,1691,1085,8473
"09001071300",656,607,1192,435,680,423,870,930,5793
"09001071400",1447,360,442,279,835,379,1197,617,5556
"09001071600",265,995,189,570,195,387,248,1422,4271
"09001071900",987,456,1252,535,730,238,1182,626,6006
"09001072000",1297,397,754,345,544,151,914,412,4814
"09001072100",3052,375,1097,196,377,128,1445,138,6808
"09001072200",2135,295,737,152,305,295,1076,228,5223
"09001072300",2481,534,1405,124,1129,189,1962,653,8477
"09001072400",938,76,719,83,585,138,974,137,3650
"09001072500",3060,505,1942,14,1006,68,956,254,7805
"09001072600",3979,961,1303,325,549,0,921,168,8206
"09001072700",1381,84,1442,0,641,24,985,34,4591
"09001072800",1051,260,3260,370,628,157,1469,399,7594
"09001072900",1587,284,2443,243,645,52,1328,162,6744
"09001073000",758,114,719,86,137,74,478,110,2476
"09001073100",1816,213,1139,686,419,199,1478,313,6263
"09001073200",1064,176,561,42,559,59,531,73,3065
"09001073300",676,308,1457,185,539,0,838,248,4251
"09001073400",1369,181,1580,491,561,243,1406,322,6153
"09001073500",776,310,783,693,793,101,1531,412,5399
"09001073600",498,342,513,206,565,297,935,689,4045
"09001073700",954,497,1511,326,763,536,1442,908,6937
"09001073800",415,391,567,184,608,378,810,826,4179
"09001073900",802,455,584,458,791,167,1390,605,5252
"09001074000",338,288,469,260,266,292,593,570,3076
"09001074300",799,518,1626,593,364,213,842,722,5677
"09001074400",464,628,2043,436,737,245,1137,805,6495
"09001080100",2764,270,896,52,946,45,1321,117,6411
"09001080200",2259,479,894,195,508,155,810,267,5567
"09001080400",2002,236,2260,557,605,46,1050,165,6921
"09001080500",2825,287,27,14,60,0,179,20,3412
"09001080600",1658,75,224,19,135,0,146,0,2257
"09001080700",1463,216,320,6,82,9,178,94,2368
"09001080800",4266,92,151,9,317,0,331,0,5166
"09001080900",3910,238,672,0,298,26,641,0,5785
"09001081000",3395,110,337,47,513,0,786,6,5194
"09001081100",4119,84,336,8,106,0,373,0,5026
"09001081200",4313,205,542,49,259,26,260,51,5705
"09001081300",4003,163,196,54,217,27,440,37,5137
"09001090100",2931,30,82,0,240,3,71,3,3360
"09001090200",7460,74,108,0,267,0,429,0,8338
"09001090300",3999,89,46,0,567,2,671,2,5376
"09001090400",5188,198,334,0,733,0,814,0,7267
"09001090500",3908,186,100,0,386,40,360,60,5040
"09001090600",2923,142,12,0,283,4,118,5,3487
"09001090700",5014,111,25,0,363,3,391,3,5910
"09001100100",5234,298,0,0,188,0,344,0,6064
"09001100200",6553,299,18,2,386,0,251,92,7601
"09001100300",5856,292,116,0,459,28,268,0,7019
"09001105100",3799,161,38,0,101,0,214,0,4313
"09001105200",3136,91,0,0,250,0,207,0,3684
"09001110100",1647,397,0,10,90,8,107,62,2321
"09001110201",4225,434,99,1,392,26,407,59,5643
"09001110202",4456,135,72,13,182,7,431,7,5303
"09001110301",4953,225,91,0,474,205,371,76,6395
"09001110302",2428,103,58,0,192,0,67,0,2848
"09001110400",4918,118,0,0,136,0,93,0,5265
"09001110500",5580,128,36,1,38,0,56,0,5839
"09001110600",7513,185,0,0,351,2,416,2,8469
"09001200100",2800,203,110,0,507,0,375,0,3995
"09001200200",4175,115,80,0,299,182,270,0,5121
"09001200301",4479,95,37,0,410,13,505,0,5539
"09001200302",4841,95,55,0,389,24,128,11,5543
"09001205100",3347,80,19,0,674,60,230,60,4470
"09001205200",6114,105,21,1,323,14,201,1,6780
"09001205300",5408,200,79,0,310,0,243,0,6240
"09001210100",2020,980,247,24,2426,486,2432,893,9508
"09001210200",1510,284,282,292,3017,1004,3006,983,10378
"09001210300",3364,138,286,0,1435,239,1377,261,7100
"09001210400",4859,252,1089,61,2088,834,2091,714,11988
"09001210500",5407,600,186,2,761,221,810,239,8226
"09001210600",2758,281,344,77,2407,67,2030,237,8201
"09001210701",2236,196,122,59,1734,327,1728,240,6642
"09001210702",2069,476,561,55,1040,267,1037,375,5880
"09001210800",3744,149,342,0,771,10,621,38,5675
"09001210900",4633,128,39,0,395,0,370,0,5565
"09001211000",2918,118,504,0,516,34,207,38,4335
"09001211100",25,0,16,0,0,0,0,0,41
"09001211200",4448,449,312,28,1004,134,707,186,7268
"09001211300",3001,240,298,3,305,1,278,1,4127
"09001211400",4079,266,195,0,844,8,701,8,6101
"09001220100",4591,62,0,0,241,0,342,7,5243
"09001220200",4515,143,0,23,460,0,590,0,5731
"09001220300",3558,79,37,4,171,99,131,2,4081
"09001230100",6412,236,45,1,169,0,445,0,7308
"09001230200",1844,64,4,0,111,1,132,17,2173
"09001230300",2899,134,37,0,378,14,400,2,3864
"09001230400",5752,212,31,0,347,62,177,80,6661
"09001230501",3508,141,0,0,302,285,394,285,4915
"09001230502",3893,199,0,62,167,0,189,0,4510
"09001240100",4236,133,62,48,198,0,177,1,4855
"09001240200",4240,155,14,0,122,9,114,0,4654
"09001245100",2898,42,20,0,102,0,130,0,3192
"09001245200",3944,144,33,0,62,1,162,1,4347
"09001245300",4579,234,1,9,188,25,322,94,5452
"09001245400",3241,43,0,0,260,0,172,0,3716
"09001245500",2691,47,0,0,99,0,140,0,2977
"09001245600",5590,230,94,0,327,1,271,1,6514
"09001257100",3379,60,0,0,145,0,71,0,3655
"09001257200",1523,250,1067,314,579,158,1410,203,5504
"09001990000",0,0,0,0,0,0,0,0,0
"09003330100",2006,114,14,0,65,0,46,0,2245
"09003400100",6344,278,195,1,246,283,192,71,7610
"09003400200",5456,136,1,0,300,0,252,0,6145
"09003400300",6858,132,0,0,60,3,11,36,7100
"09003405100",2647,115,57,0,117,168,219,175,3498
"09003405200",3611,303,20,1,329,0,62,76,4402
"09003405300",5382,341,27,0,146,0,452,0,6348
"09003405401",2710,131,13,0,121,55,175,0,3205
"09003405402",2536,439,298,0,787,28,238,28,4354
"09003405500",3873,373,44,0,1085,11,1054,76,6516
"09003405600",6588,528,218,19,234,13,661,214,8475
"09003405700",1492,346,4,67,156,63,61,263,2452
"09003405800",6604,330,1,0,373,47,471,47,7873
"09003405900",4141,90,205,13,41,91,142,33,4756
"09003406001",2640,428,109,218,229,130,389,475,4618
"09003406002",4411,214,99,0,82,95,145,46,5092
"09003406100",1884,741,439,27,306,319,424,508,4648
"09003410101",5140,306,32,0,154,0,101,18,5751
"09003410102",3496,117,63,3,122,0,67,0,3868
"09003415300",1092,260,471,115,382,612,925,829,4686
"09003415400",2901,296,552,13,904,433,1603,412,7114
"09003415500",921,527,90,58,636,420,1017,698,4367
"09003415600",1899,434,573,56,1092,307,1738,475,6574
"09003415700",1876,292,232,164,357,132,511,229,3793
"09003415800",944,376,361,39,360,200,480,313,3073
"09003415900",838,490,53,27,169,210,309,424,2520
"09003416000",3350,464,49,45,586,489,1205,571,6759
"09003416100",1959,1068,320,369,983,701,1990,1595,8985
"09003416200",879,1010,223,138,380,286,689,1223,4828
"09003416300",1415,646,179,29,813,450,861,619,5012
"09003416400",2771,33,21,62,439,4,430,4,3764
"09003416500",2454,356,629,116,1224,129,1630,251,6789
"09003416600",1141,636,270,110,464,151,662,629,4063
"09003416700",3567,623,797,44,929,255,1504,494,8213
"09003416800",1867,518,264,0,379,142,605,92,3867
"09003417100",378,484,99,143,374,214,526,501,2719
"09003417200",915,541,198,13,121,40,292,105,2225
"09003417300",0,5,0,0,0,3,0,0,8
"09003417400",1527,377,310,19,257,20,391,69,2970
"09003417500",3583,236,250,0,563,11,653,19,5315
"09003420400",2508,170,23,0,72,1,80,1,2855
"09003420500",4383,409,189,40,109,128,418,103,5779
"09003420600",4778,478,265,1,255,129,316,167,6389
"09003420700",3366,162,48,8,82,30,175,11,3882
"09003430100",3384,397,13,0,129,0,95,0,4018
"09003430201",2637,266,0,1,352,0,131,74,3461
"09003430202",4572,20,88,0,278,0,206,0,5164
"09003430203",3908,97,76,2,238,0,74,23,4418
"09003430301",3430,104,13,0,72,0,70,0,3689
"09003430302",2531,86,12,1,22,6,39,0,2697
"09003430400",4562,189,51,49,28,33,61,2,4975
"09003430500",6447,18,89,0,74,4,146,4,6782
"09003430601",4274,477,20,0,86,0,183,74,5114
"09003430602",3498,157,32,0,244,0,232,37,4200
"09003460100",2531,220,10,0,522,9,66,0,3358
"09003460202",3409,301,86,12,335,83,123,18,4367
"09003460203",2019,160,75,0,266,146,8,0,2674
"09003460204",4750,186,261,1,1126,0,108,59,6491
"09003460301",4349,151,51,1,388,90,229,77,5336
"09003460302",3456,98,20,7,210,0,55,0,3846
"09003462101",5493,165,20,0,470,0,218,0,6366
"09003462102",2985,402,19,0,655,16,141,0,4218
"09003462201",4490,143,16,0,494,0,55,0,5198
"09003462202",2383,78,9,0,255,0,58,0,2783
"09003464101",4900,181,18,0,212,0,142,0,5453
"09003464102",4576,133,24,0,197,0,483,0,5413
"09003466101",3847,223,117,0,227,0,207,125,4746
"09003466102",4358,68,85,0,591,8,389,12,5511
"09003466201",1838,75,120,51,223,0,64,0,2371
"09003466202",4113,50,32,0,292,7,50,0,4544
"09003466300",4240,70,58,0,149,66,179,66,4828
"09003466400",2235,82,69,18,107,0,49,33,2593
"09003468101",6721,98,71,9,216,5,289,5,7414
"09003468102",3743,151,24,14,178,0,49,0,4159
"09003470100",4454,55,314,0,193,82,182,0,5280
"09003471100",347,81,2779,365,203,15,214,61,4065
"09003471200",301,0,1849,325,240,12,96,0,2823
"09003471300",1819,202,2055,80,661,95,345,12,5269
"09003471400",3394,82,1457,140,241,4,199,4,5521
"09003471500",930,70,2029,120,204,6,57,15,3431
"09003473100",2215,215,3299,58,484,6,685,136,7098
"09003473400",1193,48,338,69,148,21,71,16,1904
"09003473501",2686,124,885,0,643,43,330,20,4731
"09003473502",2021,46,866,7,282,72,182,0,3476
"09003473601",2372,34,550,0,205,0,210,18,3389
"09003473602",1250,62,519,68,469,37,116,7,2528
"09003473700",2027,33,2799,101,331,183,287,68,5829
"09003473800",408,53,988,343,64,20,168,38,2082
"09003476100",3553,274,152,14,231,237,86,34,4581
"09003476200",2401,66,12,2,118,0,48,0,2647
"09003476300",4191,159,383,0,644,53,346,24,5800
"09003477101",3596,174,84,0,104,0,42,0,4000
"09003477102",4914,513,324,43,421,0,244,0,6459
"09003477200",2706,29,24,0,100,0,53,0,2912
"09003480300",2100,71,24,0,173,0,98,15,2481
"09003480400",3381,169,87,0,67,0,85,0,3789
"09003480500",2740,127,35,0,343,0,118,0,3363
"09003480600",3167,730,314,92,532,452,886,685,6858
"09003480700",1524,112,104,10,176,102,170,22,2220
"09003480800",3578,289,68,8,224,34,104,20,4325
"09003480900",1966,60,26,0,203,0,205,0,2460
"09003481000",3472,86,19,19,0,0,101,0,3697
"09003481100",3443,394,130,0,18,9,24,34,4052
"09003481200",3149,263,73,132,76,0,79,12,3784
"09003481300",2609,78,27,0,107,11,92,0,2924
"09003484100",3458,191,554,79,994,54,139,28,5497
"09003484200",4688,257,261,1,531,81,413,132,6364
"09003487100",5240,545,345,1,729,0,381,42,7283
"09003487201",3866,115,312,1,418,1,220,1,4934
"09003487202",2828,2,112,0,610,52,330,2,3936
"09003487300",1065,33,6,0,267,8,42,0,1421
"09003487400",1901,57,37,0,271,0,100,6,2372
"09003487500",4963,142,501,1,1105,62,251,18,7043
"09003490100",4100,296,291,0,219,95,406,113,5520
"09003490302",6037,218,115,5,2090,209,239,55,8968
"09003492100",2984,117,163,0,304,0,253,14,3835
"09003492200",3253,141,421,12,291,44,777,35,4974
"09003492300",4396,263,326,0,795,71,833,199,6883
"09003492400",2445,152,67,0,140,0,71,0,2875
"09003492500",3040,24,95,25,56,13,49,13,3315
"09003492600",5755,355,29,20,509,174,570,0,7412
"09003494100",4443,121,342,21,843,33,593,33,6429
"09003494201",3620,154,190,157,480,31,245,14,4891
"09003494202",2425,48,216,0,200,0,229,0,3118
"09003494300",3232,129,148,143,331,13,355,37,4388
"09003494400",3867,218,71,12,534,90,343,86,5221
"09003494500",3689,102,260,0,588,9,498,24,5170
"09003494600",2849,180,91,11,393,2,98,2,3626
"09003496100",1001,297,411,210,622,26,656,146,3369
"09003496200",3409,113,77,2,798,2,343,26,4770
"09003496300",2786,302,168,8,307,57,355,188,4171
"09003496400",2529,48,33,1,158,0,44,0,2813
"09003496500",2398,50,20,3,225,4,57,4,2761
"09003496600",2092,79,344,0,163,9,0,9,2696
"09003496700",2395,242,657,28,732,20,860,63,4997
"09003496800",2375,123,190,194,618,126,796,113,4535
"09003496900",4013,501,327,595,688,214,954,75,7367
"09003497000",4179,33,39,2,139,0,124,0,4516
"09003497100",3199,235,68,1,410,135,188,52,4288
"09003497200",1381,34,78,0,142,2,123,2,1762
"09003497300",3303,111,246,1,573,7,372,0,4613
"09003497400",3167,112,13,47,438,112,127,96,4112
"09003497500",2931,188,127,30,310,102,170,0,3858
"09003497600",1904,132,64,4,138,87,43,6,2378
"09003497700",3851,94,201,73,209,44,34,12,4518
"09003500100",633,718,478,203,995,818,1426,1497,6768
"09003500200",581,521,362,369,694,166,968,687,4348
"09003500300",440,431,275,184,373,232,743,527,3205
"09003500400",417,266,293,236,390,183,609,410,2804
"09003500500",242,174,245,111,434,209,287,230,1932
"09003500700",0,0,45,0,0,0,0,0,45
"09003500900",445,476,429,451,207,265,642,822,3737
"09003501200",103,187,990,670,320,273,397,380,3320
"09003501300",1,50,603,680,151,284,134,317,2220
"09003501400",60,32,1287,926,257,259,273,394,3488
"09003501500",55,137,1890,1018,162,158,194,214,3828
"09003501700",149,52,486,197,146,216,235,265,1746
"09003501800",196,302,711,543,365,705,480,1020,4322
"09003502100",946,151,254,20,316,78,227,76,2068
"09003502300",2926,852,875,81,1310,325,2529,1073,9971
"09003502400",2550,879,851,317,782,999,2731,1579,10688
"09003502500",715,473,80,113,369,95,650,427,2922
"09003502600",1382,904,732,258,409,308,1205,961,6159
"09003502700",687,506,381,344,329,516,773,1054,4590
"09003502800",540,677,141,241,670,652,1205,1288,5414
"09003502900",714,571,540,274,411,633,688,1138,4969
"09003503000",499,610,226,345,688,854,1074,1469,5765
"09003503100",1051,273,1227,597,705,506,766,686,5811
"09003503300",341,292,1002,341,564,158,719,339,3756
"09003503500",306,0,667,635,51,246,410,177,2492
"09003503700",39,61,1599,676,167,6,35,57,2640
"09003503800",64,19,383,157,158,58,264,64,1167
"09003503900",93,0,4098,604,305,15,166,0,5281
"09003504000",38,30,2713,578,138,1,8,0,3506
"09003504100",298,314,253,185,513,129,612,484,2788
"09003504200",1555,1003,784,557,566,353,891,288,5997
"09003504300",680,378,280,357,486,330,817,618,3946
"09003504500",776,765,583,199,1015,643,1526,1321,6828
"09003504800",1321,136,619,29,1665,251,2117,296,6434
"09003504900",1163,344,840,204,945,663,1875,922,6956
"09003510100",1077,99,639,114,305,153,463,185,3035
"09003510200",909,189,617,168,367,96,356,163,2865
"09003510300",1519,213,1356,463,919,209,1591,308,6578
"09003510400",1848,622,983,379,706,377,1818,726,7459
"09003510500",1070,57,484,26,1162,283,677,214,3973
"09003510600",1613,496,1418,326,1089,165,1605,432,7144
"09003510700",2822,135,870,196,457,412,863,428,6183
"09003510800",1579,190,420,11,699,0,716,38,3653
"09003510900",2391,37,529,19,349,2,578,0,3905
"09003511000",2395,42,516,109,752,1,688,19,4522
"09003511100",2280,172,319,0,686,80,562,167,4266
"09003511200",1614,334,763,294,579,138,488,298,4508
"09003511300",1130,117,955,288,901,104,925,104,4524
"09003511400",1486,105,484,21,261,14,370,0,2741
"09003514101",2911,118,28,0,209,13,59,1,3339
"09003514102",3377,235,670,83,2566,110,973,37,8051
"09003514200",1814,416,523,61,285,28,685,197,4009
"09003514300",3146,124,557,10,578,66,419,15,4915
"09003514400",2715,586,517,245,357,162,517,305,5404
"09003514500",3122,149,487,12,542,86,562,24,4984
"09003514600",3198,301,647,250,418,401,1044,428,6687
"09003514700",2153,655,952,80,475,101,679,286,5381
"09003514800",1844,549,604,157,334,142,702,342,4674
"09003514900",2540,67,29,0,88,3,81,3,2811
"09003515000",2532,153,172,9,127,5,277,89,3364
"09003515101",1717,157,203,51,150,50,165,80,2573
"09003515102",3425,155,388,516,1389,269,508,83,6733
"09003515200",2857,66,75,22,294,11,137,23,3485
"09003520100",5262,137,54,0,428,0,169,0,6050
"09003520201",3068,82,21,0,442,2,103,2,3720
"09003520202",3554,134,0,0,682,2,90,2,4464
"09003520301",3355,145,390,15,709,211,335,137,5297
"09003520302",2949,123,117,60,341,65,155,0,3810
"09003520400",6786,141,106,0,770,9,137,9,7958
"09003520501",3467,156,40,0,543,1,178,26,4411
"09003524100",5986,34,84,2,151,16,224,0,6497
"09003524200",4764,443,37,46,324,214,279,224,6331
"09003524300",3342,41,149,0,169,0,56,0,3757
"09003524400",273,274,1606,612,178,141,482,451,4017
"09003524501",1087,180,375,77,452,333,651,319,3474
"09003524502",872,174,773,229,115,45,162,162,2532
"09003524600",343,188,1563,780,688,94,455,176,4287
"09003524700",1311,257,755,96,610,168,1459,400,5056
"09003980000",0,0,0,0,0,0,0,0,0
"09005250100",1584,37,11,4,109,2,81,2,1830
"09005253100",2942,60,14,0,68,236,103,238,3661
"09005253200",5581,379,251,127,607,185,518,175,7823
"09005253300",1756,162,73,0,260,0,156,0,2407
"09005253400",5494,250,0,46,363,0,228,0,6381
"09005253500",5900,147,0,26,145,0,43,0,6261
"09005253600",1840,349,112,12,204,23,201,92,2833
"09005260200",2708,216,16,24,125,32,70,32,3223
"09005261100",3208,106,114,0,85,9,124,9,3655
"09005262100",2338,113,0,0,178,52,14,0,2695
"09005263200",1327,130,0,0,48,0,4,0,1509
"09005265100",1214,137,0,0,31,4,30,9,1425
"09005266100",2295,194,159,12,35,42,0,7,2744
"09005267100",3054,194,0,0,102,4,201,24,3579
"09005268100",2144,77,0,0,52,0,66,0,2339
"09005290100",3604,54,0,1,58,0,28,0,3745
"09005293100",1468,54,5,0,11,10,7,0,1555
"09005296100",2494,393,0,15,34,10,65,38,3049
"09005298300",2523,257,0,0,0,0,0,18,2798
"09005298400",2642,94,0,3,55,0,6,0,2800
"09005300100",2330,122,25,0,43,21,14,0,2555
"09005300400",1948,102,10,0,59,0,26,0,2145
"09005300500",3410,187,1,0,29,0,36,4,3667
"09005303100",2158,97,7,0,19,0,51,0,2332
"09005306100",6631,103,51,5,109,0,156,0,7055
"09005310100",3442,416,0,0,167,234,384,123,4766
"09005310200",2183,396,58,0,177,63,252,86,3215
"09005310300",829,441,0,33,84,0,41,0,1428
"09005310400",2351,159,22,0,115,0,54,0,2701
"09005310500",1444,258,33,0,60,0,59,116,1970
"09005310601",3148,178,61,0,237,7,195,40,3866
"09005310602",4220,114,56,0,363,0,37,0,4790
"09005310700",3129,319,63,0,172,97,132,0,3912
"09005310801",1895,452,44,66,338,20,460,77,3352
"09005310803",3136,228,539,18,363,15,466,30,4795
"09005310804",2200,271,3,0,104,76,271,181,3106
"09005320100",5172,615,73,0,236,0,784,0,6880
"09005320200",4159,281,88,0,327,0,189,0,5044
"09005342100",3246,249,0,13,10,8,15,14,3555
"09005349100",4725,107,0,0,162,8,63,2,5067
"09005349200",2437,112,45,0,100,38,34,38,2804
"09005360100",4629,174,44,0,379,51,465,51,5793
"09005360200",7108,128,34,0,197,0,98,10,7575
"09005360300",3063,120,113,0,142,0,371,34,3843
"09005360400",5330,313,184,0,78,11,31,8,5955
"09005362101",3797,153,0,15,218,0,248,0,4431
"09005362102",5015,348,0,7,234,64,160,25,5853
"09005425300",3626,275,30,0,184,0,301,0,4416
"09005425400",4003,232,14,1,90,12,76,39,4467
"09005425500",2952,306,87,0,200,0,118,0,3663
"09005425600",2419,154,13,0,69,58,28,0,2741
"09007541100",1108,370,703,80,165,95,241,107,2869
"09007541200",3647,327,263,402,459,45,521,39,5703
"09007541300",4113,399,523,311,595,46,405,40,6432
"09007541401",2776,47,96,19,332,6,70,0,3346
"09007541402",3976,453,535,14,384,72,265,72,5771
"09007541500",1170,188,119,34,167,7,61,7,1753
"09007541600",719,338,250,125,123,50,500,83,2188
"09007541700",1470,545,443,258,154,4,215,338,3427
"09007542000",3343,195,319,0,392,27,274,0,4550
"09007542100",2131,245,387,112,209,89,204,148,3525
"09007542200",1276,18,195,5,104,4,56,4,1662
"09007550100",4962,186,0,0,541,0,422,0,6111
"09007550201",3518,43,16,4,134,0,226,0,3941
"09007550202",2875,199,58,5,101,0,58,0,3296
"09007560100",5912,124,17,0,132,0,78,0,6263
"09007560200",2689,331,6,78,74,47,103,109,3437
"09007570100",3719,96,512,0,583,111,346,17,5384
"09007570200",2937,107,170,0,88,4,95,14,3415
"09007570300",4687,177,342,0,69,117,194,106,5692
"09007580100",4077,152,18,2,170,6,61,4,4490
"09007585100",6692,183,11,0,411,0,229,0,7526
"09007590100",7791,304,24,0,223,0,193,14,8549
"09007595101",3286,210,66,0,38,5,146,5,3756
"09007595102",4932,231,0,0,268,0,19,0,5450
"09007600100",3853,163,9,21,50,18,113,0,4227
"09007610100",1873,155,2,3,21,10,23,0,2087
"09007610200",3039,294,0,0,214,48,91,18,3704
"09007610300",3568,539,0,2,40,0,377,180,4706
"09007610400",3035,130,31,0,106,0,127,0,3429
"09007620100",4084,96,80,108,169,50,88,51,4726
"09007630100",6119,355,27,0,45,0,89,0,6635
"09007640100",6059,87,0,0,370,0,196,0,6712
"09007670100",4320,101,31,0,270,19,113,0,4854
"09007670200",4639,294,72,0,311,0,13,0,5329
"09007680100",6219,386,5,24,221,0,352,0,7207
"09007680200",4187,209,551,137,543,121,317,42,6107
"09007990100",0,0,0,0,0,0,0,0,0
"09009120100",4788,260,292,94,268,195,626,124,6647
"09009120200",4764,629,120,0,747,427,1728,770,9185
"09009125100",3848,214,192,6,131,29,288,35,4743
"09009125200",3762,1163,209,162,637,17,1274,174,7398
"09009125300",3538,535,278,376,296,205,973,583,6784
"09009125400",1992,687,143,190,339,72,590,406,4419
"09009130101",4414,90,0,1,177,0,394,0,5076
"09009130102",2330,257,13,7,321,0,145,12,3085
"09009130200",7162,288,542,100,483,175,852,60,9662
"09009140100",1402,210,549,164,663,173,224,52,3437
"09009140200",371,93,275,318,55,242,186,305,1845
"09009140300",442,228,843,283,459,290,761,345,3651
"09009140400",982,370,467,548,691,816,942,877,5693
"09009140500",517,477,1023,685,633,599,968,1248,6150
"09009140600",633,467,958,935,624,432,924,772,5745
"09009140700",1078,771,1071,603,161,427,661,453,5225
"09009140800",559,158,1538,449,421,446,568,403,4542
"09009140900",951,555,2297,309,306,107,239,309,5073
"09009141000",2752,374,540,46,376,0,280,27,4395
"09009141100",1404,108,1315,76,223,6,270,34,3436
"09009141200",1133,350,2279,601,545,117,542,160,5727
"09009141300",1081,513,1137,760,371,85,269,72,4288
"09009141400",832,219,2339,985,326,266,193,395,5555
"09009141500",353,0,3594,1212,347,660,489,562,7217
"09009141600",495,273,2241,700,211,175,356,267,4718
"09009141800",1115,350,696,155,1059,98,227,151,3851
"09009141900",4000,466,34,2,700,99,210,0,5511
"09009142000",2044,339,109,72,541,172,224,42,3543
"09009142100",460,263,249,395,283,74,324,320,2368
"09009142200",1208,148,41,0,127,52,71,32,1679
"09009142300",1837,467,868,339,1240,927,2503,1250,9431
"09009142400",1070,863,895,612,1512,463,2223,1164,8802
"09009142500",2207,756,1067,597,629,540,1997,1361,9154
"09009142601",1629,423,1785,744,1240,457,906,637,7821
"09009142603",2010,321,944,115,446,186,931,268,5221
"09009142604",1420,364,573,50,555,147,940,444,4493
"09009142700",2608,194,1392,681,832,531,1598,562,8398
"09009142800",3566,90,844,0,279,45,187,53,5064
"09009150100",3470,187,0,72,114,34,144,17,4038
"09009150200",2380,266,51,15,1019,0,171,186,4088
"09009150300",3703,275,69,30,189,30,216,53,4565
"09009150400",3346,196,93,155,508,0,277,0,4575
"09009150500",3398,160,141,9,167,144,197,22,4238
"09009150600",5511,411,36,0,668,114,316,111,7167
"09009150700",4163,70,1,6,197,0,140,0,4577
"09009150800",3429,140,68,0,193,0,225,0,4055
"09009150900",3389,141,69,30,231,25,61,62,4008
"09009151000",3456,193,21,0,150,8,163,0,3991
"09009151100",6114,130,35,15,338,18,278,10,6938
"09009151200",2821,77,100,5,94,13,129,18,3257
"09009154100",3413,178,1898,519,758,540,1675,286,9267
"09009154200",2738,332,2215,665,755,321,1570,274,8870
"09009154500",2346,526,628,69,316,181,765,235,5066
"09009154600",2575,301,938,128,467,105,633,167,5314
"09009154700",5398,423,112,0,252,32,144,109,6470
"09009154800",4268,158,227,2,169,1,259,16,5100
"09009154900",2747,220,147,60,234,50,570,76,4104
"09009155000",3219,286,1620,13,470,373,754,250,6985
"09009155100",2650,299,326,137,360,33,830,25,4660
"09009157100",2090,99,40,6,249,116,127,1,2728
"09009157200",3311,35,66,0,286,22,203,22,3945
"09009157300",2705,94,52,0,274,0,167,0,3292
"09009157400",3906,129,19,20,366,0,134,0,4574
"09009160100",2935,20,34,0,209,145,90,0,3433
"09009160200",4566,58,93,3,794,16,174,1,5705
"09009161100",5171,214,1,0,160,0,72,0,5618
"09009165100",2723,123,849,224,418,0,691,23,5051
"09009165200",2019,27,32,58,230,0,43,0,2409
"09009165300",1993,155,61,0,200,0,10,0,2419
"09009165400",3263,202,626,243,675,17,352,0,5378
"09009165500",930,196,2600,443,388,8,587,83,5235
"09009165600",3593,390,451,1,1146,77,1672,296,7626
"09009165700",1647,40,1528,111,436,123,290,82,4257
"09009165801",2555,334,1319,59,1657,42,657,30,6653
"09009165802",2994,54,1176,15,125,54,369,54,4841
"09009165900",5784,428,850,36,356,0,298,0,7752
"09009166001",4018,967,341,168,937,36,340,0,6807
"09009166002",3646,133,138,0,127,1,0,1,4046
"09009167100",6953,293,391,31,559,0,312,17,8556
"09009167201",3400,95,171,0,373,74,145,48,4306
"09009167202",3996,170,88,1,237,6,245,0,4743
"09009167300",6025,274,25,0,682,0,98,25,7129
"09009170100",595,446,140,132,219,261,472,615,2880
"09009170200",941,329,244,130,355,69,875,246,3189
"09009170300",952,245,117,85,454,256,773,379,3261
"09009170400",1172,78,112,8,209,14,219,27,1839
"09009170500",5369,203,219,0,303,0,650,122,6866
"09009170600",1838,270,100,36,359,33,455,113,3204
"09009170700",1590,136,95,178,505,131,701,131,3467
"09009170800",3341,800,566,45,274,112,1080,647,6865
"09009170900",1025,253,294,50,308,145,624,300,2999
"09009171000",572,366,122,116,321,171,542,330,2540
"09009171100",3688,790,335,125,443,32,868,407,6688
"09009171200",6827,417,740,47,335,89,577,105,9137
"09009171300",2612,510,144,40,479,46,909,472,5212
"09009171400",873,189,161,73,470,102,839,234,2941
"09009171500",1426,505,453,81,625,94,1296,493,4973
"09009171600",3240,74,587,205,562,203,727,298,5896
"09009171700",3570,117,398,28,130,0,387,14,4644
"09009175100",2524,166,0,1,193,22,548,1,3455
"09009175200",1847,264,46,0,212,43,577,74,3063
"09009175300",3309,489,0,2,223,0,225,0,4248
"09009175400",3205,365,168,2,608,13,843,105,5309
"09009175500",6362,184,351,0,398,53,215,0,7563
"09009175600",4401,62,112,0,467,0,424,0,5466
"09009175700",2253,127,12,0,63,0,40,31,2526
"09009175800",3198,24,38,0,398,0,201,0,3859
"09009175900",4493,60,37,7,483,3,571,5,5659
"09009176000",6417,165,33,2,205,76,230,0,7128
"09009180100",4957,744,94,0,657,8,350,144,6954
"09009180200",3510,244,534,19,905,262,837,263,6574
"09009180300",1629,508,0,2,219,107,140,85,2690
"09009180400",2129,383,214,0,199,0,410,0,3335
"09009180500",3840,117,76,0,450,31,425,0,4939
"09009180601",2653,164,57,0,127,15,191,0,3207
"09009180602",3635,117,57,5,75,129,130,129,4277
"09009184100",4641,404,100,25,82,18,264,57,5591
"09009184200",3158,266,118,3,417,210,258,1,4431
"09009184300",3472,106,0,14,257,0,94,0,3943
"09009184400",2846,199,24,0,137,0,25,0,3231
"09009184500",2043,230,13,3,73,0,42,0,2404
"09009184600",2829,148,0,0,24,0,199,0,3200
"09009184700",4702,509,16,6,787,0,527,0,6547
"09009186100",6776,212,86,0,326,0,251,0,7651
"09009186200",6504,298,68,0,72,1,114,0,7057
"09009190100",2687,355,0,8,83,1,70,30,3234
"09009190200",3091,128,1,1,96,1,112,1,3431
"09009190301",6351,186,7,0,379,0,345,0,7268
"09009190302",4835,290,51,7,245,0,132,22,5582
"09009190303",3122,141,27,8,108,0,184,0,3590
"09009194100",5034,194,3,5,119,5,44,1,5405
"09009194201",6622,230,0,5,355,1,111,2,7326
"09009194202",5012,110,49,5,252,7,32,1,5468
"09009341100",5707,111,36,0,211,0,385,0,6450
"09009343101",3206,107,10,0,396,7,37,0,3763
"09009343102",2960,42,0,22,395,12,144,0,3575
"09009343200",5441,82,63,29,904,0,595,0,7114
"09009343300",5387,183,88,1,712,27,319,90,6807
"09009343400",5905,43,21,0,671,15,187,8,6850
"09009344100",4005,186,61,35,361,38,77,17,4780
"09009344200",2399,51,33,0,347,5,73,0,2908
"09009345100",4744,878,401,154,341,108,401,211,7238
"09009345201",5151,631,352,37,285,96,309,88,6949
"09009345202",3369,165,158,0,394,30,515,30,4661
"09009345300",5542,406,152,29,636,21,362,44,7192
"09009345400",6003,437,348,35,450,31,971,200,8475
"09009346101",6374,343,0,0,216,0,336,27,7296
"09009346102",5620,121,36,5,89,0,213,0,6084
"09009347100",4861,66,284,0,60,0,238,0,5509
"09009347200",3707,338,11,1,106,0,51,10,4224
"09009348111",2029,639,20,0,170,0,67,0,2925
"09009348122",3564,227,210,6,178,7,76,7,4275
"09009348123",5085,251,45,0,159,71,253,0,5864
"09009348124",2141,98,0,0,42,0,142,15,2438
"09009348125",3824,347,82,0,386,0,285,0,4924
"09009350100",894,931,396,227,275,523,693,873,4812
"09009350200",801,492,748,746,360,482,937,865,5431
"09009350300",289,251,446,312,221,270,247,509,2545
"09009350400",373,556,717,301,253,361,493,784,3838
"09009350500",614,670,139,180,607,566,846,1224,4846
"09009350800",2248,1118,925,385,444,506,1561,1334,8521
"09009350900",1137,28,683,182,257,18,619,73,2997
"09009351000",1727,434,848,559,419,222,1054,414,5677
"09009351100",1340,461,1131,323,393,247,714,532,5141
"09009351200",876,615,688,527,577,694,846,1146,5969
"09009351300",3062,594,845,137,1208,172,1675,284,7977
"09009351400",1680,654,518,56,399,509,1237,922,5975
"09009351500",2913,394,578,53,664,279,858,613,6352
"09009351601",2000,253,326,238,251,281,438,294,4081
"09009351602",4950,283,270,133,347,249,601,275,7108
"09009351700",609,735,479,270,479,177,707,672,4128
"09009351800",2614,356,335,42,129,55,143,101,3775
"09009351900",1699,119,123,30,157,100,357,81,2666
"09009352000",3186,110,593,15,915,204,610,204,5837
"09009352100",1815,387,584,231,616,101,520,285,4539
"09009352200",614,361,469,238,419,536,497,775,3909
"09009352300",1436,479,876,134,302,44,804,421,4496
"09009352400",1920,150,279,97,420,216,1027,210,4319
"09009352500",1480,163,641,14,356,30,414,81,3179
"09009352600",3167,804,616,32,978,0,957,284,6838
"09009352701",2187,350,220,9,213,32,592,166,3769
"09009352702",3914,399,608,60,567,66,1372,250,7236
"09009352800",3474,545,396,380,1187,579,1894,851,9306
"09009361100",6101,206,101,0,148,3,367,3,6929
"09009361200",4883,97,142,5,161,37,514,42,5881
"09009361300",4269,168,42,2,210,0,112,0,4803
"09009361401",913,610,85,80,366,72,81,61,2268
"09009361402",151,51,0,0,24,31,5,0,262
"09009361500",1848,257,1587,599,792,114,1546,55,6798
"09009990000",0,0,0,0,0,0,0,0,0
"09011650100",2213,74,0,0,52,28,37,17,2421
"09011660101",3124,8,0,0,49,3,57,1,3242
"09011660102",4093,80,13,0,216,0,42,0,4444
"09011690300",2360,752,1445,402,1083,566,1556,694,8858
"09011690400",811,332,318,102,348,245,785,431,3372
"09011690500",878,636,419,155,273,387,355,359,3462
"09011690700",472,258,176,16,39,123,147,157,1388
"09011690800",1453,272,388,55,684,312,660,398,4222
"09011690900",3253,225,263,0,457,192,446,192,5028
"09011693300",4187,297,111,2,424,0,168,0,5189
"09011693400",3335,310,50,0,395,32,400,16,4538
"09011693500",3182,93,26,105,92,0,132,0,3630
"09011693600",2541,121,19,14,208,1,51,1,2956
"09011693700",2634,228,49,0,559,0,364,64,3898
"09011695201",4343,250,99,45,291,63,152,98,5341
"09011695202",5284,315,0,0,1024,27,424,4,7078
"09011696100",3654,262,228,202,494,30,487,0,5357
"09011696200",3995,46,300,16,548,69,691,0,5665
"09011696300",1991,80,69,0,397,133,256,101,3027
"09011696400",2767,456,588,267,949,556,716,239,6538
"09011696500",2138,342,394,37,333,34,126,24,3428
"09011696600",2657,132,232,129,718,75,253,8,4204
"09011696700",2695,977,725,178,1221,151,648,401,6996
"09011696800",1546,370,382,168,736,575,359,385,4521
"09011697000",2791,436,508,122,872,205,735,155,5824
"09011700100",3667,291,89,13,602,73,117,32,4884
"09011701100",5941,307,185,9,1337,106,622,146,8653
"09011701200",6257,380,86,0,423,38,148,37,7369
"09011702100",3910,102,72,6,394,0,254,0,4738
"09011702300",1338,228,100,17,312,0,224,90,2309
"09011702400",2504,99,515,19,435,55,110,0,3737
"09011702500",2243,873,464,92,695,127,778,409,5681
"09011702600",1076,34,0,0,61,0,24,0,1195
"09011702700",3388,334,36,57,895,22,368,76,5176
"09011702800",2618,253,329,52,806,3,436,38,4535
"09011702900",2245,118,1,0,160,14,96,1,2635
"09011703000",3073,182,70,8,115,0,137,0,3585
"09011705101",4160,294,15,0,255,75,172,117,5088
"09011705102",3407,359,111,0,287,3,76,3,4246
"09011705200",3201,104,36,12,69,9,25,0,3456
"09011705300",2984,115,0,0,245,0,209,0,3553
"09011705400",2296,112,0,0,105,0,78,0,2591
"09011707100",4601,278,110,1,278,21,71,93,5453
"09011708100",2387,63,0,0,142,10,45,0,2647
"09011709100",5713,433,47,0,449,28,34,5,6709
"09011709200",3912,893,31,1,235,88,203,257,5620
"09011710100",4114,81,0,0,129,11,38,0,4373
"09011711100",2561,170,48,0,149,40,49,0,3017
"09011712100",1834,86,0,0,47,7,14,9,1997
"09011713100",2378,88,20,12,88,41,108,0,2735
"09011714101",2735,349,26,0,89,7,137,0,3343
"09011714103",7238,121,88,0,252,0,45,0,7744
"09011714104",4759,121,48,0,99,5,99,15,5146
"09011715100",3637,160,69,0,281,0,91,0,4238
"09011716101",3619,70,40,12,367,0,85,0,4193
"09011716102",3979,141,139,6,790,10,224,0,5289
"09011870100",6732,295,32,2,213,22,243,11,7550
"09011870200",4371,450,639,0,710,2,571,16,6759
"09011870300",1266,743,670,103,620,112,1054,579,5147
"09011870501",2602,132,245,0,897,30,252,42,4200
"09011870502",1893,82,67,10,247,10,111,0,2420
"09011870701",1980,62,59,0,67,0,102,0,2270
"09011870703",1472,67,0,0,57,51,176,0,1823
"09011870704",3664,149,119,2,273,9,177,2,4395
"09011980000",3,0,0,0,14,0,0,0,17
"09011990100",0,0,0,0,0,0,0,0,0
"09013526101",4317,34,24,0,84,0,74,0,4533
"09013526102",4790,100,49,1,215,0,113,7,5275
"09013528100",2841,92,65,25,158,0,47,0,3228
"09013529100",4495,151,40,19,255,1,223,1,5185
"09013530100",1780,140,59,0,268,2,285,1,2535
"09013530200",4186,711,181,149,252,278,269,137,6163
"09013530301",3639,398,745,135,615,63,528,219,6342
"09013530302",5045,337,48,0,591,0,228,0,6249
"09013530400",2422,200,90,73,439,70,208,62,3564
"09013530500",2969,109,16,0,94,0,103,13,3304
"09013530600",2468,17,178,4,21,3,59,3,2753
"09013533101",8776,164,30,0,287,20,559,29,9865
"09013533102",5254,93,20,0,218,6,95,0,5686
"09013535100",8495,217,76,0,120,51,189,4,9152
"09013535200",6257,125,36,0,331,17,57,0,6823
"09013538100",0,0,0,0,0,0,0,0,0
"09013538201",4662,296,0,15,211,51,68,1,5304
"09013538202",3898,64,28,0,129,0,48,0,4167
"09013840100",5121,622,0,0,228,23,356,0,6350
"09013850100",4830,87,52,0,361,0,298,0,5628
"09013850200",6738,250,0,0,97,0,170,15,7270
"09013860100",4580,265,126,0,493,0,0,0,5464
"09013881100",3432,214,114,0,299,106,175,11,4351
"09013881200",77,84,0,0,9,3,0,0,173
"09013881300",2018,1257,36,26,422,221,157,22,4159
"09013881500",3679,207,242,11,743,62,277,26,5247
"09013890100",3068,727,9,0,280,50,95,127,4356
"09013890201",3382,105,4,0,8,75,56,0,3630
"09013890202",4672,322,27,9,54,0,29,6,5119
"09015800300",1764,1071,257,122,404,312,578,1080,5588
"09015800400",3103,247,126,19,485,99,1434,178,5691
"09015800500",4716,972,155,0,447,234,758,699,7981
"09015800600",1635,1418,170,78,571,405,1584,1256,7117
"09015800700",1958,450,126,14,533,112,829,170,4192
"09015815000",2094,66,0,24,44,14,110,8,2360
"09015820000",1714,107,18,0,51,5,58,23,1976
"09015825000",1621,43,3,0,42,0,79,0,1788
"09015830100",3801,291,77,0,75,26,47,2,4319
"09015900100",4168,367,33,0,124,0,19,5,4716
"09015900200",4214,304,0,0,125,7,111,13,4774
"09015901100",7482,141,33,0,218,42,275,0,8191
"09015902200",1577,47,4,1,75,3,27,3,1737
"09015902500",3838,127,34,0,91,0,17,17,4124
"09015903100",6018,712,28,0,341,18,219,68,7404
"09015903200",1956,151,0,6,19,3,13,0,2148
"09015904100",6547,487,34,0,46,10,203,27,7354
"09015904400",3418,369,28,12,300,9,130,4,4270
"09015904500",4369,471,158,108,464,174,146,260,6150
"09015905100",6631,857,12,14,83,96,298,273,8264
"09015906100",4740,205,37,0,128,0,0,0,5110
"09015907100",3576,459,91,0,153,166,10,0,4455
"09015907200",4505,436,134,0,175,77,314,128,5769
"09015907300",4578,477,97,0,161,23,100,0,5436
"09015908100",3144,428,41,0,118,10,38,0,3779
"10001040100",5358,536,456,85,230,102,258,54,7079
"10001040201",3447,310,1027,148,343,0,233,15,5523
"10001040202",8556,169,2986,425,835,100,520,53,13644
"10001040203",3697,561,1434,132,164,20,143,0,6151
"10001040501",2107,279,1610,524,397,35,232,203,5387
"10001040502",1035,51,722,0,227,47,351,30,2463
"10001040700",1943,125,1716,451,297,172,173,2,4879
"10001040900",976,250,227,109,86,63,33,0,1744
"10001041000",3211,674,2059,62,452,85,797,271,7611
"10001041100",2201,291,365,0,507,26,382,65,3837
"10001041200",1702,317,953,375,794,186,136,101,4564
"10001041300",696,150,486,839,58,15,44,84,2372
"10001041400",1132,337,829,439,415,7,398,18,3575
"10001041500",2123,87,902,607,196,90,55,1,4061
"10001041600",1412,103,306,37,286,16,44,11,2215
"10001041701",4222,271,754,218,427,0,288,0,6180
"10001041702",2941,264,1415,95,237,7,209,0,5168
"10001041801",5112,815,2277,190,890,35,467,57,9843
"10001041802",3181,430,792,188,508,152,385,21,5657
"10001041900",3900,573,425,163,191,63,133,195,5643
"10001042000",2711,298,49,13,113,37,95,1,3317
"10001042100",2809,546,396,13,65,63,191,130,4213
"10001042201",6107,379,1767,576,1060,228,522,248,10887
"10001042202",6514,674,891,331,681,77,529,4,9701
"10001042500",1943,225,727,363,24,58,839,62,4241
"10001042800",4555,697,1028,295,352,49,258,120,7354
"10001042900",3724,353,541,112,115,4,88,12,4949
"10001043000",3758,443,754,228,320,121,190,0,5814
"10001043100",2099,262,142,52,56,3,67,0,2681
"10001043202",2655,448,264,9,66,72,129,0,3643
"10001043300",1509,241,1139,167,262,94,168,63,3643
"10001043400",2934,335,658,135,225,36,248,43,4614
"10001990000",0,0,0,0,0,0,0,0,0
"10003000200",622,89,3562,1289,128,20,146,31,5887
"10003000300",477,22,1545,674,243,24,203,0,3188
"10003000400",1278,182,1010,526,75,1,92,93,3257
"10003000500",353,71,1935,376,50,0,57,19,2861
"10003000601",43,75,2001,591,154,6,80,9,2959
"10003000602",238,90,1746,883,161,27,161,12,3318
"10003000900",51,0,1341,439,101,11,149,6,2098
"10003001100",2086,250,351,113,155,52,62,92,3161
"10003001200",1227,81,86,0,70,9,138,0,1611
"10003001300",3320,120,78,0,132,0,52,0,3702
"10003001400",1394,119,562,79,57,15,171,77,2474
"10003001500",955,179,382,206,109,6,32,0,1869
"10003001600",452,157,1199,503,145,190,355,176,3177
"10003001902",398,14,890,417,149,13,45,13,1939
"10003002100",155,66,812,872,87,75,94,104,2265
"10003002200",589,164,702,701,526,160,938,309,4089
"10003002300",535,918,1350,421,268,238,656,1104,5490
"10003002400",2342,283,1211,453,274,24,735,134,5456
"10003002500",1923,173,503,128,283,158,710,189,4067
"10003002600",1099,129,1268,574,377,598,831,581,5457
"10003002700",732,176,692,483,222,68,463,173,3009
"10003002800",778,113,528,159,97,42,68,13,1798
"10003002900",30,102,1313,1794,23,53,20,119,3454
"10003003002",54,41,725,807,56,44,58,26,1811
"10003010101",1331,379,1698,321,542,81,121,107,4580
"10003010104",1992,176,772,408,314,18,181,26,3887
"10003010200",1367,71,329,12,176,0,78,0,2033
"10003010300",1784,141,813,26,205,77,222,0,3268
"10003010400",3727,161,373,62,261,8,31,4,4627
"10003010502",4359,268,770,118,190,8,47,9,5769
"10003010702",3192,121,1440,12,370,216,434,0,5785
"10003010800",3859,125,409,33,276,91,138,91,5022
"10003010900",2405,65,28,4,77,0,68,0,2647
"10003011000",2672,70,253,2,120,31,116,15,3279
"10003011100",2316,80,185,1,110,0,47,7,2746
"10003011201",1367,64,35,3,439,67,32,0,2007
"10003011202",3338,118,209,11,494,18,115,18,4321
"10003011203",3298,50,794,49,817,0,11,0,5019
"10003011204",2668,72,331,0,150,11,35,12,3279
"10003011205",1879,26,119,0,95,0,81,0,2200
"10003011206",3708,26,91,0,289,7,93,0,4214
"10003011300",1933,35,54,0,202,0,30,0,2254
"10003011400",2674,35,304,0,210,0,61,0,3284
"10003011500",2357,199,29,0,318,59,100,0,3062
"10003011600",2732,129,90,0,335,12,55,0,3353
"10003011700",3836,75,18,0,185,0,155,0,4269
"10003011800",3244,190,40,1,360,0,12,17,3864
"10003011900",2678,195,87,0,448,92,427,177,4104
"10003012000",2999,636,420,96,301,37,297,555,5341
"10003012100",2032,171,152,0,107,0,87,19,2568
"10003012200",3174,394,1004,131,71,45,710,163,5692
"10003012300",1988,176,185,59,267,20,757,10,3462
"10003012400",3350,283,223,85,334,1,1009,56,5341
"10003012500",4072,762,437,343,183,58,789,467,7111
"10003012600",2183,193,21,2,51,0,202,1,2653
"10003012700",2915,462,442,103,224,40,217,242,4645
"10003012900",2257,373,1021,336,275,199,565,470,5496
"10003013000",1599,172,60,0,66,15,62,40,2014
"10003013100",1695,201,8,22,107,6,101,120,2260
"10003013200",1998,67,250,7,338,101,595,125,3481
"10003013300",1679,35,51,0,58,0,203,0,2026
"10003013400",1998,136,96,1,233,28,12,28,2532
"10003013501",5322,76,0,0,530,8,30,0,5966
"10003013503",6089,223,92,4,916,53,169,18,7564
"10003013505",2641,62,33,0,275,0,57,0,3068
"10003013506",4109,13,108,0,386,16,210,0,4842
"10003013604",3398,297,50,0,288,0,173,34,4240
"10003013607",4153,192,466,50,502,15,492,0,5870
"10003013608",1410,195,118,3,101,26,124,1,1978
"10003013610",4591,122,217,30,694,161,179,0,5994
"10003013611",3692,100,690,26,682,31,321,0,5542
"10003013612",4719,53,301,0,968,0,204,0,6245
"10003013613",4058,93,630,66,739,0,417,0,6003
"10003013614",2608,333,113,2,184,0,875,189,4304
"10003013615",2880,225,118,25,260,256,275,236,4275
"10003013700",2160,481,461,37,509,193,716,469,5026
"10003013800",3207,155,574,102,684,0,294,0,5016
"10003013901",2201,109,309,33,455,51,477,50,3685
"10003013903",2917,119,1488,14,336,0,301,0,5175
"10003013904",3915,370,1996,224,1575,20,463,16,8579
"10003014000",2544,402,1508,173,811,97,516,49,6100
"10003014100",2619,167,1083,126,399,317,342,256,5309
"10003014200",1362,136,262,9,186,23,178,26,2182
"10003014300",3282,263,217,99,237,226,100,0,4424
"10003014402",1671,982,106,0,593,69,48,285,3754
"10003014403",2761,524,616,264,291,170,227,61,4914
"10003014404",2929,159,268,0,337,72,56,0,3821
"10003014501",456,1320,15,39,76,99,18,64,2087
"10003014502",688,1908,110,152,41,91,30,171,3191
"10003014702",1593,123,190,2,67,0,232,0,2207
"10003014703",2914,358,567,160,721,7,399,0,5126
"10003014705",3111,234,1214,0,283,23,242,0,5107
"10003014706",1338,65,929,354,289,121,379,117,3592
"10003014803",2641,270,540,0,423,20,182,0,4076
"10003014805",6194,90,2146,341,1372,76,491,0,10710
"10003014807",5719,293,1217,175,1032,27,366,20,8849
"10003014808",3126,475,1766,35,646,177,357,161,6743
"10003014809",4823,423,1895,19,600,88,306,69,8223
"10003014810",4730,205,1331,135,627,186,221,186,7621
"10003014903",2734,753,2378,841,491,208,1281,615,9301
"10003014904",2570,153,1355,54,711,22,225,17,5107
"10003014906",1716,207,1943,218,861,99,303,27,5374
"10003014907",1907,376,1920,260,688,35,585,19,5790
"10003014908",542,152,1233,93,226,49,132,10,2437
"10003014909",2306,430,2900,337,486,88,747,303,7597
"10003015000",2622,385,1636,325,409,0,480,13,5870
"10003015100",2494,239,515,0,147,87,308,223,4013
"10003015200",3232,548,705,248,618,213,1175,367,7106
"10003015400",59,0,2007,542,154,6,419,0,3187
"10003015502",707,190,1079,628,209,35,320,7,3175
"10003015600",809,321,1057,119,256,6,588,191,3347
"10003015802",1194,212,279,11,622,75,804,175,3372
"10003015900",2167,139,1072,8,185,39,522,0,4132
"10003016000",947,85,1540,167,280,138,240,134,3531
"10003016100",1043,75,422,45,196,12,136,0,1929
"10003016200",1885,231,220,29,41,231,202,193,3032
"10003016301",3130,226,841,305,698,0,572,7,5779
"10003016302",2390,69,2927,111,1571,20,685,62,7835
"10003016305",2411,223,3621,431,864,0,222,6,7778
"10003016401",3609,302,1724,52,789,0,196,0,6672
"10003016404",2450,292,299,19,144,34,131,79,3448
"10003016601",8879,327,2135,335,463,16,574,44,12773
"10003016602",5699,153,1017,53,457,0,294,0,7673
"10003016604",7533,267,2849,258,950,0,633,0,12490
"10003016608",4150,48,249,14,121,43,54,0,4679
"10003016801",4567,245,978,18,167,9,71,18,6073
"10003016804",5240,123,1493,96,134,0,199,14,7299
"10003016901",1719,131,80,2,26,0,10,0,1968
"10003016904",1120,91,15,2,0,6,24,0,1258
"10003980100",0,0,0,0,0,0,0,0,0
"10003990100",0,0,0,0,0,0,0,0,0
"10005050101",2571,216,404,134,153,13,128,13,3632
"10005050103",3307,283,522,10,268,2,299,2,4693
"10005050104",3220,380,342,20,30,90,339,112,4533
"10005050105",3581,568,1614,84,157,371,516,530,7421
"10005050200",2000,1009,710,236,145,28,318,495,4941
"10005050301",5166,754,1069,346,257,102,518,207,8419
"10005050302",3338,534,479,321,295,59,247,158,5431
"10005050401",2574,382,253,400,39,24,11,27,3710
"10005050403",2077,326,529,65,178,154,365,208,3902
"10005050405",2652,294,496,31,159,0,241,0,3873
"10005050406",1636,332,1134,1068,69,136,105,193,4673
"10005050407",2791,142,904,615,305,31,221,17,5026
"10005050408",2985,483,617,8,272,52,225,81,4723
"10005050501",2807,119,355,31,270,1,335,0,3918
"10005050503",3165,642,298,338,786,372,2632,685,8918
"10005050504",3147,585,311,140,152,56,294,366,5051
"10005050601",3439,452,570,135,88,129,190,51,5054
"10005050602",3525,567,1009,302,305,250,152,86,6196
"10005050701",2254,420,798,156,186,111,200,137,4262
"10005050703",1511,180,193,73,142,88,88,105,2380
"10005050704",3270,206,313,55,118,13,140,9,4124
"10005050705",3856,525,100,4,420,3,144,0,5052
"10005050706",1252,97,11,0,44,0,6,0,1410
"10005050801",2388,211,321,150,183,26,209,53,3541
"10005050802",3997,147,537,29,101,1,89,1,4902
"10005050803",5593,428,442,48,305,30,444,34,7324
"10005050901",1712,188,40,22,156,0,12,0,2130
"10005050902",3617,281,241,1,299,1,47,8,4495
"10005051003",3815,259,192,209,388,39,408,141,5451
"10005051004",3205,374,106,84,336,6,139,11,4261
"10005051005",3867,361,99,2,165,10,136,0,4640
"10005051006",2309,253,28,0,94,0,68,0,2752
"10005051007",4121,439,71,34,98,67,124,0,4954
"10005051101",535,76,0,0,0,0,0,0,611
"10005051102",888,46,0,0,11,5,0,0,950
"10005051103",761,52,0,0,18,0,22,7,860
"10005051201",1237,81,18,0,19,0,116,0,1471
"10005051202",718,10,0,0,4,3,14,0,749
"10005051203",555,52,0,0,32,0,10,0,649
"10005051204",552,24,0,0,10,0,10,4,600
"10005051205",666,13,0,0,7,0,0,0,686
"10005051301",4599,548,0,9,98,0,61,275,5590
"10005051302",2628,674,141,7,0,0,267,216,3933
"10005051303",4338,221,52,1,304,0,102,19,5037
"10005051305",2063,180,44,0,17,0,0,47,2351
"10005051306",2134,163,96,0,106,0,97,31,2627
"10005051400",3159,494,362,86,224,126,1080,422,5953
"10005051500",3533,461,954,15,456,140,645,143,6347
"10005051701",3505,355,139,0,72,0,172,0,4243
"10005051702",4432,507,254,0,33,239,128,239,5832
"10005051801",3577,351,217,240,252,0,92,0,4729
"10005051802",2005,350,1017,426,298,215,263,157,4731
"10005051900",3268,330,349,149,97,81,30,196,4500
"10005990000",0,0,0,0,0,0,0,0,0
"11001000100",4624,110,44,0,393,13,398,0,5582
"11001000201",11,11,0,48,0,11,0,11,92
"11001000202",2669,610,49,57,169,43,155,44,3796
"11001000300",4696,579,74,0,580,150,496,0,6575
"11001000400",1142,83,70,23,152,39,217,0,1726
"11001000501",2515,206,107,9,335,112,361,15,3660
"11001000502",2587,89,88,30,313,0,290,0,3397
"11001000600",3407,240,193,55,398,16,333,104,4746
"11001000701",4061,304,98,85,688,0,282,1,5519
"11001000702",2600,140,120,63,371,90,346,15,3745
"11001000801",4572,585,346,69,457,262,312,321,6924
"11001000802",2177,300,248,0,190,162,370,20,3467
"11001000901",3575,244,137,265,283,42,557,108,5211
"11001000902",2089,61,48,3,118,15,377,0,2711
"11001001001",6074,335,51,48,1080,17,573,71,8249
"11001001002",2067,717,136,40,345,210,352,112,3979
"11001001100",3473,152,209,64,423,27,255,24,4627
"11001001200",3867,262,200,14,474,63,251,45,5176
"11001001301",3050,309,273,17,356,55,116,139,4315
"11001001302",5709,587,440,46,873,141,522,71,8389
"11001001401",2474,245,156,106,340,12,243,22,3598
"11001001402",2192,63,344,103,269,113,314,23,3421
"11001001500",4632,152,822,4,410,0,212,0,6232
"11001001600",940,14,2926,91,118,13,160,0,4262
"11001001702",1188,26,1210,206,273,45,290,9,3247
"11001001803",361,0,2636,250,539,144,571,98,4599
"11001001804",1140,241,2768,469,869,63,1826,274,7650
"11001001901",522,6,2459,458,334,22,432,22,4255
"11001001902",267,4,1409,207,340,12,399,6,2644
"11001002001",717,42,1065,131,678,7,706,11,3357
"11001002002",681,189,1902,391,653,31,602,233,4682
"11001002101",512,74,2985,713,1168,251,1514,259,7476
"11001002102",481,0,2495,725,822,411,913,401,6248
"11001002201",433,10,2506,272,439,18,346,0,4024
"11001002202",164,112,1991,698,789,211,760,323,5048
"11001002301",760,15,1547,413,435,91,357,60,3678
"11001002302",316,307,631,160,96,32,16,0,1558
"11001002400",1030,94,2047,363,633,85,793,126,5171
"11001002501",898,4,923,686,189,38,445,105,3288
"11001002502",1752,218,2737,538,739,95,1811,276,8166
"11001002600",1071,13,1006,34,361,46,183,17,2731
"11001002701",3648,330,625,41,474,183,807,328,6436
"11001002702",3641,198,1227,187,555,47,1389,47,7291
"11001002801",1149,412,1272,441,968,133,1270,478,6123
"11001002802",2525,152,763,465,953,143,2082,189,7272
"11001002900",2078,196,1376,153,899,166,1216,277,6361
"11001003000",1435,162,1011,791,245,12,226,45,3927
"11001003100",944,218,944,99,1114,36,1161,231,4747
"11001003200",1413,192,2318,319,390,135,1134,197,6098
"11001003301",1321,176,1290,163,454,32,275,17,3728
"11001003302",709,66,983,233,253,37,165,37,2483
"11001003400",685,83,1253,282,223,92,354,92,3064
"11001003500",959,39,702,630,448,40,547,8,3373
"11001003600",2284,152,1358,278,549,71,504,71,5267
"11001003700",2461,338,1158,505,556,61,1059,246,6384
"11001003800",3369,173,499,251,701,115,801,129,6038
"11001003900",3157,297,330,159,500,0,489,0,4932
"11001004001",3469,92,93,0,202,22,227,38,4143
"11001004002",2222,51,220,0,274,46,198,14,3025
"11001004100",2132,101,103,7,207,47,242,20,2859
"11001004201",2874,137,242,69,317,0,247,24,3910
"11001004202",2020,154,48,17,375,52,221,15,2902
"11001004300",2108,134,691,213,329,6,460,37,3978
"11001004400",3461,336,1108,95,262,287,291,207,6047
"11001004600",969,15,1334,384,197,14,113,6,3032
"11001004701",724,50,1659,944,558,48,211,17,4211
"11001004702",1019,85,498,235,166,35,70,11,2119
"11001004801",755,52,838,182,287,17,95,12,2238
"11001004802",946,36,1182,435,424,256,358,44,3681
"11001004901",916,241,627,371,317,11,253,221,2957
"11001004902",1475,195,620,93,241,123,291,159,3197
"11001005001",1193,35,405,95,359,0,104,0,2191
"11001005002",2721,539,880,335,1397,63,1272,449,7656
"11001005201",4265,334,239,69,795,123,532,109,6466
"11001005301",3981,281,169,0,699,130,252,63,5575
"11001005500",4378,544,112,34,787,417,612,34,6918
"11001005600",3115,506,223,78,680,269,436,152,5459
"11001005800",1630,39,132,98,560,238,244,0,2941
"11001005900",1465,117,340,321,428,57,204,18,2950
"11001006202",0,0,0,0,0,0,0,0,0
"11001006400",103,0,906,898,44,35,59,0,2045
"11001006500",2032,68,139,63,100,0,91,24,2517
"11001006600",1662,76,69,3,113,9,66,0,1998
"11001006700",3133,115,357,38,245,28,137,0,4053
"11001006801",611,29,1018,282,74,18,24,0,2056
"11001006802",1047,76,718,151,189,71,118,28,2398
"11001006804",0,0,6,114,0,0,0,0,120
"11001006900",1480,41,475,81,71,0,54,0,2202
"11001007000",1765,59,233,77,189,13,157,0,2493
"11001007100",1050,125,800,1190,148,22,170,13,3518
"11001007200",2450,207,849,198,295,0,99,18,4116
"11001007301",1820,78,762,0,261,14,288,14,3237
"11001007304",63,27,1993,1308,43,12,62,0,3508
"11001007401",4,0,959,1468,11,0,22,22,2486
"11001007403",0,15,2154,1092,51,0,51,64,3427
"11001007404",5,1,1931,1748,49,13,0,13,3760
"11001007406",0,0,1862,1204,63,0,27,25,3181
"11001007407",21,0,2182,633,92,0,0,0,2928
"11001007408",0,0,1465,1398,16,13,16,13,2921
"11001007409",25,0,2576,1202,0,45,12,0,3860
"11001007502",20,10,2123,2832,9,6,9,0,5009
"11001007503",21,8,1350,1207,11,15,0,15,2627
"11001007504",44,8,1310,1134,0,0,0,0,2496
"11001007601",57,19,2882,837,18,31,0,68,3912
"11001007603",263,82,2740,291,91,165,79,315,4026
"11001007604",153,1,3074,503,75,0,82,0,3888
"11001007605",50,16,2401,794,205,65,24,0,3555
"11001007703",0,0,2600,2211,72,0,72,0,4955
"11001007707",72,0,3235,879,133,0,0,0,4319
"11001007708",0,0,1853,944,0,0,0,0,2797
"11001007709",29,9,1136,467,122,0,82,0,1845
"11001007803",40,0,2141,640,183,2,121,0,3127
"11001007804",0,0,2172,767,99,20,139,0,3197
"11001007806",32,26,1557,455,29,11,5,1,2116
"11001007807",26,2,1670,498,15,5,26,0,2242
"11001007808",35,4,2854,1384,46,0,60,10,4393
"11001007809",40,16,1831,658,105,0,53,0,2703
"11001007901",628,0,2135,1028,193,33,88,18,4123
"11001007903",241,5,934,410,79,8,16,0,1693
"11001008001",1758,39,717,134,321,3,131,0,3103
"11001008002",2064,101,1011,184,316,0,172,0,3848
"11001008100",2536,78,381,11,202,0,186,0,3394
"11001008200",2257,270,119,5,187,17,191,39,3085
"11001008301",1793,130,265,18,193,37,132,10,2578
"11001008302",1664,110,302,31,143,16,107,9,2382
"11001008402",912,66,710,172,133,5,50,5,2053
"11001008410",547,37,769,48,59,5,41,3,1509
"11001008701",631,15,1416,218,27,42,96,0,2445
"11001008702",219,15,990,417,69,51,76,44,1881
"11001008802",503,110,2557,1062,163,141,18,0,4554
"11001008803",22,37,457,541,39,12,21,29,1158
"11001008804",86,17,1544,636,232,140,117,21,2793
"11001008903",189,32,1981,932,66,156,55,145,3556
"11001008904",99,21,1827,739,447,0,333,0,3466
"11001009000",30,41,2281,574,53,0,45,10,3034
"11001009102",554,16,3147,1159,185,37,487,40,5625
"11001009201",388,53,712,226,103,36,73,43,1634
"11001009203",355,97,1749,354,202,15,167,69,3008
"11001009204",272,42,1260,954,238,197,410,149,3522
"11001009301",1051,92,1684,299,215,13,108,13,3475
"11001009302",187,7,628,19,184,0,69,8,1102
"11001009400",611,259,3130,360,78,65,246,60,4809
"11001009501",317,139,2830,622,479,619,626,690,6322
"11001009503",465,9,2125,539,44,0,20,75,3277
"11001009504",514,16,1609,236,369,41,385,30,3200
"11001009505",47,0,2037,266,374,63,311,63,3161
"11001009507",120,6,1364,128,5,0,164,28,1815
"11001009508",273,14,2662,273,350,112,286,112,4082
"11001009509",51,25,2711,107,423,0,423,0,3740
"11001009601",0,2,1181,926,58,0,9,0,2176
"11001009602",0,10,1745,1270,129,0,129,10,3293
"11001009603",21,9,2175,491,166,27,129,0,3018
"11001009604",57,4,1765,206,8,0,48,8,2096
"11001009700",4,4,2014,949,40,10,4,10,3035
"11001009801",16,2,1098,673,7,80,9,5,1890
"11001009802",0,0,884,663,0,0,0,0,1547
"11001009803",5,0,1658,1082,0,0,0,0,2745
"11001009804",19,18,1688,675,118,0,120,18,2656
"11001009807",68,3,1993,1067,11,0,22,0,3164
"11001009810",0,4,1501,898,66,9,0,9,2487
"11001009811",0,0,3040,1684,21,0,0,0,4745
"11001009901",139,0,1906,126,65,0,35,0,2271
"11001009902",12,6,2174,555,63,0,29,0,2839
"11001009903",40,30,1331,310,57,0,23,0,1791
"11001009904",23,0,1272,745,32,72,24,79,2247
"11001009905",100,2,2007,644,0,1,83,0,2837
"11001009906",19,26,1067,387,20,0,24,10,1553
"11001009907",14,0,1689,1071,20,48,54,39,2935
"11001010100",1428,175,236,54,386,106,185,26,2596
"11001010200",1150,46,925,90,332,0,158,0,2701
"11001010300",562,53,1579,357,375,226,439,223,3814
"11001010400",163,41,2539,1266,98,5,61,5,4178
"11001010500",1592,40,1129,286,380,0,179,14,3620
"11001010600",2440,331,1167,645,415,121,330,84,5533
"11001010700",959,310,113,12,292,49,74,0,1809
"11001010800",641,289,98,27,130,194,99,47,1525
"11001010900",15,41,1819,2164,25,10,42,10,4126
"11001011000",1829,74,1031,53,302,0,211,18,3518
"11001011100",481,80,3343,767,145,23,229,23,5091
"12001000200",1520,3555,544,375,95,423,270,558,7340
"12001000301",1197,920,649,385,99,139,123,23,3535
"12001000302",1211,544,298,126,181,47,150,114,2671
"12001000400",1496,341,2608,858,281,201,324,256,6365
"12001000500",3005,799,516,677,172,68,315,114,5666
"12001000600",240,56,2118,1672,133,59,41,14,4333
"12001000700",1030,168,3813,1229,27,59,0,16,6342
"12001000806",688,699,113,110,160,117,87,146,2120
"12001000808",1270,493,297,304,745,375,204,122,3810
"12001000809",391,149,223,72,129,49,27,11,1051
"12001000901",117,51,23,0,313,216,103,61,884
"12001000902",7,4,0,0,12,4,0,0,27
"12001001000",2966,3068,0,43,185,78,287,562,7189
"12001001100",5532,210,79,29,329,58,420,18,6675
"12001001201",1968,71,189,21,213,342,347,0,3151
"12001001202",4657,409,639,661,652,0,579,48,7645
"12001001203",2029,752,299,271,263,99,232,181,4126
"12001001400",533,263,977,559,97,65,79,10,2583
"12001001514",346,399,153,60,73,51,27,122,1231
"12001001515",1208,1632,302,572,546,804,148,586,5798
"12001001516",397,541,297,87,221,231,107,126,2007
"12001001517",1343,1714,570,544,76,799,65,553,5664
"12001001519",496,556,302,431,209,535,122,148,2799
"12001001520",713,928,108,93,200,38,393,302,2775
"12001001521",1333,1023,573,258,348,210,346,284,4375
"12001001603",569,622,216,120,54,25,53,46,1705
"12001001604",2962,2834,417,634,413,513,402,490,8665
"12001001701",3532,606,679,827,567,141,572,56,6980
"12001001702",3992,402,304,30,309,147,456,119,5759
"12001001801",4823,752,868,125,179,38,80,81,6946
"12001001802",1392,256,330,479,195,8,78,74,2812
"12001001803",3998,290,744,949,366,28,229,95,6699
"12001001805",1357,69,126,71,57,11,132,0,1823
"12001001806",6340,1252,553,307,353,57,487,174,9523
"12001001811",4524,456,268,101,1524,126,644,14,7657
"12001001813",2187,107,147,0,557,0,206,0,3204
"12001001814",2663,108,81,0,295,0,508,0,3655
"12001001902",408,785,754,844,152,11,39,32,3025
"12001001907",1869,617,189,38,71,32,33,143,2992
"12001001908",2694,425,487,101,271,42,113,27,4160
"12001002000",2862,1172,875,353,106,26,65,5,5464
"12001002101",1199,200,234,128,50,8,75,0,1894
"12001002102",637,48,106,13,4,0,36,0,844
"12001002201",3203,530,470,121,217,49,136,11,4737
"12001002202",5093,245,476,21,186,0,133,17,6171
"12001002204",8103,347,976,0,1765,56,856,0,12103
"12001002205",8001,339,361,279,817,62,926,98,10883
"12001002207",2874,95,225,0,476,0,406,0,4076
"12001002208",2287,78,40,0,120,0,131,0,2656
"12001002209",5674,639,447,190,756,100,542,161,8509
"12001002210",2700,421,581,467,106,0,343,2,4620
"12001002217",2156,682,1588,873,210,317,395,219,6440
"12001002218",795,226,611,700,88,34,70,46,2570
"12001002219",2666,665,1147,335,420,112,361,298,6004
"12001002220",1217,139,292,168,63,12,99,32,2022
"12001110800",1419,520,71,38,20,23,78,176,2345
"12003040101",4837,892,283,0,212,121,172,0,6517
"12003040102",4584,1398,647,232,36,0,0,185,7082
"12003040201",3735,963,925,267,31,4,69,3,5997
"12003040202",4350,614,144,39,8,0,88,22,5265
"12005000201",4182,416,0,0,91,99,49,15,4852
"12005000202",4096,517,21,0,350,17,0,0,5001
"12005000300",5279,1225,0,39,158,117,197,50,7065
"12005000400",6711,954,13,0,316,99,0,103,8196
"12005000500",4259,187,388,0,306,62,231,38,5471
"12005000600",1086,255,15,0,38,8,51,6,1459
"12005000700",1714,198,318,40,446,33,375,25,3149
"12005000803",2722,429,629,206,246,268,270,42,4812
"12005000804",1682,277,238,0,185,0,119,0,2501
"12005000805",2660,677,529,32,574,127,210,0,4809
"12005000806",2511,447,477,40,382,264,142,46,4309
"12005000900",2887,427,664,106,230,80,191,0,4585
"12005001000",940,414,456,189,109,46,40,7,2201
"12005001100",1872,755,655,357,457,312,78,2,4488
"12005001200",1492,450,813,172,197,64,187,55,3430
"12005001301",4100,441,349,9,217,77,201,0,5394
"12005001302",5220,659,679,113,276,113,415,33,7508
"12005001402",5466,515,1121,0,363,0,161,0,7626
"12005001403",1621,189,106,197,166,45,44,0,2368
"12005001404",5263,772,340,0,392,43,355,0,7165
"12005001501",4189,180,595,12,167,58,485,15,5701
"12005001502",4416,441,362,27,220,0,310,6,5782
"12005001600",810,420,1639,751,97,67,121,83,3988
"12005001700",931,274,1381,352,308,109,193,84,3632
"12005001800",627,326,58,83,238,49,0,3,1384
"12005001900",3352,394,24,0,274,36,126,56,4262
"12005002000",931,205,168,34,175,3,6,0,1522
"12005002200",2381,854,647,397,96,243,340,313,5271
"12005002300",3013,607,265,9,131,119,207,82,4433
"12005002400",2359,889,193,230,200,71,241,290,4473
"12005002500",2382,167,15,0,241,47,64,11,2927
"12005002601",2091,225,143,0,198,0,202,0,2859
"12005002603",2000,386,8,20,21,0,106,5,2546
"12005002604",5725,555,186,47,398,27,138,0,7076
"12005002605",885,152,0,0,0,0,95,0,1132
"12005002606",1360,353,0,0,75,14,46,7,1855
"12005002607",1177,150,5,0,56,0,72,0,1460
"12005002608",2602,0,0,0,110,0,115,0,2827
"12005002701",3194,352,153,0,400,129,286,155,4669
"12005002702",2392,329,13,0,46,0,74,0,2854
"12005002703",2474,361,132,41,197,0,220,0,3425
"12005002704",4425,638,98,17,293,0,320,45,5836
"12005002705",1511,131,65,39,114,8,220,34,2122
"12005990000",0,0,0,0,0,0,0,0,0
"12007000100",2768,651,1041,755,230,8,27,8,5488
"12007000200",4480,837,382,263,104,35,75,35,6211
"12007000300",6354,878,514,270,189,0,222,5,8432
"12007000400",2777,574,350,327,45,1,132,1,4207
"12009060101",2251,523,311,392,289,50,177,0,3993
"12009060102",2879,165,0,0,85,0,13,0,3142
"12009060200",4532,153,502,16,124,105,125,19,5576
"12009060300",3794,376,281,266,194,63,126,104,5204
"12009060400",2491,687,475,118,172,119,206,104,4372
"12009060500",3385,907,516,141,103,38,95,47,5232
"12009060600",2696,594,732,585,220,63,161,15,5066
"12009060700",700,241,626,830,0,333,42,212,2984
"12009061001",2783,633,806,31,390,40,332,163,5178
"12009061002",2181,585,168,139,21,76,125,213,3508
"12009061100",4469,518,416,90,215,58,345,1,6112
"12009061201",5426,335,649,0,513,79,437,0,7439
"12009061202",3009,174,129,0,367,6,373,0,4058
"12009062103",6326,706,483,0,265,20,400,44,8244
"12009062104",5335,725,449,35,133,8,386,103,7174
"12009062106",2141,740,98,88,127,256,45,309,3804
"12009062107",2374,374,0,112,7,10,96,0,2973
"12009062108",4663,310,465,35,295,55,331,31,6185
"12009062109",2536,491,161,47,134,0,103,26,3498
"12009062301",1082,264,1173,779,183,84,133,116,3814
"12009062302",1188,796,459,425,176,44,212,69,3369
"12009062400",3297,1389,595,413,359,127,542,505,7227
"12009062500",2158,592,922,772,121,0,69,113,4747
"12009062600",298,401,1033,974,95,247,93,353,3494
"12009062800",3343,252,92,66,30,0,278,19,4080
"12009062900",2547,256,1300,476,173,0,95,0,4847
"12009063000",3058,198,359,43,433,23,464,0,4578
"12009063102",6767,375,516,244,497,0,433,150,8982
"12009063104",2658,124,357,37,213,0,202,0,3591
"12009063105",6664,319,846,86,1035,115,928,45,10038
"12009063106",3063,280,254,53,529,22,176,113,4490
"12009063107",7095,659,610,0,486,46,710,343,9949
"12009064102",4458,86,126,0,229,0,453,0,5352
"12009064123",4761,311,209,0,293,0,375,42,5991
"12009064124",2992,213,254,103,176,30,60,33,3861
"12009064125",4532,454,80,31,658,55,462,177,6449
"12009064126",4108,95,249,13,196,43,115,13,4832
"12009064127",5880,416,201,4,479,4,520,6,7510
"12009064128",10168,683,839,0,685,0,1467,0,13842
"12009064201",1648,302,0,8,159,12,142,19,2290
"12009064202",1724,592,70,69,79,14,256,100,2904
"12009064301",4959,1122,305,42,293,90,508,25,7344
"12009064302",3858,811,319,110,904,14,462,73,6551
"12009064400",4203,573,22,102,251,0,238,93,5482
"12009064500",3266,776,25,48,139,37,292,85,4668
"12009064601",5698,432,242,6,326,82,434,6,7226
"12009064602",1849,236,40,0,90,8,203,0,2426
"12009064700",2734,776,56,72,34,23,144,140,3979
"12009064800",1728,393,114,125,95,8,38,26,2527
"12009064901",4069,615,199,54,133,339,368,16,5793
"12009064902",1015,547,1287,349,47,217,246,19,3727
"12009065001",2149,127,70,0,241,66,161,0,2814
"12009065021",7943,951,324,0,1214,19,546,64,11061
"12009065022",3823,479,58,0,291,0,317,42,5010
"12009065121",3464,1397,777,136,658,97,1065,562,8156
"12009065122",3462,1100,667,545,716,196,606,382,7674
"12009065123",2190,464,418,177,107,40,122,7,3525
"12009065124",509,125,940,952,32,124,63,53,2798
"12009065125",4055,660,885,261,118,161,438,145,6723
"12009065201",4388,585,343,330,139,41,760,26,6612
"12009065202",3885,401,270,257,156,145,751,119,5984
"12009065231",4403,541,216,269,71,167,111,29,5807
"12009065234",2941,371,24,0,32,22,60,36,3486
"12009065235",3879,1106,83,0,25,28,137,0,5258
"12009065236",1361,72,22,0,203,0,45,12,1715
"12009066101",3875,218,0,0,39,25,203,90,4450
"12009066103",1490,126,0,0,13,14,33,20,1696
"12009066104",4694,494,0,0,119,78,391,0,5776
"12009066200",2057,396,0,0,154,0,103,80,2790
"12009066301",5236,563,50,26,311,127,244,44,6601
"12009066302",3661,432,0,10,414,0,382,75,4974
"12009066400",4296,499,0,0,85,125,51,14,5070
"12009066500",2908,205,53,0,256,37,199,66,3724
"12009066600",3915,165,0,0,133,0,135,8,4356
"12009066700",4229,178,165,0,131,25,180,64,4972
"12009066800",1211,115,24,9,121,0,219,20,1719
"12009066900",5135,656,138,2,295,47,248,49,6570
"12009067100",609,39,124,0,200,18,172,32,1194
"12009068101",1776,310,0,0,91,38,0,24,2239
"12009068102",3103,270,0,1,65,0,99,10,3548
"12009068200",2285,159,0,0,80,0,25,0,2549
"12009068300",2510,120,42,0,26,9,0,0,2707
"12009068400",1944,135,29,10,111,5,101,5,2340
"12009068501",2064,166,31,11,29,0,79,0,2380
"12009068502",1963,585,103,0,46,0,112,0,2809
"12009068601",1561,297,125,0,60,10,89,10,2152
"12009068602",2936,536,0,0,115,10,356,34,3987
"12009069100",4211,297,42,15,214,0,221,49,5049
"12009069200",1882,251,0,0,103,7,240,7,2490
"12009069300",2577,325,1,0,107,31,175,10,3226
"12009069400",5144,139,110,0,387,49,145,0,5974
"12009069700",1382,537,146,52,147,0,166,246,2676
"12009069801",2887,260,63,26,264,63,274,0,3837
"12009069802",2948,815,280,103,424,124,382,38,5114
"12009069901",6688,725,14,0,418,35,557,49,8486
"12009069902",2661,281,337,530,216,0,349,33,4407
"12009071100",2879,463,0,0,37,0,128,7,3514
"12009071200",11512,770,199,0,1567,76,1341,73,15538
"12009071301",3986,101,258,9,156,15,445,38,5008
"12009071322",5570,1091,1621,334,920,100,1872,580,12088
"12009071332",6900,1507,2081,633,707,234,1533,465,14060
"12009071334",5804,884,568,436,592,71,1005,70,9430
"12009071335",3542,191,499,25,135,0,409,26,4827
"12009071336",4151,358,597,332,761,0,841,56,7096
"12009071337",4030,1693,1173,209,197,219,696,329,8546
"12009071338",4901,863,1766,23,558,29,921,289,9350
"12009071339",5473,715,1038,345,666,0,995,156,9388
"12009071340",7620,888,1478,874,692,51,1674,127,13404
"12009071400",2100,770,152,235,96,19,108,79,3559
"12009071500",2204,168,97,48,49,59,278,0,2903
"12009071600",3167,773,143,0,98,27,164,0,4372
"12009980000",0,0,0,0,0,0,0,0,0
"12009980100",0,0,0,0,0,0,0,0,0
"12009990000",0,0,0,0,0,0,0,0,0
"12011010102",2801,240,285,0,0,6,512,56,3900
"12011010103",2808,345,0,0,36,0,97,57,3343
"12011010104",1990,108,0,10,0,0,80,9,2197
"12011010200",4484,748,385,4,385,47,953,187,7193
"12011010304",813,251,1708,911,85,32,667,153,4620
"12011010305",2251,672,747,532,74,39,798,361,5474
"12011010306",601,54,1053,339,176,9,222,0,2454
"12011010307",1011,579,1324,1533,371,82,367,444,5711
"12011010308",3545,570,233,43,198,12,246,36,4883
"12011010401",3780,444,164,31,289,98,1015,54,5875
"12011010402",2634,404,128,128,77,121,501,63,4056
"12011010403",4025,797,0,15,14,50,113,30,5044
"12011010405",3692,1149,1341,339,590,97,817,546,8571
"12011010406",2994,496,262,19,478,22,685,314,5270
"12011010407",3798,518,147,48,267,31,624,42,5475
"12011010502",2310,215,159,10,189,174,271,146,3474
"12011010503",10634,402,523,0,1003,151,2129,329,15171
"12011010504",4343,232,428,108,650,13,642,36,6452
"12011010601",6947,202,246,66,1165,0,1699,25,10350
"12011010603",4073,271,476,17,538,34,831,77,6317
"12011010604",2637,123,752,86,197,0,799,17,4611
"12011010605",4807,119,505,0,764,15,1457,0,7667
"12011010606",4684,476,1071,94,576,148,1850,403,9302
"12011010607",7872,194,1264,355,957,50,2957,111,13760
"12011010609",2780,193,326,75,725,0,852,68,5019
"12011010610",4409,712,442,17,406,75,1102,480,7643
"12011010611",3103,138,322,99,573,26,1228,42,5531
"12011010612",4741,107,611,0,899,34,1155,75,7622
"12011010701",2029,664,1709,463,152,106,517,336,5976
"12011010702",1973,842,3547,1378,178,94,1246,446,9704
"12011010800",3246,570,1127,847,751,113,1532,256,8442
"12011010901",1968,190,52,0,43,35,122,35,2445
"12011010902",2618,240,31,0,43,17,268,8,3225
"12011011000",1528,49,9,10,34,0,151,14,1795
"12011020101",5037,408,1077,16,1291,0,2565,175,10569
"12011020103",3330,289,898,300,407,148,803,257,6432
"12011020104",1206,296,723,68,74,64,491,108,3030
"12011020204",3229,517,1363,233,446,119,1332,144,7383
"12011020205",3503,413,1845,113,988,30,1163,76,8131
"12011020206",2081,530,823,273,610,92,742,101,5252
"12011020207",3580,192,1536,72,291,96,1020,15,6802
"12011020209",1855,262,399,112,282,89,1037,60,4096
"12011020210",3995,512,750,386,242,48,1046,22,7001
"12011020211",2028,347,160,39,45,6,720,15,3360
"12011020212",2034,428,308,65,176,87,354,223,3675
"12011020302",3439,567,1445,997,554,39,1281,406,8728
"12011020308",1870,267,1944,803,565,198,695,279,6621
"12011020309",3702,315,884,131,415,0,1372,105,6924
"12011020311",1964,408,579,17,205,48,281,103,3605
"12011020312",3543,317,836,58,765,76,1177,143,6915
"12011020313",3470,487,1858,357,426,200,1556,289,8643
"12011020314",2785,444,1172,104,401,58,1040,258,6262
"12011020315",3480,199,660,354,315,18,871,92,5989
"12011020316",2603,346,969,4,322,129,946,383,5702
"12011020317",2259,166,610,121,135,43,776,158,4268
"12011020318",6806,84,914,209,1152,28,2112,28,11333
"12011020319",5020,262,315,202,333,21,1401,88,7642
"12011020320",3595,353,506,249,426,57,1231,457,6874
"12011020321",1457,51,208,34,34,0,139,1,1924
"12011020322",2475,34,146,122,455,0,817,0,4049
"12011020323",1895,343,711,230,297,27,974,173,4650
"12011020324",3712,294,1691,43,657,170,2119,135,8821
"12011020325",1736,124,1039,157,292,32,721,71,4172
"12011020326",2707,367,1887,556,766,195,1915,257,8650
"12011020404",1780,128,3912,1179,663,87,910,143,8802
"12011020405",2081,575,1561,417,389,103,1277,525,6928
"12011020406",4666,530,1537,486,564,91,2447,326,10647
"12011020407",2127,572,3530,1085,745,129,1237,497,9922
"12011020409",6750,521,861,74,397,33,2090,160,10886
"12011020411",4658,464,1029,34,235,15,1328,409,8172
"12011020412",425,345,1571,1199,400,35,687,381,5043
"12011020413",1957,362,3512,693,429,25,1066,305,8349
"12011020414",2808,395,127,66,200,35,903,289,4823
"12011020415",2398,159,447,202,456,20,882,77,4641
"12011020501",1780,291,2013,234,779,91,1149,122,6459
"12011020502",1863,176,3344,526,635,403,862,461,8270
"12011030100",4023,116,89,49,121,0,390,15,4803
"12011030201",1973,618,800,356,86,80,685,297,4895
"12011030202",926,74,299,346,9,12,43,0,1709
"12011030203",3546,471,465,87,103,0,1295,145,6112
"12011030301",594,469,992,389,46,42,298,410,3240
"12011030302",3169,477,2960,1394,109,0,1549,57,9715
"12011030401",110,24,2601,943,25,0,14,0,3717
"12011030402",32,263,1714,1748,54,110,61,328,4310
"12011030500",1085,847,1809,952,208,41,802,657,6401
"12011030600",512,469,3244,1324,104,9,277,90,6029
"12011030702",2654,55,558,16,236,42,797,31,4389
"12011030703",3081,332,749,0,284,52,886,45,5429
"12011030704",3750,272,378,0,339,44,351,49,5183
"12011030705",3117,373,45,31,40,10,203,28,3847
"12011030801",2797,1384,1152,838,631,223,1686,1212,9923
"12011030802",5104,639,417,18,614,58,1142,184,8176
"12011030902",2385,427,287,107,96,7,126,12,3447
"12011030903",2064,851,159,243,195,89,373,563,4537
"12011030904",3824,366,47,89,176,0,421,0,4923
"12011031001",1526,254,58,128,194,0,218,0,2378
"12011031002",3368,641,105,49,158,61,655,96,5133
"12011031101",2027,237,0,189,18,0,105,46,2622
"12011031102",2644,291,117,34,60,88,310,24,3568
"12011031202",5080,516,58,0,130,19,385,25,6213
"12011031203",1047,39,6,0,35,0,34,0,1161
"12011031204",1805,503,0,3,20,0,126,26,2483
"12011031205",1319,144,21,7,52,18,92,12,1665
"12011040101",1328,202,0,0,88,0,96,0,1714
"12011040102",2627,263,30,0,22,5,195,0,3142
"12011040203",1450,235,18,0,84,0,196,49,2032
"12011040204",2341,195,82,0,97,20,431,20,3186
"12011040205",3944,253,24,117,148,24,614,18,5142
"12011040206",1849,241,69,22,170,0,397,0,2748
"12011040300",3007,486,118,58,258,33,467,163,4590
"12011040401",2088,101,20,0,39,17,199,0,2464
"12011040402",2499,238,45,12,65,18,331,124,3332
"12011040502",2984,359,0,2,88,116,144,15,3708
"12011040503",1650,199,92,16,16,0,92,18,2083
"12011040504",3212,218,22,0,83,0,243,0,3778
"12011040601",2995,362,79,0,273,27,427,0,4163
"12011040602",2650,172,8,40,207,6,263,77,3423
"12011040701",2112,247,108,16,149,59,335,98,3124
"12011040702",2719,350,301,95,186,311,440,332,4734
"12011040801",992,458,2200,1762,58,50,165,137,5822
"12011040802",1842,552,1472,534,249,89,394,175,5307
"12011040901",82,6,3121,1295,123,0,121,6,4754
"12011040902",143,64,2390,917,97,0,157,0,3768
"12011041000",46,29,1903,1207,4,45,17,41,3292
"12011041100",95,6,2951,1596,26,3,236,6,4919
"12011041200",134,39,2995,1447,42,39,119,17,4832
"12011041300",82,460,5303,886,94,0,45,460,7330
"12011041400",80,91,1728,1489,4,0,33,71,3496
"12011041500",49,87,1701,1401,70,74,114,90,3586
"12011041600",673,75,2808,1791,471,46,338,0,6202
"12011041700",620,341,981,2025,75,49,239,211,4541
"12011041801",1221,226,0,29,104,12,181,52,1825
"12011041802",2387,299,73,39,204,0,424,37,3463
"12011041900",2714,250,58,46,80,0,436,0,3584
"12011042000",2720,302,57,0,65,10,322,39,3515
"12011042100",2265,383,3,29,138,16,411,13,3258
"12011042200",2594,230,13,0,134,0,96,30,3097
"12011042301",2992,342,110,0,95,56,414,179,4188
"12011042302",721,387,76,414,28,0,316,93,2035
"12011042400",1207,42,14,0,16,0,94,0,1373
"12011042500",3640,699,873,71,385,194,683,355,6900
"12011042600",3419,745,395,306,119,15,500,75,5574
"12011042700",2627,619,922,1161,321,77,825,298,6850
"12011042800",1600,1323,3301,1082,148,7,1130,1068,9659
"12011042900",735,186,5418,1385,386,43,432,74,8659
"12011043001",1204,59,0,0,64,10,268,10,1615
"12011043002",4683,845,1016,236,364,93,2630,618,10485
"12011043100",3803,765,267,2,321,158,1135,572,7023
"12011043301",3650,489,447,2,252,1,1156,200,6197
"12011043302",942,254,137,213,51,4,212,95,1908
"12011050100",2903,571,84,0,830,417,1700,679,7184
"12011050204",3378,596,961,203,266,259,670,298,6631
"12011050205",2573,513,142,0,0,0,369,188,3785
"12011050206",2015,308,462,0,85,47,609,95,3621
"12011050207",2366,489,1586,696,374,206,927,92,6736
"12011050208",1423,363,1116,227,346,300,851,640,5266
"12011050301",665,49,5948,1339,294,237,483,57,9072
"12011050306",285,182,3141,697,47,113,98,166,4729
"12011050307",269,228,3630,1679,221,151,192,260,6630
"12011050308",35,45,1914,1045,16,0,34,0,3089
"12011050309",997,388,620,208,235,16,957,358,3779
"12011050310",1737,179,3825,250,181,103,576,46,6897
"12011050311",791,240,1632,347,119,8,243,25,3405
"12011050312",389,162,1139,214,142,35,293,15,2389
"12011050401",1798,477,1147,119,210,27,645,276,4699
"12011050402",2298,681,743,62,291,51,600,119,4845
"12011050501",2606,473,411,59,243,61,1176,233,5262
"12011050502",3155,260,651,316,494,132,1350,199,6557
"12011050601",2799,181,49,100,117,44,602,52,3944
"12011050602",2017,536,265,258,182,98,587,283,4226
"12011050701",1474,448,831,633,370,95,688,455,4994
"12011050702",2292,754,1710,648,691,153,1647,671,8566
"12011050800",377,50,2777,820,222,47,230,7,4530
"12011050900",3174,327,945,420,790,15,1082,61,6814
"12011051001",2748,488,220,0,65,0,467,200,4188
"12011051002",2111,244,74,16,69,0,144,8,2666
"12011060105",2829,359,2029,500,450,46,870,92,7175
"12011060107",1351,224,865,176,320,0,868,186,3990
"12011060109",1805,111,739,48,108,5,434,20,3270
"12011060111",3683,288,1536,87,420,60,1479,52,7605
"12011060112",3814,471,1029,76,282,62,1515,365,7614
"12011060113",3267,517,1579,193,514,12,994,215,7291
"12011060114",2693,283,2916,199,607,167,1014,180,8059
"12011060115",3662,237,1719,100,647,156,1958,132,8611
"12011060116",3404,238,2366,324,923,31,1885,87,9258
"12011060117",2984,552,2190,338,727,76,1737,442,9046
"12011060118",3791,273,657,21,398,13,1329,53,6535
"12011060119",3599,355,610,2,619,10,1594,270,7059
"12011060120",4803,273,1290,17,933,157,2437,150,10060
"12011060121",3727,223,441,38,459,25,836,85,5834
"12011060122",3254,173,961,0,548,75,1937,100,7048
"12011060123",1293,165,2086,172,84,0,749,16,4565
"12011060124",1099,238,2381,677,236,87,630,181,5529
"12011060125",585,84,1042,250,325,11,413,69,2779
"12011060126",926,54,3344,656,804,128,261,26,6199
"12011060127",1011,145,794,655,106,0,356,82,3149
"12011060128",2147,247,2468,550,352,59,1130,132,7085
"12011060203",348,195,3451,1504,162,127,205,91,6083
"12011060206",2166,377,955,410,562,42,1077,269,5858
"12011060207",1343,494,1136,178,190,21,697,286,4345
"12011060208",742,193,3162,1025,153,35,324,120,5754
"12011060209",754,87,1357,279,135,15,303,71,3001
"12011060210",1945,214,463,100,530,18,763,53,4086
"12011060211",3114,320,654,0,180,47,940,135,5390
"12011060212",2450,77,328,254,192,0,1092,51,4444
"12011060213",2540,564,427,51,390,73,1087,333,5465
"12011060302",304,190,4268,2535,291,44,189,126,7947
"12011060303",109,0,4349,2064,73,45,91,45,6776
"12011060304",126,30,1725,1191,41,6,31,27,3177
"12011060305",434,61,1385,178,171,5,303,21,2558
"12011060306",629,249,493,82,161,17,216,147,1994
"12011060401",540,81,2519,1229,83,0,156,9,4617
"12011060402",212,68,3991,1739,86,0,229,0,6325
"12011060403",276,184,3289,1016,320,58,355,19,5517
"12011060501",2874,597,1915,369,399,87,828,560,7629
"12011060503",3403,16,582,78,480,0,719,0,5278
"12011060504",3675,187,396,0,233,37,976,29,5533
"12011060505",3014,292,562,44,223,98,898,73,5204
"12011060603",2918,193,939,30,515,71,1365,159,6190
"12011060605",2421,323,659,87,266,25,824,119,4724
"12011060606",2759,404,1728,222,295,134,981,161,6684
"12011060607",2211,105,310,53,149,0,440,2,3270
"12011060608",4313,1154,1073,260,812,19,1796,119,9546
"12011060609",2249,281,372,12,126,48,655,127,3870
"12011060700",2086,150,629,232,133,8,445,16,3699
"12011060801",1259,131,116,93,322,31,147,9,2108
"12011060802",924,116,3483,947,494,217,1073,81,7335
"12011060900",3461,151,531,0,354,129,916,10,5552
"12011061001",5625,279,344,37,174,57,1142,31,7689
"12011061002",6822,193,430,134,746,129,2015,53,10522
"12011061100",4267,1362,655,340,786,76,3533,1116,12135
"12011070101",4048,1563,692,463,1154,394,1981,808,11103
"12011070102",907,67,68,0,24,0,158,39,1263
"12011070204",2466,610,638,135,249,193,879,139,5309
"12011070205",4555,305,186,8,352,163,1771,79,7419
"12011070207",4625,615,28,77,335,7,1024,281,6992
"12011070208",6302,650,269,8,1145,111,2160,167,10812
"12011070209",4666,52,10,0,578,0,740,0,6046
"12011070210",2522,244,99,80,292,14,801,131,4183
"12011070211",4202,266,134,103,427,159,1086,57,6434
"12011070304",5869,206,754,243,934,31,2929,51,11017
"12011070305",5692,1032,163,0,1137,167,3738,469,12398
"12011070306",5650,139,1164,125,714,19,2070,29,9910
"12011070310",2737,206,8,0,351,14,1489,120,4925
"12011070311",4612,273,230,0,701,61,2268,224,8369
"12011070312",6458,540,49,0,453,27,2727,269,10523
"12011070313",8567,501,491,0,1226,0,5099,360,16244
"12011070314",3797,290,298,10,542,8,2200,109,7254
"12011070315",4178,92,703,48,759,70,1895,75,7820
"12011070316",3974,174,396,20,636,16,1277,27,6520
"12011070317",11484,1186,948,160,1259,188,7261,1005,23491
"12011070318",6099,188,327,42,91,84,2311,175,9317
"12011070319",3975,155,109,0,477,63,1813,59,6651
"12011070320",5365,340,196,0,564,137,2796,91,9489
"12011070321",2253,263,231,0,125,175,823,149,4019
"12011070322",4735,743,196,17,1151,128,4169,671,11810
"12011070401",4987,304,430,0,708,152,2014,366,8961
"12011070402",2612,86,164,7,369,0,605,14,3857
"12011070403",4234,483,329,65,694,31,1517,199,7552
"12011070404",2776,196,21,0,323,0,562,0,3878
"12011070405",4100,113,376,55,549,29,1341,68,6631
"12011070501",4974,104,186,63,513,17,1332,79,7268
"12011070502",4213,901,1757,523,1831,288,3744,702,13959
"12011070601",3045,838,248,95,339,209,1518,468,6760
"12011070602",2977,487,312,152,158,159,1149,233,5627
"12011080101",3731,347,350,45,317,18,694,45,5547
"12011080102",2156,553,1314,814,192,88,883,182,6182
"12011080103",1061,151,107,7,12,5,418,44,1805
"12011080200",859,112,14,0,41,0,232,5,1263
"12011080402",1864,440,140,27,89,8,187,86,2841
"12011080403",3084,1167,1381,70,804,105,1154,519,8284
"12011080405",1717,220,263,148,236,184,522,180,3470
"12011080406",4181,689,606,28,584,175,1508,239,8010
"12011080500",1194,550,2257,2500,249,131,519,435,7835
"12011090101",5046,666,0,0,30,0,841,53,6636
"12011090102",1180,263,20,0,7,0,131,33,1634
"12011090200",3586,279,32,0,197,41,641,63,4839
"12011090301",1125,330,127,162,108,21,251,28,2152
"12011090302",3846,991,429,388,626,292,1466,375,8413
"12011090401",2677,540,367,158,164,30,962,226,5124
"12011090403",1757,405,747,314,292,135,1006,265,4921
"12011090404",2048,774,877,626,449,275,668,242,5959
"12011090502",5637,468,542,40,240,0,1560,141,8628
"12011090503",2255,138,28,0,72,0,36,0,2529
"12011090504",1690,610,282,6,404,250,549,492,4283
"12011090601",1938,303,141,19,810,0,1423,170,4804
"12011090602",4172,918,271,25,665,342,2039,850,9282
"12011090700",4609,540,1070,167,1001,137,3117,427,11068
"12011090801",2789,383,541,9,199,99,919,441,5380
"12011090802",3065,510,319,71,168,144,1147,247,5671
"12011090900",4480,384,703,15,416,11,1100,74,7183
"12011091000",3444,243,283,55,285,15,1305,78,5708
"12011091100",2563,1212,1206,418,710,203,2103,679,9094
"12011091201",2609,399,601,214,788,190,2076,370,7247
"12011091202",2531,512,584,96,904,137,2334,477,7575
"12011091300",2864,287,487,142,516,9,1740,177,6222
"12011091400",2535,271,1559,517,922,220,2035,408,8467
"12011091500",2028,224,2197,373,496,118,1487,195,7118
"12011091600",3823,396,1007,66,526,47,2012,87,7964
"12011091701",2521,409,301,169,326,42,1201,206,5175
"12011091702",2407,396,788,247,262,71,855,121,5147
"12011091801",1941,345,2313,554,612,24,1039,281,7109
"12011091802",1096,282,1282,477,125,20,651,223,4156
"12011091901",2549,387,315,23,226,56,760,105,4421
"12011091902",2870,712,496,22,476,106,869,280,5831
"12011092000",3215,235,47,0,215,0,948,46,4706
"12011100101",5825,713,165,13,348,103,1414,113,8694
"12011100103",2967,504,65,67,166,28,978,95,4870
"12011100104",2577,281,40,0,115,42,932,63,4050
"12011100105",1828,479,61,10,54,0,444,100,2976
"12011100201",650,237,103,97,163,8,360,113,1731
"12011100202",3925,777,188,119,123,96,1625,594,7447
"12011100300",3776,435,745,1249,419,37,2103,548,9312
"12011100400",1013,233,2575,1306,224,22,976,210,6559
"12011100501",357,91,215,80,33,48,214,68,1106
"12011100502",1627,1325,394,120,212,33,798,891,5400
"12011100600",2395,594,1595,157,873,168,1803,389,7974
"12011100700",282,136,3599,1200,76,61,151,38,5543
"12011100801",664,369,1601,617,146,62,509,157,4125
"12011100802",2039,434,4161,728,474,54,1134,273,9297
"12011110100",4456,399,1236,310,573,59,2400,248,9681
"12011110301",4883,205,732,28,832,0,3617,153,10450
"12011110302",6401,545,1697,63,308,163,4052,304,13533
"12011110303",3292,61,482,1,476,41,1828,62,6243
"12011110307",3961,373,623,2,385,3,2047,308,7702
"12011110308",3829,889,1323,132,726,101,1804,940,9744
"12011110309",4484,294,885,6,767,160,2540,207,9343
"12011110311",4556,178,1458,126,1079,174,2917,29,10517
"12011110312",4727,598,1380,89,1055,46,3328,304,11527
"12011110313",2821,752,1208,97,574,250,2124,690,8516
"12011110319",1202,101,3165,219,549,31,1097,75,6439
"12011110320",1366,315,6362,1010,832,354,1636,734,12609
"12011110321",3828,178,1097,62,439,12,3107,192,8915
"12011110322",5463,474,3581,16,881,213,4933,667,16228
"12011110323",796,209,3386,637,595,124,776,361,6884
"12011110324",8099,176,5088,153,2416,50,7687,174,23843
"12011110325",13601,327,5928,53,4515,182,11649,152,36407
"12011110326",3149,61,760,67,573,4,2076,33,6723
"12011110327",4491,219,709,40,1108,76,3172,43,9858
"12011110328",3421,210,1322,0,884,92,1931,202,8062
"12011110330",2168,55,772,0,595,0,1872,39,5501
"12011110331",6832,294,1441,0,1758,25,4461,66,14877
"12011110332",2806,64,789,157,612,0,1505,8,5941
"12011110333",3997,33,1009,0,1583,155,3346,168,10291
"12011110334",2410,121,87,36,116,16,1304,101,4191
"12011110335",5201,1674,383,74,328,183,2456,1333,11632
"12011110336",3303,417,1575,209,1193,83,2920,366,10066
"12011110337",2747,111,1828,546,921,115,2386,145,8799
"12011110338",2025,168,1199,17,401,74,1656,120,5660
"12011110339",2682,199,479,11,319,49,1553,89,5381
"12011110340",2851,488,2117,305,849,49,1948,77,8684
"12011110341",713,162,1587,264,261,0,661,65,3713
"12011110342",4057,284,5425,117,1186,62,3812,201,15144
"12011110343",4487,181,1563,67,2042,7,3949,32,12328
"12011110402",421,53,3692,553,538,148,296,73,5774
"12011110403",1326,548,2328,685,646,183,1112,619,7447
"12011110404",1206,256,3496,610,538,53,1282,354,7795
"12011110501",891,208,1803,386,370,41,746,212,4657
"12011110502",1380,20,2657,864,127,23,976,49,6096
"12011110600",3434,1024,326,17,310,239,1233,602,7185
"12011980000",21,0,0,0,0,0,0,0,21
"12011990000",0,0,0,0,0,0,0,0,0
"12013010100",1736,405,95,4,30,34,6,34,2344
"12013010200",2981,559,0,0,47,0,170,0,3757
"12013010300",3772,1523,784,213,281,78,7,294,6952
"12015010100",2290,374,0,1,101,101,270,63,3200
"12015010200",3431,684,0,0,216,42,264,0,4637
"12015010301",2551,290,9,0,260,0,16,0,3126
"12015010302",1646,625,319,25,62,192,10,179,3058
"12015010401",2776,214,19,10,23,0,41,0,3083
"12015010402",1963,300,32,0,16,55,9,0,2375
"12015010403",1910,39,10,17,9,21,142,0,2148
"12015010404",4195,57,18,0,116,0,159,0,4545
"12015010501",3365,736,0,3,6,18,180,275,4583
"12015010502",5982,599,1,1,218,42,413,26,7282
"12015020101",5524,869,1016,12,230,23,758,55,8487
"12015020103",4239,676,439,11,295,0,202,144,6006
"12015020104",1836,53,153,0,12,0,9,0,2063
"12015020201",5445,540,1001,346,52,21,669,129,8203
"12015020202",4993,816,444,46,94,0,523,18,6934
"12015020301",4266,590,314,20,251,44,41,100,5626
"12015020302",2404,451,315,71,389,43,364,84,4121
"12015020303",3431,868,326,177,48,10,239,91,5190
"12015020400",6805,645,386,47,227,0,283,0,8393
"12015020501",3988,283,143,27,105,0,139,0,4685
"12015020502",1302,70,0,0,228,45,182,45,1872
"12015020601",1690,452,21,89,130,0,283,127,2792
"12015020602",1950,513,429,38,62,51,115,26,3184
"12015020700",2649,754,104,288,387,45,292,0,4519
"12015020800",2732,955,202,78,128,54,302,184,4635
"12015020900",4788,692,520,78,599,31,525,15,7248
"12015021001",1448,118,120,14,32,7,32,7,1778
"12015021002",2565,151,42,0,65,0,212,56,3091
"12015021003",1959,425,432,14,72,0,108,148,3158
"12015030100",5096,768,46,17,123,7,208,107,6372
"12015030200",6452,1025,0,0,257,70,437,59,8300
"12015030301",2598,250,0,0,13,9,94,32,2996
"12015030302",3211,363,0,0,0,0,102,4,3680
"12015030401",1499,444,9,39,0,0,9,187,2187
"12015030402",1570,140,0,0,15,9,0,9,1743
"12015030501",3082,143,13,2,27,0,20,0,3287
"12015030502",4660,368,173,0,44,0,91,0,5336
"12015030503",5164,592,26,0,14,0,60,0,5856
"12015990000",0,0,0,0,0,0,0,0,0
"12017450101",4737,921,208,145,80,0,273,5,6369
"12017450102",2859,807,38,0,106,61,205,81,4157
"12017450201",2396,606,141,0,259,21,287,22,3732
"12017450202",3017,1815,140,46,69,0,394,363,5844
"12017450302",6782,1039,343,157,191,33,550,279,9374
"12017450303",3678,1397,36,63,428,77,334,58,6071
"12017450304",8134,931,225,185,302,21,453,0,10251
"12017450400",4614,788,0,21,81,87,96,10,5697
"12017450500",3596,483,0,42,199,0,62,90,4472
"12017450601",3314,1365,17,0,205,40,74,116,5131
"12017450602",3134,440,232,114,121,42,57,0,4140
"12017450701",5314,703,337,0,466,0,189,40,7049
"12017450702",6397,1391,295,401,329,23,332,149,9317
"12017450800",3569,840,151,0,19,32,180,0,4791
"12017450901",2466,387,0,10,10,54,21,2,2950
"12017450902",1662,450,39,108,150,0,13,3,2425
"12017451000",4537,729,20,0,278,0,339,0,5903
"12017451101",1663,67,14,28,27,0,98,43,1940
"12017451102",4568,794,65,159,187,23,50,90,5936
"12017451200",3064,508,0,43,149,0,54,47,3865
"12017451300",2430,478,51,12,33,15,191,88,3298
"12017451400",3206,580,0,0,216,18,199,122,4341
"12017451501",2376,430,22,0,0,12,37,8,2885
"12017451502",4141,1893,0,5,312,8,36,100,6495
"12017451601",5183,199,58,0,132,0,162,0,5734
"12017451602",6062,753,0,49,117,126,159,49,7315
"12017451700",3440,692,0,3,75,0,24,0,4234
"12017990000",0,0,0,0,0,0,0,0,0
"12019030102",6191,1792,219,132,236,0,27,145,8742
"12019030103",4352,1036,0,0,158,14,204,178,5942
"12019030104",2346,731,86,0,170,0,179,39,3551
"12019030201",8447,613,2620,173,1936,206,690,233,14918
"12019030202",6945,421,733,141,273,261,881,0,9655
"12019030203",10802,745,2366,775,2550,70,1744,98,19150
"12019030301",5610,188,940,60,719,74,882,110,8583
"12019030303",1744,193,320,54,240,69,449,9,3078
"12019030304",2769,249,751,31,531,35,563,61,4990
"12019030400",1103,250,274,184,151,8,335,29,2334
"12019030500",1934,193,268,18,252,0,234,4,2903
"12019030600",3310,412,493,32,321,202,92,52,4914
"12019030701",7311,264,15,3,162,14,304,0,8073
"12019030702",10661,810,829,124,1530,27,1746,41,15768
"12019030703",10618,184,450,58,1034,110,706,139,13299
"12019030801",4750,275,196,68,281,16,531,0,6117
"12019030802",5267,561,627,25,226,50,115,125,6996
"12019030902",6354,906,967,166,1093,396,1048,374,11304
"12019030903",2964,557,159,59,216,148,324,135,4562
"12019030904",5223,223,829,28,599,9,816,31,7758
"12019031101",2510,232,0,18,181,0,67,0,3008
"12019031104",3077,525,11,50,14,11,168,0,3856
"12019031105",1286,640,13,0,66,21,70,31,2127
"12019031106",4834,1032,326,0,108,0,62,23,6385
"12019031107",311,5,0,0,0,0,0,0,316
"12019031108",1171,133,48,0,23,0,17,10,1402
"12019031200",11459,1127,931,122,418,50,1114,28,15249
"12019031300",5007,335,109,91,172,0,366,27,6107
"12019031400",2500,595,1051,425,187,34,540,40,5372
"12019031500",2363,454,6,0,116,9,110,19,3077
"12021000101",1281,87,0,0,11,0,4,13,1396
"12021000102",1215,120,0,3,0,0,4,2,1344
"12021000200",1678,119,29,0,118,0,157,12,2113
"12021000301",2646,127,0,0,0,11,99,27,2910
"12021000302",1381,89,8,0,0,0,19,0,1497
"12021000401",2472,109,11,0,20,16,30,0,2658
"12021000402",1950,10,0,0,0,0,0,0,1960
"12021000500",1621,102,0,0,39,0,85,28,1875
"12021000600",1509,84,24,0,13,8,47,0,1685
"12021000700",204,326,489,312,0,0,30,254,1615
"12021010102",4454,307,137,17,57,60,596,75,5703
"12021010105",3816,147,12,0,0,0,472,7,4454
"12021010106",4178,157,0,11,60,0,44,0,4450
"12021010107",3809,170,34,6,193,0,257,42,4511
"12021010108",2901,194,0,0,0,0,217,14,3326
"12021010109",1997,262,29,0,145,0,411,154,2998
"12021010110",3860,675,39,8,557,45,1072,303,6559
"12021010205",2332,217,35,0,120,0,98,0,2802
"12021010208",3082,27,0,0,7,0,11,0,3127
"12021010209",1848,71,5,0,4,0,140,0,2068
"12021010210",3136,323,7,0,70,28,139,135,3838
"12021010211",1496,140,72,40,5,11,210,36,2010
"12021010212",5319,334,13,0,106,81,448,125,6426
"12021010213",4102,247,14,0,64,0,231,0,4658
"12021010215",2177,35,0,0,16,0,0,0,2228
"12021010300",2628,637,339,256,83,31,622,343,4939
"12021010401",3347,397,118,307,60,15,334,24,4602
"12021010405",9986,600,577,68,526,183,2061,168,14169
"12021010408",2220,278,11,7,213,72,271,106,3178
"12021010410",4949,2183,851,407,791,353,4089,2287,15910
"12021010411",5348,629,1446,103,281,519,3462,1056,12844
"12021010412",7422,617,218,222,136,44,2279,236,11174
"12021010413",5851,949,112,2,603,125,2748,572,10962
"12021010414",6147,499,715,46,286,31,2120,146,9990
"12021010415",12012,667,144,18,1329,0,2110,67,16347
"12021010416",4945,152,30,21,252,0,428,99,5927
"12021010417",4437,378,19,0,138,0,733,68,5773
"12021010418",4904,332,195,0,63,0,635,33,6162
"12021010419",2200,589,394,341,53,277,1665,695,6214
"12021010420",3874,868,552,378,692,815,3501,1495,12175
"12021010505",4650,875,336,211,441,10,1460,485,8468
"12021010506",3831,1709,0,0,440,119,887,1297,8283
"12021010507",2746,739,469,199,178,0,529,661,5521
"12021010508",3310,396,222,0,327,0,885,97,5237
"12021010509",3833,396,409,44,44,21,60,142,4949
"12021010510",2752,335,59,0,69,0,31,26,3272
"12021010601",1463,649,147,64,53,29,491,284,3180
"12021010602",2543,107,286,23,103,0,513,0,3575
"12021010604",2138,206,349,66,25,0,510,11,3305
"12021010605",2553,296,463,38,110,7,635,19,4121
"12021010606",1845,60,66,0,81,0,169,5,2226
"12021010701",2596,429,323,82,249,0,595,168,4442
"12021010702",2239,415,124,183,78,0,621,85,3745
"12021010801",3099,168,6,0,23,0,271,0,3567
"12021010802",5659,1775,1858,471,768,106,3400,1628,15665
"12021010803",2774,559,283,13,36,88,583,260,4596
"12021010902",3355,267,0,0,26,85,91,139,3963
"12021010903",4764,433,0,0,17,106,210,108,5638
"12021010904",1687,82,0,0,0,0,135,36,1940
"12021010905",2588,160,25,0,6,0,210,0,2989
"12021011001",1378,42,10,5,41,0,12,17,1505
"12021011002",1920,88,66,0,52,0,94,0,2220
"12021011102",6182,1281,119,65,690,21,1001,0,9359
"12021011103",1390,420,319,27,5,5,298,134,2598
"12021011105",2045,291,7,0,34,0,689,27,3093
"12021011106",1971,393,67,122,161,0,265,250,3229
"12021011201",6435,708,49,0,410,25,262,148,8037
"12021011202",17795,1647,354,338,790,158,6384,725,28191
"12021011204",759,864,700,756,354,449,1031,1383,6296
"12021011205",301,775,299,469,264,285,395,1009,3797
"12021011301",3502,1924,824,237,306,45,3736,1921,12495
"12021011302",2876,1520,552,519,514,881,3120,2230,12212
"12021011400",1953,956,105,78,580,579,2364,1451,8066
"12021990000",0,0,0,0,0,0,0,0,0
"12023110201",3317,267,419,538,147,185,285,168,5326
"12023110202",2322,373,1154,926,46,0,34,27,4882
"12023110300",2493,551,1045,379,218,62,145,24,4917
"12023110400",1335,259,807,584,188,94,133,11,3411
"12023110500",4256,543,601,564,261,47,239,90,6601
"12023110601",6156,1553,506,271,580,98,299,91,9554
"12023110602",3261,507,318,188,89,90,256,85,4794
"12023110700",3487,533,546,101,94,66,425,35,5287
"12023110800",4558,627,185,180,240,31,50,46,5917
"12023110901",3409,922,61,5,177,1,68,2,4645
"12023110903",2812,841,126,0,175,0,252,4,4210
"12023110904",4588,1025,459,115,102,81,196,153,6719
"12027010101",3147,961,9,0,122,0,680,501,5420
"12027010102",1818,1095,83,214,47,95,409,442,4203
"12027010200",2456,558,452,422,532,0,1011,362,5793
"12027010301",4217,2531,174,190,220,38,2496,2165,12031
"12027010302",297,260,908,976,15,10,42,187,2695
"12027010403",2244,428,12,136,37,3,75,35,2970
"12027010404",1861,1001,17,43,28,37,205,509,3701
"12027010405",1237,24,0,12,14,0,0,12,1299
"12027010406",2626,732,69,0,68,202,580,315,4592
"12029970101",2380,695,652,214,70,8,24,2,4045
"12029970102",5643,1086,0,0,108,87,67,0,6991
"12029970200",2856,596,201,90,74,15,16,9,3857
"12029990000",0,0,0,0,0,0,0,0,0
"12031000100",2587,238,1206,708,40,122,102,143,5146
"12031000200",91,104,1772,877,30,0,0,0,2874
"12031000300",277,219,666,690,19,101,31,12,2015
"12031000600",2332,810,650,768,531,399,38,167,5695
"12031000700",3066,213,333,112,207,85,126,15,4157
"12031000800",1812,93,88,100,69,30,85,43,2320
"12031001000",175,180,420,890,31,107,24,53,1880
"12031001100",696,195,250,262,36,0,52,0,1491
"12031001200",617,206,774,472,188,73,65,6,2401
"12031001300",148,327,2005,1590,25,0,73,51,4219
"12031001400",625,163,2059,1911,119,0,0,0,4877
"12031001500",6,24,1914,1441,35,11,0,173,3604
"12031001600",10,24,590,891,0,15,0,0,1530
"12031002101",1909,249,237,87,127,48,149,10,2816
"12031002102",2282,104,94,26,170,23,33,0,2732
"12031002200",3356,614,98,9,163,71,131,17,4459
"12031002300",1503,138,52,0,75,0,204,0,1972
"12031002400",1633,63,0,11,30,6,89,0,1832
"12031002501",1525,566,882,639,126,142,494,97,4471
"12031002502",2829,249,361,55,184,25,159,0,3862
"12031002600",249,362,1303,1169,0,5,13,35,3136
"12031002701",316,46,1882,1536,86,7,105,0,3978
"12031002702",698,120,1558,774,76,15,27,7,3275
"12031002801",31,9,2465,1171,23,0,0,9,3708
"12031002802",42,102,2335,1293,36,8,10,0,3826
"12031002901",59,16,1952,1661,37,8,47,1,3781
"12031002902",17,1,1637,1198,9,35,8,38,2943
"12031010101",4466,398,683,0,265,0,335,0,6147
"12031010102",6894,1037,1311,92,1092,83,821,92,11422
"12031010103",4527,112,949,9,383,1,303,17,6301
"12031010201",5749,1449,2296,175,858,0,707,179,11413
"12031010202",2643,301,69,0,200,101,125,2,3441
"12031010301",2290,554,575,37,205,43,61,0,3765
"12031010303",1536,140,4397,564,279,0,350,0,7266
"12031010304",508,90,5168,995,72,55,287,0,7175
"12031010401",1034,141,1105,531,40,0,76,87,3014
"12031010402",1286,263,1381,647,129,190,162,47,4105
"12031010500",3466,1659,8928,995,663,127,683,70,16591
"12031010600",4085,411,832,215,77,32,71,13,5736
"12031010700",135,39,3677,1459,60,11,0,0,5381
"12031010800",94,159,3944,1194,15,46,39,43,5534
"12031010900",277,90,2356,517,52,0,12,0,3304
"12031011000",593,191,1920,784,37,148,0,0,3673
"12031011100",300,138,1995,910,34,50,8,0,3435
"12031011200",160,13,2033,309,0,17,43,19,2594
"12031011300",13,0,1811,1248,8,8,0,0,3088
"12031011400",16,1,1684,701,5,12,5,73,2497
"12031011500",95,31,2655,1373,4,31,4,31,4224
"12031011600",0,113,2237,1372,0,0,0,0,3722
"12031011700",1586,807,755,215,80,24,236,30,3733
"12031011800",1352,230,756,686,40,116,29,66,3275
"12031011901",5083,963,1024,0,392,118,239,253,8072
"12031011902",4980,1860,2796,579,1247,198,1018,63,12741
"12031011903",3131,591,1003,142,367,0,82,57,5373
"12031012000",3526,234,644,572,212,86,304,54,5632
"12031012100",582,351,177,150,39,247,34,192,1772
"12031012200",2602,770,1373,1995,215,369,133,347,7804
"12031012300",2089,292,600,162,428,39,142,0,3752
"12031012400",2379,260,154,15,19,0,94,73,2994
"12031012500",1779,260,509,766,246,91,205,80,3936
"12031012601",887,153,840,706,171,89,179,0,3025
"12031012602",1936,378,1810,551,276,49,374,0,5374
"12031012702",2469,909,1470,441,125,42,354,390,6200
"12031012703",2870,268,1122,536,805,75,340,0,6016
"12031012704",2064,237,1950,843,301,89,629,57,6170
"12031012800",2923,581,1965,1488,831,392,544,294,9018
"12031012900",1496,161,719,10,391,6,192,10,2985
"12031013000",2453,126,48,0,41,0,8,0,2676
"12031013100",1665,174,325,61,9,0,47,0,2281
"12031013200",600,264,203,57,115,139,127,119,1624
"12031013300",3646,665,1859,566,797,160,694,406,8793
"12031013402",2051,890,913,637,298,138,250,311,5488
"12031013403",1688,339,611,253,37,118,58,99,3203
"12031013404",1139,334,644,714,97,169,9,255,3361
"12031013502",1535,245,1202,191,238,0,434,83,3928
"12031013503",3282,679,3014,965,780,382,573,274,9949
"12031013504",2055,322,1712,1417,525,27,581,69,6708
"12031013521",4045,490,3821,1727,1073,99,1158,42,12455
"12031013522",1871,317,1042,402,301,46,595,82,4656
"12031013721",4328,1356,2505,307,1183,90,1460,798,12027
"12031013723",3322,719,1040,234,543,97,596,203,6754
"12031013726",5165,804,2050,78,1805,169,932,469,11472
"12031013727",5152,458,2251,0,1220,213,353,21,9668
"12031013800",953,264,68,12,276,39,214,77,1903
"12031013901",2115,320,624,199,280,19,261,0,3818
"12031013902",3210,602,548,360,231,15,761,79,5806
"12031013904",2362,577,771,275,289,133,239,161,4807
"12031013905",3868,147,10,0,135,0,65,40,4265
"12031013906",3829,170,187,0,141,0,276,0,4603
"12031014001",3420,477,0,0,15,0,209,0,4121
"12031014002",2401,89,8,0,153,0,172,0,2823
"12031014101",3923,215,10,15,152,0,98,8,4421
"12031014102",2853,515,15,17,131,0,118,28,3677
"12031014202",3025,450,266,386,136,64,156,28,4511
"12031014203",3747,186,12,0,83,0,195,0,4223
"12031014204",4137,455,450,79,341,61,302,79,5904
"12031014311",2611,730,841,311,310,97,481,433,5814
"12031014312",4778,293,1281,357,462,240,1014,184,8609
"12031014326",5400,492,390,45,722,63,322,63,7497
"12031014328",3539,260,1021,77,1427,288,648,10,7270
"12031014329",1946,187,416,0,180,0,226,25,2980
"12031014330",3792,202,135,0,374,28,217,15,4763
"12031014331",3933,580,66,44,299,10,162,155,5249
"12031014332",6243,416,598,0,459,10,765,0,8491
"12031014333",2265,81,639,28,56,0,284,22,3375
"12031014334",2527,515,915,283,307,31,270,80,4928
"12031014335",5930,208,830,19,697,35,262,0,7981
"12031014336",3615,301,1136,22,1470,136,776,42,7498
"12031014337",4941,680,1351,767,2393,212,1250,304,11898
"12031014338",2605,259,577,90,930,104,415,110,5090
"12031014401",7426,1486,1221,1057,1400,141,2033,643,15407
"12031014404",3270,862,551,194,810,73,299,0,6059
"12031014406",5145,229,407,45,1021,0,340,92,7279
"12031014408",2824,347,297,234,249,98,98,12,4159
"12031014409",7532,290,284,0,1110,69,580,69,9934
"12031014410",5766,525,299,21,426,14,582,1,7634
"12031014411",3815,298,1091,131,2024,26,392,47,7824
"12031014412",9593,150,1348,40,2357,0,1336,0,14824
"12031014413",4142,536,184,108,1049,31,930,107,7087
"12031014500",2749,650,285,271,253,179,287,298,4972
"12031014601",5212,220,261,0,262,0,463,54,6472
"12031014603",2713,364,1007,53,443,0,396,0,4976
"12031014604",1925,264,1475,193,389,30,402,0,4678
"12031014701",2908,622,2704,786,360,28,324,63,7795
"12031014702",1388,126,451,880,405,0,121,21,3392
"12031014800",1534,174,704,662,112,57,313,46,3602
"12031014901",3372,267,1441,233,203,52,352,51,5971
"12031014902",3157,373,2374,236,702,39,655,73,7609
"12031015001",2957,265,1007,334,449,0,194,26,5232
"12031015002",2127,287,823,238,225,18,277,48,4043
"12031015100",2401,343,1194,545,143,1,350,15,4992
"12031015200",1181,212,812,296,72,129,273,139,3114
"12031015300",1591,310,507,287,153,20,135,17,3020
"12031015400",1199,204,559,243,60,7,80,8,2360
"12031015501",1304,349,416,402,102,13,58,16,2660
"12031015502",1152,295,1580,1227,238,0,140,44,4676
"12031015600",2548,504,545,121,167,15,87,0,3987
"12031015700",2411,627,1165,276,360,81,292,259,5471
"12031015801",4749,659,316,412,224,126,617,48,7151
"12031015802",2770,1031,1499,1386,424,262,581,192,8145
"12031015922",1582,275,520,118,433,36,186,10,3160
"12031015923",5508,323,579,693,1178,80,584,63,9008
"12031015924",3436,444,444,142,142,0,367,151,5126
"12031015925",2088,356,1350,95,1254,60,914,0,6117
"12031015926",3003,643,772,197,424,9,334,274,5656
"12031016000",4277,466,472,362,900,14,953,28,7472
"12031016100",4371,889,823,838,709,265,943,632,9470
"12031016200",992,443,190,99,299,29,151,219,2422
"12031016300",1165,187,379,181,133,289,91,19,2444
"12031016400",3883,419,276,131,24,0,132,186,5051
"12031016500",4146,214,257,0,406,430,212,87,5752
"12031016601",2549,856,1539,663,692,273,745,136,7453
"12031016603",2867,188,92,8,54,27,118,23,3377
"12031016604",3043,358,498,199,160,218,369,164,5009
"12031016711",3890,63,50,10,167,0,135,0,4315
"12031016722",4999,833,641,371,343,236,367,274,8064
"12031016724",3137,594,765,108,271,15,488,106,5484
"12031016725",2155,245,770,234,392,135,534,76,4541
"12031016726",2352,193,241,0,505,71,415,17,3794
"12031016727",2384,219,57,0,130,30,287,0,3107
"12031016728",3380,210,317,24,270,135,330,101,4767
"12031016729",4983,412,765,78,334,64,620,79,7335
"12031016801",1937,114,3,0,179,23,181,50,2487
"12031016803",6305,201,93,0,415,27,471,40,7552
"12031016804",7165,135,245,39,456,0,221,0,8261
"12031016805",5606,123,804,93,1381,99,728,99,8933
"12031016806",9359,524,1120,35,1236,37,1467,81,13859
"12031016807",2641,422,109,0,390,25,149,147,3883
"12031016808",2530,457,425,36,312,70,232,162,4224
"12031017100",3337,627,196,177,135,28,263,63,4826
"12031017200",574,194,363,557,145,34,247,35,2149
"12031017300",5067,824,810,187,371,63,514,43,7879
"12031017400",54,75,1294,945,0,66,10,57,2501
"12031990000",0,0,0,0,0,0,0,0,0
"12033000100",740,208,211,110,142,42,38,32,1523
"12033000300",697,215,663,179,199,0,105,0,2058
"12033000400",292,134,1585,1406,63,39,36,39,3594
"12033000500",861,68,243,189,39,9,43,12,1464
"12033000600",314,40,877,369,3,0,75,0,1678
"12033000800",2939,335,951,87,132,41,198,1,4684
"12033000900",2170,233,96,19,76,0,29,7,2630
"12033001001",5430,343,73,172,504,128,242,0,6892
"12033001002",2114,300,326,0,348,69,121,0,3278
"12033001101",4944,156,294,52,455,48,382,100,6431
"12033001103",2144,250,93,12,124,0,79,39,2741
"12033001104",4195,482,680,21,562,66,326,4,6336
"12033001201",2404,564,826,127,548,182,412,57,5120
"12033001202",2406,254,759,125,155,11,48,96,3854
"12033001300",1060,257,1586,1221,171,154,59,0,4508
"12033001401",1015,146,44,31,51,13,28,18,1346
"12033001402",3552,504,1348,1588,309,350,543,91,8285
"12033001500",4,0,732,377,8,0,0,0,1121
"12033001600",15,0,638,413,6,62,0,0,1134
"12033001700",869,328,526,573,9,19,10,130,2464
"12033001800",444,200,639,469,27,9,62,20,1870
"12033001900",461,145,585,442,168,112,7,15,1935
"12033002000",674,116,766,640,4,155,0,23,2378
"12033002100",1964,756,780,310,252,399,66,194,4721
"12033002200",1877,429,195,405,177,46,42,86,3257
"12033002300",3434,718,245,176,50,52,67,0,4742
"12033002400",731,14,248,0,125,15,149,21,1303
"12033002500",2330,164,0,0,145,132,102,75,2948
"12033002601",2380,200,58,0,190,0,66,0,2894
"12033002602",1047,43,0,0,19,5,0,5,1119
"12033002603",6406,536,392,24,685,11,388,34,8476
"12033002604",3182,388,259,50,251,12,99,38,4279
"12033002605",4020,152,321,174,597,141,724,40,6169
"12033002701",2078,126,213,195,462,13,23,64,3174
"12033002703",1081,355,540,956,71,107,128,192,3430
"12033002704",2648,488,432,297,702,122,207,63,4959
"12033002801",1309,430,372,675,218,0,76,46,3126
"12033002802",3165,585,409,337,493,61,210,363,5623
"12033002803",1412,364,457,357,156,18,63,0,2827
"12033002804",1285,151,292,76,196,0,192,0,2192
"12033002900",1845,606,562,815,328,42,150,96,4444
"12033003000",2883,382,1639,839,323,112,318,30,6526
"12033003100",1289,199,2523,639,243,103,41,3,5040
"12033003201",2115,91,1335,478,366,61,360,0,4806
"12033003203",1875,146,1909,647,148,26,66,15,4832
"12033003204",2090,15,296,0,377,0,100,0,2878
"12033003301",3059,335,325,34,200,35,143,26,4157
"12033003305",1488,191,160,44,115,10,5,58,2071
"12033003306",4082,372,1077,89,730,97,177,25,6649
"12033003307",861,315,923,106,264,0,40,0,2509
"12033003308",2667,215,767,0,360,14,150,25,4198
"12033003309",4594,897,659,297,283,198,168,226,7322
"12033003400",3059,348,862,223,286,102,199,64,5143
"12033003503",4725,495,831,296,241,236,160,43,7027
"12033003505",2444,366,294,10,189,26,202,80,3611
"12033003506",2761,203,1048,217,319,39,85,16,4688
"12033003507",3171,707,937,251,1037,207,447,176,6933
"12033003508",3549,579,1610,482,234,247,201,126,7028
"12033003603",5231,617,499,0,631,73,187,24,7262
"12033003607",1062,240,64,12,64,30,27,12,1511
"12033003608",6391,1496,574,87,211,46,272,38,9115
"12033003609",2623,467,569,11,197,144,0,0,4011
"12033003610",5575,699,419,18,524,40,242,0,7517
"12033003611",3991,204,472,0,364,3,266,3,5303
"12033003612",3735,149,287,0,287,86,177,56,4777
"12033003613",3296,482,14,4,177,3,109,0,4085
"12033003614",3819,143,675,768,153,0,53,20,5631
"12033003700",2142,780,648,121,117,108,85,30,4031
"12033003800",3077,275,301,62,215,216,49,36,4231
"12033003900",3121,430,240,90,235,207,212,12,4547
"12033004000",1440,153,599,320,95,15,1,2,2625
"12033990000",0,0,0,0,0,0,0,0,0
"12035060103",1212,167,34,0,22,61,28,53,1577
"12035060104",2817,362,101,11,190,346,168,1,3996
"12035060105",2950,222,151,15,115,0,137,0,3590
"12035060106",2275,397,0,0,0,0,25,0,2697
"12035060107",2907,537,434,73,337,241,445,206,5180
"12035060204",5221,461,709,70,596,634,502,626,8819
"12035060205",5671,1136,653,415,384,11,961,91,9322
"12035060206",3478,716,71,348,245,16,141,38,5053
"12035060207",3329,698,311,440,69,61,93,87,5088
"12035060208",4211,1441,329,231,337,42,641,170,7402
"12035060209",5134,739,660,193,316,0,363,100,7505
"12035060210",2358,601,556,70,163,93,26,122,3989
"12035060211",4218,261,523,341,495,52,507,42,6439
"12035060212",3232,789,586,218,299,18,519,288,5949
"12035060213",3434,202,669,694,684,730,381,703,7497
"12035060214",5460,925,1032,468,414,0,771,0,9070
"12035060301",4121,203,341,28,323,54,570,43,5683
"12035060302",3241,192,45,0,0,0,128,0,3606
"12035060303",1924,43,78,0,15,9,35,0,2104
"12035060304",2515,65,8,0,25,0,28,8,2649
"12035990000",0,0,0,0,0,0,0,0,0
"12037970100",1903,981,58,25,66,6,46,24,3109
"12037970200",2095,618,41,5,70,0,101,35,2965
"12037970302",1364,289,417,105,76,0,15,0,2266
"12037970304",1264,141,110,59,18,0,63,14,1669
"12037990000",0,0,0,0,0,0,0,0,0
"12037990100",0,0,0,0,0,0,0,0,0
"12039020101",2853,155,872,402,7,13,5,34,4341
"12039020102",2562,377,1872,973,124,13,79,6,6006
"12039020300",916,312,3378,1102,19,106,371,270,6474
"12039020400",1426,856,1169,1059,189,39,120,78,4936
"12039020500",2000,139,1982,933,75,35,907,66,6137
"12039020600",1076,117,2534,477,49,0,37,93,4383
"12039020701",394,85,1758,874,124,46,99,46,3426
"12039020702",465,88,2425,2032,512,303,502,228,6555
"12039020800",2567,638,778,475,270,463,794,831,6816
"12041950100",3651,1579,7,0,42,6,48,198,5531
"12041950201",1342,339,0,1,71,0,70,7,1830
"12041950202",1536,497,27,3,36,15,32,6,2152
"12041950203",2354,682,0,0,63,22,199,13,3333
"12041950204",2381,600,239,162,44,9,58,104,3597
"12043000100",1901,404,0,0,19,14,176,0,2514
"12043000200",4554,1382,412,377,60,306,1254,866,9211
"12043000300",1143,204,421,20,481,178,165,35,2647
"12043990000",0,0,0,0,0,0,0,0,0
"12045960100",4711,886,604,85,40,97,234,110,6767
"12045960200",1963,375,994,176,86,0,11,0,3605
"12045960300",2741,569,49,0,106,25,18,18,3526
"12045990000",0,0,0,0,0,0,0,0,0
"12047960100",2057,382,816,946,134,56,108,6,4505
"12047960200",2992,548,498,405,103,228,328,246,5348
"12047960300",831,313,462,207,55,91,84,3,2046
"12049970101",2442,1094,0,0,109,202,945,986,5778
"12049970102",2630,1102,0,103,117,111,891,402,5356
"12049970201",2444,1032,197,60,114,397,1330,993,6567
"12049970202",1119,163,0,0,34,0,279,0,1595
"12049970300",3772,1767,104,56,584,595,2261,1565,10704
"12049970400",3750,853,221,324,169,51,1627,327,7322
"12051000100",4201,466,452,157,1320,477,3163,881,11117
"12051000200",3644,910,1371,1182,295,226,2353,883,10864
"12051000300",3484,1556,12,117,894,304,2199,1489,10055
"12051000401",1620,744,0,0,607,614,923,964,5472
"12051000402",5339,1417,285,213,347,137,2936,807,11481
"12051000600",2181,612,24,39,534,590,1407,728,6115
"12051990000",0,0,0,0,0,0,0,0,0
"12053040101",4130,463,84,0,118,17,335,0,5147
"12053040102",1644,372,0,0,24,0,28,72,2140
"12053040201",2323,519,25,0,14,0,23,81,2985
"12053040202",3596,1251,443,469,111,0,38,65,5973
"12053040301",1433,219,0,44,22,2,61,10,1791
"12053040302",3256,459,69,3,10,6,192,37,4032
"12053040303",1735,415,9,0,34,35,212,76,2516
"12053040400",1782,404,617,198,0,11,25,41,3078
"12053040501",1679,751,353,473,174,61,201,170,3862
"12053040502",2062,715,127,209,183,31,192,37,3556
"12053040601",1558,347,11,392,12,11,76,103,2510
"12053040602",1933,216,30,0,43,0,11,0,2233
"12053040701",5028,454,181,9,53,48,320,72,6165
"12053040702",4603,387,55,2,123,0,655,55,5880
"12053040801",2640,599,55,0,138,35,162,0,3629
"12053040802",4113,489,74,0,14,11,401,11,5113
"12053040901",4662,407,61,47,138,62,521,46,5944
"12053040905",5544,263,232,0,278,0,527,112,6956
"12053040906",4510,442,133,69,560,70,939,69,6792
"12053040907",1984,126,165,0,108,75,496,13,2967
"12053040908",5102,954,334,0,530,21,758,461,8160
"12053040909",3250,382,309,192,545,74,591,58,5401
"12053040910",2510,888,34,156,239,0,217,130,4174
"12053040911",2829,279,182,0,170,5,608,14,4087
"12053041003",1622,823,186,170,65,42,267,98,3273
"12053041004",5165,559,196,11,450,488,670,381,7920
"12053041005",1720,305,147,13,211,7,416,150,2969
"12053041006",4684,1012,70,25,385,91,1083,159,7509
"12053041103",2664,512,16,395,307,0,416,25,4335
"12053041104",2150,286,36,10,135,0,137,2,2756
"12053041105",2981,1024,236,127,177,10,795,250,5600
"12053041106",3216,491,48,0,188,41,564,188,4736
"12053041201",3141,307,114,173,124,21,552,8,4440
"12053041203",3117,704,59,176,219,22,361,163,4821
"12053041204",2246,610,7,57,126,96,298,161,3601
"12053041302",1905,919,72,44,112,106,336,202,3696
"12053041303",2428,23,6,0,0,0,0,0,2457
"12053041304",1533,154,8,0,4,0,11,0,1710
"12053041305",1255,75,17,0,38,8,51,0,1444
"12053041401",3907,715,75,0,140,120,526,40,5523
"12053041402",4244,268,190,43,22,138,456,182,5543
"12053041501",2366,595,0,0,72,0,43,0,3076
"12053041502",2876,479,129,15,48,0,314,64,3925
"12053041600",4759,422,39,38,0,0,55,34,5347
"12053990000",0,0,0,0,0,0,0,0,0
"12055960101",2532,134,79,16,181,59,16,0,3017
"12055960102",602,40,410,104,4,0,19,0,1179
"12055960103",2804,610,596,14,179,152,354,439,5148
"12055960200",2340,425,268,273,108,323,705,479,4921
"12055960300",1547,1067,1383,572,360,144,712,861,6646
"12055960400",4928,1337,285,263,672,67,1052,706,9310
"12055960501",1115,124,26,0,0,0,306,0,1571
"12055960502",5548,652,308,33,667,122,969,131,8430
"12055960601",2362,240,459,15,30,0,336,96,3538
"12055960602",4677,545,68,0,245,69,172,134,5910
"12055960700",2958,317,350,226,149,73,384,127,4584
"12055960800",1457,458,134,58,87,46,484,284,3008
"12055960900",1215,235,850,256,17,166,201,284,3224
"12055961000",3548,379,28,13,89,0,457,70,4584
"12055961100",1970,890,160,131,60,108,542,391,4252
"12055961200",3001,873,93,267,162,12,459,160,5027
"12055961301",5575,340,251,19,301,2,661,18,7167
"12055961302",3513,481,17,0,86,16,285,0,4398
"12055961400",3972,452,35,0,64,0,191,170,4884
"12055961500",3213,619,84,0,251,0,581,191,4939
"12055961601",833,418,0,0,0,9,56,31,1347
"12055961602",773,49,0,0,48,0,75,0,945
"12055961603",3820,1788,325,104,109,501,519,1302,8468
"12055961700",3357,1508,175,332,483,71,1191,875,7992
"12055980000",13,0,0,0,0,0,0,0,13
"12055980100",0,0,0,0,0,0,0,0,0
"12055980200",0,0,0,0,0,0,0,0,0
"12057000101",1355,569,503,208,96,322,284,237,3574
"12057000102",2049,852,1492,751,167,74,763,739,6887
"12057000201",429,616,795,600,75,10,273,218,3016
"12057000202",1569,565,1335,892,430,260,973,652,6676
"12057000300",2200,723,1683,1252,865,357,1698,908,9686
"12057000401",1198,303,236,253,236,36,378,140,2780
"12057000402",1430,438,316,13,331,152,782,220,3682
"12057000500",2802,495,58,0,131,0,448,219,4153
"12057000601",2152,954,506,163,223,67,1416,439,5920
"12057000602",1129,178,588,81,251,65,719,105,3116
"12057000700",1441,734,1303,2115,77,308,615,904,7497
"12057000800",1367,472,862,396,177,47,658,172,4151
"12057000901",858,504,830,269,114,74,383,424,3456
"12057000902",669,238,2147,1083,162,0,379,75,4753
"12057001001",469,364,1327,1146,56,85,301,569,4317
"12057001002",471,44,2964,1566,43,8,284,187,5567
"12057001100",1359,266,492,126,61,40,221,159,2724
"12057001200",874,247,270,499,565,378,623,437,3893
"12057001300",3690,883,407,431,1179,225,2234,727,9776
"12057001400",2737,1428,391,198,399,19,1634,1098,7904
"12057001500",1902,170,122,305,216,19,295,117,3146
"12057001600",1494,243,143,87,49,4,237,151,2408
"12057001700",2202,391,676,774,519,66,711,296,5635
"12057001800",161,103,1952,1411,247,137,335,231,4577
"12057001900",50,15,2078,1382,11,11,250,15,3812
"12057002000",520,186,1165,828,99,128,360,147,3433
"12057002100",1024,478,702,290,113,25,312,588,3532
"12057002200",973,142,216,180,92,28,287,72,1990
"12057002300",2625,156,323,21,298,0,588,78,4089
"12057002400",2378,695,299,42,471,49,1366,529,5829
"12057002500",2292,1495,1239,309,712,246,2352,1579,10224
"12057002600",690,403,63,70,226,27,762,284,2525
"12057002700",5248,1065,550,4,699,159,4315,1181,13221
"12057002800",1838,648,353,113,86,0,693,246,3977
"12057002900",950,243,455,344,35,1,441,146,2615
"12057003000",446,386,581,973,14,62,264,335,3061
"12057003100",481,221,902,775,108,158,445,331,3421
"12057003200",624,322,556,759,278,95,632,345,3611
"12057003300",283,114,753,913,61,8,204,113,2449
"12057003400",54,36,1638,745,16,90,13,111,2703
"12057003500",70,154,1547,772,6,0,45,98,2692
"12057003600",559,473,2167,1358,130,54,490,390,5621
"12057003700",274,411,49,176,63,61,50,148,1232
"12057003800",310,68,223,346,35,0,124,11,1117
"12057003900",832,227,496,524,65,11,222,196,2573
"12057004000",0,31,15,71,0,0,0,0,117
"12057004100",336,245,421,409,20,31,139,196,1797
"12057004200",393,72,375,232,55,7,135,32,1301
"12057004300",324,381,775,2017,53,199,305,552,4606
"12057004400",333,183,1001,494,269,41,505,183,3009
"12057004500",2293,709,595,226,288,93,2409,785,7398
"12057004600",1547,209,1053,344,344,40,618,69,4224
"12057004700",1766,192,261,56,352,7,661,142,3437
"12057004800",2380,572,540,0,334,0,1461,346,5633
"12057004900",2232,516,668,274,164,12,399,101,4366
"12057005000",574,463,860,386,219,19,279,91,2891
"12057005101",884,172,20,33,108,42,139,76,1474
"12057005102",2849,274,56,0,313,0,278,0,3770
"12057005301",2329,218,72,0,168,0,423,19,3229
"12057005302",1037,251,76,90,373,190,1102,333,3452
"12057005401",4676,172,67,57,119,0,640,51,5782
"12057005500",1560,211,38,10,233,49,161,45,2307
"12057005700",2907,389,289,44,177,7,683,187,4683
"12057005800",3837,100,454,0,333,33,364,30,5151
"12057005900",5278,245,15,0,527,0,746,0,6811
"12057006000",4909,106,58,3,74,59,415,17,5641
"12057006101",2382,220,36,0,120,28,73,77,2936
"12057006103",3095,130,160,15,54,0,690,28,4172
"12057006200",3416,266,12,0,269,8,383,35,4389
"12057006300",3602,98,179,3,183,10,551,17,4643
"12057006400",3549,122,186,0,85,0,587,17,4546
"12057006501",2145,220,282,0,427,425,326,411,4236
"12057006502",1360,175,112,14,58,0,156,8,1883
"12057006600",2643,360,121,0,449,36,350,173,4132
"12057006700",4207,371,0,0,552,0,452,0,5582
"12057006801",3264,270,272,161,534,34,540,0,5075
"12057006802",2679,307,189,26,153,16,370,38,3778
"12057006900",4612,232,284,112,461,138,669,27,6535
"12057007001",2061,346,110,125,728,112,424,105,4011
"12057007002",1391,193,719,909,245,195,318,119,4089
"12057007102",1612,251,227,17,94,55,162,35,2453
"12057007103",2827,448,265,5,193,40,398,269,4445
"12057007200",2387,408,553,91,297,114,324,92,4266
"12057007300",1109,136,199,43,106,5,266,76,1940
"12057010103",3507,423,38,10,147,48,366,42,4581
"12057010105",3812,610,89,44,455,102,642,386,6140
"12057010106",4379,747,0,11,240,9,708,276,6370
"12057010107",2701,554,0,10,264,215,374,396,4514
"12057010108",1561,195,92,50,56,169,106,142,2371
"12057010203",849,456,313,70,58,19,189,93,2047
"12057010204",3393,553,1108,290,366,49,751,237,6747
"12057010205",5174,227,1361,0,2108,12,1755,45,10682
"12057010209",5566,510,2163,305,1821,122,1549,202,12238
"12057010210",2081,515,385,62,1042,139,434,124,4782
"12057010211",3104,139,769,186,1003,156,717,198,6272
"12057010212",3357,220,408,0,956,29,698,39,5707
"12057010213",1194,387,278,76,72,5,95,117,2224
"12057010214",95,11,10,0,9,0,19,0,144
"12057010303",2157,798,0,26,93,94,148,108,3424
"12057010304",3188,163,265,168,215,0,495,0,4494
"12057010305",1587,703,747,288,261,4,223,86,3899
"12057010401",2607,532,1224,414,332,199,479,223,6010
"12057010402",1659,692,1702,569,551,291,686,518,6668
"12057010501",696,130,2553,763,342,276,456,276,5492
"12057010502",716,187,891,69,227,39,224,52,2405
"12057010600",1739,447,406,38,251,74,206,80,3241
"12057010701",4064,277,566,394,472,150,775,188,6886
"12057010702",1968,233,223,52,0,97,330,60,2963
"12057010805",1020,1212,818,852,645,482,933,1252,7214
"12057010808",647,670,380,286,237,214,233,421,3088
"12057010809",1495,670,269,462,183,164,414,212,3869
"12057010810",1189,319,464,107,764,30,255,25,3153
"12057010811",3221,549,1355,228,713,144,687,154,7051
"12057010812",1292,1213,521,429,615,527,236,290,5123
"12057010813",924,1045,458,403,223,375,253,307,3988
"12057010814",1091,258,782,328,92,78,476,277,3382
"12057010815",284,352,620,226,138,64,243,261,2188
"12057010816",598,1060,1049,921,200,238,533,975,5574
"12057010817",1701,616,437,482,583,207,1545,714,6285
"12057010818",554,1183,913,1099,812,442,1098,1246,7347
"12057010900",0,0,0,0,0,0,0,0,0
"12057011003",2367,746,410,109,369,170,552,230,4953
"12057011005",1893,253,330,0,271,71,173,48,3039
"12057011006",4151,369,25,7,365,2,608,131,5658
"12057011007",2541,199,285,21,140,7,408,15,3616
"12057011008",4304,496,461,198,917,139,795,57,7367
"12057011010",2713,502,618,808,201,200,808,62,5912
"12057011012",4199,181,427,0,1394,27,910,76,7214
"12057011013",2045,224,492,34,367,173,488,86,3909
"12057011014",466,155,156,0,28,0,196,85,1086
"12057011015",3327,999,530,351,1052,91,691,111,7152
"12057011016",2003,74,622,36,435,9,336,0,3515
"12057011103",2815,213,451,4,152,2,337,2,3976
"12057011106",1124,125,132,19,374,33,551,59,2417
"12057011107",5172,269,505,114,768,91,1503,183,8605
"12057011108",1155,164,17,38,22,56,225,90,1767
"12057011109",2770,93,21,0,92,0,555,32,3563
"12057011203",2496,99,207,0,322,27,883,20,4054
"12057011204",3525,730,608,244,293,438,769,709,7316
"12057011205",1992,265,429,21,248,25,652,94,3726
"12057011206",1543,454,199,196,274,51,304,182,3203
"12057011301",2449,167,127,16,84,56,599,29,3527
"12057011303",2075,159,158,49,379,73,485,33,3411
"12057011304",3778,252,459,52,476,47,561,79,5704
"12057011407",2012,227,121,0,106,0,256,8,2730
"12057011408",2022,425,230,22,338,30,595,229,3891
"12057011409",2439,136,153,64,14,2,559,60,3427
"12057011410",4537,215,368,0,1233,1,1304,115,7773
"12057011411",1296,163,83,0,114,63,379,187,2285
"12057011412",2401,366,248,0,476,26,747,62,4326
"12057011413",4207,383,326,33,985,55,1672,98,7759
"12057011414",4157,1025,779,83,529,93,2718,634,10018
"12057011415",3541,365,191,54,1145,131,1825,337,7589
"12057011416",4140,700,918,185,794,193,2450,714,10094
"12057011417",2847,365,408,0,674,193,1430,63,5980
"12057011418",3098,80,481,0,199,9,545,40,4452
"12057011504",1706,169,58,0,75,0,142,0,2150
"12057011506",5518,740,1313,64,828,161,967,71,9662
"12057011507",5267,315,240,133,960,96,981,206,8198
"12057011509",5621,116,164,0,350,20,678,0,6949
"12057011510",3318,14,128,33,348,1,787,1,4630
"12057011512",3198,78,26,0,416,6,626,17,4367
"12057011514",4492,488,386,0,366,126,1073,326,7257
"12057011515",2946,110,171,16,321,6,831,14,4415
"12057011516",2485,115,87,0,366,6,579,0,3638
"12057011517",7489,131,344,0,843,0,759,0,9566
"12057011518",2820,148,304,10,270,6,507,8,4073
"12057011519",2283,49,32,0,91,0,261,6,2722
"12057011520",3860,125,308,21,468,8,374,0,5164
"12057011521",2914,640,209,0,243,128,755,370,5259
"12057011522",3252,328,12,10,586,0,520,25,4733
"12057011523",1413,62,23,0,93,0,240,0,1831
"12057011524",2949,787,476,148,489,65,1081,464,6459
"12057011603",3223,222,264,49,493,12,1568,108,5939
"12057011605",4660,869,229,57,469,3,3333,589,10209
"12057011606",5766,345,839,18,551,45,1514,208,9286
"12057011607",5735,534,848,2,669,68,2411,295,10562
"12057011608",1006,0,40,0,118,23,351,23,1561
"12057011610",3298,1103,246,12,278,88,2229,989,8243
"12057011611",2800,412,187,72,520,134,2189,406,6720
"12057011612",4813,832,249,79,796,39,2682,592,10082
"12057011613",3879,693,156,174,180,353,1991,877,8303
"12057011614",4279,1290,790,383,537,169,3148,1335,11931
"12057011615",3030,784,123,73,460,14,2477,598,7559
"12057011706",5309,820,612,248,602,91,3679,631,11992
"12057011708",3125,196,204,9,360,88,1088,116,5186
"12057011709",610,13,9,0,93,33,57,0,815
"12057011710",4589,347,351,49,555,159,1246,58,7354
"12057011712",3522,774,188,68,661,1,1282,311,6807
"12057011802",4997,1540,155,21,189,234,3937,1339,12412
"12057011803",3516,2008,635,41,583,207,2535,1451,10976
"12057011804",3293,1001,144,319,867,83,2999,889,9595
"12057011901",3300,766,918,168,517,94,1661,454,7878
"12057011902",4567,732,300,38,1055,431,3730,963,11816
"12057011904",984,184,424,69,57,123,485,294,2620
"12057011905",790,417,86,41,77,20,574,397,2402
"12057011906",2348,503,349,182,619,122,1660,354,6137
"12057012001",1067,169,611,304,91,21,298,115,2676
"12057012002",1190,740,786,668,266,85,411,235,4381
"12057012103",2528,518,1213,153,1567,275,1123,184,7561
"12057012104",3530,1589,871,472,448,821,1110,1438,10279
"12057012106",3141,707,356,0,709,126,680,249,5968
"12057012107",2781,451,597,114,550,0,835,2,5330
"12057012108",2124,277,249,3,172,54,297,8,3184
"12057012206",4145,283,948,98,513,77,1281,44,7389
"12057012207",5617,690,667,8,143,0,1171,151,8447
"12057012208",5084,146,645,0,755,57,1121,21,7829
"12057012209",2889,520,451,186,975,6,1117,247,6391
"12057012210",3607,745,373,62,174,0,535,103,5599
"12057012211",100,4,0,0,0,0,83,0,187
"12057012212",1838,1141,768,229,383,93,1108,793,6353
"12057012213",3004,248,429,21,313,23,536,187,4761
"12057012301",3712,432,988,121,482,7,868,44,6654
"12057012303",2241,174,227,37,150,117,587,61,3594
"12057012304",3293,705,591,192,330,46,1361,568,7086
"12057012401",2925,1750,100,48,699,218,1093,1680,8513
"12057012402",1778,726,22,166,164,398,740,754,4748
"12057012403",4062,871,443,43,155,539,1199,838,8150
"12057012501",2383,442,216,2,419,171,928,295,4856
"12057012503",3003,358,223,21,450,337,505,530,5427
"12057012504",2688,304,170,86,211,0,449,240,4148
"12057012600",2575,393,1148,781,425,89,611,239,6261
"12057012701",3356,1949,508,84,870,210,2168,1793,10938
"12057012702",2616,359,125,9,170,8,858,205,4350
"12057012800",2592,448,173,36,552,87,1201,190,5279
"12057012900",778,243,1102,440,215,75,407,259,3519
"12057013001",2444,681,178,53,235,179,314,392,4476
"12057013002",3473,545,75,91,545,168,1201,369,6467
"12057013003",1979,551,119,4,434,324,878,625,4914
"12057013004",1927,555,772,222,188,168,559,419,4810
"12057013100",2125,466,139,53,40,82,364,371,3640
"12057013203",2218,334,314,26,303,0,491,37,3723
"12057013204",2080,452,197,86,148,120,346,238,3667
"12057013205",5612,315,849,50,492,28,1242,105,8693
"12057013206",4667,217,764,44,372,2,997,12,7075
"12057013207",3123,443,153,64,398,18,516,230,4945
"12057013208",4149,155,75,0,393,0,604,12,5388
"12057013305",3606,154,129,13,320,0,689,13,4924
"12057013307",2073,263,636,53,373,0,931,177,4506
"12057013310",1893,116,538,0,191,0,620,50,3408
"12057013311",1748,406,287,7,144,124,274,141,3131
"12057013312",2907,347,518,48,790,31,1031,19,5691
"12057013313",3717,402,515,273,407,31,624,147,6116
"12057013314",2046,345,102,0,288,36,468,302,3587
"12057013315",2159,99,564,86,419,9,898,27,4261
"12057013316",1148,476,529,149,163,0,552,293,3310
"12057013317",1260,72,408,61,178,158,378,92,2607
"12057013318",1490,126,751,117,803,48,570,41,3946
"12057013319",3501,192,418,0,648,175,1060,127,6121
"12057013320",2281,249,687,53,509,97,550,216,4642
"12057013321",4437,837,1653,73,565,102,1888,579,10134
"12057013322",4791,737,1039,264,715,115,2133,362,10156
"12057013406",899,137,183,17,44,29,295,17,1621
"12057013407",5137,197,660,15,657,38,1022,41,7767
"12057013409",3204,534,460,34,418,111,378,267,5406
"12057013410",3083,182,633,457,759,328,759,239,6440
"12057013411",1289,287,31,0,234,43,60,65,2009
"12057013412",2479,254,190,68,408,5,466,46,3916
"12057013413",2796,230,151,77,191,20,271,28,3764
"12057013414",5404,195,304,0,506,18,768,0,7195
"12057013415",2685,140,282,0,489,33,546,70,4245
"12057013501",1526,731,848,290,376,239,933,697,5640
"12057013503",1517,731,543,266,377,200,990,705,5329
"12057013504",1956,791,699,62,403,9,1595,717,6232
"12057013505",1137,440,945,555,418,169,1013,376,5053
"12057013602",1167,346,10,117,52,148,432,406,2678
"12057013604",499,378,21,13,45,73,75,200,1304
"12057013702",3504,530,2658,469,683,174,1334,390,9742
"12057013703",2637,180,1393,202,733,402,1216,434,7197
"12057013704",4381,700,1816,531,1527,358,1255,653,11221
"12057013801",1135,664,192,0,282,357,635,496,3761
"12057013802",1700,584,182,17,226,34,378,283,3404
"12057013803",1097,405,0,0,138,0,434,38,2112
"12057013804",3600,819,2346,145,840,285,1681,679,10395
"12057013806",799,225,8,0,214,37,235,38,1556
"12057013807",3870,517,1158,115,542,119,1519,445,8285
"12057013903",2717,381,6,0,233,13,340,13,3703
"12057013907",1793,119,6,0,531,8,669,53,3179
"12057013908",5751,666,1159,63,1087,73,2049,112,10960
"12057013912",2027,479,25,52,235,234,647,327,4026
"12057013913",2640,764,555,273,942,799,1873,1406,9252
"12057013914",2364,558,12,0,462,463,1885,803,6547
"12057013915",4011,205,1520,104,1524,14,1354,113,8845
"12057013916",5180,76,1816,16,1019,60,1639,81,9887
"12057013917",5307,138,1303,0,997,0,2221,21,9987
"12057013918",1588,467,6,0,49,14,100,52,2276
"12057013919",4390,294,795,0,573,0,830,0,6882
"12057013920",2697,602,13,53,434,26,430,166,4421
"12057013921",1987,70,95,0,32,0,172,9,2365
"12057013922",5416,207,143,0,435,0,723,20,6944
"12057013923",4542,327,338,0,244,13,555,99,6118
"12057014002",1447,431,0,0,95,424,250,581,3228
"12057014003",1294,73,6,0,33,0,72,0,1478
"12057014007",1301,192,747,39,475,5,709,5,3473
"12057014008",3089,172,0,12,0,0,0,0,3273
"12057014009",1458,66,47,0,10,0,126,0,1707
"12057014010",2235,170,0,0,9,0,28,27,2469
"12057014011",3055,227,0,0,16,0,222,0,3520
"12057014012",2369,110,42,0,7,0,0,0,2528
"12057014013",1013,310,25,0,28,38,236,238,1888
"12057014014",2032,116,19,0,0,0,14,69,2250
"12057014015",1421,29,0,44,12,0,24,13,1543
"12057014016",805,6,9,0,0,0,37,0,857
"12057014104",1186,205,0,2,95,19,118,37,1662
"12057014106",2268,531,86,1,122,31,234,245,3518
"12057014108",3150,908,341,94,483,393,1379,606,7354
"12057014109",2804,523,576,20,651,590,1664,887,7715
"12057014117",2897,100,0,0,88,0,174,0,3259
"12057014118",3195,90,69,0,179,77,122,59,3791
"12057014119",2971,333,602,81,484,22,655,63,5211
"12057014121",2845,131,844,0,306,0,422,24,4572
"12057014122",1693,287,524,13,725,269,1029,408,4948
"12057980100",0,0,0,0,0,0,0,0,0
"12057980200",0,0,0,0,0,0,0,0,0
"12057980300",59,0,0,0,14,0,0,0,73
"12057980400",51,0,0,0,3,0,0,0,54
"12057980500",0,0,0,0,0,0,0,0,0
"12057980600",0,0,0,0,0,0,0,0,0
"12057980700",0,0,0,0,0,0,0,0,0
"12057990000",0,0,0,0,0,0,0,0,0
"12057990100",0,0,0,0,0,0,0,0,0
"12059960100",3272,684,90,47,74,127,33,130,4457
"12059960200",3670,1487,60,0,57,32,9,35,5350
"12059960300",1992,878,0,0,137,20,30,0,3057
"12059960400",3389,1223,180,160,97,59,13,58,5179
"12061050100",4368,1896,326,88,0,229,383,167,7457
"12061050200",2802,599,35,134,168,0,239,129,4106
"12061050301",2409,337,149,273,42,27,184,8,3429
"12061050302",1282,784,2097,1239,142,40,261,734,6579
"12061050401",2011,957,386,26,223,85,110,350,4148
"12061050402",1543,255,0,2,16,15,39,28,1898
"12061050501",4532,261,104,0,43,0,263,0,5203
"12061050503",4213,178,0,0,45,30,35,11,4512
"12061050504",1540,46,0,26,5,1,18,1,1637
"12061050505",2971,168,0,0,52,0,15,0,3206
"12061050601",1498,314,23,45,12,0,139,53,2084
"12061050602",3944,652,173,50,95,28,355,108,5405
"12061050603",3032,287,472,426,61,71,468,54,4871
"12061050604",1276,83,102,0,10,0,28,0,1499
"12061050605",1625,182,0,0,46,0,50,0,1903
"12061050606",6555,910,2241,695,719,131,1495,136,12882
"12061050702",4952,359,16,33,199,71,352,90,6072
"12061050703",8443,500,209,92,490,19,686,100,10539
"12061050704",2022,385,0,5,87,9,224,9,2741
"12061050705",4117,302,135,49,20,0,291,44,4958
"12061050802",7466,501,377,5,204,30,608,0,9191
"12061050804",4661,919,76,45,425,31,366,335,6858
"12061050805",2982,412,368,496,50,0,252,21,4581
"12061050806",3973,538,587,0,113,84,128,0,5423
"12061050807",3543,516,154,0,77,0,304,63,4657
"12061050808",3096,582,76,9,148,26,101,111,4149
"12061050902",4402,257,154,0,0,0,366,36,5215
"12061050903",5460,1005,145,23,242,73,689,215,7852
"12061050904",3954,1632,159,119,957,741,3007,1788,12357
"12061980000",0,0,0,0,0,0,0,0,0
"12061990000",0,0,0,0,0,0,0,0,0
"12063210100",1351,415,775,80,33,43,17,96,2810
"12063210200",465,85,613,284,17,0,12,0,1476
"12063210300",2434,718,626,95,45,57,96,129,4200
"12063210400",1773,563,636,277,43,50,56,51,3449
"12063210500",2678,152,470,697,169,0,51,0,4217
"12063210600",2009,1142,1376,917,140,137,16,5,5742
"12063210700",2322,261,558,175,45,68,24,0,3453
"12063210800",2078,291,877,300,111,11,70,0,3738
"12063210900",3183,507,276,167,25,167,47,296,4668
"12063211000",4016,325,168,100,143,34,83,19,4888
"12063211100",2748,616,193,38,69,10,40,39,3753
"12065250101",2031,206,1294,548,33,158,103,32,4405
"12065250102",2254,100,1053,238,138,0,41,9,3833
"12065250200",2401,434,850,394,29,0,42,33,4183
"12065990000",0,0,0,0,0,0,0,0,0
"12067960100",1125,301,0,0,7,0,204,58,1695
"12067960200",3924,898,355,377,175,137,325,326,6517
"12069030102",2183,878,0,0,30,45,263,21,3420
"12069030104",1371,247,6,0,30,42,14,68,1778
"12069030105",6628,821,319,33,96,0,481,82,8460
"12069030106",1150,255,0,3,34,22,213,19,1696
"12069030107",4184,1518,145,0,79,33,83,291,6333
"12069030108",3233,685,58,28,89,0,570,146,4809
"12069030203",6844,701,493,184,329,22,631,27,9231
"12069030204",1970,1098,371,0,238,45,228,340,4290
"12069030206",1371,588,1159,820,169,60,275,198,4640
"12069030207",3519,829,106,0,39,230,26,291,5040
"12069030208",3051,498,249,7,244,239,188,36,4512
"12069030209",1771,406,22,28,96,0,157,38,2518
"12069030302",2793,512,270,25,112,25,163,0,3900
"12069030305",2282,143,33,0,23,13,31,25,2550
"12069030306",3505,264,16,0,48,0,111,21,3965
"12069030307",3422,704,205,0,110,32,165,270,4908
"12069030308",3301,697,134,8,44,0,251,19,4454
"12069030405",3749,388,227,410,45,125,28,0,4972
"12069030406",3132,543,329,11,24,0,142,26,4207
"12069030407",1805,523,439,9,122,14,48,23,2983
"12069030408",3274,209,83,0,52,0,77,0,3695
"12069030409",3835,301,0,0,10,0,0,0,4146
"12069030410",2533,72,235,0,290,42,114,0,3286
"12069030411",4322,1480,34,98,74,0,132,600,6740
"12069030502",3542,570,1082,476,173,349,129,142,6463
"12069030503",493,317,332,166,58,0,178,217,1761
"12069030504",3288,392,568,971,643,77,542,54,6535
"12069030601",2959,235,583,58,167,32,221,12,4267
"12069030602",842,286,507,358,0,33,150,33,2209
"12069030701",1903,118,67,2,12,10,113,15,2240
"12069030702",3073,506,438,53,463,9,268,124,4934
"12069030803",2400,512,380,86,185,0,77,0,3640
"12069030804",895,142,6,64,24,10,68,15,1224
"12069030805",1933,325,122,509,237,7,110,228,3471
"12069030806",2641,225,150,78,74,0,58,0,3226
"12069030807",2380,206,334,391,293,146,465,124,4339
"12069030902",10569,639,534,33,680,0,1629,37,14121
"12069030912",4029,1141,354,102,286,124,614,496,7146
"12069030913",1302,76,0,0,0,0,63,5,1446
"12069030914",2467,501,843,558,180,0,343,98,4990
"12069031000",6256,725,206,18,333,67,743,194,8542
"12069031101",6908,706,65,0,139,0,85,0,7903
"12069031102",6683,193,160,17,203,0,173,2,7431
"12069031103",1507,174,17,0,32,0,310,67,2107
"12069031202",4870,870,143,145,430,57,1213,79,7807
"12069031203",5081,437,473,25,76,0,1350,59,7501
"12069031204",7687,1235,1302,59,634,0,1378,332,12627
"12069031205",951,860,8,16,987,34,1286,301,4443
"12069031301",4957,234,194,0,413,37,995,10,6840
"12069031305",3846,714,551,96,979,650,673,395,7904
"12069031306",3831,302,666,18,740,121,685,5,6368
"12069031307",13267,1413,2198,419,1871,137,3888,612,23805
"12069031308",4539,43,626,25,999,0,790,0,7022
"12069031309",7374,709,473,184,1307,0,2041,121,12209
"12069031310",10434,1506,1286,123,934,74,2212,166,16735
"12069031311",10148,2490,2191,0,1718,316,3741,1880,22484
"12071000301",1853,925,178,266,262,487,794,1087,5852
"12071000302",1743,1308,763,354,960,249,1966,1378,8721
"12071000401",1306,706,74,20,350,188,852,678,4174
"12071000402",1637,477,36,0,28,29,352,34,2593
"12071000502",93,114,1591,970,13,49,28,66,2924
"12071000503",658,621,1469,674,470,30,891,661,5474
"12071000504",1096,480,289,72,291,137,825,407,3597
"12071000600",101,133,2148,2186,72,36,22,92,4790
"12071000700",605,450,421,664,134,106,132,153,2665
"12071000800",1172,200,25,6,30,0,18,42,1493
"12071000900",2757,78,0,0,142,0,175,0,3152
"12071001000",4809,933,72,0,280,83,681,651,7509
"12071001101",1123,427,687,372,47,273,203,387,3519
"12071001102",1194,527,529,473,152,0,266,162,3303
"12071001201",2589,629,1255,1559,607,291,1149,410,8489
"12071001202",7211,601,369,87,575,2,1013,237,10095
"12071001300",1668,612,103,213,117,12,373,318,3416
"12071001401",2901,941,392,333,227,537,803,1193,7327
"12071001402",2473,144,0,0,103,0,131,8,2859
"12071001501",2353,52,0,0,124,0,124,6,2659
"12071001502",3238,1203,133,415,499,300,1581,970,8339
"12071001601",3420,407,158,0,332,105,432,283,5137
"12071001602",2816,265,0,0,114,19,52,8,3274
"12071001701",2269,216,0,0,106,0,114,14,2719
"12071001703",3739,315,26,0,106,35,37,35,4293
"12071001705",2610,289,35,0,5,20,114,20,3093
"12071001706",2950,303,29,0,165,0,365,59,3871
"12071001707",4300,804,72,24,120,0,230,151,5701
"12071001801",4089,385,113,0,88,0,139,93,4907
"12071001802",1897,163,20,0,43,0,69,0,2192
"12071001903",2742,122,0,0,0,0,97,0,2961
"12071001906",5266,973,7,95,272,196,1060,381,8250
"12071001907",4893,267,181,16,220,11,395,11,5994
"12071001908",883,44,0,0,0,0,0,0,927
"12071001910",2057,258,0,0,12,0,53,0,2380
"12071001911",984,41,0,0,22,0,0,0,1047
"12071001912",1615,112,0,0,56,0,31,0,1814
"12071001913",1280,94,0,0,0,16,0,16,1406
"12071001914",4322,223,0,0,0,0,307,0,4852
"12071001915",2573,72,0,0,34,0,0,0,2679
"12071010102",6410,897,237,43,455,59,1284,329,9714
"12071010103",6687,1512,134,76,271,212,1112,695,10699
"12071010104",1785,48,0,0,4,0,10,0,1847
"12071010105",4283,768,162,15,180,18,506,139,6071
"12071010201",7126,1276,631,491,318,276,1962,844,12924
"12071010203",4622,1657,322,54,252,26,1487,859,9279
"12071010204",7064,1151,634,0,199,112,406,220,9786
"12071010302",3682,1005,442,150,223,64,1005,239,6810
"12071010303",5064,297,192,36,35,242,752,169,6787
"12071010304",8480,531,594,87,387,209,2039,283,12610
"12071010305",2973,507,8,9,40,0,202,151,3890
"12071010306",4059,774,94,102,245,12,1021,366,6673
"12071010307",4274,885,81,63,187,142,931,529,7092
"12071010404",5278,804,122,43,357,73,1432,251,8360
"12071010405",6764,676,595,0,309,44,1270,391,10049
"12071010406",5115,421,40,12,297,0,748,48,6681
"12071010407",6261,382,66,0,523,26,662,59,7979
"12071010409",6933,1004,317,52,511,114,948,143,10022
"12071010410",9984,783,329,79,462,166,1517,174,13494
"12071010411",4036,573,31,24,488,0,478,374,6004
"12071010412",3538,534,183,0,181,0,494,127,5057
"12071010501",3173,354,108,6,81,0,625,186,4533
"12071010502",3641,383,197,17,383,71,489,64,5245
"12071010601",3451,726,10,25,279,0,599,73,5163
"12071010602",1887,326,119,11,113,0,294,162,2912
"12071010701",3629,334,41,0,38,0,172,102,4316
"12071010702",2061,100,0,0,28,0,22,10,2221
"12071010801",2033,370,0,0,21,0,105,130,2659
"12071010802",2480,602,9,37,81,24,369,202,3804
"12071010803",1537,193,16,0,62,4,140,0,1952
"12071020101",4092,222,0,0,100,0,301,34,4749
"12071020102",3550,671,51,0,51,98,373,116,4910
"12071020201",1045,168,0,76,0,0,57,12,1358
"12071020202",2363,166,0,4,65,68,291,70,3027
"12071020300",3107,2248,0,0,17,0,177,0,5549
"12071020400",2422,170,0,0,38,0,48,24,2702
"12071020501",2064,352,14,0,163,0,95,26,2714
"12071020502",3105,691,48,0,15,9,41,57,3966
"12071020600",1873,541,57,7,92,66,62,185,2883
"12071020700",2764,310,0,194,19,0,122,10,3419
"12071020800",2115,735,25,0,109,0,101,0,3085
"12071030100",2316,259,0,27,188,0,81,33,2904
"12071030201",767,30,24,0,39,0,23,0,883
"12071030202",3980,625,115,37,447,47,1202,114,6567
"12071030203",1532,95,181,0,6,0,52,20,1886
"12071030204",627,105,35,41,11,0,0,0,819
"12071030300",1984,83,146,81,44,58,97,22,2515
"12071040108",2764,206,212,0,281,6,122,0,3591
"12071040109",2274,878,787,232,457,154,1299,638,6719
"12071040110",1068,75,159,0,327,0,161,12,1802
"12071040111",2233,228,56,0,25,12,6,0,2560
"12071040112",2070,82,62,8,471,10,454,0,3157
"12071040113",1710,34,0,0,34,0,42,0,1820
"12071040114",3742,209,20,0,197,0,129,11,4308
"12071040115",1831,234,4,0,5,0,530,25,2629
"12071040116",5447,183,112,76,331,0,700,45,6894
"12071040117",2868,51,71,0,617,0,148,0,3755
"12071040118",759,143,0,0,26,0,20,0,948
"12071040119",750,20,0,0,104,0,49,0,923
"12071040120",942,44,94,0,139,19,135,28,1401
"12071040121",1550,401,666,523,284,116,730,208,4478
"12071040122",1669,1519,1260,1266,1089,88,1880,1335,10106
"12071040123",3213,718,44,136,116,37,253,416,4933
"12071040124",3100,478,920,325,758,819,1782,1176,9358
"12071040125",1283,177,143,178,224,207,679,335,3226
"12071040126",1160,342,643,159,366,100,690,286,3746
"12071040127",1721,757,609,128,663,220,1090,815,6003
"12071040203",6497,1129,1894,63,909,411,2880,592,14375
"12071040205",2710,378,775,253,472,53,713,317,5671
"12071040206",1097,83,0,1,35,0,50,2,1268
"12071040207",3175,222,477,74,132,51,529,86,4746
"12071040208",1092,440,149,29,163,68,296,141,2378
"12071040209",2233,420,464,12,213,68,412,363,4185
"12071040210",1327,218,130,162,170,0,356,116,2479
"12071040301",3863,668,1914,291,618,60,2560,548,10522
"12071040302",1792,633,659,162,383,194,1267,351,5441
"12071040303",3560,1071,789,479,428,195,2001,765,9288
"12071040304",2561,748,217,286,465,156,1363,464,6260
"12071040305",1526,469,181,41,422,23,908,126,3696
"12071040308",2228,932,740,257,329,82,1275,708,6551
"12071040309",3778,479,1567,39,440,93,1610,265,8271
"12071040310",1911,320,387,21,135,68,593,212,3647
"12071040311",2212,738,779,40,558,249,1331,537,6444
"12071040312",1018,102,354,80,12,38,151,55,1810
"12071040313",700,403,234,3,71,41,238,366,2056
"12071040314",1425,328,528,59,114,39,590,90,3173
"12071050103",858,159,0,0,44,0,66,67,1194
"12071050104",2087,198,0,0,61,0,103,0,2449
"12071050105",2231,19,0,0,22,0,63,0,2335
"12071050106",3472,167,0,0,28,17,138,0,3822
"12071050203",3662,101,200,0,167,73,224,0,4427
"12071050204",1942,87,21,0,60,0,152,7,2269
"12071050205",1429,231,16,0,233,0,458,35,2402
"12071050206",2468,65,30,0,378,0,403,0,3344
"12071050207",1654,154,30,32,39,0,80,0,1989
"12071050208",4286,723,18,6,73,16,728,89,5939
"12071050209",6795,1046,74,0,923,204,1967,253,11262
"12071050305",2941,217,0,0,41,0,59,0,3258
"12071050306",1791,52,21,0,50,0,64,0,1978
"12071050307",3933,135,40,0,0,15,144,0,4267
"12071050308",5259,1356,159,63,297,322,430,1252,9138
"12071050310",4210,95,0,0,209,96,89,0,4699
"12071050311",4345,188,80,0,249,0,364,24,5250
"12071050312",1971,528,0,0,84,12,100,97,2792
"12071050313",4595,481,157,19,317,0,384,400,6353
"12071050314",3203,179,390,0,111,0,31,0,3914
"12071050400",5543,2919,138,0,1038,956,2514,3299,16407
"12071050500",4189,1394,10,15,668,405,2426,1550,10657
"12071050601",2573,203,7,0,68,0,91,19,2961
"12071050602",3675,403,0,2,186,150,527,232,5175
"12071060101",590,64,0,0,0,4,0,0,658
"12071060102",2247,262,17,0,43,5,87,0,2661
"12071060201",904,34,0,0,8,0,18,0,964
"12071060202",1437,38,0,0,0,0,7,26,1508
"12071060203",1286,153,20,25,37,23,26,5,1575
"12071060300",1015,58,0,0,52,13,20,0,1158
"12071070101",1434,128,0,0,0,0,12,0,1574
"12071070102",2684,442,8,0,101,0,122,0,3357
"12071070200",3136,299,0,0,16,0,167,0,3618
"12071080100",82,80,29,13,0,0,0,0,204
"12071080202",2417,106,0,0,17,0,53,0,2593
"12071080203",1293,120,0,0,24,5,12,0,1454
"12071080204",2439,239,25,0,15,0,8,0,2726
"12071080300",1048,195,207,137,63,190,62,8,1910
"12071090100",704,76,0,63,41,4,0,7,895
"12071980000",0,0,0,0,0,0,0,0,0
"12071990000",0,0,0,0,0,0,0,0,0
"12073000200",3083,806,116,101,59,1,105,121,4392
"12073000301",979,63,374,186,94,0,52,0,1748
"12073000302",1562,186,290,256,68,64,27,60,2513
"12073000303",1000,313,1449,671,166,22,31,8,3660
"12073000400",145,5,403,501,0,26,21,13,1114
"12073000500",312,944,144,136,34,50,38,157,1815
"12073000600",387,991,978,1508,73,41,103,66,4147
"12073000700",1092,364,205,340,38,21,89,35,2184
"12073000800",1961,165,442,132,104,0,85,0,2889
"12073000901",4525,720,1407,317,837,327,579,0,8712
"12073000903",1057,375,695,290,72,10,77,0,2576
"12073000904",1838,198,877,46,79,0,125,35,3198
"12073000905",1353,201,924,329,288,70,103,28,3296
"12073001001",217,79,685,1681,122,158,72,86,3100
"12073001002",153,25,1096,915,0,16,8,0,2213
"12073001101",42,51,823,948,6,59,0,82,2011
"12073001102",15,0,1870,809,55,0,0,0,2749
"12073001200",34,84,431,783,0,0,0,0,1332
"12073001300",0,1,0,4,0,0,0,0,5
"12073001401",176,193,1089,490,43,0,19,21,2031
"12073001402",629,1171,833,1939,75,472,42,188,5349
"12073001500",2001,598,919,709,71,50,70,97,4515
"12073001601",2174,570,1065,702,253,93,344,226,5427
"12073001602",2855,87,112,6,140,0,149,2,3351
"12073001700",5434,351,467,193,269,11,261,1,6987
"12073001801",697,78,2074,1354,135,142,127,30,4637
"12073001802",1420,357,2497,696,228,61,183,81,5523
"12073001901",260,70,1197,759,452,277,100,27,3142
"12073001902",675,359,1341,1049,93,21,67,0,3605
"12073002003",341,169,270,605,14,29,53,25,1506
"12073002004",1461,3466,994,1481,112,374,570,550,9008
"12073002005",654,1657,153,307,34,77,106,264,3252
"12073002006",1047,1611,331,453,61,189,97,185,3974
"12073002101",1671,1258,997,579,91,3,15,53,4667
"12073002103",939,1512,843,368,52,90,119,195,4118
"12073002104",1721,2906,1088,1493,212,407,310,727,8864
"12073002201",1859,672,1099,1244,108,0,295,85,5362
"12073002205",2376,486,1476,885,302,29,291,12,5857
"12073002206",2141,51,850,99,180,9,221,0,3551
"12073002207",1138,272,413,629,13,0,0,0,2465
"12073002208",3325,291,1323,50,171,20,142,20,5342
"12073002302",2179,172,652,60,83,0,51,0,3197
"12073002303",2184,71,1264,313,72,51,110,38,4103
"12073002304",1418,716,840,220,130,27,181,97,3629
"12073002403",1413,155,863,83,275,34,126,22,2971
"12073002408",6833,490,513,0,209,0,249,351,8645
"12073002410",3712,587,1112,58,504,28,130,111,6242
"12073002411",1092,110,186,0,102,0,13,0,1503
"12073002412",7928,182,490,0,822,44,495,0,9961
"12073002413",2422,29,126,11,56,0,57,0,2701
"12073002414",4112,60,189,3,26,8,250,0,4648
"12073002415",3595,61,212,0,315,0,337,0,4520
"12073002416",2422,96,380,0,62,0,72,0,3032
"12073002417",5675,62,696,24,906,18,485,0,7866
"12073002505",2854,383,1093,428,521,0,284,29,5592
"12073002507",1737,43,558,70,63,46,40,57,2614
"12073002508",5980,526,2336,173,374,37,580,37,10043
"12073002509",1312,264,662,330,301,75,183,95,3222
"12073002510",3457,101,1627,240,425,0,242,14,6106
"12073002511",769,12,251,39,204,0,10,0,1285
"12073002512",2602,31,371,0,228,0,213,0,3445
"12073002513",3444,35,329,56,579,42,72,0,4557
"12073002603",1939,225,1760,864,231,55,36,0,5110
"12073002604",1948,207,185,94,64,15,90,4,2607
"12073002605",3471,133,453,17,667,0,205,0,4946
"12073002606",2484,139,466,0,104,0,98,14,3305
"12073002701",2579,852,1072,336,103,110,225,77,5354
"12073002702",3833,626,56,76,64,64,291,222,5232
"12075970101",1386,197,97,104,64,86,197,101,2232
"12075970102",4457,2202,650,100,144,55,485,410,8503
"12075970200",2421,743,330,430,170,109,123,105,4431
"12075970301",1191,168,0,0,0,0,0,0,1359
"12075970302",5279,1202,22,17,35,43,338,0,6936
"12075970400",1863,741,12,0,34,4,156,166,2976
"12075970500",5915,1610,183,102,218,47,637,0,8712
"12075970600",1887,346,1129,333,85,81,136,80,4077
"12075970700",2249,618,6,23,29,49,49,11,3034
"12075990000",0,0,0,0,0,0,0,0,0
"12077950100",1744,171,0,0,25,0,0,0,1940
"12077950200",2903,751,438,273,248,149,240,118,5120
"12079110100",2255,333,467,116,108,0,183,0,3462
"12079110200",1752,249,1107,379,32,18,41,23,3601
"12079110301",896,237,492,193,223,0,220,0,2261
"12079110302",864,209,1766,1185,42,21,21,0,4108
"12079110400",2515,637,398,122,117,16,135,22,3962
"12081000101",1063,161,59,4,14,6,32,0,1339
"12081000103",1715,651,1325,496,299,311,1421,555,6773
"12081000105",1570,1073,362,307,404,350,632,897,5595
"12081000106",1497,1046,743,234,225,782,939,1636,7102
"12081000201",2688,325,94,17,348,62,194,17,3745
"12081000202",2500,375,177,0,42,39,89,129,3351
"12081000304",1495,364,240,225,63,0,399,204,2990
"12081000305",2219,1721,402,451,686,1117,2143,2514,11253
"12081000306",2866,1364,332,756,218,349,918,963,7766
"12081000307",1688,404,48,0,601,0,457,165,3363
"12081000308",2695,365,177,225,158,18,72,73,3783
"12081000309",2095,564,805,124,305,240,651,291,5075
"12081000310",2759,1019,233,131,245,142,754,805,6088
"12081000403",1506,62,0,0,72,0,39,0,1679
"12081000405",2638,70,0,0,108,12,292,0,3120
"12081000406",3093,284,152,0,194,38,89,2,3852
"12081000407",3365,340,0,0,21,0,71,0,3797
"12081000408",4276,643,117,29,431,30,429,227,6182
"12081000501",2983,272,213,0,87,10,210,0,3775
"12081000503",2990,277,303,3,123,0,126,4,3826
"12081000504",2682,492,31,9,95,6,196,100,3611
"12081000601",1548,630,150,260,276,29,418,121,3432
"12081000603",2786,371,35,0,262,70,837,175,4536
"12081000604",1989,776,126,249,19,71,419,226,3875
"12081000703",905,194,892,368,67,107,476,229,3238
"12081000704",2448,601,1043,706,162,257,1576,583,7376
"12081000705",1399,678,1366,981,319,46,700,328,5817
"12081000803",5604,589,1199,405,747,0,1699,279,10522
"12081000804",3222,238,31,0,346,0,150,24,4011
"12081000805",3792,938,30,187,677,41,206,671,6542
"12081000807",5260,175,175,0,462,0,990,0,7062
"12081000808",4999,490,115,26,55,0,111,6,5802
"12081000809",4539,344,195,0,159,0,755,29,6021
"12081000810",4858,170,269,0,112,0,99,0,5508
"12081000901",3257,367,250,80,371,200,627,208,5360
"12081000902",3144,416,267,62,368,210,474,276,5217
"12081001000",3781,475,31,181,542,17,719,104,5850
"12081001104",3175,203,75,0,572,0,395,0,4420
"12081001105",2525,309,236,224,218,17,163,6,3698
"12081001106",2609,237,131,36,176,111,387,90,3777
"12081001107",2724,491,0,0,47,0,86,0,3348
"12081001108",2077,209,0,4,60,2,105,26,2483
"12081001202",3851,490,21,0,103,0,235,0,4700
"12081001203",3620,311,81,3,387,40,590,0,5032
"12081001204",5068,250,202,0,286,33,71,0,5910
"12081001300",2643,556,43,0,2,0,194,222,3660
"12081001402",1386,43,0,0,0,0,102,7,1538
"12081001403",3783,874,41,0,248,0,685,450,6081
"12081001404",2877,289,270,19,123,109,464,109,4260
"12081001501",1147,442,1331,761,319,15,1042,390,5447
"12081001502",2289,922,1755,313,312,290,1182,975,8038
"12081001601",4215,569,951,47,188,0,1004,166,7140
"12081001602",2361,461,65,0,12,0,180,0,3079
"12081001701",1363,187,0,5,11,27,89,12,1694
"12081001703",1416,127,0,0,87,128,35,0,1793
"12081001704",659,27,0,0,11,0,0,0,697
"12081001800",3881,683,109,1,41,17,54,50,4836
"12081001904",3802,710,92,124,0,30,377,305,5440
"12081001907",3820,497,387,114,118,35,360,94,5425
"12081001908",5538,600,109,46,143,0,237,80,6753
"12081001909",2795,136,76,0,150,0,60,0,3217
"12081001910",3772,148,39,0,275,0,397,0,4631
"12081001911",5243,141,249,20,354,13,510,0,6530
"12081001912",3848,246,376,34,207,0,328,20,5059
"12081001913",2585,113,92,3,128,13,215,27,3176
"12081001914",1854,608,76,26,304,13,371,350,3602
"12081002003",3631,294,350,7,357,27,328,5,4999
"12081002005",4742,337,196,0,35,0,577,0,5887
"12081002007",4179,301,269,0,225,0,114,0,5088
"12081002008",4914,200,25,12,64,0,267,0,5482
"12081002010",2656,295,0,96,246,162,352,218,4025
"12081002011",2888,498,228,216,283,166,604,350,5233
"12081002012",4167,437,43,49,125,19,129,12,4981
"12081002013",10426,497,417,45,342,81,746,35,12589
"12081002014",3794,130,0,6,19,0,47,0,3996
"12081002015",4775,447,48,0,169,10,416,7,5872
"12081002016",5053,672,61,0,198,182,205,430,6801
"12081002017",3055,205,43,0,173,14,499,0,3989
"12081990000",0,0,0,0,0,0,0,0,0
"12083000100",2886,806,762,416,52,0,381,63,5366
"12083000200",3445,1123,1350,759,223,51,226,321,7498
"12083000301",3300,491,238,13,67,54,108,23,4294
"12083000302",1472,810,405,730,32,40,175,329,3993
"12083000401",1781,244,15,21,242,10,143,0,2456
"12083000402",3856,1063,0,0,105,22,309,59,5414
"12083000501",1422,224,0,0,0,0,52,0,1698
"12083000502",969,228,0,0,6,27,0,15,1245
"12083000601",3108,967,0,0,60,133,92,196,4556
"12083000602",4402,810,0,0,92,85,72,35,5496
"12083000604",2161,1495,0,10,0,84,161,349,4260
"12083000605",1676,751,65,1,31,0,8,0,2532
"12083000701",2933,1143,283,30,81,42,152,25,4689
"12083000702",6462,468,116,6,131,0,246,64,7493
"12083000801",13174,956,348,9,342,0,341,15,15185
"12083000802",9216,729,107,226,107,42,758,29,11214
"12083000901",4209,1231,246,0,81,48,697,145,6657
"12083000902",7138,1620,148,519,247,227,1005,728,11632
"12083001003",678,577,24,5,103,7,108,242,1744
"12083001004",7461,1756,2213,452,1303,489,3695,933,18302
"12083001005",3703,687,2020,69,224,73,537,661,7974
"12083001006",7532,371,623,45,658,205,1133,179,10746
"12083001007",5207,95,78,34,316,0,684,15,6429
"12083001008",4017,267,176,0,42,77,247,110,4936
"12083001102",2036,422,121,11,73,8,164,37,2872
"12083001103",4408,394,642,157,566,48,738,85,7038
"12083001104",4311,1101,464,18,313,61,467,221,6956
"12083001204",2351,1698,1834,562,405,37,859,754,8500
"12083001205",2577,476,264,15,77,0,145,56,3610
"12083001206",941,191,415,22,77,78,58,122,1904
"12083001207",6011,1356,2216,440,1196,293,2126,408,14046
"12083001208",2990,548,195,198,51,0,279,47,4308
"12083001301",4484,410,648,0,233,76,523,0,6374
"12083001302",5092,470,232,53,19,24,411,78,6379
"12083001401",2316,847,1035,624,124,179,149,227,5501
"12083001402",3733,657,376,267,278,54,307,83,5755
"12083001500",674,478,1490,818,57,6,164,28,3715
"12083001600",957,397,223,75,200,142,277,279,2550
"12083001700",760,661,2005,1289,265,492,458,884,6814
"12083001800",46,48,441,936,7,6,0,6,1490
"12083001900",1331,167,187,104,23,23,108,86,2029
"12083002001",1628,683,206,63,163,19,287,150,3199
"12083002002",2161,837,232,482,157,106,209,108,4292
"12083002100",4078,297,83,14,94,14,342,111,5033
"12083002201",2454,465,148,0,49,16,131,50,3313
"12083002202",3448,123,1,0,0,0,63,62,3697
"12083002203",5132,608,310,265,229,18,306,58,6926
"12083002301",4433,550,493,73,189,0,214,119,6071
"12083002302",4619,234,656,200,117,43,186,13,6068
"12083002401",3238,437,358,152,285,22,387,12,4891
"12083002402",3841,445,143,177,299,8,106,1,5020
"12083002502",8219,1211,460,0,1669,45,1360,379,13343
"12083002503",3790,469,629,348,503,616,729,603,7687
"12083002504",2993,573,838,652,256,0,299,292,5903
"12083002601",4471,1049,95,81,314,395,351,320,7076
"12083002602",3868,1642,306,134,120,378,514,1523,8485
"12083002604",2662,350,109,0,69,13,330,87,3620
"12083002605",2042,314,93,19,188,28,181,20,2885
"12083002606",5702,538,20,0,80,0,88,33,6461
"12083002701",4244,1433,45,9,122,0,470,281,6604
"12083002702",4806,896,303,620,285,17,76,19,7022
"12083980000",0,0,0,0,0,0,0,0,0
"12083980100",0,0,0,0,0,0,0,0,0
"12085000100",2154,53,13,0,51,0,50,0,2321
"12085000200",2420,216,207,9,63,0,48,7,2970
"12085000300",4706,596,181,345,155,21,126,27,6157
"12085000400",7105,730,12,0,67,0,219,0,8133
"12085000501",3355,794,45,39,64,58,113,20,4488
"12085000502",1905,52,25,0,12,0,133,0,2127
"12085000603",5058,312,52,0,475,0,401,0,6298
"12085000604",4991,164,13,0,308,13,224,0,5713
"12085000606",4779,340,37,0,38,0,301,0,5495
"12085000607",2580,72,28,0,42,0,89,40,2851
"12085000610",3633,98,21,0,206,0,171,11,4140
"12085000700",3133,389,72,3,58,0,39,27,3721
"12085000800",641,151,684,256,85,20,88,59,1984
"12085000901",1852,85,27,1,0,0,17,0,1982
"12085000902",3425,602,107,51,209,49,461,204,5108
"12085001000",2565,532,483,285,255,757,513,626,6016
"12085001102",5822,423,0,2,312,0,150,82,6791
"12085001103",1789,151,11,0,153,40,154,41,2339
"12085001104",7130,429,345,0,234,260,797,415,9610
"12085001200",1160,512,33,76,276,32,547,218,2854
"12085001301",4072,1241,238,97,1260,434,2151,1229,10722
"12085001302",3853,200,45,26,85,0,50,26,4285
"12085001404",4551,359,393,0,67,189,231,179,5969
"12085001406",3113,237,136,16,47,0,86,0,3635
"12085001407",1781,108,0,0,0,0,81,0,1970
"12085001408",2069,699,333,181,110,64,343,454,4253
"12085001409",2927,226,50,0,21,0,61,0,3285
"12085001410",3783,277,629,51,336,87,200,189,5552
"12085001500",3113,147,74,11,72,0,256,12,3685
"12085001601",3811,251,0,33,144,14,88,26,4367
"12085001602",1153,20,0,0,15,5,172,0,1365
"12085001700",7917,687,286,46,505,122,501,152,10216
"12085001801",2521,799,784,636,1765,428,2855,1259,11047
"12085001802",949,484,19,4,334,477,608,849,3724
"12085990000",0,0,0,0,0,0,0,0,0
"12085990100",0,0,0,0,0,0,0,0,0
"12086000107",1934,384,115,0,14,37,901,295,3680
"12086000109",1570,769,678,126,211,107,1101,707,5269
"12086000113",6153,938,114,47,200,29,2338,302,10121
"12086000115",1917,511,157,3,78,21,822,335,3844
"12086000118",825,276,0,0,21,34,218,164,1538
"12086000119",3348,423,252,172,59,0,1578,18,5850
"12086000120",3179,473,311,0,648,0,1356,140,6107
"12086000121",1462,164,43,7,78,0,503,0,2257
"12086000122",2978,612,89,0,66,30,739,216,4730
"12086000123",3341,423,120,1,95,130,968,156,5234
"12086000124",475,425,843,455,285,37,714,235,3469
"12086000125",2703,439,275,101,157,44,1290,89,5098
"12086000126",1793,451,0,0,89,0,1005,190,3528
"12086000127",3373,243,10,19,210,14,1619,126,5614
"12086000128",1369,93,149,13,34,7,770,81,2516
"12086000129",2044,55,0,0,21,0,557,0,2677
"12086000130",2256,269,23,39,15,0,556,88,3246
"12086000131",2108,59,0,0,48,0,873,34,3122
"12086000132",4179,886,43,0,111,57,1551,555,7382
"12086000133",6173,467,137,0,262,0,2395,194,9628
"12086000134",1828,348,66,214,395,29,1006,291,4177
"12086000140",2473,313,155,0,112,92,1698,159,5002
"12086000202",3309,1102,1621,772,806,149,2066,897,10722
"12086000204",919,292,2730,629,293,23,853,267,6006
"12086000206",1326,217,2744,1155,163,47,1318,151,7121
"12086000209",815,468,3184,1667,222,10,729,437,7532
"12086000211",1836,274,520,170,253,89,1167,86,4395
"12086000212",691,337,1676,1422,41,10,683,334,5194
"12086000213",2399,505,1647,944,151,12,823,135,6616
"12086000214",2588,966,1362,482,239,106,1186,634,7563
"12086000215",749,131,1767,1062,407,0,722,64,4902
"12086000216",1049,131,2967,711,158,0,1141,36,6193
"12086000217",779,210,3308,1327,580,295,1162,461,8122
"12086000218",562,116,1714,1132,66,65,464,87,4206
"12086000219",1116,233,1351,1226,167,104,771,161,5129
"12086000220",927,417,2826,842,213,111,862,480,6678
"12086000301",1043,278,3445,1239,451,0,1071,214,7741
"12086000302",552,87,1733,74,255,0,500,16,3217
"12086000305",655,450,4303,1387,408,28,600,458,8289
"12086000306",821,316,2694,1323,128,15,603,227,6127
"12086000307",1399,83,1968,631,194,61,1239,196,5771
"12086000308",1448,131,2566,989,537,13,1514,121,7319
"12086000402",188,110,1962,1471,0,0,170,67,3968
"12086000403",339,496,3646,1714,20,0,350,527,7092
"12086000404",941,203,3816,880,79,171,1118,401,7609
"12086000405",806,229,2278,1017,276,10,922,239,5777
"12086000408",595,571,1942,1167,75,82,648,622,5702
"12086000409",232,284,3415,562,74,192,298,401,5458
"12086000410",1110,382,2912,489,193,142,1241,536,7005
"12086000411",671,76,3423,1993,106,15,859,100,7243
"12086000412",1905,574,2554,1364,87,246,1833,678,9241
"12086000413",791,393,2092,1513,123,0,557,406,5875
"12086000414",530,166,2670,1044,269,52,458,186,5375
"12086000501",1545,1119,2956,1474,58,69,1819,1241,10281
"12086000503",1470,818,1896,2559,344,76,1626,1135,9924
"12086000504",1637,731,1923,472,177,0,1843,729,7512
"12086000505",4403,1325,0,10,8,55,4214,1390,11405
"12086000601",3613,1506,46,0,95,11,3546,1445,10262
"12086000602",3642,1204,13,8,58,182,3381,1300,9788
"12086000603",3946,1023,25,76,47,0,3759,1044,9920
"12086000604",4691,1514,15,15,288,7,4856,1482,12868
"12086000605",3511,840,6,80,135,6,3590,926,9094
"12086000607",3922,1530,10,0,6,15,3788,1501,10772
"12086000608",4499,2421,159,142,79,66,4479,2505,14350
"12086000705",3319,1248,19,3,121,11,3423,1238,9382
"12086000706",6117,1852,0,126,159,24,6116,2002,16396
"12086000707",5946,1030,189,181,124,226,5944,1433,15073
"12086000708",5072,1240,36,35,560,129,5409,1162,13643
"12086000709",4997,1482,52,105,140,13,5159,1600,13548
"12086000710",3070,1761,28,44,52,16,2993,1809,9773
"12086000711",3108,1695,272,10,72,8,3251,1698,10114
"12086000712",1633,741,0,33,106,0,1725,648,4886
"12086000804",3309,1414,108,173,16,88,3274,1630,10012
"12086000805",4916,969,134,0,178,9,5040,931,12177
"12086000806",2672,1707,79,104,60,0,2720,1761,9103
"12086000807",1866,1938,22,142,87,66,1939,1995,8055
"12086000808",2412,1671,30,30,110,0,2503,1633,8389
"12086000901",4705,1446,865,89,246,93,5016,1508,13968
"12086000902",2555,1005,2040,315,112,21,2907,1143,10098
"12086000903",736,569,831,330,23,51,760,646,3946
"12086001002",245,314,4085,479,57,45,263,243,5731
"12086001003",698,211,3162,936,89,85,1130,260,6571
"12086001004",325,473,2942,2083,128,52,421,647,7071
"12086001005",170,64,1051,296,4,210,121,281,2197
"12086001006",934,529,2149,1181,273,94,887,540,6587
"12086001101",1303,162,3045,867,396,81,1081,243,7178
"12086001102",1289,346,2338,666,89,0,1015,297,6040
"12086001103",1221,167,1765,497,148,59,1195,142,5194
"12086001104",3190,276,949,85,339,15,1234,168,6256
"12086001203",2316,740,2351,1552,165,16,1613,446,9199
"12086001204",3303,663,1026,52,220,131,1752,533,7680
"12086001205",2777,139,425,86,161,8,1067,95,4758
"12086001206",2852,746,66,106,199,0,1094,196,5259
"12086001301",1692,754,979,408,268,56,1103,659,5919
"12086001302",3431,267,1035,936,443,152,1945,423,8632
"12086001401",384,452,2639,2014,10,46,280,414,6239
"12086001402",328,253,1958,3497,121,24,180,190,6551
"12086001501",129,272,1120,2503,0,27,106,249,4406
"12086001502",71,71,1408,2091,18,154,89,272,4174
"12086001602",4270,1914,59,0,149,35,4256,1949,12632
"12086001603",2444,660,0,2,66,9,2469,667,6317
"12086001605",1873,1618,158,180,32,0,2000,1716,7577
"12086001606",3201,1449,115,6,22,86,3278,1510,9667
"12086001701",841,635,2012,836,39,74,836,631,5904
"12086001702",550,107,1314,383,6,7,524,112,3003
"12086001703",3037,1293,330,77,145,372,3388,1723,10365
"12086001801",212,65,1643,1852,0,0,204,208,4184
"12086001802",623,288,1642,1310,27,38,630,289,4847
"12086001803",302,313,950,1454,0,205,387,580,4191
"12086001901",11,396,2034,932,94,24,105,394,3990
"12086001903",233,147,1743,1196,24,0,384,135,3862
"12086001904",205,30,1875,1373,0,147,205,177,4012
"12086002001",74,95,1828,1622,97,0,265,143,4124
"12086002003",221,413,1664,739,94,30,116,405,3682
"12086002004",565,235,1268,794,56,14,596,211,3739
"12086002100",1310,682,505,11,91,0,571,361,3531
"12086002201",1178,247,1346,256,212,148,913,370,4670
"12086002202",1085,503,2260,1852,280,110,1305,540,7935
"12086002300",646,287,2703,1384,71,87,679,282,6139
"12086002402",2731,1184,258,358,215,303,3061,1560,9670
"12086002403",1916,583,469,239,893,308,3012,1123,8543
"12086002404",1734,1721,552,612,212,192,2182,2101,9306
"12086002501",1617,1052,700,804,586,241,2229,1598,8827
"12086002502",1081,844,797,491,295,150,1445,928,6031
"12086002600",2643,1331,420,1070,227,350,2306,1612,9959
"12086002702",1759,585,345,242,179,8,1758,416,5292
"12086002703",4639,401,348,52,308,22,2310,384,8464
"12086002705",2081,380,81,134,103,0,1410,206,4395
"12086002706",2143,352,176,148,344,162,1887,331,5543
"12086002800",240,415,255,561,32,31,280,352,2166
"12086002900",3090,1466,832,515,379,453,3709,1812,12256
"12086003001",540,556,373,221,174,110,360,607,2941
"12086003003",4279,1819,211,521,56,14,4482,1848,13230
"12086003004",1794,1231,296,78,143,36,1919,1271,6768
"12086003100",441,166,1513,2004,71,61,635,350,5241
"12086003400",129,129,737,650,0,43,92,186,1966
"12086003601",705,819,780,992,162,77,897,854,5286
"12086003602",3766,2499,265,460,99,61,3818,2626,13594
"12086003702",2386,599,214,179,399,50,1595,290,5712
"12086003703",946,261,229,0,109,46,538,85,2214
"12086003704",1151,152,96,47,18,15,819,105,2403
"12086003705",979,114,16,0,100,0,770,74,2053
"12086003706",0,0,0,0,0,0,0,0,0
"12086003707",656,205,61,82,135,35,312,153,1639
"12086003801",4366,463,140,171,519,249,2090,446,8444
"12086003803",2107,336,13,0,149,0,1006,250,3861
"12086003804",4796,327,22,0,759,23,1588,191,7706
"12086003906",2962,175,43,0,61,4,558,96,3899
"12086003909",798,419,72,30,82,65,596,318,2380
"12086003911",1947,1103,140,200,1151,147,2597,1048,8333
"12086003912",2652,580,71,71,1019,404,2850,827,8474
"12086003913",2329,720,56,0,1489,243,3039,876,8752
"12086003914",1977,862,136,162,433,124,1245,856,5795
"12086003915",2811,913,0,49,1035,58,2625,751,8242
"12086003916",1981,359,324,60,1034,44,2075,303,6180
"12086003917",3276,283,72,14,979,118,2941,293,7976
"12086003918",1395,281,164,0,610,93,1150,222,3915
"12086003919",2039,182,29,0,93,0,998,142,3483
"12086003921",2189,326,27,2,220,0,1420,263,4447
"12086003922",2399,302,24,0,275,9,1361,229,4599
"12086004000",4343,549,61,57,446,70,1175,167,6868
"12086004102",2205,264,10,21,332,23,1010,164,4029
"12086004103",1668,286,659,64,627,57,1597,228,5186
"12086004105",1685,164,27,0,726,12,1101,44,3759
"12086004106",3042,288,146,19,308,82,1144,173,5202
"12086004203",2961,561,141,0,870,63,1390,132,6118
"12086004204",1582,164,25,0,260,22,961,54,3068
"12086004205",1331,685,14,0,568,75,1113,298,4084
"12086004206",799,151,96,55,497,38,970,189,2795
"12086004301",1271,91,150,0,347,20,737,33,2649
"12086004303",1185,570,197,48,115,73,569,426,3183
"12086004304",1957,227,16,69,500,52,1196,270,4287
"12086004403",1489,488,136,87,239,70,1001,502,4012
"12086004404",1193,492,62,69,41,21,706,516,3100
"12086004405",1752,783,26,154,564,395,1752,1147,6573
"12086004406",1540,231,168,0,378,66,836,182,3401
"12086004500",2991,319,86,0,376,50,1336,275,5433
"12086004602",3785,149,0,45,97,189,2079,86,6430
"12086004605",3204,239,0,0,8,0,2112,219,5782
"12086004607",2834,117,0,0,191,0,1676,89,4907
"12086004608",1721,72,0,0,109,14,1113,52,3081
"12086004701",4985,424,37,0,343,21,3168,223,9201
"12086004702",4786,929,225,0,122,1,3765,859,10687
"12086004703",3551,772,7,131,227,8,3069,837,8602
"12086004901",1633,1249,145,1,281,0,1861,1214,6384
"12086004902",5461,1295,64,7,99,24,5483,1158,13591
"12086005001",6380,1584,0,58,236,0,6395,1577,16230
"12086005002",3862,1599,172,7,150,23,4075,1613,11501
"12086005102",2526,1267,46,137,19,0,2284,1291,7570
"12086005103",1542,865,65,0,28,0,1618,859,4977
"12086005104",1576,1480,357,188,119,0,2021,1461,7202
"12086005201",2706,1997,322,137,316,35,3113,2074,10700
"12086005202",3192,1595,63,76,305,378,3445,1965,11019
"12086005302",2976,3271,126,444,144,77,3149,3750,13937
"12086005303",2293,907,29,75,0,47,2301,939,6591
"12086005304",2369,1733,88,179,103,79,2474,1865,8890
"12086005403",848,261,129,49,0,0,953,310,2550
"12086005405",2078,899,185,130,64,0,2184,1028,6568
"12086005406",1968,1433,411,79,147,160,2526,1672,8396
"12086005407",1208,840,56,9,44,0,1208,809,4174
"12086005409",2110,1439,14,71,39,41,2126,1456,7296
"12086005410",2385,800,54,24,0,23,2362,847,6495
"12086005501",4681,944,280,65,259,133,4953,1110,12425
"12086005502",3918,2727,0,0,269,0,3986,2723,13623
"12086005600",4249,788,256,5,92,30,4282,809,10511
"12086005701",4640,1410,12,17,213,149,4724,1559,12724
"12086005703",5423,964,57,28,421,15,5396,976,13280
"12086005704",5337,2335,75,18,73,0,5345,2331,15514
"12086005801",6892,750,190,14,264,101,7075,760,16046
"12086005802",7113,2588,38,37,160,0,6845,2586,19367
"12086005901",3339,893,0,0,88,0,3027,865,8212
"12086005902",2871,952,30,17,0,0,2639,944,7453
"12086005903",4804,1119,17,0,50,0,4603,1045,11638
"12086005904",3504,554,21,8,184,26,3275,580,8152
"12086006001",5737,864,43,12,348,0,5292,846,13142
"12086006002",5031,443,73,22,114,48,4357,222,10310
"12086006101",5142,277,34,0,312,0,3811,171,9747
"12086006102",5936,470,19,0,97,4,3392,179,10097
"12086006201",1808,616,154,1,116,13,1759,628,5095
"12086006203",1400,199,0,2,171,1,907,152,2832
"12086006205",2912,414,215,71,231,72,2697,455,7067
"12086006206",2181,445,35,0,45,55,1333,308,4402
"12086006301",4361,1796,155,109,307,2,4406,1858,12994
"12086006302",3650,517,55,16,93,488,3385,942,9146
"12086006401",2557,881,95,24,148,57,2583,945,7290
"12086006402",2882,439,51,0,206,28,3031,467,7104
"12086006403",2429,855,177,1,170,8,2337,840,6817
"12086006501",2335,884,0,27,133,30,2168,844,6421
"12086006503",2054,468,17,0,247,6,1973,472,5237
"12086006504",1966,352,0,13,166,25,1743,347,4612
"12086006601",5707,1246,333,47,178,187,5166,1404,14268
"12086006602",2905,1753,54,4,221,0,2429,1744,9110
"12086006702",6854,1106,376,0,417,93,4095,672,13613
"12086006705",2324,377,61,1,60,63,1573,300,4759
"12086006706",1726,427,103,0,131,5,1069,375,3836
"12086006707",3871,204,91,0,143,0,2117,135,6561
"12086006709",601,113,35,4,217,7,381,16,1374
"12086006711",1634,361,147,0,201,7,1153,278,3781
"12086006713",1214,602,11,0,23,49,739,624,3262
"12086006714",1256,270,17,0,382,0,1145,213,3283
"12086006801",2285,356,33,8,103,15,850,197,3847
"12086006802",3513,255,17,5,164,0,1621,178,5753
"12086006900",4569,1067,31,70,335,107,4002,1151,11332
"12086007001",6439,1768,375,34,467,107,6221,1740,17151
"12086007002",5440,1823,211,55,114,21,5376,1665,14705
"12086007101",1013,375,528,370,120,0,485,296,3187
"12086007103",1319,149,24,12,125,0,515,34,2178
"12086007104",2166,509,172,18,165,17,764,334,4145
"12086007200",520,110,1079,921,9,0,290,159,3088
"12086007300",3594,242,19,0,211,1,1348,101,5516
"12086007400",6090,316,21,0,395,29,3751,145,10747
"12086007501",2574,178,0,0,61,28,1648,121,4610
"12086007503",797,59,0,0,5,0,353,38,1252
"12086007601",2493,315,5,3,59,0,1728,144,4747
"12086007603",1318,648,1312,211,89,78,963,257,4876
"12086007604",4918,288,121,0,221,96,2839,212,8695
"12086007605",3570,673,0,39,366,156,2270,386,7460
"12086007606",4242,625,594,10,385,80,2885,397,9218
"12086007701",5731,604,111,0,147,0,5159,541,12293
"12086007702",5980,341,47,17,276,37,4791,343,11832
"12086007704",3532,427,103,55,190,137,2993,297,7734
"12086007705",3894,467,124,0,264,0,3101,384,8234
"12086007801",1104,96,7,2,14,0,525,90,1838
"12086007804",5807,431,74,5,639,299,4224,298,11777
"12086007805",4039,112,0,59,481,48,2664,71,7474
"12086007806",4045,125,82,19,204,54,1904,144,6577
"12086007807",3883,284,14,0,381,108,2005,204,6879
"12086007901",3037,285,81,27,67,15,1629,218,5359
"12086007902",3183,115,0,3,120,32,1473,42,4968
"12086008000",5512,384,400,0,202,0,2911,245,9654
"12086008101",3181,151,10,3,195,0,981,25,4546
"12086008102",3910,175,48,5,777,45,1712,121,6793
"12086008202",3094,301,269,13,270,37,1294,209,5487
"12086008205",3933,32,31,0,335,0,1724,6,6061
"12086008206",3229,229,226,11,365,76,1218,256,5610
"12086008207",3865,35,23,10,136,0,1518,12,5599
"12086008208",2990,623,314,336,256,14,1828,445,6806
"12086008209",3903,87,348,0,444,0,1547,87,6416
"12086008304",1035,562,4857,1431,142,119,897,737,9780
"12086008305",3916,328,504,18,450,31,2086,229,7562
"12086008306",4830,897,2313,519,461,15,3736,840,13611
"12086008307",2559,514,3121,237,378,58,2417,496,9780
"12086008308",2366,1039,1906,194,330,65,1973,856,8729
"12086008309",192,181,2436,1430,116,61,259,182,4857
"12086008405",5457,267,84,201,213,0,3322,265,9809
"12086008407",6248,516,30,1,605,11,4955,503,12869
"12086008409",4855,224,97,85,354,75,2883,144,8717
"12086008410",5359,451,36,84,309,23,3473,317,10052
"12086008412",4202,894,262,19,220,41,3545,815,9998
"12086008414",6103,640,426,4,678,0,4179,604,12634
"12086008415",4524,81,146,0,388,81,2186,27,7433
"12086008416",3005,247,16,0,200,0,2218,240,5926
"12086008417",3661,721,336,13,310,60,3264,663,9028
"12086008418",2467,249,99,86,116,0,2339,138,5494
"12086008419",4227,431,82,413,89,57,3467,268,9034
"12086008501",5385,1675,221,74,84,13,5101,1614,14167
"12086008502",4157,384,38,0,196,9,3625,275,8684
"12086008601",3514,842,8,45,75,126,3109,837,8556
"12086008602",6444,570,0,9,218,0,5802,524,13567
"12086008701",5117,656,0,24,36,34,4637,676,11180
"12086008702",4895,518,91,22,253,142,4426,535,10882
"12086008803",5140,1082,163,58,94,17,4818,1049,12421
"12086008804",5937,1337,292,96,107,25,5933,1443,15170
"12086008805",3696,1215,19,232,75,10,3638,1423,10308
"12086008806",3378,385,0,18,4,5,3064,351,7205
"12086008901",7014,438,91,0,29,0,6939,385,14896
"12086008902",5490,751,99,82,153,10,5257,765,12607
"12086008904",0,21,0,0,0,0,0,9,30
"12086008906",3930,915,0,196,115,2,3812,1097,10067
"12086008907",4013,614,101,0,64,21,3646,465,8924
"12086009006",7201,1401,349,2,122,124,6925,1254,17378
"12086009010",4746,288,121,0,153,0,3924,266,9498
"12086009014",3479,386,53,0,206,13,3478,389,8004
"12086009015",3987,578,39,16,202,180,3952,574,9528
"12086009017",4703,1409,14,27,98,25,4694,1373,12343
"12086009019",4210,396,11,0,158,9,4219,385,9388
"12086009020",1750,809,16,81,149,22,1821,912,5560
"12086009021",3174,1360,15,6,90,14,3213,1324,9196
"12086009022",1622,351,11,3,109,16,1701,354,4167
"12086009023",5495,1275,108,13,265,268,5597,1275,14296
"12086009024",3585,645,87,0,308,47,3570,692,8934
"12086009026",1555,719,0,0,34,53,1412,670,4443
"12086009027",2736,845,0,0,339,36,2769,778,7503
"12086009028",3797,357,7,0,102,0,3751,357,8371
"12086009029",3095,707,6,12,73,0,2998,716,7607
"12086009030",3445,653,113,0,45,0,3477,574,8307
"12086009031",3060,593,12,18,238,0,3033,576,7530
"12086009034",6181,535,138,0,825,26,5197,452,13354
"12086009035",3632,800,174,38,268,65,2978,819,8774
"12086009036",6943,603,18,7,607,56,6224,545,15003
"12086009038",6798,657,52,0,348,31,5750,602,14238
"12086009039",4082,480,156,0,456,56,3804,419,9453
"12086009040",48,38,0,2,0,0,43,40,171
"12086009043",3614,576,157,0,91,0,3243,527,8208
"12086009044",1129,303,0,0,81,12,964,281,2770
"12086009046",612,129,29,69,60,27,527,182,1635
"12086009047",2605,395,56,14,95,41,2347,395,5948
"12086009100",4250,1007,0,6,240,0,4327,1004,10834
"12086009200",2738,571,7,124,75,0,2655,661,6831
"12086009305",4054,482,50,0,201,54,3109,410,8360
"12086009306",4530,1367,90,106,306,42,4482,1472,12395
"12086009307",3726,1721,228,62,355,38,3990,1686,11806
"12086009308",4766,2827,86,263,80,66,4665,3122,15875
"12086009309",5915,1052,14,22,349,46,6164,1104,14666
"12086009311",4909,1095,43,41,150,0,4921,1071,12230
"12086009312",4249,776,222,0,75,41,3665,725,9753
"12086009313",4698,373,250,1,107,0,3983,340,9752
"12086009314",3063,1111,32,0,194,48,3164,1119,8731
"12086009315",2216,540,71,0,40,6,2163,495,5531
"12086009400",1380,522,3700,1066,250,71,1642,622,9253
"12086009501",614,29,3046,1238,55,53,645,85,5765
"12086009503",335,43,3352,751,69,0,514,43,5107
"12086009504",252,39,3908,792,12,8,239,52,5302
"12086009600",1002,243,4363,839,56,50,943,231,7727
"12086009703",3218,152,10,0,191,148,1296,178,5193
"12086009704",5167,333,218,87,138,67,1912,284,8206
"12086009705",2591,1304,228,261,325,111,1880,770,7470
"12086009706",2899,301,152,53,82,6,1524,275,5292
"12086009803",2185,80,1902,269,256,9,1397,87,6185
"12086009804",1330,114,1414,269,235,0,783,56,4201
"12086009806",1223,684,809,143,98,30,776,499,4262
"12086009807",1536,676,3910,952,254,0,990,354,8672
"12086009808",1857,416,1937,204,241,48,1424,225,6352
"12086009901",911,225,6405,766,392,52,1162,171,10084
"12086009903",55,17,4490,777,17,0,106,0,5462
"12086009904",61,17,2142,779,193,53,160,76,3481
"12086009905",524,8,4336,1038,12,0,903,0,6821
"12086009906",644,53,3663,549,139,0,481,46,5575
"12086010001",519,570,3650,2035,367,0,910,565,8616
"12086010005",4182,827,1239,423,761,183,4855,1187,13657
"12086010006",2731,998,3680,813,214,11,3217,1229,12893
"12086010009",3674,858,2338,742,393,0,3937,858,12800
"12086010010",1739,259,1804,1074,55,177,1806,502,7416
"12086010011",482,301,3450,1164,313,195,1033,450,7388
"12086010012",72,12,3920,748,257,27,406,12,5454
"12086010013",2263,582,1403,71,319,30,2514,618,7800
"12086010015",2297,895,0,41,153,582,2238,1173,7379
"12086010016",3065,875,454,81,253,2,3176,871,8777
"12086010193",2143,134,91,2,202,0,1965,73,4610
"12086010198",3235,187,334,15,649,0,2587,177,7184
"12086010201",3053,317,485,6,362,3,2388,259,6873
"12086010204",5342,609,891,0,162,53,4322,435,11814
"12086010205",2573,1053,955,300,247,0,2489,1050,8667
"12086010207",953,857,1280,329,225,0,908,916,5468
"12086010208",2387,673,883,630,88,142,2316,702,7821
"12086010209",3478,594,423,346,343,96,3395,737,9412
"12086010210",4076,451,550,1115,673,125,3998,475,11463
"12086010300",5539,1812,131,33,534,33,2959,900,11941
"12086010400",1864,370,464,301,52,440,1567,702,5760
"12086010500",4611,1201,2882,1332,84,94,3040,1288,14532
"12086010604",4393,403,106,46,401,0,1883,185,7417
"12086010606",5044,759,917,68,470,0,3068,681,11007
"12086010608",3873,547,990,77,304,21,2463,421,8696
"12086010609",2280,1201,1548,281,183,29,2159,920,8601
"12086010610",2583,526,437,52,322,38,1264,578,5800
"12086010612",6702,512,1640,3,966,0,4646,331,14800
"12086010613",3232,568,525,99,512,19,2619,381,7955
"12086010614",3425,764,2125,1729,653,68,3015,812,12591
"12086010617",3658,434,686,111,556,77,3193,363,9078
"12086010703",6179,2244,2150,1205,713,210,6065,2125,20891
"12086010704",4748,1688,2211,743,430,49,4575,1482,15926
"12086010801",2643,1394,897,1118,455,178,2475,1433,10593
"12086010802",2548,798,1082,1778,265,113,2446,822,9852
"12086010900",2939,1862,460,277,301,92,2999,1757,10687
"12086011001",4338,3484,1497,985,123,93,3823,3317,17660
"12086011003",2007,1190,370,494,209,146,1960,1147,7523
"12086011005",3318,1439,1231,222,249,0,3215,1358,11032
"12086011007",4755,352,632,52,393,201,3330,466,10181
"12086011008",2760,290,722,8,296,16,2320,306,6718
"12086011009",3485,722,932,131,610,44,2679,637,9240
"12086011101",3909,3191,735,347,468,367,3304,3421,15742
"12086011102",5144,599,494,0,329,0,2804,232,9602
"12086011201",3963,1350,755,753,101,93,2390,1260,10665
"12086011202",3984,2820,343,75,276,0,2705,2581,12784
"12086011300",1849,1684,1801,2582,157,442,1764,2083,12362
"12086011401",8470,1760,2752,1047,1466,99,5912,977,22483
"12086011403",3014,1795,610,1363,173,92,2650,1278,10975
"12086011404",2170,2042,665,504,186,46,1906,1794,9313
"12086011500",4348,340,55,40,156,125,2659,193,7916
"12086011600",4258,511,924,317,146,11,3740,436,10343
"12086011700",4923,1120,622,331,413,66,5092,1459,14026
"12086011800",1972,285,1050,22,262,26,1898,250,5765
"12086011900",4073,503,426,54,217,161,3620,621,9675
"12086012000",4954,2191,1031,127,177,84,4911,2065,15540
"12086012100",10675,2497,487,849,605,312,10371,2103,27899
"12086012200",5331,202,30,4,73,0,4500,199,10339
"12086012300",6087,102,531,419,353,33,6093,370,13988
"12086012400",7765,699,518,101,191,162,7353,634,17423
"12086012500",5108,903,162,3,361,24,5449,898,12908
"12086012600",5587,1426,0,0,103,0,5424,1399,13939
"12086012700",5954,1120,336,4,289,35,5439,1155,14332
"12086012800",7334,570,278,8,366,0,6850,524,15930
"12086012900",3795,459,254,6,57,0,3991,465,9027
"12086013000",4257,598,6,0,596,0,4185,537,10179
"12086013100",4356,1046,120,74,43,66,4319,1158,11182
"12086013200",4605,779,161,17,371,24,5027,703,11687
"12086013300",4505,958,78,22,45,0,4439,929,10976
"12086013400",4286,1321,122,0,251,34,4358,1346,11718
"12086013500",3396,1391,67,9,0,238,3215,1529,9845
"12086013600",4089,1682,34,91,126,18,4203,1791,12034
"12086013700",3398,1704,198,0,60,16,3487,1698,10561
"12086013800",5343,1217,67,58,140,0,5451,1084,13360
"12086013900",4223,495,63,6,86,37,4253,534,9697
"12086014000",92,0,0,0,8,9,81,9,199
"12086014100",0,0,0,0,0,0,0,0,0
"12086014200",4503,848,285,8,30,29,4468,843,11014
"12086014300",3222,317,0,9,40,0,3043,306,6937
"12086014400",3947,541,52,3,74,218,4002,537,9374
"12086014500",3823,653,0,16,29,0,3524,637,8682
"12086014600",5428,1958,0,0,61,37,5327,1868,14679
"12086014700",5825,1305,194,1,5,56,5850,1216,14452
"12086014800",4217,1080,249,1,136,0,4291,1002,10976
"12086014900",4963,409,29,1,96,10,4829,402,10739
"12086015000",6955,1036,22,21,335,25,7024,1041,16459
"12086015100",9443,1013,64,15,324,75,9189,952,21075
"12086015200",6044,513,26,47,357,67,6162,504,13720
"12086015300",5366,503,0,31,261,0,5331,508,12000
"12086015400",4956,512,57,0,170,28,4899,521,11143
"12086015500",5694,726,41,42,72,0,5171,700,12446
"12086015600",3711,715,77,0,149,7,3106,641,8406
"12086015700",2208,310,45,5,58,60,2099,285,5070
"12086015800",4042,829,191,5,77,0,3814,787,9745
"12086015900",3106,842,0,3,120,0,2828,839,7738
"12086016000",4206,656,9,1,200,0,3893,638,9603
"12086016100",4494,561,62,0,192,8,4355,516,10188
"12086016200",2756,514,0,0,14,13,2499,475,6271
"12086016300",4701,233,75,18,432,12,4408,187,10066
"12086016400",5967,560,78,2,82,10,5692,524,12915
"12086016500",6871,413,437,14,521,64,6958,415,15693
"12086016600",3637,309,215,5,79,19,3137,306,7707
"12086016700",4941,736,64,18,103,107,4569,713,11251
"12086016800",3542,212,247,2,127,122,3232,332,7816
"12086016900",3719,506,28,0,224,6,3665,512,8660
"12086017000",4113,940,8,29,284,38,4121,933,10466
"12086017100",4783,891,533,150,210,151,4945,941,12604
"12086017200",3859,296,77,33,319,0,3454,314,8352
"12086017300",3342,696,176,0,313,77,3047,727,8378
"12086017400",4955,1141,41,62,18,14,4113,1109,11453
"12086017500",2994,687,36,19,152,38,2986,688,7600
"12086017600",5462,620,47,0,278,37,5258,608,12310
"12086017700",2986,1099,209,8,100,75,2833,1103,8413
"12086017800",3819,1690,128,137,189,8,3917,1693,11581
"12086017900",6934,473,295,5,629,0,5795,466,14597
"12086018000",6073,746,690,28,436,91,5401,685,14150
"12086018100",4352,386,171,9,338,29,3892,369,9546
"12086018200",2044,343,143,0,81,38,1976,316,4941
"12086018300",4297,683,265,8,296,148,3580,578,9855
"12086018400",2441,691,314,0,162,48,2125,724,6505
"12086018500",3164,612,273,129,448,2,2704,604,7936
"12086018600",7897,441,332,54,135,141,6826,403,16229
"12086018700",4369,636,188,16,176,0,3624,582,9591
"12086018800",5882,878,379,54,602,8,4763,820,13386
"12086018900",5251,1074,223,32,663,47,3563,887,11740
"12086019000",4857,759,189,31,243,0,3628,625,10332
"12086019100",3825,354,328,1,241,273,3000,428,8450
"12086019200",4308,518,394,75,451,67,3343,431,9587
"12086019300",5934,786,596,226,452,0,3896,580,12470
"12086019400",7037,155,324,126,570,45,5376,140,13773
"12086019500",5416,771,573,43,142,151,3794,772,11662
"12086019600",4200,323,624,22,684,0,3381,323,9557
"12086019700",3303,75,578,21,239,0,2850,67,7133
"12086019800",6834,471,540,2,496,0,6037,337,14717
"12086019900",8003,837,579,0,1068,53,7837,702,19079
"12086020000",5964,609,199,129,214,47,5070,584,12816
"12086020100",3988,380,290,12,315,8,3745,378,9116
"12086020200",2597,285,416,1,261,16,2718,301,6595
"12086020300",3005,240,527,119,82,0,2714,223,6910
"12086490100",1178,603,63,25,23,14,1216,642,3764
"12086980100",0,0,0,0,0,0,0,0,0
"12086980200",0,0,0,0,0,0,0,0,0
"12086980300",4,26,0,0,8,0,8,0,46
"12086980400",0,0,0,0,0,0,0,0,0
"12086980500",0,0,0,0,0,0,0,0,0
"12086980600",0,0,0,0,0,0,0,0,0
"12086980700",58,450,31,362,7,50,7,322,1287
"12086980800",0,0,0,0,0,0,0,0,0
"12086980900",0,0,0,0,0,0,0,0,0
"12086981000",0,0,0,0,0,0,0,0,0
"12086990000",0,0,0,0,0,0,0,0,0
"12087970200",1035,162,7,44,7,15,92,25,1387
"12087970300",1826,433,16,1,165,19,524,145,3129
"12087970400",2678,816,265,13,159,9,982,431,5353
"12087970500",2346,130,0,0,130,0,485,48,3139
"12087970600",1461,178,23,5,84,8,175,74,2008
"12087970700",2412,174,9,1,52,0,285,26,2959
"12087970800",3521,505,0,1,41,0,232,58,4358
"12087970900",1383,182,11,6,37,4,196,6,1825
"12087971001",924,98,10,2,3,0,76,4,1117
"12087971002",1113,287,21,22,0,17,224,94,1778
"12087971100",2205,337,102,232,147,156,613,187,3979
"12087971200",1617,355,79,2,0,0,298,159,2510
"12087971300",1173,573,49,152,0,7,634,467,3055
"12087971401",2400,322,35,2,116,9,381,62,3327
"12087971402",1471,121,0,0,66,0,191,59,1908
"12087971501",1490,160,12,0,32,0,139,0,1833
"12087971502",2782,253,0,0,82,0,452,0,3569
"12087971600",1797,85,58,0,109,0,131,0,2180
"12087971700",2252,313,92,149,130,0,575,238,3749
"12087971800",3304,562,650,0,297,262,1920,468,7463
"12087971900",4416,604,689,26,254,8,1637,304,7938
"12087972000",2762,473,221,35,30,32,615,88,4256
"12087972100",3178,417,534,10,143,38,542,72,4934
"12087972200",2640,219,46,30,186,0,395,60,3576
"12087972300",1998,251,20,4,42,113,532,38,2998
"12087972400",1670,343,652,130,23,0,335,64,3217
"12087972500",925,174,6,10,37,35,74,0,1261
"12087972600",642,93,0,3,35,1,129,6,909
"12087980000",5,0,0,0,4,0,0,0,9
"12087980100",0,3,0,4,0,0,0,2,9
"12087990000",0,0,0,0,0,0,0,0,0
"12089050101",4061,485,898,341,81,96,446,109,6517
"12089050102",2284,479,114,139,106,0,177,93,3392
"12089050201",1452,49,0,0,3,0,0,0,1504
"12089050202",5226,546,179,57,360,70,87,132,6657
"12089050203",2888,150,207,0,157,0,158,52,3612
"12089050301",6139,262,684,73,378,34,423,1,7994
"12089050302",5554,832,202,4,183,13,160,4,6952
"12089050303",9326,2325,654,0,77,28,418,0,12828
"12089050400",6692,1070,254,273,131,93,107,0,8620
"12089050502",6575,500,105,0,168,0,155,0,7503
"12089050503",5020,928,572,25,58,18,78,2,6701
"12089050504",3624,399,67,0,116,0,65,0,4271
"12089990000",0,0,0,0,0,0,0,0,0
"12091020100",5549,1046,175,17,299,61,63,64,7274
"12091020200",1343,226,144,63,141,33,109,14,2073
"12091020301",4381,459,152,57,1013,177,421,231,6891
"12091020302",3633,552,182,32,81,17,21,0,4518
"12091020400",4125,1260,479,111,132,31,98,107,6343
"12091020500",4659,1252,584,374,354,169,219,252,7863
"12091020600",5992,676,1834,663,817,0,773,20,10775
"12091020700",6424,1061,932,112,879,343,444,41,10236
"12091020800",3408,351,227,0,336,57,219,13,4611
"12091020900",4853,322,283,32,440,0,139,8,6077
"12091021001",4842,270,103,0,592,0,476,0,6283
"12091021002",4288,281,195,0,139,0,424,0,5327
"12091021101",2300,272,117,0,430,24,16,13,3172
"12091021102",5786,845,214,132,758,262,474,15,8486
"12091021200",3663,593,135,0,599,24,179,9,5202
"12091021400",1165,102,82,12,197,5,261,18,1842
"12091021501",2745,349,340,17,353,93,258,93,4248
"12091021502",2930,430,163,36,357,44,315,17,4292
"12091021600",1719,90,43,0,151,0,64,0,2067
"12091021700",2274,416,90,0,99,0,196,0,3075
"12091021801",3060,230,564,319,868,146,242,91,5520
"12091021802",2938,238,403,106,364,347,323,262,4981
"12091021900",4966,476,1326,659,1173,1116,573,525,10814
"12091022001",1647,978,549,168,758,102,822,490,5514
"12091022002",2725,455,196,62,386,62,330,83,4299
"12091022100",1929,374,183,65,722,7,507,48,3835
"12091022300",1816,173,87,67,285,44,159,10,2641
"12091022400",2863,307,69,37,223,66,301,46,3912
"12091022500",2753,229,264,79,353,242,231,228,4379
"12091022600",1624,409,309,209,327,90,156,0,3124
"12091022700",2453,332,209,18,206,193,247,158,3816
"12091022800",1153,185,437,168,268,87,266,41,2605
"12091022900",3436,207,154,72,201,174,206,35,4485
"12091023100",4961,755,410,15,968,0,523,94,7726
"12091023200",1599,83,7,14,43,84,222,75,2127
"12091023303",1351,209,5,0,6,0,51,0,1622
"12091023304",3305,106,0,0,339,0,212,37,3999
"12091023305",3005,182,8,0,231,22,190,31,3669
"12091023306",2049,145,159,105,236,34,171,139,3038
"12091023307",1387,148,31,9,225,0,80,0,1880
"12091023308",2583,158,0,0,359,0,80,0,3180
"12091990100",0,0,0,0,0,0,0,0,0
"12091990200",0,0,0,0,0,0,0,0,0
"12093910101",3008,714,140,44,41,37,316,120,4420
"12093910102",1958,306,0,441,154,50,641,51,3601
"12093910201",2502,712,78,529,145,102,1006,332,5406
"12093910202",2070,1598,189,89,143,331,1337,1416,7173
"12093910300",853,339,370,236,0,49,250,246,2343
"12093910401",2317,532,0,1,139,1,246,2,3238
"12093910402",1550,725,0,0,155,429,319,771,3949
"12093910403",2117,836,0,0,11,1,145,308,3418
"12093910500",2613,1231,60,0,225,73,360,659,5221
"12093910601",3623,485,28,0,31,37,175,77,4456
"12093910602",1552,225,0,0,172,8,78,0,2035
"12093990000",0,0,0,0,0,0,0,0,0
"12095010200",3742,452,128,37,446,27,458,82,5372
"12095010300",1739,373,188,33,138,38,214,105,2828
"12095010400",66,15,665,718,26,107,107,124,1828
"12095010500",41,59,458,465,23,52,34,28,1160
"12095010802",2277,365,0,8,83,5,158,38,2934
"12095011000",2173,431,95,21,160,128,401,268,3677
"12095011100",2145,188,31,204,193,155,335,222,3473
"12095011200",2637,90,80,103,201,130,360,7,3608
"12095011300",3388,454,335,260,33,134,170,59,4833
"12095011600",978,165,1507,1235,172,197,298,305,4857
"12095011701",30,63,2376,1438,41,153,24,158,4283
"12095011702",26,34,2282,1401,9,0,13,63,3828
"12095012000",613,116,3304,1887,521,514,489,252,7696
"12095012100",618,392,2619,1267,853,256,1146,232,7383
"12095012201",838,150,2347,753,137,15,295,162,4697
"12095012202",742,73,2206,1143,541,167,530,162,5564
"12095012303",920,107,4012,1129,735,260,600,0,7763
"12095012304",475,120,3567,1748,507,142,390,52,7001
"12095012305",722,99,4175,1957,625,83,658,80,8399
"12095012306",596,123,1742,459,503,75,520,99,4117
"12095012307",772,208,3457,2096,280,88,337,23,7261
"12095012401",1313,98,4436,1616,492,127,673,71,8826
"12095012402",830,291,2597,429,943,168,929,343,6530
"12095012403",1156,314,2166,706,423,0,426,48,5239
"12095012500",1688,291,28,28,48,38,168,62,2351
"12095012600",3865,484,184,17,65,38,391,63,5107
"12095012701",3980,409,132,49,381,0,305,0,5256
"12095012800",3301,140,26,1,146,46,120,19,3799
"12095012900",2366,182,21,0,163,48,161,41,2982
"12095013201",2773,728,66,148,184,200,1592,785,6476
"12095013202",3008,842,536,114,804,94,2545,787,8730
"12095013300",4442,719,218,319,645,397,2080,932,9752
"12095013402",2171,386,124,0,574,228,1984,493,5960
"12095013403",2335,601,195,248,75,88,1482,446,5470
"12095013405",969,448,361,48,205,12,741,346,3130
"12095013406",1907,809,192,47,588,5,1263,609,5420
"12095013503",1078,760,277,74,102,195,909,815,4210
"12095013505",2415,1072,237,35,212,136,1638,1040,6785
"12095013507",3623,1192,757,268,699,312,2819,1140,10810
"12095013508",1230,808,242,98,290,52,1076,782,4578
"12095013509",913,166,147,0,96,32,319,98,1771
"12095013510",956,62,445,177,21,149,510,293,2613
"12095013511",2919,1454,94,144,435,121,1849,1220,8236
"12095013512",2339,922,638,245,527,542,2236,1404,8853
"12095013603",3375,923,264,0,424,53,1732,710,7481
"12095013604",4244,582,621,220,434,127,1679,494,8401
"12095013605",2652,517,166,0,396,54,1173,329,5287
"12095013606",1886,954,253,87,375,302,1076,1052,5985
"12095013607",4420,718,319,10,368,41,1306,567,7749
"12095013701",3397,1090,312,46,291,62,1407,1008,7613
"12095013702",2873,707,596,133,531,47,1143,326,6356
"12095013801",2002,361,76,6,74,11,177,44,2751
"12095013802",2383,363,0,1,60,1,340,170,3318
"12095013803",2185,111,167,0,73,31,362,89,3018
"12095013900",3131,484,67,32,151,68,458,174,4565
"12095014000",5952,309,4,27,271,20,366,48,6997
"12095014100",4675,225,154,0,737,164,634,58,6647
"12095014200",4300,2077,1022,911,1384,225,2752,2320,14991
"12095014301",2980,454,507,324,571,11,1139,267,6253
"12095014302",1981,973,816,133,745,182,1759,722,7311
"12095014400",2172,301,295,239,173,76,458,102,3816
"12095014502",706,463,1718,1230,168,40,626,394,5345
"12095014503",1083,213,795,539,119,7,485,122,3363
"12095014504",2232,249,843,79,214,68,1273,158,5116
"12095014601",462,141,3652,1763,661,327,810,475,8291
"12095014605",0,52,2997,928,94,216,117,238,4642
"12095014606",2992,423,1310,624,1345,350,2097,354,9495
"12095014607",2317,348,986,164,691,221,1071,281,6079
"12095014608",548,205,2381,931,224,0,280,18,4587
"12095014609",1727,260,2611,674,449,174,944,305,7144
"12095014701",1498,525,1594,372,881,332,620,619,6441
"12095014702",2591,158,1423,196,539,125,861,150,6043
"12095014703",961,104,545,90,371,72,528,88,2759
"12095014704",5399,800,2031,405,2244,601,1934,221,13635
"12095014804",2625,783,1267,315,918,284,607,488,7287
"12095014805",1682,235,1610,319,1464,268,1086,259,6923
"12095014806",3415,92,315,23,1062,123,543,72,5645
"12095014807",3167,393,1406,138,1375,106,1019,167,7771
"12095014808",9207,181,815,24,1344,270,1109,240,13190
"12095014809",2203,68,118,0,355,41,107,0,2892
"12095014810",4131,378,593,45,530,61,441,81,6260
"12095014811",4220,366,336,0,598,33,591,90,6234
"12095014812",3512,443,740,29,728,116,810,128,6506
"12095014813",1964,475,218,65,780,364,553,488,4907
"12095014904",825,232,2926,927,426,231,492,232,6291
"12095014906",3425,323,1454,267,684,57,898,90,7198
"12095014908",835,85,3295,526,476,242,462,271,6192
"12095014909",1000,49,1245,438,240,81,338,20,3411
"12095015001",904,98,303,32,65,217,361,232,2212
"12095015002",3152,766,219,225,1118,481,1863,796,8620
"12095015003",3998,287,474,0,613,488,773,579,7212
"12095015004",4248,159,2265,292,1446,32,1225,0,9667
"12095015103",4256,381,540,413,986,84,1141,114,7915
"12095015104",2697,351,926,513,659,22,939,161,6268
"12095015105",1492,532,695,203,432,158,627,131,4270
"12095015106",2323,246,2917,962,985,189,1118,143,8883
"12095015201",3546,690,1332,478,1692,105,1718,309,9870
"12095015202",2804,1158,735,1341,535,189,893,762,8417
"12095015300",2421,333,102,25,105,39,185,15,3225
"12095015402",1344,229,0,0,152,79,188,39,2031
"12095015501",3821,315,508,190,270,60,380,102,5646
"12095015601",1958,37,0,0,75,0,89,0,2159
"12095015602",2366,110,31,0,34,0,149,5,2695
"12095015701",1773,67,35,0,61,0,97,0,2033
"12095015702",1528,63,28,0,87,0,134,8,1848
"12095015801",1396,186,41,4,93,0,171,25,1916
"12095015802",2341,53,2,7,163,0,267,6,2839
"12095015901",836,166,568,343,9,35,149,51,2157
"12095015902",1109,108,8,22,118,71,64,29,1529
"12095016001",830,94,0,4,11,25,15,29,1008
"12095016002",2096,83,0,0,170,10,223,25,2607
"12095016100",3409,376,155,0,431,32,190,131,4724
"12095016200",4600,714,316,249,254,13,477,119,6742
"12095016301",4142,789,376,73,543,124,740,138,6925
"12095016302",1886,880,334,197,502,112,927,435,5273
"12095016402",1677,452,256,133,300,133,958,495,4404
"12095016406",919,416,48,16,443,116,517,195,2670
"12095016407",2050,1238,383,578,567,169,1197,432,6614
"12095016408",1652,278,94,61,197,51,476,78,2887
"12095016409",2762,148,156,115,229,11,336,11,3768
"12095016410",4636,1274,840,181,1091,53,2619,534,11228
"12095016411",1908,637,290,27,207,80,610,393,4152
"12095016412",3479,612,447,5,510,34,1225,256,6568
"12095016503",2501,498,287,100,398,152,932,52,4920
"12095016504",2755,696,167,118,691,256,925,527,6135
"12095016505",1615,624,119,47,248,56,436,200,3345
"12095016507",4893,871,545,61,572,200,1879,181,9202
"12095016508",3083,1777,868,138,655,607,1903,1418,10449
"12095016509",3231,575,93,22,332,13,733,68,5067
"12095016510",745,600,56,144,267,337,389,74,2612
"12095016511",1496,968,90,67,175,40,690,467,3993
"12095016601",7301,1205,384,361,1538,122,2246,333,13490
"12095016602",6178,830,1032,331,1041,298,2017,118,11845
"12095016704",12671,618,1274,20,2184,132,5604,417,22920
"12095016709",4697,700,519,57,315,419,3740,839,11286
"12095016710",2892,606,383,28,831,293,1910,586,7529
"12095016712",4652,2247,491,313,1027,778,2855,2153,14516
"12095016713",4536,1160,657,198,845,269,3161,1317,12143
"12095016714",2494,331,99,79,121,125,1576,448,5273
"12095016715",3492,945,452,281,545,24,2460,635,8834
"12095016716",4941,209,320,23,249,39,1675,97,7553
"12095016717",2012,141,275,0,731,55,1356,88,4658
"12095016723",4007,592,364,12,464,109,2139,525,8212
"12095016724",3580,1541,473,8,533,37,1915,1185,9272
"12095016727",7117,1992,312,281,1691,256,3470,1190,16309
"12095016728",3847,447,294,23,421,24,694,99,5849
"12095016729",9555,1865,1615,85,2081,1937,5584,1823,24545
"12095016730",22763,750,1700,892,3551,295,9789,864,40604
"12095016731",2327,155,448,13,423,24,826,51,4267
"12095016732",9935,622,2091,163,2594,638,5138,564,21745
"12095016733",4146,856,598,75,753,39,2775,824,10066
"12095016734",6918,1685,1055,124,3092,17,4817,1459,19167
"12095016802",4675,204,388,22,1147,41,2491,113,9081
"12095016803",1575,240,318,57,326,134,933,294,3877
"12095016804",2630,514,413,54,592,207,1942,164,6516
"12095016806",6630,1405,1129,363,2314,357,6192,1444,19834
"12095016807",10846,2335,1671,317,3011,401,10332,2329,31242
"12095016902",1962,1058,969,248,814,94,1908,785,7838
"12095016903",5784,1265,3586,2042,1420,781,3624,1381,19883
"12095016904",1508,173,1310,455,612,88,1217,233,5596
"12095016906",776,573,1397,545,96,90,654,480,4611
"12095016907",1467,1324,1949,627,371,342,1078,1382,8540
"12095017001",618,169,1481,515,96,0,288,108,3275
"12095017004",3170,548,186,0,637,106,512,166,5325
"12095017006",2452,101,178,278,1061,0,1200,238,5508
"12095017008",4833,812,894,22,2096,273,4039,677,13646
"12095017011",2963,423,956,59,806,64,1926,354,7551
"12095017012",1804,65,432,108,719,208,786,13,4135
"12095017013",5005,1101,599,61,899,195,3078,529,11467
"12095017014",7616,879,892,101,2071,388,4070,621,16638
"12095017015",5211,416,398,54,751,0,2338,291,9459
"12095017016",7395,1019,147,12,1240,299,2310,609,13031
"12095017017",3832,904,118,323,585,196,1073,401,7432
"12095017103",9853,657,1012,98,1932,1048,2010,493,17103
"12095017104",16685,854,3781,45,3196,162,3670,126,28519
"12095017105",10548,410,455,0,2522,36,1904,143,16018
"12095017107",4557,453,267,0,2198,13,1116,66,8670
"12095017108",5041,645,381,212,1017,162,671,32,8161
"12095017109",4508,631,351,0,1167,0,392,0,7049
"12095017200",2043,283,489,110,219,50,340,62,3596
"12095017300",5278,591,1821,298,1169,1182,1773,1690,13802
"12095017400",5555,374,2451,345,1686,342,2029,417,13199
"12095017501",4458,764,1952,941,1365,0,1339,232,11051
"12095017503",2775,1081,357,504,832,637,1598,1319,9103
"12095017504",4841,594,1883,283,1150,261,2782,463,12257
"12095017600",907,310,1679,990,319,258,602,391,5456
"12095017701",2732,672,1000,195,800,336,1021,790,7546
"12095017702",1764,76,96,0,131,7,272,0,2346
"12095017703",2180,899,375,271,410,176,1063,585,5959
"12095017802",9454,570,2215,704,1549,273,2472,379,17616
"12095017804",5980,623,865,0,707,732,721,831,10459
"12095017805",1825,344,136,238,404,195,519,410,4071
"12095017806",3762,237,301,0,282,140,257,321,5300
"12095017807",2200,477,382,144,533,277,1250,412,5675
"12095017808",3105,237,310,2,236,0,621,0,4511
"12095017901",1888,251,184,66,292,71,535,130,3417
"12095017902",4117,961,417,45,522,83,563,542,7250
"12095018000",825,388,1099,300,228,110,212,127,3289
"12095018100",1663,166,474,130,257,206,301,43,3240
"12095018200",7287,911,502,468,804,89,1504,238,11803
"12095018300",561,273,1267,414,200,80,302,155,3252
"12095018400",1726,312,28,8,105,251,701,86,3217
"12095018500",936,168,1193,1005,273,32,214,28,3849
"12095018700",871,179,1945,1699,365,24,475,53,5611
"12095018800",2440,167,100,128,233,59,330,41,3498
"12095018900",3306,592,1153,1497,393,93,530,253,7817
"12095990000",0,0,0,0,0,0,0,0,0
"12097040801",733,83,20,9,109,47,43,44,1088
"12097040802",4687,713,594,137,926,113,1664,436,9270
"12097040803",6865,218,113,136,340,27,464,42,8205
"12097040804",4593,688,56,65,321,64,2314,279,8380
"12097040901",2413,505,295,50,648,65,1538,154,5668
"12097040902",3404,1563,342,15,617,321,2212,1436,9910
"12097041001",6393,878,898,0,1942,45,4991,472,15619
"12097041002",6032,1393,824,204,868,84,4546,1022,14973
"12097041100",8543,2017,4324,1085,1995,645,7090,2049,27748
"12097041300",6463,2542,3418,547,1287,309,5523,2560,22649
"12097041500",7685,863,1399,84,1760,121,5146,606,17664
"12097041600",1345,888,395,365,213,135,745,549,4635
"12097041700",3220,1210,477,71,668,106,2353,951,9056
"12097041800",1379,971,67,329,279,123,785,612,4545
"12097041900",4203,852,490,230,653,161,3856,831,11276
"12097042000",3951,1680,458,157,620,684,3298,2039,12887
"12097042100",5630,868,602,426,1135,560,4133,1566,14920
"12097042200",5384,1394,490,222,486,534,3516,1613,13639
"12097042300",2997,827,939,309,859,339,2238,894,9402
"12097042400",5196,1016,614,254,751,218,3006,1227,12282
"12097042500",5444,459,861,155,1091,82,4948,567,13607
"12097042601",2362,221,268,178,283,69,2339,278,5998
"12097042602",6407,1591,1484,83,1289,699,5932,1998,19483
"12097042701",4071,1043,1067,353,1270,868,4746,1958,15376
"12097042702",4566,910,447,187,672,403,4001,1241,12427
"12097042800",6608,1715,292,147,1369,18,4535,1491,16175
"12097042900",9467,2422,875,365,2004,253,6698,2240,24324
"12097043100",3050,141,169,0,342,23,511,23,4259
"12097043201",92,0,0,0,5,27,18,22,164
"12097043202",439,0,0,0,13,0,17,0,469
"12097043203",3465,375,129,137,315,275,1340,225,6261
"12097043204",10317,1527,1623,78,403,669,4288,851,19756
"12097043205",1504,128,0,0,99,14,131,18,1894
"12097043206",210,10,0,0,0,0,5,6,231
"12097043301",968,125,0,0,11,0,76,0,1180
"12097043302",9985,801,750,232,650,168,2942,484,16012
"12097043400",3949,703,49,29,97,232,772,413,6244
"12097043500",3209,1130,167,53,367,37,621,113,5697
"12097043600",4325,588,30,39,383,34,719,209,6327
"12097043700",4159,668,45,0,420,52,774,125,6243
"12097043800",5552,1287,58,27,226,111,850,293,8404
"12099000101",6803,277,0,0,330,0,548,15,7973
"12099000102",2326,191,92,0,54,9,128,27,2827
"12099000202",5840,727,0,0,259,0,1268,393,8487
"12099000204",3446,383,59,0,168,206,399,274,4935
"12099000205",4430,539,37,101,110,0,1290,202,6709
"12099000206",5905,500,119,0,435,63,820,90,7932
"12099000208",4230,138,27,0,88,9,655,0,5147
"12099000209",5336,421,172,0,846,0,938,0,7713
"12099000210",3321,355,823,15,146,29,573,115,5377
"12099000211",3809,148,0,0,0,0,396,0,4353
"12099000213",2082,380,486,23,120,35,267,297,3690
"12099000214",6039,167,58,0,467,255,565,15,7566
"12099000215",6775,370,23,0,578,12,601,19,8378
"12099000301",3211,427,0,0,245,0,71,47,4001
"12099000303",4729,57,0,0,236,0,130,0,5152
"12099000304",4332,349,394,0,240,192,739,95,6341
"12099000405",2836,88,0,0,55,0,108,0,3087
"12099000406",2686,113,0,23,101,27,65,0,3015
"12099000407",1492,164,0,0,0,0,32,0,1688
"12099000408",3198,258,0,22,49,0,54,12,3593
"12099000410",3323,131,17,6,34,1,157,1,3670
"12099000505",2445,85,0,0,63,2,86,2,2683
"12099000507",715,19,0,0,0,0,0,0,734
"12099000509",1282,83,0,0,52,0,22,12,1451
"12099000511",2286,104,8,9,58,7,99,0,2571
"12099000600",1159,179,16,10,15,0,66,0,1445
"12099000702",2622,189,0,5,34,19,123,19,3011
"12099000703",3140,104,33,0,77,34,173,0,3561
"12099000802",1978,495,67,10,231,23,321,54,3179
"12099000803",2657,247,0,3,102,33,328,13,3383
"12099000804",2486,102,155,24,181,21,207,0,3176
"12099000902",1816,98,379,63,248,36,197,0,2837
"12099000903",3441,647,748,165,251,16,472,128,5868
"12099000904",2672,198,551,3,206,130,425,108,4293
"12099000905",3185,222,111,16,766,29,365,58,4752
"12099001002",974,364,3603,1445,263,0,570,134,7353
"12099001003",3588,114,181,130,522,0,779,18,5332
"12099001004",2692,693,718,250,142,266,632,461,5854
"12099001101",1790,110,2038,1415,417,17,84,3,5874
"12099001102",2171,276,72,14,83,0,144,45,2805
"12099001200",964,192,1819,882,338,38,376,112,4721
"12099001301",827,272,3131,1117,343,152,341,289,6472
"12099001302",88,2,2764,1293,80,0,0,0,4227
"12099001402",253,118,1206,681,8,21,33,104,2424
"12099001403",0,0,1662,1596,0,8,0,0,3266
"12099001404",52,48,1897,1203,95,119,22,17,3453
"12099001500",388,80,1717,526,51,4,78,29,2873
"12099001600",1161,455,867,469,70,29,293,302,3646
"12099001700",1924,269,971,566,570,215,934,237,5686
"12099001801",582,343,2404,1065,160,310,252,604,5720
"12099001802",2375,75,1021,228,287,18,847,34,4885
"12099001904",1226,264,1398,130,89,26,299,16,3448
"12099001907",1465,135,652,6,54,0,92,42,2446
"12099001908",3233,347,2630,352,379,14,1742,207,8904
"12099001909",1055,454,320,252,130,96,612,384,3303
"12099001910",1314,208,69,53,53,8,298,62,2065
"12099001911",597,237,0,0,62,0,60,22,978
"12099001912",1295,287,145,18,257,14,226,102,2344
"12099001913",1333,206,58,25,23,0,54,8,1707
"12099001914",1668,182,440,0,239,24,402,15,2970
"12099001915",3473,360,2125,74,498,33,1745,166,8474
"12099001916",1637,198,831,64,285,118,500,27,3660
"12099001917",1665,144,1362,402,347,63,604,104,4691
"12099002005",844,230,2222,277,0,89,258,60,3980
"12099002006",1340,543,984,600,167,37,561,304,4536
"12099002100",101,84,2299,826,111,191,69,59,3740
"12099002200",8,36,768,765,109,28,93,34,1841
"12099002300",809,511,386,240,130,17,419,92,2604
"12099002400",109,117,916,530,21,0,23,26,1742
"12099002600",918,175,19,27,37,6,142,93,1417
"12099002700",3073,707,470,93,213,158,159,222,5095
"12099002800",2436,622,574,43,224,31,536,493,4959
"12099002900",1446,1098,1104,832,581,272,1603,1199,8135
"12099003000",3022,812,913,557,403,316,2093,970,9086
"12099003101",3197,1086,1132,714,349,172,1763,826,9239
"12099003102",1739,766,2176,1890,352,171,861,520,8475
"12099003201",2557,523,817,154,119,102,1323,390,5985
"12099003202",2316,524,1472,405,317,133,1235,487,6889
"12099003300",2983,1025,281,213,163,62,2286,950,7963
"12099003400",2823,604,107,1,261,7,1097,270,5170
"12099003504",952,37,0,0,1,12,17,0,1019
"12099003507",1788,121,0,0,24,0,83,0,2016
"12099003509",2772,54,1,0,13,0,113,0,2953
"12099003511",1398,89,45,0,46,0,25,0,1603
"12099003600",4799,942,143,19,188,239,1664,760,8754
"12099003700",3403,1539,58,39,283,233,2360,1609,9524
"12099003800",4531,1198,425,149,389,82,3176,809,10759
"12099003901",2924,459,461,199,194,121,1157,262,5777
"12099003902",3599,1066,1081,634,282,13,2163,772,9610
"12099004005",2034,341,398,24,411,0,1179,217,4604
"12099004007",2791,1239,299,89,279,27,2225,913,7862
"12099004008",2713,604,1306,858,680,57,2428,343,8989
"12099004009",2171,1321,238,79,419,207,2053,1068,7556
"12099004010",1910,598,269,24,154,5,868,426,4254
"12099004011",3908,920,597,63,374,40,2625,816,9343
"12099004012",2755,519,173,18,176,0,920,287,4848
"12099004013",2291,819,52,0,24,7,786,316,4295
"12099004101",3036,996,518,123,149,34,1869,825,7550
"12099004102",2278,401,430,0,173,73,1787,362,5504
"12099004201",5583,1205,598,387,379,166,4098,931,13347
"12099004202",2861,804,637,9,209,48,1440,564,6572
"12099004203",2045,432,128,102,46,0,778,274,3805
"12099004300",4891,643,240,0,215,1,1408,206,7604
"12099004401",2023,488,678,119,143,0,938,329,4718
"12099004402",1953,1403,464,435,207,13,1441,1109,7025
"12099004500",2440,1088,947,658,158,154,1699,809,7953
"12099004601",2675,522,257,65,427,179,1668,472,6265
"12099004602",2155,1266,325,102,363,119,1608,1165,7103
"12099004702",3520,996,659,212,425,172,2205,949,9138
"12099004704",3818,1892,355,474,247,78,2788,1452,11104
"12099004705",2772,994,779,147,395,173,2134,976,8370
"12099004706",1484,403,320,16,243,0,388,355,3209
"12099004809",1106,157,76,0,28,28,127,36,1558
"12099004810",4278,259,12,0,223,9,717,127,5625
"12099004811",3013,79,164,135,215,2,643,35,4286
"12099004812",2866,281,3831,583,289,230,1807,387,10274
"12099004813",2942,233,1557,322,333,223,1475,139,7224
"12099004815",4022,316,846,387,526,528,1360,438,8423
"12099004816",2794,421,98,5,71,10,341,100,3840
"12099004817",3304,706,40,13,104,16,991,512,5686
"12099004818",1539,295,243,10,284,0,332,56,2759
"12099004819",2423,494,658,181,286,184,1618,479,6323
"12099004902",1873,85,62,0,16,0,125,6,2167
"12099004903",1576,1238,987,507,228,56,1543,1173,7308
"12099004904",3421,1525,649,371,384,34,2415,1254,10053
"12099005000",3867,681,226,57,562,38,2164,297,7892
"12099005101",1402,1107,159,106,144,136,1372,1052,5478
"12099005102",1693,1108,1667,1310,492,126,1769,1045,9210
"12099005202",1779,746,348,194,415,60,1228,535,5305
"12099005203",1325,362,73,68,62,12,323,209,2434
"12099005204",2415,352,200,397,110,42,890,235,4641
"12099005300",3564,536,177,17,104,35,348,55,4836
"12099005405",915,32,16,0,8,8,6,21,1006
"12099005407",1409,126,12,0,60,3,26,7,1643
"12099005409",720,3,0,0,32,0,36,0,791
"12099005411",3264,262,70,19,21,20,151,15,3822
"12099005501",1700,606,651,314,253,71,422,313,4330
"12099005502",3468,676,965,664,269,238,836,400,7516
"12099005601",1840,143,2267,380,212,30,1288,40,6200
"12099005602",2247,200,299,39,43,0,514,16,3358
"12099005701",1245,169,1499,1198,250,11,333,91,4796
"12099005702",1188,572,2566,1537,348,80,279,167,6737
"12099005807",2644,549,424,160,359,23,680,105,4944
"12099005808",3221,307,815,51,502,101,343,31,5371
"12099005810",1478,307,10,0,21,0,79,100,1995
"12099005811",2491,214,443,20,313,0,426,11,3918
"12099005812",2556,518,317,12,131,139,612,256,4541
"12099005813",3610,433,533,229,310,23,882,130,6150
"12099005814",2976,1222,608,218,354,40,2419,976,8813
"12099005815",2391,220,1188,376,492,11,607,20,5305
"12099005816",3770,414,1083,0,604,0,1421,99,7391
"12099005817",2930,93,1869,466,753,122,906,72,7211
"12099005903",6735,246,540,0,1045,25,1522,125,10238
"12099005915",3403,541,783,5,519,24,605,153,6033
"12099005916",4288,265,1472,262,1119,26,1758,111,9301
"12099005917",3305,149,543,0,462,0,1002,80,5541
"12099005918",1951,363,296,61,183,0,598,101,3553
"12099005921",6834,233,535,46,520,11,654,0,8833
"12099005922",4567,322,457,0,241,0,357,13,5957
"12099005923",2887,267,166,32,71,0,145,149,3717
"12099005926",3510,287,352,271,20,250,90,0,4780
"12099005930",2439,270,443,24,92,83,338,70,3759
"12099005931",2535,343,34,18,13,0,38,33,3014
"12099005933",2687,187,0,0,32,0,69,12,2987
"12099005934",1993,138,58,159,20,16,51,0,2435
"12099005935",1663,265,9,0,51,0,41,88,2117
"12099005936",2333,133,361,307,67,68,248,19,3536
"12099005937",1450,157,0,0,67,0,0,5,1679
"12099005938",3389,126,49,0,222,0,501,0,4287
"12099005939",923,215,31,0,15,9,98,0,1291
"12099005940",1111,350,91,13,19,8,100,79,1771
"12099005942",1954,103,0,0,122,0,28,11,2218
"12099005943",1510,197,152,38,26,40,77,36,2076
"12099005944",1740,163,0,0,16,0,71,0,1990
"12099005945",4477,172,181,17,7,0,98,0,4952
"12099005946",6396,435,815,53,607,146,729,57,9238
"12099005947",4122,131,0,0,32,0,16,0,4301
"12099005949",2947,242,77,42,13,0,174,97,3592
"12099005950",2674,205,690,42,522,161,461,151,4906
"12099005951",2413,518,1237,647,190,67,589,125,5786
"12099005952",1347,21,6,0,0,0,0,0,1374
"12099005953",4015,185,204,269,69,0,323,4,5069
"12099005954",3147,344,132,0,0,0,20,0,3643
"12099005955",4116,187,76,0,40,0,238,0,4657
"12099005956",652,53,25,0,3,0,13,0,746
"12099006005",2831,143,316,57,171,14,394,29,3955
"12099006006",1997,307,127,0,0,0,72,0,2503
"12099006007",1376,219,1325,643,59,38,83,155,3898
"12099006008",2004,125,161,68,6,0,91,11,2466
"12099006009",1670,127,0,0,5,0,115,26,1943
"12099006010",2065,377,792,51,150,34,789,106,4364
"12099006011",2333,127,187,62,136,20,387,9,3261
"12099006012",3207,194,732,63,162,0,815,63,5236
"12099006100",980,351,1772,1065,76,128,108,282,4762
"12099006201",1726,289,1380,1059,197,21,477,17,5166
"12099006202",1568,390,104,117,100,31,399,33,2742
"12099006203",1180,193,568,69,158,0,36,0,2204
"12099006300",4026,445,509,459,299,0,623,85,6446
"12099006401",1578,122,37,0,54,0,76,0,1867
"12099006402",3147,434,57,0,38,11,30,140,3857
"12099006501",863,111,467,156,162,71,291,99,2220
"12099006502",1440,451,986,430,109,67,136,75,3694
"12099006602",3010,154,0,0,142,18,200,0,3524
"12099006603",4081,237,100,0,9,0,190,0,4617
"12099006604",2377,230,1700,519,262,31,379,0,5498
"12099006605",2841,143,857,375,307,59,342,59,4983
"12099006700",200,27,1257,662,57,17,15,44,2279
"12099006801",949,188,2461,1246,400,292,844,369,6749
"12099006802",202,221,1462,1487,85,64,211,107,3839
"12099006906",3554,514,343,52,76,80,321,101,5041
"12099006907",2306,235,361,41,82,9,272,0,3306
"12099006908",3071,303,509,327,404,93,910,195,5812
"12099006909",2112,303,88,227,85,13,205,0,3033
"12099006910",1306,87,211,76,180,0,321,20,2201
"12099006911",1743,252,69,119,1137,0,990,79,4389
"12099006912",3012,231,123,26,276,66,164,0,3898
"12099007002",3400,172,44,22,146,0,333,28,4145
"12099007005",3251,307,35,20,126,0,225,62,4026
"12099007006",3120,305,78,0,325,184,217,197,4426
"12099007007",3250,197,0,0,284,20,231,21,4003
"12099007008",3674,61,20,14,362,0,516,0,4647
"12099007009",2840,88,147,4,244,2,347,15,3687
"12099007010",1725,144,0,0,0,0,359,0,2228
"12099007011",2537,231,0,0,84,0,150,0,3002
"12099007100",10,107,0,60,0,20,0,40,237
"12099007201",4885,391,15,42,285,33,812,186,6649
"12099007202",3127,379,51,0,374,69,408,105,4513
"12099007203",3868,1155,496,146,357,152,842,350,7366
"12099007301",3076,228,308,59,259,30,446,47,4453
"12099007302",3830,358,79,41,323,79,618,50,5378
"12099007407",1347,54,67,0,18,0,0,0,1486
"12099007410",1377,69,0,8,53,0,94,0,1601
"12099007412",1106,62,0,0,35,0,64,4,1271
"12099007414",1768,287,21,0,52,0,93,10,2231
"12099007416",2514,222,74,0,28,0,134,10,2982
"12099007418",889,43,0,0,33,0,33,0,998
"12099007420",2352,253,0,0,120,13,44,0,2782
"12099007501",2384,144,440,123,135,16,323,62,3627
"12099007504",2685,202,76,48,29,28,131,121,3320
"12099007505",1913,165,126,54,62,0,119,36,2475
"12099007602",2257,543,449,233,817,78,1032,88,5497
"12099007603",2073,19,0,11,271,0,280,0,2654
"12099007604",6284,444,129,5,165,234,471,131,7863
"12099007605",3326,413,75,64,282,0,306,16,4482
"12099007607",4224,551,243,0,204,66,510,93,5891
"12099007610",4193,134,57,105,209,17,713,35,5463
"12099007612",4073,572,297,189,536,64,998,189,6918
"12099007613",2876,502,86,75,268,10,728,276,4821
"12099007614",3240,326,0,4,401,2,406,115,4494
"12099007615",2905,565,309,83,589,31,655,321,5458
"12099007616",2702,180,0,8,14,7,202,45,3158
"12099007617",1362,85,0,0,26,0,15,0,1488
"12099007618",4267,271,151,0,41,0,407,11,5148
"12099007705",3682,157,292,22,143,103,643,30,5072
"12099007710",3329,293,465,81,425,36,390,100,5119
"12099007713",11173,269,943,17,1065,7,2071,10,15555
"12099007716",3810,496,196,39,450,0,833,100,5924
"12099007721",3948,125,269,0,250,31,617,0,5240
"12099007723",2011,120,90,11,105,10,278,21,2646
"12099007724",4478,256,816,9,555,20,1035,72,7241
"12099007725",4504,302,490,8,376,27,777,161,6645
"12099007730",5290,181,6,0,751,24,984,0,7236
"12099007731",3427,313,437,0,683,13,633,13,5519
"12099007732",3408,965,482,31,301,267,992,239,6685
"12099007733",2219,117,260,0,225,56,396,130,3403
"12099007734",2143,35,11,0,82,0,264,7,2542
"12099007735",5139,177,152,0,306,6,752,11,6543
"12099007736",3023,159,597,0,61,39,638,38,4555
"12099007738",2992,369,314,11,476,105,852,257,5376
"12099007739",2237,291,136,12,405,27,628,75,3811
"12099007740",4179,448,179,3,200,111,861,168,6149
"12099007741",3659,509,42,0,178,25,432,86,4931
"12099007742",4147,373,7,0,505,280,452,153,5917
"12099007743",4239,445,77,0,586,71,700,91,6209
"12099007744",2334,388,30,0,226,8,361,24,3371
"12099007746",748,139,37,0,0,63,15,69,1071
"12099007747",2280,257,0,0,0,0,70,15,2622
"12099007748",3750,439,110,0,451,0,520,0,5270
"12099007749",4096,235,259,0,367,32,488,32,5509
"12099007750",2882,192,876,0,270,0,1938,56,6214
"12099007751",3031,59,10,35,124,0,703,0,3962
"12099007752",5144,347,881,143,380,154,890,136,8075
"12099007753",5853,631,860,167,335,1,1385,1,9233
"12099007754",3554,189,268,20,173,86,257,0,4547
"12099007756",4295,203,67,0,324,1,357,53,5300
"12099007757",3242,209,351,0,238,0,344,9,4393
"12099007758",3806,605,515,276,202,101,1180,264,6949
"12099007759",1256,51,78,0,165,0,207,0,1757
"12099007760",2258,203,534,0,705,0,680,0,4380
"12099007762",1411,75,54,0,234,0,244,0,2018
"12099007763",4344,306,1393,455,529,23,1186,30,8266
"12099007764",1681,26,77,0,33,0,282,13,2112
"12099007765",5649,165,1306,171,840,84,1315,20,9550
"12099007766",2397,471,249,122,188,69,307,295,4098
"12099007767",2513,160,376,15,498,17,833,13,4425
"12099007805",4607,264,155,0,171,0,569,27,5793
"12099007808",3774,679,697,69,384,0,878,247,6728
"12099007809",2777,162,128,2,257,4,205,40,3575
"12099007812",3558,623,1125,397,266,19,1099,137,7224
"12099007813",3836,536,1363,196,742,87,1541,336,8637
"12099007814",1935,108,0,0,25,0,33,14,2115
"12099007817",5450,251,1588,63,304,135,1434,95,9320
"12099007818",868,103,35,24,92,0,43,7,1172
"12099007820",2285,353,129,23,31,0,490,31,3342
"12099007821",2252,105,259,0,70,3,105,18,2812
"12099007822",5602,379,145,0,60,0,261,211,6658
"12099007823",3557,172,122,0,161,0,528,0,4540
"12099007828",1240,40,197,0,51,0,272,7,1807
"12099007830",2956,75,191,15,127,0,307,18,3689
"12099007831",2426,181,251,0,558,25,310,12,3763
"12099007832",1692,272,392,176,56,6,440,173,3207
"12099007833",1133,376,1513,973,230,72,479,323,5099
"12099007834",1370,147,6,15,8,6,22,6,1580
"12099007835",3135,173,168,0,366,0,283,0,4125
"12099007836",4537,468,1359,0,600,0,1241,46,8251
"12099007837",4170,145,884,35,423,0,691,66,6414
"12099007838",5911,283,1496,169,669,36,1551,0,10115
"12099007839",4928,154,527,120,445,7,1165,57,7403
"12099007908",6045,599,1657,0,216,16,933,428,9894
"12099007909",3407,434,90,0,208,21,89,14,4263
"12099007910",4913,358,974,156,564,0,1508,1,8474
"12099007912",6417,622,1225,315,258,0,1057,165,10059
"12099008001",980,254,861,782,179,54,870,254,4234
"12099008002",1045,189,1732,1642,85,61,875,217,5846
"12099008101",3593,1025,1133,324,252,53,2755,914,10049
"12099008102",0,15,0,28,0,0,0,15,58
"12099008201",296,171,1663,1420,20,17,228,140,3955
"12099008202",0,8,1275,1535,0,0,0,8,2826
"12099008203",1495,575,1945,847,252,87,1244,548,6993
"12099008301",427,80,630,504,61,0,488,93,2283
"12099008302",819,230,1127,571,117,19,683,255,3821
"12099980000",0,0,0,0,0,0,0,0,0
"12099980100",0,0,0,0,0,0,0,0,0
"12099980200",0,0,0,0,0,0,0,0,0
"12099980400",0,0,0,0,0,0,0,0,0
"12099980500",0,0,0,0,0,0,0,0,0
"12099990000",0,0,0,0,0,0,0,0,0
"12099990100",0,0,0,0,0,0,0,0,0
"12101030101",1774,390,37,33,28,35,138,159,2594
"12101030102",1902,596,50,38,57,36,145,122,2946
"12101030202",2046,531,24,27,78,71,163,119,3059
"12101030203",1112,429,42,0,0,53,74,16,1726
"12101030204",798,241,0,0,44,35,20,8,1146
"12101030205",1852,276,0,0,66,23,88,25,2330
"12101030301",1513,469,10,0,80,16,217,234,2539
"12101030302",1847,297,68,0,86,0,206,51,2555
"12101030303",2430,182,46,0,412,0,48,0,3118
"12101030404",2439,386,20,10,66,13,213,0,3147
"12101030405",1513,349,0,49,110,0,59,14,2094
"12101030406",1541,400,0,7,75,0,147,42,2212
"12101030407",1983,469,0,75,14,27,256,119,2943
"12101030408",1787,403,0,0,180,0,107,51,2528
"12101030409",2210,289,188,0,138,50,461,38,3374
"12101030410",1262,452,24,0,125,11,29,27,1930
"12101030411",2032,349,178,0,247,23,302,40,3171
"12101030412",1502,451,156,117,0,68,446,189,2929
"12101030501",1023,400,0,1,37,52,54,78,1645
"12101030502",3257,797,58,115,189,12,310,3,4741
"12101030601",1595,344,8,0,203,0,77,0,2227
"12101030602",1577,618,237,52,210,48,324,201,3267
"12101030700",2704,957,205,8,95,206,383,230,4788
"12101030800",2299,471,129,16,109,29,310,66,3429
"12101030901",2851,713,43,0,86,20,315,162,4190
"12101030903",1564,527,10,0,176,0,177,79,2533
"12101030904",1546,586,0,33,241,37,267,39,2749
"12101030905",2304,419,64,0,65,0,166,121,3139
"12101031003",4257,1017,147,40,200,129,578,255,6623
"12101031005",2423,762,56,69,231,17,485,34,4077
"12101031006",1060,602,31,135,75,24,211,205,2343
"12101031007",3161,785,48,7,157,112,509,83,4862
"12101031008",1608,524,0,0,50,0,52,124,2358
"12101031009",2120,681,57,4,85,2,288,29,3266
"12101031010",2889,635,53,0,219,150,408,111,4465
"12101031011",2129,294,0,0,9,7,142,52,2633
"12101031012",3117,764,99,0,133,196,158,149,4616
"12101031013",2182,550,246,172,37,30,281,62,3560
"12101031014",2348,319,229,45,24,216,361,256,3798
"12101031101",3111,575,0,0,62,130,197,150,4225
"12101031102",4149,501,46,0,68,0,287,72,5123
"12101031203",2065,182,35,0,0,33,13,22,2350
"12101031204",2372,176,66,0,56,0,21,0,2691
"12101031205",3306,444,19,0,125,38,118,17,4067
"12101031206",2062,998,0,0,112,43,268,187,3670
"12101031207",1738,499,0,0,20,0,48,16,2321
"12101031208",2510,275,105,17,249,17,295,0,3468
"12101031301",2977,237,26,0,143,7,118,28,3536
"12101031302",5209,375,0,0,348,10,372,59,6373
"12101031401",2127,1101,61,66,143,40,153,529,4220
"12101031404",2725,1131,49,84,84,117,409,164,4763
"12101031405",1337,697,52,78,34,23,183,82,2486
"12101031406",2015,431,0,43,25,192,269,129,3104
"12101031407",2039,350,1,1,87,43,139,43,2703
"12101031408",1813,348,27,0,76,0,31,93,2388
"12101031409",3996,1150,160,43,305,120,214,618,6606
"12101031503",2464,416,21,58,275,0,340,0,3574
"12101031504",1592,72,30,0,113,0,9,0,1816
"12101031505",5113,413,66,3,144,8,457,39,6243
"12101031506",3366,515,217,0,357,0,342,0,4797
"12101031507",5031,393,76,0,155,0,420,39,6114
"12101031508",3279,88,100,133,251,5,156,16,4028
"12101031601",3502,131,49,0,190,14,210,0,4096
"12101031602",5002,501,395,0,286,0,539,49,6772
"12101031603",5799,101,601,0,972,14,2219,0,9706
"12101031604",4903,257,378,0,412,54,797,22,6823
"12101031605",2729,294,18,0,59,0,148,0,3248
"12101031701",1783,218,73,6,317,32,149,27,2605
"12101031703",3345,1295,51,31,84,57,52,24,4939
"12101031704",4939,256,34,0,118,0,424,0,5771
"12101031705",3355,382,98,0,368,0,188,9,4400
"12101031706",3067,99,40,0,52,0,130,0,3388
"12101031707",2902,256,23,5,110,0,272,0,3568
"12101031708",4818,295,149,31,122,21,424,0,5860
"12101031804",3025,697,0,1,89,0,23,94,3929
"12101031805",2993,510,28,0,57,10,109,52,3759
"12101031806",3680,714,0,0,48,0,344,0,4786
"12101031807",2278,836,76,14,31,12,202,53,3502
"12101031808",1646,553,0,0,78,12,106,64,2459
"12101031809",1861,835,34,26,38,9,148,9,2960
"12101031901",2197,210,0,0,83,0,142,3,2635
"12101031902",4719,292,0,0,316,17,582,0,5926
"12101031903",4351,172,503,19,472,0,1312,0,6829
"12101032001",4206,303,339,0,262,41,432,103,5686
"12101032005",3027,192,33,0,141,42,200,29,3664
"12101032006",5596,986,556,48,650,28,1394,91,9349
"12101032007",2646,211,0,0,135,0,571,19,3582
"12101032008",4099,272,126,34,300,17,974,31,5853
"12101032009",5588,265,942,0,364,42,1350,16,8567
"12101032010",2568,142,96,15,251,59,527,84,3742
"12101032011",3898,208,513,27,326,10,691,94,5767
"12101032012",2332,148,278,246,249,165,938,25,4381
"12101032013",4053,424,195,0,284,0,1233,22,6211
"12101032014",5193,242,654,23,623,13,1287,77,8112
"12101032103",3897,447,762,11,566,35,1157,87,6962
"12101032104",3053,200,486,59,700,8,970,86,5562
"12101032105",2802,71,765,170,872,235,776,48,5739
"12101032106",5425,284,702,49,634,35,1138,241,8508
"12101032107",3449,53,287,13,737,14,1029,0,5582
"12101032108",3282,424,0,0,212,9,530,23,4480
"12101032109",1920,99,564,20,416,106,645,35,3805
"12101032110",2578,189,116,0,292,0,399,12,3586
"12101032111",2372,199,156,0,137,0,589,0,3453
"12101032112",2827,120,529,134,406,73,614,0,4703
"12101032113",2478,157,488,0,792,0,687,56,4658
"12101032200",3358,168,77,22,134,9,306,6,4080
"12101032300",2067,145,85,16,24,56,282,55,2730
"12101032401",2022,391,56,17,118,0,354,17,2975
"12101032402",1915,1493,104,125,126,38,423,907,5131
"12101032500",3504,356,177,364,351,318,1496,402,6968
"12101032601",1577,828,431,547,56,44,638,523,4644
"12101032602",1908,561,183,276,47,227,332,219,3753
"12101032700",1795,560,298,54,34,14,345,97,3197
"12101032801",1585,127,17,0,164,0,131,16,2040
"12101032802",2607,359,34,93,51,81,98,0,3323
"12101032803",1524,575,59,0,31,0,24,461,2674
"12101032804",2010,95,0,101,117,0,34,6,2363
"12101032901",4097,320,50,2,510,7,939,55,5980
"12101032902",1660,205,4,0,34,19,46,0,1968
"12101032903",3212,282,0,0,42,0,347,53,3936
"12101032904",1458,194,0,0,15,0,74,4,1745
"12101033005",3739,459,131,69,196,47,171,119,4931
"12101033006",1455,246,61,0,0,0,14,0,1776
"12101033007",1508,101,10,0,6,0,15,0,1640
"12101033008",1766,507,0,156,115,15,85,0,2644
"12101033009",2317,625,73,8,134,28,113,224,3522
"12101033010",2731,506,0,181,256,58,229,0,3961
"12101033011",1324,294,0,0,18,12,16,92,1756
"12101033012",2039,336,27,0,32,11,17,0,2462
"12101033013",2264,691,68,12,229,23,305,248,3840
"12101033014",2969,462,18,0,0,0,250,18,3717
"12101033101",1997,291,50,22,52,37,49,82,2580
"12101033102",953,199,21,0,22,0,188,0,1383
"12101990000",0,0,0,0,0,0,0,0,0
"12103020101",785,230,2364,1151,0,74,54,80,4738
"12103020105",2558,278,363,94,97,37,233,0,3660
"12103020106",2936,200,11,0,65,15,92,0,3319
"12103020107",1468,65,9,0,47,0,15,0,1604
"12103020108",1435,426,34,0,96,21,44,0,2056
"12103020201",1525,149,2681,357,59,131,312,9,5223
"12103020202",1478,222,1323,66,43,17,35,130,3314
"12103020206",668,293,2390,221,373,30,74,60,4109
"12103020207",1387,220,726,74,9,7,112,26,2561
"12103020208",533,165,967,463,26,0,91,12,2257
"12103020209",1158,69,1834,858,85,33,38,33,4108
"12103020301",965,96,1582,375,124,133,120,67,3462
"12103020302",1705,396,1103,329,82,52,274,53,3994
"12103020400",1217,136,652,309,15,0,112,11,2452
"12103020500",235,246,1527,1172,63,83,13,94,3433
"12103020600",138,82,2450,1150,103,68,44,0,4035
"12103020700",62,51,2991,559,34,41,0,0,3738
"12103020800",241,108,2172,2121,70,41,80,23,4856
"12103021200",56,67,1928,1533,37,216,23,5,3865
"12103021500",2038,555,238,184,63,40,58,51,3227
"12103021600",646,406,254,502,24,38,94,144,2108
"12103021800",1462,212,417,606,59,2,144,14,2916
"12103021900",1345,390,1102,294,147,32,162,171,3643
"12103022000",260,102,2267,641,35,8,10,32,3355
"12103022100",2568,641,1343,270,541,22,411,34,5830
"12103022200",2161,415,695,335,410,15,232,66,4329
"12103022301",2254,147,148,88,92,0,417,1,3147
"12103022302",2770,292,74,99,42,61,133,61,3532
"12103022401",3180,290,0,2,98,22,138,17,3747
"12103022402",4625,504,109,5,82,10,378,11,5724
"12103022501",4068,699,104,172,229,0,668,40,5980
"12103022502",3159,274,106,1,250,1,681,1,4473
"12103022503",4217,276,115,292,565,0,163,0,5628
"12103022601",2730,193,34,17,106,0,161,99,3340
"12103022602",3573,356,50,88,336,54,292,95,4844
"12103022700",2924,359,190,7,279,200,181,12,4152
"12103022801",3105,556,236,84,266,186,764,120,5317
"12103022802",2597,85,83,0,575,30,278,0,3648
"12103022901",1454,266,361,80,318,191,111,0,2781
"12103022902",1692,216,58,17,416,82,405,6,2892
"12103023000",1581,328,8,59,385,44,56,0,2461
"12103023100",1595,279,77,44,99,365,90,24,2573
"12103023200",2434,417,129,19,46,29,227,29,3330
"12103023300",1705,318,197,102,79,60,119,143,2723
"12103023400",909,353,53,106,178,12,230,96,1937
"12103023500",1884,501,206,177,86,18,212,39,3123
"12103023600",2305,442,16,47,56,9,88,9,2972
"12103023700",2263,139,35,0,202,0,81,0,2720
"12103023800",2045,228,69,14,58,20,116,31,2581
"12103023900",1399,188,22,0,67,65,82,0,1823
"12103024001",3035,95,57,0,41,0,106,0,3334
"12103024002",4380,300,0,0,500,25,326,0,5531
"12103024004",4535,106,64,0,395,0,201,0,5301
"12103024005",2749,124,0,0,160,18,288,0,3339
"12103024100",3518,505,39,352,33,0,169,49,4665
"12103024200",3828,635,37,106,386,132,102,52,5278
"12103024301",3020,302,34,16,398,173,216,35,4194
"12103024302",3531,487,311,66,457,109,246,23,5230
"12103024403",2943,423,42,132,352,33,158,49,4132
"12103024406",2852,464,598,262,427,209,289,54,5155
"12103024408",2999,354,168,516,366,74,732,157,5366
"12103024409",2788,106,0,0,45,0,225,0,3164
"12103024410",2473,561,382,58,156,31,635,0,4296
"12103024411",3274,270,78,0,227,78,376,8,4311
"12103024412",2529,207,161,25,289,44,384,104,3743
"12103024413",3139,721,122,0,577,0,124,33,4716
"12103024505",5239,889,181,21,700,185,479,470,8164
"12103024507",2596,474,34,55,203,82,229,52,3725
"12103024508",3887,820,772,156,333,78,1040,493,7579
"12103024509",2579,117,29,0,492,11,137,58,3423
"12103024510",1131,728,283,56,189,92,573,476,3528
"12103024511",5378,606,1197,27,1099,80,316,24,8727
"12103024512",2201,477,22,21,361,0,292,32,3406
"12103024513",3074,129,132,45,25,0,135,65,3605
"12103024514",2702,740,272,197,356,185,564,249,5265
"12103024601",2543,346,63,38,485,78,192,68,3813
"12103024602",3089,1421,278,763,234,43,311,273,6412
"12103024701",1951,844,79,53,207,141,192,63,3530
"12103024702",1290,464,52,57,133,73,165,101,2335
"12103024703",1342,581,505,35,470,56,124,40,3153
"12103024801",3512,526,17,10,460,125,303,26,4979
"12103024803",1697,395,186,21,239,20,209,97,2864
"12103024804",1262,121,73,13,423,126,243,114,2375
"12103024805",1775,321,265,21,233,72,199,157,3043
"12103024901",4086,525,117,3,724,0,461,34,5950
"12103024902",3451,1302,209,125,775,62,412,400,6736
"12103024904",2649,408,159,64,578,90,552,138,4638
"12103024905",4693,644,140,26,1106,51,636,306,7602
"12103024906",2801,484,233,26,215,82,424,30,4295
"12103025004",4297,608,126,29,587,74,588,11,6320
"12103025007",3124,523,35,7,214,15,126,49,4093
"12103025009",2682,393,189,68,314,50,346,76,4118
"12103025010",3691,524,28,81,499,0,137,302,5262
"12103025011",4293,217,37,1,464,65,188,52,5317
"12103025012",4272,689,11,272,365,0,122,31,5762
"12103025013",3138,308,0,337,243,0,265,0,4291
"12103025014",3610,348,31,0,632,30,314,66,5031
"12103025015",2313,226,31,2,90,38,62,11,2773
"12103025016",1280,148,15,62,253,28,70,0,1856
"12103025017",2086,304,26,12,116,0,303,0,2847
"12103025018",1247,555,137,118,469,61,211,257,3055
"12103025019",1502,482,8,49,82,19,18,0,2160
"12103025106",1895,259,0,9,98,9,87,0,2357
"12103025107",3025,472,19,1,195,0,81,0,3793
"12103025108",1739,266,7,0,47,46,31,7,2143
"12103025109",2784,635,40,2,79,21,141,3,3705
"12103025110",4989,574,59,0,203,49,353,35,6262
"12103025111",2189,171,18,14,69,0,34,0,2495
"12103025112",2684,366,135,51,164,0,118,57,3575
"12103025113",2303,280,5,1,36,2,103,5,2735
"12103025114",2744,214,0,0,153,11,56,48,3226
"12103025115",2457,393,33,103,222,35,236,20,3499
"12103025116",1806,241,15,20,69,0,215,88,2454
"12103025119",5057,366,57,0,234,32,308,17,6071
"12103025120",3059,181,74,2,133,0,125,2,3576
"12103025121",3858,208,35,17,330,7,120,0,4575
"12103025122",4539,94,192,0,249,0,402,0,5476
"12103025123",1770,103,55,0,52,0,45,0,2025
"12103025203",5035,539,40,0,33,0,73,10,5730
"12103025204",2520,541,57,10,89,33,157,4,3411
"12103025205",3214,383,35,0,188,10,86,0,3916
"12103025207",4153,748,1086,293,651,39,346,331,7647
"12103025208",1298,100,0,139,39,11,35,4,1626
"12103025209",3783,348,216,72,160,9,574,13,5175
"12103025303",2988,691,346,0,169,35,232,55,4516
"12103025304",2645,334,77,8,50,0,142,84,3340
"12103025305",1990,354,72,28,133,121,178,161,3037
"12103025306",1066,172,69,0,44,3,98,0,1452
"12103025307",2433,292,858,388,203,130,254,3,4561
"12103025308",1799,202,12,0,56,28,63,25,2185
"12103025401",3946,228,137,2,125,93,170,113,4814
"12103025405",3485,403,162,0,149,115,321,87,4722
"12103025407",4190,415,173,107,341,0,468,146,5840
"12103025408",4400,1442,150,203,507,19,704,356,7781
"12103025411",1021,435,170,82,135,108,292,142,2385
"12103025412",3580,432,13,13,210,17,151,64,4480
"12103025413",2625,597,42,0,160,0,172,163,3759
"12103025414",1661,307,243,104,147,32,75,73,2642
"12103025415",2819,499,27,17,286,13,262,152,4075
"12103025416",2544,534,38,20,269,148,517,45,4115
"12103025417",1844,345,0,93,18,0,12,0,2312
"12103025501",3668,248,108,0,86,11,392,20,4533
"12103025503",3142,495,338,26,314,23,444,13,4795
"12103025505",1071,581,143,196,10,64,385,349,2799
"12103025506",3853,852,214,23,472,75,583,267,6339
"12103025602",1942,749,131,21,257,0,389,101,3590
"12103025603",1736,327,30,14,108,42,97,77,2431
"12103025604",993,169,76,0,57,15,142,34,1486
"12103025700",3507,115,43,0,110,16,190,16,3997
"12103025800",2077,636,649,467,188,69,517,186,4789
"12103025900",2386,1040,408,347,75,216,243,352,5067
"12103026001",2762,305,20,0,25,0,89,0,3201
"12103026002",2187,281,0,0,299,0,73,43,2883
"12103026101",937,435,837,100,188,114,227,142,2980
"12103026102",953,223,59,60,32,2,3,2,1334
"12103026200",48,186,875,598,40,63,40,97,1947
"12103026300",3068,1130,1348,1055,146,135,481,466,7829
"12103026400",3868,1037,430,106,353,294,1675,787,8550
"12103026500",4725,555,617,408,570,302,631,169,7977
"12103026601",2784,90,45,3,42,0,459,12,3435
"12103026602",2100,544,277,202,69,24,481,265,3962
"12103026701",3429,314,182,316,114,0,303,82,4740
"12103026702",5631,348,223,50,671,197,770,18,7908
"12103026703",4098,610,666,127,543,229,733,303,7309
"12103026804",4091,568,276,67,305,102,390,254,6053
"12103026809",2478,122,77,0,27,22,206,0,2932
"12103026811",5933,142,0,0,346,13,355,1,6790
"12103026812",4230,144,19,0,237,0,234,0,4864
"12103026813",3046,443,0,5,110,217,485,542,4848
"12103026814",2070,130,0,60,35,0,103,3,2401
"12103026815",4258,270,28,0,418,0,200,2,5176
"12103026816",3975,628,141,172,347,0,374,217,5854
"12103026817",3940,353,164,50,256,12,140,95,5010
"12103026818",2197,397,249,291,257,306,744,213,4654
"12103026819",1446,86,76,5,113,0,469,0,2195
"12103026820",3594,392,178,0,126,91,502,0,4883
"12103026821",2342,396,13,1,0,6,158,155,3071
"12103026904",4500,478,11,12,103,14,542,30,5690
"12103026907",5415,343,272,0,76,57,574,29,6766
"12103026908",3621,222,154,8,104,0,166,0,4275
"12103026909",4098,305,97,1,157,0,263,0,4921
"12103026910",4298,267,138,4,420,0,326,19,5472
"12103026911",3154,244,0,0,174,0,622,0,4194
"12103026912",2249,621,167,0,316,137,169,401,4060
"12103026913",2647,477,232,0,37,41,206,28,3668
"12103027000",3309,308,229,64,434,146,380,115,4985
"12103027101",2637,542,107,69,103,27,96,18,3599
"12103027105",3104,128,56,7,53,0,131,0,3479
"12103027106",3976,200,0,1,12,0,249,1,4439
"12103027202",4979,312,0,2,256,0,226,48,5823
"12103027204",3769,399,30,1,83,10,133,12,4437
"12103027205",5116,672,160,0,288,0,559,77,6872
"12103027206",6214,290,14,30,325,0,466,23,7362
"12103027207",4123,579,8,12,221,15,287,66,5311
"12103027208",5999,753,0,14,283,16,255,246,7566
"12103027209",972,115,4,6,4,12,43,6,1162
"12103027210",3794,452,0,0,164,15,494,0,4919
"12103027308",2783,347,105,0,182,16,195,22,3650
"12103027309",1593,121,6,28,93,0,41,6,1888
"12103027310",8338,259,107,0,532,15,622,2,9875
"12103027314",2952,313,96,81,94,8,79,10,3633
"12103027315",4117,435,201,0,58,62,123,0,4996
"12103027316",3369,214,51,0,98,0,157,0,3889
"12103027317",4583,199,65,29,73,19,357,0,5325
"12103027318",3298,312,131,0,248,48,279,30,4346
"12103027319",3770,390,416,0,459,0,236,69,5340
"12103027320",3226,395,191,0,134,40,485,88,4559
"12103027321",1405,88,0,10,36,0,102,0,1641
"12103027322",5501,473,92,0,362,0,317,0,6745
"12103027323",2412,206,0,0,96,31,300,106,3151
"12103027324",3615,237,31,60,118,34,174,0,4269
"12103027325",3207,181,0,0,315,38,137,0,3878
"12103027326",2537,486,9,0,335,0,335,119,3821
"12103027327",3299,376,104,326,432,96,308,125,5066
"12103027401",2079,303,100,101,0,41,40,14,2678
"12103027402",4091,705,310,527,251,27,393,174,6478
"12103027403",1291,311,37,0,7,3,71,40,1760
"12103027501",5024,538,12,18,39,0,200,0,5831
"12103027502",5601,888,0,4,411,25,251,51,7231
"12103027603",2254,76,0,0,112,64,86,43,2635
"12103027604",2336,210,0,0,64,10,116,10,2746
"12103027605",1646,81,0,0,39,0,55,0,1821
"12103027606",1494,84,10,0,59,0,25,0,1672
"12103027701",2544,191,10,0,56,15,96,39,2951
"12103027703",1101,126,0,0,27,0,30,0,1284
"12103027704",2094,180,6,0,69,0,123,19,2491
"12103027801",1072,265,17,0,79,0,105,18,1556
"12103027802",2439,311,0,0,39,0,225,0,3014
"12103027901",1775,211,0,0,156,39,84,7,2272
"12103027903",1317,73,0,0,2,0,80,5,1477
"12103027904",2701,445,0,0,30,0,76,16,3268
"12103028002",3624,140,0,0,110,18,55,12,3959
"12103028003",2662,586,46,0,23,10,63,0,3390
"12103028004",1819,229,0,15,7,22,65,11,2168
"12103028102",2490,318,57,111,386,14,115,24,3515
"12103028103",1421,174,18,0,18,0,115,0,1746
"12103028104",2563,278,0,0,98,0,101,15,3055
"12103028200",1850,251,36,71,55,69,113,33,2478
"12103028300",1946,616,371,389,190,52,120,207,3891
"12103028401",1251,176,13,0,0,0,27,24,1491
"12103028402",1009,167,21,6,0,0,18,0,1221
"12103028500",1205,406,191,95,67,32,76,43,2115
"12103028600",2150,513,288,106,187,20,429,37,3730
"12103028700",126,25,1452,912,83,62,74,0,2734
"12103990000",0,0,0,0,0,0,0,0,0
"12103990100",0,0,0,0,0,0,0,0,0
"12105010300",2322,811,469,239,287,142,408,431,5109
"12105010401",1518,233,46,32,55,0,77,0,1961
"12105010402",1940,527,271,0,444,0,116,0,3298
"12105010501",1406,164,106,13,26,0,188,0,1903
"12105010502",3446,282,13,51,14,0,166,137,4109
"12105010601",3050,407,166,29,80,116,334,86,4268
"12105010603",2930,155,10,0,200,0,214,2,3511
"12105010604",2581,383,280,0,63,22,542,161,4032
"12105010701",2818,466,585,133,81,30,187,31,4331
"12105010702",2821,117,197,0,58,15,394,24,3626
"12105010800",1537,756,570,305,193,172,380,515,4428
"12105010900",2116,715,684,464,38,258,475,394,5144
"12105011000",1150,561,960,260,39,24,240,259,3493
"12105011100",641,924,1086,543,0,90,287,642,4213
"12105011202",0,12,1345,671,14,11,45,4,2102
"12105011203",374,495,1718,1051,355,68,325,428,4814
"12105011204",119,6,703,770,59,7,29,7,1700
"12105011300",871,116,167,464,188,137,152,135,2230
"12105011400",2390,793,541,286,237,68,637,313,5265
"12105011501",3508,1091,554,339,323,84,371,144,6414
"12105011502",3719,505,634,77,298,92,877,329,6531
"12105011603",1989,273,64,52,82,0,147,0,2607
"12105011604",4046,381,18,222,330,36,443,151,5627
"12105011605",2303,210,100,321,122,4,44,54,3158
"12105011606",1488,147,251,35,0,4,7,4,1936
"12105011704",2185,1274,397,412,362,49,663,724,6066
"12105011721",1902,1048,14,11,29,0,90,74,3168
"12105011722",2365,494,0,9,56,17,214,101,3256
"12105011731",1985,695,738,179,119,46,466,398,4626
"12105011732",1216,519,576,398,397,104,302,325,3837
"12105011821",2681,98,122,0,128,0,282,2,3313
"12105011822",3137,174,105,63,332,90,231,115,4247
"12105011832",2993,608,634,84,70,0,476,110,4975
"12105011833",6127,434,619,2,837,88,1115,249,9471
"12105011834",4469,332,464,40,691,25,581,0,6602
"12105011835",3975,250,74,0,43,0,526,87,4955
"12105011836",3280,49,102,0,141,13,243,7,3835
"12105011901",2990,720,214,166,175,0,624,114,5003
"12105011902",2238,347,118,165,280,3,553,3,3707
"12105011908",2915,156,389,81,157,40,316,0,4054
"12105011909",2581,39,51,0,55,0,130,0,2856
"12105011910",1443,314,50,5,24,6,461,62,2365
"12105011911",2647,11,70,94,92,30,599,30,3573
"12105011912",1300,110,101,9,92,29,127,0,1768
"12105011913",1676,279,308,128,51,0,437,82,2961
"12105012001",2979,710,1092,420,145,26,465,38,5875
"12105012002",1749,358,308,63,141,290,416,290,3615
"12105012003",4658,615,55,52,81,119,627,362,6569
"12105012004",1811,152,77,47,65,189,99,189,2629
"12105012111",5560,402,8,0,248,0,45,63,6326
"12105012113",5125,441,682,0,65,45,477,0,6835
"12105012124",3613,799,550,96,350,94,613,43,6158
"12105012125",2077,493,17,0,37,163,126,8,2921
"12105012126",2161,123,558,6,497,22,1341,45,4753
"12105012127",4572,446,615,45,473,65,852,157,7225
"12105012128",3217,42,773,12,649,281,830,0,5804
"12105012129",5207,558,1131,0,154,51,1255,0,8356
"12105012203",1772,268,154,15,157,48,268,178,2860
"12105012204",3963,1349,424,17,121,128,579,348,6929
"12105012205",685,138,68,50,222,58,115,15,1351
"12105012206",3841,493,571,45,46,0,923,0,5919
"12105012303",2556,734,194,0,132,0,143,0,3759
"12105012304",4832,173,312,0,253,23,367,0,5960
"12105012305",1181,474,16,0,45,15,73,112,1916
"12105012306",2273,283,0,85,47,0,336,132,3156
"12105012307",2321,549,0,0,115,41,29,0,3055
"12105012309",993,377,0,0,75,26,16,26,1513
"12105012403",6915,939,685,293,1755,204,3319,503,14613
"12105012404",465,37,386,0,23,5,48,0,964
"12105012405",3916,588,110,0,561,52,1260,281,6768
"12105012406",3854,135,191,6,196,106,1061,7,5556
"12105012407",921,92,219,19,7,5,42,0,1305
"12105012408",2167,769,185,0,89,7,148,178,3543
"12105012409",1156,356,435,10,36,0,140,25,2158
"12105012410",1654,192,447,79,165,0,688,89,3314
"12105012411",4073,815,534,91,180,68,2038,439,8238
"12105012502",3953,1190,553,116,503,407,1576,839,9137
"12105012503",9030,813,1096,1169,2310,388,5975,1050,21831
"12105012504",3101,939,608,251,54,0,605,690,6248
"12105012506",3860,317,367,117,434,111,1077,220,6503
"12105012507",4104,396,100,15,182,206,830,0,5833
"12105012601",1642,244,1268,437,126,140,697,119,4673
"12105012602",2318,2121,605,400,610,185,2464,1501,10204
"12105012700",4170,1419,538,176,83,198,2407,1144,10135
"12105012802",1981,302,368,268,101,63,264,96,3443
"12105012803",3362,248,0,0,32,0,83,0,3725
"12105012804",2927,325,356,40,578,13,617,102,4958
"12105012900",2538,941,895,497,101,198,163,593,5926
"12105013001",2650,332,143,0,0,0,457,125,3707
"12105013002",2387,1211,117,279,72,76,243,550,4935
"12105013101",3727,142,127,0,126,20,368,0,4510
"12105013102",2334,666,84,197,116,0,230,372,3999
"12105013103",679,324,0,0,3,12,177,186,1381
"12105013200",1110,278,354,133,54,0,217,35,2181
"12105013300",771,605,403,414,38,56,73,56,2416
"12105013400",2745,866,646,515,308,92,533,108,5813
"12105013500",2162,613,247,29,154,69,203,78,3555
"12105013600",1536,206,2235,1922,174,0,541,2,6616
"12105013701",973,245,122,288,27,44,211,40,1950
"12105013702",2709,142,1612,657,86,2,473,0,5681
"12105013801",1749,509,576,68,158,7,14,314,3395
"12105013802",4097,797,632,761,672,9,1251,303,8522
"12105013901",993,319,859,236,16,79,73,153,2728
"12105013902",3799,371,205,2,97,273,309,130,5186
"12105014001",3707,589,199,85,124,0,152,274,5130
"12105014003",2177,240,367,463,150,22,90,88,3597
"12105014005",3397,250,125,60,202,21,193,32,4280
"12105014006",2265,209,235,0,154,0,73,134,3070
"12105014103",4286,1537,2151,1486,423,202,3582,1212,14879
"12105014104",280,27,0,0,5,70,10,9,401
"12105014105",5352,1106,296,0,233,24,1710,441,9162
"12105014121",1139,403,91,4,158,54,357,151,2357
"12105014123",5084,434,173,140,107,0,831,69,6838
"12105014124",1333,206,399,89,9,0,115,118,2269
"12105014125",3031,1169,950,184,274,0,394,9,6011
"12105014201",4443,539,371,141,85,143,510,89,6321
"12105014202",2190,171,123,0,155,5,337,0,2981
"12105014203",2330,243,0,27,0,12,96,10,2718
"12105014301",114,149,454,722,17,9,61,127,1653
"12105014302",3941,388,823,350,259,121,952,90,6924
"12105014400",5042,705,954,112,292,69,778,321,8273
"12105014501",5035,1541,154,116,300,53,1498,1154,9851
"12105014502",2432,1275,0,89,28,22,1429,862,6137
"12105014600",2710,1139,350,28,300,4,1170,514,6215
"12105014701",2952,611,156,87,168,0,279,150,4403
"12105014702",5914,287,1938,93,290,0,352,0,8874
"12105014802",1557,232,536,143,158,314,551,131,3622
"12105014803",1796,4,95,5,84,0,135,4,2123
"12105014804",5456,547,708,36,403,0,557,0,7707
"12105014901",7389,692,781,0,336,0,1835,188,11221
"12105014902",4554,1276,118,0,256,217,1913,868,9202
"12105015000",2737,634,912,240,222,81,566,194,5586
"12105015101",2518,580,139,0,43,0,300,60,3640
"12105015102",1942,336,0,0,0,0,125,2,2405
"12105015200",1329,544,1575,1086,289,26,320,26,5195
"12105015301",2118,696,837,239,84,14,422,233,4643
"12105015302",1677,711,0,0,5,12,16,301,2722
"12105015401",1638,274,516,237,77,57,358,0,3157
"12105015402",1937,365,207,6,66,114,200,98,2993
"12105015404",958,135,0,34,0,0,0,20,1147
"12105015405",1657,286,138,38,91,36,263,113,2622
"12105015500",2079,1347,279,532,77,48,719,911,5992
"12105015600",2213,323,196,0,6,9,149,88,2984
"12105015701",1480,121,241,213,0,106,133,4,2298
"12105015702",1877,877,110,17,123,12,257,462,3735
"12105015801",1579,277,0,9,53,0,212,160,2290
"12105015802",1348,870,33,5,47,104,518,818,3743
"12105015900",1533,387,97,40,46,0,506,177,2786
"12105016001",1602,177,90,54,152,12,406,49,2542
"12105016002",691,479,565,83,123,29,440,279,2689
"12105016003",1985,596,68,18,210,17,669,348,3911
"12105016100",560,55,170,88,63,36,56,71,1099
"12105016400",419,571,555,407,41,46,130,60,2229
"12105980000",0,31,0,0,0,0,0,24,55
"12107950100",2936,675,114,0,68,71,116,0,3980
"12107950201",3456,1055,181,107,145,34,139,43,5160
"12107950202",1813,718,0,0,308,0,70,0,2909
"12107950300",4429,1090,452,82,31,131,300,197,6712
"12107950400",3120,208,158,31,47,12,77,0,3653
"12107950500",4620,1715,307,96,150,27,462,492,7869
"12107950600",3301,1320,618,488,37,145,41,59,6009
"12107950700",1198,419,869,1561,120,16,149,151,4483
"12107950800",739,234,962,673,31,34,141,19,2833
"12107950900",2892,594,1235,649,84,18,238,24,5734
"12107951000",2581,491,356,60,25,0,204,10,3727
"12107951100",2946,912,201,9,398,109,104,249,4928
"12107951200",3659,1077,58,153,232,38,468,103,5788
"12107951300",2341,464,376,245,567,313,529,337,5172
"12107951401",1289,695,529,468,310,231,354,434,4310
"12107951402",1940,959,16,311,443,281,532,730,5212
"12107980000",0,0,0,0,0,0,0,0,0
"12109020200",1939,464,0,8,38,46,120,0,2615
"12109020300",2322,475,398,710,210,51,295,103,4564
"12109020400",1093,733,338,27,10,11,67,111,2390
"12109020500",2988,365,0,13,150,0,27,7,3550
"12109020601",4533,440,0,0,76,0,134,0,5183
"12109020602",10054,783,294,0,501,0,481,0,12113
"12109020704",3205,87,0,0,201,0,58,0,3551
"12109020705",5184,298,209,75,88,0,290,88,6232
"12109020706",2825,47,0,0,293,0,49,0,3214
"12109020707",4387,414,312,51,298,46,347,11,5866
"12109020708",2393,327,67,0,91,6,136,6,3026
"12109020710",2192,67,0,1,91,0,83,0,2434
"12109020711",4570,261,23,0,235,0,93,0,5182
"12109020801",6822,303,552,28,356,271,587,49,8968
"12109020802",3649,42,18,0,174,0,473,0,4356
"12109020803",4441,90,0,5,84,16,175,0,4811
"12109020804",2376,430,163,31,148,0,137,11,3296
"12109020805",11260,189,528,0,841,0,678,0,13496
"12109020806",4917,527,183,14,849,0,479,11,6980
"12109020807",1427,40,0,0,48,0,9,0,1524
"12109020901",6170,1157,305,0,372,36,600,43,8683
"12109020902",21707,1302,1029,128,1415,48,1897,16,27542
"12109021002",2612,433,868,380,110,5,373,73,4854
"12109021003",2544,542,1282,166,310,135,247,0,5226
"12109021004",2452,98,113,0,62,0,6,0,2731
"12109021101",3248,406,517,238,130,12,153,91,4795
"12109021102",3946,579,204,417,166,16,145,25,5498
"12109021103",1302,345,0,1,35,24,80,24,1811
"12109021203",5867,954,188,1,229,0,361,106,7706
"12109021204",847,109,22,18,0,0,54,11,1061
"12109021205",954,95,0,0,67,0,85,0,1201
"12109021206",5705,551,141,10,177,0,217,36,6837
"12109021301",4589,1297,142,156,477,20,234,72,6987
"12109021302",4719,400,84,8,312,10,510,22,6065
"12109021403",2087,166,5,0,17,0,17,0,2292
"12109021404",3403,106,0,0,20,0,156,0,3685
"12109021405",4553,484,15,0,100,39,237,39,5467
"12109021406",3838,670,0,0,313,28,361,0,5210
"12109021407",1292,96,0,15,20,11,11,0,1445
"12109990100",0,0,0,0,0,0,0,0,0
"12109990200",0,0,0,0,0,0,0,0,0
"12111380100",206,399,69,257,12,48,28,89,1108
"12111380200",61,165,1145,1445,10,148,55,142,3171
"12111380300",270,230,2316,3069,12,0,134,8,6039
"12111380400",1796,1441,908,631,401,200,1277,991,7645
"12111380500",2531,657,1042,951,208,303,1168,833,7693
"12111380600",2327,473,453,570,336,44,1290,133,5626
"12111380700",4882,740,1109,980,140,356,1409,660,10276
"12111380800",1429,402,236,15,110,7,29,69,2297
"12111380901",410,707,668,438,0,0,0,332,2555
"12111380902",772,314,2687,1431,166,90,356,152,5968
"12111381000",824,85,319,0,11,4,43,6,1292
"12111381101",5247,591,742,186,201,47,440,1,7455
"12111381102",3072,385,406,7,505,37,255,4,4671
"12111381204",2705,114,0,0,18,0,87,23,2947
"12111381300",3464,398,106,17,131,0,202,0,4318
"12111381401",3598,739,224,204,45,128,630,106,5674
"12111381402",3714,1286,543,293,40,148,674,857,7555
"12111381502",7717,1457,1278,151,977,38,1050,511,13179
"12111381503",6173,1108,1286,330,1078,24,1477,301,11777
"12111381601",4880,512,1,153,144,33,50,33,5806
"12111381602",2628,242,208,12,160,12,344,52,3658
"12111381603",5022,264,278,28,87,168,304,164,6315
"12111381701",2668,197,0,0,10,0,37,31,2943
"12111381702",1706,259,0,0,6,31,27,0,2029
"12111381802",2065,722,287,441,379,132,660,296,4982
"12111381803",4065,373,380,16,291,32,611,45,5813
"12111381804",3440,548,414,0,306,85,253,51,5097
"12111381900",4969,398,36,0,835,32,886,30,7186
"12111382002",4914,1643,1018,224,199,993,871,876,10738
"12111382003",6361,553,1361,613,745,105,1464,189,11391
"12111382006",5438,425,1297,8,807,17,726,46,8764
"12111382007",2891,265,525,605,490,137,954,182,6049
"12111382008",4141,765,1239,225,590,50,1482,314,8806
"12111382009",2435,509,420,309,193,65,462,200,4593
"12111382010",1632,375,228,14,25,0,103,26,2403
"12111382106",13878,1785,3980,221,2272,293,4390,1337,28156
"12111382108",13475,1529,2226,1132,1567,542,2614,559,23644
"12111382109",7675,725,781,123,591,0,1065,82,11042
"12111382110",4481,142,1144,47,501,256,685,198,7454
"12111382111",9567,1495,2250,652,1192,214,3187,1038,19595
"12111382112",3705,1723,1075,80,479,0,613,1114,8789
"12111382113",7270,1703,1843,459,786,778,1151,1716,15706
"12111382200",4892,721,93,53,343,39,776,236,7153
"12111980000",0,0,0,0,0,0,0,0,0
"12111990000",0,0,0,0,0,0,0,0,0
"12113010100",2759,223,2,14,112,15,3,0,3128
"12113010200",3399,355,0,12,42,10,29,0,3847
"12113010300",9754,402,73,9,600,4,676,19,11537
"12113010400",1833,386,0,41,160,0,84,0,2504
"12113010502",5489,1295,410,448,583,2,210,30,8467
"12113010503",4569,297,189,124,596,55,48,61,5939
"12113010504",3598,393,105,26,342,17,153,0,4634
"12113010600",3846,844,717,336,513,78,265,61,6660
"12113010702",4995,755,162,115,573,70,253,3,6926
"12113010704",4487,428,307,6,209,56,130,76,5699
"12113010705",2072,489,21,18,435,354,133,154,3676
"12113010706",6039,1261,327,50,569,40,308,171,8765
"12113010707",4163,227,45,0,210,135,204,0,4984
"12113010708",4619,295,187,0,444,21,572,0,6138
"12113010802",3601,555,178,0,300,14,232,189,5069
"12113010808",3008,650,0,26,281,257,185,120,4527
"12113010809",2799,1312,251,20,86,319,41,63,4891
"12113010811",9744,839,745,0,1466,128,462,198,13582
"12113010812",4185,290,0,0,215,0,110,0,4800
"12113010813",4192,277,10,0,162,29,71,0,4741
"12113010814",5112,310,35,0,398,14,339,0,6208
"12113010815",6511,1151,154,18,701,133,144,8,8820
"12113010817",4436,412,229,0,261,5,680,0,6023
"12113010819",8623,1383,775,205,624,304,368,198,12480
"12113010900",5520,316,54,0,94,0,107,0,6091
"12113990000",0,0,0,0,0,0,0,0,0
"12115000101",3089,361,19,239,83,0,73,29,3893
"12115000102",1973,1020,149,50,38,0,374,556,4160
"12115000200",1892,539,860,608,164,115,467,301,4946
"12115000300",231,216,1662,1289,12,230,202,151,3993
"12115000401",3483,404,187,133,102,0,1012,130,5451
"12115000404",1155,157,30,0,74,0,73,9,1498
"12115000405",2339,933,94,5,79,0,625,495,4570
"12115000406",2117,760,220,24,53,29,577,505,4285
"12115000407",2575,645,259,131,357,74,1246,466,5753
"12115000501",1324,174,7,0,118,13,123,0,1759
"12115000502",2404,704,114,15,241,406,438,776,5098
"12115000503",2752,442,40,79,72,20,248,53,3706
"12115000601",1788,312,7,0,78,21,69,0,2275
"12115000602",3003,379,11,0,196,30,16,4,3639
"12115000700",2429,129,85,0,79,0,141,0,2863
"12115000801",1828,118,0,0,123,0,87,0,2156
"12115000802",2261,169,0,0,49,0,108,0,2587
"12115000900",1686,191,196,102,63,65,160,62,2525
"12115001000",2070,197,215,259,144,71,283,106,3345
"12115001101",2691,488,257,506,110,12,298,12,4374
"12115001102",2711,603,581,886,106,208,1130,123,6348
"12115001201",5963,559,175,0,360,210,725,197,8189
"12115001202",2976,572,286,65,267,52,891,421,5530
"12115001203",3477,118,149,0,0,0,82,0,3826
"12115001204",3487,269,101,30,103,30,268,131,4419
"12115001301",2250,111,136,13,116,10,270,10,2916
"12115001302",3276,394,14,0,150,62,357,127,4380
"12115001303",2941,63,0,0,173,62,85,0,3324
"12115001304",1808,185,23,10,16,0,139,0,2181
"12115001401",7090,362,27,27,279,0,226,0,8011
"12115001402",4201,296,149,20,58,10,463,61,5258
"12115001403",5266,482,30,0,90,0,215,122,6205
"12115001503",2870,429,106,11,61,0,442,8,3927
"12115001504",2917,165,12,0,94,37,465,65,3755
"12115001505",3517,433,0,13,285,67,372,201,4888
"12115001506",5201,541,100,0,65,27,428,31,6393
"12115001507",5062,719,36,0,416,183,413,259,7088
"12115001601",2814,454,0,0,115,9,204,54,3650
"12115001602",3286,264,0,50,82,8,355,0,4045
"12115001702",5437,320,22,0,101,21,325,0,6226
"12115001703",2873,360,29,0,58,0,312,37,3669
"12115001704",2231,284,233,8,35,36,303,0,3130
"12115001801",3381,316,0,54,92,16,53,0,3912
"12115001803",2096,639,87,49,74,37,385,211,3578
"12115001804",1781,228,26,30,170,10,277,47,2569
"12115001805",1488,109,26,0,71,0,98,8,1800
"12115001903",1623,199,0,0,24,0,56,0,1902
"12115001904",2986,201,13,0,77,0,109,0,3386
"12115001905",1099,51,9,0,13,0,20,0,1192
"12115001907",848,23,0,0,49,0,0,0,920
"12115001908",762,54,0,0,72,0,37,0,925
"12115002003",3511,507,20,75,174,64,735,64,5150
"12115002004",3219,325,0,0,115,11,472,40,4182
"12115002005",3826,439,0,0,18,0,147,0,4430
"12115002007",2053,162,25,0,60,0,68,0,2368
"12115002008",2405,210,0,0,20,0,80,0,2715
"12115002009",5784,484,229,0,343,95,251,22,7208
"12115002010",5248,250,0,29,65,0,309,0,5901
"12115002100",5842,305,0,0,232,28,282,0,6689
"12115002201",2736,227,0,0,165,11,64,0,3203
"12115002202",4057,299,0,0,52,0,64,16,4488
"12115002203",2795,528,84,6,268,39,96,7,3823
"12115002302",3418,316,15,0,28,0,25,0,3802
"12115002303",4116,405,10,0,16,51,12,96,4706
"12115002304",2255,224,12,22,25,0,87,34,2659
"12115002305",1266,168,45,0,12,10,26,10,1537
"12115002401",2486,248,16,0,15,7,24,1,2797
"12115002402",2868,354,0,0,281,8,180,0,3691
"12115002504",2292,284,9,1,54,2,71,31,2744
"12115002505",1960,107,0,1,275,71,306,36,2756
"12115002507",4484,475,0,0,311,67,196,66,5599
"12115002508",2804,199,31,5,155,0,31,5,3230
"12115002509",3992,478,0,0,0,0,346,109,4925
"12115002510",2797,557,0,0,17,0,4,21,3396
"12115002511",2476,109,0,0,77,0,23,0,2685
"12115002601",1972,119,0,0,290,32,84,10,2507
"12115002602",2148,106,0,0,87,11,16,11,2379
"12115002603",1379,115,33,0,61,0,23,0,1611
"12115002604",2040,329,0,0,41,119,28,164,2721
"12115002605",1887,292,10,0,5,0,123,0,2317
"12115002710",2230,335,31,129,38,13,176,40,2992
"12115002711",7641,605,181,0,630,99,503,72,9731
"12115002712",25419,2935,2327,1424,1741,152,2427,184,36609
"12115002713",7076,433,0,0,154,29,121,0,7813
"12115002714",4047,382,0,0,95,64,77,0,4665
"12115002715",6067,290,0,42,239,43,13,0,6694
"12115002716",6356,488,0,36,45,78,105,0,7108
"12115002718",5096,362,46,14,89,0,160,15,5782
"12115002719",3291,221,0,0,76,0,55,0,3643
"12115002720",2783,126,0,0,62,49,44,0,3064
"12115002721",2923,1026,155,15,313,59,288,0,4779
"12115002722",6245,469,400,231,657,58,516,87,8663
"12115002723",2071,289,16,0,132,14,76,139,2737
"12115002724",2135,147,0,0,66,0,57,0,2405
"12115990000",0,0,0,0,0,0,0,0,0
"12117020101",526,220,102,200,33,5,14,5,1105
"12117020102",660,88,280,173,8,7,181,15,1412
"12117020201",897,298,846,122,185,23,218,49,2638
"12117020202",1830,297,1789,303,180,118,267,201,4985
"12117020301",1435,398,191,188,117,0,192,44,2565
"12117020302",879,234,390,159,78,13,20,71,1844
"12117020401",204,41,1315,496,0,19,0,50,2125
"12117020402",1079,54,1691,524,209,21,89,0,3667
"12117020500",434,247,731,957,41,38,48,87,2583
"12117020600",7646,679,1115,793,1164,319,2485,319,14520
"12117020701",9836,743,1005,474,909,0,1111,116,14194
"12117020703",5364,234,317,0,945,0,502,48,7410
"12117020704",4505,247,374,0,828,0,339,0,6293
"12117020705",1582,109,375,26,485,24,254,39,2894
"12117020803",5226,394,178,56,353,157,835,138,7337
"12117020805",5579,251,156,0,989,0,703,51,7729
"12117020806",4681,473,947,458,282,121,1564,324,8850
"12117020807",4290,656,1091,129,568,121,1665,222,8742
"12117020808",2734,244,274,45,580,27,550,27,4481
"12117020810",3503,392,50,7,602,2,603,4,5163
"12117020811",3802,168,176,54,73,0,719,63,5055
"12117020812",2168,101,284,181,254,41,812,100,3941
"12117020901",2027,695,283,293,32,16,675,557,4578
"12117020902",1476,259,197,105,70,22,339,56,2524
"12117020903",5875,1184,1380,506,1213,264,2538,533,13493
"12117021000",2974,405,462,39,491,84,613,50,5118
"12117021100",1229,99,1276,353,251,53,339,54,3654
"12117021201",4400,399,69,23,310,0,448,18,5667
"12117021203",5455,54,341,0,696,5,1422,29,8002
"12117021204",7427,640,239,1,523,5,647,55,9537
"12117021306",6316,650,157,0,192,0,727,177,8219
"12117021307",6353,464,269,51,704,91,725,1,8658
"12117021311",2847,349,597,315,212,0,615,156,5091
"12117021312",2693,361,111,97,297,71,542,226,4398
"12117021313",4703,515,230,12,680,0,804,339,7283
"12117021314",3344,279,125,106,269,0,584,67,4774
"12117021315",6309,820,368,307,352,124,1595,87,9962
"12117021316",2660,713,167,67,544,58,351,20,4580
"12117021317",6133,788,145,211,1191,473,1670,120,10731
"12117021318",6468,378,1252,102,605,86,2467,206,11564
"12117021319",1171,41,117,16,45,48,93,0,1531
"12117021320",5099,594,559,0,747,153,986,262,8400
"12117021321",2022,241,290,8,138,10,464,43,3216
"12117021401",4746,757,644,36,511,202,1468,401,8765
"12117021403",6838,211,350,11,392,195,1053,169,9219
"12117021404",4907,988,541,181,720,79,735,656,8807
"12117021502",3820,416,160,296,376,70,879,227,6244
"12117021503",1101,213,121,13,128,57,98,82,1813
"12117021504",2550,293,33,0,194,0,426,9,3505
"12117021505",3726,209,246,42,181,0,390,81,4875
"12117021506",2620,132,276,0,159,0,405,20,3612
"12117021604",3869,273,21,0,74,0,499,25,4761
"12117021606",4234,478,747,59,798,35,1384,220,7955
"12117021608",3911,1178,950,58,362,0,1192,676,8327
"12117021609",2879,41,9,0,123,18,283,6,3359
"12117021611",5317,227,79,0,290,0,667,64,6644
"12117021612",3541,287,514,0,347,0,751,0,5440
"12117021613",1681,261,286,104,179,20,638,108,3277
"12117021614",4041,203,982,187,381,6,1355,74,7229
"12117021615",2226,98,107,0,161,46,216,51,2905
"12117021616",2742,179,57,0,443,0,378,0,3799
"12117021704",3642,527,203,52,297,25,1035,66,5847
"12117021705",2727,681,626,284,202,20,1361,487,6388
"12117021706",2323,453,304,8,206,12,731,303,4340
"12117021707",4444,376,321,96,550,52,1372,131,7342
"12117021708",4682,542,587,203,616,222,1117,392,8361
"12117021802",3283,866,513,115,312,0,375,544,6008
"12117021803",1813,209,517,15,79,43,406,106,3188
"12117021805",1774,34,108,0,24,0,30,0,1970
"12117021806",4227,125,240,0,129,15,833,0,5569
"12117021901",3534,457,128,16,577,16,784,74,5586
"12117021902",2394,297,1005,311,142,12,521,53,4735
"12117022001",859,207,513,363,168,115,288,153,2666
"12117022002",3042,340,131,70,258,48,693,44,4626
"12117022004",1843,282,119,20,133,20,324,165,2906
"12117022005",6269,626,354,67,242,12,1072,236,8878
"12117022101",5087,1008,736,125,416,30,1821,187,9410
"12117022104",5560,662,215,53,409,0,1498,369,8766
"12117022105",3140,223,10,12,291,0,519,51,4246
"12117022106",6773,351,547,136,787,117,1610,50,10371
"12117022201",3904,387,384,0,388,82,874,194,6213
"12117022205",2469,171,159,36,168,0,392,15,3410
"12117022206",4373,345,772,104,696,170,1095,245,7800
"12117022207",4212,551,74,75,666,48,928,340,6894
"12117022208",2555,794,421,155,73,65,777,0,4840
"12117022209",3150,522,61,1,382,60,787,277,5240
"12119910100",1637,337,378,135,19,33,128,33,2700
"12119910300",1341,151,0,8,0,2,42,8,1552
"12119910401",2540,430,0,0,57,0,42,31,3100
"12119910402",2114,502,55,26,36,45,197,0,2975
"12119910500",3327,577,532,100,295,21,539,104,5495
"12119910601",3020,860,32,3,166,35,105,52,4273
"12119910602",1871,635,83,125,59,0,146,127,3046
"12119910700",3337,1252,245,164,150,69,367,576,6160
"12119910800",4369,157,0,0,0,0,29,0,4555
"12119910900",0,0,0,0,0,0,0,0,0
"12119911000",114,230,68,191,27,80,28,122,860
"12119911200",32954,1462,465,103,515,0,457,15,35971
"12119911301",2570,270,1,8,40,24,31,24,2968
"12119911302",74,1,346,514,0,2,0,1,938
"12119911400",3835,586,278,163,151,0,96,37,5146
"12119911500",1159,158,681,74,8,0,20,0,2100
"12119911701",10002,458,81,0,159,22,141,48,10911
"12119911702",4745,311,63,0,57,0,186,0,5362
"12119980000",0,0,9,0,0,0,0,0,9
"12121970100",3432,904,871,910,27,27,319,237,6727
"12121970200",2687,696,412,287,346,214,337,497,5476
"12121970301",1444,342,7,51,37,4,215,51,2151
"12121970302",3924,1122,302,20,323,0,102,15,5808
"12121970400",4134,1222,1369,433,60,20,576,521,8335
"12121970500",6579,1611,265,61,70,194,124,176,9080
"12121970600",5162,1593,154,237,202,168,190,313,8019
"12123950100",2645,514,215,417,20,10,70,49,3940
"12123950200",4239,286,350,78,108,49,103,0,5213
"12123950300",2606,460,1831,307,183,18,0,0,5405
"12123950400",4142,474,0,0,50,0,44,0,4710
"12123990000",0,0,0,0,0,0,0,0,0
"12125960100",1196,209,86,14,62,1,24,0,1592
"12125960200",2935,649,437,224,94,117,133,14,4603
"12125960300",3283,552,122,146,145,50,26,135,4459
"12127080100",7055,434,81,0,413,54,67,0,8104
"12127080201",2296,202,0,1,119,0,184,11,2813
"12127080202",2720,358,12,0,40,0,44,9,3183
"12127080300",2261,731,60,18,62,0,67,18,3217
"12127080400",2538,210,0,4,97,0,90,9,2948
"12127080500",1896,248,75,0,157,73,47,17,2513
"12127080600",1985,568,164,339,99,137,146,129,3567
"12127080700",3630,364,82,0,95,37,26,37,4271
"12127080803",4025,667,87,246,167,595,148,2,5937
"12127080804",4101,1012,312,69,717,22,220,100,6553
"12127080805",4346,368,213,0,768,66,402,2,6165
"12127080806",2241,339,232,0,42,0,0,0,2854
"12127080807",3531,409,235,0,604,0,466,17,5262
"12127080901",2276,714,299,709,251,155,113,27,4544
"12127080902",2024,541,492,101,67,0,12,0,3237
"12127081000",2396,779,222,237,12,14,57,45,3762
"12127081101",1548,190,61,0,12,62,131,41,2045
"12127081102",1545,205,26,0,39,38,120,19,1992
"12127081200",2437,1078,58,26,111,32,260,82,4084
"12127081300",1537,160,34,0,133,75,125,0,2064
"12127081500",844,691,141,274,0,121,12,156,2239
"12127081600",770,508,880,174,42,48,107,276,2805
"12127081700",1616,734,1961,2118,146,177,155,106,7013
"12127081800",428,172,1443,831,206,48,22,16,3166
"12127081900",34,0,1062,1215,0,191,24,166,2692
"12127082000",306,239,356,162,15,17,27,10,1132
"12127082100",98,74,1824,2142,146,76,96,46,4502
"12127082201",1662,483,201,808,47,115,32,193,3541
"12127082202",1067,158,282,16,54,2,91,13,1683
"12127082301",2078,841,1367,829,503,355,397,506,6876
"12127082401",1723,529,430,559,186,223,218,149,4017
"12127082404",1726,456,64,88,166,40,119,12,2671
"12127082405",2654,443,121,221,154,0,203,14,3810
"12127082406",2333,37,277,0,47,0,205,0,2899
"12127082410",4618,677,185,104,185,19,243,22,6053
"12127082411",2690,432,150,0,193,81,183,41,3770
"12127082412",1754,290,316,27,76,0,71,0,2534
"12127082413",2328,259,526,78,306,63,364,62,3986
"12127082414",2515,632,114,32,95,28,44,88,3548
"12127082415",1430,467,263,75,141,281,40,330,3027
"12127082503",4714,1008,0,220,83,0,64,95,6184
"12127082506",3483,648,0,0,185,16,199,0,4531
"12127082507",5797,948,86,66,246,64,115,66,7388
"12127082508",3843,320,248,2,376,0,204,2,4995
"12127082509",3913,144,102,0,0,0,49,0,4208
"12127082510",2927,471,10,4,167,76,116,0,3771
"12127082511",1834,470,0,0,92,0,87,0,2483
"12127082604",1952,467,0,0,240,74,0,0,2733
"12127082605",2875,260,0,0,60,0,139,0,3334
"12127082606",2772,190,0,0,50,30,202,0,3244
"12127082607",1853,252,0,21,47,24,55,0,2252
"12127082701",1675,114,0,0,22,0,42,0,1853
"12127082703",2636,314,0,0,22,0,86,0,3058
"12127082704",1897,260,32,0,16,0,30,0,2235
"12127082705",2013,364,23,0,42,0,99,0,2541
"12127082801",2257,388,0,0,105,11,145,0,2906
"12127082802",3144,493,2,104,6,3,55,92,3899
"12127082902",3998,915,118,0,77,30,106,75,5319
"12127082903",2762,666,820,262,32,20,301,56,4919
"12127082904",4000,504,30,0,14,0,93,0,4641
"12127083003",4400,900,177,26,177,7,28,30,5745
"12127083005",3170,424,100,15,58,26,101,27,3921
"12127083006",5425,398,121,191,59,345,146,118,6803
"12127083007",3684,537,233,42,21,0,39,46,4602
"12127083008",2163,356,0,30,125,12,126,23,2835
"12127083009",3141,522,36,0,307,0,113,0,4119
"12127083203",6141,376,41,219,383,74,235,7,7476
"12127083205",1788,349,26,0,328,27,78,36,2632
"12127083206",665,80,0,16,95,0,16,0,872
"12127083207",5839,425,170,17,184,0,136,53,6824
"12127083208",9637,766,497,2,641,101,575,0,12219
"12127083209",4969,169,174,156,61,62,85,0,5676
"12127090101",2772,533,45,0,345,10,404,131,4240
"12127090102",1807,423,110,54,536,598,618,785,4931
"12127090202",4390,980,509,31,101,42,628,200,6881
"12127090203",3317,907,72,71,1113,339,528,716,7063
"12127090204",5635,626,283,44,214,294,913,53,8062
"12127090303",2119,585,0,156,51,62,413,299,3685
"12127090304",3178,554,42,61,224,306,465,276,5106
"12127090305",2708,391,0,55,38,0,92,33,3317
"12127090306",3022,580,45,0,280,199,141,539,4806
"12127090307",4319,598,519,67,208,179,780,304,6974
"12127090400",3499,616,50,0,141,6,299,6,4617
"12127090500",1104,399,103,30,0,7,50,0,1693
"12127090600",1819,982,1412,721,576,441,446,836,7233
"12127090701",4219,872,237,5,100,0,548,12,5993
"12127090702",2385,696,1107,440,328,26,313,16,5311
"12127090803",3847,655,12,107,149,0,421,142,5333
"12127090804",5045,1572,385,48,461,85,698,682,8976
"12127090805",4484,842,187,0,140,11,339,134,6137
"12127090806",2211,910,228,73,390,92,946,341,5191
"12127090902",7216,1011,437,98,672,107,1367,296,11204
"12127090903",3770,214,23,0,155,0,321,15,4498
"12127090904",4464,390,200,0,92,0,269,69,5484
"12127091001",3922,476,537,19,425,19,600,68,6066
"12127091005",1761,179,92,130,44,0,126,29,2361
"12127091013",5758,800,315,478,670,7,2101,175,10304
"12127091015",2768,1027,294,198,140,30,921,281,5659
"12127091016",3495,1057,391,92,430,345,1265,986,8061
"12127091017",2022,848,243,0,446,33,1100,587,5279
"12127091018",3734,807,391,274,1074,281,1656,394,8611
"12127091019",3214,671,713,129,145,0,660,424,5956
"12127091020",4592,429,818,167,467,41,1308,265,8087
"12127091021",1755,189,89,15,162,37,497,74,2818
"12127091022",5711,884,458,11,463,198,1903,802,10430
"12127091023",2144,354,110,80,570,0,1237,36,4531
"12127091024",5038,301,486,454,706,263,2193,217,9658
"12127091025",2922,622,556,123,583,42,1089,331,6268
"12127091026",4332,1162,460,205,174,116,1126,583,8158
"12127091027",4849,369,377,3,1173,203,2158,179,9311
"12127091028",2961,278,407,61,493,130,1286,109,5725
"12127091029",4035,393,261,0,208,18,682,25,5622
"12127092500",2017,725,653,315,218,277,620,64,4889
"12127990000",0,0,0,0,0,0,0,0,0
"12129010100",3739,570,92,49,75,49,24,0,4598
"12129010201",6813,681,1257,239,441,80,192,17,9720
"12129010202",3508,799,718,87,21,0,98,0,5231
"12129010203",6621,1085,363,0,91,29,317,61,8567
"12129990000",0,0,0,0,0,0,0,0,0
"12131950101",3658,1794,60,62,16,394,36,188,6208
"12131950102",2254,556,0,0,14,0,61,60,2945
"12131950200",2043,634,479,402,312,269,300,218,4657
"12131950301",3875,1350,383,1,421,92,461,72,6655
"12131950302",3865,399,279,154,274,129,223,61,5384
"12131950400",1743,760,115,109,419,32,73,0,3251
"12131950501",2775,899,118,27,281,27,120,4,4251
"12131950502",3226,273,31,6,272,56,255,0,4119
"12131950601",8386,592,63,1,771,0,730,12,10555
"12131950602",2515,140,0,0,0,0,61,0,2716
"12131950603",6503,650,0,0,583,0,213,0,7949
"12131990000",0,0,0,0,0,0,0,0,0
"12133970102",1403,282,35,0,0,0,0,0,1720
"12133970103",2559,405,195,172,55,12,4,6,3408
"12133970104",1559,341,589,344,64,27,75,0,2999
"12133970200",2420,412,88,102,107,62,107,23,3321
"12133970301",1980,310,32,2,13,4,176,10,2527
"12133970302",3012,441,599,383,115,168,114,10,4842
"12133970303",2634,736,196,30,165,86,1,71,3919
"13001950100",2822,372,35,17,44,87,0,87,3464
"13001950200",1601,748,1528,408,70,46,0,266,4667
"13001950300",2540,699,534,176,306,232,385,166,5038
"13001950400",861,192,249,96,0,0,2,10,1410
"13001950500",3159,873,126,89,52,9,537,221,5066
"13003960100",1076,274,368,180,93,278,180,258,2707
"13003960200",2305,612,641,155,383,571,554,703,5924
"13003960300",845,397,40,0,42,0,110,208,1642
"13005970100",2357,530,145,0,205,23,300,33,3593
"13005970201",2082,342,485,433,229,61,213,39,3884
"13005970202",2637,588,277,200,85,0,124,108,4019
"13007960100",861,152,729,488,5,0,6,5,2246
"13007960200",752,5,212,104,8,0,0,0,1081
"13009970100",2616,366,1479,352,20,113,0,113,5059
"13009970200",3372,534,1257,1496,147,175,57,195,7233
"13009970300",3359,419,1620,389,338,58,144,58,6385
"13009970400",1578,1011,1479,461,145,167,58,48,4947
"13009970500",1314,1809,823,835,172,68,0,131,5152
"13009970600",714,674,1400,850,22,103,0,0,3763
"13009970701",373,184,640,1137,14,6,0,0,2354
"13009970702",455,314,707,400,3,13,2,5,1899
"13009970800",3756,543,877,1068,14,0,11,0,6269
"13011970100",4150,861,32,16,131,21,119,348,5678
"13011970200",3820,748,221,77,216,17,17,31,5147
"13011970300",3372,602,52,0,120,15,250,1,4412
"13011970400",2916,612,127,0,142,0,317,41,4155
"13013180103",3299,279,128,0,469,0,153,0,4328
"13013180104",1440,259,155,9,139,0,184,12,2198
"13013180105",1950,250,118,0,225,214,156,109,3022
"13013180106",1862,230,241,28,64,74,76,143,2718
"13013180107",2060,667,165,204,812,22,409,106,4445
"13013180108",2458,384,170,19,262,33,133,10,3469
"13013180203",1721,240,508,225,486,23,554,25,3782
"13013180204",1294,247,581,238,114,119,286,94,2973
"13013180205",2033,1122,490,303,242,72,234,17,4513
"13013180206",2444,260,0,16,213,0,125,0,3058
"13013180301",1870,113,69,0,67,0,200,0,2319
"13013180302",4620,260,190,0,293,44,200,15,5622
"13013180303",3027,274,347,43,239,0,39,90,4059
"13013180401",4235,297,513,116,286,0,156,0,5603
"13013180402",4221,454,1302,44,187,0,810,117,7135
"13013180501",4090,198,661,376,166,10,987,32,6520
"13013180502",3404,772,180,53,317,22,142,149,5039
"13013180503",3667,756,648,91,131,0,37,641,5971
"13015960101",1516,57,0,0,0,0,18,27,1618
"13015960102",8529,547,137,376,48,11,445,0,10093
"13015960200",8345,1612,971,246,504,37,429,277,12421
"13015960300",5323,764,243,143,123,330,200,228,7354
"13015960401",5862,589,1173,282,668,441,1038,566,10619
"13015960402",5482,1433,756,178,320,267,479,0,8915
"13015960500",5145,1251,633,594,152,137,375,378,8665
"13015960600",5427,1316,1376,491,387,0,370,641,10008
"13015960700",4108,419,1354,88,192,56,584,124,6925
"13015960801",2347,728,217,7,167,0,242,0,3708
"13015960802",1654,890,67,1,212,33,200,168,3225
"13015960803",4038,874,83,88,416,82,229,43,5853
"13015960901",2381,708,43,0,48,13,35,86,3314
"13015960902",4436,589,914,39,464,0,321,59,6822
"13015961000",6909,416,122,31,249,55,175,0,7957
"13017960100",1403,615,303,271,14,0,0,0,2606
"13017960200",904,423,196,47,51,10,43,22,1696
"13017960300",1607,657,619,570,28,0,122,148,3751
"13017960400",1155,208,757,1155,212,251,331,266,4335
"13017960500",2781,528,677,1407,251,76,126,8,5854
"13019970100",1125,183,262,126,52,0,34,0,1782
"13019970200",2183,904,300,46,110,119,327,122,4111
"13019970300",2304,508,46,36,188,5,197,5,3289
"13019970400",1624,632,236,350,10,0,0,0,2852
"13019970500",2563,460,146,264,45,173,111,59,3821
"13019970600",2570,875,152,28,111,38,69,0,3843
"13021010100",54,29,637,887,12,34,0,0,1653
"13021010200",1190,229,358,277,15,0,46,0,2115
"13021010300",97,19,481,161,0,0,0,0,758
"13021010400",0,73,859,1130,115,0,0,19,2196
"13021010500",7,66,381,1032,0,56,0,0,1542
"13021010800",794,424,227,38,41,9,57,106,1696
"13021011000",1650,223,1032,1192,174,47,151,47,4516
"13021011100",49,38,719,1054,0,0,18,0,1878
"13021011500",43,11,564,485,5,32,12,0,1152
"13021011701",202,49,1782,694,32,0,28,8,2795
"13021011702",197,33,2718,1006,75,14,0,0,4043
"13021011800",2234,219,515,435,240,43,82,0,3768
"13021011900",726,226,725,196,36,0,0,0,1909
"13021012000",3390,127,894,103,65,9,115,0,4703
"13021012101",1218,38,249,45,28,0,0,0,1578
"13021012102",2917,444,1077,103,586,83,48,243,5501
"13021012200",461,180,624,741,68,0,24,0,2098
"13021012300",292,212,808,1464,20,6,0,121,2923
"13021012400",273,12,1857,1925,0,15,0,0,4082
"13021012500",214,56,1274,1628,65,0,40,0,3277
"13021012600",509,203,2218,1630,122,0,137,0,4819
"13021012700",113,63,729,991,0,141,0,25,2062
"13021012800",407,169,1065,1733,6,16,42,11,3449
"13021012900",278,74,550,1045,52,3,0,1,2003
"13021013101",671,566,2206,2099,51,72,19,429,6113
"13021013102",549,19,2343,1099,0,65,0,0,4075
"13021013201",673,131,3530,1118,151,0,160,0,5763
"13021013202",343,214,1505,1017,8,76,125,236,3524
"13021013302",527,219,2567,675,25,23,0,0,4036
"13021013407",2004,322,1074,339,192,310,154,0,4395
"13021013408",3494,79,802,9,307,27,92,0,4810
"13021013409",2128,139,1049,36,245,141,85,0,3823
"13021013410",4472,63,596,14,86,0,0,0,5231
"13021013411",2507,295,675,140,213,0,38,48,3916
"13021013502",1242,360,156,127,52,0,0,206,2143
"13021013503",1410,396,609,189,414,4,530,272,3824
"13021013504",6034,501,1583,84,285,47,146,61,8741
"13021013603",2329,270,350,0,0,105,89,79,3222
"13021013604",2635,348,1638,312,248,0,109,0,5290
"13021013605",2829,144,1918,275,147,0,250,0,5563
"13021013606",3961,381,1233,19,183,0,0,0,5777
"13021013700",650,195,594,643,25,30,15,11,2163
"13021013800",16,4,966,1066,6,132,12,64,2266
"13021013900",324,333,651,624,45,5,7,71,2060
"13023790100",3600,649,143,211,42,4,8,4,4661
"13023790200",709,122,763,692,99,0,101,0,2486
"13023790300",2821,510,205,665,13,77,9,0,4300
"13025960100",5375,1424,430,0,150,67,135,0,7581
"13025960200",4065,1220,191,83,73,13,85,25,5755
"13025960300",4207,1024,24,3,0,0,137,0,5395
"13027960200",951,88,226,106,182,83,155,62,1853
"13027960300",3115,691,551,595,90,307,86,318,5753
"13027960400",1476,280,916,872,95,0,87,50,3776
"13027960500",789,96,923,753,61,0,61,15,2698
"13027960600",1360,321,494,135,0,0,0,0,2310
"13029920101",3602,756,364,109,136,4,91,0,5062
"13029920102",3029,699,1073,587,134,271,110,132,6035
"13029920301",1479,201,168,21,114,22,123,20,2148
"13029920303",3182,744,1174,215,364,0,236,0,5915
"13029920305",3679,57,355,0,195,87,462,87,4922
"13029920306",7507,252,725,0,709,0,566,0,9759
"13029980000",0,0,0,0,0,0,0,0,0
"13031110100",2340,615,575,258,51,119,6,89,4053
"13031110200",3261,545,1282,1244,418,23,127,38,6938
"13031110300",5034,1038,841,369,300,170,153,395,8300
"13031110401",815,531,1355,413,68,48,61,0,3291
"13031110403",1279,2808,891,1363,53,318,180,99,6991
"13031110404",143,1362,167,990,26,234,26,43,2991
"13031110500",1880,1181,515,704,150,299,123,185,5037
"13031110601",3445,912,1351,797,409,0,136,0,7050
"13031110602",1561,471,827,751,108,127,50,0,3895
"13031110700",5671,1584,1300,869,820,41,503,2,10790
"13031110800",1397,529,505,171,21,5,0,0,2628
"13031110900",4945,804,540,321,110,0,130,0,6850
"13033950100",2104,894,892,1342,176,0,236,55,5699
"13033950200",1452,602,390,253,43,18,86,18,2862
"13033950400",985,145,1936,1757,0,65,0,0,4888
"13033950500",2325,199,1083,1573,100,0,89,0,5369
"13033950700",1300,118,768,525,18,0,17,0,2746
"13033950900",745,76,767,131,40,0,115,9,1883
"13035150100",5908,985,670,364,39,8,83,0,8057
"13035150200",3624,442,1761,909,167,91,317,0,7311
"13035150300",3818,546,1053,328,87,41,160,0,6033
"13037950100",720,168,835,618,106,92,107,92,2738
"13037950200",593,125,723,927,0,82,0,57,2507
"13039010100",1739,188,425,116,54,0,32,5,2559
"13039010200",3239,279,1091,379,150,40,69,49,5296
"13039010301",5688,722,936,589,368,99,269,27,8698
"13039010302",2095,195,867,265,510,17,144,38,4131
"13039010401",8054,681,1529,472,478,72,666,47,11999
"13039010402",4450,207,259,0,262,0,649,0,5827
"13039010403",3061,186,428,247,159,13,83,0,4177
"13039010500",928,221,124,62,251,12,238,50,1886
"13039010601",3835,705,919,554,368,96,228,126,6831
"13039010602",610,71,35,31,90,15,79,1,932
"13039990000",0,0,0,0,0,0,0,0,0
"13043950100",2021,880,975,731,150,74,170,194,5195
"13043950200",2300,619,440,120,139,43,110,218,3989
"13043950300",1099,366,295,62,190,208,329,204,2753
"13045910101",3091,562,1079,738,390,280,62,133,6335
"13045910103",3431,366,923,14,295,0,346,51,5426
"13045910104",5895,1301,1517,442,430,174,358,209,10326
"13045910200",8495,1518,1276,85,0,0,231,0,11605
"13045910300",4526,856,675,29,94,28,191,0,6399
"13045910400",2662,484,97,5,17,8,4,16,3293
"13045910501",2521,1663,921,818,208,115,733,273,7252
"13045910502",513,277,874,484,227,214,514,264,3367
"13045910600",3276,597,726,829,123,702,54,807,7114
"13045910701",5518,808,534,598,473,172,421,112,8636
"13045910702",5612,634,534,209,495,0,375,0,7859
"13045910703",4907,1115,1378,568,200,43,0,204,8415
"13045910800",3217,442,125,3,64,42,107,30,4030
"13045910900",3344,335,234,78,85,0,75,19,4170
"13045911000",3843,634,874,209,465,59,527,304,6915
"13045911100",4721,1395,890,161,57,215,32,408,7879
"13045911200",3897,682,434,344,214,120,32,0,5723
"13047030100",5028,1056,51,2,45,25,47,57,6311
"13047030201",3778,433,59,42,154,32,109,32,4639
"13047030202",5017,431,140,22,450,36,58,7,6161
"13047030301",6564,626,0,3,142,0,238,0,7573
"13047030303",2966,339,37,0,106,0,66,0,3514
"13047030304",3661,150,72,0,47,0,74,0,4004
"13047030401",6150,694,12,0,434,199,239,46,7774
"13047030402",4528,1048,201,94,214,40,235,26,6386
"13047030500",4613,760,355,0,209,15,20,15,5987
"13047030600",4201,911,276,0,93,14,262,0,5757
"13047030700",5940,1234,52,242,306,13,70,0,7857
"13049010100",4682,700,2303,738,114,12,473,0,9022
"13049010200",2301,634,95,0,28,0,88,0,3146
"13051000100",5,3,77,820,9,0,9,1,924
"13051000300",1005,193,18,6,14,24,63,49,1372
"13051000601",12,87,1862,940,49,14,0,0,2964
"13051000900",870,185,35,71,6,25,39,48,1279
"13051001100",671,236,503,555,5,29,21,14,2034
"13051001200",30,50,596,1162,0,0,0,50,1888
"13051001500",348,433,89,261,21,61,23,204,1440
"13051002000",217,319,433,306,10,8,48,13,1354
"13051002100",190,130,1286,685,14,0,0,0,2305
"13051002200",697,197,2519,822,51,67,9,0,4362
"13051002300",52,8,990,996,18,0,0,0,2064
"13051002600",281,159,796,186,18,0,25,5,1470
"13051002700",345,124,1717,706,0,43,33,10,2978
"13051002800",192,45,1371,636,60,20,10,0,2334
"13051002900",2604,192,138,36,78,50,40,22,3160
"13051003000",1646,311,62,19,105,20,72,47,2282
"13051003301",0,16,1530,455,46,12,0,4,2063
"13051003302",127,0,1297,320,6,0,0,0,1750
"13051003400",2033,125,953,559,119,0,59,9,3857
"13051003501",696,121,960,794,11,81,29,9,2701
"13051003502",1386,178,1687,593,121,0,0,22,3987
"13051003601",504,176,1505,789,15,0,201,112,3302
"13051003602",1061,230,2540,665,219,14,58,5,4792
"13051003700",469,54,752,496,19,6,34,0,1830
"13051003800",277,98,1164,560,102,0,17,0,2218
"13051003900",1221,91,1801,644,19,0,0,0,3776
"13051004001",3146,240,703,306,65,0,80,0,4540
"13051004002",1789,355,636,375,235,175,123,90,3778
"13051004100",1213,219,153,243,49,13,29,0,1919
"13051004207",706,297,1619,905,226,101,43,36,3933
"13051004208",1849,265,2065,370,626,51,597,39,5862
"13051004209",1229,135,1278,456,99,361,22,168,3748
"13051004210",1546,223,1460,995,364,69,570,16,5243
"13051004211",2751,472,1158,602,71,0,152,137,5343
"13051004212",3003,265,1037,336,251,22,252,30,5196
"13051004300",986,215,541,0,198,91,226,143,2400
"13051004400",40,9,1463,772,0,13,0,0,2297
"13051004500",191,27,2878,882,0,0,4,27,4009
"13051010101",305,14,52,438,31,0,3,0,843
"13051010102",1778,209,654,274,154,43,330,94,3536
"13051010200",1566,248,2010,481,540,0,23,0,4868
"13051010501",1816,1561,660,124,451,390,725,1006,6733
"13051010502",762,115,1722,869,43,21,17,0,3549
"13051010601",1362,443,1532,581,40,310,95,459,4822
"13051010603",580,147,735,99,96,12,10,12,1691
"13051010605",10,0,0,0,0,0,0,0,10
"13051010700",7272,1160,6390,490,1768,118,1499,20,18717
"13051010801",2057,303,222,25,61,12,111,42,2833
"13051010802",5596,400,2364,243,603,12,539,54,9811
"13051010803",6126,869,2499,690,485,19,431,0,11119
"13051010806",2898,735,1466,292,701,93,296,78,6559
"13051010807",2673,268,1279,1,421,0,353,0,4995
"13051010808",3793,909,3477,163,583,700,554,934,11113
"13051010809",6821,484,3434,370,524,96,632,120,12481
"13051010901",1300,550,1637,461,115,99,212,329,4703
"13051011003",4562,826,644,29,200,12,304,96,6673
"13051011004",3087,100,54,20,134,0,52,0,3447
"13051011005",4028,84,55,0,216,0,111,0,4494
"13051011006",3277,114,16,0,44,0,68,0,3519
"13051011103",2815,452,3,0,92,0,134,42,3538
"13051011104",4192,447,149,1,373,15,81,0,5258
"13051011106",4137,463,320,7,427,352,186,0,5892
"13051011107",2841,49,68,0,98,0,85,10,3151
"13051011108",2712,92,78,1,200,24,22,0,3129
"13051011109",5942,206,268,0,446,160,275,21,7318
"13051011200",958,439,31,153,8,100,30,22,1741
"13051011300",503,641,495,315,37,61,32,17,2101
"13051011400",600,464,695,498,43,0,26,20,2346
"13051011500",1819,159,509,60,89,0,40,0,2676
"13051011600",144,78,1575,515,101,15,131,93,2652
"13051980000",0,0,0,0,0,0,0,0,0
"13051990000",0,0,0,0,0,0,0,0,0
"13053020100",1227,322,814,60,249,71,16,21,2780
"13053020201",925,49,39,0,195,0,202,4,1414
"13053020203",1319,29,162,18,118,9,291,24,1970
"13053020205",2108,62,534,55,195,107,777,17,3855
"13053020206",0,0,0,0,0,0,0,0,0
"13055010100",1583,271,82,37,34,5,30,5,2047
"13055010200",4453,1320,188,32,282,87,471,345,7178
"13055010300",2113,453,8,28,41,38,0,12,2693
"13055010400",3375,1382,203,111,32,83,0,0,5186
"13055010500",2857,844,638,267,54,0,88,28,4776
"13055010600",1745,617,158,8,27,23,74,16,2668
"13057090100",7492,659,121,7,234,23,307,4,8847
"13057090200",6154,612,165,48,235,172,82,93,7561
"13057090300",10738,930,348,69,452,26,381,50,12994
"13057090400",6138,961,1167,172,528,524,1167,833,11490
"13057090501",5400,593,100,0,144,44,227,44,6552
"13057090502",11094,1664,23,2,741,17,1078,820,15439
"13057090601",4655,831,220,1,316,737,776,1233,8769
"13057090602",6045,653,389,665,853,103,1195,175,10078
"13057090701",14920,1339,953,320,1316,6,1059,90,20003
"13057090702",5904,722,216,232,368,61,825,42,8370
"13057090802",5627,351,64,314,250,68,328,68,7070
"13057090803",8159,712,359,0,610,71,360,90,10361
"13057090804",7623,502,411,3,561,227,258,494,10079
"13057090901",6386,653,501,128,285,6,567,41,8567
"13057090902",11411,376,275,101,1597,20,1213,58,15051
"13057090904",5394,835,288,41,1012,468,848,442,9328
"13057090905",2779,187,309,0,246,42,271,0,3834
"13057091001",2699,146,730,215,371,0,517,0,4678
"13057091003",4777,853,842,86,439,161,1471,206,8835
"13057091005",6305,1056,619,0,167,0,689,660,9496
"13057091006",4166,149,197,93,124,0,254,0,4983
"13057091007",5593,232,159,0,229,0,176,45,6434
"13057091008",6767,277,626,0,665,0,281,0,8616
"13057091101",4289,235,390,98,303,68,94,38,5515
"13057091102",6454,1068,909,37,367,0,900,404,10139
"13057091103",6606,603,762,0,429,0,477,46,8923
"13059000100",220,1308,2,95,20,97,12,60,1814
"13059000401",168,174,65,53,256,255,21,5,997
"13059000402",107,639,9,6,3,110,23,7,904
"13059000600",782,935,170,243,9,95,88,161,2483
"13059000900",228,265,1142,1535,89,0,0,90,3349
"13059001200",1987,286,183,131,54,28,47,31,2747
"13059001700",1249,202,464,32,91,0,52,20,2110
"13059001800",1650,282,53,33,157,0,114,0,2289
"13059001900",1835,1212,298,583,13,82,202,64,4289
"13059002000",1356,470,120,109,65,6,8,25,2159
"13059002100",1263,1334,31,32,285,90,0,32,3067
"13059002200",1192,848,22,47,59,58,63,85,2374
"13059030100",775,1290,1339,943,244,80,87,0,4758
"13059030200",353,541,1934,967,58,128,5,0,3986
"13059130300",2374,1015,1392,1064,229,59,1427,941,8501
"13059130400",2946,569,1917,178,154,126,449,127,6466
"13059130500",1320,104,690,329,73,0,58,0,2574
"13059130600",3023,1224,794,592,300,413,480,614,7440
"13059130700",3037,696,869,152,567,32,350,119,5822
"13059140300",1583,745,1909,608,11,310,458,701,6325
"13059140400",1104,1513,516,273,130,357,487,1501,5881
"13059140500",481,251,677,347,13,23,293,138,2223
"13059140600",2697,400,840,445,326,21,485,162,5376
"13059150300",1624,444,394,334,302,87,347,37,3569
"13059150400",749,3192,73,250,100,493,70,152,5079
"13059150500",1874,1877,267,194,92,235,360,24,4923
"13059150600",1160,679,340,439,483,48,315,108,3572
"13059150700",3334,585,626,662,429,52,272,20,5980
"13059150800",3423,544,1015,492,419,163,62,279,6397
"13059150900",2222,560,574,184,231,13,81,0,3865
"13061960300",706,205,766,1193,182,0,138,0,3190
"13063040202",112,9,1250,769,256,179,20,147,2742
"13063040203",154,0,2112,912,81,20,108,92,3479
"13063040204",46,207,2332,993,33,0,231,9,3851
"13063040302",1153,322,1786,1011,591,169,763,441,6236
"13063040303",1121,1167,2493,1651,354,354,281,1231,8652
"13063040306",812,899,900,616,523,334,821,1101,6006
"13063040307",1216,261,1055,350,1191,224,584,234,5115
"13063040308",1305,693,1043,564,414,368,961,762,6110
"13063040407",753,107,1658,294,961,179,647,138,4737
"13063040408",1347,261,2758,938,1589,315,544,26,7778
"13063040409",1086,296,2580,276,1181,216,739,101,6475
"13063040410",1360,1100,2822,385,402,360,283,1185,7897
"13063040411",1840,133,8889,978,384,393,325,282,13224
"13063040412",1581,82,3551,1184,1326,276,711,22,8733
"13063040413",1149,637,3274,1410,843,60,671,380,8424
"13063040414",855,133,382,131,187,8,589,122,2407
"13063040415",928,461,2128,1486,263,721,703,946,7636
"13063040416",811,541,1676,276,468,160,489,328,4749
"13063040417",263,151,2070,1395,234,297,261,313,4984
"13063040509",329,145,3548,516,101,60,111,158,4968
"13063040510",301,138,2070,422,258,137,184,28,3538
"13063040512",416,54,3097,999,134,166,97,10,4973
"13063040513",371,16,3416,714,595,0,17,0,5129
"13063040514",882,337,4602,810,0,466,593,714,8404
"13063040515",1174,130,4430,1395,484,319,782,267,8981
"13063040516",486,333,2405,2133,658,89,607,368,7079
"13063040518",683,319,2254,1290,161,338,240,417,5702
"13063040519",102,36,2663,1296,81,127,41,157,4503
"13063040520",77,80,1941,1109,35,32,77,106,3457
"13063040521",768,38,1628,664,253,102,197,71,3721
"13063040522",500,280,1919,1045,396,102,158,241,4641
"13063040523",237,53,1470,669,857,98,434,149,3967
"13063040524",1055,276,4113,1153,727,45,842,288,8499
"13063040525",228,3,1988,561,68,0,116,0,2964
"13063040526",418,272,3114,1687,60,153,222,212,6138
"13063040606",1102,142,1025,218,20,303,460,294,3564
"13063040608",1825,84,7500,1157,110,144,361,22,11203
"13063040609",1848,104,3303,232,567,75,509,23,6661
"13063040611",1703,426,2311,1104,222,242,753,475,7236
"13063040612",1179,223,1825,1031,450,328,310,214,5560
"13063040613",2362,303,3850,1013,145,133,177,156,8139
"13063040614",2231,154,1181,209,631,80,257,44,4787
"13063040615",262,42,1436,135,209,1,202,0,2287
"13063040616",632,418,4484,1924,364,79,420,381,8702
"13063040617",936,187,0,16,343,120,895,191,2688
"13063040619",515,0,1866,483,237,105,256,82,3544
"13063040620",708,119,1712,596,156,0,134,284,3709
"13063040621",1365,404,6369,1009,364,40,354,303,10208
"13063040622",981,551,4288,851,659,573,657,739,9299
"13063980000",0,0,0,0,0,0,0,0,0
"13065970100",2926,858,594,576,40,272,30,214,5510
"13065970200",573,122,152,478,67,0,24,0,1416
"13067030101",5895,517,296,234,359,23,421,0,7745
"13067030103",5708,390,1888,499,755,80,519,99,9938
"13067030104",2076,130,785,146,454,25,471,0,4087
"13067030106",3134,696,2171,222,1152,195,854,214,8638
"13067030107",2297,92,1614,70,486,111,396,0,5066
"13067030209",4691,52,1351,39,437,0,380,0,6950
"13067030214",6096,431,1127,3,785,0,637,78,9157
"13067030215",5895,787,900,65,1079,435,713,730,10604
"13067030218",4299,168,714,0,420,0,397,36,6034
"13067030219",7570,419,758,0,573,0,447,0,9767
"13067030220",1290,0,308,63,149,0,123,0,1933
"13067030222",4637,449,423,48,285,28,243,34,6147
"13067030223",3489,117,1548,119,368,0,456,0,6097
"13067030224",3720,206,1473,91,653,75,530,36,6784
"13067030226",5756,322,1349,24,729,350,866,0,9396
"13067030227",3691,270,2329,118,1182,88,995,47,8720
"13067030228",4051,1236,1146,313,250,83,663,220,7962
"13067030229",1671,421,123,6,85,200,66,200,2772
"13067030230",7670,492,2335,1513,1053,65,1845,150,15123
"13067030231",6183,164,399,59,481,0,202,0,7488
"13067030232",3369,41,1782,38,476,16,734,0,6456
"13067030233",2924,22,904,133,236,0,309,0,4528
"13067030234",4353,136,978,32,299,0,158,0,5956
"13067030235",3879,192,534,0,253,0,233,0,5091
"13067030236",4054,83,362,5,159,0,82,0,4745
"13067030238",4989,399,833,105,375,55,91,26,6873
"13067030239",6866,461,458,0,294,167,349,376,8971
"13067030310",5584,1236,849,19,421,0,643,443,9195
"13067030311",5001,231,222,148,460,14,211,103,6390
"13067030312",4709,302,425,7,699,0,333,56,6531
"13067030313",5491,330,1325,7,817,0,262,0,8232
"13067030314",5778,291,752,79,1013,74,643,38,8668
"13067030318",6750,224,355,0,645,15,69,0,8058
"13067030319",3681,125,51,0,276,93,96,0,4322
"13067030320",5295,380,884,180,897,88,361,48,8133
"13067030322",2503,97,376,0,244,0,183,0,3403
"13067030324",3007,136,146,2,227,71,180,0,3769
"13067030326",3647,125,102,22,690,37,357,113,5093
"13067030327",3313,77,352,17,514,84,86,18,4461
"13067030328",5620,38,318,2,228,0,373,0,6579
"13067030329",3361,186,395,10,450,74,67,16,4559
"13067030330",4018,23,681,20,876,67,130,0,5815
"13067030331",4774,106,301,2,537,20,318,11,6069
"13067030332",2825,63,142,14,390,12,106,0,3552
"13067030333",4689,244,347,18,848,0,244,0,6390
"13067030334",2618,67,111,100,422,0,45,0,3363
"13067030335",4074,111,110,116,177,31,175,0,4794
"13067030336",6105,341,186,0,846,0,361,39,7878
"13067030337",3898,168,108,0,291,0,212,0,4677
"13067030339",2902,318,1294,73,954,58,381,31,6011
"13067030340",3278,0,253,0,323,0,369,0,4223
"13067030341",3480,196,581,0,305,9,221,61,4853
"13067030342",4136,116,365,1,347,0,151,17,5133
"13067030343",3907,52,125,0,524,0,242,0,4850
"13067030344",919,222,1569,433,289,190,195,148,3965
"13067030345",1131,419,931,292,1859,323,871,556,6382
"13067030405",2999,333,1724,339,483,404,220,267,6769
"13067030407",3206,337,515,20,567,14,380,20,5059
"13067030408",1841,211,353,74,534,183,243,127,3566
"13067030409",2553,143,282,0,400,145,98,0,3621
"13067030410",3000,439,748,150,477,106,828,0,5748
"13067030411",548,191,1481,973,198,376,453,406,4626
"13067030412",598,286,1682,613,347,526,449,508,5009
"13067030413",1986,511,1564,382,709,949,737,638,7476
"13067030414",378,125,1354,692,341,18,400,70,3378
"13067030502",4438,232,1122,20,722,0,523,19,7076
"13067030504",3932,418,794,660,840,129,1073,195,8041
"13067030505",2449,496,1816,491,1023,175,1021,110,7581
"13067030506",2510,210,795,41,479,39,482,67,4623
"13067030507",3446,341,543,19,563,0,365,0,5277
"13067030601",3764,794,2270,261,1056,707,641,185,9678
"13067030602",5313,408,245,70,246,0,211,0,6493
"13067030700",1058,391,1085,314,517,173,616,236,4390
"13067030800",1970,636,391,135,176,246,991,632,5177
"13067030901",4777,402,1073,491,309,139,340,144,7675
"13067030902",3074,377,616,185,715,388,1381,472,7208
"13067030904",1902,827,1737,879,712,330,1458,1166,9011
"13067030905",1745,434,1789,403,801,635,995,826,7628
"13067031001",1552,1133,846,411,464,668,1052,1497,7623
"13067031002",2137,874,2041,1175,1687,843,2668,1116,12541
"13067031004",2677,1159,2007,795,949,191,1925,757,10460
"13067031005",1967,665,1359,261,907,420,1140,658,7377
"13067031101",1484,565,598,650,561,372,675,714,5619
"13067031106",3675,506,2395,502,930,124,809,220,9161
"13067031108",2099,289,1680,688,357,132,417,163,5825
"13067031110",2072,616,744,347,161,0,470,530,4940
"13067031111",2177,32,501,40,490,73,279,40,3632
"13067031112",3060,20,1412,39,464,209,320,209,5733
"13067031113",202,139,226,123,43,107,112,112,1064
"13067031114",2484,766,2345,526,1096,454,1311,791,9773
"13067031115",1187,494,1089,774,858,218,726,641,5987
"13067031116",1197,338,1418,697,866,564,1131,721,6932
"13067031117",3207,297,353,307,471,131,420,156,5342
"13067031118",2842,151,965,201,986,37,191,19,5392
"13067031205",3450,188,1629,213,310,52,527,71,6440
"13067031206",4253,360,3569,80,1272,7,325,0,9866
"13067031207",1781,177,730,46,379,14,113,0,3240
"13067031208",2691,420,1269,169,1783,0,266,69,6667
"13067031209",3188,160,374,0,449,0,207,45,4423
"13067031211",1717,225,1393,254,518,0,609,0,4716
"13067031212",2161,36,53,0,90,0,37,0,2377
"13067031306",1918,475,1272,358,61,75,264,133,4556
"13067031307",3484,222,1181,421,401,17,491,13,6230
"13067031308",1763,288,1936,1057,184,143,767,468,6606
"13067031309",2587,577,3666,698,430,90,1483,270,9801
"13067031310",835,671,3002,1730,604,433,1122,1135,9532
"13067031311",1429,912,4366,1748,1028,66,1229,610,11388
"13067031312",3001,761,4165,690,623,321,842,870,11273
"13067031313",5446,160,3399,178,1173,0,1079,67,11502
"13067031404",2863,505,2280,175,170,0,462,193,6648
"13067031405",3216,546,3078,710,379,317,945,635,9826
"13067031406",2127,351,3196,950,114,14,696,53,7501
"13067031408",1599,219,3147,591,208,7,223,24,6018
"13067031409",1526,682,1645,965,266,85,435,341,5945
"13067031503",2988,845,4043,530,765,3,634,521,10329
"13067031505",2394,269,2151,617,256,0,182,9,5878
"13067031506",1856,410,1773,188,700,99,703,275,6004
"13067031507",672,215,1514,761,83,70,162,216,3693
"13067031508",2333,177,1700,46,355,0,233,39,4883
"13067031509",3495,627,4658,375,505,0,512,141,10313
"13069010100",2412,404,289,144,48,22,103,80,3502
"13069010200",2037,846,56,0,96,119,155,387,3696
"13069010300",1756,688,249,300,262,22,262,56,3595
"13069010400",2708,351,552,861,448,58,252,0,5230
"13069010500",1791,442,252,415,106,280,130,431,3847
"13069010600",4265,443,416,36,142,33,140,85,5560
"13069010700",2618,984,917,246,290,874,441,1119,7489
"13069010801",1976,543,1977,419,143,312,227,243,5840
"13069010802",1437,633,1830,763,53,17,224,17,4974
"13071970100",3309,941,550,58,255,52,583,240,5988
"13071970200",2086,179,136,210,107,88,46,73,2925
"13071970300",1337,317,1123,2015,180,0,229,126,5327
"13071970400",1507,738,377,444,9,41,256,272,3644
"13071970500",2531,239,174,79,235,102,637,163,4160
"13071970600",4472,733,282,96,554,153,874,625,7789
"13071970701",4070,761,686,1061,28,311,278,619,7814
"13071970702",534,852,621,209,114,55,293,453,3131
"13071970800",1323,516,658,608,0,0,235,316,3656
"13071970900",4210,789,708,226,350,575,807,820,8485
"13073030102",7692,189,430,0,1579,11,310,0,10211
"13073030103",2389,86,309,0,393,0,164,0,3341
"13073030105",3970,219,783,0,626,109,181,0,5888
"13073030106",2897,419,259,189,219,87,108,29,4207
"13073030201",4048,151,1274,52,378,0,56,68,6027
"13073030202",2105,367,532,8,241,42,206,71,3572
"13073030203",4543,366,844,42,369,0,80,14,6258
"13073030302",7747,256,1148,241,682,167,490,103,10834
"13073030304",5173,133,1008,109,339,108,297,32,7199
"13073030306",3756,76,823,129,144,103,139,0,5170
"13073030307",5617,138,803,46,176,0,137,0,6917
"13073030308",6895,200,1044,99,834,0,396,0,9468
"13073030309",7757,350,1761,1,577,53,286,26,10811
"13073030401",1487,145,293,237,31,8,51,0,2252
"13073030402",5861,1109,1351,31,600,25,690,214,9881
"13073030503",4935,1253,895,555,94,143,351,32,8258
"13073030504",2415,360,399,142,46,7,79,197,3645
"13073030505",3613,734,1449,74,238,337,901,435,7781
"13073030506",6344,792,2282,557,791,488,690,624,12568
"13073030603",2827,468,758,419,137,166,20,13,4808
"13075960100",1317,456,192,97,34,8,74,49,2227
"13075960200",2016,460,577,820,14,36,189,49,4161
"13075960300",3440,584,1002,471,314,75,317,0,6203
"13075960400",2776,600,959,549,0,89,218,114,5305
"13077170100",4704,1360,626,85,248,250,206,0,7479
"13077170200",4528,791,521,345,387,0,76,123,6771
"13077170303",4319,193,226,210,250,0,87,0,5285
"13077170304",5096,67,1114,113,175,28,272,59,6924
"13077170305",4482,1935,1660,867,585,61,1038,943,11571
"13077170306",4920,341,1334,619,507,267,643,71,8702
"13077170402",7421,606,1263,14,93,101,758,294,10550
"13077170403",3655,119,258,0,219,0,193,0,4444
"13077170404",5145,99,327,0,409,0,221,0,6201
"13077170405",5876,468,491,72,440,13,651,59,8070
"13077170406",3241,77,192,0,50,0,14,0,3574
"13077170501",5261,384,447,83,200,49,551,52,7027
"13077170502",4702,572,433,104,179,0,138,0,6128
"13077170503",4346,536,723,113,207,0,310,8,6243
"13077170601",2684,571,2475,1551,114,19,497,236,8147
"13077170602",6701,296,1136,0,599,13,311,13,9069
"13077170603",4109,430,531,132,256,0,323,37,5818
"13077170700",2397,288,2586,1150,159,155,143,38,6916
"13077170801",3843,656,748,274,121,11,100,155,5908
"13077170802",3510,416,213,45,174,64,149,9,4580
"13079070100",1782,266,1106,336,12,38,0,2,3542
"13079070201",4176,606,297,75,98,24,120,0,5396
"13079070202",2007,370,537,423,205,0,13,0,3555
"13081010100",2069,289,830,1344,135,71,119,22,4879
"13081010201",2733,171,547,1138,9,0,83,0,4681
"13081010202",938,163,1012,888,82,95,25,95,3298
"13081010300",1959,826,666,332,37,15,15,164,4014
"13081010400",1917,57,1291,1511,114,119,221,0,5230
"13081010500",1119,170,162,65,0,7,0,0,1523
"13083040101",3527,585,59,0,145,55,61,11,4443
"13083040102",3148,523,0,0,31,0,77,39,3818
"13083040200",3562,583,7,0,76,18,12,6,4264
"13083040300",2472,317,0,3,150,10,49,0,3001
"13085970100",6007,1263,9,13,183,64,104,22,7665
"13085970201",5581,1101,28,0,368,0,462,0,7540
"13085970202",6122,1021,0,0,373,36,228,36,7816
"13087970100",2500,302,319,110,143,109,16,116,3615
"13087970200",1492,448,282,329,23,120,23,216,2933
"13087970300",2145,451,1945,925,196,0,187,0,5849
"13087970400",1203,349,1225,1854,83,37,73,0,4824
"13087970600",2808,537,829,786,120,145,143,0,5368
"13087970700",905,149,232,156,353,0,494,0,2289
"13087970800",522,189,1057,742,108,50,111,80,2859
"13089020100",1655,64,20,0,114,0,32,49,1934
"13089020200",1725,122,21,22,89,29,143,0,2151
"13089020300",2945,173,208,87,342,12,180,0,3947
"13089020400",2093,115,72,30,141,0,62,0,2513
"13089020500",979,78,1286,329,250,0,206,0,3128
"13089020600",596,60,590,535,86,0,36,4,1907
"13089020700",868,122,591,387,71,21,5,12,2077
"13089020801",1252,82,906,243,80,0,86,0,2649
"13089020802",1489,99,1963,552,124,13,109,134,4483
"13089020900",2057,155,2624,500,92,65,91,65,5649
"13089021101",3047,10,392,45,266,37,126,0,3923
"13089021102",3496,385,344,30,289,0,207,0,4751
"13089021202",5787,315,348,39,537,0,292,32,7350
"13089021204",1593,1002,21,56,840,890,2282,1502,8186
"13089021208",2252,353,387,31,748,384,237,389,4781
"13089021209",3704,374,330,107,950,144,221,39,5869
"13089021210",4757,127,69,2,486,0,94,0,5535
"13089021211",3995,52,78,0,492,15,168,0,4800
"13089021213",3349,112,0,0,113,0,88,11,3673
"13089021214",5544,348,123,0,168,86,291,86,6646
"13089021215",2515,93,327,102,2562,27,201,8,5835
"13089021216",4796,408,1008,655,1528,133,350,439,9317
"13089021217",1485,176,271,80,358,10,65,37,2482
"13089021218",2221,291,1408,80,806,30,274,0,5110
"13089021301",1406,416,766,258,726,60,988,113,4733
"13089021303",2541,1216,492,225,1511,549,2526,1279,10339
"13089021305",1718,985,625,151,980,774,973,1506,7712
"13089021306",2528,641,689,59,811,288,1943,571,7530
"13089021307",1946,698,435,104,878,364,1044,533,6002
"13089021308",1698,677,300,32,684,365,1021,814,5591
"13089021405",3066,475,218,3,318,137,341,270,4828
"13089021409",709,814,527,308,291,333,477,1026,4485
"13089021410",2615,772,269,73,273,491,1191,1202,6886
"13089021411",2834,117,114,156,290,15,292,0,3818
"13089021412",3085,90,76,69,249,0,359,0,3928
"13089021413",1875,748,356,159,1091,460,2194,1111,7994
"13089021414",1410,372,841,140,369,698,993,957,5780
"13089021415",2420,442,276,107,664,90,446,325,4770
"13089021416",1395,459,100,43,370,255,902,727,4251
"13089021417",2399,599,454,142,644,1166,2102,1429,8935
"13089021502",2502,735,704,67,337,277,246,67,4935
"13089021503",2186,224,376,8,958,160,979,94,4985
"13089021504",2854,913,162,81,393,219,154,105,4881
"13089021602",3040,343,195,23,501,113,224,11,4450
"13089021603",2909,178,607,108,515,60,261,22,4660
"13089021604",2589,18,277,11,192,0,148,0,3235
"13089021605",2984,403,499,388,402,441,440,514,6071
"13089021703",3875,177,58,0,449,153,296,0,5008
"13089021704",3973,168,169,36,704,169,86,0,5305
"13089021705",1968,344,1145,303,671,391,545,382,5749
"13089021706",3888,258,811,86,909,252,367,250,6821
"13089021805",3421,110,1337,252,737,400,688,195,7140
"13089021806",2379,145,1323,890,511,375,944,64,6631
"13089021808",2713,733,640,121,570,66,237,354,5434
"13089021809",4927,293,704,28,403,258,399,15,7027
"13089021810",3517,69,894,326,469,57,314,0,5646
"13089021812",1319,358,243,6,320,40,289,299,2874
"13089021813",570,352,1008,615,73,209,571,554,3952
"13089021814",2353,795,1118,607,816,243,2077,809,8818
"13089021906",661,139,3281,779,437,88,184,92,5661
"13089021907",1879,76,5256,804,317,60,320,0,8712
"13089021908",350,339,2946,1671,246,59,96,64,5771
"13089021909",1012,169,2722,1610,281,9,141,72,6016
"13089021910",722,41,2903,611,459,39,134,1,4910
"13089021911",24,5,1056,1162,0,0,33,15,2295
"13089021912",1929,124,984,151,322,0,49,0,3559
"13089021913",174,375,2973,908,77,14,123,408,5052
"13089022001",2760,367,518,306,166,458,350,0,4925
"13089022004",613,212,3411,1343,717,36,37,0,6369
"13089022005",530,108,2270,603,151,451,81,9,4203
"13089022007",275,146,1661,563,246,990,32,45,3958
"13089022008",819,259,1862,1656,1906,1934,56,196,8688
"13089022009",222,282,3377,1814,75,253,0,0,6023
"13089022010",432,14,452,380,443,850,83,0,2654
"13089022100",531,81,1364,1504,325,0,174,20,3999
"13089022203",753,168,386,90,323,116,54,68,1958
"13089022204",1743,682,643,356,1637,796,634,0,6491
"13089022301",4160,545,376,104,480,291,124,177,6257
"13089022302",2716,472,343,177,605,139,376,159,4987
"13089022401",3609,307,27,0,159,195,38,17,4352
"13089022402",668,194,50,17,198,115,18,6,1266
"13089022403",3473,223,43,1,162,19,73,28,4022
"13089022500",3288,209,284,1555,272,57,180,0,5845
"13089022600",4381,299,500,60,300,195,223,37,5995
"13089022700",2928,95,614,300,219,21,94,0,4271
"13089022800",2173,125,587,165,315,0,58,0,3423
"13089022900",1999,150,733,179,320,5,142,0,3528
"13089023000",1610,126,126,56,126,0,11,0,2055
"13089023101",822,73,2471,1185,154,118,100,118,5041
"13089023102",1074,73,1549,604,97,0,79,21,3497
"13089023107",690,279,2589,924,120,85,27,228,4942
"13089023108",182,258,2240,2001,85,45,60,190,5061
"13089023111",165,12,1219,454,80,0,73,12,2015
"13089023112",92,216,1863,1693,141,118,120,219,4462
"13089023113",612,235,1497,698,166,0,84,103,3395
"13089023114",442,37,1358,261,159,76,49,0,2382
"13089023115",0,1,0,0,0,0,0,0,1
"13089023204",809,158,4955,997,115,139,300,11,7484
"13089023206",495,41,5342,1381,245,106,214,1,7825
"13089023208",410,75,4614,1143,230,89,62,51,6674
"13089023209",632,6,4008,623,250,3,452,6,5980
"13089023210",222,33,4996,1270,303,1,67,0,6892
"13089023211",47,2,2649,181,144,45,16,78,3162
"13089023212",84,79,3206,326,51,11,26,0,3783
"13089023213",125,62,4605,853,339,86,25,29,6124
"13089023214",110,23,4440,1061,43,0,56,63,5796
"13089023303",328,197,3524,1333,1068,82,667,109,7308
"13089023306",133,2,5875,686,247,75,570,0,7588
"13089023309",269,28,7020,1827,558,0,221,20,9943
"13089023310",86,2,6200,2763,76,89,11,112,9339
"13089023311",148,89,3496,825,83,27,17,0,4685
"13089023312",414,164,6916,1586,177,31,267,148,9703
"13089023313",20,123,3252,1143,222,37,0,0,4797
"13089023314",141,2,4406,670,70,0,88,0,5377
"13089023315",230,6,3905,377,122,1,16,0,4657
"13089023316",151,8,6619,371,517,0,360,0,8026
"13089023410",42,0,1912,1080,0,20,17,9,3080
"13089023411",150,65,2808,742,36,0,41,65,3907
"13089023412",57,260,4853,1117,224,12,51,0,6574
"13089023413",145,38,3016,204,69,9,76,33,3590
"13089023414",57,53,4638,1360,151,332,19,0,6610
"13089023416",91,13,6521,799,154,105,34,31,7748
"13089023418",498,136,14714,2195,196,0,335,48,18122
"13089023419",58,3,7297,1262,203,1,82,0,8906
"13089023421",516,2,5483,1686,313,154,11,24,8189
"13089023422",69,1,4014,735,176,0,143,0,5138
"13089023423",311,25,6436,706,188,1,128,55,7850
"13089023424",218,83,4937,524,64,0,179,0,6005
"13089023425",72,0,4681,680,120,0,33,0,5586
"13089023426",43,2,4178,540,56,0,45,0,4864
"13089023427",22,1,2256,309,105,9,0,0,2702
"13089023428",79,1,6574,2618,56,70,0,29,9427
"13089023501",209,83,1713,1112,18,10,23,18,3186
"13089023504",51,41,1823,1357,0,115,8,126,3521
"13089023505",109,16,1878,356,65,27,0,1,2452
"13089023506",243,24,4064,1025,206,0,0,12,5574
"13089023507",92,214,3050,611,37,37,21,131,4193
"13089023601",603,77,1430,420,49,1,22,0,2602
"13089023602",97,53,1756,372,42,35,11,8,2374
"13089023603",235,36,2206,839,49,47,15,0,3427
"13089023700",859,73,2472,1584,98,31,70,144,5331
"13089023801",1001,79,1883,464,115,0,79,0,3621
"13089023802",580,98,1550,927,123,87,85,0,3450
"13089023803",885,113,3410,1018,168,100,336,138,6168
"13089980000",0,0,0,0,0,0,0,0,0
"13091960100",1502,152,187,102,8,4,76,0,2031
"13091960200",1941,746,317,206,121,7,115,101,3554
"13091960300",3476,135,1789,580,256,192,0,165,6593
"13091960400",1788,569,642,376,131,0,133,0,3639
"13091960500",1360,233,247,150,11,26,15,0,2042
"13091960600",1526,185,201,116,10,0,31,18,2087
"13093970100",1914,484,1109,609,4,0,48,109,4277
"13093970200",645,297,662,476,232,49,267,118,2746
"13093970300",2185,537,2139,999,36,0,37,315,6248
"13095000100",496,253,2103,1960,222,62,113,64,5273
"13095000200",0,37,1262,1599,90,149,39,184,3360
"13095000400",2199,432,2145,945,95,0,64,8,5888
"13095000501",1839,341,1972,344,230,262,95,0,5083
"13095000502",3004,185,1047,163,432,0,283,0,5114
"13095000600",1395,243,579,60,40,18,0,17,2352
"13095000700",841,277,513,217,0,0,25,54,1927
"13095000800",97,55,345,1050,12,16,12,10,1597
"13095000900",611,87,754,735,35,12,10,0,2244
"13095001000",292,153,875,684,53,11,20,0,2088
"13095001100",216,113,3524,2415,28,20,24,0,6340
"13095001403",0,0,1365,1236,0,11,0,0,2612
"13095001500",16,5,828,1979,0,113,0,175,3116
"13095010302",195,24,2555,1958,67,53,9,29,4890
"13095010401",3994,122,2575,83,267,0,85,66,7192
"13095010402",581,74,1632,602,46,9,66,0,3010
"13095010403",949,79,349,337,30,7,11,0,1762
"13095010500",431,133,1321,303,75,8,69,0,2340
"13095010601",104,53,1294,1122,35,0,0,7,2615
"13095010602",394,95,2163,1542,24,1,0,0,4219
"13095010700",500,405,1890,2211,86,47,88,212,5439
"13095010900",418,36,921,128,38,9,0,0,1550
"13095011000",1316,231,1007,91,42,13,49,0,2749
"13095011200",973,334,1461,1082,45,109,11,185,4200
"13095011300",913,63,436,664,42,37,45,0,2200
"13095011400",12,54,779,589,0,75,10,24,1543
"13095011600",917,115,731,80,0,65,22,74,2004
"13097080102",1191,663,4044,356,414,466,376,577,8087
"13097080103",1975,712,2868,873,163,94,334,465,7484
"13097080201",3453,405,987,599,347,279,977,279,7326
"13097080202",4063,425,3477,1151,880,161,1718,16,11891
"13097080301",1685,664,6338,2573,218,403,337,339,12557
"13097080303",1498,198,1077,632,326,0,550,63,4344
"13097080304",2155,242,1152,713,102,147,168,79,4758
"13097080402",6852,406,777,67,74,44,290,12,8522
"13097080403",2660,389,943,222,232,13,62,13,4534
"13097080404",4862,908,2411,128,328,34,907,150,9728
"13097080505",2575,1153,1038,265,207,0,111,339,5688
"13097080506",3558,333,942,95,240,22,442,9,5641
"13097080507",2256,195,478,303,314,15,421,0,3982
"13097080508",2988,235,1781,18,254,87,588,17,5968
"13097080509",3213,36,1210,470,132,21,144,0,5226
"13097080510",3698,1080,2184,366,402,25,233,175,8163
"13097080511",4150,137,3862,129,677,0,498,81,9534
"13097080602",2214,243,2515,293,246,34,76,0,5621
"13097080603",2752,322,2173,171,224,3,248,185,6078
"13097080604",3407,379,4191,875,221,349,348,0,9770
"13099090100",341,64,604,263,0,0,16,0,1288
"13099090200",774,131,1090,493,0,8,0,0,2496
"13099090300",842,22,373,260,105,8,85,0,1695
"13099090400",1558,57,709,1028,22,0,55,11,3440
"13099090500",928,328,228,153,7,37,0,34,1715
"13101880100",825,705,32,7,236,7,241,279,2332
"13101880200",1461,225,6,17,244,249,349,272,2823
"13103030100",2388,289,384,19,106,0,14,0,3200
"13103030202",4104,261,963,371,28,42,6,58,5833
"13103030203",5721,613,915,0,124,40,247,0,7660
"13103030204",2008,232,686,961,8,0,0,37,3932
"13103030301",4159,160,248,16,76,10,12,10,4691
"13103030303",1857,197,52,7,124,0,158,0,2395
"13103030304",5531,822,680,97,124,50,462,0,7766
"13103030305",5347,186,1128,324,962,31,349,0,8327
"13103030401",4058,259,352,0,67,11,117,11,4875
"13103030402",5127,586,107,17,88,0,263,0,6188
"13105000100",2527,351,348,184,29,13,115,0,3567
"13105000200",1816,636,122,18,70,7,83,52,2804
"13105000300",1870,391,1103,556,0,125,270,125,4440
"13105000400",1638,403,874,864,226,7,243,94,4349
"13105000500",3239,158,1570,264,20,0,0,0,5251
"13107970100",2777,768,769,677,104,102,47,134,5378
"13107970200",1188,183,309,96,0,0,0,0,1776
"13107970300",1200,529,1046,726,44,48,22,179,3794
"13107970400",1696,462,1171,914,131,59,0,89,4522
"13107970500",1072,177,149,31,19,0,0,0,1448
"13107970600",2552,970,650,619,214,368,153,363,5889
"13109970100",1599,403,353,79,243,349,249,439,3714
"13109970200",2268,333,777,339,116,31,121,30,4015
"13109970300",1346,228,787,688,61,343,128,327,3908
"13111050100",2812,438,0,9,11,120,121,31,3542
"13111050200",5392,917,0,0,24,16,3,3,6355
"13111050300",1902,443,0,0,0,124,0,0,2469
"13111050400",4746,1904,0,1,275,13,264,21,7224
"13111050500",2860,1279,0,8,25,8,10,0,4190
"13113140101",1859,404,3757,230,371,102,80,333,7136
"13113140102",3274,87,1468,175,358,141,195,0,5698
"13113140203",3627,254,1061,89,386,0,581,29,6027
"13113140204",2708,649,1486,163,261,42,627,380,6316
"13113140206",3562,373,340,0,198,0,204,0,4677
"13113140207",4519,130,430,0,377,31,218,31,5736
"13113140208",5025,822,892,323,1022,10,871,214,9179
"13113140303",3804,338,130,0,341,8,243,0,4864
"13113140304",4659,273,359,0,495,0,588,0,6374
"13113140305",3433,361,419,71,545,104,406,147,5486
"13113140306",5656,389,295,439,566,58,326,178,7907
"13113140307",4257,67,343,0,158,0,214,0,5039
"13113140403",2196,291,2920,42,417,0,206,14,6086
"13113140404",3280,335,1318,131,415,0,227,0,5706
"13113140405",2583,192,421,144,153,7,68,0,3568
"13113140406",1955,193,1071,187,374,100,278,29,4187
"13113140407",4310,116,2061,172,754,143,269,97,7922
"13113140408",2200,64,586,2,352,0,51,0,3255
"13113140501",4920,146,272,0,158,0,87,13,5596
"13113140502",3297,214,107,3,54,31,40,43,3789
"13115000100",3355,649,388,0,223,12,153,0,4780
"13115000201",4264,979,261,51,567,0,550,252,6924
"13115000202",3429,231,52,26,236,68,0,15,4057
"13115000300",849,77,111,46,143,41,140,47,1454
"13115000400",4063,1880,309,434,142,185,416,723,8152
"13115000500",1544,642,376,232,217,682,487,809,4989
"13115000600",1596,680,1396,509,56,145,190,162,4734
"13115000700",4140,440,345,55,23,0,36,10,5049
"13115000800",3502,220,712,129,11,0,0,0,4574
"13115000900",1513,270,51,407,64,28,0,7,2340
"13115001100",936,550,317,433,141,340,150,459,3326
"13115001200",1840,693,514,268,877,442,987,905,6526
"13115001300",3559,796,737,130,410,63,437,406,6538
"13115001400",5621,411,0,0,486,9,433,0,6960
"13115001600",841,569,1292,731,331,69,246,107,4186
"13115001701",5145,1364,119,1,108,17,130,3,6887
"13115001702",4260,463,890,77,344,31,55,0,6120
"13115001800",3444,788,107,18,198,109,318,16,4998
"13115002000",3393,710,28,69,62,16,53,13,4344
"13115002100",1285,737,1049,533,170,149,321,214,4458
"13117130101",3326,382,0,0,394,79,430,23,4634
"13117130102",2311,594,64,0,0,0,0,0,2969
"13117130103",3049,454,0,0,50,0,134,0,3687
"13117130104",3542,45,0,0,130,0,24,0,3741
"13117130105",1672,608,0,0,132,0,434,35,2881
"13117130201",4203,331,0,0,111,0,152,0,4797
"13117130202",3679,52,28,0,126,0,105,0,3990
"13117130203",4872,255,0,0,303,159,472,148,6209
"13117130204",3191,300,7,0,206,54,353,113,4224
"13117130205",1464,114,57,0,185,163,206,151,2340
"13117130301",4232,873,19,20,199,33,120,388,5884
"13117130302",5184,156,112,0,210,16,183,12,5873
"13117130303",3720,88,0,0,52,183,477,183,4703
"13117130304",3966,158,38,0,101,15,637,56,4971
"13117130305",4040,177,111,30,711,0,325,25,5419
"13117130306",3421,237,65,0,660,0,184,0,4567
"13117130307",3117,427,58,20,651,41,292,5,4611
"13117130403",4859,505,136,1,645,0,1088,85,7319
"13117130404",3293,0,122,84,891,0,216,0,4606
"13117130405",3225,72,27,0,30,72,118,39,3583
"13117130406",3821,272,247,209,433,276,453,272,5983
"13117130408",2435,669,145,0,272,66,607,313,4507
"13117130409",1712,243,0,0,294,28,362,142,2781
"13117130410",2507,266,175,20,487,480,798,470,5203
"13117130503",2086,301,19,0,51,0,0,0,2457
"13117130504",3089,205,193,0,138,0,242,0,3867
"13117130505",2419,340,0,0,23,0,22,0,2804
"13117130506",3058,43,0,0,151,35,160,0,3447
"13117130507",2028,182,28,0,17,0,33,0,2288
"13117130508",4793,42,156,0,182,0,390,0,5563
"13117130509",2811,85,48,0,103,26,440,0,3513
"13117130510",4784,328,63,82,1124,84,409,215,7089
"13117130601",2717,509,330,0,509,39,518,228,4850
"13117130602",3624,210,672,1,822,24,1540,87,6980
"13117130603",3150,115,237,5,882,34,399,4,4826
"13117130604",3952,57,86,0,1011,26,480,0,5612
"13117130605",3236,94,225,0,411,25,152,14,4157
"13117130606",3894,95,110,7,373,130,235,85,4929
"13117130607",3565,26,185,0,1532,26,459,52,5845
"13117130608",2543,56,470,0,1925,272,243,0,5509
"13117130609",3368,136,297,0,1045,22,225,47,5140
"13117130610",2993,111,149,0,887,39,148,0,4327
"13117130611",3205,57,6,0,482,12,162,12,3936
"13117130612",5637,70,344,1,465,0,199,0,6716
"13117130613",2401,110,0,1,395,50,214,16,3187
"13119890101",2180,454,468,154,245,340,220,309,4370
"13119890102",3120,662,195,5,71,0,11,124,4188
"13119890200",3591,1081,601,62,95,60,14,1,5505
"13119890300",2491,479,0,0,43,3,15,0,3031
"13119890400",3423,973,293,135,86,40,132,74,5156
"13121000100",3949,293,22,70,134,1,159,56,4684
"13121000200",5187,350,190,43,200,25,185,16,6196
"13121000400",1284,82,103,6,30,9,20,0,1534
"13121000500",2984,396,849,54,431,143,151,63,5071
"13121000600",1457,1052,1085,419,542,759,400,96,5810
"13121000700",392,118,89,136,57,11,0,34,837
"13121001001",719,141,52,12,222,41,56,19,1262
"13121001002",209,165,120,80,93,135,6,30,838
"13121001100",2599,218,430,132,401,17,137,0,3934
"13121001201",2393,302,397,92,235,63,221,23,3726
"13121001202",2173,93,359,74,692,127,157,10,3685
"13121001300",2484,385,267,553,425,28,255,48,4445
"13121001400",1745,110,125,58,119,0,72,0,2229
"13121001500",3297,236,185,211,161,102,289,18,4499
"13121001600",1473,164,424,35,66,0,81,11,2254
"13121001700",997,59,1042,933,248,35,61,43,3418
"13121001800",1272,187,1026,1323,199,119,49,101,4276
"13121001900",785,170,527,457,138,45,122,0,2244
"13121002100",650,197,726,837,28,104,30,0,2572
"13121002300",29,22,859,331,22,0,0,0,1263
"13121002400",2,0,1236,465,29,23,3,0,1758
"13121002500",21,20,1000,731,0,36,13,47,1868
"13121002600",118,44,389,304,18,88,5,95,1061
"13121002800",398,120,514,612,86,32,69,10,1841
"13121002900",1215,135,659,168,144,31,58,16,2426
"13121003000",2183,125,244,0,323,0,206,0,3081
"13121003100",805,103,718,234,68,9,26,3,1966
"13121003200",1137,83,536,84,232,13,56,13,2154
"13121003500",509,45,336,613,118,81,55,59,1816
"13121003600",126,5,699,233,73,0,36,0,1172
"13121003700",0,0,0,30,0,0,0,0,30
"13121003800",36,14,186,92,7,0,36,14,385
"13121003900",89,8,701,906,0,0,0,0,1704
"13121004000",19,0,1291,1059,8,4,0,0,2381
"13121004100",88,0,1200,474,25,36,19,0,1842
"13121004200",130,68,1625,747,18,5,6,0,2599
"13121004300",69,25,486,419,29,4,28,10,1070
"13121004400",0,59,1308,652,17,0,0,13,2049
"13121004800",73,27,328,439,5,102,1,60,1035
"13121004900",1139,230,669,530,118,0,148,4,2838
"13121005000",1171,292,293,37,58,42,61,74,2028
"13121005200",2797,281,731,541,348,73,250,52,5073
"13121005300",2122,148,968,310,138,12,155,15,3868
"13121005501",242,153,1030,790,273,49,65,71,2673
"13121005502",153,35,1348,1084,0,7,0,25,2652
"13121005700",19,8,902,839,0,0,14,8,1790
"13121005800",132,41,903,626,32,20,0,0,1754
"13121006000",83,67,1708,1195,14,16,15,133,3231
"13121006100",21,15,2164,1310,104,0,47,0,3661
"13121006200",149,0,701,403,21,92,47,0,1413
"13121006300",7,0,889,723,0,0,0,0,1619
"13121006400",174,62,361,252,225,8,269,0,1351
"13121006500",484,53,2348,918,218,9,80,32,4142
"13121006601",330,80,1096,841,42,6,33,6,2434
"13121006602",0,0,384,643,39,25,18,0,1109
"13121006700",233,62,1847,1606,57,32,24,22,3883
"13121006801",0,0,0,0,0,0,0,0,0
"13121006802",0,0,361,1504,0,42,0,0,1907
"13121006900",1102,402,934,710,378,124,558,293,4501
"13121007001",69,22,2947,1599,0,93,7,30,4767
"13121007002",80,134,1208,632,0,163,10,146,2373
"13121007100",9,22,1205,681,5,1,10,1,1934
"13121007200",5,2,1162,691,21,97,14,0,1992
"13121007300",169,26,3817,3751,78,81,47,0,7969
"13121007400",93,279,788,893,432,104,443,165,3197
"13121007500",93,67,1493,1497,225,60,88,56,3579
"13121007602",10,3,1871,681,53,87,89,14,2808
"13121007603",75,28,2186,2231,81,27,9,36,4673
"13121007604",0,0,921,1311,0,10,0,0,2242
"13121007703",0,0,3010,724,0,0,0,0,3734
"13121007704",103,118,3463,1458,354,0,460,118,6074
"13121007705",19,0,2983,1837,47,83,48,11,5028
"13121007706",292,0,7595,1290,152,8,129,0,9466
"13121007802",24,0,7214,1898,74,84,16,84,9394
"13121007805",61,212,2023,825,7,71,8,212,3419
"13121007806",0,207,4444,1744,0,0,52,207,6654
"13121007807",0,78,1162,1121,38,444,38,503,3384
"13121007808",0,81,1309,2518,32,333,6,396,4675
"13121007900",2,0,4883,830,274,0,0,0,5989
"13121008000",114,44,3625,1537,63,0,43,0,5426
"13121008101",10,0,808,340,0,0,0,0,1158
"13121008102",212,355,3778,2174,0,315,243,670,7747
"13121008201",146,50,4347,1947,65,0,107,292,6954
"13121008202",20,0,1286,695,6,0,6,0,2013
"13121008301",76,36,1475,531,19,15,0,0,2152
"13121008302",10,0,1094,406,0,5,0,0,1515
"13121008400",20,141,1592,1200,26,0,11,11,3001
"13121008500",73,0,1970,1392,57,0,0,0,3492
"13121008601",24,0,2417,1974,50,1,0,1,4467
"13121008602",45,0,574,530,15,8,0,0,1172
"13121008700",287,13,2572,1337,20,0,35,0,4264
"13121008800",3303,174,865,207,280,319,447,319,5914
"13121008902",3116,607,1169,340,762,363,288,121,6766
"13121008903",1175,157,188,89,162,0,754,97,2622
"13121008904",3127,478,537,132,441,61,91,210,5077
"13121009000",3958,41,212,37,344,106,215,7,4920
"13121009101",3307,285,661,127,317,86,87,0,4870
"13121009102",1620,312,679,112,227,51,116,77,3194
"13121009200",3022,1340,1050,178,659,328,315,910,7802
"13121009300",3927,141,288,19,49,25,350,0,4799
"13121009402",2726,558,814,121,830,66,1445,286,6846
"13121009403",2633,241,891,337,794,567,1373,0,6836
"13121009404",3384,185,771,0,367,30,381,20,5138
"13121009501",3616,80,49,0,52,26,19,0,3842
"13121009502",2076,296,409,53,106,0,65,9,3014
"13121009601",1961,168,79,15,189,5,23,62,2502
"13121009602",3728,106,393,0,470,0,170,0,4867
"13121009603",2726,260,371,162,289,93,329,0,4230
"13121009700",3728,98,117,0,126,0,94,0,4163
"13121009801",4138,165,19,8,111,15,30,0,4486
"13121009802",3585,108,176,99,379,47,113,25,4532
"13121009900",3955,35,40,0,316,0,57,0,4403
"13121010001",3612,101,208,16,354,0,92,0,4383
"13121010002",5945,89,460,0,503,40,382,0,7419
"13121010106",2590,116,651,146,387,14,192,0,4096
"13121010107",1831,44,4,16,64,0,37,5,2001
"13121010108",2978,129,145,0,309,20,122,43,3746
"13121010110",3080,488,771,41,692,51,252,168,5543
"13121010113",4009,995,779,43,398,611,1603,944,9382
"13121010114",5138,1006,337,254,528,93,1322,703,9381
"13121010115",1705,12,258,0,249,0,123,0,2347
"13121010117",1243,140,1246,62,314,0,199,7,3211
"13121010118",1781,395,1448,990,470,159,923,163,6329
"13121010119",1133,115,1898,1311,567,224,414,107,5769
"13121010120",1104,151,722,101,143,0,211,17,2449
"13121010121",1661,105,178,11,230,8,36,0,2229
"13121010122",2907,100,648,14,2316,66,517,41,6609
"13121010123",2715,345,1429,276,134,77,718,199,5893
"13121010204",4330,216,92,0,184,16,167,0,5005
"13121010205",4133,243,290,28,235,73,0,52,5054
"13121010206",4327,206,168,0,318,10,199,20,5248
"13121010208",1957,185,1520,172,340,111,107,0,4392
"13121010209",2104,167,2454,144,460,10,570,10,5919
"13121010210",3744,149,1327,322,212,10,171,0,5935
"13121010211",2837,186,247,29,184,0,211,133,3827
"13121010212",2756,851,570,82,416,332,1131,834,6972
"13121010301",969,87,12244,1712,320,101,204,0,15637
"13121010303",59,40,9265,688,95,34,32,52,10265
"13121010304",723,77,12763,367,190,239,226,163,14748
"13121010400",4229,378,2559,754,284,171,1023,200,9598
"13121010507",107,0,5376,2287,179,205,82,0,8236
"13121010508",70,39,3034,957,114,55,134,76,4479
"13121010510",802,1187,10836,2170,277,543,364,1226,17405
"13121010511",388,57,6760,871,163,0,95,0,8334
"13121010512",219,68,4274,1776,66,177,44,0,6624
"13121010513",1694,373,7930,2528,453,227,1075,326,14606
"13121010514",1498,185,8649,761,994,118,721,118,13044
"13121010515",557,89,3406,577,48,0,81,0,4758
"13121010516",292,0,6234,2206,166,0,338,0,9236
"13121010601",870,126,1086,964,50,31,201,12,3340
"13121010603",0,21,2211,1544,15,105,0,23,3919
"13121010604",87,1,1482,563,232,185,248,190,2988
"13121010800",2555,336,1648,887,419,766,1052,881,8544
"13121011000",364,328,1046,1132,242,0,488,282,3882
"13121011100",812,180,871,77,243,6,141,11,2341
"13121011201",456,37,2164,832,263,68,261,59,4140
"13121011202",1123,344,2360,984,67,349,339,527,6093
"13121011301",365,112,2928,719,111,179,367,197,4978
"13121011303",457,43,5979,1212,617,702,696,727,10433
"13121011305",116,0,2401,1792,27,0,48,23,4407
"13121011306",172,0,1449,721,78,0,109,0,2529
"13121011405",4943,1092,948,347,338,148,1492,647,9955
"13121011410",5017,227,605,2,1336,0,544,0,7731
"13121011411",6005,856,579,63,333,19,697,413,8965
"13121011412",6881,162,894,59,883,74,907,66,9926
"13121011414",5100,124,1527,32,675,0,636,0,8094
"13121011416",4447,121,150,6,587,0,117,14,5442
"13121011417",3992,224,43,1,374,0,321,0,4955
"13121011418",5472,145,167,0,164,15,0,0,5963
"13121011419",3950,440,460,20,530,0,92,0,5492
"13121011420",2922,1529,1354,476,1031,112,3051,1479,11954
"13121011421",1757,240,973,388,429,102,919,319,5127
"13121011422",3007,111,830,171,202,17,212,49,4599
"13121011423",3977,99,90,87,656,15,103,0,5027
"13121011424",4121,49,651,8,758,14,167,0,5768
"13121011425",5394,76,363,0,1521,0,134,0,7488
"13121011426",2057,58,281,0,238,5,494,0,3133
"13121011427",5838,119,480,0,1059,42,435,0,7973
"13121011503",8245,122,138,183,535,103,479,29,9834
"13121011504",11149,239,820,0,676,24,545,0,13453
"13121011505",3732,96,411,56,287,0,138,0,4720
"13121011506",5220,121,557,0,440,28,122,28,6516
"13121011610",3787,432,533,143,682,60,122,98,5857
"13121011611",4156,555,999,154,1200,17,1285,246,8612
"13121011612",2548,49,138,16,563,78,21,0,3413
"13121011613",3821,469,866,0,1175,98,470,316,7215
"13121011614",7506,674,2624,276,2992,157,1245,462,15936
"13121011615",8060,209,655,2,1058,0,587,0,10571
"13121011616",2595,45,973,146,1141,79,658,30,5667
"13121011617",5384,205,544,18,1176,30,187,0,7544
"13121011618",2761,241,223,23,979,0,106,0,4333
"13121011619",3775,170,746,87,3135,114,985,0,9012
"13121011620",7010,296,559,2,1981,93,794,165,10900
"13121011621",4603,93,354,0,1669,47,529,0,7295
"13121011622",4517,21,640,0,4377,385,399,0,10339
"13121011623",6251,379,1234,36,3733,567,371,0,12571
"13121011624",3158,45,314,8,863,0,26,0,4414
"13121011625",4404,40,886,147,1935,238,240,0,7890
"13121011626",3431,344,2400,12,2863,160,717,0,9927
"13121011800",174,317,648,1534,30,276,52,97,3128
"13121011900",612,207,771,436,8,121,60,8,2223
"13121012000",42,20,881,1485,205,84,130,36,2883
"13121012300",785,29,834,476,232,0,78,205,2639
"13121980000",0,0,0,0,0,0,0,0,0
"13123080100",3041,881,0,0,23,9,13,126,4093
"13123080200",4479,699,0,8,469,14,362,7,6038
"13123080300",4151,1253,56,134,155,668,247,1186,7850
"13123080400",6557,1331,6,16,413,40,640,256,9259
"13123080500",2741,963,0,0,16,10,85,7,3822
"13125010100",2335,350,138,49,11,94,22,22,3021
"13127000101",986,117,14,0,17,0,0,0,1134
"13127000102",2948,200,71,101,195,30,118,0,3663
"13127000200",4372,83,0,21,84,49,69,0,4678
"13127000300",4892,422,98,32,438,0,239,0,6121
"13127000401",5518,292,965,339,315,299,166,217,8111
"13127000403",2528,94,341,16,123,0,27,0,3129
"13127000404",8040,1018,1217,259,494,528,566,447,12569
"13127000501",1193,390,1474,678,109,10,10,114,3978
"13127000503",1821,385,754,573,577,145,203,219,4677
"13127000504",779,138,1324,1104,323,8,264,0,3940
"13127000600",3791,742,525,583,55,188,37,188,6109
"13127000700",1692,712,2779,1659,66,362,12,188,7470
"13127000800",118,242,1112,1640,340,60,300,119,3931
"13127000900",1395,361,1305,561,446,264,651,425,5408
"13127001000",7120,605,350,296,722,44,539,37,9713
"13127990000",0,0,0,0,0,0,0,0,0
"13129970100",4830,1295,0,1,26,177,289,253,6871
"13129970200",6111,676,414,25,169,0,92,0,7487
"13129970300",5706,1451,168,448,291,223,1082,773,10142
"13129970400",3807,637,158,54,159,21,625,115,5576
"13129970500",3124,753,145,212,311,287,1080,636,6548
"13129970600",3419,791,343,163,579,719,1363,877,8254
"13129970700",3289,584,21,0,103,0,99,0,4096
"13129970800",4700,628,91,24,195,123,275,132,6168
"13129970900",5248,1753,72,35,82,79,231,79,7579
"13131950100",1435,436,10,77,64,85,4,129,2240
"13131950200",1727,334,85,478,21,16,3,0,2664
"13131950300",1447,323,1206,1380,55,213,0,266,4890
"13131950400",3705,810,767,319,312,672,485,672,7742
"13131950500",3254,742,1286,1042,175,243,235,594,7571
"13131950600",1249,322,311,94,16,151,24,146,2313
"13133950100",1189,321,505,256,48,5,4,0,2328
"13133950200",802,181,553,484,49,53,31,34,2187
"13133950301",2117,85,8,0,3,2,58,0,2273
"13133950302",1809,24,209,322,25,77,0,4,2470
"13133950303",1006,408,1219,1215,304,182,418,424,5176
"13133950400",388,172,580,175,0,0,0,0,1315
"13133950500",814,43,215,154,20,0,19,0,1265
"13135050103",6965,813,780,159,1014,544,2077,700,13052
"13135050105",2092,626,476,193,360,371,1108,668,5894
"13135050106",6464,2240,841,164,1371,31,1915,1846,14872
"13135050107",4987,170,709,0,577,118,728,0,7289
"13135050108",6711,47,754,103,1346,662,404,591,10618
"13135050109",4602,344,1278,30,660,248,915,229,8306
"13135050205",1925,270,594,127,1118,135,321,125,4615
"13135050208",4039,86,1447,114,979,103,1168,127,8063
"13135050209",3185,540,1646,85,3086,906,967,450,10865
"13135050210",3610,430,755,0,1432,381,531,571,7710
"13135050211",913,627,1038,421,1552,844,1251,1239,7885
"13135050212",9680,13,811,0,1847,186,372,0,12909
"13135050213",6824,656,1358,179,3239,596,1302,73,14227
"13135050214",4436,242,1247,75,2341,140,373,0,8854
"13135050215",529,41,822,35,1321,430,68,0,3246
"13135050216",3379,116,304,46,4292,412,237,0,8786
"13135050217",4929,31,1326,59,3371,403,566,116,10801
"13135050218",2177,56,975,100,1089,0,1412,0,5809
"13135050219",1485,115,710,256,876,140,202,17,3801
"13135050220",2111,295,1583,732,1130,462,765,220,7298
"13135050304",1935,636,1012,303,876,560,1531,812,7665
"13135050306",1385,678,550,182,1282,948,1921,1414,8360
"13135050308",2915,17,0,0,755,24,66,24,3801
"13135050309",3409,342,2407,152,1605,106,311,16,8348
"13135050310",3244,99,991,179,639,49,535,73,5809
"13135050311",1621,97,445,58,433,11,94,0,2759
"13135050313",3924,371,621,424,1569,356,1175,185,8625
"13135050314",4007,573,2683,507,2749,531,3500,645,15195
"13135050315",2101,204,1546,604,459,650,611,725,6900
"13135050317",623,322,1256,148,1180,244,1345,489,5607
"13135050318",590,99,1168,409,598,36,409,99,3408
"13135050319",1434,942,1235,57,1457,1072,2281,1644,10122
"13135050320",1473,421,671,291,1318,1727,1702,1641,9244
"13135050321",3890,82,59,0,404,11,234,0,4680
"13135050322",4046,80,62,0,286,0,36,0,4510
"13135050410",1505,469,747,246,1764,641,1324,648,7344
"13135050415",1430,76,1401,113,421,24,26,50,3541
"13135050416",964,305,1793,147,148,190,176,414,4137
"13135050417",1253,764,966,305,1478,862,2040,1502,9170
"13135050418",1341,553,1353,321,1986,1620,2107,1912,11193
"13135050419",2021,583,1186,317,2514,1515,2276,1809,12221
"13135050421",1809,880,2133,230,1393,1277,1646,1909,11277
"13135050422",1678,699,1169,588,2470,1207,2487,1641,11939
"13135050423",1717,302,1212,712,2240,681,1786,482,9132
"13135050424",2025,729,1767,409,1611,878,2226,1361,11006
"13135050425",3303,213,630,149,962,225,297,93,5872
"13135050426",4414,315,897,64,677,251,168,0,6786
"13135050427",3666,241,638,120,1199,408,719,453,7444
"13135050428",3999,421,473,0,1679,77,382,51,7082
"13135050429",4445,277,1092,2,1245,50,578,0,7689
"13135050430",2770,293,1265,70,941,45,523,0,5907
"13135050431",1616,317,2225,292,2770,878,1331,851,10280
"13135050432",1654,229,1352,120,2671,122,1740,48,7936
"13135050433",1114,88,462,86,441,370,896,295,3752
"13135050434",2151,729,960,401,2106,1704,2807,2358,13216
"13135050435",1475,339,539,56,1146,147,1278,324,5304
"13135050436",1880,486,2039,202,2180,624,1646,883,9940
"13135050511",3720,1127,2027,498,2436,326,2093,937,13164
"13135050520",1795,433,1052,311,1000,154,1244,205,6194
"13135050521",2638,657,741,163,695,326,943,489,6652
"13135050522",1948,404,1055,386,696,541,561,352,5943
"13135050523",3406,172,2420,281,888,17,1494,0,8678
"13135050524",1598,441,1162,212,1350,448,1557,579,7347
"13135050525",4276,520,911,55,1890,26,955,8,8641
"13135050526",1407,346,1080,116,1168,541,1462,568,6688
"13135050527",3865,197,913,349,890,0,1012,0,7226
"13135050528",2771,49,1002,38,1219,135,490,34,5738
"13135050529",1970,101,509,151,826,351,248,205,4361
"13135050530",2916,16,901,63,1985,0,337,0,6218
"13135050531",2507,407,2495,312,1593,647,1546,727,10234
"13135050532",3072,272,2466,291,1166,259,1096,230,8852
"13135050533",1668,320,2015,0,2980,896,1679,915,10473
"13135050534",2002,336,2085,159,3162,246,2617,175,10782
"13135050535",1839,234,1756,250,1626,997,1193,916,8811
"13135050536",1711,307,1061,302,1351,84,1187,283,6286
"13135050537",1019,83,1463,823,1080,294,1181,330,6273
"13135050538",4930,330,1198,42,1168,0,1174,293,9135
"13135050539",916,547,1051,385,1137,698,1154,983,6871
"13135050540",3112,51,2702,94,781,324,431,18,7513
"13135050541",1418,634,1851,425,1406,237,2353,614,8938
"13135050542",833,651,1690,509,1122,352,821,617,6595
"13135050543",2890,100,2198,148,1381,145,1030,106,7998
"13135050544",4130,681,3440,364,2941,161,963,549,13229
"13135050545",5861,142,3924,463,1332,47,3309,65,15143
"13135050546",5068,963,6601,512,1576,1374,1249,2003,19346
"13135050547",5026,489,1037,99,1048,454,539,442,9134
"13135050548",5539,614,1329,391,1035,89,785,196,9978
"13135050549",3131,45,628,37,942,71,462,43,5359
"13135050605",8982,1415,1371,143,1529,206,2057,810,16513
"13135050606",13488,949,3334,146,3304,70,2347,0,23638
"13135050607",10827,270,3130,239,560,594,2093,115,17828
"13135050608",10530,752,3919,584,1099,623,1712,850,20069
"13135050609",8516,684,716,335,1031,320,1017,99,12718
"13135050610",11895,383,2277,241,1837,45,1506,0,18184
"13135050709",3726,593,6073,905,486,347,796,689,13615
"13135050712",4386,522,926,1,840,64,573,144,7456
"13135050713",4793,579,1080,64,1308,87,19,399,8329
"13135050714",3040,206,1247,143,756,17,425,82,5916
"13135050715",3476,419,625,154,843,0,742,222,6481
"13135050718",5308,199,1380,85,773,70,530,0,8345
"13135050719",1703,342,2451,428,346,0,306,242,5818
"13135050720",4516,744,1471,39,297,0,256,0,7323
"13135050721",4488,313,3255,515,584,606,707,582,11050
"13135050722",892,216,1313,303,294,523,337,437,4315
"13135050723",1756,2,3829,523,657,189,422,0,7378
"13135050724",7785,525,5163,352,1106,114,688,0,15733
"13135050725",1981,67,2312,497,485,30,620,8,6000
"13135050726",5798,485,1416,398,853,164,841,208,10163
"13135050727",6378,956,2299,25,802,211,463,30,11164
"13135050728",4877,941,6712,884,505,76,826,362,15183
"13135050729",1145,118,1083,510,429,6,478,0,3769
"13135050730",3550,48,3014,233,311,0,732,48,7936
"13135050731",4866,337,3183,430,389,55,701,177,10138
"13137000100",2926,374,28,0,113,108,41,0,3590
"13137000201",3518,426,12,0,225,15,401,0,4597
"13137000202",5048,371,12,0,64,0,296,15,5806
"13137000300",2867,533,46,37,130,76,262,157,4108
"13137000400",3861,778,31,7,546,192,661,49,6125
"13137000500",3852,1160,262,24,535,92,347,8,6280
"13137000601",3032,597,0,0,211,80,441,211,4572
"13137000602",5538,1469,233,138,175,705,1403,1340,11001
"13139000101",3284,667,255,10,221,0,338,78,4853
"13139000102",2816,634,30,0,69,17,346,37,3949
"13139000201",4116,1343,39,0,161,36,282,589,6566
"13139000203",4001,184,0,0,77,0,0,0,4262
"13139000204",3667,629,0,15,83,0,187,54,4635
"13139000302",5966,235,81,0,490,47,879,0,7698
"13139000303",2232,344,0,0,0,83,13,123,2795
"13139000304",2830,522,1,1,6,109,137,205,3811
"13139000305",3628,322,217,137,139,0,170,1,4614
"13139000400",5006,908,80,166,205,134,908,470,7877
"13139000500",5454,698,85,142,502,351,703,808,8743
"13139000600",3420,1118,268,237,163,460,642,705,7013
"13139000701",1971,772,1729,480,911,160,1984,553,8560
"13139000702",3094,1068,365,33,766,303,1925,1230,8784
"13139000800",733,625,707,432,269,243,643,590,4242
"13139000900",3464,560,595,17,12,298,200,597,5743
"13139001002",4418,980,304,19,975,26,2035,766,9523
"13139001003",2856,1584,462,533,708,287,3107,1387,10924
"13139001004",1799,167,504,193,458,118,283,41,3563
"13139001101",1208,1471,170,146,875,538,2004,1890,8302
"13139001102",1755,1218,9,69,864,428,1896,1477,7716
"13139001201",3646,2073,357,513,180,176,1644,1606,10195
"13139001202",3539,1188,213,164,1125,0,2892,965,10086
"13139001301",4204,752,112,0,497,277,1251,714,7807
"13139001302",4513,443,95,35,160,24,90,25,5385
"13139001402",4262,580,172,49,220,110,632,365,6390
"13139001403",2190,333,157,121,945,98,982,197,5023
"13139001404",3600,345,456,10,496,28,1492,211,6638
"13139001501",3592,231,123,17,344,0,402,0,4709
"13139001502",3942,499,185,0,110,0,877,0,5613
"13139001603",3694,365,46,1,496,490,733,514,6339
"13139001604",5425,764,347,0,232,0,614,409,7791
"13139001605",3990,248,422,103,194,144,457,109,5667
"13139001606",2186,474,498,0,240,74,450,45,3967
"13139001607",3840,568,166,24,206,88,529,57,5478
"13139001608",4564,402,147,39,94,0,453,9,5708
"13141480300",833,114,1047,115,32,0,0,0,2141
"13141480400",472,342,2472,1788,34,1,0,1,5110
"13143010100",2778,670,31,3,30,17,0,0,3529
"13143010200",4896,1079,61,69,108,32,44,21,6310
"13143010301",2225,826,179,18,48,6,0,0,3302
"13143010302",5753,1375,216,128,175,65,24,68,7804
"13143010400",4877,1432,579,75,280,80,169,0,7492
"13145120198",2966,257,1330,368,108,63,68,8,5168
"13145120200",2426,369,505,189,53,0,79,0,3621
"13145120300",7010,834,1071,88,325,65,195,0,9588
"13145120401",5674,36,133,24,285,5,276,0,6433
"13145120402",5713,375,1346,75,305,55,343,2,8214
"13147960100",4201,963,203,265,49,96,20,105,5902
"13147960200",2819,399,96,96,19,30,2,4,3465
"13147960300",1693,759,358,306,20,0,19,51,3206
"13147960400",2959,1072,717,367,174,13,171,218,5691
"13147960500",3335,940,1581,713,325,30,212,69,7205
"13149970100",2962,848,288,119,168,34,213,6,4638
"13149970200",3125,716,212,156,24,6,24,17,4280
"13149970300",1741,673,337,31,40,36,0,0,2858
"13151070104",3730,241,5257,820,1343,741,400,77,12609
"13151070106",2788,595,1758,250,416,20,255,96,6178
"13151070107",1874,240,4053,461,107,25,215,0,6975
"13151070108",919,96,3097,329,227,0,370,0,5038
"13151070109",1732,61,1319,56,101,39,85,0,3393
"13151070110",3552,241,2087,541,542,0,243,0,7206
"13151070111",2363,166,4443,1314,400,58,934,210,9888
"13151070113",2342,308,678,73,316,72,627,69,4485
"13151070114",996,122,2846,553,763,54,72,0,5406
"13151070202",8613,529,1584,14,325,52,305,0,11422
"13151070203",10293,954,3116,86,400,0,410,0,15259
"13151070204",2933,105,1149,60,166,0,87,0,4500
"13151070205",4089,1510,3364,300,1057,467,466,491,11744
"13151070304",3446,622,4138,2381,409,98,482,209,11785
"13151070305",3900,260,3125,260,1270,229,779,0,9823
"13151070306",4707,513,3665,81,851,41,503,354,10715
"13151070307",2365,81,1750,156,286,1,338,1,4978
"13151070309",2890,16,3222,231,959,105,356,0,7779
"13151070310",2929,189,598,28,125,187,130,161,4347
"13151070311",2956,623,6224,1281,565,268,466,430,12813
"13151070402",9584,1149,1050,117,351,21,229,21,12522
"13151070403",7869,693,1890,18,146,54,757,63,11490
"13151070404",3990,105,1538,717,480,10,356,10,7206
"13151070501",2449,1086,2319,328,350,303,240,420,7495
"13151070502",7146,1351,3412,1243,705,33,693,58,14641
"13153020105",2441,843,1239,1269,125,123,451,15,6506
"13153020106",1826,247,773,26,281,15,94,0,3262
"13153020108",3695,544,951,129,258,11,171,105,5864
"13153020109",4503,664,1976,441,1383,21,809,71,9868
"13153020200",2429,785,953,949,230,46,220,63,5675
"13153020300",1342,543,2404,1605,358,481,173,392,7298
"13153020400",759,379,938,354,204,601,85,576,3896
"13153020600",751,45,147,0,99,8,136,0,1186
"13153020700",806,292,1204,767,267,175,116,112,3739
"13153020800",1206,321,605,135,265,152,212,108,3004
"13153020900",2474,282,939,341,41,36,93,0,4206
"13153021000",3092,718,872,541,496,78,318,28,6143
"13153021103",7584,397,2039,160,755,12,691,0,11638
"13153021104",4107,754,1626,289,518,224,414,326,8258
"13153021105",3073,354,1686,504,851,108,606,0,7182
"13153021107",4615,496,2068,540,451,9,431,104,8714
"13153021108",4150,650,1231,121,238,88,204,125,6807
"13153021113",10502,629,3590,348,1589,224,481,194,17557
"13153021201",5238,361,1123,0,929,0,281,140,8072
"13153021202",3781,267,1666,437,123,0,196,59,6529
"13153021300",1758,271,1032,849,179,228,44,59,4420
"13153021400",5421,415,1237,664,595,17,391,17,8757
"13153021500",2831,293,978,119,51,0,44,13,4329
"13155950100",1881,412,78,0,0,0,5,24,2400
"13155950200",3288,693,1545,810,78,57,4,7,6482
"13157010101",4473,764,169,0,102,0,3,0,5511
"13157010102",6175,236,116,15,349,0,351,0,7242
"13157010103",4300,555,299,1,123,22,433,193,5926
"13157010200",3674,881,7,125,392,54,203,65,5401
"13157010300",2784,748,380,204,243,95,592,51,5097
"13157010400",3342,967,116,237,158,44,89,0,4953
"13157010500",3686,905,147,53,73,4,80,417,5365
"13157010600",6163,1466,634,214,299,14,534,339,9663
"13157010701",1654,105,233,3,0,10,0,0,2005
"13157010702",7563,532,239,629,437,0,437,0,9837
"13157010703",2589,127,301,52,29,0,185,0,3283
"13159010100",1317,383,249,233,54,47,62,35,2380
"13159010200",2344,387,83,13,48,42,47,0,2964
"13159010500",4696,895,1598,663,144,328,19,383,8726
"13161960100",4747,953,345,0,49,396,259,526,7275
"13161960200",3463,869,1092,718,260,316,351,333,7402
"13161960300",1059,368,163,28,56,0,121,0,1795
"13163960100",2275,227,1127,933,142,0,115,18,4837
"13163960200",1239,213,469,115,13,5,136,0,2190
"13163960300",1688,260,1598,2039,59,0,22,0,5666
"13163960400",872,254,1362,1033,68,3,68,154,3814
"13165960100",2918,810,1288,871,66,131,34,303,6421
"13165960200",1295,327,478,354,53,93,81,93,2774
"13167960100",1946,445,95,85,14,0,29,7,2621
"13167960200",1855,184,1580,821,154,60,0,0,4654
"13167960300",1055,253,312,125,0,36,4,0,1785
"13169030101",2283,115,145,3,102,0,116,0,2764
"13169030103",1691,361,274,19,22,0,0,0,2367
"13169030104",3022,1036,2473,683,87,17,128,0,7446
"13169030200",1662,373,858,120,8,10,0,0,3031
"13169030301",4645,183,1500,322,80,83,38,83,6934
"13169030302",4526,883,648,184,2,18,0,0,6261
"13171970100",5177,1010,399,208,101,2,166,47,7110
"13171970200",2796,507,1730,571,102,166,41,0,5913
"13171970300",1927,206,1083,676,156,3,56,3,4110
"13173950100",1238,485,223,8,43,85,36,50,2168
"13173950200",4452,1072,918,1200,91,221,148,260,8362
"13175950100",1672,434,769,301,0,39,90,16,3321
"13175950201",2901,246,578,525,78,65,0,0,4393
"13175950202",2862,205,840,130,254,25,133,37,4486
"13175950300",196,33,597,1036,6,5,0,17,1890
"13175950400",1311,308,1360,756,211,7,23,0,3976
"13175950500",2356,438,495,319,19,0,72,0,3699
"13175950600",1172,250,440,230,74,0,122,0,2288
"13175950700",1699,570,124,106,6,9,0,9,2523
"13175950800",1295,231,1380,646,79,14,110,29,3784
"13175950900",37,18,1052,1433,39,0,0,12,2591
"13175951000",4106,1049,1630,970,38,38,200,56,8087
"13175951100",2734,910,501,192,53,1,84,0,4475
"13175951400",1581,448,232,59,29,0,9,101,2459
"13177020100",4801,504,1154,89,126,0,165,0,6839
"13177020200",514,192,571,116,26,0,0,0,1419
"13177020300",3817,598,574,203,212,113,93,76,5686
"13177020402",5743,400,835,546,337,112,51,12,8036
"13177020403",4345,363,857,31,317,0,208,36,6157
"13179010101",2669,1456,1163,298,653,137,968,177,7521
"13179010102",242,17,131,102,115,43,30,0,680
"13179010103",457,66,624,7,178,18,183,0,1533
"13179010202",1257,325,1371,315,679,116,569,58,4690
"13179010204",552,291,1504,511,177,273,129,169,3606
"13179010205",2302,246,1545,717,631,124,535,133,6233
"13179010206",2548,314,1221,968,258,44,331,88,5772
"13179010207",1598,104,1828,844,1015,0,750,37,6176
"13179010208",1919,462,2181,227,719,186,734,39,6467
"13179010300",3095,152,2336,608,883,59,662,121,7916
"13179010400",2658,269,2732,632,749,206,851,171,8268
"13179010501",2795,199,277,11,147,0,0,0,3429
"13179010502",2406,320,1606,304,226,14,159,18,5053
"13179010600",247,48,1173,277,11,0,16,0,1772
"13179990000",0,0,0,0,0,0,0,0,0
"13181970100",1808,531,848,551,60,14,5,10,3827
"13181970200",2253,484,844,214,28,84,0,8,3915
"13183970100",5004,815,2041,264,672,374,993,563,10726
"13183970200",3576,709,1165,603,372,146,247,112,6930
"13183980000",0,0,0,0,0,0,0,0,0
"13185010101",2287,472,708,486,318,45,147,87,4550
"13185010102",2902,401,1078,530,123,59,121,59,5273
"13185010103",2144,144,624,60,285,120,163,0,3540
"13185010201",1918,132,205,0,52,0,11,0,2318
"13185010202",9040,434,848,312,413,16,391,86,11540
"13185010301",3119,547,807,160,642,21,146,68,5510
"13185010302",2629,104,10,13,73,0,58,0,2887
"13185010401",1385,94,125,59,19,0,46,6,1734
"13185010402",1635,137,3027,1597,607,192,164,0,7359
"13185010500",556,125,2169,1879,90,12,169,87,5087
"13185010601",1833,651,1481,527,350,264,298,210,5614
"13185010604",2642,379,1494,541,439,19,266,0,5780
"13185010700",2307,324,699,99,79,44,120,0,3672
"13185010800",343,219,2857,2034,0,19,0,168,5640
"13185010900",261,109,576,676,13,3,0,0,1638
"13185011000",104,145,1579,1330,149,195,11,204,3717
"13185011100",1112,536,133,207,42,60,57,16,2163
"13185011200",2858,1222,583,271,238,37,418,120,5747
"13185011301",983,1272,714,1997,22,182,31,274,5475
"13185011302",347,459,902,698,80,29,37,136,2688
"13185011401",1081,130,527,461,78,3,39,0,2319
"13185011402",747,279,280,253,151,56,118,112,1996
"13185011403",4874,1008,1103,1120,173,160,322,358,9118
"13185011500",2825,569,533,35,88,40,131,18,4239
"13185011600",3058,390,181,127,149,45,193,41,4184
"13187960101",5536,1265,0,302,70,11,245,36,7465
"13187960102",5448,684,0,0,140,50,244,50,6616
"13187960201",6868,1503,0,0,167,151,172,55,8916
"13187960202",4935,1581,75,180,132,143,375,178,7599
"13189950100",2154,215,194,36,22,16,0,0,2637
"13189950200",1895,155,1750,1162,0,77,94,77,5210
"13189950300",1373,118,1014,541,13,0,0,45,3104
"13189950400",1789,396,1416,1238,30,39,0,66,4974
"13189950500",3372,695,1202,195,47,68,157,96,5832
"13191110100",2612,146,1115,82,228,0,28,0,4211
"13191110200",2740,170,369,742,59,0,18,0,4098
"13191110300",2416,523,1656,787,305,88,214,0,5989
"13191980000",0,0,0,0,0,0,0,0,0
"13191990000",0,0,0,0,0,0,0,0,0
"13193000100",511,26,845,522,23,7,21,0,1955
"13193000200",823,163,655,383,151,2,17,1,2195
"13193000300",901,209,1284,768,50,165,41,44,3462
"13193000400",1699,130,1818,1335,90,6,0,44,5122
"13195020100",3782,1414,54,17,0,243,23,243,5776
"13195020200",3876,684,80,86,50,42,104,5,4927
"13195020300",2893,486,497,104,59,184,23,2,4248
"13195020400",3848,480,365,9,600,0,713,0,6015
"13195020500",4116,573,547,416,298,69,50,35,6104
"13195020600",1631,249,18,59,86,53,0,0,2096
"13197920100",3196,325,259,72,305,9,170,0,4336
"13197920200",1423,145,1320,1048,535,7,437,0,4915
"13199970500",2476,381,1293,1192,84,0,0,0,5426
"13199970600",1424,406,736,323,163,24,80,8,3164
"13199970700",4000,858,1676,738,235,31,134,29,7701
"13199970800",2281,345,1795,479,14,25,89,31,5059
"13201950100",1126,286,150,167,0,0,61,0,1790
"13201950200",684,87,458,573,2,0,0,0,1804
"13201950300",1695,237,195,184,0,0,0,0,2311
"13205090100",1494,707,684,450,0,45,165,0,3545
"13205090200",1697,532,466,377,144,257,167,72,3712
"13205090300",452,73,1292,767,0,0,78,15,2677
"13205090400",1721,385,2003,1389,122,0,78,22,5720
"13205090500",2738,528,1782,602,0,248,0,248,6146
"13207050101",4856,424,674,179,45,0,171,0,6349
"13207050102",2206,298,1052,308,13,26,80,26,4009
"13207050200",1649,221,1235,1141,200,10,89,0,4545
"13207050301",3817,207,516,238,9,0,32,0,4819
"13207050302",5119,258,463,0,204,95,74,64,6277
"13209950100",1490,385,75,80,24,14,15,48,2131
"13209950200",2061,506,923,437,87,0,141,153,4308
"13209950300",1263,417,211,179,32,10,74,52,2238
"13211010100",2211,242,377,70,79,0,167,0,3146
"13211010200",2736,206,442,64,55,0,0,0,3503
"13211010300",3708,447,1598,1047,156,0,134,0,7090
"13211010400",1870,373,438,103,14,18,55,75,2946
"13211010500",1164,122,83,2,42,1,69,0,1483
"13213010100",2935,641,14,0,151,0,282,65,4088
"13213010201",1614,504,0,0,1,0,0,67,2186
"13213010202",6833,1640,65,69,231,123,1198,423,10582
"13213010300",3232,588,51,12,40,15,51,26,4015
"13213010400",3831,1153,19,94,354,0,682,389,6522
"13213010500",4263,816,0,0,119,15,922,405,6540
"13213010600",3121,775,0,49,116,0,261,33,4355
"13213010700",3764,1535,10,1,64,53,468,51,5946
"13215000200",2193,426,55,62,273,0,240,147,3396
"13215000300",321,125,286,277,256,153,270,195,1883
"13215000400",2161,124,151,0,240,5,54,0,2735
"13215000800",1020,198,553,355,116,15,172,0,2429
"13215000900",1187,232,655,83,172,43,246,29,2647
"13215001000",2129,370,276,377,287,52,209,11,3711
"13215001100",2560,32,149,5,74,38,36,0,2894
"13215001200",2105,186,779,277,48,0,63,32,3490
"13215001400",629,218,442,398,109,51,77,19,1943
"13215001600",451,225,464,1023,31,64,26,48,2332
"13215001800",430,229,286,276,40,8,41,0,1310
"13215002000",143,1,2421,933,203,0,110,0,3811
"13215002100",1188,205,726,113,167,30,79,0,2508
"13215002200",70,134,1518,1461,0,18,0,26,3227
"13215002300",479,18,437,392,51,0,18,5,1400
"13215002400",100,51,671,598,0,61,0,24,1505
"13215002500",85,112,445,1100,19,14,55,14,1844
"13215002700",70,71,669,1464,49,22,0,0,2345
"13215002800",17,7,1094,595,86,0,64,0,1863
"13215002901",500,70,1708,395,73,145,45,100,3036
"13215002902",130,147,1332,853,168,69,167,124,2990
"13215003000",234,0,1213,1097,213,163,101,189,3210
"13215003200",53,142,1026,368,75,148,65,209,2086
"13215003301",178,144,650,208,96,11,0,37,1324
"13215003302",419,115,1249,971,72,32,105,0,2963
"13215003400",331,317,620,800,120,197,156,220,2761
"13215010104",3401,198,1805,103,673,257,514,52,7003
"13215010106",2944,248,1211,249,520,62,436,13,5683
"13215010107",4573,110,1711,45,776,12,423,63,7713
"13215010201",4889,242,412,0,921,183,367,37,7051
"13215010203",5117,469,1261,290,956,19,352,0,8464
"13215010204",4268,121,893,130,486,0,769,133,6800
"13215010205",2369,298,306,0,77,0,78,0,3128
"13215010301",2022,25,12,0,259,0,71,0,2389
"13215010302",4615,726,823,244,452,182,296,127,7465
"13215010401",4904,222,404,366,406,13,329,0,6644
"13215010402",2482,162,725,240,511,51,518,10,4699
"13215010501",3178,270,1783,201,283,12,214,0,5941
"13215010502",706,104,643,59,129,11,128,15,1795
"13215010602",906,283,2896,535,586,100,325,17,5648
"13215010605",134,35,3313,583,293,29,201,1,4589
"13215010606",4,0,23,15,0,0,0,0,42
"13215010607",569,289,3579,1073,177,16,75,23,5801
"13215010608",403,8,3024,655,143,57,57,59,4406
"13215010701",669,258,4219,711,112,0,144,24,6137
"13215010702",180,177,3780,858,180,52,87,35,5349
"13215010703",233,45,3805,1902,230,96,127,0,6438
"13215010801",889,108,288,113,158,35,250,0,1841
"13215010802",2540,111,910,29,1192,0,922,0,5704
"13215011100",401,319,332,229,7,6,32,5,1331
"13215011200",745,218,325,662,122,32,28,38,2170
"13215011400",1002,742,155,271,64,51,77,152,2514
"13215011500",1741,560,2155,552,762,216,730,376,7092
"13217100100",7175,806,2008,282,296,0,143,0,10710
"13217100201",5191,223,182,416,77,1,42,13,6145
"13217100202",3916,357,477,17,79,82,49,0,4977
"13217100300",4299,977,2405,1080,156,110,131,421,9579
"13217100400",1202,244,706,556,139,5,138,0,2990
"13217100501",2422,963,10073,1457,492,58,464,466,16395
"13217100502",2793,441,3088,869,257,115,847,159,8569
"13217100600",2141,626,2565,300,436,52,304,41,6465
"13217100700",1798,538,2127,1497,204,0,371,0,6535
"13217100800",5542,1105,1896,312,363,129,168,111,9626
"13217100901",4633,542,3732,430,411,0,0,0,9748
"13217100902",3021,249,1548,615,416,25,449,91,6414
"13217100903",2463,386,2126,745,328,0,101,166,6315
"13219030100",8989,598,682,11,774,80,541,116,11791
"13219030200",4316,466,201,234,191,23,138,270,5839
"13219030300",4552,326,29,26,124,64,207,25,5353
"13219030400",5919,484,247,36,314,34,120,0,7154
"13219030500",1913,51,111,33,12,0,4,0,2124
"13219030600",2228,227,182,0,6,42,111,0,2796
"13221960100",1019,411,203,198,18,88,0,36,1973
"13221960201",4995,375,395,145,468,131,220,110,6839
"13221960202",2956,389,600,205,191,10,159,0,4510
"13221960300",1117,120,406,24,49,25,34,8,1783
"13223120101",8786,1576,1352,0,359,0,190,0,12263
"13223120102",8267,609,833,253,807,0,714,0,11483
"13223120103",7800,681,678,0,159,39,238,227,9822
"13223120104",2023,122,7,0,153,0,20,0,2325
"13223120202",4507,361,1959,287,354,168,346,0,7982
"13223120203",4547,324,323,77,26,11,79,15,5402
"13223120204",5167,478,597,264,126,10,143,0,6785
"13223120301",3303,299,848,446,305,0,258,0,5459
"13223120302",7796,1822,2257,1144,224,127,961,652,14983
"13223120303",1213,160,357,24,46,7,83,0,1890
"13223120400",13531,1635,2135,386,572,0,651,16,18926
"13223120501",3402,882,1657,91,224,0,105,329,6690
"13223120502",7061,503,960,308,151,0,236,103,9322
"13223120503",3893,445,535,14,171,0,123,0,5181
"13223120601",2435,59,1326,98,473,24,563,0,4978
"13223120602",5849,953,1841,1132,150,0,400,197,10522
"13223120603",4026,186,1402,93,198,16,358,0,6279
"13223120604",3424,822,808,327,38,0,67,444,5930
"13223120605",4299,840,425,96,68,227,32,204,6191
"13225040101",1350,184,186,9,17,0,0,0,1746
"13225040102",6301,528,2043,278,275,151,174,113,9863
"13225040200",1553,204,1306,891,267,321,386,415,5343
"13225040301",1506,117,559,255,326,3,552,1,3319
"13225040302",451,122,577,1084,155,13,117,35,2554
"13225040400",256,9,2318,1492,10,60,0,99,4244
"13227050100",4092,217,67,0,25,0,177,0,4578
"13227050200",4885,528,89,26,422,14,301,0,6265
"13227050300",4005,466,68,0,72,0,174,0,4785
"13227050400",2817,927,0,3,33,0,59,0,3839
"13227050500",3817,452,27,0,55,0,50,0,4401
"13227050600",4976,808,24,0,239,70,108,0,6225
"13229960100",1909,593,170,21,21,5,17,66,2802
"13229960200",1424,272,0,111,117,33,238,24,2219
"13229960300",3978,1045,549,699,368,111,284,0,7034
"13229960400",6070,775,0,36,324,31,310,0,7546
"13231010100",5297,551,482,244,147,30,88,0,6839
"13231010200",3334,62,96,3,2,0,64,2,3563
"13231010300",2878,546,479,226,91,0,47,0,4267
"13231010400",2236,419,206,100,28,0,32,0,3021
"13233010100",3783,557,466,3,415,0,298,3,5525
"13233010200",5290,927,403,161,1592,178,1511,113,10175
"13233010300",3249,791,414,0,220,287,546,562,6069
"13233010400",3328,1123,535,510,193,421,476,574,7160
"13233010500",3488,577,801,278,304,27,763,98,6336
"13233010600",3592,1016,597,220,195,15,0,40,5675
"13233010700",2950,856,509,382,33,26,3,83,4842
"13235950100",1028,184,210,123,0,0,132,26,1703
"13235950200",3780,602,2163,385,236,0,141,220,7527
"13235950300",1087,66,227,49,21,0,13,0,1463
"13237960101",2694,236,236,47,28,0,55,0,3296
"13237960102",4378,159,286,32,159,0,198,80,5292
"13237960201",784,154,165,104,2,2,108,0,1319
"13237960202",2075,423,3018,1301,133,139,617,292,7998
"13237960300",3513,346,487,0,50,37,37,0,4470
"13239960300",895,199,788,486,32,7,0,0,2407
"13241970100",4050,991,4,107,176,209,298,450,6285
"13241970201",2644,600,0,0,120,14,122,86,3586
"13241970202",1808,643,21,28,162,0,269,0,2931
"13241970301",2287,573,8,7,8,113,20,19,3035
"13241970302",986,422,0,0,0,102,49,0,1559
"13243790100",785,142,537,308,0,0,0,20,1792
"13243790200",1239,314,2030,1566,229,0,22,0,5400
"13245000100",1724,442,788,588,187,0,56,0,3785
"13245000200",809,387,282,660,194,72,59,69,2532
"13245000300",343,220,309,228,4,9,9,0,1122
"13245000600",375,87,673,802,44,0,31,9,2021
"13245000700",15,23,647,684,0,0,7,0,1376
"13245000900",0,2,678,676,13,0,0,0,1369
"13245001000",838,576,544,403,41,56,37,66,2561
"13245001100",1603,122,37,45,32,13,26,0,1878
"13245001200",1578,622,989,778,112,0,26,0,4105
"13245001300",626,76,700,149,28,23,70,0,1672
"13245001400",6,58,806,1079,9,1,9,18,1986
"13245001500",9,3,551,399,0,0,0,0,962
"13245001601",993,265,1895,825,155,57,132,50,4372
"13245001602",2590,289,522,307,103,66,11,0,3888
"13245010101",2045,205,691,236,266,12,332,10,3797
"13245010104",1810,139,767,278,315,9,133,23,3474
"13245010105",3133,306,922,212,129,24,104,147,4977
"13245010106",2648,258,1623,260,451,65,122,20,5447
"13245010107",1227,296,449,223,111,318,39,14,2677
"13245010201",3781,304,212,180,105,0,53,0,4635
"13245010203",1096,349,1831,315,224,46,66,47,3974
"13245010204",4853,1160,5228,494,1015,0,836,475,14061
"13245010300",607,239,2857,1782,53,18,244,152,5952
"13245010400",501,45,1465,2317,9,60,52,65,4514
"13245010504",1777,384,2648,1957,63,59,54,259,7201
"13245010506",1247,242,1681,1491,200,83,161,17,5122
"13245010507",803,298,3201,1233,128,11,89,11,5774
"13245010508",1133,128,1369,985,111,62,49,43,3880
"13245010509",1547,158,1625,886,263,26,71,0,4576
"13245010510",1813,542,1665,891,181,35,28,0,5155
"13245010511",931,534,1263,680,25,80,13,10,3536
"13245010512",390,219,2745,1085,85,42,0,85,4651
"13245010513",276,177,1941,591,120,18,47,0,3170
"13245010600",131,33,1982,1821,10,95,53,25,4150
"13245010706",1489,458,2024,1114,151,124,96,49,5505
"13245010707",134,151,1508,677,70,155,19,172,2886
"13245010708",895,56,3472,921,593,257,484,28,6706
"13245010709",198,1,4700,740,265,23,158,0,6085
"13245010710",1214,554,1864,1372,190,44,153,0,5391
"13245010711",627,402,1341,297,160,31,141,49,3048
"13245010712",898,56,5953,890,612,251,139,121,8920
"13245010800",1672,396,1174,8,958,198,690,163,5259
"13245010903",2453,665,1422,271,251,43,130,65,5300
"13245010904",1437,372,966,248,153,7,16,97,3296
"13245010905",3240,797,788,16,85,99,30,0,5055
"13245010906",4117,248,1913,283,442,68,655,58,7784
"13245011000",488,294,240,274,60,12,47,33,1448
"13247060101",2451,322,352,73,42,11,209,37,3497
"13247060102",2898,531,1342,86,387,21,332,0,5597
"13247060201",1605,844,1254,174,357,164,1259,961,6618
"13247060202",3045,106,4684,1052,581,124,260,118,9970
"13247060304",1729,143,2426,813,14,11,337,20,5493
"13247060305",1197,865,1973,895,234,64,486,707,6421
"13247060306",627,130,1888,193,11,0,12,5,2866
"13247060307",2512,313,6420,611,692,107,325,33,11013
"13247060308",1607,597,3961,1051,420,563,594,722,9515
"13247060309",1565,217,2474,919,518,0,737,51,6481
"13247060403",1691,63,1315,246,260,0,106,13,3694
"13247060404",3289,210,1947,214,287,58,170,31,6206
"13247060405",3622,241,2017,615,264,36,186,36,7017
"13247060406",3256,110,1535,275,239,0,486,13,5914
"13247060407",2110,428,421,91,105,0,160,30,3345
"13249960100",1507,307,543,392,136,43,140,125,3193
"13249960200",1535,135,186,189,9,51,9,51,2165
"13251970200",825,40,678,403,2,0,2,0,1950
"13251970300",1436,268,657,392,19,6,51,0,2829
"13251970400",2127,521,972,874,37,204,60,56,4851
"13251970500",1293,210,877,314,17,0,5,0,2716
"13251970600",979,112,468,124,43,1,34,1,1762
"13253200100",2201,372,147,33,23,45,93,23,2937
"13253200200",1305,194,985,879,62,63,24,84,3596
"13253200300",1434,53,572,324,0,0,23,0,2406
"13255160100",4197,719,268,24,57,31,666,69,6031
"13255160200",3792,774,1088,148,278,19,140,19,6258
"13255160300",618,413,1335,870,14,58,14,11,3333
"13255160400",1119,482,2119,749,258,136,172,35,5070
"13255160500",3189,278,1801,870,672,23,238,96,7167
"13255160600",3616,393,87,136,27,69,101,27,4456
"13255160700",2377,574,2060,1244,273,98,133,0,6759
"13255160800",643,731,1903,1583,0,120,203,253,5436
"13255160900",1036,496,650,231,10,73,0,101,2597
"13255161000",3933,731,419,124,132,11,8,48,5406
"13255161100",3039,337,260,28,93,51,199,0,4007
"13255161200",5762,474,1410,1059,31,0,0,0,8736
"13257970100",4413,955,368,387,105,0,120,0,6348
"13257970200",4909,830,287,168,186,84,146,84,6694
"13257970301",1692,372,505,467,318,19,248,19,3640
"13257970302",1854,372,384,56,0,0,0,0,2666
"13257970400",4623,1041,348,56,69,0,70,0,6207
"13259950100",733,52,726,878,8,0,12,0,2409
"13259950400",695,46,780,661,92,0,17,0,2291
"13261950100",518,170,442,84,62,5,13,17,1311
"13261950200",1365,518,1107,1661,129,247,51,144,5222
"13261950300",1126,128,3256,1795,269,25,23,25,6647
"13261950400",1419,389,589,379,8,0,83,180,3047
"13261950500",2290,211,511,375,83,72,214,84,3840
"13261950600",935,85,460,430,201,19,104,19,2253
"13261950700",1681,357,1675,1592,104,200,154,325,6088
"13261950800",1319,410,741,249,47,0,155,14,2935
"13263960100",1010,38,1139,192,34,0,0,0,2413
"13263960200",705,106,1360,409,0,11,59,6,2656
"13263960300",572,246,508,202,28,0,49,0,1605
"13265010200",596,163,530,361,32,0,24,18,1724
"13267950100",1922,509,373,480,52,134,80,134,3684
"13267950201",1863,734,1148,754,91,6,173,7,4776
"13267950202",1766,637,7,166,251,949,532,897,5205
"13267950300",2502,315,310,300,309,0,188,106,4030
"13267950400",2911,649,465,177,86,12,151,103,4554
"13269950100",942,91,363,46,0,0,0,0,1442
"13269950200",1147,210,589,438,15,4,54,29,2486
"13269950300",1995,538,918,862,13,69,29,69,4493
"13271950100",4593,927,2006,1604,49,0,292,0,9471
"13271950200",909,226,24,86,10,0,10,0,1265
"13271950500",1105,361,489,275,4,10,57,121,2422
"13273120200",1078,54,290,365,6,0,6,0,1799
"13273120300",445,64,1505,1051,46,0,124,0,3235
"13273120400",657,82,720,1047,31,0,0,0,2537
"13273120500",918,113,225,133,47,39,45,26,1546
"13275960100",438,92,269,398,15,59,95,80,1446
"13275960200",2561,700,182,129,94,107,29,79,3881
"13275960300",1347,156,352,231,35,38,6,35,2200
"13275960400",1443,312,257,249,10,13,14,20,2318
"13275960500",4135,756,869,400,181,41,51,46,6479
"13275960600",2977,600,1271,299,75,0,56,7,5285
"13275960700",2162,428,1811,2145,170,138,0,170,7024
"13275960800",1975,153,1742,1509,158,27,232,29,5825
"13275960900",1209,255,1339,528,64,18,13,6,3432
"13275961000",2575,597,291,399,53,29,107,183,4234
"13275961100",1116,125,1013,504,32,55,31,38,2914
"13277960100",1800,310,240,102,5,17,285,148,2907
"13277960200",2182,304,438,95,21,4,113,83,3240
"13277960300",3968,767,554,161,279,445,58,200,6432
"13277960400",3207,665,1109,572,232,197,461,158,6601
"13277960500",3276,823,204,0,41,56,52,0,4452
"13277960600",309,432,2328,2330,252,21,271,38,5981
"13277960700",1350,538,1132,1168,583,195,792,304,6062
"13277960800",1278,806,75,69,300,86,485,443,3542
"13277960900",2108,422,557,123,226,56,317,65,3874
"13279970100",2007,920,813,713,505,147,553,477,6135
"13279970200",2722,437,477,1109,16,0,268,98,5127
"13279970300",3428,477,1451,344,395,0,562,1,6658
"13279970400",1769,675,841,595,250,30,38,24,4222
"13279970500",2220,956,80,62,163,20,275,414,4190
"13279970600",2415,311,220,48,119,122,250,122,3607
"13281960100",2953,496,3,22,2,0,18,22,3516
"13281960200",2262,276,0,0,21,92,16,92,2759
"13281960300",2841,720,0,6,115,60,18,51,3811
"13283960100",1052,112,57,0,0,0,48,0,1269
"13283960200",2824,342,994,868,7,74,0,0,5109
"13285960100",3416,844,779,800,204,55,15,1,6114
"13285960201",2182,201,325,0,142,0,20,0,2870
"13285960202",1757,60,392,91,42,0,30,0,2372
"13285960300",3242,147,163,0,111,0,188,12,3863
"13285960400",2896,454,1420,426,469,127,51,73,5916
"13285960501",1558,620,1425,680,178,24,184,368,5037
"13285960502",3718,924,1228,664,604,59,285,40,7522
"13285960600",1642,270,2043,1425,147,0,113,9,5649
"13285960700",2370,319,1268,753,538,9,306,0,5563
"13285960800",611,471,1047,1024,30,184,138,1,3506
"13285960901",1104,292,1339,958,189,83,237,99,4301
"13285960902",5008,415,1092,33,142,47,28,0,6765
"13285961000",3003,738,1693,1026,32,0,50,17,6559
"13285961100",2293,231,127,111,0,18,37,0,2817
"13287970200",1913,297,1756,1302,77,48,262,42,5697
"13287970300",2096,273,258,79,29,23,10,7,2775
"13289060100",2370,655,920,548,53,9,0,0,4555
"13289060200",1343,387,1290,926,3,0,0,0,3949
"13291000101",1950,526,0,0,0,0,0,0,2476
"13291000102",4316,546,10,0,8,0,0,0,4880
"13291000201",2275,382,0,3,232,5,22,0,2919
"13291000203",1728,396,0,0,129,0,101,0,2354
"13291000204",2449,580,0,0,104,0,24,0,3157
"13291000205",4227,1160,0,3,21,47,0,431,5889
"13293010100",2319,272,437,57,15,7,71,0,3178
"13293010201",2824,952,875,488,0,11,11,386,5547
"13293010202",2259,462,72,1,62,0,0,0,2856
"13293010300",2741,265,186,83,17,17,17,0,3326
"13293010400",3046,384,1228,869,91,0,102,0,5720
"13293010500",1334,870,1636,897,20,54,0,28,4839
"13293010600",545,78,451,108,45,0,0,0,1227
"13295020100",4280,1836,271,41,246,46,92,21,6833
"13295020200",1959,1223,160,54,235,86,45,36,3798
"13295020301",3363,1263,230,14,161,32,169,32,5264
"13295020302",4307,676,17,0,92,0,55,0,5147
"13295020400",2842,503,31,6,73,0,45,5,3505
"13295020501",6230,713,345,21,189,15,56,0,7569
"13295020502",5287,1300,68,0,13,104,21,9,6802
"13295020601",5480,423,18,15,80,22,138,0,6176
"13295020602",3170,510,183,9,395,20,295,16,4598
"13295020700",5377,969,134,227,192,33,78,0,7010
"13295020800",2502,388,123,120,24,0,0,0,3157
"13295020901",5180,608,65,39,10,73,10,20,6005
"13295020902",1527,215,139,11,35,0,36,0,1963
"13297110100",6904,878,420,102,482,55,21,188,9050
"13297110200",3258,419,393,13,126,0,5,0,4214
"13297110300",2971,356,1504,1440,110,96,254,0,6731
"13297110400",2331,519,1315,1763,206,20,84,14,6252
"13297110503",2922,370,101,0,14,0,183,0,3590
"13297110504",3198,301,263,0,552,372,322,331,5339
"13297110505",3650,279,154,0,157,208,174,215,4837
"13297110506",4243,340,297,18,145,0,242,0,5285
"13297110507",5329,438,793,197,711,91,253,135,7947
"13297110508",3917,455,221,26,43,28,36,28,4754
"13297110601",3947,343,372,56,90,0,75,0,4883
"13297110602",4052,473,463,12,123,0,58,0,5181
"13297110603",3415,752,205,8,144,162,6,197,4889
"13297110700",4964,911,1047,430,27,58,174,24,7635
"13297110800",5164,177,1132,284,85,0,51,0,6893
"13299950100",1415,211,16,0,5,44,0,0,1691
"13299950200",3971,987,216,0,143,101,152,195,5765
"13299950300",1383,261,249,178,5,0,0,0,2076
"13299950400",87,62,776,938,0,5,0,30,1898
"13299950500",2141,871,1334,426,53,234,49,0,5108
"13299950600",4108,484,836,156,298,0,55,0,5937
"13299950700",178,101,453,579,104,23,105,22,1565
"13299950800",2651,557,1103,1113,326,0,315,0,6065
"13299950900",2260,934,469,371,45,114,146,114,4453
"13301970400",875,47,785,831,126,0,0,0,2664
"13301970500",863,266,1197,542,13,1,3,0,2885
"13303950100",1334,44,380,199,58,9,0,0,2024
"13303950300",1568,247,1194,1243,36,15,87,0,4390
"13303950400",1784,182,1672,1216,32,0,10,34,4930
"13303950500",1821,377,1213,478,109,21,49,65,4133
"13303950700",1417,282,1407,921,13,0,6,141,4187
"13305970100",3341,639,162,7,34,243,72,140,4638
"13305970200",5130,1120,1048,381,164,65,185,142,8235
"13305970300",2510,364,693,837,110,60,251,106,4931
"13305970400",2390,341,384,69,167,8,179,3,3541
"13305970500",1554,774,652,447,184,122,14,200,3947
"13305970600",2972,408,207,313,22,0,24,24,3970
"13307960100",613,109,557,162,0,0,0,0,1441
"13307960200",426,181,464,221,0,0,0,0,1292
"13309780100",1258,347,63,135,1,4,9,0,1817
"13309780200",1344,304,176,94,18,0,0,0,1936
"13311950100",2178,366,90,12,75,15,9,0,2745
"13311950201",5765,2258,473,15,135,2,165,243,9056
"13311950202",2951,216,0,0,15,16,92,0,3290
"13311950203",4275,592,211,0,0,0,0,0,5078
"13311950300",5816,1544,1,0,0,116,76,143,7696
"13313000101",3502,626,2,3,46,54,97,160,4490
"13313000102",6025,1127,286,10,701,68,1277,157,9651
"13313000200",3293,543,0,2,106,27,206,289,4466
"13313000301",2859,702,44,58,309,111,1182,490,5755
"13313000302",7843,934,154,88,306,25,2412,576,12338
"13313000400",4789,1767,257,140,1190,375,3892,1590,14000
"13313000501",3209,456,28,42,393,129,894,96,5247
"13313000502",3032,1934,622,301,111,200,1827,872,8899
"13313000600",3087,489,127,20,182,140,257,421,4723
"13313000700",3904,668,71,1,136,135,153,127,5195
"13313000800",5914,730,249,311,544,80,1092,55,8975
"13313000900",2893,242,227,136,232,0,187,136,4053
"13313001000",2539,1034,202,109,114,91,2101,961,7151
"13313001100",3078,1283,80,2,290,91,1404,841,7069
"13313001200",4749,1502,157,16,607,497,2332,1268,11128
"13313001300",1675,1881,151,125,144,125,1413,1594,7108
"13313001400",5035,403,48,1,766,66,2511,234,9064
"13313001500",4832,537,77,0,248,21,281,41,6037
"13315960100",1145,313,390,237,35,0,0,0,2120
"13315960200",669,43,332,306,36,18,10,18,1432
"13315960300",960,296,85,132,5,2,0,0,1480
"13315960400",1098,265,401,197,18,16,0,0,1995
"13317010101",825,160,343,248,16,9,0,0,1601
"13317010102",644,217,240,350,25,144,55,144,1819
"13317010301",1470,157,313,253,60,0,86,0,2339
"13317010302",1574,288,1462,1037,33,62,90,0,4546
"13319960200",1276,463,1208,536,0,1,66,134,3684
"13319960300",2577,289,915,409,238,2,20,0,4450
"13319960400",916,80,353,74,1,5,10,5,1444
"13321950100",1783,311,429,329,33,0,45,0,2930
"13321950200",4164,577,1519,544,14,0,127,188,7133
"13321950400",2983,636,643,337,157,47,0,22,4825
"13321950500",1957,373,1344,715,59,28,14,9,4499
"13321950600",1506,426,220,28,23,0,18,0,2221
"15001020100",1510,322,7,29,2580,635,356,183,5622
"15001020202",538,104,5,0,981,198,134,19,1979
"15001020300",557,253,12,0,1885,849,307,79,3942
"15001020400",546,242,104,25,1693,1477,193,660,4940
"15001020500",372,388,0,8,2694,1072,212,266,5012
"15001020600",471,137,43,0,4617,793,365,100,6526
"15001020701",392,91,18,0,3474,293,207,54,4529
"15001020702",585,0,39,0,4165,256,504,12,5561
"15001020801",669,94,0,0,3411,150,267,34,4625
"15001020802",1040,123,0,0,4064,1027,253,329,6836
"15001020900",907,74,13,0,3602,503,564,157,5820
"15001021003",1547,485,44,8,3822,1339,733,531,8509
"15001021005",2613,1154,225,0,4838,2519,857,1793,13999
"15001021010",2422,765,22,69,1864,1508,589,719,7958
"15001021011",1308,269,0,0,1324,554,312,194,3961
"15001021013",714,219,0,4,3401,760,336,97,5531
"15001021101",1454,463,0,0,762,376,191,199,3445
"15001021106",1334,650,28,39,3426,1752,509,572,8310
"15001021202",2172,769,0,5,3365,1342,467,323,8443
"15001021300",1933,408,6,0,3745,639,354,21,7106
"15001021402",872,94,23,0,2644,337,360,76,4406
"15001021502",1943,206,56,15,2349,300,515,48,5432
"15001021504",699,40,58,2,3030,914,369,50,5162
"15001021507",4556,574,16,0,3252,789,1252,124,10563
"15001021509",2488,406,0,0,2067,901,391,334,6587
"15001021601",3175,390,34,0,3259,489,621,93,8061
"15001021604",3332,364,55,0,3660,323,1136,62,8932
"15001021702",3444,199,170,6,5025,1018,651,116,10629
"15001021704",4064,327,52,0,3448,312,298,30,8531
"15001021800",1289,217,23,0,3919,1076,742,148,7414
"15001021902",1309,368,0,0,2455,288,261,11,4692
"15001022000",873,85,0,0,1909,353,96,33,3349
"15001022102",469,37,0,0,1190,179,302,0,2177
"15001990000",0,0,0,0,0,0,0,0,0
"15001990100",0,0,0,0,0,0,0,0,0
"15001990300",0,0,0,0,0,0,0,0,0
"15001990400",0,0,0,0,0,0,0,0,0
"15001990500",0,0,0,0,0,0,0,0,0
"15001990600",0,0,0,0,0,0,0,0,0
"15001990700",0,0,0,0,0,0,0,0,0
"15001990800",0,0,0,0,0,0,0,0,0
"15001990900",0,0,0,0,0,0,0,0,0
"15001991000",0,0,0,0,0,0,0,0,0
"15001991100",0,0,0,0,0,0,0,0,0
"15001991200",0,0,0,0,0,0,0,0,0
"15001991300",0,0,0,0,0,0,0,0,0
"15001991400",0,0,0,0,0,0,0,0,0
"15001991500",0,0,0,0,0,0,0,0,0
"15001991600",0,0,0,0,0,0,0,0,0
"15001991700",0,0,0,0,0,0,0,0,0
"15003000106",2096,136,169,0,5312,191,366,66,8336
"15003000107",716,0,0,0,1997,17,52,0,2782
"15003000108",1258,38,53,0,1895,78,92,0,3414
"15003000110",1364,157,0,0,2720,82,105,0,4428
"15003000111",603,55,0,0,4114,59,232,14,5077
"15003000112",1185,293,39,0,3524,59,164,37,5301
"15003000114",637,0,0,0,849,23,56,0,1565
"15003000200",1039,58,0,14,4541,88,314,5,6059
"15003000301",531,37,17,0,2660,26,153,0,3424
"15003000302",502,1,0,0,2486,126,67,0,3182
"15003000401",610,31,6,0,1821,56,33,11,2568
"15003000402",822,26,0,0,2923,31,133,0,3935
"15003000500",1296,57,12,0,2017,69,209,0,3660
"15003000600",413,47,0,0,898,19,0,0,1377
"15003000700",228,7,0,0,2498,190,219,0,3142
"15003000800",310,38,17,0,3444,132,63,0,4004
"15003000901",516,34,0,0,2049,209,43,0,2851
"15003000902",1105,46,64,13,2526,130,227,45,4156
"15003000903",510,100,15,0,2063,166,121,3,2978
"15003001000",478,54,0,0,2238,227,339,13,3349
"15003001100",304,30,0,0,2948,877,208,19,4386
"15003001201",189,26,0,0,2584,168,246,12,3225
"15003001202",193,21,0,0,2700,200,260,22,3396
"15003001300",510,92,62,0,3714,318,147,0,4843
"15003001400",236,19,27,0,1976,104,26,1,2389
"15003001500",650,124,0,0,2714,133,99,0,3720
"15003001600",576,86,0,0,2925,144,242,0,3973
"15003001700",1125,108,35,0,706,73,95,0,2142
"15003001801",330,154,8,2,526,232,100,31,1383
"15003001803",1221,50,250,0,1161,193,237,20,3132
"15003001804",644,47,30,0,653,119,103,10,1606
"15003001901",241,25,0,8,118,20,33,0,445
"15003001903",1342,107,0,0,1647,209,173,24,3502
"15003001904",1462,274,72,0,1667,135,158,0,3768
"15003002003",671,246,51,0,593,461,67,38,2127
"15003002004",554,119,0,0,781,78,172,7,1711
"15003002005",807,205,113,21,637,145,75,0,2003
"15003002006",714,126,36,0,1000,239,114,8,2237
"15003002100",593,64,14,0,2302,268,240,48,3529
"15003002201",522,67,0,0,2671,328,59,33,3680
"15003002202",950,36,24,0,2085,86,173,0,3354
"15003002300",469,204,37,0,3474,679,262,253,5378
"15003002401",174,68,227,35,2383,445,139,7,3478
"15003002402",400,62,0,0,2190,627,40,0,3319
"15003002500",396,44,12,0,2704,747,105,53,4061
"15003002600",460,196,10,0,2995,261,175,40,4137
"15003002701",262,34,141,0,1742,348,137,25,2689
"15003002702",792,132,25,22,3189,646,145,86,5037
"15003002800",981,111,0,0,2814,121,219,48,4294
"15003002900",711,75,0,0,1566,92,108,0,2552
"15003003000",1282,154,0,0,2970,224,130,37,4797
"15003003101",468,64,30,0,3132,89,61,12,3856
"15003003102",725,86,0,0,2665,86,0,4,3566
"15003003200",310,36,7,0,437,49,7,0,846
"15003003300",255,26,0,0,907,38,28,0,1254
"15003003403",1109,177,79,0,3737,560,380,104,6146
"15003003404",509,44,76,0,3842,325,385,50,5231
"15003003405",789,244,5,0,2011,448,164,34,3695
"15003003406",644,259,20,28,3917,953,474,13,6308
"15003003407",231,27,0,0,434,47,3,9,751
"15003003501",370,32,46,0,1581,214,100,0,2343
"15003003502",336,36,15,0,2932,382,98,0,3799
"15003003601",807,158,95,12,2678,436,273,0,4459
"15003003603",445,41,0,0,1861,727,53,0,3127
"15003003604",370,22,49,0,1633,197,78,0,2349
"15003003700",1807,139,0,0,3716,239,502,40,6443
"15003003800",817,14,25,10,2792,143,59,14,3874
"15003003900",81,4,38,22,147,37,8,4,341
"15003004000",459,133,95,23,591,50,33,6,1390
"15003004100",580,43,213,0,2935,364,205,0,4340
"15003004200",841,43,27,0,2055,216,109,0,3291
"15003004300",634,263,150,19,3636,676,87,47,5512
"15003004400",301,11,0,0,4862,386,294,39,5893
"15003004500",971,30,18,0,3496,114,276,0,4905
"15003004600",241,24,0,0,3544,111,148,0,4068
"15003004700",494,127,0,0,3691,237,164,16,4729
"15003004800",363,75,20,0,5206,902,504,102,7172
"15003004900",118,29,26,0,2712,317,165,89,3456
"15003005000",273,134,42,0,3383,266,128,0,4226
"15003005100",586,35,0,0,1700,700,43,32,3096
"15003005200",194,46,125,47,1892,510,45,0,2859
"15003005300",234,84,183,63,2548,697,208,96,4113
"15003005400",7,5,0,0,671,885,102,67,1737
"15003005500",20,5,0,0,1633,345,93,34,2130
"15003005600",126,22,0,0,5650,1248,342,191,7579
"15003005700",152,212,9,22,1486,477,78,45,2481
"15003005800",39,29,0,0,2646,771,110,53,3648
"15003005900",46,3,4,0,1848,221,9,0,2131
"15003006000",64,32,21,0,5700,232,240,0,6289
"15003006100",202,3,0,7,3480,546,203,87,4528
"15003006201",121,18,9,0,4339,1256,167,30,5940
"15003006202",18,4,5,4,540,1228,40,32,1871
"15003006301",121,20,13,0,3336,247,182,28,3947
"15003006302",33,0,0,0,1453,1035,12,133,2666
"15003006401",5,9,69,0,2459,196,82,7,2827
"15003006402",348,50,1,23,6390,547,424,24,7807
"15003006500",308,44,29,0,4138,158,202,28,4907
"15003006600",271,0,64,0,519,0,0,0,854
"15003006701",586,76,105,0,4770,250,46,11,5844
"15003006702",746,17,149,0,1319,92,263,17,2603
"15003006802",542,9,175,0,6473,733,472,36,8440
"15003006804",1523,166,1114,110,969,249,594,0,4725
"15003006805",494,85,294,0,4826,50,323,30,6102
"15003006806",32,1,0,0,1665,24,0,0,1722
"15003006808",460,7,175,0,3678,294,99,7,4720
"15003006809",323,21,15,0,4045,784,333,267,5788
"15003006900",2302,200,315,0,1137,6,548,96,4604
"15003007000",2338,174,415,15,1275,149,893,41,5300
"15003007100",2539,83,315,55,510,76,590,32,4200
"15003007302",3252,274,188,12,714,109,617,0,5166
"15003007303",26,0,0,0,0,0,0,0,26
"15003007400",1887,133,152,24,555,50,270,11,3082
"15003007502",142,2,47,3,133,5,55,0,387
"15003007503",549,21,24,0,4062,336,256,199,5447
"15003007504",125,16,33,0,2494,668,294,195,3825
"15003007505",833,17,7,0,4280,343,371,96,5947
"15003007506",155,0,22,0,102,0,24,0,303
"15003007701",900,51,0,0,3049,308,353,52,4713
"15003007702",778,63,0,0,3856,87,194,9,4987
"15003007804",165,2,0,0,1808,29,275,0,2279
"15003007805",292,9,44,0,4424,279,657,110,5815
"15003007807",942,11,197,14,3361,449,456,0,5430
"15003007808",308,23,27,0,2369,139,412,0,3278
"15003007809",158,14,0,0,3323,72,213,0,3780
"15003007810",672,17,12,0,4357,77,141,16,5292
"15003007811",773,0,90,0,3781,180,208,22,5054
"15003008001",51,11,0,0,1511,315,246,157,2291
"15003008002",157,0,0,0,2297,337,102,81,2974
"15003008003",1133,0,117,0,3422,552,513,16,5753
"15003008005",826,59,0,1,5583,336,830,1,7636
"15003008006",238,10,21,119,4385,140,443,0,5356
"15003008007",248,36,35,0,5231,192,197,28,5967
"15003008301",1722,218,379,59,2578,200,748,124,6028
"15003008302",427,65,33,0,5324,1022,527,202,7600
"15003008402",700,61,39,13,5422,1012,710,127,8084
"15003008405",995,0,48,0,3477,71,430,28,5049
"15003008406",1319,25,742,0,4464,116,480,0,7146
"15003008407",1022,47,609,27,1710,144,365,41,3965
"15003008408",2481,25,374,77,3046,0,606,0,6609
"15003008410",618,19,154,0,2359,83,253,6,3492
"15003008411",560,59,107,0,2726,93,336,78,3959
"15003008412",1049,81,40,8,4122,143,829,59,6331
"15003008502",731,127,77,19,1090,599,211,217,3071
"15003008606",1077,93,446,0,8526,220,915,0,11277
"15003008609",635,35,39,0,1227,60,222,33,2251
"15003008610",927,4,22,0,180,26,48,0,1207
"15003008611",30,0,0,0,56,62,45,0,193
"15003008612",1923,36,354,37,3514,152,803,0,6819
"15003008613",143,14,0,1,904,164,207,44,1477
"15003008614",1343,85,543,0,7241,233,1183,50,10678
"15003008617",403,143,143,0,10097,276,2009,0,13071
"15003008622",777,76,32,0,3230,156,382,0,4653
"15003008701",345,33,31,26,8154,455,624,33,9701
"15003008702",149,9,0,0,4888,673,436,82,6237
"15003008703",535,64,0,16,3937,2066,593,182,7393
"15003008800",340,108,0,10,7455,805,298,131,9147
"15003008906",749,61,45,0,3169,38,368,0,4430
"15003008907",821,62,136,8,2856,376,272,127,4658
"15003008908",1242,32,30,0,4359,62,699,0,6424
"15003008909",742,17,75,0,2836,213,553,26,4462
"15003008912",0,26,0,0,2179,110,38,7,2360
"15003008913",141,6,0,0,3907,115,341,0,4510
"15003008914",199,110,172,51,4230,938,392,267,6359
"15003008915",902,62,153,0,2987,703,365,77,5249
"15003008917",769,8,45,0,3747,47,287,0,4903
"15003008918",951,127,144,0,4211,183,415,165,6196
"15003008920",710,48,149,0,2979,229,517,86,4718
"15003008921",226,60,23,0,2469,86,749,16,3629
"15003008922",846,0,358,0,6578,86,429,46,8343
"15003008923",554,0,102,0,3712,146,486,0,5000
"15003008924",1014,40,66,0,6062,217,405,27,7831
"15003008925",947,26,297,0,5878,232,626,16,8022
"15003008926",585,59,91,7,939,74,47,0,1802
"15003008927",941,8,117,0,3807,21,141,0,5035
"15003008928",756,0,29,0,3307,0,489,0,4581
"15003008929",805,1,129,0,3771,136,721,0,5563
"15003008930",590,0,0,0,1816,6,102,0,2514
"15003008931",536,21,35,0,2404,29,48,17,3090
"15003009000",1479,281,244,4,449,54,422,61,2994
"15003009100",376,73,113,0,4466,546,384,46,6004
"15003009200",802,56,0,0,5920,410,707,99,7994
"15003009300",520,145,180,0,3296,546,321,27,5035
"15003009400",646,120,163,12,3593,915,514,85,6048
"15003009501",3204,382,1126,27,1012,179,1379,204,7513
"15003009502",2570,316,857,163,1008,162,863,175,6114
"15003009503",437,48,80,17,127,0,87,0,796
"15003009504",960,52,197,0,136,11,152,0,1508
"15003009507",1109,171,418,12,413,163,458,45,2789
"15003009603",1080,277,109,59,6073,1896,1162,237,10893
"15003009608",457,55,97,91,3813,1319,499,378,6709
"15003009701",508,137,53,42,3216,2339,865,539,7699
"15003009703",234,55,119,0,4759,1056,388,332,6943
"15003009704",221,86,66,0,2653,329,541,85,3981
"15003009801",643,159,102,73,748,525,179,207,2636
"15003009802",566,254,33,9,4169,1584,996,404,8015
"15003009902",1080,188,60,20,2062,217,433,38,4098
"15003009904",1843,209,28,8,3076,226,566,47,6003
"15003010000",2296,245,307,0,840,164,524,63,4439
"15003010100",3055,348,75,17,4372,406,552,93,8918
"15003010201",1596,105,50,31,2882,563,559,81,5867
"15003010202",1038,229,55,0,3438,490,326,28,5604
"15003010303",784,81,38,0,3372,370,410,5,5060
"15003010305",889,58,0,0,3118,660,883,0,5608
"15003010306",1376,175,44,0,4776,176,570,1,7118
"15003010308",492,52,0,0,2548,58,78,31,3259
"15003010503",144,36,26,0,1306,59,138,10,1719
"15003010504",462,191,0,0,3465,287,370,22,4797
"15003010505",915,10,0,0,2333,24,205,0,3487
"15003010507",1103,55,70,0,3741,653,608,168,6398
"15003010508",1009,61,18,0,1345,44,176,28,2681
"15003010601",473,46,18,0,3017,223,281,12,4070
"15003010602",554,30,50,0,4326,217,258,68,5503
"15003010701",1407,122,0,0,2047,8,89,0,3673
"15003010702",750,20,37,0,2312,131,136,0,3386
"15003010801",1702,62,91,0,563,137,348,53,2956
"15003010802",3523,551,406,0,930,140,982,116,6648
"15003010901",2011,88,8,0,1116,20,170,0,3413
"15003010903",1258,313,61,9,2629,118,339,26,4753
"15003010904",1504,110,46,4,1517,187,246,35,3649
"15003010905",662,219,6,0,1517,119,292,3,2818
"15003011000",1206,22,12,0,2114,49,145,0,3548
"15003011103",1240,17,14,0,2567,13,213,0,4064
"15003011104",1586,141,0,4,2803,166,472,2,5174
"15003011105",1834,131,110,15,1348,49,184,32,3703
"15003011106",1824,97,24,0,4011,82,326,0,6364
"15003011201",2943,170,0,0,1304,47,432,8,4904
"15003011202",932,93,0,0,671,28,31,5,1760
"15003011300",711,71,29,25,3906,1057,388,55,6242
"15003011400",1279,51,169,0,589,162,162,0,2412
"15003011500",627,65,436,0,5098,173,1171,2,7572
"15003940001",430,38,0,0,3836,336,498,28,5166
"15003940002",183,30,20,0,5740,1024,833,135,7965
"15003980000",0,0,0,0,2,0,0,0,2
"15003980200",0,0,0,0,0,0,0,0,0
"15003980300",0,0,0,0,0,0,0,0,0
"15003980600",91,0,0,0,0,0,0,0,91
"15003980700",0,0,0,0,0,0,0,0,0
"15003980800",0,0,0,0,0,0,0,0,0
"15003981000",0,0,0,0,0,0,0,0,0
"15003981100",14,0,0,0,0,0,0,0,14
"15003981200",0,0,0,0,0,0,0,0,0
"15003981300",0,0,0,0,0,0,0,0,0
"15003981400",0,0,0,0,0,0,0,0,0
"15003990001",0,0,0,0,0,0,0,0,0
"15005031900",29,2,0,0,27,10,3,0,71
"15005990000",0,0,0,0,0,0,0,0,0
"15007040103",3962,616,19,0,2067,263,450,51,7428
"15007040104",436,116,0,0,215,14,68,0,849
"15007040204",2133,201,24,0,2831,184,231,0,5604
"15007040205",1327,189,8,0,2304,152,299,125,4404
"15007040300",2249,377,135,0,4598,743,677,208,8987
"15007040400",1341,306,40,29,7067,518,942,78,10321
"15007040500",1394,143,49,0,4112,1029,469,9,7205
"15007040603",1076,81,11,0,1693,92,231,34,3218
"15007040604",1211,101,2,0,1579,287,351,125,3656
"15007040700",2258,280,5,0,4645,994,1132,212,9526
"15007040800",709,57,11,4,2907,182,579,14,4463
"15007040900",1115,56,0,3,3234,362,266,9,5045
"15007041200",0,0,0,0,0,0,0,0,0
"15007940000",933,191,2,26,2047,324,274,90,3887
"15007990100",0,0,0,0,0,0,0,0,0
"15007990200",0,0,0,0,0,0,0,0,0
"15007990300",0,0,0,0,0,0,0,0,0
"15009030100",560,67,0,0,1030,241,56,93,2047
"15009030201",1397,191,0,0,511,61,54,102,2316
"15009030202",3651,490,0,47,2825,278,440,59,7790
"15009030301",3829,573,14,16,3544,697,547,294,9514
"15009030303",2630,277,3,0,812,45,46,18,3831
"15009030402",2763,341,0,0,5255,197,848,21,9425
"15009030403",1337,179,2,0,1799,152,246,0,3715
"15009030404",1131,501,12,0,3188,577,576,115,6100
"15009030501",1091,95,0,0,1264,84,152,23,2709
"15009030705",744,110,16,0,2594,154,455,124,4197
"15009030706",881,254,8,34,939,299,104,289,2808
"15009030707",5148,489,89,0,3032,541,1382,5,10686
"15009030708",1164,196,17,0,1629,5,351,70,3432
"15009030709",2324,316,40,0,1085,32,285,55,4137
"15009030710",1257,291,0,0,269,565,105,224,2711
"15009030800",1466,85,9,0,5380,253,843,39,8075
"15009030901",377,250,39,14,1881,507,255,186,3509
"15009030902",511,23,7,0,2160,391,492,136,3720
"15009030903",620,65,62,0,6019,427,667,40,7900
"15009031000",1738,230,76,0,6453,511,905,296,10209
"15009031101",591,250,0,152,6277,700,781,194,8945
"15009031102",672,35,0,0,4107,378,551,131,5874
"15009031103",668,0,0,0,6630,709,456,45,8508
"15009031402",635,71,0,19,2233,92,124,19,3193
"15009031404",1640,245,0,31,1270,252,263,42,3743
"15009031405",696,162,0,0,4113,465,369,5,5810
"15009031501",1010,82,0,0,1189,53,123,0,2457
"15009031502",3051,78,38,14,1305,52,437,17,4992
"15009031503",1633,113,0,36,590,27,302,24,2725
"15009031601",410,20,24,12,2738,304,565,25,4098
"15009031700",887,60,0,1,2487,643,214,132,4424
"15009031801",275,31,8,14,1964,498,170,16,2976
"15009031900",538,61,22,0,3540,987,321,28,5497
"15009032000",724,33,6,0,174,12,84,3,1036
"15009980000",0,0,0,0,0,0,0,0,0
"15009990000",0,0,0,0,0,0,0,0,0
"15009990200",0,0,0,0,0,0,0,0,0
"15009991200",0,0,0,0,0,0,0,0,0
"16001000100",2052,1257,0,103,289,265,148,169,4283
"16001000201",2754,238,15,0,64,0,40,0,3111
"16001000202",4862,197,80,0,184,53,190,27,5593
"16001000302",2359,443,29,0,233,65,103,68,3300
"16001000303",1278,209,19,0,54,103,137,106,1906
"16001000304",5130,547,78,0,884,41,348,0,7028
"16001000400",3875,1232,140,0,230,191,180,211,6059
"16001000500",4896,724,56,0,388,105,351,197,6717
"16001000600",4681,514,9,18,159,0,394,38,5813
"16001000701",3821,255,0,0,210,121,128,33,4568
"16001000702",2448,69,79,0,170,0,41,7,2814
"16001000802",4848,606,23,0,446,36,310,81,6350
"16001000803",3582,296,163,21,626,93,136,0,4917
"16001000804",4227,1089,193,103,742,87,142,9,6592
"16001000805",2946,63,0,0,226,0,94,0,3329
"16001000900",2553,1762,44,33,164,296,648,294,5794
"16001001000",4410,1436,80,0,557,120,397,93,7093
"16001001100",2423,1213,17,0,124,410,564,510,5261
"16001001201",2772,398,12,0,233,56,264,22,3757
"16001001202",4718,1230,86,149,315,164,644,127,7433
"16001001400",2863,1116,0,0,493,406,407,313,5598
"16001001500",2792,701,0,0,37,43,150,202,3925
"16001001600",3411,595,0,0,200,136,87,48,4477
"16001001700",3631,1091,106,58,510,122,556,38,6112
"16001001800",3355,644,41,0,180,84,121,24,4449
"16001001900",3804,1026,78,0,258,98,247,0,5511
"16001002000",2167,1097,126,350,207,568,177,716,5408
"16001002100",1919,87,0,0,173,25,130,4,2338
"16001002221",7152,977,4,35,531,14,237,243,9193
"16001002222",4547,479,43,0,584,209,255,218,6335
"16001002223",3833,71,0,0,155,6,20,0,4085
"16001002224",5249,379,106,0,589,128,623,18,7092
"16001002302",6734,1763,32,0,611,69,1080,567,10856
"16001002310",7700,829,0,82,1128,31,680,241,10691
"16001002312",3793,547,107,0,277,230,423,228,5605
"16001002313",3014,546,53,0,344,45,318,150,4470
"16001002410",6211,196,182,0,573,0,489,0,7651
"16001002411",4637,415,0,0,236,12,271,105,5676
"16001002412",2880,511,0,0,70,11,112,123,3707
"16001002413",6962,1092,0,150,434,128,595,174,9535
"16001010100",5236,204,60,0,116,34,77,0,5727
"16001010201",8486,564,57,0,286,342,495,191,10421
"16001010221",6003,262,0,0,300,63,300,39,6967
"16001010223",5186,792,23,0,323,0,271,38,6633
"16001010224",4088,109,0,0,142,67,219,49,4674
"16001010225",7402,730,0,0,359,48,370,111,9020
"16001010313",18691,418,89,0,296,187,1213,112,21006
"16001010321",5552,602,23,0,512,104,342,108,7243
"16001010322",5446,1237,274,0,96,114,916,53,8136
"16001010331",16986,1247,184,0,1104,400,351,12,20284
"16001010332",11234,1108,52,0,780,303,526,350,14353
"16001010333",9328,898,94,0,428,21,538,151,11458
"16001010334",5796,484,51,0,201,65,405,0,7002
"16001010335",20044,1574,81,0,853,123,993,301,23969
"16001010401",16694,3510,0,0,842,52,996,123,22217
"16001010402",9592,882,44,0,576,170,587,220,12071
"16001010501",1943,356,0,0,94,31,276,30,2730
"16001010503",3332,167,0,0,643,0,260,64,4466
"16001010504",5972,387,69,0,669,72,419,34,7622
"16003950100",1203,170,0,0,66,0,43,0,1482
"16003950200",1999,322,0,0,40,73,20,54,2508
"16005000200",3414,79,0,0,139,0,30,0,3662
"16005000300",7266,962,0,0,576,238,861,32,9935
"16005000400",4856,545,8,0,304,7,312,51,6083
"16005000500",1684,86,0,0,50,0,43,14,1877
"16005000600",2335,483,21,0,262,178,50,121,3450
"16005000700",2470,574,9,22,80,69,86,22,3332
"16005000800",898,1118,37,31,259,222,208,246,3019
"16005000900",1421,669,51,35,95,19,88,28,2406
"16005001000",2593,581,22,0,152,41,227,83,3699
"16005001101",6509,484,13,0,336,16,545,1,7904
"16005001102",2798,431,59,0,312,19,242,108,3969
"16005001200",2040,692,0,0,174,0,169,39,3114
"16005001300",2099,202,8,0,249,101,440,44,3143
"16005001400",2959,760,0,32,166,153,213,84,4367
"16005001500",4639,904,0,0,120,58,154,32,5907
"16005001601",1801,597,5,17,195,43,356,125,3139
"16005001602",2861,644,68,0,178,210,124,212,4297
"16005001603",1859,527,12,0,103,113,11,113,2738
"16005001700",3176,104,15,0,161,0,53,0,3509
"16005001900",3910,596,13,3,55,24,63,7,4671
"16005940000",731,64,0,0,1279,211,161,81,2527
"16005981800",151,41,0,0,0,13,0,0,205
"16007950100",2762,531,0,0,73,66,90,80,3602
"16007950200",2221,173,9,0,44,9,61,5,2522
"16009940000",2728,521,37,2,694,379,132,98,4591
"16009950100",4041,494,0,9,125,0,35,9,4713
"16011940000",243,101,0,0,1598,665,175,82,2864
"16011950100",7126,735,36,0,395,7,960,0,9259
"16011950200",2968,504,0,0,237,21,345,69,4144
"16011950300",4262,661,0,0,623,50,1167,389,7152
"16011950400",5609,833,4,0,222,3,613,445,7729
"16011950500",5693,1072,61,0,428,167,924,337,8682
"16011950600",4317,673,6,6,375,83,820,350,6630
"16011950700",4300,477,0,20,469,199,1069,232,6766
"16013960100",4102,493,0,0,226,105,578,307,5811
"16013960200",7389,1184,3,0,1459,77,2649,394,13155
"16013960300",3022,222,1,0,99,1,139,0,3484
"16013960500",2467,208,8,0,127,0,207,40,3057
"16015950200",5512,1013,17,8,211,61,163,79,7064
"16017950100",1733,305,0,0,64,12,8,10,2132
"16017950200",7363,948,20,0,307,95,283,0,9016
"16017950300",2607,710,0,0,57,106,121,44,3645
"16017950400",5686,917,0,0,100,17,193,15,6928
"16017950500",2498,788,0,0,79,0,96,0,3461
"16017950600",1651,232,0,0,61,0,0,0,1944
"16017950700",3527,694,0,0,208,10,59,21,4519
"16017950800",4447,760,17,0,288,91,9,12,5624
"16017950900",3145,594,0,0,86,17,113,0,3955
"16019970100",4535,363,2,0,85,1,63,0,5049
"16019970300",6006,448,0,0,231,92,275,82,7134
"16019970401",1874,146,41,0,224,11,208,2,2506
"16019970402",3294,436,0,0,17,3,109,63,3922
"16019970403",8628,824,158,0,1577,497,2152,529,14365
"16019970501",6903,391,40,0,377,139,784,139,8773
"16019970502",3818,475,31,0,488,54,407,83,5356
"16019970503",4331,257,12,0,138,65,269,68,5140
"16019970601",2302,286,0,0,241,129,463,131,3552
"16019970602",3259,1002,18,0,411,336,359,375,5760
"16019970603",1680,224,9,0,23,36,91,59,2122
"16019970700",3475,853,0,0,243,433,514,423,5941
"16019970800",2895,666,0,30,96,132,169,107,4095
"16019970900",3851,590,70,0,218,12,129,242,5112
"16019971000",4375,429,0,0,278,22,482,99,5685
"16019971100",2702,302,0,52,128,41,356,33,3614
"16019971200",2868,823,72,0,429,230,709,249,5380
"16019971301",5435,746,10,0,467,336,915,177,8086
"16019971302",4033,425,14,9,395,195,441,167,5679
"16019971400",7735,473,0,0,434,15,599,1,9257
"16019971500",1166,230,0,0,61,102,98,135,1792
"16021970100",4742,672,0,2,105,89,125,40,5775
"16021970200",3775,954,13,0,350,35,227,15,5369
"16023970100",2184,341,42,0,34,78,88,17,2784
"16025970100",812,181,0,0,136,26,169,31,1355
"16027020100",506,441,15,0,108,17,123,31,1241
"16027020200",1704,1707,21,0,354,412,877,1313,6388
"16027020300",2547,930,73,0,354,418,890,492,5704
"16027020401",6008,1953,129,0,722,251,2130,693,11886
"16027020402",3316,1303,80,0,159,364,455,448,6125
"16027020501",2578,754,0,9,224,132,457,251,4405
"16027020503",2314,448,69,0,140,47,305,61,3384
"16027020504",2897,2129,0,0,144,306,254,527,6257
"16027020601",3996,987,0,0,392,17,597,324,6313
"16027020602",4462,1866,22,0,485,236,1345,799,9215
"16027020700",3204,135,0,0,97,22,283,44,3785
"16027020901",10539,1586,0,0,1138,103,3165,174,16705
"16027020902",11197,2033,64,0,986,351,2368,375,17374
"16027021001",10229,1995,39,0,828,220,3160,1096,17567
"16027021002",7703,1313,36,0,395,128,1404,766,11745
"16027021100",12698,1542,0,0,1011,308,2219,659,18437
"16027021200",4544,1070,0,0,816,557,1641,1045,9673
"16027021300",1116,985,6,21,174,63,981,682,4028
"16027021500",2555,1272,0,38,278,156,655,479,5433
"16027021600",2915,1073,0,0,77,87,698,569,5419
"16027021700",8134,1930,118,25,364,69,2810,1102,14552
"16027021800",4718,579,0,0,364,37,804,151,6653
"16027021901",3934,702,0,0,439,133,505,141,5854
"16027021903",8204,963,0,0,345,67,484,133,10196
"16027021904",2483,1088,0,5,135,91,550,960,5312
"16027022100",3587,958,0,0,461,51,863,210,6130
"16027022200",3825,874,0,0,224,203,1065,587,6778
"16027022300",5074,1111,0,0,136,37,1021,258,7637
"16027022400",3758,546,0,0,60,18,151,232,4765
"16029960100",3433,406,4,0,85,11,186,96,4221
"16029960200",2547,196,0,0,19,0,46,0,2808
"16031950100",2698,315,0,0,29,4,339,113,3498
"16031950200",2579,245,5,0,277,0,524,110,3740
"16031950300",3687,689,43,0,314,20,685,327,5765
"16031950400",2589,848,13,0,425,66,1526,474,5941
"16031950500",4362,520,0,0,284,177,655,405,6403
"16031950600",1916,374,0,0,214,77,437,218,3236
"16033950100",568,207,0,0,26,22,196,158,1177
"16035940000",3632,684,18,0,257,41,75,13,4720
"16035970100",2698,247,4,0,17,46,54,23,3089
"16037960200",3311,829,0,0,64,28,100,6,4338
"16039960100",2129,334,0,0,89,78,388,123,3141
"16039960200",6737,1127,103,0,477,624,534,683,10285
"16039960300",2466,680,71,0,381,256,361,167,4382
"16039960400",5225,695,229,0,718,358,1181,386,8792
"16039960500",1912,101,145,0,364,56,155,6,2739
"16041970100",5013,568,0,0,225,31,170,51,6058
"16041970200",5756,1127,17,0,53,0,312,322,7587
"16043970100",1039,144,0,0,21,0,11,0,1215
"16043970200",2979,543,22,16,38,170,388,295,4451
"16043970300",6419,576,4,0,364,29,673,105,8170
"16045960100",3246,646,0,0,205,25,175,70,4367
"16045960200",4220,922,0,0,38,88,314,34,5616
"16045960300",5500,1055,0,0,345,255,538,176,7869
"16047960100",4859,1665,0,0,620,308,1126,941,9519
"16047960200",5339,872,2,0,906,427,1756,507,9809
"16049940000",3193,572,0,0,285,320,70,14,4454
"16049960100",1670,379,0,0,30,18,0,0,2097
"16049960200",5312,823,1,0,189,0,178,1,6504
"16049960300",1395,231,2,6,77,10,28,15,1764
"16049960400",1147,133,0,0,5,17,15,40,1357
"16051960100",2777,611,20,11,289,118,643,417,4886
"16051960200",3447,450,0,0,289,45,207,67,4505
"16051960300",6239,1091,19,0,160,0,312,217,8038
"16051960400",9389,952,0,0,352,227,603,238,11761
"16053970100",2719,341,3,0,166,15,700,174,4118
"16053970200",3206,528,0,0,214,306,1277,528,6059
"16053970300",3472,878,0,24,634,160,1188,380,6736
"16053970400",1750,734,0,0,309,250,861,799,4703
"16053970500",5609,660,0,0,456,25,1344,89,8183
"16055000100",4974,683,9,0,278,64,152,9,6169
"16055000200",7757,749,12,0,185,235,127,12,9077
"16055000301",4713,603,19,0,427,23,254,50,6089
"16055000302",5220,1179,18,0,96,147,279,293,7232
"16055000401",4926,570,0,0,399,49,238,23,6205
"16055000402",6610,613,17,0,466,0,159,25,7890
"16055000500",9729,1419,32,0,223,22,275,48,11748
"16055000601",4045,400,0,0,115,35,192,35,4822
"16055000602",4133,1259,0,139,142,199,154,103,6129
"16055000700",14417,980,0,0,731,51,1047,38,17264
"16055000800",3878,339,15,17,323,14,91,6,4683
"16055000900",2882,1797,0,0,188,99,41,0,5007
"16055001001",5822,503,26,0,135,47,129,0,6662
"16055001002",3402,615,0,0,124,3,53,16,4213
"16055001100",1595,157,0,0,30,3,35,0,1820
"16055001200",4856,866,62,0,80,61,212,60,6197
"16055001300",3447,617,0,19,146,15,552,0,4796
"16055001400",1897,473,0,0,85,356,78,6,2895
"16055001500",2258,610,0,0,74,49,151,40,3182
"16055001600",2061,583,0,21,51,11,6,17,2750
"16055001700",3873,402,15,0,290,0,213,59,4852
"16055001800",7555,332,23,11,147,29,215,0,8312
"16055001900",2162,342,16,0,67,1,34,13,2635
"16055002000",3080,169,0,0,180,33,20,33,3515
"16055940000",1771,153,3,0,401,219,34,51,2632
"16057005100",5238,2355,13,0,378,224,60,134,8402
"16057005200",5301,713,0,0,207,117,195,0,6533
"16057005300",4858,1198,0,84,108,136,256,123,6763
"16057005400",1719,1190,29,27,212,139,38,102,3456
"16057005500",3281,342,3,0,239,2,96,2,3965
"16057005600",3031,413,10,0,175,6,115,7,3757
"16057005700",2624,361,2,3,70,44,52,0,3156
"16059970100",1940,496,0,0,106,73,42,11,2668
"16059970200",2005,864,6,0,33,22,49,55,3034
"16059970300",1893,196,0,0,51,0,35,0,2175
"16061940001",1318,282,3,0,143,92,94,9,1941
"16061940002",1559,226,0,0,60,34,27,1,1907
"16061950300",24,1,0,0,0,0,0,0,25
"16063950100",3919,610,15,0,414,219,1210,321,6708
"16065950100",5016,634,0,0,124,23,511,66,6374
"16065950200",1952,1319,0,0,232,162,204,93,3962
"16065950301",765,3394,0,62,37,247,10,163,4678
"16065950302",6246,4777,79,0,135,265,160,383,12045
"16065950400",4572,1297,58,0,60,165,82,134,6368
"16065950500",4366,769,10,0,31,25,364,167,5732
"16067970100",2594,563,0,0,299,8,690,265,4419
"16067970200",3882,929,3,0,154,127,1293,387,6775
"16067970300",2755,180,0,4,107,50,694,82,3872
"16067970400",3169,315,33,10,458,86,1293,113,5477
"16067970500",2954,547,0,3,489,294,1402,444,6133
"16069940000",2540,371,18,10,1572,375,222,48,5156
"16069960200",293,20,0,0,22,0,0,0,335
"16069960300",2995,907,18,39,344,145,49,18,4515
"16069960400",2611,283,0,0,224,7,220,7,3352
"16069960500",3127,200,0,0,122,20,55,42,3566
"16069960600",3686,692,0,0,203,16,17,16,4630
"16069960700",4787,340,5,0,155,27,59,0,5373
"16069960800",3377,283,10,0,132,125,104,178,4209
"16069960900",2815,377,10,0,26,86,35,49,3398
"16069961000",4916,205,16,0,147,9,64,0,5357
"16071960100",3478,600,0,0,87,45,82,58,4350
"16073950101",2686,1107,0,0,321,185,983,639,5921
"16073950102",2296,664,0,0,86,48,298,318,3710
"16073950200",2511,888,0,0,281,201,258,462,4601
"16075960100",3929,1197,0,0,333,130,456,540,6585
"16075960200",2266,816,0,13,272,174,670,152,4363
"16075960300",6902,877,43,0,369,42,1002,284,9519
"16075960400",3913,845,0,0,158,25,403,15,5359
"16077960100",1202,234,0,0,284,54,132,96,2002
"16077960200",4388,434,8,0,767,304,1829,299,8029
"16079960200",3414,658,25,0,41,14,112,0,4264
"16079960300",2723,756,19,0,136,126,112,40,3912
"16079960400",3496,560,0,0,121,51,43,46,4317
"16081960100",8532,1065,15,9,485,85,1361,409,11961
"16083000200",5042,711,0,0,277,71,321,45,6467
"16083000300",4509,619,0,0,223,11,622,181,6165
"16083000400",2807,807,6,0,267,261,600,454,5202
"16083000500",4409,633,6,0,164,115,176,177,5680
"16083000600",2492,250,2,0,80,0,147,0,2971
"16083000700",9382,1195,62,0,622,333,692,583,12869
"16083000800",5018,848,0,0,258,26,907,92,7149
"16083000900",4253,260,68,31,182,77,119,28,5018
"16083001000",6097,1681,0,28,699,434,1531,461,10931
"16083001100",1825,699,83,95,260,84,120,139,3305
"16083001200",5229,1278,10,0,651,129,1540,467,9304
"16083001300",6402,897,0,0,234,24,638,165,8360
"16083001400",854,139,0,0,43,9,207,95,1347
"16083001500",2441,512,12,0,15,7,452,140,3579
"16085970100",2673,304,0,0,63,3,4,0,3047
"16085970200",2466,113,0,0,17,0,280,0,2876
"16085970300",3117,719,0,0,39,0,113,4,3992
"16087970100",1154,231,0,0,63,31,28,0,1507
"16087970200",3076,473,0,0,107,117,458,174,4405
"16087970300",3569,650,0,0,382,34,857,164,5656
"17001000100",3858,370,73,4,179,0,224,0,4708
"17001000201",1598,271,55,17,50,0,14,0,2005
"17001000202",1936,370,98,0,198,71,52,0,2725
"17001000400",1993,837,335,111,89,57,48,0,3470
"17001000500",1325,273,180,210,31,0,19,0,2038
"17001000600",3060,306,5,106,67,7,0,0,3551
"17001000700",625,438,94,0,0,101,0,0,1258
"17001000800",1505,696,110,251,186,54,42,44,2888
"17001000900",1626,587,23,235,90,0,0,0,2561
"17001001001",3054,523,25,24,41,38,17,47,3769
"17001001002",2581,360,74,0,77,0,5,1,3098
"17001001100",6695,598,65,39,382,135,129,4,8047
"17001010100",3579,457,1,0,7,9,43,19,4115
"17001010200",3147,398,0,0,32,34,48,0,3659
"17001010300",5592,453,52,2,51,0,67,0,6217
"17001010400",2894,250,0,0,5,0,0,0,3149
"17001010500",2832,46,39,23,46,0,0,0,2986
"17001010600",5284,635,15,16,42,3,0,0,5995
"17003957600",1441,519,253,81,64,13,4,0,2375
"17003957700",1407,375,229,155,7,11,10,79,2273
"17003957800",454,46,552,616,22,45,3,35,1773
"17003957900",155,273,156,581,7,46,4,4,1226
"17005951200",2477,376,78,41,41,12,4,0,3029
"17005951300",3705,1004,63,4,327,21,73,34,5231
"17005951400",2640,430,30,0,21,15,21,92,3249
"17005951500",3888,549,3,55,83,17,113,8,4716
"17007010100",5579,1017,57,163,1337,369,2512,641,11675
"17007010200",4684,910,17,0,228,13,1713,254,7819
"17007010300",4347,1230,103,23,524,172,969,628,7996
"17007010400",5823,535,130,0,568,0,1139,24,8219
"17007010500",8580,337,557,0,422,0,561,62,10519
"17007010601",3087,450,4,0,215,105,483,149,4493
"17007010602",10353,1062,107,0,479,2,1738,28,13769
"17009970400",2573,152,0,0,242,31,50,0,3048
"17009970500",1725,321,56,12,119,5,0,0,2238
"17011964700",2670,193,3,0,26,20,39,0,2951
"17011964800",3152,400,0,0,9,12,168,3,3744
"17011964900",2360,218,35,1,41,8,23,0,2686
"17011965000",3142,323,27,1,146,123,1110,213,5085
"17011965100",3416,426,31,0,233,7,341,88,4542
"17011965200",2523,436,52,16,333,14,341,30,3745
"17011965300",2565,722,0,0,79,7,76,41,3490
"17011965400",2843,339,21,0,132,24,114,9,3482
"17011965500",3239,431,0,0,46,14,75,17,3822
"17011965600",2563,325,4,0,68,9,53,1,3023
"17013951200",2193,324,0,0,10,44,5,0,2576
"17013951300",2053,206,0,2,27,2,4,3,2297
"17015960100",3057,392,8,0,117,12,135,11,3732
"17015960200",1817,251,0,0,29,12,6,0,2115
"17015960300",2186,635,40,84,137,0,225,0,3307
"17015960400",1800,218,4,0,50,4,13,0,2089
"17015960500",2275,167,0,1,22,12,22,1,2500
"17015960600",1269,152,13,0,0,0,56,0,1490
"17017960100",2069,246,50,0,24,7,40,0,2436
"17017960200",2193,218,39,0,40,5,76,0,2571
"17017960300",2725,65,90,20,73,0,404,17,3394
"17017960400",1785,479,71,7,160,136,450,264,3352
"17017960500",1671,459,120,58,322,68,846,333,3877
"17019000200",182,51,761,426,73,0,54,0,1547
"17019000301",480,2787,0,364,146,516,119,246,4658
"17019000302",241,729,85,64,636,1264,89,165,3273
"17019000401",193,908,7,17,29,119,72,32,1377
"17019000402",443,2286,20,202,29,499,11,145,3635
"17019000500",2272,693,158,20,412,174,125,32,3886
"17019000700",1704,328,724,675,266,95,883,132,4807
"17019000800",1935,644,828,667,1305,36,178,395,5988
"17019000901",1205,478,1312,1097,219,199,112,266,4888
"17019000902",4441,312,875,322,564,131,61,72,6778
"17019001000",3030,245,110,611,289,126,31,0,4442
"17019001100",3258,100,296,0,222,17,216,68,4177
"17019001201",3855,235,615,970,849,298,228,85,7135
"17019001203",3667,305,350,101,321,57,14,24,4839
"17019001204",2745,42,55,0,813,0,62,0,3717
"17019001205",4156,254,244,73,974,275,183,90,6249
"17019001206",1466,12,35,0,141,0,41,0,1695
"17019001301",4643,271,370,23,487,117,121,105,6137
"17019001302",2888,107,248,0,416,84,166,0,3909
"17019001400",1952,371,156,79,1016,100,305,99,4078
"17019005300",847,1421,1234,764,374,1730,36,209,6615
"17019005401",2503,427,160,555,277,89,282,227,4520
"17019005402",2323,416,112,0,286,54,193,0,3384
"17019005500",3168,479,507,337,480,97,52,21,5141
"17019005600",3295,550,1000,614,545,51,211,0,6266
"17019005701",2649,444,311,366,408,270,112,0,4560
"17019005702",2136,265,399,246,138,14,20,0,3218
"17019005800",2118,1016,51,109,249,213,209,12,3977
"17019005900",308,1044,120,195,135,507,56,111,2476
"17019006000",198,127,16,8,444,341,0,16,1150
"17019010100",2840,587,367,245,243,213,317,116,4928
"17019010204",2567,1110,409,276,328,27,469,617,5803
"17019010300",1527,515,998,439,243,59,207,64,4052
"17019010400",3977,402,68,60,68,14,124,23,4736
"17019010500",4050,329,10,0,54,2,21,0,4466
"17019010601",5483,366,0,0,79,48,59,0,6035
"17019010603",5892,434,304,0,404,26,26,0,7086
"17019010604",2014,381,74,76,150,43,2,1,2741
"17019010700",7626,226,0,2,269,1,84,38,8246
"17019010800",4116,373,30,0,61,14,60,0,4654
"17019010900",8519,627,138,135,294,32,323,42,10110
"17019011000",2643,444,160,264,208,57,215,55,4046
"17019011100",573,638,6,5,500,467,66,199,2454
"17021958100",2344,485,6,0,36,15,47,0,2933
"17021958200",3305,491,1,0,155,21,122,0,4095
"17021958300",3746,299,0,0,1,0,1,0,4047
"17021958400",2908,726,6,5,53,0,29,0,3727
"17021958500",2295,442,17,0,25,0,82,4,2865
"17021958600",1931,278,5,0,0,22,31,59,2326
"17021958700",2865,400,9,5,20,0,17,3,3319
"17021958800",2064,669,0,0,20,11,20,0,2784
"17021958900",1809,595,0,56,83,50,0,0,2593
"17021959000",3954,239,3,0,12,0,2,0,4210
"17023060100",4228,497,5,0,102,0,13,0,4845
"17023060200",3272,711,0,9,51,8,14,40,4105
"17023060300",4363,680,3,10,120,3,86,45,5310
"17023060400",1608,186,0,0,5,0,0,0,1799
"17025971900",2285,235,0,2,20,0,104,0,2646
"17025972000",2330,270,0,9,11,4,0,0,2624
"17025972100",4159,792,0,20,15,124,0,0,5110
"17025972200",2636,396,0,0,55,0,53,5,3145
"17027900100",5748,254,0,7,115,9,94,33,6260
"17027900200",1937,145,0,2,5,0,15,0,2104
"17027900300",6357,462,0,0,160,0,220,0,7199
"17027900401",1179,80,0,0,18,11,57,0,1345
"17027900402",3976,614,77,37,124,113,134,0,5075
"17027900500",4428,818,54,55,110,62,75,0,5602
"17027900601",2315,83,0,1,31,0,31,0,2461
"17027900602",5868,422,80,86,70,79,150,39,6794
"17029000100",2414,511,0,0,35,11,72,3,3046
"17029000200",5357,694,26,0,22,2,50,0,6151
"17029000300",3886,479,16,34,30,50,77,0,4572
"17029000400",1650,715,57,0,23,13,0,13,2471
"17029000500",4269,1699,0,3,137,68,37,0,6213
"17029000600",3358,233,10,0,54,46,20,2,3723
"17029000700",3663,2196,281,313,179,71,92,78,6873
"17029000800",555,1017,37,270,51,180,36,56,2202
"17029000900",3536,481,108,106,183,28,69,5,4516
"17029001000",2839,462,9,3,139,36,77,83,3648
"17029001100",2403,605,78,10,67,28,52,15,3258
"17029001200",2569,880,0,2,66,68,49,32,3666
"17031010100",1583,450,983,640,305,122,181,271,4535
"17031010201",2374,822,2058,1479,320,20,1009,562,8644
"17031010202",742,222,418,327,404,139,414,221,2887
"17031010300",2346,550,802,713,757,169,663,235,6235
"17031010400",1951,412,505,55,355,115,350,25,3768
"17031010501",1792,533,1001,186,216,94,172,18,4012
"17031010502",1254,852,437,158,374,530,431,146,4182
"17031010503",956,575,163,54,183,219,326,24,2500
"17031010600",3491,540,1603,244,301,215,1269,441,8104
"17031010701",2434,131,547,108,384,326,1311,327,5568
"17031010702",1965,1010,715,354,580,639,1327,1327,7917
"17031020100",1658,139,684,453,915,141,447,42,4479
"17031020200",3809,727,201,85,1268,165,443,139,6837
"17031020301",4034,312,239,41,564,27,317,13,5547
"17031020302",2675,79,332,121,799,255,794,67,5122
"17031020400",2212,268,573,179,968,83,930,29,5242
"17031020500",2022,404,788,412,1566,567,1708,210,7677
"17031020601",3392,728,333,88,1572,565,234,749,7661
"17031020602",1696,326,175,150,1136,599,714,346,5142
"17031020701",983,261,146,7,371,125,212,56,2161
"17031020702",3596,1040,209,2,2810,444,574,515,9190
"17031020801",2093,586,220,1,1411,201,1126,243,5881
"17031020802",2078,869,567,20,3218,1181,1084,322,9339
"17031020901",1876,554,580,454,1171,378,784,499,6296
"17031020902",1932,448,610,113,702,159,387,29,4380
"17031030101",1711,583,556,190,560,127,607,204,4538
"17031030102",1451,305,484,86,467,120,323,81,3317
"17031030103",607,373,324,0,477,16,301,10,2108
"17031030104",742,164,267,169,385,379,63,37,2206
"17031030200",4144,245,258,221,322,76,778,78,6122
"17031030300",1696,298,314,29,320,392,802,470,4321
"17031030400",1498,418,163,176,331,97,576,311,3570
"17031030500",4090,784,296,47,828,83,1191,541,7860
"17031030601",1572,675,425,250,306,120,185,337,3870
"17031030603",589,259,587,244,195,174,92,37,2177
"17031030604",1431,147,557,107,458,261,82,9,3052
"17031030701",742,61,209,82,236,225,49,32,1636
"17031030702",1039,98,75,26,222,0,28,0,1488
"17031030703",1412,344,322,39,388,74,133,17,2729
"17031030706",1854,231,447,75,744,109,218,67,3745
"17031030800",2845,360,55,21,820,164,473,71,4809
"17031030900",2056,73,230,47,792,8,522,0,3728
"17031031000",2371,271,115,7,728,0,390,122,4004
"17031031100",2837,286,101,106,708,11,647,21,4717
"17031031200",1583,858,735,809,295,354,266,341,5241
"17031031300",2777,652,1198,553,1592,367,586,271,7996
"17031031400",3568,247,463,74,582,115,460,45,5554
"17031031501",968,441,376,656,520,429,154,43,3587
"17031031502",1387,342,1136,772,371,280,538,130,4956
"17031031700",3254,624,528,924,752,314,608,368,7372
"17031031800",1172,310,17,4,152,54,211,129,2049
"17031031900",1719,169,110,72,203,82,113,113,2581
"17031032100",4228,877,560,188,586,224,385,389,7437
"17031040100",2639,369,175,33,470,107,601,116,4510
"17031040201",4218,724,37,2,819,374,817,253,7244
"17031040202",2996,829,318,136,1583,695,699,335,7591
"17031040300",1655,84,65,1,651,125,252,0,2833
"17031040401",1902,120,166,0,427,221,385,158,3379
"17031040402",3416,299,121,32,753,80,649,121,5471
"17031040600",2256,138,29,32,183,46,333,37,3054
"17031040700",2737,128,90,27,217,154,774,104,4231
"17031040800",1342,52,0,0,283,39,144,5,1865
"17031040900",1834,127,1,1,155,0,158,34,2310
"17031050100",2118,59,43,0,175,11,363,9,2778
"17031050200",4470,131,160,0,321,38,1088,25,6233
"17031050300",1996,207,0,18,315,7,429,83,3055
"17031050500",4700,85,43,5,532,0,572,0,5937
"17031050600",1928,258,45,0,175,8,209,31,2654
"17031050700",1649,12,15,0,77,0,82,0,1835
"17031050800",1309,54,5,7,52,0,104,0,1531
"17031050900",1374,119,0,0,148,19,99,14,1773
"17031051000",1263,87,11,18,173,44,230,11,1837
"17031051100",1270,76,20,9,151,0,203,36,1765
"17031051200",1216,125,88,15,95,0,156,14,1709
"17031051300",2589,108,35,17,186,18,329,0,3282
"17031051400",1673,159,44,30,268,0,256,27,2457
"17031060100",2085,208,150,56,64,33,182,30,2808
"17031060200",1545,337,18,41,166,19,184,120,2430
"17031060300",2899,108,9,0,160,0,137,0,3313
"17031060400",3372,367,16,0,203,45,372,55,4430
"17031060500",808,169,34,40,66,118,123,21,1379
"17031060800",3602,245,253,15,649,63,194,16,5037
"17031060900",5083,435,330,0,842,68,837,60,7655
"17031061000",1311,117,25,0,126,137,259,5,1980
"17031061100",1037,168,27,0,63,14,23,19,1351
"17031061200",1661,270,19,10,255,20,66,36,2337
"17031061500",1597,108,9,0,145,0,95,24,1978
"17031061800",742,145,13,17,70,54,103,6,1150
"17031061901",2850,267,29,118,478,43,404,49,4238
"17031061902",2884,419,181,15,479,67,190,26,4261
"17031062000",2230,203,135,18,269,42,94,12,3003
"17031062100",2651,382,9,13,258,59,192,33,3597
"17031062200",2310,281,106,0,214,43,160,0,3114
"17031062300",1373,200,6,0,137,0,71,0,1787
"17031062400",1480,23,30,0,85,4,78,7,1707
"17031062500",1098,136,0,0,104,4,15,45,1402
"17031062600",1889,73,21,0,292,6,226,67,2574
"17031062700",2072,396,13,3,235,38,139,36,2932
"17031062800",3133,234,100,48,265,12,296,30,4118
"17031062900",3264,531,11,0,362,8,140,0,4316
"17031063000",2215,372,69,10,283,99,229,59,3336
"17031063100",1793,231,0,0,306,64,118,68,2580
"17031063200",4836,403,191,23,617,423,109,57,6659
"17031063301",1601,444,192,75,234,80,163,10,2799
"17031063302",3186,320,67,1,612,0,180,0,4366
"17031063303",1027,48,27,0,48,6,50,0,1206
"17031063400",1572,348,26,67,136,9,129,37,2324
"17031070101",2972,592,60,36,302,26,37,0,4025
"17031070102",1971,166,166,50,227,56,311,16,2963
"17031070103",1295,217,45,31,79,12,56,67,1802
"17031070200",2844,365,112,18,393,28,245,17,4022
"17031070300",2351,474,25,31,343,141,113,27,3505
"17031070400",2861,300,56,76,68,79,227,59,3726
"17031070500",2426,145,35,9,119,27,145,36,2942
"17031070600",2843,106,39,0,85,10,328,12,3423
"17031070700",2941,450,8,9,536,39,372,289,4644
"17031071000",1734,510,44,5,148,44,111,99,2695
"17031071100",1996,341,18,2,133,8,84,0,2582
"17031071200",1430,258,8,64,226,29,176,40,2231
"17031071300",2816,195,94,14,245,24,108,0,3496
"17031071400",3221,489,63,108,392,84,189,52,4598
"17031071500",4513,385,123,63,609,17,196,111,6017
"17031071600",1358,121,40,35,144,17,34,15,1764
"17031071700",1354,56,167,95,140,1,150,0,1963
"17031071800",2075,111,257,62,132,0,134,0,2771
"17031080100",5550,446,315,0,323,23,321,0,6978
"17031080201",2750,199,131,0,142,13,13,13,3261
"17031080202",2968,135,109,0,297,24,82,0,3615
"17031080300",3348,286,133,216,456,41,127,21,4628
"17031080400",1551,235,557,2226,283,11,73,49,4985
"17031081000",3807,823,391,270,712,335,282,162,6782
"17031081100",2571,321,166,199,315,85,186,83,3926
"17031081201",3179,247,107,1,601,148,184,97,4564
"17031081202",2688,214,17,8,294,0,291,0,3512
"17031081300",3734,235,213,0,743,128,225,0,5278
"17031081401",1453,238,421,0,311,50,39,0,2512
"17031081402",3175,106,156,0,813,139,188,21,4598
"17031081403",4615,231,130,56,1767,205,409,115,7528
"17031081500",2933,372,88,4,878,101,116,22,4514
"17031081600",2169,315,38,0,471,184,154,13,3344
"17031081700",2292,74,136,0,1016,89,538,76,4221
"17031081800",5989,329,155,24,950,41,253,14,7755
"17031081900",471,11,160,269,230,11,32,5,1189
"17031090100",3037,74,0,0,151,0,357,0,3619
"17031090200",5975,101,117,0,197,16,456,0,6862
"17031090300",1191,78,0,0,56,0,44,0,1369
"17031100100",4860,270,0,0,515,21,755,0,6421
"17031100200",5765,176,148,1,332,0,821,31,7274
"17031100300",4811,435,28,0,436,23,743,23,6499
"17031100400",2668,192,0,5,161,0,336,54,3416
"17031100500",4688,64,0,5,399,0,302,3,5461
"17031100600",4343,223,35,18,576,59,720,151,6125
"17031100700",3582,541,8,1,475,116,460,64,5247
"17031110100",4497,317,120,0,882,107,974,242,7139
"17031110200",1895,367,59,15,627,54,323,21,3361
"17031110300",4153,281,41,0,778,61,954,31,6299
"17031110400",3506,241,19,4,663,6,836,0,5275
"17031110501",3800,241,16,1,569,0,1006,21,5654
"17031110502",2477,318,22,39,419,331,715,248,4569
"17031120100",3540,138,0,1,285,29,162,11,4166
"17031120200",3697,66,21,0,768,0,502,0,5054
"17031120300",4400,141,0,9,1511,118,552,145,6876
"17031120400",2199,140,0,0,1137,278,794,191,4739
"17031130100",3170,294,0,59,1279,167,579,47,5595
"17031130200",1278,86,13,16,176,29,308,0,1906
"17031130300",2314,374,175,36,2172,189,936,128,6324
"17031140100",1224,681,80,211,1033,850,1006,1309,6394
"17031140200",1714,352,40,73,2141,414,2343,437,7514
"17031140301",903,176,23,0,1394,252,1479,358,4585
"17031140302",1557,195,272,25,1338,774,1382,471,6014
"17031140400",3497,515,0,0,2978,196,1442,522,9150
"17031140500",1744,376,77,0,1649,275,1719,337,6177
"17031140601",1032,65,28,0,1429,415,1681,199,4849
"17031140602",2114,342,249,91,2205,613,3150,763,9527
"17031140701",1364,153,60,11,702,95,1050,159,3594
"17031140702",3042,771,199,230,1394,604,2937,1062,10239
"17031140800",4416,466,184,15,1270,775,2017,761,9904
"17031150200",4744,594,200,64,1402,799,1482,638,9923
"17031150300",4621,774,139,31,1892,69,2310,116,9952
"17031150401",3145,538,16,0,871,235,999,371,6175
"17031150402",2423,203,0,0,849,220,1521,238,5454
"17031150501",2822,208,0,3,656,54,1090,0,4833
"17031150502",2225,292,15,6,1378,349,1527,199,5991
"17031150600",2396,271,0,0,1054,147,1439,154,5461
"17031150700",3205,488,29,0,873,17,1740,246,6598
"17031150800",2968,314,21,4,2007,137,2567,320,8338
"17031151001",755,484,54,14,757,474,910,799,4247
"17031151002",1976,342,0,13,1814,540,2433,600,7718
"17031151100",2678,743,36,0,1650,276,2023,687,8093
"17031151200",2631,247,118,0,669,10,1276,0,4951
"17031160100",1804,186,4,1,613,12,680,73,3373
"17031160200",2473,81,83,16,1117,24,1098,0,4892
"17031160300",1859,526,333,290,656,125,861,73,4723
"17031160400",2738,854,142,38,749,569,1324,938,7352
"17031160501",2470,470,136,38,1128,235,2466,681,7624
"17031160502",2623,262,30,9,1345,291,2676,360,7596
"17031160601",2763,442,16,1,709,68,2003,384,6386
"17031160602",2385,384,76,0,923,197,1567,334,5866
"17031160700",3056,974,210,2,1489,75,1667,810,8283
"17031160800",3892,320,52,0,1103,21,2877,202,8467
"17031160900",1784,138,13,0,315,21,532,52,2855
"17031161000",1391,153,12,2,149,14,498,83,2302
"17031161100",1617,119,39,10,231,10,320,71,2417
"17031161200",1827,179,19,0,575,64,1238,129,4031
"17031161300",2985,505,40,54,302,18,2115,387,6406
"17031170100",1437,200,26,1,86,13,179,34,1976
"17031170200",3177,335,0,1,724,129,1424,237,6027
"17031170300",3545,452,0,0,636,281,869,403,6186
"17031170400",2934,574,17,0,190,5,711,49,4480
"17031170500",4187,289,137,11,255,9,924,59,5871
"17031170600",2164,102,25,41,412,30,486,29,3289
"17031170700",1988,458,8,0,345,32,394,169,3394
"17031170800",3094,372,11,0,230,29,724,105,4565
"17031170900",1369,90,9,0,152,109,384,102,2215
"17031171000",6177,515,198,142,916,0,2330,22,10300
"17031171100",3183,438,56,0,522,58,1421,191,5869
"17031180100",3695,528,123,17,1062,384,2483,506,8798
"17031190100",860,317,68,14,976,476,1297,654,4662
"17031190200",1723,332,17,83,2571,961,3445,1044,10176
"17031190300",2790,400,26,9,1979,235,3100,470,9009
"17031190401",2541,159,0,0,1072,411,2095,437,6715
"17031190402",1938,642,145,18,1509,390,2301,888,7831
"17031190601",1559,329,63,141,1964,721,3042,957,8776
"17031190602",1973,101,159,1,2314,398,3500,497,8943
"17031190701",1093,85,11,69,1643,171,2245,209,5526
"17031190702",1754,383,183,134,1914,708,3118,895,9089
"17031190800",2149,310,32,41,3229,1120,4638,1240,12759
"17031190900",586,38,79,0,801,356,1181,382,3423
"17031191000",927,325,81,27,1069,472,1895,791,5587
"17031191100",1821,621,257,4,3898,1335,5402,1854,15192
"17031191200",784,340,36,71,1773,971,2380,1194,7549
"17031191301",1324,399,516,182,2753,767,3888,1099,10928
"17031191302",1854,611,360,37,1663,531,3446,1140,9642
"17031200100",1862,267,71,0,2024,327,3105,441,8097
"17031200200",1227,211,74,26,2731,691,3528,847,9335
"17031200300",499,369,16,0,1153,364,1495,726,4622
"17031200401",1441,303,114,0,1480,476,2833,779,7426
"17031200402",739,275,44,37,2166,754,2720,1026,7761
"17031210100",2215,534,42,12,443,134,962,229,4571
"17031210400",2043,632,46,6,296,64,1580,581,5248
"17031210501",3142,652,169,0,510,96,2691,346,7606
"17031210502",3215,1230,62,4,311,76,2396,812,8106
"17031210601",1871,388,60,2,625,65,1819,321,5151
"17031210602",2675,943,129,71,257,51,2005,807,6938
"17031210700",3101,445,21,0,342,45,1909,255,6118
"17031210800",736,140,4,3,139,5,447,101,1575
"17031210900",1993,508,200,0,506,16,1398,475,5096
"17031220300",1764,214,74,6,293,55,689,142,3237
"17031220400",1963,238,0,0,323,41,798,172,3535
"17031220500",2003,328,148,26,147,30,515,219,3416
"17031220601",1116,239,138,5,80,6,537,181,2302
"17031220602",2823,969,222,77,519,71,790,853,6324
"17031220701",2098,730,263,85,191,36,1577,583,5563
"17031220702",2574,666,147,153,534,315,2541,770,7700
"17031220901",1177,1048,169,88,557,258,1398,1100,5795
"17031220902",2218,753,26,42,281,5,2030,607,5962
"17031221000",2079,520,211,13,334,87,1893,578,5715
"17031221100",2665,576,181,517,393,272,1444,519,6567
"17031221200",2175,289,104,7,366,124,1102,214,4381
"17031221300",1669,479,54,99,358,103,771,421,3954
"17031221400",2205,318,7,115,114,40,1186,264,4249
"17031221500",1911,359,99,0,180,25,982,275,3831
"17031221600",2384,352,24,1,308,49,611,114,3843
"17031222200",1628,68,33,28,197,9,128,6,2097
"17031222500",1032,175,29,59,82,47,764,185,2373
"17031222600",991,205,99,17,206,36,590,92,2236
"17031222700",1632,593,113,133,129,52,1164,584,4400
"17031222800",419,341,138,42,10,64,389,416,1819
"17031222900",441,196,56,67,118,0,485,151,1514
"17031230100",439,126,188,208,536,137,617,185,2436
"17031230200",681,83,205,79,546,378,1030,442,3444
"17031230300",241,178,13,25,574,125,778,253,2187
"17031230400",1011,77,68,32,948,530,1873,576,5115
"17031230500",969,167,150,146,1514,764,2272,932,6914
"17031230600",967,258,1460,1319,1762,1106,2331,1325,10528
"17031230700",1244,153,305,300,2388,764,3567,874,9595
"17031230800",377,24,61,11,577,144,809,163,2166
"17031230900",1039,162,679,905,1401,969,1806,1038,7999
"17031231100",241,16,536,220,125,89,275,104,1606
"17031231200",233,156,1553,1664,924,565,1037,691,6823
"17031231500",121,68,3692,2674,100,310,101,311,7377
"17031240200",1144,128,21,7,155,14,209,56,1734
"17031240300",1210,58,0,0,134,0,67,0,1469
"17031240500",1756,98,0,24,269,7,258,0,2412
"17031240600",950,192,25,11,74,88,167,237,1744
"17031240700",707,331,50,111,164,64,232,366,2025
"17031240800",1081,295,93,37,203,82,891,346,3028
"17031240900",648,65,74,50,302,97,618,79,1933
"17031241000",866,130,316,312,125,109,632,232,2722
"17031241100",1948,482,193,127,974,262,1264,513,5763
"17031241200",1257,205,66,68,292,64,289,150,2391
"17031241300",1199,119,59,136,85,102,166,182,2048
"17031241400",3288,392,374,332,755,97,232,276,5746
"17031241500",2219,184,17,63,244,129,395,166,3417
"17031241600",2287,388,81,51,534,97,564,155,4157
"17031242000",2529,491,346,278,1009,133,1353,344,6483
"17031242100",2495,195,93,10,446,72,613,19,3943
"17031242200",2879,432,144,67,316,37,601,268,4744
"17031242300",2511,122,89,19,222,40,407,40,3450
"17031242400",2374,217,45,10,279,0,210,34,3169
"17031242500",2597,365,89,41,702,134,1291,330,5549
"17031242600",3181,415,527,349,1106,421,1698,317,8014
"17031242700",642,175,198,273,281,105,410,264,2348
"17031242800",1155,174,4,1,164,17,241,17,1773
"17031242900",1090,188,96,6,298,140,400,237,2455
"17031243000",1692,398,0,0,301,7,936,359,3693
"17031243100",1463,353,195,7,558,18,974,289,3857
"17031243200",1504,269,20,0,356,28,619,166,2962
"17031243300",1729,215,69,10,260,70,489,201,3043
"17031243400",1897,166,144,41,538,169,937,206,4098
"17031243500",2291,135,182,210,301,79,204,35,3437
"17031250200",383,103,1405,420,300,317,796,426,4150
"17031250300",224,14,2452,1008,361,716,417,672,5864
"17031250400",215,0,3428,1383,545,374,760,407,7112
"17031250500",3430,562,2188,413,878,174,1698,185,9528
"17031250600",96,0,3407,628,189,89,237,89,4735
"17031250700",25,0,3425,2160,178,0,196,120,6104
"17031250800",124,28,1522,351,124,289,202,276,2916
"17031251000",149,0,716,403,16,0,157,0,1441
"17031251100",138,7,2402,1344,336,101,434,101,4863
"17031251200",133,6,3041,996,158,0,43,0,4377
"17031251300",150,24,2933,1443,144,31,266,33,5024
"17031251400",148,36,2797,1289,48,0,173,1,4492
"17031251500",105,34,2554,1187,48,64,172,73,4237
"17031251600",74,11,2034,1318,239,13,192,2,3883
"17031251700",57,21,672,761,80,214,101,235,2141
"17031251800",31,6,3033,1976,0,23,0,0,5069
"17031251900",9,20,2809,2852,150,33,150,59,6082
"17031252000",176,56,4167,1906,5,0,138,81,6529
"17031252101",19,0,1211,443,96,0,50,0,1819
"17031252102",0,0,3678,2210,0,0,0,0,5888
"17031252201",0,0,1491,1135,7,0,7,0,2640
"17031252202",57,11,3095,1643,0,24,0,24,4854
"17031260100",39,47,434,519,8,0,7,0,1054
"17031260200",28,0,577,634,0,0,36,0,1275
"17031260300",23,4,797,594,47,18,47,0,1530
"17031260400",0,14,473,997,0,2,0,1,1487
"17031260500",3,4,1025,739,0,61,0,60,1892
"17031260600",18,67,1291,1176,25,0,7,7,2591
"17031260700",25,0,890,1022,194,11,171,9,2322
"17031260800",16,0,1170,1289,5,0,0,0,2480
"17031260900",22,57,1083,655,0,17,0,44,1878
"17031261000",0,0,1502,1072,10,0,10,0,2594
"17031270500",16,40,842,904,43,16,0,43,1904
"17031271200",0,10,590,481,0,23,0,23,1127
"17031271300",6,3,544,612,4,0,0,3,1172
"17031271400",28,10,697,414,0,0,0,0,1149
"17031271500",20,0,528,676,17,10,8,10,1269
"17031271800",11,0,699,520,0,0,0,0,1230
"17031280100",5026,357,257,0,730,154,351,56,6931
"17031280400",44,13,607,664,34,4,0,8,1374
"17031280800",77,1,422,301,18,8,20,8,855
"17031280900",50,13,235,442,50,0,52,0,842
"17031281900",2077,328,285,32,1402,696,359,63,5242
"17031282700",597,331,635,475,240,75,551,277,3181
"17031282800",756,63,309,5,381,51,334,26,1925
"17031283100",531,261,719,522,474,251,86,0,2844
"17031283200",399,184,317,259,303,19,65,9,1555
"17031283800",898,141,1073,577,604,74,211,95,3673
"17031290900",4,29,1689,1661,44,0,7,11,3445
"17031291200",19,10,1382,955,0,0,0,0,2366
"17031291600",185,108,115,52,299,45,462,100,1366
"17031292200",143,5,1393,1244,23,8,83,0,2899
"17031292400",117,43,942,1016,6,0,29,0,2153
"17031292500",66,0,2541,1625,0,18,12,117,4379
"17031300500",1413,602,61,58,821,60,2152,662,5829
"17031300600",1303,668,268,99,849,108,2123,780,6198
"17031300700",1810,1512,0,40,801,531,2501,2043,9238
"17031300800",1719,1218,0,17,1064,611,2763,1825,9217
"17031300900",1334,1601,83,11,601,333,1830,1922,7715
"17031301100",1176,682,44,52,666,550,1774,1230,6174
"17031301200",1082,995,209,59,879,294,1655,1217,6390
"17031301600",2077,1102,2,90,679,499,2708,1596,8753
"17031301701",2441,912,1,1,191,198,2488,1109,7341
"17031301702",1505,1266,0,0,607,316,2013,1582,7289
"17031301801",2251,970,0,281,340,404,2535,1370,8151
"17031301802",1262,690,0,13,857,67,2090,740,5719
"17031301803",1643,1471,0,115,1463,362,3021,1819,9894
"17031310200",812,232,45,1,376,60,634,231,2391
"17031310300",616,76,57,28,479,233,671,199,2359
"17031310400",868,65,72,15,294,112,911,142,2479
"17031310500",593,334,6,0,437,352,968,672,3362
"17031310600",1748,983,363,79,1162,806,2321,1517,8979
"17031310700",518,249,20,42,301,111,666,285,2192
"17031310800",2094,633,49,1,1708,249,3420,798,8952
"17031310900",2145,918,89,17,1350,546,2970,1405,9440
"17031320100",7117,396,753,36,1446,521,623,180,11072
"17031320400",629,24,12,7,149,39,24,7,891
"17031320600",2454,215,436,353,831,162,158,19,4628
"17031330100",8171,547,3414,612,4264,388,1210,0,18606
"17031330200",1697,105,958,163,630,203,162,33,3951
"17031340300",316,34,4,16,1001,363,60,16,1810
"17031340400",196,29,0,2,798,715,75,1,1816
"17031340500",890,107,100,47,164,380,306,45,2039
"17031340600",0,3,315,728,18,2,0,3,1069
"17031350100",162,7,928,189,399,304,58,7,2054
"17031350400",0,21,371,897,27,63,31,21,1431
"17031351000",113,25,2389,573,470,452,0,0,4022
"17031351100",14,0,409,1214,14,5,0,0,1656
"17031351400",50,18,504,960,5,14,0,0,1551
"17031351500",35,40,166,37,84,53,0,10,425
"17031360200",0,0,722,857,37,0,0,0,1616
"17031380100",115,9,1060,579,0,42,0,0,1805
"17031380200",85,45,1149,399,9,65,21,26,1799
"17031380500",2,2,541,271,2,2,0,2,822
"17031380700",124,5,561,324,22,0,10,2,1048
"17031381200",31,0,1518,336,53,8,58,0,2004
"17031381400",5,0,1126,615,0,0,5,0,1751
"17031381500",22,6,143,71,4,4,12,0,262
"17031381700",0,0,0,0,0,0,0,0,0
"17031381800",61,1,536,319,133,18,111,8,1187
"17031381900",92,0,822,369,10,0,22,6,1321
"17031390100",50,0,1140,126,66,4,80,0,1466
"17031390200",132,26,1073,348,58,0,16,1,1654
"17031390300",106,9,1308,1213,79,0,41,0,2756
"17031390400",148,38,1384,871,57,0,52,0,2550
"17031390500",323,26,888,211,152,43,68,6,1717
"17031390600",811,42,700,131,264,28,83,23,2082
"17031390700",1283,451,2912,99,831,566,240,91,6473
"17031400300",28,0,828,429,22,7,17,7,1338
"17031400400",0,0,844,791,10,0,15,0,1660
"17031400500",0,0,1152,1241,5,13,0,0,2411
"17031400800",0,1,976,1696,120,46,0,1,2840
"17031410100",422,126,736,179,247,246,184,210,2350
"17031410200",325,118,130,69,211,175,20,17,1065
"17031410500",573,160,998,358,235,199,101,60,2684
"17031410600",738,468,670,89,127,146,12,23,2273
"17031410700",801,285,394,74,285,94,57,30,2020
"17031410800",752,257,1060,346,648,138,289,65,3555
"17031410900",1230,264,737,202,248,141,99,151,3072
"17031411000",1407,194,809,146,285,125,80,47,3093
"17031411100",1321,89,100,16,333,49,16,10,1934
"17031411200",916,167,239,44,218,78,19,6,1687
"17031420100",72,0,639,483,19,11,52,0,1276
"17031420200",154,12,865,368,96,0,11,0,1506
"17031420300",133,108,667,264,16,75,7,19,1289
"17031420400",264,113,242,378,142,77,48,18,1282
"17031420500",0,11,1061,887,85,55,12,0,2111
"17031420600",14,97,723,1198,0,24,6,6,2068
"17031420700",53,58,1625,1253,0,52,1,33,3075
"17031420800",118,0,1177,964,33,0,71,0,2363
"17031421200",0,0,1050,640,0,17,0,17,1724
"17031430101",40,78,2583,957,249,6,17,69,3999
"17031430102",47,1,2434,839,84,9,51,0,3465
"17031430200",61,4,2397,2263,196,6,150,3,5080
"17031430300",4,0,1328,926,0,4,0,0,2262
"17031430400",8,15,1491,1427,72,45,0,28,3086
"17031430500",47,2,2047,1467,54,12,90,6,3725
"17031430600",41,0,1220,419,56,6,0,0,1742
"17031430700",24,21,1362,769,9,70,9,8,2272
"17031430800",36,18,1165,415,45,0,3,0,1682
"17031430900",0,19,839,451,12,0,0,0,1321
"17031431200",65,1,2623,405,89,30,69,30,3312
"17031431301",68,15,1676,1479,121,31,25,11,3426
"17031431302",37,2,1926,1209,148,47,134,44,3547
"17031431400",122,131,3358,1744,47,20,31,74,5527
"17031440101",34,22,2334,1207,94,56,97,0,3844
"17031440102",15,0,1940,1170,19,12,18,0,3174
"17031440201",0,28,3635,1543,13,33,53,13,5318
"17031440202",0,7,2466,1047,63,0,19,0,3602
"17031440300",72,14,3747,483,121,18,1,0,4456
"17031440600",23,0,1606,420,7,0,11,0,2067
"17031440700",3,0,1151,316,31,0,0,0,1501
"17031440800",0,0,939,787,3,17,0,17,1763
"17031440900",1,2,2105,341,29,0,0,0,2478
"17031450300",174,0,2832,663,18,6,15,0,3708
"17031460100",739,71,1633,916,238,17,708,214,4536
"17031460200",964,106,598,783,115,60,1029,148,3803
"17031460301",485,40,1065,746,204,99,657,131,3427
"17031460302",103,44,1635,1552,172,0,194,21,3721
"17031460400",54,0,2488,603,0,0,0,0,3145
"17031460500",73,42,3978,584,104,0,39,0,4820
"17031460600",229,56,436,329,57,0,146,39,1292
"17031460700",667,184,368,1352,163,148,743,302,3927
"17031461000",488,315,558,458,123,67,680,315,3004
"17031470100",0,0,1782,836,0,0,0,0,2618
"17031480100",51,0,1707,276,8,3,0,0,2045
"17031480200",0,0,893,252,6,0,0,0,1151
"17031480300",20,3,848,288,32,0,66,0,1257
"17031480400",71,27,5250,638,71,49,18,29,6153
"17031480500",263,22,2042,314,97,162,221,184,3305
"17031490300",18,0,1717,445,92,18,28,21,2339
"17031490400",0,0,837,117,18,0,0,0,972
"17031490500",0,0,1895,159,25,0,46,0,2125
"17031490600",5,2,1173,256,16,0,0,1,1453
"17031490700",21,0,1947,880,9,12,0,0,2869
"17031490800",32,10,2762,842,70,28,24,0,3768
"17031490901",34,48,2853,1216,64,0,0,2,4217
"17031490902",23,7,4042,733,20,0,0,7,4832
"17031491000",25,27,2706,2731,8,1,0,46,5544
"17031491100",44,13,3471,776,21,0,21,47,4393
"17031491200",9,0,2086,599,44,0,14,0,2752
"17031491300",17,57,1258,953,31,13,33,40,2402
"17031491400",15,24,1596,919,42,0,95,0,2691
"17031500100",21,20,2550,695,28,0,24,0,3338
"17031500200",21,8,1190,797,36,10,8,8,2078
"17031500300",757,128,344,154,158,10,484,46,2081
"17031510100",1520,270,209,129,1234,284,2535,491,6672
"17031510200",414,92,1644,363,0,142,312,190,3157
"17031510300",31,8,4360,1449,76,99,15,0,6038
"17031520100",1121,718,125,44,148,112,1208,791,4267
"17031520200",2104,1044,54,212,282,272,2026,1339,7333
"17031520300",3998,1288,20,0,588,222,3994,1387,11497
"17031520400",2316,217,148,25,824,205,2830,347,6912
"17031520500",3706,534,0,23,327,23,2524,344,7481
"17031520600",2205,363,0,0,412,30,1969,389,5368
"17031530100",476,233,553,431,180,178,662,320,3033
"17031530200",0,0,2259,2601,9,24,0,0,4893
"17031530300",83,10,3196,1090,42,0,40,0,4461
"17031530400",10,0,1576,396,17,18,17,4,2038
"17031530501",44,52,2963,1939,149,0,14,17,5178
"17031530502",8,0,1185,293,0,9,0,0,1495
"17031530503",9,59,3378,1570,39,11,16,59,5141
"17031530600",11,82,1740,1026,13,0,10,82,2964
"17031540101",47,25,1131,2696,13,3,47,48,4010
"17031540102",22,52,1350,1729,16,8,16,0,3193
"17031550100",4687,1018,335,77,333,297,2726,791,10264
"17031550200",2184,155,42,1,151,46,1202,168,3949
"17031560100",476,190,31,32,270,78,546,177,1800
"17031560200",298,64,884,187,71,6,187,0,1697
"17031560300",1570,95,279,0,1077,142,1559,176,4898
"17031560400",862,177,18,0,360,0,720,153,2290
"17031560700",2507,221,1,3,677,76,1551,159,5195
"17031560800",4553,201,14,18,1064,86,2927,151,9014
"17031560900",4120,313,19,1,915,1,1584,111,7064
"17031561000",3991,177,0,0,509,215,1731,215,6838
"17031561100",4805,165,0,0,818,28,2129,83,8028
"17031570100",784,129,0,3,333,47,844,139,2279
"17031570200",1250,124,8,0,442,54,1217,133,3228
"17031570300",3501,608,16,0,1701,511,3925,921,11183
"17031570400",930,182,14,1,682,87,1326,217,3439
"17031570500",1176,236,80,0,922,140,1487,339,4380
"17031580100",1110,592,5,10,891,388,1359,729,5084
"17031580200",1383,464,17,54,1141,245,2190,537,6031
"17031580300",941,350,0,0,895,148,1667,450,4451
"17031580400",1938,411,15,108,1017,523,2336,763,7111
"17031580501",2514,755,19,78,1067,576,2979,1214,9202
"17031580502",2807,634,62,29,743,596,3052,1027,8950
"17031580600",3003,997,29,62,1435,277,4042,1144,10989
"17031580700",2722,1275,40,0,1895,328,3950,1552,11762
"17031580800",692,468,21,4,357,119,973,557,3191
"17031590500",804,147,35,8,540,308,639,190,2671
"17031590600",1765,247,53,0,1516,373,2046,545,6545
"17031590700",1435,441,44,80,903,331,1706,517,5457
"17031600400",1510,149,8,9,2231,841,716,205,5669
"17031600600",735,274,0,67,1124,294,543,403,3440
"17031600700",1047,265,62,65,629,132,645,39,2884
"17031600900",1410,267,348,160,1205,204,716,273,4583
"17031610300",2186,1298,205,103,1543,345,3225,1552,10457
"17031610400",609,529,0,38,502,219,1092,716,3705
"17031610800",1231,244,17,0,57,0,183,72,1804
"17031611000",293,152,169,418,38,76,282,224,1652
"17031611100",831,565,224,378,329,271,1118,786,4502
"17031611200",979,317,186,340,179,313,1062,585,3961
"17031611300",1001,474,291,228,420,354,1300,760,4828
"17031611400",1236,653,0,141,980,534,2085,1123,6752
"17031611500",1423,252,134,62,675,304,2015,509,5374
"17031611600",345,25,588,387,47,132,392,157,2073
"17031611700",179,81,538,374,44,119,210,172,1717
"17031611800",75,418,750,479,309,412,353,761,3557
"17031611900",232,67,870,860,100,0,279,0,2408
"17031612000",4,1,810,620,136,10,154,0,1735
"17031612100",77,18,636,300,0,37,20,9,1097
"17031620100",2431,414,25,46,1354,465,3014,868,8617
"17031620200",1529,301,9,0,508,83,1344,357,4131
"17031620300",3526,613,67,22,2454,298,4493,656,12129
"17031620400",2530,224,30,10,1497,591,3699,793,9374
"17031630100",578,92,69,118,167,111,736,197,2068
"17031630200",987,188,50,22,597,361,1523,513,4241
"17031630300",2505,767,0,14,1698,315,4014,926,10239
"17031630400",2036,676,0,0,2744,1279,4444,1921,13100
"17031630500",2216,718,61,3,3191,439,5252,1096,12976
"17031630800",2505,1407,124,185,2520,592,4760,1976,14069
"17031630900",1622,413,54,13,2014,901,3493,1270,9780
"17031640100",715,26,0,36,417,36,731,36,1997
"17031640300",4675,268,0,0,1992,0,2936,156,10027
"17031640400",2345,138,0,0,1006,164,1602,198,5453
"17031640500",2549,149,42,1,367,74,1017,158,4357
"17031640600",2728,620,0,0,795,281,1360,521,6305
"17031640700",1975,172,0,24,858,206,1730,236,5201
"17031640800",910,106,75,0,526,145,1149,158,3069
"17031650100",1169,483,0,1,2429,418,3280,794,8574
"17031650200",3713,1029,59,41,2340,446,4241,1203,13072
"17031650301",2617,318,0,2,2368,439,3949,713,10406
"17031650302",1633,237,146,0,1754,378,2956,559,7663
"17031650400",2183,275,292,58,3112,1364,4627,1617,13528
"17031650500",1995,300,208,125,1166,369,2339,638,7140
"17031660301",161,44,275,505,617,188,773,165,2728
"17031660302",691,357,558,320,3060,568,3643,855,10052
"17031660400",1631,158,178,89,2438,1462,3842,1534,11332
"17031660500",1053,695,398,432,2449,675,3246,1365,10313
"17031660600",337,261,2120,1726,1178,504,1325,703,8154
"17031660700",31,37,1350,1108,105,14,17,23,2685
"17031660800",392,53,2010,1273,1742,938,1949,965,9322
"17031660900",143,71,1921,1706,259,208,209,74,4591
"17031661000",158,0,3749,1533,277,0,172,0,5889
"17031661100",1271,249,2396,586,1009,460,1955,694,8620
"17031670100",14,61,890,539,51,0,51,0,1606
"17031670200",30,0,590,303,0,56,30,56,1065
"17031670300",15,21,638,607,0,82,0,88,1451
"17031670400",24,105,847,626,78,178,98,125,2081
"17031670500",0,10,597,314,62,57,65,57,1162
"17031670600",0,0,785,716,118,11,72,11,1713
"17031670700",26,0,893,613,10,5,16,0,1563
"17031670800",0,0,896,773,0,0,0,0,1669
"17031670900",0,0,1017,428,46,5,5,0,1501
"17031671100",5,0,569,912,0,0,0,0,1486
"17031671200",0,0,478,512,6,24,0,0,1020
"17031671300",1,0,1217,924,24,13,0,0,2179
"17031671400",0,32,1191,604,0,18,0,71,1916
"17031671500",79,6,1756,1262,38,94,88,98,3421
"17031671600",5,21,1189,891,148,37,115,37,2443
"17031671800",0,0,627,425,87,0,2,0,1141
"17031671900",0,0,1040,265,3,0,0,0,1308
"17031672000",20,0,3386,523,112,0,96,0,4137
"17031680500",53,57,416,696,0,55,53,55,1385
"17031680600",0,36,656,855,34,13,0,0,1594
"17031680900",0,9,1644,1649,35,32,16,2,3387
"17031681000",24,1,1208,1525,0,86,0,77,2921
"17031681100",7,22,1765,1683,1,0,0,15,3493
"17031681200",0,0,1247,997,16,104,0,0,2364
"17031681300",0,0,1108,1117,125,59,96,33,2538
"17031681400",0,0,1736,1162,0,0,0,0,2898
"17031690300",0,8,1165,703,10,4,0,8,1898
"17031690400",18,11,2184,1306,38,13,112,18,3700
"17031690500",0,0,631,316,0,5,0,0,952
"17031690900",0,57,2492,1869,24,0,44,0,4486
"17031691000",20,10,1967,679,6,21,8,0,2711
"17031691100",22,11,1485,1585,22,77,56,0,3258
"17031691200",81,0,1607,1147,12,128,0,0,2975
"17031691300",5,0,2411,327,6,0,18,0,2767
"17031691400",0,0,2082,589,36,9,10,9,2735
"17031691500",0,25,1061,916,0,84,11,132,2229
"17031700100",468,37,1951,164,263,603,525,603,4614
"17031700200",2072,520,856,40,2905,460,3992,822,11667
"17031700301",2666,356,591,81,1332,770,2626,1028,9450
"17031700302",2859,247,917,251,1118,294,2260,495,8441
"17031700401",1346,348,3115,166,1092,69,1601,314,8051
"17031700402",536,90,2354,347,501,12,652,43,4535
"17031700501",366,61,6627,283,184,0,208,0,7729
"17031700502",82,24,2536,90,13,90,0,90,2925
"17031710100",66,0,468,871,0,0,66,0,1471
"17031710200",119,0,3029,2588,109,0,111,0,5956
"17031710300",0,0,934,398,10,23,10,0,1375
"17031710400",30,0,3716,1235,78,33,54,0,5146
"17031710500",9,32,2802,1021,128,101,86,24,4203
"17031710600",0,0,1193,597,0,0,0,0,1790
"17031710700",9,2,1861,755,67,1,30,0,2725
"17031710800",0,2,4432,330,58,49,79,1,4951
"17031710900",8,0,1147,1295,5,6,28,0,2489
"17031711000",7,0,2285,1094,42,0,18,0,3446
"17031711100",0,0,2157,970,9,0,0,0,3136
"17031711200",0,0,3760,1139,14,0,0,0,4913
"17031711300",0,0,1119,419,0,17,21,14,1590
"17031711400",1,1,1224,963,17,0,17,64,2287
"17031711500",0,0,1885,541,44,42,0,42,2554
"17031720100",2127,3,1424,0,95,36,394,17,4096
"17031720200",1593,122,2259,237,117,16,244,0,4588
"17031720300",2319,7,1222,0,122,1,221,2,3894
"17031720400",1798,12,66,1,74,22,93,12,2078
"17031720500",2024,50,68,0,47,0,124,0,2313
"17031720600",1425,41,193,19,23,8,22,0,1731
"17031720700",1159,0,1954,181,116,0,40,0,3450
"17031730100",9,0,1981,510,38,10,14,9,2571
"17031730201",69,1,3976,1495,243,1,125,0,5910
"17031730202",0,47,2538,612,0,47,0,94,3338
"17031730300",4,0,747,214,18,0,4,0,987
"17031730400",6,0,3141,529,116,0,52,0,3844
"17031730500",107,1,3789,354,26,29,37,0,4343
"17031730600",0,0,2810,337,32,30,0,0,3209
"17031730700",8,6,1663,535,38,0,17,0,2267
"17031740100",2633,116,0,0,56,0,133,0,2938
"17031740200",5130,223,122,12,183,19,254,19,5962
"17031740300",4268,42,77,0,49,0,368,8,4812
"17031740400",3673,170,505,51,356,54,169,45,5023
"17031750100",67,0,3043,1162,57,25,0,13,4367
"17031750200",1189,40,1342,142,141,21,0,9,2884
"17031750300",2300,26,164,46,118,0,245,0,2899
"17031750400",1937,102,1040,16,86,0,73,4,3258
"17031750500",1143,138,3287,1198,120,188,63,188,6325
"17031750600",0,3,2176,1255,149,43,21,0,3647
"17031760801",2473,891,73,0,854,108,194,0,4593
"17031760802",2019,321,16,0,45,0,225,30,2656
"17031760803",4366,1340,60,1,1040,536,863,363,8569
"17031770201",4118,284,27,38,1082,91,675,0,6315
"17031770202",4079,343,55,1,457,0,493,0,5428
"17031770300",6281,393,0,0,585,23,707,15,8004
"17031770400",3017,304,33,17,1103,221,737,213,5645
"17031770500",1188,806,19,15,1788,257,2621,883,7577
"17031770601",2196,118,0,1,403,206,397,205,3526
"17031770602",2539,400,48,0,1022,554,1275,842,6680
"17031770700",1946,273,55,21,290,5,295,5,2890
"17031770800",4128,295,63,34,1300,40,1166,177,7203
"17031770901",4514,410,0,0,291,0,288,114,5617
"17031770902",2943,225,22,2,159,11,102,21,3485
"17031800100",2413,63,0,0,117,0,23,7,2623
"17031800200",5778,216,62,2,173,0,215,0,6446
"17031800300",3002,14,19,0,266,0,150,0,3451
"17031800400",3223,21,0,0,429,43,55,0,3771
"17031800500",4690,169,0,1,405,1,119,0,5385
"17031800600",2453,38,26,0,76,5,51,0,2649
"17031800700",4575,76,0,0,375,0,299,0,5325
"17031800800",1659,95,0,0,403,0,50,0,2207
"17031800900",2810,180,109,0,1470,14,464,0,5047
"17031801000",3606,134,26,25,916,93,58,25,4883
"17031801100",4240,29,37,0,316,0,151,0,4773
"17031801200",3090,128,19,0,205,0,134,0,3576
"17031801300",3924,122,62,15,391,13,113,13,4653
"17031801400",2432,9,25,0,551,0,316,0,3333
"17031801500",5284,257,0,0,729,52,194,0,6516
"17031801601",3487,8,0,1,684,0,49,8,4237
"17031801603",1971,62,167,133,1087,314,150,6,3890
"17031801605",4239,151,109,0,901,21,118,0,5539
"17031801606",4749,392,0,1,688,0,175,19,6024
"17031801607",3770,161,103,10,1122,183,204,6,5559
"17031801608",4977,200,0,0,946,78,287,0,6488
"17031801701",3076,107,0,0,407,0,93,0,3683
"17031801702",4099,85,0,0,578,131,129,0,5022
"17031801800",4829,196,0,0,379,40,35,4,5483
"17031801901",3324,150,60,11,680,0,717,0,4942
"17031801902",2993,6,38,0,284,13,154,0,3488
"17031802002",4117,172,56,0,813,0,258,0,5416
"17031802003",1887,314,67,3,509,5,271,301,3357
"17031802004",3179,352,61,0,1495,370,769,181,6407
"17031802100",3039,40,0,2,253,0,59,0,3393
"17031802200",3796,137,31,0,218,0,203,0,4385
"17031802300",3725,409,62,5,905,33,283,2,5424
"17031802402",3132,1140,67,0,766,237,1186,963,7491
"17031802403",1122,55,12,0,237,31,39,14,1510
"17031802404",4099,812,44,0,1950,364,2260,429,9958
"17031802503",3560,261,14,0,1300,377,255,324,6091
"17031802504",4176,185,19,0,2050,40,2429,136,9035
"17031802505",3279,431,81,138,2566,393,3001,541,10430
"17031802506",1552,311,6,0,950,75,1530,185,4609
"17031802605",5356,202,318,5,1227,1,561,1,7671
"17031802607",1213,27,0,0,89,0,31,0,1360
"17031802608",5909,181,20,0,355,0,262,0,6727
"17031802609",3270,1104,0,44,1955,104,2305,812,9594
"17031802610",1105,9,0,0,483,17,89,0,1703
"17031802701",4685,90,31,0,1714,195,1427,125,8267
"17031802702",3221,84,36,31,1169,77,294,28,4940
"17031802801",4095,295,87,0,628,0,156,179,5440
"17031802802",5710,96,27,0,605,0,396,0,6834
"17031802900",5478,189,0,0,356,15,46,0,6084
"17031803005",2303,158,47,55,181,0,23,0,2767
"17031803007",4015,238,0,2,547,0,302,0,5104
"17031803008",3731,144,85,1,579,1,374,1,4916
"17031803010",3961,138,0,0,599,0,436,0,5134
"17031803012",1909,18,103,0,226,63,243,0,2562
"17031803013",4496,163,86,0,438,86,161,0,5430
"17031803014",2368,205,20,0,703,0,543,31,3870
"17031803015",3826,119,68,27,425,70,287,62,4884
"17031803016",1405,76,47,2,818,6,143,0,2497
"17031803017",4443,123,0,19,811,107,286,30,5819
"17031803100",3098,69,79,3,67,15,72,0,3403
"17031803200",4964,159,64,2,265,42,506,42,6044
"17031803300",4638,316,6,2,735,32,261,12,6002
"17031803400",5508,275,43,3,322,46,373,124,6694
"17031803500",5762,284,0,5,238,0,144,3,6436
"17031803603",5245,128,76,0,1276,0,96,41,6862
"17031803604",3528,203,75,29,540,0,122,56,4553
"17031803605",5101,485,187,2,1193,487,680,570,8705
"17031803606",3343,1432,370,191,2355,1440,3336,1963,14430
"17031803607",4260,75,54,0,582,69,201,0,5241
"17031803608",5450,116,301,207,1597,102,965,37,8775
"17031803610",4836,361,241,87,1775,131,619,113,8163
"17031803611",3043,279,295,0,1641,623,1984,546,8411
"17031803612",1612,249,139,64,1050,437,1051,592,5194
"17031803701",1948,232,15,0,463,0,148,34,2840
"17031803702",4400,171,0,0,1259,63,457,0,6350
"17031803800",4176,209,2,1,507,105,595,105,5700
"17031803901",2620,152,66,2,371,92,234,127,3664
"17031803902",3367,183,30,0,55,0,544,14,4193
"17031804000",3720,148,40,1,544,34,562,9,5058
"17031804102",5417,127,0,11,960,33,225,0,6773
"17031804104",3432,146,24,4,1470,1,276,0,5353
"17031804105",3474,101,57,0,688,0,243,0,4563
"17031804106",4870,230,109,16,1784,0,342,44,7395
"17031804108",1397,205,306,33,1819,55,335,37,4187
"17031804109",2282,81,91,25,371,27,240,15,3132
"17031804201",5386,296,59,5,1824,265,210,60,8105
"17031804202",6465,93,0,0,1149,131,514,0,8352
"17031804305",4424,286,259,0,2770,83,2983,234,11039
"17031804306",3709,159,0,71,2121,78,2747,49,8934
"17031804308",3259,112,88,0,1630,68,495,14,5666
"17031804309",1441,135,1,3,1231,71,906,146,3934
"17031804310",5487,175,216,0,3427,34,1728,39,11106
"17031804311",4054,296,31,0,3896,230,2599,189,11295
"17031804403",3715,1129,354,52,1475,99,1746,1060,9630
"17031804404",2860,231,166,0,1815,196,2937,134,8339
"17031804405",920,127,129,234,1340,593,1566,666,5575
"17031804406",2811,214,155,32,2612,370,2615,409,9218
"17031804505",2661,194,92,0,679,17,711,35,4389
"17031804506",3707,67,141,0,1001,16,478,0,5410
"17031804507",8023,179,138,237,3869,106,1069,44,13665
"17031804508",968,121,38,218,609,515,629,456,3554
"17031804509",2533,177,64,0,2225,408,2414,477,8298
"17031804510",2392,87,207,79,3001,921,3789,999,11475
"17031804511",647,174,53,0,1349,420,1195,479,4317
"17031804603",2702,465,156,14,1821,127,1171,134,6590
"17031804606",5533,101,20,13,1553,0,291,0,7511
"17031804607",5263,190,148,0,1173,96,191,34,7095
"17031804608",2339,182,94,14,955,28,288,0,3900
"17031804609",3580,523,22,0,1614,0,353,28,6120
"17031804610",1765,101,0,0,466,16,136,0,2484
"17031804611",3307,95,85,0,701,249,87,40,4564
"17031804701",1971,268,895,117,2998,324,1856,65,8494
"17031804705",1986,213,124,126,1332,156,578,52,4567
"17031804706",2052,33,0,0,360,61,125,0,2631
"17031804709",3025,170,458,37,2034,153,894,120,6891
"17031804710",3564,112,0,0,717,0,645,0,5038
"17031804711",3557,359,575,57,3069,474,1150,448,9689
"17031804712",3736,86,113,11,1516,147,710,147,6466
"17031804713",2382,144,117,42,1513,115,94,0,4407
"17031804714",2668,30,82,0,621,12,444,0,3857
"17031804715",1274,28,143,32,1775,112,1478,10,4852
"17031804716",2896,52,99,0,2364,275,1140,251,7077
"17031804803",4129,335,225,0,1092,0,246,0,6027
"17031804804",3524,688,282,0,2276,127,1087,118,8102
"17031804805",5157,110,549,64,1057,106,876,43,7962
"17031804806",2141,145,230,189,1099,87,975,90,4956
"17031804807",3575,267,318,47,784,0,608,0,5599
"17031804808",2253,108,9,0,185,0,303,0,2858
"17031804809",3536,25,48,0,579,0,72,0,4260
"17031804810",4663,318,287,18,1329,206,814,149,7784
"17031804901",5676,164,30,27,345,92,218,7,6559
"17031804902",4255,58,1,0,1426,0,819,0,6559
"17031805001",4546,96,24,0,190,0,360,0,5216
"17031805002",4008,305,239,71,1618,400,509,215,7365
"17031805105",3694,383,334,73,1736,1048,2128,1028,10424
"17031805106",2087,239,93,6,142,12,40,0,2619
"17031805107",3509,280,210,115,2405,346,1803,209,8877
"17031805108",2882,243,324,13,3537,108,2677,234,10018
"17031805109",3716,180,42,0,384,0,79,9,4410
"17031805110",3414,87,34,14,534,0,112,19,4214
"17031805111",3787,471,246,0,2739,305,2147,228,9923
"17031805112",1858,82,0,10,948,49,276,9,3232
"17031805201",2240,83,1,0,712,0,163,26,3225
"17031805202",2734,169,86,32,905,99,382,0,4407
"17031805301",1910,221,0,28,988,89,262,0,3498
"17031805302",2359,162,52,0,946,0,118,0,3637
"17031805401",3154,161,146,0,333,45,326,11,4176
"17031805402",3466,246,41,0,1037,0,563,0,5353
"17031805501",3139,214,8,0,337,0,167,44,3909
"17031805502",3794,92,1,1,38,0,210,40,4176
"17031805600",4417,161,15,11,75,0,152,0,4831
"17031805701",4654,144,0,0,334,19,475,0,5626
"17031805702",1692,72,0,2,129,1,51,15,1962
"17031805801",2034,72,30,2,162,85,20,0,2405
"17031805802",4552,162,19,0,193,8,385,16,5335
"17031805901",3432,214,1,1,354,44,336,0,4382
"17031805902",4606,99,173,1,747,468,287,77,6458
"17031806001",3064,466,202,39,1984,469,610,256,7090
"17031806002",3326,445,363,36,3161,266,852,173,8622
"17031806003",4138,253,125,0,2861,275,1018,32,8702
"17031806004",4954,289,116,109,1490,427,1185,287,8857
"17031806102",2980,172,215,1,694,22,553,31,4668
"17031806103",3668,347,164,0,1010,114,313,42,5658
"17031806104",1985,496,591,71,1085,630,274,477,5609
"17031806201",3326,155,52,0,994,22,717,87,5353
"17031806202",3461,404,51,21,477,18,360,22,4814
"17031806300",3834,112,0,0,813,84,794,69,5706
"17031806400",1838,338,17,0,244,22,260,240,2959
"17031806501",1298,68,6,1,913,233,960,43,3522
"17031806502",3183,374,92,0,708,6,1364,283,6010
"17031806600",2326,114,99,0,760,127,902,104,4432
"17031806700",3095,96,204,25,777,20,319,0,4536
"17031806801",1862,306,366,112,814,25,264,22,3771
"17031806802",1794,23,207,25,867,49,246,0,3211
"17031806900",2254,245,0,12,2010,163,299,10,4993
"17031807000",3073,476,349,299,1046,543,388,9,6183
"17031807100",2762,85,381,87,337,0,162,0,3814
"17031807200",3208,240,496,38,1771,83,752,71,6659
"17031807300",3663,575,253,113,2314,505,400,106,7929
"17031807400",3830,938,403,4,1564,97,818,258,7912
"17031807500",1999,64,133,19,1093,116,377,37,3838
"17031807600",3051,369,74,4,2579,284,709,22,7092
"17031807700",2724,1078,286,55,1825,270,577,512,7327
"17031807800",1979,73,3,14,651,5,370,16,3111
"17031807900",2740,53,0,0,1083,198,461,49,4584
"17031808001",2542,94,171,0,1084,0,272,0,4163
"17031808002",2608,146,132,0,1611,134,150,0,4781
"17031808100",2363,226,32,22,334,0,235,30,3242
"17031808200",3378,657,0,1,1370,137,297,33,5873
"17031808301",3295,277,96,2,1864,266,140,186,6126
"17031808302",2253,124,130,63,1326,50,258,0,4204
"17031808400",2377,133,19,31,1645,181,237,158,4781
"17031808500",2555,127,26,44,1280,40,168,16,4256
"17031808600",1786,39,0,0,235,0,98,0,2158
"17031808702",442,233,19,0,77,125,48,18,962
"17031808800",2631,176,53,0,280,27,174,10,3351
"17031808900",3458,155,15,0,255,66,238,0,4187
"17031809000",3701,12,69,0,226,10,58,0,4076
"17031809100",2822,43,150,23,192,59,73,0,3362
"17031809200",1067,259,2628,368,525,279,940,190,6256
"17031809300",1767,1432,127,135,286,635,177,319,4878
"17031809400",2816,692,128,66,686,457,70,94,5009
"17031809500",2370,345,91,73,407,166,115,98,3665
"17031809600",1489,103,975,419,310,29,510,0,3835
"17031809700",2476,110,875,25,406,79,1256,42,5269
"17031809800",1986,135,195,118,244,19,265,25,2987
"17031809900",2463,108,81,9,271,77,87,0,3096
"17031810000",3417,432,154,73,677,172,115,0,5040
"17031810100",3225,340,534,146,506,19,517,233,5520
"17031810200",2052,289,2447,537,565,30,321,159,6400
"17031810301",1921,125,864,137,442,23,656,85,4253
"17031810302",2023,49,629,73,383,17,139,0,3313
"17031810400",4874,357,0,1,138,0,473,10,5853
"17031810501",4209,504,11,6,243,0,481,31,5485
"17031810502",3739,585,11,0,447,0,244,132,5158
"17031810600",3741,551,26,9,359,31,608,37,5362
"17031810701",3524,542,20,0,856,61,1373,216,6592
"17031810702",3123,172,103,0,294,78,742,95,4607
"17031810800",4169,308,76,16,946,0,1173,20,6708
"17031810900",4444,233,172,0,1153,246,1446,202,7896
"17031811000",3455,296,111,37,282,0,617,0,4798
"17031811100",4734,800,31,6,511,60,1049,51,7242
"17031811200",3818,601,26,0,1025,183,1560,295,7508
"17031811301",2931,114,195,55,1598,282,2560,311,8046
"17031811302",1372,245,297,90,1163,371,1857,547,5942
"17031811401",3933,332,25,55,679,137,1955,357,7473
"17031811402",3059,191,10,0,891,288,1558,352,6349
"17031811500",4324,383,45,0,1150,81,2100,231,8314
"17031811600",3904,479,29,16,1272,282,1145,479,7606
"17031811701",2325,388,32,0,825,211,1974,572,6327
"17031811702",2751,314,58,23,1362,137,1970,190,6805
"17031811800",3702,221,38,6,1003,314,2580,416,8280
"17031811900",4080,214,391,13,306,66,101,23,5194
"17031812000",4276,142,118,0,718,0,342,0,5596
"17031812100",2244,11,1052,407,504,133,272,76,4699
"17031812200",3041,42,423,125,363,17,151,9,4171
"17031812301",2003,228,571,25,586,104,474,55,4046
"17031812302",1973,122,347,20,192,42,153,26,2875
"17031812400",2827,26,296,45,340,0,94,0,3628
"17031812500",1831,227,1053,220,358,19,313,72,4093
"17031812600",1794,175,690,140,456,140,186,84,3665
"17031812700",2121,135,468,31,307,86,159,69,3376
"17031812801",1533,262,545,132,279,18,129,11,2909
"17031812802",1925,87,230,51,244,169,327,75,3108
"17031812900",3510,269,486,179,541,15,193,19,5212
"17031813000",2246,157,618,152,213,29,220,0,3635
"17031813100",2367,142,1660,124,451,55,329,60,5188
"17031813200",3231,147,568,48,551,0,151,0,4696
"17031813301",1087,230,112,151,1446,385,2347,602,6360
"17031813302",1327,306,5,171,1406,522,2599,824,7160
"17031813400",2342,604,242,322,3238,1089,5159,1618,14614
"17031813500",3199,771,164,95,3516,457,5950,1055,15207
"17031813600",1174,583,78,0,2413,947,3391,1507,10093
"17031813701",810,369,94,80,1688,406,2405,680,6532
"17031813702",1025,312,290,206,1772,385,2620,670,7280
"17031813801",1200,153,46,0,1348,360,2455,496,6058
"17031813802",1999,382,100,9,2136,596,3879,864,9965
"17031813900",1982,840,57,196,2705,614,4219,1562,12175
"17031814000",2637,282,65,138,1625,375,3561,597,9280
"17031814100",1309,579,126,0,1844,448,3019,1013,8338
"17031814200",1914,676,77,76,2847,1199,4400,1760,12949
"17031814300",1041,503,56,130,2242,636,3060,1180,8848
"17031814400",3505,849,55,1,2651,487,4827,1142,13517
"17031814500",2230,341,87,1,1929,113,3703,382,8786
"17031814600",2732,449,492,111,1320,246,2863,495,8708
"17031814700",3538,472,76,116,1633,385,3470,650,10340
"17031814800",4507,161,300,121,444,283,2870,319,9005
"17031814900",3253,1034,1072,185,911,256,2413,1083,10207
"17031815000",2138,426,419,231,869,211,2297,454,7045
"17031815100",2603,186,201,126,830,298,2290,431,6965
"17031815200",3560,578,168,282,1544,245,3489,484,10350
"17031815300",2290,275,96,0,932,252,1840,335,6020
"17031815400",3977,392,104,0,802,329,1995,358,7957
"17031815500",5212,423,14,0,1777,697,4371,1013,13507
"17031815600",4044,494,76,36,355,57,1363,207,6632
"17031815701",3589,71,32,0,180,0,388,31,4291
"17031815702",4368,285,76,0,344,0,884,143,6100
"17031815800",1331,32,27,0,49,0,93,6,1538
"17031815900",2246,141,1336,134,524,210,245,15,4851
"17031816000",1932,124,1083,58,175,7,266,8,3653
"17031816100",2627,280,1732,244,1079,82,879,236,7159
"17031816200",2214,119,214,197,499,211,942,284,4680
"17031816300",2530,335,90,21,2117,258,3445,396,9192
"17031816401",2445,234,10,9,1970,387,3768,572,9395
"17031816402",1490,496,142,117,2164,224,3338,515,8486
"17031816500",1869,451,77,54,1758,357,3076,716,8358
"17031816600",1717,420,0,25,1962,646,3377,1000,9147
"17031816700",1361,89,58,56,995,273,1957,363,5152
"17031816800",2264,104,1562,64,1186,153,1404,118,6855
"17031816900",895,147,3541,279,631,390,1293,352,7528
"17031817000",635,122,3381,406,312,123,750,250,5979
"17031817101",215,62,3527,614,187,67,161,65,4898
"17031817102",194,0,2685,200,366,23,393,23,3884
"17031817200",119,1,2920,860,246,341,297,318,5102
"17031817300",305,10,1085,633,201,143,434,130,2941
"17031817400",1477,168,862,306,1423,24,2294,179,6733
"17031817500",405,50,2248,684,259,233,491,235,4605
"17031817600",346,21,2444,801,246,1,382,1,4242
"17031817700",115,193,4179,567,75,72,186,275,5662
"17031817900",1132,104,3402,481,182,0,288,139,5728
"17031818000",2026,76,1736,216,282,94,442,94,4966
"17031818100",1602,92,334,2,380,7,303,18,2738
"17031818200",2664,357,1094,74,309,56,706,259,5519
"17031818300",1683,219,2240,384,1149,458,1620,568,8321
"17031818401",1656,101,806,126,673,0,777,0,4139
"17031818402",2061,67,381,67,498,11,646,0,3731
"17031818500",4262,258,381,1,537,1,575,20,6035
"17031818600",4004,274,231,134,99,31,624,67,5464
"17031818700",2996,277,106,1,122,73,372,130,4077
"17031818800",4716,696,140,8,54,16,767,94,6491
"17031818900",4111,356,69,0,78,9,581,112,5316
"17031819000",4201,114,27,18,235,0,334,0,4929
"17031819100",3249,251,139,33,564,76,1844,157,6313
"17031819200",4641,968,218,5,492,44,2318,559,9245
"17031819300",2417,229,138,0,205,29,323,45,3386
"17031819400",3962,412,32,15,770,16,1182,123,6512
"17031819500",2056,180,312,239,119,0,333,44,3283
"17031819600",3432,71,169,32,108,0,209,13,4034
"17031819700",5549,266,0,0,115,55,47,0,6032
"17031819801",5275,62,9,0,59,0,239,0,5644
"17031819802",2505,10,5,0,117,0,98,0,2735
"17031819900",3284,89,0,0,43,0,139,0,3555
"17031820000",1589,116,13,0,278,12,116,63,2187
"17031820101",6559,179,134,0,307,13,32,31,7255
"17031820103",3294,309,0,1,118,34,1015,20,4791
"17031820104",3074,531,135,213,168,0,431,120,4672
"17031820201",6592,667,196,10,622,0,391,148,8626
"17031820202",2839,272,27,0,361,98,1074,176,4847
"17031820300",3512,738,125,3,684,93,2518,547,8220
"17031820400",3405,738,616,261,927,204,3661,870,10682
"17031820501",4825,953,24,1,438,19,1180,95,7535
"17031820502",3476,591,79,0,485,0,625,0,5256
"17031820603",3889,341,166,309,506,66,1057,132,6466
"17031820604",2883,622,178,2,349,96,436,86,4652
"17031820605",1411,359,1635,602,117,26,374,165,4689
"17031820606",3125,268,39,11,211,94,185,72,4005
"17031820700",4708,287,9,25,1369,345,3006,227,9976
"17031820800",2850,98,43,128,947,115,1883,187,6251
"17031820901",3791,605,109,16,941,0,1572,45,7079
"17031820902",3198,216,24,116,1004,216,1769,92,6635
"17031821001",4006,557,30,47,596,51,992,23,6302
"17031821002",4192,841,42,16,466,39,1242,78,6916
"17031821101",3633,332,1,12,450,30,968,85,5511
"17031821102",2878,581,21,12,609,90,1054,255,5500
"17031821200",1561,403,2234,527,1256,259,1948,531,8719
"17031821300",2134,491,937,607,1319,0,2392,354,8234
"17031821401",181,218,2586,422,12,13,63,230,3725
"17031821402",206,35,2947,530,0,0,34,9,3761
"17031821500",63,0,1282,654,10,10,45,4,2068
"17031821600",2174,238,1526,118,289,96,516,193,5150
"17031821700",3951,342,411,20,71,44,261,53,5153
"17031821800",4089,179,907,15,162,76,683,111,6222
"17031821900",3774,250,539,228,178,0,363,84,5416
"17031822000",3966,184,0,0,115,51,785,59,5160
"17031822101",3610,294,35,68,383,23,621,142,5176
"17031822102",3137,259,358,73,654,99,1354,138,6072
"17031822200",2995,334,25,0,399,33,584,139,4509
"17031822301",3488,149,120,10,310,42,541,28,4688
"17031822302",2692,389,312,26,598,197,603,91,4908
"17031822400",4194,2032,72,8,150,117,761,118,7452
"17031822500",3843,101,52,1,317,19,548,13,4894
"17031822601",3768,450,77,8,205,46,490,132,5176
"17031822602",5555,666,361,47,557,72,560,60,7878
"17031822701",3248,427,374,0,78,21,870,45,5063
"17031822702",2316,232,139,122,356,20,367,12,3564
"17031822801",2725,94,98,0,300,256,658,0,4131
"17031822802",3244,89,182,11,35,1,542,42,4146
"17031822900",1527,254,77,0,98,0,284,167,2407
"17031823001",3481,568,468,259,692,115,874,103,6560
"17031823002",4732,614,190,4,479,24,939,26,7008
"17031823101",3602,425,0,26,227,115,359,134,4888
"17031823102",3081,583,0,0,10,0,63,88,3825
"17031823200",3815,345,208,10,251,20,358,31,5038
"17031823302",2602,670,1772,79,1111,0,1601,259,8094
"17031823303",3240,398,216,77,642,33,880,33,5519
"17031823304",3735,886,799,5,666,5,1163,415,7674
"17031823400",1846,832,833,164,1159,230,2031,778,7873
"17031823500",3039,310,409,69,623,400,1866,554,7270
"17031823602",5329,222,23,0,123,107,195,94,6093
"17031823603",189,93,800,297,469,491,611,552,3502
"17031823604",3177,176,110,0,109,15,16,7,3610
"17031823605",3454,188,58,57,75,38,253,0,4123
"17031823702",4879,709,581,185,429,105,601,41,7530
"17031823703",4550,1645,34,21,1042,122,458,522,8394
"17031823704",3362,279,33,8,420,83,552,20,4757
"17031823705",3276,979,77,114,243,80,530,166,5465
"17031823801",4672,399,0,13,310,0,124,17,5535
"17031823803",5603,648,36,24,430,123,382,199,7445
"17031823805",2421,370,42,0,65,0,150,0,3048
"17031823806",2829,312,188,56,173,15,247,112,3932
"17031823901",3234,34,88,1,367,0,126,0,3850
"17031823903",4257,50,119,0,112,0,441,0,4979
"17031823904",3931,68,11,0,127,0,228,0,4365
"17031824003",5701,100,0,0,244,0,325,1,6371
"17031824004",4645,340,88,41,210,12,286,31,5653
"17031824005",4706,212,100,0,504,35,471,35,6063
"17031824006",3906,138,0,0,82,17,359,18,4520
"17031824105",5222,354,62,0,730,2,211,79,6660
"17031824106",5731,254,248,0,909,0,365,118,7625
"17031824107",5605,367,325,4,303,0,646,0,7250
"17031824108",5555,514,351,131,994,122,622,14,8303
"17031824113",6169,359,59,0,579,0,713,189,8068
"17031824114",4268,247,101,0,325,0,235,115,5291
"17031824115",2986,94,0,0,126,145,168,73,3592
"17031824116",3845,351,19,0,542,117,540,129,5543
"17031824117",8561,229,180,1,912,0,567,69,10519
"17031824119",5216,233,75,0,476,0,233,0,6233
"17031824120",7100,576,223,0,529,14,222,0,8664
"17031824121",2886,135,95,0,159,22,69,9,3375
"17031824122",4839,631,141,0,464,0,319,50,6444
"17031824123",7270,308,344,20,610,0,1143,93,9788
"17031824300",127,33,2958,1312,10,167,94,174,4875
"17031824400",934,205,711,249,96,13,273,41,2522
"17031824503",5817,266,186,0,249,0,310,0,6828
"17031824505",5895,407,354,32,431,23,816,94,8052
"17031824506",6655,200,153,21,826,0,400,0,8255
"17031824507",3343,296,53,41,460,214,415,217,5039
"17031824601",4285,115,177,2,181,11,690,12,5473
"17031824602",5712,341,209,14,321,241,884,223,7945
"17031824701",2989,22,187,139,602,10,895,0,4844
"17031824702",3425,440,283,339,673,400,1277,232,7069
"17031824800",3253,747,1453,631,1459,160,3259,596,11558
"17031824900",916,34,1527,416,134,97,343,82,3549
"17031825000",3754,234,188,243,484,3,486,50,5442
"17031825200",1277,107,85,30,336,13,363,6,2217
"17031825302",4656,354,190,77,330,1,931,1,6540
"17031825303",2802,522,82,0,427,215,425,251,4724
"17031825304",3341,109,197,0,165,84,234,64,4194
"17031825400",4288,396,185,39,471,16,610,16,6021
"17031825501",941,15,3508,977,133,86,395,86,6141
"17031825503",825,68,4706,1011,229,372,296,278,7785
"17031825504",246,6,3086,340,27,48,26,0,3779
"17031825505",682,0,3374,1111,23,0,89,0,5279
"17031825600",775,217,3099,1290,41,161,412,235,6230
"17031825700",890,299,1786,673,178,53,595,275,4749
"17031825801",195,74,2142,1163,39,92,35,0,3740
"17031825802",665,202,3590,454,323,0,484,199,5917
"17031825803",748,98,2847,843,393,71,602,140,5742
"17031825900",1136,122,1198,853,195,0,921,24,4449
"17031826000",861,542,1265,726,72,0,490,552,4508
"17031826100",1422,686,4148,409,259,205,623,682,8434
"17031826201",364,114,2492,497,44,0,55,35,3601
"17031826202",1500,133,2955,970,419,0,698,35,6710
"17031826301",349,50,3225,398,79,12,313,31,4457
"17031826303",205,1,3208,724,104,18,12,7,4279
"17031826304",100,0,1979,950,62,0,120,14,3225
"17031826401",94,165,2995,727,159,0,114,162,4416
"17031826402",501,16,3659,742,207,8,348,0,5481
"17031826500",327,41,3893,2055,72,68,84,27,6567
"17031826600",303,11,4151,1384,135,42,102,11,6139
"17031826700",205,18,3631,1222,108,20,18,0,5222
"17031826800",779,963,1521,339,822,331,1225,1046,7026
"17031826901",0,15,811,565,88,31,70,45,1625
"17031826902",8,3,784,279,9,7,17,2,1109
"17031827000",23,119,2454,905,50,184,36,303,4074
"17031827100",53,22,1336,701,390,90,27,27,2646
"17031827200",876,320,2092,844,80,118,628,386,5344
"17031827300",267,5,1704,1188,66,65,141,51,3487
"17031827400",1,0,2584,1625,67,83,67,83,4510
"17031827500",1061,415,1870,896,532,594,1364,897,7629
"17031827600",39,7,1998,1458,20,0,6,7,3535
"17031827700",445,66,1292,919,185,0,212,0,3119
"17031827801",1435,129,2280,417,174,0,392,0,4827
"17031827802",492,2,2671,328,109,0,41,0,3643
"17031827804",487,19,2384,147,52,0,20,0,3109
"17031827805",543,18,2360,153,0,0,19,6,3099
"17031827901",262,15,1865,104,37,0,63,0,2346
"17031827902",1850,374,1668,243,282,11,744,180,5352
"17031828000",2649,144,1115,541,664,51,981,97,6242
"17031828100",3340,213,680,60,178,269,365,308,5413
"17031828201",1857,207,1645,256,240,16,247,105,4573
"17031828202",2282,151,1427,389,257,52,293,67,4918
"17031828300",2242,328,690,142,306,5,462,8,4183
"17031828401",2359,98,730,162,273,59,375,12,4068
"17031828402",1731,77,1226,359,412,31,552,49,4437
"17031828503",1288,157,2706,484,86,21,338,26,5106
"17031828504",1496,246,2250,1351,340,171,487,138,6479
"17031828505",3190,295,2059,469,350,88,727,31,7209
"17031828506",2508,951,4367,1096,101,218,454,541,10236
"17031828601",3062,263,553,0,165,15,198,135,4391
"17031828602",1895,55,1851,182,453,87,105,68,4696
"17031828701",1333,143,1530,271,316,0,314,0,3907
"17031828702",903,112,3333,558,122,52,266,99,5445
"17031828801",2276,341,1808,51,433,72,521,289,5791
"17031828802",2092,398,783,104,85,95,418,368,4343
"17031828900",654,380,864,592,753,242,1007,473,4965
"17031829000",0,10,536,923,0,11,0,13,1493
"17031829100",1111,660,293,191,766,749,1518,1168,6456
"17031829200",2905,548,1059,671,740,220,2394,438,8975
"17031829301",1525,68,1489,263,267,74,315,74,4075
"17031829302",537,185,1593,683,332,428,579,578,4915
"17031829401",21,0,679,728,74,42,55,50,1649
"17031829402",1011,32,1522,668,107,9,143,3,3495
"17031829500",1909,416,522,199,830,159,1033,431,5499
"17031829600",2219,368,123,0,288,27,488,51,3564
"17031829700",812,4,1760,1390,166,36,75,0,4243
"17031829800",3719,123,2144,91,466,0,258,0,6801
"17031829901",2918,146,4637,691,651,93,734,125,9995
"17031829902",801,17,5102,392,65,0,140,0,6517
"17031830001",1774,300,101,0,30,0,45,156,2406
"17031830003",520,60,6075,997,136,164,68,160,8180
"17031830004",790,24,5509,576,100,0,150,0,7149
"17031830005",1001,33,2879,115,156,0,30,10,4224
"17031830006",742,58,1207,132,107,17,127,0,2390
"17031830007",816,42,2240,781,389,32,259,33,4592
"17031830008",554,0,3598,233,159,10,93,10,4657
"17031830100",564,50,1855,338,377,104,421,32,3741
"17031830201",1029,16,3737,878,307,0,20,0,5987
"17031830202",1238,145,1749,477,80,30,80,11,3810
"17031830300",1160,150,2276,1021,122,0,224,16,4969
"17031830400",1310,216,1761,737,189,73,212,104,4602
"17031830500",2273,988,0,15,985,11,3216,977,8465
"17031830600",2243,640,517,171,883,359,1471,764,7048
"17031830700",1434,479,619,501,242,239,366,132,4012
"17031830800",1779,86,139,84,412,0,214,0,2714
"17031830900",2217,222,33,43,326,27,995,150,4013
"17031831000",1909,8,70,0,339,0,160,0,2486
"17031831100",4692,1173,262,1,1309,159,3303,944,11843
"17031831200",1709,634,41,115,1914,604,3478,1132,9627
"17031831300",200,83,320,102,351,150,546,233,1985
"17031831400",254,22,1294,580,279,89,324,84,2926
"17031831500",2151,257,155,57,965,7,1754,139,5485
"17031831600",3161,580,372,60,2392,286,3696,707,11254
"17031831700",1158,100,80,64,639,266,972,300,3579
"17031831800",2825,198,373,12,1580,709,1349,455,7501
"17031831900",2162,116,0,1,302,38,83,29,2731
"17031832000",1656,298,18,44,94,71,201,113,2495
"17031832100",1894,319,414,266,313,46,145,52,3449
"17031832200",2487,177,75,18,368,48,549,0,3722
"17031832300",1477,133,53,1,277,34,219,64,2258
"17031832400",2233,580,86,0,448,40,1026,510,4923
"17031832500",2291,568,64,136,117,122,124,231,3653
"17031832600",3383,373,73,23,239,9,227,22,4349
"17031832900",1014,649,45,0,361,278,108,232,2687
"17031833000",2020,156,127,140,301,24,63,0,2831
"17031833100",4745,227,292,580,1080,195,429,41,7589
"17031833300",1063,433,89,129,324,404,217,135,2794
"17031833900",596,166,430,625,139,210,722,400,3288
"17031834000",47,0,2752,758,13,0,47,0,3617
"17031834200",83,14,2591,1594,0,16,103,0,4401
"17031834300",88,2,5024,1147,74,0,43,1,6379
"17031834400",129,16,2826,1035,191,0,30,24,4251
"17031834500",43,11,703,700,100,0,62,11,1630
"17031834600",0,78,1583,1314,25,10,38,0,3048
"17031834700",0,95,872,925,18,128,8,109,2155
"17031834800",0,3,989,822,5,11,0,0,1830
"17031834900",0,32,1131,1080,0,49,0,18,2310
"17031835000",418,113,2039,1684,937,479,1202,594,7466
"17031835100",2222,373,545,191,1626,598,3774,908,10237
"17031835200",1061,164,0,6,532,108,981,127,2979
"17031835500",24,54,899,462,148,6,139,47,1779
"17031835600",22,0,513,405,0,0,5,0,945
"17031835700",0,0,0,222,0,26,0,0,248
"17031835800",33,9,886,493,33,0,32,0,1486
"17031835900",21,2,1826,1532,45,163,41,0,3630
"17031836000",33,0,1643,822,82,76,6,48,2710
"17031836100",11,0,1154,610,0,5,133,0,1913
"17031836200",125,30,11,0,65,17,0,0,248
"17031836300",358,96,852,71,118,67,9,31,1602
"17031836400",146,0,2062,825,148,0,62,8,3251
"17031836500",24,52,806,766,0,0,0,52,1700
"17031836600",672,54,436,288,794,121,1186,148,3699
"17031836700",67,183,1327,624,261,110,363,267,3202
"17031836800",46,0,925,1210,31,36,41,36,2325
"17031836900",73,11,907,500,62,0,97,11,1661
"17031837000",141,5,1182,1072,51,5,100,14,2570
"17031837100",288,41,976,467,154,0,154,4,2084
"17031837300",34,5,1014,726,102,0,69,17,1967
"17031837400",143,55,1096,729,0,11,9,6,2049
"17031837800",425,25,1418,943,329,41,235,46,3462
"17031838000",501,71,598,1350,296,45,192,20,3073
"17031838100",471,53,583,353,298,79,70,29,1936
"17031838200",445,207,71,80,90,74,230,17,1214
"17031838300",493,73,360,351,88,37,188,37,1627
"17031838600",0,3,599,605,0,0,0,0,1207
"17031838700",206,8,2113,2404,133,0,206,96,5166
"17031838800",975,330,721,940,150,116,1000,388,4620
"17031839000",4099,605,790,264,1374,381,98,180,7791
"17031839100",2353,260,361,136,640,321,251,26,4348
"17031839200",216,57,1254,370,224,66,58,0,2245
"17031839500",149,16,732,214,38,69,26,0,1244
"17031839600",74,38,1149,374,29,7,5,5,1681
"17031839700",1585,663,109,36,1579,822,1591,832,7217
"17031839800",1424,159,26,0,873,171,634,88,3375
"17031839900",2424,469,37,0,681,196,779,79,4665
"17031840000",1332,61,15,0,912,330,333,62,3045
"17031840100",766,125,0,0,1165,280,290,18,2644
"17031840200",672,259,12,2,1363,260,580,115,3263
"17031840300",1517,368,28,80,1581,573,1858,690,6695
"17031840400",1083,381,0,141,1111,556,784,512,4568
"17031840700",1397,1532,49,79,688,276,1859,1751,7631
"17031840800",1937,774,1,9,427,271,2318,1017,6754
"17031841000",113,3,240,109,195,23,0,0,683
"17031841100",257,100,158,144,4464,2498,37,0,7658
"17031841200",2436,464,51,234,1379,1121,3487,1438,10610
"17031841300",1526,557,22,139,1263,714,2372,1213,7806
"17031841400",59,40,543,603,60,4,63,77,1449
"17031841500",29,22,1115,1359,31,116,25,118,2815
"17031841600",6,0,255,556,0,0,0,0,817
"17031841700",100,365,625,311,146,66,200,431,2244
"17031841800",0,7,1699,766,159,11,130,7,2779
"17031841900",1865,282,294,365,753,46,472,48,4125
"17031842000",102,53,469,34,79,59,34,5,835
"17031842100",508,422,2787,1185,845,722,1446,1124,9039
"17031842200",1381,75,207,290,360,31,231,59,2634
"17031842300",2341,415,317,116,301,9,53,176,3728
"17031842400",0,0,2605,769,0,0,0,0,3374
"17031842500",1,1,604,1765,4,0,4,0,2379
"17031842600",2737,1035,146,1,905,164,1349,444,6781
"17031842800",2649,1262,15,1,2462,1158,4421,2301,14269
"17031842900",147,20,910,851,217,101,251,86,2583
"17031843000",0,7,1524,1546,53,0,60,7,3197
"17031843100",78,20,1374,534,101,40,96,0,2243
"17031843200",1033,310,37,7,885,453,1647,690,5062
"17031843300",307,231,377,525,211,6,482,226,2365
"17031843400",6,36,1043,265,19,91,5,42,1507
"17031843500",466,244,0,0,102,171,558,415,1956
"17031843600",61,0,1758,732,37,21,17,35,2661
"17031843700",1865,189,21,0,192,12,361,49,2689
"17031843800",540,124,523,398,249,11,372,41,2258
"17031843900",90,0,2417,873,139,70,161,47,3797
"17031980000",0,0,0,0,0,0,0,0,0
"17031980100",0,0,0,0,0,0,0,0,0
"17031990000",0,0,0,0,0,0,0,0,0
"17033880100",2573,218,0,0,108,0,4,0,2903
"17033880200",2960,284,0,11,176,0,8,0,3439
"17033880300",2877,491,3,0,108,3,21,7,3510
"17033880400",2037,772,6,28,140,12,29,133,3157
"17033880500",2194,323,51,0,24,14,0,0,2606
"17033880600",2556,364,14,0,67,3,21,0,3025
"17035972400",2498,539,0,0,17,0,0,0,3054
"17035972500",2791,530,4,0,19,7,39,4,3394
"17035972600",3794,395,0,0,48,121,10,26,4394
"17037000100",5929,440,0,0,359,97,411,42,7278
"17037000200",4314,299,7,0,162,8,195,63,5048
"17037000300",2251,215,21,16,56,4,38,12,2613
"17037000400",7227,329,64,2,508,339,384,339,9192
"17037000500",3000,596,32,0,266,161,274,142,4471
"17037000600",4238,406,95,37,413,132,328,166,5815
"17037000700",3467,201,152,25,288,142,224,134,4633
"17037000800",4371,1133,421,23,807,139,998,343,8235
"17037000900",3741,783,303,61,318,289,359,33,5887
"17037001001",2029,1332,604,1157,678,503,367,424,7094
"17037001002",1350,2259,705,704,234,388,165,354,6159
"17037001300",3427,806,29,16,214,699,96,613,5900
"17037001400",4978,549,280,213,277,106,588,145,7136
"17037001500",2879,334,130,0,131,303,284,357,4418
"17037001600",3421,386,40,21,383,106,453,129,4939
"17037001700",2885,357,37,0,107,0,183,0,3569
"17037001800",3243,343,9,110,101,18,107,17,3948
"17037001900",2126,156,15,37,95,47,177,7,2660
"17037002000",4198,395,0,0,133,0,456,0,5182
"17037002100",1723,274,0,12,268,233,342,334,3186
"17037002200",141,566,0,1,82,188,131,135,1244
"17039971400",2353,260,0,0,17,27,0,0,2657
"17039971500",2496,131,0,0,46,15,9,2,2699
"17039971600",3500,306,0,0,54,11,13,35,3919
"17039971700",2793,486,11,0,25,48,96,47,3506
"17039971800",2706,655,0,13,81,90,102,35,3682
"17041952000",1748,266,14,3,24,29,17,9,2110
"17041952100",3505,486,0,0,79,1,97,1,4169
"17041952200",3566,476,26,0,205,51,171,86,4581
"17041952300",5233,432,4,0,26,0,45,68,5808
"17041952400",2791,390,3,6,214,53,773,66,4296
"17043840000",2026,216,59,0,644,53,1705,168,4871
"17043840101",4466,511,35,32,429,294,1740,490,7997
"17043840102",3811,262,0,0,411,113,720,133,5450
"17043840103",5102,488,59,0,537,0,687,289,7162
"17043840104",4611,1126,82,92,280,125,2564,1010,9890
"17043840201",4592,139,6,1,519,115,362,115,5849
"17043840202",4343,256,0,0,725,23,684,0,6031
"17043840303",3017,591,237,0,219,123,949,518,5654
"17043840304",3269,215,74,1,428,0,503,73,4563
"17043840600",3867,167,29,0,510,0,341,30,4944
"17043840703",3176,220,199,57,286,53,1418,11,5420
"17043840704",2257,591,30,0,223,33,684,468,4286
"17043840705",2473,45,127,0,848,0,604,10,4107
"17043840706",2190,162,333,0,762,15,341,0,3803
"17043840801",1578,293,29,145,366,5,1191,177,3784
"17043840802",3439,764,108,68,969,413,1747,1020,8528
"17043840901",2613,244,45,0,521,23,379,8,3833
"17043840904",1826,269,101,324,1432,114,1163,208,5437
"17043840906",2164,366,291,114,145,0,650,288,4018
"17043840907",2334,250,176,559,1120,79,543,218,5279
"17043840908",2844,562,122,20,626,238,906,391,5709
"17043840910",3745,528,397,24,592,34,1802,464,7586
"17043840911",1676,104,88,0,1096,214,586,178,3942
"17043841002",2545,80,34,24,97,0,58,0,2838
"17043841003",2266,188,337,0,417,0,231,20,3459
"17043841004",3020,50,289,20,133,11,579,0,4102
"17043841102",4031,278,407,0,1090,5,694,195,6700
"17043841103",3161,74,153,238,390,30,651,40,4737
"17043841104",3735,147,64,0,429,0,362,0,4737
"17043841108",2507,92,399,273,1044,207,1309,160,5991
"17043841109",3082,131,348,3,513,218,673,0,4968
"17043841110",3154,93,27,0,115,0,378,0,3767
"17043841111",3117,104,8,13,282,154,259,0,3937
"17043841112",2090,191,52,0,739,2,345,11,3430
"17043841113",2829,252,0,64,898,80,458,7,4588
"17043841114",2631,94,108,10,1024,6,152,10,4035
"17043841204",3125,374,291,145,2343,158,1365,331,8132
"17043841205",3534,414,32,0,889,0,737,246,5852
"17043841206",4497,428,0,0,621,187,541,395,6669
"17043841207",2427,132,46,16,634,0,1420,112,4787
"17043841208",2830,393,233,191,1258,189,773,291,6158
"17043841209",2529,45,23,305,986,0,196,0,4084
"17043841210",2169,385,174,77,1015,131,317,213,4481
"17043841307",5194,120,121,0,774,0,472,10,6691
"17043841308",3760,85,65,0,699,8,449,9,5075
"17043841310",3122,57,130,0,530,0,56,0,3895
"17043841312",2328,487,29,0,1072,76,1483,521,5996
"17043841313",2281,99,6,0,285,12,396,0,3079
"17043841314",5202,138,29,48,686,31,491,8,6633
"17043841315",2388,58,294,0,297,229,749,0,4015
"17043841316",3237,38,0,0,245,113,219,0,3852
"17043841318",2172,119,37,0,511,22,551,22,3434
"17043841320",1460,285,0,96,805,85,573,180,3484
"17043841321",2043,9,74,0,390,89,244,0,2849
"17043841322",2557,40,303,37,1715,54,573,0,5279
"17043841323",2203,46,32,0,574,193,534,0,3582
"17043841324",2099,23,25,0,682,24,178,0,3031
"17043841325",4446,51,187,0,1274,24,578,16,6576
"17043841326",2652,52,39,0,528,51,198,11,3531
"17043841327",3691,86,8,0,626,8,228,0,4647
"17043841401",4852,257,38,41,460,42,2321,237,8248
"17043841403",3595,176,93,13,98,0,287,0,4262
"17043841404",2730,217,0,0,162,13,130,0,3252
"17043841501",4871,675,0,256,377,106,3097,668,10050
"17043841503",2880,400,0,0,601,11,2781,362,7035
"17043841504",2269,518,88,90,217,12,1515,332,5041
"17043841603",3289,254,50,21,566,85,1314,152,5731
"17043841604",2925,96,188,83,837,266,1031,130,5556
"17043841605",2601,1087,0,0,273,0,724,967,5652
"17043841606",1711,112,24,0,381,8,25,0,2261
"17043841607",4275,174,73,10,418,8,1364,67,6389
"17043841703",3611,627,884,106,1637,418,1126,414,8823
"17043841704",3439,130,225,254,412,0,114,102,4676
"17043841705",3887,259,84,47,1426,94,1063,209,7069
"17043841706",2026,355,400,181,1073,88,744,270,5137
"17043841801",4042,209,241,0,308,287,122,0,5209
"17043841802",4835,29,112,9,282,0,213,0,5480
"17043841901",2357,34,0,0,132,0,96,0,2619
"17043841902",1661,231,61,40,91,25,47,25,2181
"17043842000",3959,145,170,0,116,12,28,0,4430
"17043842100",5066,273,13,0,391,356,108,0,6207
"17043842200",4296,226,32,20,101,93,299,0,5067
"17043842300",3275,54,52,9,115,25,128,0,3658
"17043842400",3960,484,342,74,668,45,347,64,5984
"17043842500",2497,258,32,28,132,0,45,9,3001
"17043842601",3913,89,74,0,324,0,73,0,4473
"17043842602",4318,32,24,0,127,0,136,0,4637
"17043842603",2413,153,68,0,268,11,119,11,3043
"17043842604",3388,241,104,141,146,123,151,28,4322
"17043842605",3707,91,44,0,183,15,162,0,4202
"17043842702",3444,240,264,122,608,47,267,0,4992
"17043842703",3847,73,34,0,284,0,419,0,4657
"17043842704",4043,273,196,19,403,130,226,69,5359
"17043842706",4093,78,139,0,355,0,377,0,5042
"17043842708",1874,56,256,0,261,3,68,0,2518
"17043842709",2400,53,647,34,386,0,278,0,3798
"17043842710",2610,232,185,10,388,89,124,0,3638
"17043842711",2595,60,0,0,186,0,153,0,2994
"17043842800",4263,86,0,0,292,8,221,0,4870
"17043842900",3995,370,0,23,453,0,75,49,4965
"17043843000",3791,294,102,0,191,17,345,0,4740
"17043843100",2983,238,83,17,549,103,806,164,4943
"17043843200",3773,371,262,157,517,46,1096,171,6393
"17043843301",3467,256,179,0,348,114,1160,290,5814
"17043843302",2807,224,12,0,232,23,246,28,3572
"17043843400",3129,64,58,105,80,0,182,8,3626
"17043843500",4888,221,31,10,375,22,310,27,5884
"17043843601",3202,396,49,3,100,1,220,229,4200
"17043843602",2902,142,23,112,66,0,182,0,3427
"17043843700",4112,205,0,0,193,0,431,4,4945
"17043843800",2740,55,21,41,298,36,328,0,3519
"17043843900",3895,19,0,0,222,0,280,0,4416
"17043844001",3463,106,18,1,201,0,185,0,3974
"17043844002",4565,43,0,0,104,0,67,0,4779
"17043844100",3538,191,8,0,109,15,182,126,4169
"17043844201",4572,313,59,0,586,141,530,11,6212
"17043844202",2334,45,0,0,361,0,246,0,2986
"17043844301",4267,116,410,0,907,115,162,24,6001
"17043844304",1997,210,357,0,1268,63,151,7,4053
"17043844305",2918,194,176,0,373,21,365,59,4106
"17043844306",2121,145,457,33,1184,367,1202,186,5695
"17043844307",2196,153,47,9,678,219,436,95,3833
"17043844401",2737,183,47,0,351,0,115,0,3433
"17043844402",2888,206,221,0,870,139,354,74,4752
"17043844501",2909,250,119,0,379,169,461,19,4306
"17043844502",2164,142,45,0,809,24,56,8,3248
"17043844601",3003,64,74,0,616,45,73,24,3899
"17043844602",2948,109,220,0,641,8,152,0,4078
"17043844701",3303,214,6,0,446,60,293,43,4365
"17043844702",4359,173,19,0,729,53,198,9,5540
"17043844801",3905,298,0,12,135,14,130,11,4505
"17043844802",3060,46,0,0,99,48,81,9,3343
"17043844901",3007,129,39,3,218,9,153,3,3561
"17043844902",3749,270,0,43,244,47,189,0,4542
"17043845000",3995,458,77,46,385,48,154,66,5229
"17043845100",5454,582,30,2,639,0,289,344,7340
"17043845200",4492,88,0,0,359,19,297,19,5274
"17043845300",3015,61,0,0,94,29,73,0,3272
"17043845401",2624,291,109,0,441,71,363,9,3908
"17043845402",2111,170,132,0,444,144,105,107,3213
"17043845502",3465,155,538,41,1154,0,477,0,5830
"17043845505",2777,142,343,0,730,103,256,88,4439
"17043845506",2649,238,324,50,441,425,68,374,4569
"17043845507",3034,52,37,0,325,0,51,0,3499
"17043845508",2767,214,0,0,566,70,110,9,3736
"17043845509",1778,36,296,9,1133,0,125,0,3377
"17043845510",1903,156,272,15,775,90,137,29,3377
"17043845601",3277,115,458,0,416,31,460,50,4807
"17043845602",4265,263,137,40,175,0,40,0,4920
"17043845701",3143,127,177,0,329,22,175,0,3973
"17043845702",4242,46,0,0,336,0,100,0,4724
"17043845703",3423,239,229,90,631,42,289,66,5009
"17043845704",3824,138,77,28,574,0,434,0,5075
"17043845802",2930,298,40,0,440,0,153,0,3861
"17043845803",2438,197,1540,377,1079,207,290,56,6184
"17043845805",2975,126,157,11,365,0,279,0,3913
"17043845807",4932,565,120,18,654,10,275,0,6574
"17043845808",2600,35,20,0,1136,0,390,0,4181
"17043845809",3147,107,46,0,706,0,262,0,4268
"17043845810",2919,192,380,42,604,17,166,57,4377
"17043845811",2984,179,346,31,325,19,214,64,4162
"17043845901",2217,203,130,0,648,0,217,0,3415
"17043845902",2830,112,64,0,440,0,68,0,3514
"17043846002",3697,255,161,0,311,88,506,0,5018
"17043846003",3748,246,12,0,348,26,152,131,4663
"17043846004",2448,139,378,115,318,1,216,99,3714
"17043846102",2602,209,298,145,666,326,463,177,4886
"17043846103",3943,148,154,1,457,36,321,26,5086
"17043846104",2917,313,66,3,1092,89,320,299,5099
"17043846105",2857,70,38,0,364,0,232,56,3617
"17043846106",2599,224,54,0,1008,70,21,214,4190
"17043846201",4620,114,375,85,659,103,235,56,6247
"17043846202",3722,150,297,0,962,207,295,0,5633
"17043846203",3085,52,52,78,820,26,127,0,4240
"17043846205",3043,150,6,1,637,0,361,0,4198
"17043846206",3839,109,11,0,299,84,117,24,4483
"17043846207",4925,95,119,0,544,38,225,51,5997
"17043846208",2858,58,36,0,187,0,186,0,3325
"17043846209",2837,75,20,0,363,63,117,0,3475
"17043846304",4019,207,172,0,1626,180,450,0,6654
"17043846305",4193,79,180,91,940,0,482,0,5965
"17043846307",2693,214,592,180,804,35,566,42,5126
"17043846308",1798,99,682,0,925,0,732,16,4252
"17043846310",3091,188,447,156,688,25,859,85,5539
"17043846311",4232,193,424,0,432,110,633,71,6095
"17043846312",3248,299,247,32,386,111,80,42,4445
"17043846313",3219,102,146,10,1017,45,313,0,4852
"17043846314",2758,86,28,0,614,19,180,33,3718
"17043846315",3938,15,87,0,366,0,184,0,4590
"17043846404",4005,557,375,25,572,111,222,256,6123
"17043846405",2776,45,132,18,870,18,82,0,3941
"17043846408",2410,59,119,0,1581,24,170,0,4363
"17043846409",3116,92,323,0,1006,0,143,26,4706
"17043846410",2735,165,416,3,1635,133,851,126,6064
"17043846411",2381,82,196,128,801,24,517,0,4129
"17043846412",3170,72,300,80,761,9,206,0,4598
"17043846413",3170,99,111,0,187,0,150,7,3724
"17043846504",4499,242,309,240,664,18,886,16,6874
"17043846507",1631,35,253,36,610,77,147,0,2789
"17043846509",2071,233,963,140,1178,15,542,34,5176
"17043846510",1920,73,205,17,592,0,507,46,3360
"17043846511",4736,437,1054,36,860,0,1601,262,8986
"17043846513",1934,24,43,0,777,11,203,0,2992
"17043846514",2775,106,106,0,1260,103,507,0,4857
"17043846515",2724,364,709,179,1403,73,816,79,6347
"17043846517",3685,12,811,0,1468,167,776,0,6919
"17043846518",3027,14,42,12,623,26,361,25,4130
"17043846519",1617,68,301,0,1087,119,261,27,3480
"17043846521",3761,198,169,0,1055,105,272,1,5561
"17043846522",1954,67,129,28,1205,47,247,26,3703
"17043846523",2615,36,96,0,90,0,73,1,2911
"17043846524",2777,176,257,29,1425,56,61,16,4797
"17043846603",3265,709,2,117,596,12,3098,642,8441
"17043846604",3022,110,103,0,265,83,1160,104,4847
"17043846701",3516,431,90,20,331,137,1555,382,6462
"17043846702",3108,466,205,23,498,70,965,345,5680
"17045070100",2177,328,0,24,15,6,12,13,2575
"17045070200",1629,333,0,0,24,11,5,67,2069
"17045070300",2833,1190,0,12,35,0,28,0,4098
"17045070400",4388,826,0,46,55,6,50,6,5377
"17045070500",3454,382,17,0,54,0,7,0,3914
"17047956900",2212,205,19,0,3,2,1,5,2447
"17047957000",1802,225,0,0,32,8,19,0,2086
"17047957100",1691,376,17,0,46,14,0,53,2197
"17049950100",3724,203,0,2,42,9,33,11,4024
"17049950200",4168,344,6,5,135,0,123,0,4781
"17049950300",3496,496,0,1,55,0,27,0,4075
"17049950400",3377,396,6,0,72,8,2,0,3861
"17049950500",4028,273,1,0,141,5,109,11,4568
"17049950600",4454,545,2,2,69,9,124,9,5214
"17049950700",2837,607,0,0,79,31,77,2,3633
"17049950800",3315,525,14,29,52,23,71,9,4038
"17051950500",2355,609,0,0,4,5,9,0,2982
"17051950600",1897,457,0,0,41,6,0,0,2401
"17051950700",3924,380,0,0,18,42,7,0,4371
"17051950800",2955,277,10,3,13,23,19,9,3309
"17051950900",1401,380,6,7,4,6,27,0,1831
"17051951000",2009,188,4,0,8,0,24,0,2233
"17051951100",2479,981,0,0,21,0,9,58,3548
"17053961600",1619,274,0,0,27,1,59,12,1992
"17053961700",1744,297,0,0,7,0,73,9,2130
"17053961800",3663,404,13,21,32,0,88,0,4221
"17053961900",1610,201,16,0,13,2,47,23,1912
"17053962000",3054,293,0,0,59,87,0,0,3493
"17055040100",2315,416,15,0,112,25,44,0,2927
"17055040200",2842,405,0,0,11,6,0,13,3277
"17055040300",2564,595,0,0,0,0,16,0,3175
"17055040400",2977,877,0,18,7,22,43,7,3951
"17055040500",2149,388,0,0,14,20,0,0,2571
"17055040600",2147,612,0,0,44,24,72,125,3024
"17055040700",3168,1182,0,0,9,103,119,0,4581
"17055040800",2856,448,9,8,17,10,9,0,3357
"17055040900",1975,485,2,1,37,149,0,24,2673
"17055041000",1992,778,0,2,24,33,7,24,2860
"17055041100",2820,480,0,0,88,11,0,0,3399
"17055041200",3202,529,0,5,37,0,25,0,3798
"17057952800",2217,324,5,0,54,0,99,49,2748
"17057952900",2433,219,0,2,69,0,23,3,2749
"17057953000",1908,367,3,4,103,9,38,17,2449
"17057953100",2192,169,0,0,68,10,18,8,2465
"17057953200",2420,360,39,0,48,10,30,2,2909
"17057953300",2981,463,0,0,67,0,0,0,3511
"17057953400",1386,469,4,0,9,25,0,3,1896
"17057953500",2165,948,10,11,52,64,0,5,3255
"17057953600",3741,601,36,8,54,0,36,38,4514
"17057953700",2314,254,0,0,41,4,16,0,2629
"17057953800",2260,346,0,3,36,2,90,7,2744
"17057953900",2347,359,8,31,95,41,20,23,2924
"17059972700",1924,383,0,0,98,3,0,0,2408
"17059972800",2437,485,17,4,37,32,13,0,3025
"17061973600",3156,337,0,5,40,6,32,0,3576
"17061973700",1467,345,0,0,35,7,13,20,1887
"17061973800",1529,335,0,0,23,2,43,2,1934
"17061973900",1875,667,0,0,39,0,0,0,2581
"17061974000",3057,337,0,0,15,0,0,0,3409
"17063000102",6995,499,41,0,201,45,809,69,8659
"17063000103",5445,517,258,21,103,0,556,0,6900
"17063000200",5904,261,29,125,197,5,716,29,7266
"17063000300",2709,312,26,0,196,0,671,73,3987
"17063000400",4089,599,0,25,103,14,147,113,5090
"17063000500",2602,153,2,3,127,0,138,12,3037
"17063000600",2558,384,0,0,86,9,152,93,3282
"17063000700",4995,774,9,76,129,51,96,119,6249
"17063000800",4620,336,52,0,199,0,331,20,5558
"17063000900",3285,407,3,0,111,6,157,18,3987
"17065973100",2311,559,28,2,61,0,77,0,3038
"17065973200",1965,498,0,15,7,0,34,0,2519
"17065973300",2486,297,0,0,6,0,5,0,2794
"17067953700",1946,291,0,0,27,7,2,0,2273
"17067953800",2361,201,0,0,40,24,52,0,2678
"17067953900",1632,274,2,1,10,1,11,14,1945
"17067954000",2150,243,11,13,74,22,25,36,2574
"17067954100",2909,299,12,0,19,0,14,16,3269
"17067954200",2121,308,0,0,47,13,50,9,2548
"17067954300",2929,526,1,3,30,11,4,0,3504
"17069970900",1504,543,0,1,27,126,0,30,2231
"17069971000",1563,340,0,8,15,38,13,40,2017
"17071973300",2079,270,2,0,47,24,34,0,2456
"17071973400",1719,98,0,0,22,0,6,0,1845
"17071973500",2342,321,0,4,22,42,30,12,2773
"17073030100",4608,703,4,0,232,101,220,0,5868
"17073030201",4417,242,13,0,61,24,26,0,4783
"17073030202",3381,279,19,0,60,0,39,0,3778
"17073030203",4170,75,32,0,49,7,81,7,4421
"17073030300",6396,382,0,2,168,113,170,42,7273
"17073030400",2103,205,0,0,14,1,15,3,2341
"17073030500",2075,132,4,5,56,26,22,8,2328
"17073030600",2020,232,96,61,444,58,737,103,3751
"17073030800",1978,689,46,142,306,62,296,162,3681
"17073030900",2920,351,10,34,245,26,381,12,3979
"17073031000",2741,588,58,61,40,31,52,39,3610
"17073031100",2260,317,0,5,31,12,10,6,2641
"17073031200",2627,330,45,0,79,3,84,0,3168
"17075950100",2349,341,5,99,62,19,19,20,2914
"17075950200",3421,258,19,0,72,2,34,11,3817
"17075950300",2941,326,38,6,45,0,55,21,3432
"17075950400",2833,718,61,0,23,243,46,215,4139
"17075950500",2944,862,5,73,62,1,62,48,4057
"17075950600",2589,449,16,0,237,82,686,237,4296
"17075950700",2427,187,0,11,29,5,53,21,2733
"17075950800",2066,274,3,4,24,8,116,5,2500
"17075950900",1954,378,0,0,50,53,34,59,2528
"17077010100",2901,455,0,0,22,14,95,14,3501
"17077010200",3121,775,44,14,58,110,63,70,4255
"17077010300",2300,355,4,0,10,35,4,0,2708
"17077010400",4009,432,35,86,32,22,0,0,4616
"17077010600",4742,1165,127,286,48,19,18,0,6405
"17077010700",1495,789,130,282,76,145,21,20,2958
"17077010800",1690,938,461,191,320,9,188,29,3826
"17077010900",659,273,777,529,18,86,24,167,2533
"17077011000",4154,283,490,156,671,182,81,0,6017
"17077011100",492,1159,17,619,148,380,143,216,3174
"17077011200",1359,1283,433,1928,67,252,81,349,5752
"17077011400",968,1949,187,175,347,294,121,57,4098
"17077011600",2942,375,74,66,344,0,14,48,3863
"17077011700",1045,1257,211,172,493,366,102,385,4031
"17079977300",2625,129,4,0,117,11,66,11,2963
"17079977400",2493,310,2,7,7,0,0,0,2819
"17079977500",3637,160,0,0,34,11,21,0,3863
"17081050100",3350,471,0,0,175,7,58,0,4061
"17081050200",2699,351,0,3,30,60,16,0,3159
"17081050300",3754,432,3,4,80,22,68,9,4372
"17081050400",3331,533,0,33,55,0,51,0,4003
"17081050500",2667,640,164,31,134,60,11,2,3709
"17081050600",2708,148,76,3,200,29,38,0,3202
"17081050700",2744,686,129,32,82,29,44,0,3746
"17081050800",3537,547,14,11,80,36,6,9,4240
"17081050900",1288,365,492,148,209,57,125,24,2708
"17081051000",367,186,291,500,30,206,42,22,1644
"17081051100",1384,620,239,37,50,20,12,106,2468
"17083010100",4053,640,0,0,86,0,37,23,4839
"17083010200",3384,148,0,0,0,0,78,0,3610
"17083010300",3075,201,48,0,75,0,4,0,3403
"17083010401",6174,212,0,0,113,0,72,1,6572
"17083010402",1776,199,0,0,56,3,0,0,2034
"17083010500",1263,162,0,13,103,6,41,0,1588
"17085020100",3914,544,1,0,23,7,78,1,4568
"17085020200",4394,261,6,8,171,24,53,0,4917
"17085020300",4070,393,0,0,72,13,293,84,4925
"17085020401",2076,27,20,0,15,0,27,0,2165
"17085020402",2395,354,3,0,27,22,50,7,2858
"17085020500",2972,332,5,0,31,3,20,0,3363
"17087977600",3634,603,18,0,96,0,0,0,4351
"17087977700",2580,301,0,0,30,0,23,0,2934
"17087977800",2630,686,11,17,32,10,12,5,3403
"17087980000",42,0,0,0,0,0,0,0,42
"17089850101",4387,491,39,132,1622,313,2413,688,10085
"17089850103",4919,136,226,42,783,0,557,16,6679
"17089850105",5885,373,50,0,1094,0,618,35,8055
"17089850106",6247,259,52,0,1177,325,937,325,9322
"17089850201",2387,249,34,260,1233,227,2431,378,7199
"17089850202",3202,485,197,153,2087,474,4435,896,11929
"17089850301",3165,606,154,952,1890,434,3632,949,11782
"17089850302",2806,90,196,263,1124,257,1961,228,6925
"17089850400",1948,294,0,0,25,0,198,214,2679
"17089850500",3000,208,237,0,96,162,135,177,4015
"17089850600",6152,160,113,34,832,157,606,10,8064
"17089850701",14118,255,638,134,2908,957,2704,985,22699
"17089850702",13165,341,49,0,829,0,1434,13,15831
"17089850703",2016,227,24,1,27,0,50,27,2372
"17089850800",4678,645,223,0,1070,86,3141,280,10123
"17089851000",4029,424,258,111,1256,163,2108,234,8583
"17089851101",2760,320,144,2,658,171,1475,338,5868
"17089851102",1891,448,188,111,611,345,1008,644,5246
"17089851301",2419,286,150,55,1028,314,2552,451,7255
"17089851302",1363,493,201,171,793,126,1701,552,5400
"17089851400",3211,317,254,136,2336,362,4179,445,11240
"17089851500",606,222,38,0,91,90,200,270,1517
"17089851600",3869,897,306,223,768,290,2141,753,9247
"17089851801",6566,407,47,97,509,0,1082,221,8929
"17089851904",5033,669,369,16,1025,278,2173,825,10388
"17089851905",9157,470,555,0,2178,40,1358,0,13758
"17089851907",5058,299,386,0,1436,0,1490,154,8823
"17089851908",2841,267,351,225,1169,128,1420,163,6564
"17089851909",3151,303,74,8,838,33,1132,189,5728
"17089851910",2618,112,228,101,1956,190,2086,199,7490
"17089852001",3456,195,65,1,202,18,436,18,4391
"17089852002",6085,263,102,0,722,0,574,0,7746
"17089852003",7247,210,0,0,310,9,247,0,8023
"17089852101",6495,114,0,1,770,0,126,0,7506
"17089852102",8131,197,65,0,975,0,505,0,9873
"17089852201",4649,105,0,0,104,0,397,0,5255
"17089852202",5809,362,222,59,1264,55,1300,37,9108
"17089852300",1679,217,0,0,114,0,133,12,2155
"17089852401",8010,350,32,0,192,37,428,71,9120
"17089852402",7760,468,95,0,103,75,337,76,8914
"17089852403",4829,242,15,16,163,0,73,2,5340
"17089852500",5692,352,132,0,316,39,340,76,6947
"17089852601",6725,436,0,0,181,100,375,152,7969
"17089852606",4062,70,0,2,64,0,70,0,4268
"17089852700",6192,388,194,20,587,28,880,84,8373
"17089852803",3718,615,127,109,259,35,138,215,5216
"17089852805",4469,84,78,23,443,162,513,143,5915
"17089852806",6513,73,244,0,340,0,368,0,7538
"17089852807",2357,97,0,0,582,49,85,0,3170
"17089852808",6526,252,72,62,530,107,349,172,8070
"17089852903",3622,183,615,275,1471,57,2041,206,8470
"17089852904",856,73,136,310,683,449,1304,460,4271
"17089852905",1856,251,424,851,1020,350,1667,470,6889
"17089852906",3103,483,392,149,805,228,893,590,6643
"17089852907",2118,572,276,138,2037,534,2717,950,9342
"17089853001",1656,92,223,29,619,10,691,10,3330
"17089853004",2130,140,148,47,195,125,246,45,3076
"17089853005",2835,486,869,117,961,860,1630,845,8603
"17089853006",2065,187,343,8,596,350,1097,239,4885
"17089853007",2064,463,667,358,1680,661,2193,776,8862
"17089853008",2244,515,500,12,1392,111,2272,380,7426
"17089853100",1421,183,146,32,824,335,1327,475,4743
"17089853200",2374,616,623,397,1953,627,2745,745,10080
"17089853300",2876,391,38,1,1191,517,3244,865,9123
"17089853400",2657,542,327,0,4295,1503,6615,1912,17851
"17089853500",1779,640,392,33,2706,1004,4061,1523,12138
"17089853600",2217,592,373,105,3562,1912,5182,2312,16255
"17089853900",4176,710,344,0,773,172,1066,15,7256
"17089854001",3838,209,153,5,306,41,529,85,5166
"17089854002",3002,525,257,182,507,452,846,645,6416
"17089854100",1530,156,110,235,2691,253,3436,373,8784
"17089854200",2057,304,305,129,2103,854,3107,1089,9948
"17089854301",2416,254,282,87,3186,1105,4726,1264,13320
"17089854302",1759,377,286,10,2279,797,3159,1109,9776
"17089854400",6194,950,1240,1001,3048,1836,4447,2319,21035
"17089854501",13731,245,369,20,1007,31,654,0,16057
"17089854503",8817,311,617,0,2187,0,2116,244,14292
"17089854504",6700,171,118,0,754,0,906,13,8662
"17089854600",1310,868,295,244,680,280,1221,866,5764
"17089854700",851,389,238,172,594,245,902,379,3770
"17089854800",7448,88,33,0,540,46,184,0,8339
"17089854900",3321,367,445,303,524,144,841,117,6062
"17091010100",2125,163,2,2,58,7,51,23,2431
"17091010201",1695,96,41,0,22,4,24,0,1882
"17091010202",8484,448,41,4,579,0,603,12,10171
"17091010300",3516,229,4,22,46,8,100,0,3925
"17091010400",4600,227,70,0,71,9,49,1,5027
"17091010500",5267,367,446,52,300,21,360,0,6813
"17091010601",4287,128,669,0,273,0,179,7,5543
"17091010602",3773,1010,294,56,167,270,263,151,5984
"17091010701",3650,166,567,96,101,68,609,54,5311
"17091010702",6009,475,292,4,285,0,365,0,7430
"17091010800",2552,300,450,102,198,143,441,229,4415
"17091010900",3652,481,51,59,228,0,697,4,5172
"17091011000",154,131,1098,597,68,26,15,50,2139
"17091011100",1868,265,9,3,106,0,334,62,2647
"17091011200",1769,138,109,0,106,3,59,9,2193
"17091011300",1843,162,118,9,73,8,116,15,2344
"17091011400",631,135,313,441,164,48,174,27,1933
"17091011500",211,75,960,766,48,56,125,79,2320
"17091011600",11,60,717,789,7,0,0,47,1631
"17091011700",1667,523,187,699,59,43,358,149,3685
"17091011800",2459,219,4,0,14,178,117,122,3113
"17091011900",1262,128,3,1,5,14,63,0,1476
"17091012000",2035,630,94,562,142,126,64,181,3834
"17091012100",2193,221,195,50,101,258,233,316,3567
"17091012200",2384,761,454,139,41,0,303,263,4345
"17091012300",1243,823,1232,1075,299,79,766,374,5891
"17091012400",2336,242,1154,300,564,349,886,480,6311
"17091012500",1377,507,198,115,95,37,107,175,2611
"17091012600",3937,364,44,17,51,18,20,16,4467
"17093890101",13323,219,1968,310,3178,119,2663,306,22086
"17093890102",11696,252,380,279,631,40,837,80,14195
"17093890201",3508,412,167,0,461,51,1014,51,5664
"17093890202",2441,199,128,0,261,64,708,61,3862
"17093890301",5138,192,339,144,482,0,1206,0,7501
"17093890302",5250,341,45,0,126,92,524,0,6378
"17093890400",22232,790,710,0,2783,442,4785,716,32458
"17093890500",9666,1270,501,110,1413,214,3396,255,16825
"17093890600",8328,354,395,6,417,40,409,14,9963
"17093890700",12359,671,1161,157,1244,62,1532,298,17484
"17095000100",2923,145,0,0,71,3,55,0,3197
"17095000200",2470,227,9,4,93,9,59,5,2876
"17095000300",3409,453,207,34,91,42,108,99,4443
"17095000400",3383,468,160,172,165,0,89,0,4437
"17095000500",2798,148,111,125,66,53,169,37,3507
"17095000600",3011,360,26,12,63,13,109,52,3646
"17095000700",1248,320,137,144,139,117,105,70,2280
"17095000800",849,631,64,45,44,46,44,40,1763
"17095000900",818,908,353,163,58,13,81,309,2703
"17095001000",2721,801,221,27,245,128,460,191,4794
"17095001100",1072,638,88,877,0,0,58,17,2750
"17095001200",1577,86,16,0,85,0,25,0,1789
"17095001300",3186,350,9,0,28,0,40,0,3613
"17095001400",1475,190,22,0,67,0,10,0,1764
"17095001500",2875,436,72,0,49,63,69,0,3564
"17095001600",3161,286,4,2,23,33,20,2,3531
"17097860101",4807,410,2148,81,1453,0,2047,88,11034
"17097860103",3071,128,24,13,149,0,197,26,3608
"17097860104",2759,359,129,12,217,0,197,12,3685
"17097860200",1862,177,602,339,311,17,494,184,3986
"17097860301",1550,255,584,387,381,50,1099,302,4608
"17097860302",1286,41,868,382,521,51,952,3,4104
"17097860400",3209,207,1092,243,627,95,1375,8,6856
"17097860500",1365,666,1088,483,832,166,1017,412,6029
"17097860600",5123,530,467,227,820,25,1821,288,9301
"17097860805",1223,120,18,12,100,18,4,21,1516
"17097860806",4490,600,14,0,45,31,556,62,5798
"17097860807",3038,394,0,0,67,0,215,0,3714
"17097860808",2214,264,0,0,76,12,104,8,2678
"17097860809",2968,187,25,0,66,0,73,0,3319
"17097860810",5742,969,17,61,619,0,205,55,7668
"17097860811",3287,251,306,2,345,4,235,10,4440
"17097860903",4281,1040,21,0,592,25,673,0,6632
"17097860904",5109,363,30,0,61,19,537,51,6170
"17097860905",4579,574,35,0,461,28,605,202,6484
"17097860906",7605,518,312,7,976,42,1368,192,11020
"17097861007",3512,73,115,0,451,0,203,34,4388
"17097861008",4597,153,29,10,446,2,512,33,5782
"17097861009",4318,174,54,0,488,51,368,6,5459
"17097861010",4668,369,125,0,522,15,893,59,6651
"17097861011",6413,123,463,0,771,149,1523,0,9442
"17097861012",4907,369,92,0,39,23,293,24,5747
"17097861013",2621,100,24,49,248,0,217,0,3259
"17097861014",2829,284,216,9,411,20,282,192,4243
"17097861105",3726,97,123,97,254,30,400,0,4727
"17097861106",6446,264,126,0,1334,87,787,178,9222
"17097861107",3296,52,107,0,412,0,255,0,4122
"17097861108",5668,160,0,5,422,85,530,2,6872
"17097861201",5735,468,0,137,697,36,3996,209,11278
"17097861202",3452,426,46,40,126,252,1300,552,6194
"17097861301",3381,482,66,158,364,160,1620,325,6556
"17097861303",3214,1240,8,8,605,17,2448,944,8484
"17097861304",2461,669,0,0,193,0,1770,480,5573
"17097861402",6290,875,333,0,1244,108,2193,408,11451
"17097861403",1912,197,63,92,389,156,1436,214,4459
"17097861404",3683,1044,35,146,751,160,2131,895,8845
"17097861504",3576,650,505,0,2999,162,3073,546,11511
"17097861505",2898,0,216,25,694,4,552,0,4389
"17097861506",2988,155,928,249,1063,6,1104,68,6561
"17097861507",1802,228,374,11,593,0,599,28,3635
"17097861508",2331,209,433,36,828,16,523,41,4417
"17097861509",2726,159,509,60,282,59,405,86,4286
"17097861510",3302,324,316,75,855,84,983,285,6224
"17097861603",4941,125,37,0,649,1,193,0,5946
"17097861604",4355,201,314,0,937,98,622,70,6597
"17097861607",3443,306,283,123,553,23,682,164,5577
"17097861608",2607,240,77,10,332,0,451,32,3749
"17097861609",2955,260,240,93,1108,0,466,166,5288
"17097861610",3049,29,183,0,261,0,316,0,3838
"17097861611",3150,31,215,0,645,49,146,0,4236
"17097861701",1661,77,80,46,195,0,586,10,2655
"17097861702",2466,176,345,120,723,115,1297,180,5422
"17097861803",3347,761,935,204,1092,289,2738,742,10108
"17097861804",1809,341,375,224,563,81,1749,339,5481
"17097861901",2703,321,341,1,860,14,1515,276,6031
"17097861902",3114,393,866,400,1189,114,2620,488,9184
"17097862000",2782,212,584,399,1559,78,3417,239,9270
"17097862100",2683,419,589,449,699,40,2372,326,7577
"17097862200",1470,545,391,410,384,187,937,514,4838
"17097862300",475,816,715,509,533,151,705,877,4781
"17097862401",2131,504,135,173,352,142,1894,629,5960
"17097862402",1475,610,289,87,709,163,2063,708,6104
"17097862501",2010,279,136,126,897,55,2655,313,6471
"17097862502",866,894,379,13,215,100,930,815,4212
"17097862603",4206,1061,850,205,1568,322,4105,1197,13514
"17097862604",2307,449,416,117,983,329,2432,638,7671
"17097862605",1225,365,718,1560,548,79,949,184,5628
"17097862700",1284,785,526,205,520,268,1691,1038,6317
"17097862800",368,32,919,400,335,153,575,170,2952
"17097862901",1306,333,655,266,759,302,1912,611,6144
"17097862902",500,157,904,389,223,315,568,378,3434
"17097863003",89,17,0,0,4,0,4,13,127
"17097863004",2433,302,583,79,412,165,576,0,4550
"17097863005",0,0,0,0,0,0,0,0,0
"17097863006",0,0,0,0,0,0,0,0,0
"17097863100",704,419,902,577,316,0,805,326,4049
"17097863201",807,268,1116,763,686,61,1190,283,5174
"17097863202",3969,334,106,0,656,58,320,84,5527
"17097863300",2410,113,15,0,113,0,0,0,2651
"17097863400",3244,250,60,0,11,0,85,0,3650
"17097863500",3515,136,11,0,178,18,90,0,3948
"17097863601",3096,39,77,5,434,0,70,5,3726
"17097863603",2771,33,20,1,597,8,200,1,3631
"17097863604",2558,70,87,16,109,0,144,0,2984
"17097863701",3783,395,9,0,243,8,184,7,4629
"17097863702",2834,55,9,0,714,11,170,0,3793
"17097863801",4294,95,12,0,175,20,246,21,4863
"17097863902",4126,133,38,45,1317,0,446,3,6108
"17097863903",4141,213,19,1,119,0,73,0,4566
"17097863904",4643,11,18,0,1377,15,69,0,6133
"17097864001",5258,617,14,0,531,15,1559,549,8543
"17097864002",4433,877,37,2,860,128,3185,866,10388
"17097864101",8415,526,900,4,1498,24,942,253,12562
"17097864105",4733,105,353,72,971,0,476,151,6861
"17097864106",3835,250,0,0,209,0,1038,172,5504
"17097864107",3841,458,49,0,431,4,774,27,5584
"17097864108",4580,276,0,4,690,127,1826,126,7629
"17097864203",3561,216,26,0,383,211,514,202,5113
"17097864204",3514,604,12,9,219,109,715,1,5183
"17097864205",7836,500,185,0,830,12,920,170,10453
"17097864206",3063,324,24,3,55,84,1104,107,4764
"17097864303",4082,137,57,0,203,0,184,0,4663
"17097864305",3652,151,0,32,213,0,109,66,4223
"17097864306",2205,60,0,0,128,0,80,0,2473
"17097864307",1552,166,0,0,128,0,57,0,1903
"17097864308",3359,387,10,0,228,9,98,221,4312
"17097864402",6125,361,71,0,890,38,371,0,7856
"17097864403",3903,115,205,9,441,5,270,2,4950
"17097864407",5181,89,50,10,554,0,80,0,5964
"17097864408",5039,265,10,0,403,43,796,156,6712
"17097864409",3608,275,42,109,528,0,243,145,4950
"17097864410",4350,156,0,0,593,43,8,79,5229
"17097864411",4554,42,0,0,259,7,73,11,4946
"17097864412",3582,89,36,0,386,75,154,6,4328
"17097864505",4885,269,364,42,1083,208,453,0,7304
"17097864510",3037,279,97,0,1088,75,1520,198,6294
"17097864511",3782,172,12,0,2234,60,627,49,6936
"17097864512",3659,226,0,0,558,66,553,73,5135
"17097864513",4109,55,88,0,948,0,155,20,5375
"17097864514",1804,20,0,0,939,30,116,0,2909
"17097864515",1972,34,4,0,497,26,19,0,2552
"17097864516",3423,74,8,0,832,10,118,1,4466
"17097864517",2853,77,59,0,607,19,57,0,3672
"17097864518",3746,51,8,0,1139,37,119,0,5100
"17097864519",3774,82,32,11,697,210,108,0,4914
"17097864520",3898,39,169,2,1317,51,203,0,5679
"17097864521",1634,38,58,0,567,0,35,8,2340
"17097864522",3979,109,0,0,458,51,76,0,4673
"17097864601",3349,185,64,0,226,1,8,0,3833
"17097864602",3331,90,47,0,359,0,97,0,3924
"17097864700",2488,20,177,1,93,1,113,0,2893
"17097864801",4631,77,6,0,216,40,472,0,5442
"17097864802",2513,77,0,11,148,0,60,1,2810
"17097864901",3801,146,55,1,112,9,61,9,4194
"17097864903",4399,143,0,0,185,42,0,0,4769
"17097864904",1983,73,0,0,318,0,271,0,2645
"17097865000",1214,11,0,0,35,0,10,0,1270
"17097865200",3961,672,263,0,580,101,2172,367,8116
"17097865300",2901,102,70,0,170,8,227,0,3478
"17097865400",3342,438,98,9,187,19,380,308,4781
"17097865501",1880,130,28,90,134,5,254,90,2611
"17097865502",2121,127,50,0,184,18,228,28,2756
"17097865600",3304,120,8,0,92,0,48,30,3602
"17097865700",5252,652,30,0,217,0,122,67,6340
"17097865801",2875,107,0,2,149,32,142,0,3307
"17097865802",2840,16,0,0,64,0,26,0,2946
"17097866000",5131,124,849,13,674,0,956,17,7764
"17097866100",1506,518,431,162,562,363,1696,921,6159
"17097866200",4423,431,54,6,406,11,208,17,5556
"17097990000",0,0,0,0,0,0,0,0,0
"17099961701",6012,282,0,0,88,30,214,0,6626
"17099961702",2579,197,1,2,33,9,125,40,2986
"17099961800",3245,620,0,0,48,0,314,14,4241
"17099961900",3612,397,73,59,109,66,565,167,5048
"17099962000",2859,336,0,1,308,130,862,152,4648
"17099962100",4066,580,0,0,243,0,337,52,5278
"17099962200",3978,598,14,5,99,17,120,189,5020
"17099962300",5539,468,0,0,104,23,188,11,6333
"17099962400",3181,476,0,0,28,119,163,46,4013
"17099962500",1767,363,0,0,62,14,93,14,2313
"17099962600",4328,734,118,101,79,0,444,188,5992
"17099962700",1577,545,79,48,51,0,102,72,2474
"17099962800",2857,557,52,101,125,96,108,62,3958
"17099962900",2621,422,0,2,49,10,378,6,3488
"17099963000",3617,544,29,55,44,0,84,100,4473
"17099963100",2998,127,0,0,38,0,130,0,3293
"17099963200",2729,287,3,0,94,10,263,0,3386
"17099963300",1946,393,1,5,140,0,417,31,2933
"17099963400",3551,302,10,233,0,1,216,10,4323
"17099963500",3859,462,35,0,51,104,164,12,4687
"17099963600",3067,150,115,11,30,0,111,0,3484
"17099963700",4665,820,35,0,64,0,225,43,5852
"17099963800",3406,561,21,48,116,61,564,54,4831
"17099963900",4413,466,1,108,369,70,754,185,6366
"17099964000",2003,131,2,0,26,9,60,6,2237
"17099964100",3539,490,27,1,33,18,142,160,4410
"17099964200",1911,430,40,29,217,0,283,25,2935
"17099964300",2070,792,12,49,150,0,160,55,3288
"17101880700",1912,325,7,0,13,1,49,1,2308
"17101880800",1988,340,10,5,19,1,2,0,2365
"17101880900",1524,212,0,0,1,0,24,0,1761
"17101881000",1596,219,18,0,84,22,74,6,2019
"17101881100",2403,241,39,12,78,72,14,0,2859
"17103000100",2507,305,29,3,45,7,65,44,3005
"17103000200",3151,124,1,4,74,0,56,0,3410
"17103000300",3335,404,2,7,249,50,171,25,4243
"17103000400",4234,459,65,104,80,64,205,119,5330
"17103000500",4096,204,151,0,114,0,182,11,4758
"17103000600",2670,506,99,38,250,9,150,26,3748
"17103000700",1827,291,0,9,16,1,56,36,2236
"17103000800",3007,422,0,2,42,0,177,73,3723
"17103000900",2835,462,22,9,134,17,187,23,3689
"17105960100",3551,368,14,17,38,3,94,47,4132
"17105960200",3226,260,11,0,72,40,63,10,3682
"17105960300",2584,167,12,0,15,0,146,0,2924
"17105960400",2757,264,0,0,48,11,63,20,3163
"17105960500",2256,296,3,14,63,6,64,14,2716
"17105960600",3237,773,12,6,69,1,189,1,4288
"17105960700",3115,303,35,10,79,11,39,8,3600
"17105960800",5128,380,0,7,74,22,145,54,5810
"17105960900",2136,363,0,0,43,0,27,45,2614
"17105961000",1873,323,0,0,42,73,60,24,2395
"17107952900",2352,422,55,1,65,14,10,3,2922
"17107953000",1819,126,6,0,73,6,21,1,2052
"17107953100",2455,520,16,97,128,115,0,0,3331
"17107953200",3061,495,9,0,253,74,66,0,3958
"17107953300",2703,300,21,0,209,118,0,0,3351
"17107953400",2980,297,15,40,154,13,89,13,3601
"17107953500",1807,147,1,0,120,5,8,4,2092
"17107953600",1975,198,0,0,102,41,3,1,2320
"17109010100",3126,487,36,24,41,113,12,34,3873
"17109010200",1768,124,0,0,37,0,24,0,1953
"17109010300",1898,57,27,0,163,0,55,0,2200
"17109010400",2160,2571,137,222,35,84,40,188,5437
"17109010500",31,73,0,30,0,6,4,0,144
"17109010600",1449,602,66,90,75,28,0,44,2354
"17109010700",3288,703,0,7,318,0,1,0,4317
"17109010900",1809,632,10,37,71,109,30,38,2736
"17109011000",1960,252,7,0,32,2,14,2,2269
"17109011100",2297,411,6,0,52,0,0,0,2766
"17111870101",5964,478,8,25,279,85,311,13,7163
"17111870102",6430,291,0,0,85,0,299,13,7118
"17111870200",4795,450,0,3,594,514,783,623,7762
"17111870301",3253,653,0,0,484,325,1350,777,6842
"17111870302",2198,1030,0,14,396,695,1245,1129,6707
"17111870401",6838,544,58,0,610,0,1192,5,9247
"17111870402",4137,478,72,247,495,183,1228,349,7189
"17111870500",7815,626,0,0,310,0,379,134,9264
"17111870603",3984,360,51,8,133,23,491,33,5083
"17111870604",5185,301,52,0,171,0,478,0,6187
"17111870605",5287,517,0,0,666,335,869,335,8009
"17111870606",3078,660,16,20,662,92,964,350,5842
"17111870702",6114,666,0,0,465,185,425,332,8187
"17111870703",4939,221,15,0,191,4,280,41,5691
"17111870704",3410,316,0,0,34,0,129,36,3925
"17111870803",7066,246,0,22,354,0,189,0,7877
"17111870807",4356,576,35,14,453,0,557,223,6214
"17111870808",3663,104,0,26,93,0,311,46,4243
"17111870809",5924,340,60,63,558,0,299,9,7253
"17111870810",4122,280,23,0,126,14,272,7,4844
"17111870811",4082,317,0,0,161,7,505,50,5122
"17111870812",4080,301,38,0,262,0,474,23,5178
"17111870902",6614,777,62,99,319,60,518,299,8748
"17111870903",2390,211,0,0,351,19,916,0,3887
"17111870904",3813,479,100,0,110,20,389,131,5042
"17111870905",4115,393,75,8,550,247,1282,180,6850
"17111871003",3472,266,47,0,214,26,515,10,4550
"17111871004",5248,444,22,124,402,123,915,150,7428
"17111871104",14834,510,370,27,1995,0,2252,27,20015
"17111871105",4710,88,158,0,340,0,276,0,5572
"17111871106",7868,359,319,0,536,0,611,109,9802
"17111871107",4738,11,67,9,489,27,108,0,5449
"17111871108",4946,83,0,0,472,0,399,28,5928
"17111871109",4769,43,0,0,371,0,673,10,5866
"17111871201",6039,314,0,2,294,15,314,67,7045
"17111871202",4850,289,251,6,217,187,1175,201,7176
"17111871205",3782,505,95,0,359,0,419,0,5160
"17111871206",5630,0,0,0,596,0,353,0,6579
"17111871207",4264,181,22,0,548,0,592,103,5710
"17111871208",3505,187,0,0,237,0,159,0,4088
"17111871209",2752,237,0,0,134,0,93,94,3310
"17111871301",4208,130,27,0,296,72,450,0,5183
"17111871304",2650,75,0,0,200,14,71,0,3010
"17111871305",5582,274,56,11,256,0,472,71,6722
"17111871306",7302,195,166,7,699,1,735,0,9105
"17111871307",4147,293,0,0,53,645,155,511,5804
"17111871310",4148,304,0,0,9,0,227,0,4688
"17111871311",3536,77,226,0,583,70,910,43,5445
"17111871402",5358,414,30,0,342,200,243,179,6766
"17111871404",4121,106,154,36,281,19,311,37,5065
"17111871500",10104,808,79,9,498,0,557,34,12089
"17111871600",4305,459,24,1,206,1,312,74,5382
"17113000102",3601,1975,516,323,371,154,172,126,7238
"17113000104",6969,1784,893,477,797,93,614,173,11800
"17113000105",4068,157,34,0,131,38,142,14,4584
"17113000200",89,806,0,25,0,7,12,31,970
"17113000301",1890,1279,115,136,207,95,111,23,3856
"17113000302",4201,210,585,854,333,0,171,222,6576
"17113000400",1275,1677,8,31,63,55,170,95,3374
"17113000501",1570,1238,32,84,69,25,34,0,3052
"17113000502",2395,189,1,0,133,0,66,0,2784
"17113000504",3712,465,413,147,466,0,280,59,5542
"17113000505",4746,55,72,0,1090,36,61,0,6060
"17113001103",1990,110,372,48,645,0,170,0,3335
"17113001104",6480,193,405,74,1170,29,138,123,8612
"17113001105",3757,158,338,40,942,0,269,0,5504
"17113001106",2052,68,652,87,383,47,128,1,3418
"17113001200",2106,286,16,71,104,8,472,131,3194
"17113001301",1277,146,84,59,68,0,63,32,1729
"17113001302",360,421,32,0,22,44,20,7,906
"17113001303",983,267,74,56,54,0,20,0,1454
"17113001402",2836,177,224,50,256,7,122,44,3716
"17113001403",2459,491,396,578,51,12,112,194,4293
"17113001404",2961,381,272,29,340,0,456,0,4439
"17113001500",811,440,409,347,91,88,129,81,2396
"17113001600",987,495,138,709,48,0,96,72,2545
"17113001700",1269,504,105,217,73,8,96,54,2326
"17113001800",2765,124,66,5,133,57,73,8,3231
"17113002101",3715,600,188,0,181,0,535,0,5219
"17113002102",1620,148,10,6,49,14,77,82,2006
"17113005101",6527,98,152,0,2164,30,271,0,9242
"17113005102",6547,414,14,0,262,8,40,16,7301
"17113005201",1172,18,15,0,28,0,18,0,1251
"17113005202",2794,100,62,8,94,0,79,0,3137
"17113005400",8686,318,106,19,181,4,174,0,9488
"17113005501",2161,171,16,0,31,0,52,0,2431
"17113005502",2318,109,0,0,17,0,13,0,2457
"17113005601",1554,221,6,2,31,16,6,5,1841
"17113005602",2076,199,4,2,40,0,34,3,2358
"17113005700",4473,492,0,37,66,0,109,7,5184
"17113005800",2539,222,260,51,1060,0,201,15,4348
"17113005900",3064,514,187,738,173,12,145,0,4833
"17113006000",3230,235,117,0,116,21,33,10,3762
"17115000200",789,384,563,636,136,175,52,43,2778
"17115000300",868,807,1105,630,128,77,91,0,3706
"17115000400",292,72,388,336,168,30,12,0,1298
"17115000500",855,1029,183,565,118,155,81,43,3029
"17115000600",244,96,805,621,147,0,8,0,1921
"17115000900",531,274,665,531,137,8,69,98,2313
"17115001000",795,150,94,209,16,6,0,0,1270
"17115001100",2255,315,146,155,371,0,22,0,3264
"17115001200",1516,723,513,55,21,16,0,0,2844
"17115001300",2145,51,80,0,81,5,38,0,2400
"17115001400",1960,69,154,116,8,0,0,0,2307
"17115001500",3505,311,191,81,157,21,21,0,4287
"17115001600",1052,76,120,118,24,13,12,0,1415
"17115001700",1637,482,322,41,115,203,0,10,2810
"17115001801",1779,72,441,23,97,0,28,0,2440
"17115001802",1672,652,127,2,124,59,97,9,2742
"17115001900",1052,301,433,597,244,20,58,9,2714
"17115002000",1412,513,577,296,73,287,60,161,3379
"17115002100",711,557,79,70,79,0,0,123,1619
"17115002200",4093,674,283,23,291,82,107,0,5553
"17115002300",2512,149,0,0,71,46,75,14,2867
"17115002401",2039,79,190,3,185,0,55,11,2562
"17115002402",4886,347,109,19,122,0,87,0,5570
"17115002500",6629,219,63,0,109,65,68,65,7218
"17115002601",3857,53,23,0,80,0,52,6,4071
"17115002602",1853,157,0,0,53,6,6,0,2075
"17115002700",2164,144,0,0,0,0,0,6,2314
"17115002800",3703,389,16,16,170,32,28,55,4409
"17115002901",3695,95,86,6,358,0,37,0,4277
"17115002902",3661,249,252,10,175,0,0,0,4347
"17115002903",1797,658,809,152,290,29,28,57,3820
"17115002904",3831,661,162,301,196,165,54,0,5370
"17115003000",3077,174,7,3,161,58,65,3,3548
"17115003100",192,219,252,808,109,80,21,1,1682
"17117956000",2892,376,7,0,55,0,0,0,3330
"17117956100",2766,386,5,0,76,3,6,15,3257
"17117956200",2084,228,0,0,24,2,9,0,2347
"17117956300",2391,332,1,0,30,13,23,6,2796
"17117956400",4446,859,0,0,71,0,0,0,5376
"17117956500",2437,142,10,0,100,8,51,0,2748
"17117956600",4274,274,10,0,59,23,11,26,4677
"17117956700",3711,368,55,10,34,14,56,13,4261
"17117956800",2123,366,0,0,150,42,2,0,2683
"17117956900",2833,798,0,0,104,3,36,0,3774
"17117957000",3134,614,11,0,73,19,52,23,3926
"17117957100",2519,191,0,0,0,5,0,0,2715
"17117957200",3718,594,0,0,49,59,69,15,4504
"17119400101",2024,312,203,65,45,0,106,23,2778
"17119400102",3762,876,308,137,162,156,179,227,5807
"17119400200",2536,1004,248,204,120,83,169,36,4400
"17119400600",889,308,884,993,99,61,23,71,3328
"17119400700",9,19,1016,678,13,16,5,6,1762
"17119400801",1883,60,18,0,6,0,44,0,2011
"17119400802",4878,1173,50,74,106,0,109,48,6438
"17119400903",3393,798,251,314,227,0,706,61,5750
"17119400904",2957,485,39,0,56,35,106,0,3678
"17119400951",4293,352,17,0,194,0,100,0,4956
"17119400952",2263,436,195,213,93,10,85,83,3378
"17119401000",1918,572,4,3,21,4,5,96,2623
"17119401100",4885,929,0,0,232,15,283,15,6359
"17119401200",1543,272,0,0,82,0,47,20,1964
"17119401300",3743,997,0,0,184,73,17,0,5014
"17119401400",2456,205,73,61,86,20,145,8,3054
"17119401500",1767,606,61,343,35,53,64,10,2939
"17119401701",1499,733,60,108,62,38,26,0,2526
"17119401721",5040,534,20,0,113,0,139,0,5846
"17119401722",2281,338,0,34,25,88,0,0,2766
"17119401800",5513,321,44,51,11,22,157,16,6135
"17119401901",1408,202,0,0,61,5,34,7,1717
"17119401903",3680,854,11,5,76,75,85,4,4790
"17119401904",627,31,0,0,3,0,0,0,661
"17119402000",2097,688,757,279,140,202,29,39,4231
"17119402100",1229,189,1077,508,16,211,0,50,3280
"17119402200",2001,671,255,195,127,0,41,14,3304
"17119402300",1343,151,151,77,94,18,74,6,1914
"17119402400",979,181,463,128,135,19,1,17,1923
"17119402500",865,302,686,407,102,29,78,38,2507
"17119402600",1635,422,365,176,38,20,39,11,2706
"17119402701",5297,1021,676,80,26,36,73,0,7209
"17119402721",6539,364,416,72,291,0,106,0,7788
"17119402722",2821,63,66,2,27,0,57,1,3037
"17119402801",3134,290,82,0,46,0,6,16,3574
"17119402802",7317,551,107,0,239,0,0,0,8214
"17119402803",2829,319,12,0,50,5,7,0,3222
"17119402900",3236,472,350,20,116,33,49,0,4276
"17119403001",3772,772,528,6,235,55,35,0,5403
"17119403002",5600,550,557,0,445,10,140,10,7312
"17119403101",2944,606,26,61,124,74,14,0,3849
"17119403121",7142,714,696,231,272,15,49,167,9286
"17119403122",4098,154,266,243,501,45,158,0,5465
"17119403200",3758,596,89,34,76,16,147,0,4716
"17119403300",2069,495,302,70,110,9,77,0,3132
"17119403401",2699,334,471,108,157,48,215,0,4032
"17119403402",4365,605,370,460,165,131,89,24,6209
"17119403502",4949,228,339,129,114,99,335,99,6292
"17119403531",7024,420,164,151,210,144,460,116,8689
"17119403532",4230,83,33,0,64,0,59,16,4485
"17119403533",8632,587,236,21,371,0,163,0,10010
"17119403534",3657,225,55,34,47,37,141,0,4196
"17119403601",2986,221,15,0,85,0,148,0,3455
"17119403603",1762,61,0,0,97,0,0,0,1920
"17119403604",5286,733,8,8,47,0,9,240,6331
"17119403701",5767,230,64,0,212,0,127,0,6400
"17119403702",5879,94,0,0,84,4,37,0,6098
"17119403801",4213,315,71,0,90,31,0,0,4720
"17119403802",3927,326,15,2,33,0,7,1,4311
"17119404000",1624,547,102,263,105,2,427,25,3095
"17119404100",2475,235,40,38,9,0,67,18,2882
"17121951600",2960,565,0,0,110,0,22,0,3657
"17121951700",2387,260,0,6,27,2,28,5,2715
"17121951800",1668,453,1,18,37,9,32,0,2218
"17121951900",2441,362,39,2,17,3,0,5,2869
"17121952000",3283,725,12,7,29,77,37,24,4194
"17121952100",2173,582,0,0,108,26,20,0,2909
"17121952200",3711,344,0,0,52,3,39,6,4155
"17121952300",3301,221,32,21,37,0,33,0,3645
"17121952400",2897,226,162,21,172,28,8,0,3514
"17121952500",1462,916,119,1,0,125,23,96,2742
"17121952600",1103,617,170,40,54,39,58,0,2081
"17121952700",1802,774,368,338,133,95,107,54,3671
"17123961100",2113,299,0,0,69,7,57,13,2558
"17123961200",2039,293,0,0,56,9,12,3,2412
"17123961300",2047,294,14,0,42,0,35,0,2432
"17123961400",2461,307,0,0,2,2,0,0,2772
"17123961500",1644,94,29,0,128,72,144,69,2180
"17125956300",2685,282,0,0,9,0,99,0,3075
"17125956400",1662,192,0,0,28,0,24,0,1906
"17125956500",2378,746,0,31,36,0,2,0,3193
"17125956600",1551,328,0,0,0,9,0,0,1888
"17125956700",1534,213,17,0,30,0,0,0,1794
"17125956800",1752,498,3,5,31,37,16,0,2342
"17127970100",4070,537,40,16,52,27,165,0,4907
"17127970200",2978,737,70,88,42,10,21,16,3962
"17127970300",2518,578,301,76,142,96,111,0,3822
"17127970400",1641,539,139,107,90,27,40,0,2583
"17129010100",5650,408,67,0,85,0,89,0,6299
"17129010200",3316,383,0,0,99,34,19,16,3867
"17129010300",2026,371,0,0,0,12,15,0,2424
"17131040100",4151,309,20,19,115,0,96,0,4710
"17131040200",3175,431,0,0,38,7,17,13,3681
"17131040300",3058,538,0,0,92,34,75,42,3839
"17131040400",3537,371,6,0,37,27,61,15,4054
"17133600101",6753,369,86,0,70,135,95,92,7600
"17133600102",4472,96,0,0,38,23,91,61,4781
"17133600401",6154,135,0,0,26,0,22,0,6337
"17133600402",3926,264,0,0,195,0,103,0,4488
"17133600501",6442,308,0,2,32,0,28,1,6813
"17133600502",3054,424,0,0,5,30,0,0,3513
"17135957300",2774,446,2,2,29,1,28,0,3282
"17135957400",1528,285,35,2,10,0,2,0,1862
"17135957500",1823,427,0,0,57,0,32,0,2339
"17135957600",3012,132,0,0,2,49,19,0,3214
"17135957700",2559,354,28,2,10,10,19,0,2982
"17135957800",2288,882,51,3,70,0,45,0,3339
"17135957900",3762,496,19,15,106,41,40,2,4481
"17135958000",2424,367,0,0,46,0,5,1,2843
"17137951400",2375,255,3,0,20,6,2,6,2667
"17137951500",2704,329,0,0,64,7,10,0,3114
"17137951600",1723,553,274,233,152,13,9,0,2957
"17137951700",1763,451,199,32,46,43,19,47,2600
"17137951800",2381,390,119,167,53,69,124,0,3303
"17137951900",4741,365,163,0,59,35,61,0,5424
"17137952000",1684,541,186,150,36,41,68,14,2720
"17137952100",3269,278,0,0,54,27,25,0,3653
"17137952200",2653,267,7,0,54,0,13,1,2995
"17137952300",2875,387,0,5,3,6,16,2,3294
"17139976900",4305,383,0,0,116,0,66,0,4870
"17139977000",2003,380,0,2,31,5,20,0,2441
"17139977100",2698,358,0,0,0,0,29,21,3106
"17139977200",3226,955,14,0,20,0,15,0,4230
"17141960700",4397,187,13,0,124,47,15,0,4783
"17141960800",3287,379,0,0,136,12,46,0,3860
"17141960900",3759,812,2,0,0,50,85,176,4884
"17141961000",5959,349,92,14,171,10,497,50,7142
"17141961100",3971,777,27,66,514,34,977,178,6544
"17141961200",4561,558,106,0,238,15,749,278,6505
"17141961300",4228,393,0,0,66,0,192,12,4891
"17141961400",3162,691,10,1,84,9,16,29,4002
"17141961500",3744,366,10,0,22,0,146,8,4296
"17141961600",2605,591,37,42,231,31,756,488,4781
"17141961700",4498,300,13,0,72,0,135,27,5045
"17143000100",204,56,219,514,33,141,120,89,1376
"17143000200",507,115,455,314,38,51,95,48,1623
"17143000300",924,405,419,459,163,31,391,106,2898
"17143000500",368,125,369,734,22,45,233,12,1908
"17143000600",702,278,1132,835,34,48,40,185,3254
"17143000900",370,229,718,1017,28,24,0,68,2454
"17143001200",545,181,131,509,144,45,77,35,1667
"17143001300",499,346,387,482,178,233,311,147,2583
"17143001500",656,401,387,345,68,41,67,117,2082
"17143001600",1322,307,920,745,184,133,175,14,3800
"17143001800",896,702,823,339,54,97,68,33,3012
"17143001900",725,527,140,0,66,45,0,15,1518
"17143002000",812,427,50,77,72,0,44,87,1569
"17143002100",1657,983,862,909,53,105,113,117,4799
"17143002200",2232,245,765,231,283,133,175,114,4178
"17143002300",3702,228,362,87,73,62,76,89,4679
"17143002400",2599,259,1040,197,423,0,0,60,4578
"17143002500",756,467,1234,274,438,16,278,125,3588
"17143002600",1540,149,167,3,17,28,79,21,2004
"17143002701",1810,336,725,627,137,206,207,92,4140
"17143002702",1991,398,761,430,270,126,144,0,4120
"17143002800",2197,219,672,146,278,75,53,4,3644
"17143002900",2718,230,405,204,198,45,17,1,3818
"17143003000",3356,402,257,250,334,17,240,50,4906
"17143003101",3611,59,954,181,464,39,0,13,5321
"17143003102",3682,330,533,30,1287,35,95,30,6022
"17143003200",3181,478,583,51,456,125,126,0,5000
"17143003300",2846,113,34,0,111,0,5,0,3109
"17143003401",7389,1119,262,0,2395,110,260,0,11535
"17143003402",3382,198,26,0,128,20,36,0,3790
"17143003601",2461,209,0,4,96,1,79,0,2850
"17143003602",4579,749,0,6,94,11,241,11,5691
"17143003700",3473,124,77,27,64,0,156,27,3948
"17143003800",3319,221,18,1,38,0,93,0,3690
"17143003900",5996,173,173,0,387,0,75,1,6805
"17143004000",4047,147,49,1,27,17,41,0,4329
"17143004101",5094,122,312,66,900,0,407,24,6925
"17143004102",1689,424,606,129,167,52,148,58,3273
"17143004200",2773,193,69,77,300,22,0,14,3448
"17143004300",1689,228,209,40,80,12,34,0,2292
"17143004400",2878,644,626,411,216,32,117,0,4924
"17143004500",3804,405,303,208,253,16,72,0,5061
"17143004600",4749,724,23,0,32,8,134,0,5670
"17143004801",4000,427,30,2,131,32,18,19,4659
"17143004802",3502,370,220,240,184,18,301,15,4850
"17143004901",3451,291,19,0,66,11,13,1,3852
"17143004902",4692,76,0,9,129,0,191,0,5097
"17143005000",179,145,973,1102,61,227,95,6,2788
"17145030100",2571,379,72,0,63,2,74,0,3161
"17145030200",4854,787,0,0,97,0,62,0,5800
"17145030300",1638,329,0,0,15,1,26,39,2048
"17145030400",1664,564,185,216,56,146,51,44,2926
"17145030500",2260,216,0,0,2,7,0,0,2485
"17145030600",2768,721,163,15,89,8,0,4,3768
"17147954500",4016,269,0,0,69,10,31,6,4401
"17147954600",5521,386,16,0,35,0,80,0,6038
"17147954700",2947,252,3,0,99,16,50,0,3367
"17147954800",2470,172,13,0,84,0,7,0,2746
"17149952400",2454,376,8,13,59,0,45,5,2960
"17149952500",2102,260,1,0,34,0,8,26,2431
"17149952600",2894,417,0,0,95,2,17,0,3425
"17149952700",3447,735,0,0,48,34,0,14,4278
"17149952800",2098,534,0,0,28,22,2,6,2690
"17151971200",1738,265,8,39,55,13,6,0,2124
"17151971300",1651,335,8,16,9,18,18,13,2068
"17153971000",2092,349,441,115,113,0,69,20,3199
"17153971100",1171,185,923,428,70,16,9,4,2806
"17155954500",2469,263,0,0,68,81,131,5,3017
"17155954600",2730,265,0,1,6,6,93,44,3145
"17157950500",1854,265,47,17,51,0,31,0,2265
"17157950600",2721,438,642,454,16,6,0,1,4278
"17157950700",2059,293,22,0,18,7,174,0,2573
"17157950800",4531,168,0,0,90,0,93,0,4882
"17157950900",3037,522,0,0,55,7,19,17,3657
"17157951000",2634,145,1,0,46,0,65,0,2891
"17157951100",3109,209,0,0,64,29,118,29,3558
"17157951200",1951,326,197,90,39,12,0,15,2630
"17157951300",2783,663,13,5,25,0,27,39,3555
"17159977900",3071,423,0,1,27,3,94,0,3619
"17159978000",1706,501,9,15,0,0,25,0,2256
"17159978100",3174,462,0,14,126,10,69,10,3865
"17159978200",1933,654,19,0,85,0,0,0,2691
"17159978300",3216,286,0,0,80,0,23,0,3605
"17161020100",6325,341,18,10,123,22,198,60,7097
"17161020200",2478,355,164,313,240,100,192,116,3958
"17161020300",4694,566,465,31,580,21,598,364,7319
"17161020400",3616,505,255,143,292,139,614,39,5603
"17161020600",1307,487,220,122,509,58,999,152,3854
"17161020700",804,386,92,115,386,39,468,113,2403
"17161020800",4084,99,337,0,292,170,897,40,5919
"17161020900",3854,521,365,148,379,125,264,244,5900
"17161021000",1951,424,367,379,310,131,319,180,4061
"17161021100",2713,277,366,2,331,8,235,30,3962
"17161021200",3551,211,165,11,367,70,346,48,4769
"17161021300",3113,538,407,140,90,137,304,156,4885
"17161021400",833,145,187,0,25,0,107,20,1317
"17161021500",3463,286,79,77,306,50,304,94,4659
"17161021600",2055,318,30,19,492,0,586,97,3597
"17161021700",3119,699,134,29,318,92,893,119,5403
"17161021800",3789,271,242,0,207,0,254,79,4842
"17161021900",1434,269,52,76,77,7,154,12,2081
"17161022000",3212,310,15,0,366,56,400,50,4409
"17161022100",2013,113,43,16,358,8,251,0,2802
"17161022200",2984,338,0,0,308,182,977,229,5018
"17161022300",1346,156,31,55,372,25,1062,60,3107
"17161022600",474,315,664,415,185,83,226,120,2482
"17161022800",2694,581,210,32,395,27,553,16,4508
"17161022900",2070,235,48,109,218,18,188,21,2907
"17161023000",3204,105,124,0,273,0,97,31,3834
"17161023100",2130,45,220,43,130,0,192,0,2760
"17161023200",3424,503,405,179,89,50,302,61,5013
"17161023300",2071,567,229,103,90,110,322,156,3648
"17161023500",861,320,577,371,93,165,242,61,2690
"17161023600",165,200,760,576,165,220,241,88,2415
"17161023700",1146,227,573,255,352,46,317,80,2996
"17161024000",3703,242,58,0,126,0,106,11,4246
"17161024101",3441,315,48,0,26,14,105,21,3970
"17161024102",4060,517,26,178,107,98,78,169,5233
"17161024103",3748,248,11,0,58,112,50,48,4275
"17161024200",3161,635,327,0,110,132,136,67,4568
"17161024300",2447,298,2,2,85,5,69,0,2908
"17161024400",976,342,285,179,92,88,105,22,2089
"17161024500",558,404,128,158,344,50,293,90,2025
"17163500400",0,2,626,1181,0,11,0,2,1822
"17163500500",10,3,1079,1774,9,20,0,3,2898
"17163500900",15,66,1599,2056,42,136,0,0,3914
"17163501100",0,0,802,560,14,0,11,0,1387
"17163501200",0,8,2117,1168,15,0,0,11,3319
"17163501300",11,0,2525,1014,0,19,78,0,3647
"17163501400",36,1,1718,789,85,1,16,1,2647
"17163501501",686,151,869,91,1,0,11,3,1812
"17163501502",1531,210,675,207,84,12,36,12,2767
"17163501602",3074,543,1076,442,56,58,142,4,5395
"17163501603",2710,810,942,652,158,71,108,1,5452
"17163501604",1887,313,1143,640,242,0,102,32,4359
"17163501605",1853,54,305,28,55,0,96,0,2391
"17163501700",1682,369,418,130,0,43,8,19,2669
"17163501800",4128,786,307,648,334,197,87,0,6487
"17163501900",2364,378,241,52,220,49,38,0,3342
"17163502100",1582,723,0,0,177,35,1097,740,4354
"17163502200",85,24,1085,909,0,44,0,14,2161
"17163502300",2143,313,1760,2238,192,15,148,0,6809
"17163502401",0,6,971,692,0,0,0,0,1669
"17163502404",1292,990,619,251,328,12,573,563,4628
"17163502500",0,0,759,494,5,0,0,0,1258
"17163502602",1756,327,1869,1467,122,160,17,29,5747
"17163502603",896,76,1370,1152,30,42,12,87,3665
"17163502700",7,0,649,783,0,6,0,0,1445
"17163502800",0,7,1290,1179,0,14,31,14,2535
"17163502900",12,10,1098,596,0,5,0,0,1721
"17163503100",6050,1232,121,26,202,29,206,7,7873
"17163503202",4506,594,628,139,59,0,0,0,5926
"17163503203",6214,336,0,0,61,0,22,0,6633
"17163503211",3170,166,619,50,121,28,79,11,4244
"17163503301",2593,378,390,144,205,35,62,16,3823
"17163503304",4594,563,1018,87,706,134,262,29,7393
"17163503322",5278,390,861,242,692,71,244,0,7778
"17163503323",4971,310,896,155,250,58,339,34,7013
"17163503324",3196,88,2044,418,310,0,238,0,6294
"17163503332",2812,489,1500,335,106,20,307,38,5607
"17163503334",3972,242,1006,199,290,14,60,2,5785
"17163503402",4400,283,1554,304,461,37,311,55,7405
"17163503404",4424,137,415,82,241,16,168,48,5531
"17163503411",2336,220,263,38,158,162,28,162,3367
"17163503412",4517,604,325,88,226,13,77,0,5850
"17163503413",3528,170,1519,145,288,14,94,14,5772
"17163503414",2866,509,842,153,308,9,370,76,5133
"17163503800",1051,0,60,6,36,0,42,0,1195
"17163503903",3108,121,262,2,143,0,173,0,3809
"17163503904",7379,280,1399,53,708,143,439,49,10450
"17163503905",2769,85,0,0,7,7,32,0,2900
"17163503906",5116,251,49,0,93,0,189,0,5698
"17163504001",4325,211,18,12,11,0,84,0,4661
"17163504002",5101,671,0,1,123,33,41,19,5989
"17163504302",5667,260,371,447,350,68,162,1,7326
"17163504303",6498,674,367,24,309,47,58,10,7987
"17163504351",2414,103,380,166,314,0,50,0,3427
"17163504352",3207,372,400,41,122,50,46,27,4265
"17163504353",3269,195,345,66,571,28,154,16,4644
"17163504354",4182,259,1400,0,248,0,44,0,6133
"17163504355",4521,102,270,188,383,87,262,24,5837
"17163504500",48,67,2672,2481,51,188,0,0,5507
"17163504600",3,27,1089,827,0,0,0,2,1948
"17165955100",1680,514,64,23,23,7,9,23,2343
"17165955500",1486,679,0,0,8,86,0,0,2259
"17165955600",1946,485,0,0,0,0,33,4,2468
"17165955700",2046,423,0,0,10,19,5,0,2503
"17165955800",2234,503,11,49,71,25,0,54,2947
"17165955900",1691,671,45,130,141,13,22,118,2831
"17165956000",2082,582,34,107,117,0,48,7,2977
"17165956100",1968,487,202,91,139,6,0,0,2893
"17165956200",2912,197,26,26,18,2,4,0,3185
"17167000100",2754,368,118,192,105,153,25,0,3715
"17167000201",1753,173,257,45,55,0,105,14,2402
"17167000202",1950,949,263,252,111,29,53,9,3616
"17167000300",1666,250,198,78,62,40,58,90,2442
"17167000400",2190,228,207,156,51,21,42,0,2895
"17167000501",1910,210,216,21,40,0,6,0,2403
"17167000503",2763,447,166,90,55,12,37,33,3603
"17167000504",2252,416,259,0,69,43,59,25,3123
"17167000600",3209,1256,290,120,273,67,81,0,5296
"17167000700",1272,355,230,85,63,16,9,0,2030
"17167000800",517,325,714,632,28,116,17,0,2349
"17167000900",630,456,253,516,116,9,36,0,2016
"17167001001",1466,64,480,49,23,0,42,0,2124
"17167001003",1225,119,6,0,11,0,5,0,1366
"17167001004",3344,169,861,36,448,13,203,30,5104
"17167001100",1917,208,34,14,4,111,0,95,2383
"17167001200",2557,513,349,96,246,68,115,32,3976
"17167001300",801,513,163,120,418,35,6,26,2082
"17167001400",360,267,34,42,1,0,10,25,739
"17167001500",71,138,309,400,7,8,0,11,944
"17167001600",512,315,1169,1721,11,8,0,0,3736
"17167001700",126,261,443,229,24,78,10,10,1181
"17167001800",1150,319,477,405,13,10,28,37,2439
"17167001900",1978,451,225,425,56,28,128,31,3322
"17167002000",5198,197,146,17,266,14,91,63,5992
"17167002100",2801,127,273,96,68,3,48,3,3419
"17167002200",2663,352,122,56,123,7,37,31,3391
"17167002300",679,258,538,451,57,129,42,0,2154
"17167002400",631,450,1774,741,146,4,9,22,3777
"17167002500",3001,254,1385,337,70,22,45,12,5126
"17167002600",1346,444,206,183,82,253,5,0,2519
"17167002700",2639,679,133,26,96,48,35,28,3684
"17167002801",1955,313,176,125,104,61,12,15,2761
"17167002802",1440,705,435,544,148,230,124,95,3721
"17167002900",3759,169,317,217,328,54,73,17,4934
"17167003000",3443,601,677,221,134,22,33,14,5145
"17167003100",6231,322,140,0,188,36,191,0,7108
"17167003201",3890,242,103,20,384,128,145,9,4921
"17167003202",3976,226,22,16,169,0,181,20,4610
"17167003203",4966,151,17,28,206,0,173,0,5541
"17167003300",4351,446,14,0,131,16,63,0,5021
"17167003400",5661,425,0,0,43,0,0,16,6145
"17167003500",4575,412,5,20,86,18,93,0,5209
"17167003601",2615,121,29,0,27,0,20,0,2812
"17167003602",4248,131,77,49,234,0,48,0,4787
"17167003603",4561,236,27,35,206,5,73,7,5150
"17167003604",3864,81,512,0,431,0,135,0,5023
"17167003700",8038,70,22,0,226,7,50,0,8413
"17167003801",2104,422,4,8,89,14,28,0,2669
"17167003802",4832,919,10,0,105,31,67,76,6040
"17167003901",4993,17,0,0,109,19,0,0,5138
"17167003902",3643,185,9,9,8,44,46,0,3944
"17167004000",3746,340,25,11,82,16,11,14,4245
"17169970100",1688,454,0,150,0,0,79,13,2384
"17169970200",2529,530,0,0,83,14,0,0,3156
"17169970300",1753,109,0,0,25,0,42,0,1929
"17171970600",1650,215,0,0,0,0,31,0,1896
"17171970700",2710,467,0,0,26,24,0,0,3227
"17173959100",3017,471,25,3,49,0,14,0,3579
"17173959200",2571,210,0,0,6,0,4,0,2791
"17173959300",4876,568,0,0,41,41,86,0,5612
"17173959400",2887,431,43,0,17,11,18,20,3427
"17173959500",2916,445,0,0,40,0,2,8,3411
"17173959600",2873,338,3,0,23,0,19,21,3277
"17175951400",2693,299,11,6,42,23,11,20,3105
"17175951500",2383,231,0,0,40,11,13,11,2689
"17177000100",4048,304,30,6,60,11,42,21,4522
"17177000200",3006,245,0,0,77,2,11,8,3349
"17177000300",3268,469,0,0,38,37,9,11,3832
"17177000400",2599,345,0,0,4,0,46,8,3002
"17177000500",2694,182,104,0,145,0,26,3,3154
"17177000600",2897,334,31,0,19,45,0,13,3339
"17177000700",563,154,453,297,11,119,0,0,1597
"17177000800",1340,774,411,476,46,81,37,0,3165
"17177000900",3463,635,486,148,137,58,41,109,5077
"17177001000",3694,141,103,85,240,0,70,22,4355
"17177001100",2744,324,130,50,30,27,39,30,3374
"17177001200",2158,437,554,122,238,47,103,39,3698
"17177001300",2349,663,423,402,383,106,612,152,5090
"17179020100",1884,498,29,0,17,21,63,23,2535
"17179020301",3812,574,65,0,179,0,111,0,4741
"17179020302",4553,683,149,0,72,13,90,21,5581
"17179020400",4757,751,36,0,45,26,0,0,5615
"17179020500",3996,314,3,15,69,73,77,0,4547
"17179020600",1609,267,0,0,37,104,4,10,2031
"17179020700",4116,243,0,2,17,0,9,11,4398
"17179020800",2877,549,0,0,24,9,50,59,3568
"17179020900",1608,479,12,13,0,0,52,17,2181
"17179021000",4984,714,35,3,0,65,52,0,5853
"17179021101",4973,1186,0,2,166,42,35,60,6464
"17179021102",5294,621,19,0,164,0,87,0,6185
"17179021201",3932,205,0,82,165,47,78,0,4509
"17179021202",3130,87,61,3,128,15,30,29,3483
"17179021203",4061,625,17,2,105,84,72,119,5085
"17179021500",6448,336,0,2,84,10,318,15,7213
"17179021603",4843,72,45,0,147,0,33,0,5140
"17179021604",1554,222,0,0,137,19,6,0,1938
"17179021605",2341,143,58,0,21,0,113,0,2676
"17179021606",5087,198,134,0,165,0,142,0,5726
"17179021701",5458,267,0,0,267,0,219,0,6211
"17179021702",5354,287,0,21,78,0,49,0,5789
"17179021801",3444,591,5,0,104,0,12,4,4160
"17179021802",1955,82,0,0,32,0,15,0,2084
"17179021900",4217,351,40,3,31,20,54,4,4720
"17179022000",3942,300,7,0,25,8,15,0,4297
"17179022100",3186,314,0,2,103,132,53,0,3790
"17179022200",4730,205,36,0,129,19,58,0,5177
"17179022300",4450,74,0,0,183,82,175,70,5034
"17179022400",4574,223,21,0,106,7,41,0,4972
"17181950100",3668,491,64,57,127,82,385,48,4922
"17181950200",1886,324,4,20,155,4,52,27,2472
"17181950300",1597,468,0,11,29,7,53,0,2165
"17181950400",3337,1063,34,42,20,123,23,131,4773
"17181950500",3281,412,2,0,6,14,117,14,3846
"17183000100",798,227,216,210,116,42,30,32,1671
"17183000200",554,140,546,566,34,0,150,0,1990
"17183000300",1090,370,427,615,134,45,300,72,3053
"17183000400",905,352,607,1266,139,60,171,34,3534
"17183000500",1952,300,674,468,203,80,245,0,3922
"17183000600",895,442,585,554,25,72,167,0,2740
"17183000700",2770,160,387,13,319,13,59,0,3721
"17183000800",1823,118,162,39,57,0,94,8,2301
"17183000900",1647,371,70,394,49,62,0,106,2699
"17183001200",2078,259,251,42,93,98,0,0,2821
"17183001300",2790,281,34,46,222,0,115,0,3488
"17183010100",2798,451,0,0,28,0,9,0,3286
"17183010200",4337,877,0,59,147,16,480,261,6177
"17183010300",4523,418,0,0,73,19,47,0,5080
"17183010400",2113,118,1,1,70,0,69,0,2372
"17183010500",3161,739,15,0,52,8,0,8,3983
"17183010600",3594,327,2,0,90,22,35,2,4072
"17183010701",1973,527,0,0,242,44,232,94,3112
"17183010702",2796,171,6,52,0,14,44,0,3083
"17183010800",3094,319,19,0,35,20,152,15,3654
"17183010900",2672,190,6,0,14,0,0,0,2882
"17183011000",3364,722,83,0,6,9,10,17,4211
"17183011100",2465,187,0,2,40,0,21,2,2717
"17183011200",1925,1012,768,866,33,70,16,157,4847
"17185957200",3341,276,0,0,112,7,31,1,3768
"17185957300",2738,363,0,0,35,0,13,0,3149
"17185957400",1705,140,0,0,39,46,38,31,1999
"17185957500",2011,682,28,3,50,32,0,49,2855
"17187870100",1779,247,7,2,0,0,47,3,2085
"17187870200",2125,368,3,0,17,4,27,0,2544
"17187870300",2816,90,0,0,0,0,18,0,2924
"17187870400",3280,474,35,13,192,24,400,85,4503
"17187870500",3085,765,209,225,392,366,574,283,5899
"17189950100",2755,363,9,47,37,13,35,2,3261
"17189950200",3536,180,28,0,21,2,90,0,3857
"17189950300",2459,680,0,0,40,0,24,0,3203
"17189950400",3560,421,11,0,54,44,19,30,4139
"17191954900",2752,413,0,0,43,10,36,20,3274
"17191955000",3648,588,2,8,35,0,39,0,4320
"17191955100",2278,507,0,11,5,12,0,31,2844
"17191955200",2482,414,4,65,126,0,24,27,3142
"17191955300",2565,502,4,0,25,3,13,0,3112
"17193958000",1678,612,0,0,71,4,30,0,2395
"17193958100",2469,550,7,0,18,0,0,0,3044
"17193958200",2413,294,0,0,55,3,24,4,2793
"17193958300",2414,246,6,0,11,0,15,8,2700
"17193958400",2975,318,3,0,6,8,63,0,3373
"17195000100",3640,176,38,0,104,10,230,10,4208
"17195000200",2591,128,25,9,70,0,105,1,2929
"17195000300",2569,376,0,14,139,11,163,8,3280
"17195000400",2851,228,43,0,69,9,67,0,3267
"17195000500",3063,281,13,28,103,0,40,0,3528
"17195000600",3507,304,47,44,89,122,84,15,4212
"17195000700",2224,292,0,3,58,13,113,45,2748
"17195000800",1746,244,0,0,34,0,28,0,2052
"17195000900",2665,268,14,0,263,0,352,79,3641
"17195001000",1980,400,47,24,411,91,770,149,3872
"17195001100",3829,532,0,84,407,63,1061,168,6144
"17195001200",3177,415,36,10,229,74,885,88,4914
"17195001300",1756,313,51,49,165,135,273,123,2865
"17195001400",2150,110,0,0,29,41,70,13,2413
"17195001500",2340,545,53,35,142,38,248,68,3469
"17195001600",2032,289,0,0,318,70,439,114,3262
"17195001700",2357,602,65,4,150,134,429,157,3898
"17195001800",2004,127,0,0,45,0,112,51,2339
"17197880105",4300,163,1301,59,2070,16,1777,10,9696
"17197880106",2438,191,947,232,878,24,1469,148,6327
"17197880107",2381,151,1063,77,1282,297,1417,306,6974
"17197880109",2909,180,1524,174,724,323,765,320,6919
"17197880111",2333,36,736,58,376,12,1076,12,4639
"17197880112",1374,142,157,5,436,98,574,209,2995
"17197880113",1284,388,403,221,934,261,1009,576,5076
"17197880114",874,148,414,0,653,455,756,541,3841
"17197880115",1129,113,776,303,678,130,765,147,4041
"17197880116",1551,27,639,99,326,131,570,132,3475
"17197880117",1176,239,983,480,499,351,556,447,4731
"17197880118",4069,10,174,0,676,71,40,0,5040
"17197880119",3331,63,93,53,1057,0,247,0,4844
"17197880120",4890,62,1665,84,2760,0,1287,13,10761
"17197880121",5108,223,1872,0,2265,21,1785,21,11295
"17197880202",3053,210,286,37,668,104,747,103,5208
"17197880203",2879,108,0,0,944,117,1303,134,5485
"17197880204",4076,265,449,12,828,83,1151,153,7017
"17197880303",3465,148,0,0,584,45,160,53,4455
"17197880304",4214,75,134,0,728,30,249,11,5441
"17197880305",4477,31,66,6,639,8,419,0,5646
"17197880306",3767,358,859,0,2091,209,533,9,7826
"17197880307",3070,240,653,145,1375,206,385,41,6115
"17197880308",5815,14,986,59,1402,277,269,143,8965
"17197880309",4046,31,89,28,1035,0,206,0,5435
"17197880310",8565,146,778,0,2645,124,1309,75,13642
"17197880312",6662,52,311,0,2654,39,379,0,10097
"17197880313",7712,177,692,73,2878,56,1483,129,13200
"17197880314",6425,53,381,0,570,0,572,0,8001
"17197880404",8609,563,915,5,538,669,1023,249,12571
"17197880408",3619,228,364,63,438,442,1247,288,6689
"17197880410",4213,861,1164,114,2202,41,2345,823,11763
"17197880411",2643,15,68,0,521,0,569,0,3816
"17197880412",3481,78,260,0,393,12,846,12,5082
"17197880414",3749,243,62,0,299,29,672,114,5168
"17197880415",5941,362,560,16,677,80,1640,296,9572
"17197880416",2394,7,87,0,458,24,493,24,3487
"17197880417",2064,61,29,0,460,0,516,0,3130
"17197880418",4655,32,201,0,247,0,1144,0,6279
"17197880419",6416,241,589,0,1488,0,1596,31,10361
"17197880420",7497,651,906,0,1478,191,2463,470,13656
"17197880421",4667,409,258,71,633,13,523,95,6669
"17197880502",4497,414,0,0,114,121,409,8,5563
"17197880503",3150,103,337,0,392,0,578,28,4588
"17197880505",5365,105,206,0,1343,533,2629,401,10582
"17197880507",3431,185,908,0,2193,726,2202,0,9645
"17197880601",3095,70,22,0,16,0,182,0,3385
"17197880602",2819,491,7,1,107,12,153,12,3602
"17197880701",3938,279,81,15,301,13,438,34,5099
"17197880702",1083,160,701,369,444,121,656,147,3681
"17197880901",5080,561,327,19,339,0,804,393,7523
"17197880903",1559,259,264,130,139,258,238,297,3144
"17197880905",1765,109,117,28,436,22,524,19,3020
"17197881001",4505,175,72,0,319,10,408,25,5514
"17197881002",4705,159,31,0,156,103,164,117,5435
"17197881005",3188,29,0,12,135,11,66,0,3441
"17197881006",2489,46,0,0,88,0,311,0,2934
"17197881007",5537,66,129,5,302,15,685,0,6739
"17197881009",6796,38,181,0,142,121,615,0,7893
"17197881010",3458,60,0,1,97,2,490,0,4108
"17197881011",2739,169,0,0,86,0,133,0,3127
"17197881012",2990,26,0,0,34,0,44,0,3094
"17197881105",5331,179,67,0,378,0,411,0,6366
"17197881107",2623,141,47,1,194,0,282,0,3288
"17197881108",5565,221,32,7,244,0,548,0,6617
"17197881109",4584,100,5,0,82,5,79,4,4859
"17197881111",3080,90,0,0,334,1,135,0,3640
"17197881112",4937,76,2,0,195,0,488,0,5698
"17197881113",3361,261,20,1,14,0,145,0,3802
"17197881115",3932,109,29,0,265,0,471,0,4806
"17197881116",3550,195,47,0,300,0,321,0,4413
"17197881200",978,642,2002,1029,326,166,803,613,6559
"17197881301",940,239,151,73,1079,493,1928,624,5527
"17197881302",770,272,134,0,518,131,1081,375,3281
"17197881401",1691,255,57,49,745,100,1134,85,4116
"17197881402",2051,127,125,0,365,176,630,34,3508
"17197881500",2573,262,87,36,256,47,682,147,4090
"17197881601",1567,46,97,33,69,0,159,26,1997
"17197881603",1471,58,872,262,436,0,605,0,3704
"17197881604",1266,112,987,72,199,86,378,27,3127
"17197881700",2375,173,68,49,324,10,374,10,3383
"17197881800",2017,145,406,123,1131,171,1884,168,6045
"17197881900",912,428,611,1008,648,185,911,351,5054
"17197882000",556,375,435,549,609,268,876,618,4286
"17197882100",963,404,178,101,736,357,1543,640,4922
"17197882200",2355,587,433,37,936,233,2183,439,7203
"17197882300",2268,645,318,25,809,216,1256,388,5925
"17197882400",444,571,1342,215,811,269,1099,682,5433
"17197882500",324,78,845,798,112,153,325,124,2759
"17197882601",2501,186,108,109,512,12,1330,0,4758
"17197882602",1170,628,261,249,380,580,871,674,4813
"17197882701",1785,116,135,5,270,93,744,102,3250
"17197882702",1579,229,942,11,120,62,424,136,3503
"17197882801",1928,153,86,58,144,67,709,79,3224
"17197882802",1115,176,953,299,393,49,446,20,3451
"17197882900",1817,253,25,17,192,32,783,62,3181
"17197883000",1009,240,1223,119,457,63,636,116,3863
"17197883100",1511,347,1687,347,316,42,655,163,5068
"17197883206",3100,295,520,11,483,13,481,93,4996
"17197883208",2118,220,158,51,371,145,352,115,3530
"17197883209",2411,26,262,11,486,0,446,0,3642
"17197883210",1939,84,259,0,185,0,88,0,2555
"17197883211",5078,174,355,22,374,0,902,0,6905
"17197883212",4478,288,565,0,399,103,534,24,6391
"17197883213",4609,431,126,0,313,0,277,33,5789
"17197883214",2061,126,70,7,397,0,332,31,3024
"17197883215",7240,44,992,14,1619,395,1994,350,12648
"17197883216",2567,24,131,0,108,23,189,39,3081
"17197883303",3610,7,8,0,116,17,79,17,3854
"17197883304",1630,157,0,0,0,0,41,43,1871
"17197883305",2781,14,0,0,83,0,93,0,2971
"17197883306",3351,207,39,0,148,0,168,91,4004
"17197883307",3453,298,64,46,202,38,330,0,4431
"17197883401",3077,457,74,0,117,11,270,59,4065
"17197883402",1759,260,13,0,138,39,158,75,2442
"17197883504",4323,57,494,23,28,0,35,0,4960
"17197883505",6818,390,656,121,551,14,646,0,9196
"17197883507",3714,233,26,0,30,0,112,0,4115
"17197883509",3725,166,0,17,138,0,236,0,4282
"17197883510",4961,140,0,0,143,25,347,25,5641
"17197883511",4021,220,52,0,263,0,245,7,4808
"17197883513",4525,515,6,0,346,22,261,0,5675
"17197883514",6554,174,227,0,476,0,407,27,7865
"17197883515",3753,80,0,0,114,0,158,0,4105
"17197883516",5960,553,245,0,210,0,119,0,7087
"17197883517",2953,48,1,1,139,28,271,0,3441
"17197883519",5307,152,0,0,97,0,402,0,5958
"17197883521",3319,80,19,16,154,67,127,12,3794
"17197883522",3118,74,0,0,119,0,97,0,3408
"17197883602",4163,219,541,0,326,68,372,99,5788
"17197883603",1044,87,1650,216,83,87,15,106,3288
"17197883605",127,49,2154,871,88,67,0,25,3381
"17197883606",844,14,2161,276,335,43,181,49,3903
"17197883700",1725,379,251,109,413,9,592,11,3489
"17197883803",512,5,1507,590,136,98,192,0,3040
"17197883804",1472,200,488,0,178,327,234,295,3194
"17197883806",2277,397,821,49,192,29,279,0,4044
"17197883808",1499,99,256,17,50,23,110,0,2054
"17197883809",2270,187,336,13,13,12,35,32,2898
"17197883810",2206,80,1147,57,130,0,59,0,3679
"17197883811",2325,89,285,219,107,75,226,16,3342
"17197883902",5311,414,129,0,351,9,492,117,6823
"17197883903",1849,63,9,0,57,7,146,7,2138
"17197883904",4225,196,0,0,11,0,129,0,4561
"17197884003",3706,346,0,4,57,0,35,0,4148
"17197884004",2430,370,13,0,40,20,140,29,3042
"17197884005",1157,140,0,0,35,16,31,10,1389
"17197884006",1818,268,0,0,33,10,73,0,2202
"17197884101",2293,98,205,2,304,174,608,10,3694
"17197884103",1566,315,365,202,768,0,755,154,4125
"17197980000",0,0,0,0,0,0,0,0,0
"17197980100",87,0,0,4,49,5,36,0,181
"17199020100",2949,466,195,114,17,41,79,0,3861
"17199020201",4459,948,104,23,25,105,98,95,5857
"17199020202",1920,296,12,100,226,26,101,23,2704
"17199020300",4008,459,119,0,45,6,64,0,4701
"17199020400",2659,958,69,68,28,13,0,49,3844
"17199020500",2685,468,0,0,0,5,52,36,3246
"17199020600",3386,279,29,0,151,46,82,0,3973
"17199020700",3694,902,26,3,127,122,39,46,4959
"17199020800",6003,826,0,0,33,13,29,0,6904
"17199020900",3854,201,478,0,210,19,46,8,4816
"17199021000",3362,756,221,202,135,191,98,4,4969
"17199021100",1973,747,9,117,98,24,34,95,3097
"17199021200",3629,644,75,142,176,8,45,0,4719
"17199021300",4413,267,46,38,18,0,67,0,4849
"17199021400",3239,202,29,0,0,32,107,0,3609
"17201000101",3814,684,75,88,111,52,88,76,4988
"17201000103",2067,406,15,13,143,53,58,122,2877
"17201000104",2346,395,27,0,68,41,176,110,3163
"17201000105",3431,257,69,28,130,30,113,9,4067
"17201000200",2606,793,12,12,38,52,51,20,3584
"17201000300",2956,615,219,0,79,56,55,16,3996
"17201000401",1551,78,85,0,221,22,122,5,2084
"17201000402",2374,50,202,7,141,0,138,0,2912
"17201000403",2659,402,468,77,269,31,137,26,4069
"17201000501",3660,67,359,254,173,0,614,14,5141
"17201000502",2200,345,354,138,246,48,424,113,3868
"17201000504",5346,350,388,14,470,130,453,0,7151
"17201000506",3656,96,136,64,279,0,239,14,4484
"17201000507",1994,267,335,115,431,210,251,183,3786
"17201000510",2579,152,93,2,286,0,68,75,3255
"17201000511",1698,104,304,11,506,75,345,0,3043
"17201000512",3792,317,622,15,464,21,304,21,5556
"17201000513",3013,186,202,0,156,43,39,0,3639
"17201000514",2958,201,128,0,197,6,202,59,3751
"17201000600",3463,414,140,45,92,30,365,0,4549
"17201000700",2458,257,110,14,206,78,157,25,3305
"17201000800",1343,592,185,208,116,113,289,212,3058
"17201001000",423,279,110,614,116,461,170,141,2314
"17201001100",425,277,195,125,50,50,38,67,1227
"17201001200",964,758,104,178,259,168,634,414,3479
"17201001300",1025,412,275,494,249,319,342,476,3592
"17201001400",2277,718,107,303,387,4,535,42,4373
"17201001500",3460,794,242,34,300,379,631,892,6732
"17201001600",3389,860,731,510,205,54,493,202,6444
"17201001700",2431,248,168,268,278,110,783,163,4449
"17201001800",2153,1049,474,602,644,452,634,545,6553
"17201001900",2215,505,410,12,251,9,751,56,4209
"17201002000",1409,727,43,97,49,229,161,604,3319
"17201002100",422,468,164,662,78,251,52,178,2275
"17201002200",950,419,678,587,795,91,912,357,4789
"17201002301",1258,360,568,295,101,84,398,76,3140
"17201002302",944,168,46,11,44,62,272,67,1614
"17201002400",165,500,912,527,99,60,117,295,2675
"17201002500",277,529,1070,1845,116,144,98,473,4552
"17201002600",338,394,591,997,20,140,105,209,2794
"17201002700",995,616,452,265,448,220,1175,754,4925
"17201002800",412,275,163,299,335,229,613,467,2793
"17201002900",482,306,192,115,24,69,1,87,1276
"17201003000",1388,140,17,91,95,0,79,73,1883
"17201003100",1544,686,580,728,131,297,272,501,4739
"17201003200",912,325,1189,991,162,166,399,349,4493
"17201003300",1527,593,590,565,203,363,601,401,4843
"17201003400",3377,437,406,157,473,0,839,20,5709
"17201003500",1989,75,386,0,80,0,159,0,2689
"17201003601",1120,365,51,130,19,0,72,19,1776
"17201003602",2251,342,550,665,138,26,427,26,4425
"17201003604",1712,316,447,224,81,0,295,0,3075
"17201003605",912,274,214,132,52,16,38,4,1642
"17201003606",1653,234,313,466,118,0,419,95,3298
"17201003705",4106,183,98,32,308,3,274,23,5027
"17201003706",4629,397,468,0,946,67,651,67,7225
"17201003707",2277,491,448,57,379,89,514,122,4377
"17201003708",1318,506,435,205,322,227,358,356,3727
"17201003709",934,352,141,43,266,51,400,20,2207
"17201003710",2104,47,79,16,170,0,310,0,2726
"17201003711",3556,360,209,0,102,210,186,0,4623
"17201003801",5119,505,198,17,252,36,185,0,6312
"17201003805",6437,634,22,0,453,0,394,55,7995
"17201003806",4264,204,141,0,61,0,180,0,4850
"17201003807",6090,371,409,0,695,8,297,0,7870
"17201003808",3464,186,63,0,147,0,306,8,4174
"17201003809",4196,392,184,2,66,0,308,0,5148
"17201003901",4186,232,144,34,179,5,59,0,4839
"17201003903",5610,107,35,0,139,51,90,0,6032
"17201003904",4330,216,66,0,265,0,17,0,4894
"17201004001",7698,893,59,38,202,1,361,246,9498
"17201004002",5839,397,59,0,106,0,239,0,6640
"17201004003",1321,500,87,0,193,51,212,285,2649
"17201004100",4649,267,6,6,55,0,41,0,5024
"17201004200",5373,269,110,14,503,0,148,6,6423
"17201004300",4717,235,0,0,134,16,127,0,5229
"17201980000",0,0,0,0,0,0,0,0,0
"17203030100",2315,137,8,0,46,0,37,0,2543
"17203030200",2671,203,0,0,26,0,35,4,2939
"17203030300",2793,116,0,0,22,34,78,0,3043
"17203030400",4937,419,0,2,101,1,22,23,5505
"17203030501",6969,304,153,4,262,28,173,4,7897
"17203030502",2070,447,0,0,115,4,23,0,2659
"17203030601",4944,638,0,52,64,32,50,27,5807
"17203030602",3263,96,0,0,25,0,21,1,3406
"17203030700",3973,504,5,22,40,16,83,15,4658
"18001030100",3967,523,10,0,127,0,89,23,4739
"18001030200",3717,754,13,2,135,51,366,198,5236
"18001030300",4430,605,0,159,64,18,311,10,5597
"18001030400",2898,429,0,0,13,0,186,0,3526
"18001030500",4455,1578,0,0,17,0,19,0,6069
"18001030600",2760,441,0,9,94,14,150,33,3501
"18001030700",4941,1634,0,15,46,5,37,5,6683
"18003000100",1853,266,21,0,129,107,49,73,2498
"18003000300",2344,333,113,9,205,215,184,52,3455
"18003000400",2094,249,146,46,32,6,82,14,2669
"18003000500",1254,409,123,79,307,428,419,28,3047
"18003000600",1104,484,71,90,99,82,169,22,2121
"18003000701",2209,855,48,37,51,94,81,45,3420
"18003000704",1594,188,158,71,420,38,140,19,2628
"18003000800",3119,353,71,21,127,104,132,15,3942
"18003000900",2027,553,145,23,181,48,296,67,3340
"18003001000",772,275,0,5,18,22,41,16,1149
"18003001100",1292,311,39,55,59,28,62,0,1846
"18003001200",423,342,23,84,32,84,0,51,1039
"18003001300",314,100,133,256,146,23,21,0,993
"18003001600",666,529,420,269,50,420,222,256,2832
"18003001700",446,342,439,517,45,90,274,344,2497
"18003002000",1155,682,289,190,108,156,147,159,2886
"18003002100",1032,763,21,256,144,166,282,250,2914
"18003002200",2119,775,321,348,270,163,460,129,4585
"18003002300",639,516,1590,737,581,775,471,718,6027
"18003002500",2463,175,91,42,192,120,251,141,3475
"18003002600",1564,697,328,545,300,243,389,133,4199
"18003002800",424,71,849,873,59,144,362,146,2928
"18003002900",240,486,896,429,196,257,206,265,2975
"18003003000",520,371,1114,1287,436,183,733,273,4917
"18003003100",957,659,386,562,103,357,368,447,3839
"18003003200",4473,209,274,359,479,0,744,48,6586
"18003003301",2099,374,109,24,223,69,101,0,2999
"18003003304",2498,376,174,204,353,202,167,64,4038
"18003003400",3184,558,316,191,147,64,55,95,4610
"18003003500",1859,378,347,342,429,210,91,8,3664
"18003003600",1816,441,1662,890,453,391,486,135,6274
"18003003700",1665,195,134,244,108,28,122,8,2504
"18003003800",1649,407,368,332,67,51,33,46,2953
"18003003901",2590,418,129,56,133,104,203,29,3662
"18003003902",1318,349,451,217,211,141,151,263,3101
"18003004000",598,68,1545,617,251,63,384,37,3563
"18003004101",1530,93,166,225,108,15,67,10,2214
"18003004103",3212,532,290,83,498,472,203,14,5304
"18003004300",367,350,841,303,270,266,228,221,2846
"18003004400",448,492,749,819,400,365,585,536,4394
"18003010100",4494,484,9,0,8,0,71,0,5066
"18003010201",6348,170,110,0,212,31,137,21,7029
"18003010202",5485,422,65,0,80,0,83,0,6135
"18003010304",5796,458,67,39,178,0,19,0,6557
"18003010305",5392,108,335,0,614,1,157,1,6608
"18003010306",5117,270,18,0,158,21,122,28,5734
"18003010307",4496,229,93,0,648,0,127,0,5593
"18003010308",4966,52,177,0,301,66,282,74,5918
"18003010400",3690,16,0,0,42,0,107,0,3855
"18003010500",2428,139,0,0,110,16,45,0,2738
"18003010601",2975,81,125,7,301,0,178,18,3685
"18003010602",3056,484,122,0,109,24,271,0,4066
"18003010603",1494,100,0,0,54,4,7,0,1659
"18003010604",1594,939,0,0,172,123,186,447,3461
"18003010705",3747,434,138,45,261,0,248,0,4873
"18003010706",3468,407,291,118,429,51,291,22,5077
"18003010707",4178,330,228,26,384,32,101,18,5297
"18003010803",3769,162,334,150,307,52,158,10,4942
"18003010804",3476,208,128,84,319,79,80,19,4393
"18003010807",3587,245,393,18,196,89,173,89,4790
"18003010808",4561,107,205,0,195,100,169,0,5337
"18003010809",4307,295,478,93,365,9,61,0,5608
"18003010811",4229,321,212,59,119,1,350,1,5292
"18003010812",3942,75,210,0,45,0,25,35,4332
"18003010813",3254,438,155,23,298,57,188,105,4518
"18003010815",3807,151,80,0,344,68,21,14,4485
"18003010816",4168,86,402,0,253,0,5,0,4914
"18003010817",3553,146,289,0,154,4,33,0,4179
"18003010819",3310,311,469,60,314,15,67,29,4575
"18003010821",2999,228,601,347,397,3,69,0,4644
"18003010900",5811,678,0,1,71,0,36,0,6597
"18003011000",2396,153,0,0,0,0,19,0,2568
"18003011100",2531,425,0,1,22,2,0,1,2982
"18003011201",1230,741,101,0,85,14,89,179,2439
"18003011202",2728,249,37,0,103,186,151,186,3640
"18003011204",2607,221,220,15,58,73,336,34,3564
"18003011205",2917,254,22,0,32,0,82,0,3307
"18003011302",1296,185,1731,713,286,1165,351,52,5779
"18003011303",405,348,424,162,488,405,97,145,2474
"18003011304",1980,198,1430,503,678,105,641,45,5580
"18003011501",2830,557,140,265,98,59,399,166,4514
"18003011502",2251,257,10,7,109,22,20,17,2693
"18003011603",5550,289,113,0,283,0,0,0,6235
"18003011604",3782,290,0,8,194,0,126,0,4400
"18003011605",2396,121,54,0,122,0,89,0,2782
"18003011606",3797,282,286,1,394,21,172,0,4953
"18003011607",4421,40,153,22,657,0,318,0,5611
"18003011608",5102,133,223,246,623,0,340,0,6667
"18003011609",5461,102,104,0,809,42,37,45,6600
"18003011701",2999,198,186,0,60,0,0,0,3443
"18003011702",3029,140,35,88,114,0,393,0,3799
"18003011801",3663,260,0,1,54,3,63,23,4067
"18003011802",1655,87,0,0,36,0,158,0,1936
"18003011900",1544,172,0,0,25,0,47,0,1788
"18003980001",52,29,4,0,0,0,0,0,85
"18003980002",25,22,0,0,0,0,0,0,47
"18005010100",2754,1009,104,10,439,45,381,50,4792
"18005010200",3207,537,60,26,428,0,268,0,4526
"18005010300",2963,99,37,0,338,0,97,3,3537
"18005010400",4191,374,118,0,789,0,237,170,5879
"18005010500",4380,141,200,3,336,28,0,22,5110
"18005010600",4233,543,242,35,316,47,82,33,5531
"18005010700",2552,561,56,32,409,53,167,43,3873
"18005010800",1801,1114,116,12,907,0,101,159,4210
"18005010900",4583,125,175,0,699,0,173,0,5755
"18005011000",4427,176,4,0,98,0,39,0,4744
"18005011100",5392,1207,29,0,503,1276,537,1247,10191
"18005011200",4835,530,8,0,128,17,0,0,5518
"18005011300",4846,380,78,0,61,120,29,32,5546
"18005011400",3394,401,12,0,310,109,326,193,4745
"18005011500",6234,802,0,56,733,0,369,116,8310
"18007100100",2907,445,0,2,26,0,38,7,3425
"18007100200",2564,357,39,21,6,14,71,46,3118
"18007100300",1927,300,0,2,27,22,245,50,2573
"18009975100",2763,495,0,0,4,14,25,26,3327
"18009975200",2039,355,0,0,95,0,0,0,2489
"18009975300",2100,714,0,0,32,16,52,0,2914
"18009975400",3180,371,28,0,58,0,54,0,3691
"18011810100",3244,308,0,0,234,0,86,1,3873
"18011810200",3452,328,0,0,57,11,110,0,3958
"18011810300",5463,148,0,83,0,29,0,0,5723
"18011810400",4826,816,0,0,0,0,169,28,5839
"18011810500",5221,834,5,14,267,12,559,0,6912
"18011810601",4605,627,97,66,113,0,31,36,5575
"18011810603",11205,137,169,0,1030,0,86,12,12639
"18011810604",5090,0,27,0,222,0,54,0,5393
"18011810605",4621,147,241,0,269,0,206,3,5487
"18011810700",4063,466,0,0,69,0,47,17,4662
"18013974600",2232,392,0,0,56,10,9,35,2734
"18013974700",3058,431,0,0,31,32,0,0,3552
"18013974800",3544,419,22,0,134,63,4,7,4193
"18013974900",3752,738,0,0,27,2,108,49,4676
"18015959300",2924,308,0,0,6,0,5,3,3246
"18015959400",2167,220,0,0,26,59,14,0,2486
"18015959500",2001,228,0,1,23,31,11,1,2296
"18015959600",2553,382,13,0,59,4,290,99,3400
"18015959700",2900,274,0,0,59,0,85,111,3429
"18015959800",2482,219,0,7,0,0,25,10,2743
"18015959900",2540,274,19,0,54,0,38,79,3004
"18017950900",4131,540,10,3,148,159,0,225,5216
"18017951000",2277,317,0,0,48,44,55,87,2828
"18017951100",2582,445,0,7,36,69,37,49,3225
"18017951200",1290,425,7,30,183,62,292,121,2410
"18017951300",1666,328,176,51,574,142,448,142,3527
"18017951400",1563,360,40,5,230,8,327,54,2587
"18017951500",2100,1031,0,5,911,281,1036,407,5771
"18017951600",3828,738,33,4,635,409,884,513,7044
"18017951700",2350,309,0,2,64,1,28,0,2754
"18017951800",2787,381,5,45,317,5,327,11,3878
"18017951900",3302,214,0,0,53,15,17,1,3602
"18019050100",774,247,56,101,61,0,30,0,1269
"18019050200",1582,330,491,416,100,13,114,64,3110
"18019050303",2029,322,97,87,270,0,24,0,2829
"18019050304",2848,281,881,138,287,96,33,9,4573
"18019050305",2715,119,177,39,13,233,0,0,3296
"18019050306",1339,594,299,141,90,18,40,4,2525
"18019050401",2084,467,53,37,227,14,0,14,2896
"18019050403",2277,208,237,0,138,0,541,23,3424
"18019050404",2926,585,132,9,89,15,99,0,3855
"18019050501",1500,119,11,0,0,0,45,0,1675
"18019050503",4185,932,154,110,150,3,756,544,6834
"18019050504",1630,577,266,38,241,13,388,8,3161
"18019050603",5402,543,798,97,300,15,755,0,7910
"18019050604",4548,459,459,63,241,109,142,16,6037
"18019050605",4596,241,626,2,153,24,234,37,5913
"18019050606",3335,40,256,0,227,0,184,0,4042
"18019050701",4421,128,544,0,395,39,68,38,5633
"18019050703",5366,473,124,0,44,0,18,0,6025
"18019050704",5349,269,0,2,194,2,8,2,5826
"18019050801",5817,448,0,0,144,1,205,1,6616
"18019050803",4411,429,0,0,60,0,71,0,4971
"18019050804",3292,582,0,2,0,64,0,0,3940
"18019050902",3796,561,9,0,184,121,98,305,5074
"18019050903",2729,657,113,180,215,152,171,149,4366
"18019050904",4791,153,136,31,68,13,268,13,5473
"18019051000",4205,598,8,0,33,34,46,0,4924
"18021040100",3852,1330,10,7,68,159,51,79,5556
"18021040200",4894,1073,0,0,192,10,9,0,6178
"18021040300",3117,455,0,0,31,3,17,0,3623
"18021040400",3757,244,4,16,10,0,136,0,4167
"18021040500",3317,455,0,0,23,0,29,0,3824
"18021040600",2895,390,0,0,23,3,0,0,3311
"18023950100",2704,394,0,0,33,21,57,0,3209
"18023950200",4428,417,0,0,114,46,245,74,5324
"18023950300",4292,563,22,0,50,11,30,51,5019
"18023950400",3573,375,0,0,112,0,137,10,4207
"18023950500",3655,506,0,12,140,154,988,241,5696
"18023950600",2937,460,50,0,205,15,820,161,4648
"18023950700",2752,418,121,0,379,26,650,46,4392
"18023950800",2143,643,108,0,191,115,782,284,4266
"18025951900",2995,741,0,10,29,29,64,18,3886
"18025952000",3417,775,0,0,25,16,59,4,4296
"18025952100",2163,210,1,0,22,94,0,0,2490
"18027954300",3215,385,0,0,25,8,30,0,3663
"18027954400",2585,256,30,0,0,20,5,15,2911
"18027954500",7856,1038,0,0,67,0,32,0,8993
"18027954600",3843,341,6,0,83,0,27,0,4300
"18027954700",2772,670,21,51,212,31,623,98,4478
"18027954800",2610,909,244,6,64,0,112,323,4268
"18027954900",3807,321,10,0,67,0,57,6,4268
"18029080101",2676,158,0,1,13,0,0,0,2848
"18029080103",5285,332,0,0,71,0,75,0,5763
"18029080104",3723,208,0,0,97,15,170,0,4213
"18029080201",2233,43,0,0,17,0,19,0,2312
"18029080202",6244,368,35,0,65,0,47,0,6759
"18029080300",3756,548,25,11,43,0,14,0,4397
"18029080400",4953,744,128,34,182,24,139,17,6221
"18029080500",3294,613,0,0,29,51,27,0,4014
"18029080600",5998,703,0,3,197,120,35,0,7056
"18029080700",5350,596,0,0,41,6,0,6,5999
"18031969000",4220,716,30,126,427,12,193,0,5724
"18031969100",2753,579,4,0,35,0,35,0,3406
"18031969200",3696,817,82,18,18,46,22,0,4699
"18031969300",2666,622,39,0,0,0,71,36,3434
"18031969400",5014,355,10,1,29,0,75,7,5491
"18031969500",3082,260,0,0,47,0,7,18,3414
"18033020100",3816,420,1,0,151,14,144,0,4546
"18033020200",3471,941,25,0,98,34,111,41,4721
"18033020300",3380,753,0,0,114,0,130,4,4381
"18033020400",6328,664,11,13,177,66,184,61,7504
"18033020500",4660,1059,3,0,159,5,209,0,6095
"18033020601",2627,473,0,0,28,9,18,0,3155
"18033020602",3811,552,0,0,85,68,5,23,4544
"18033020700",3260,120,0,0,41,0,92,0,3513
"18033020800",3941,269,0,0,52,84,44,0,4390
"18035000300",181,207,644,257,35,20,0,0,1344
"18035000400",735,733,86,152,73,160,77,0,2016
"18035000500",2740,865,0,13,87,101,23,14,3843
"18035000600",612,391,30,134,92,78,41,21,1399
"18035000700",1068,2140,0,78,95,250,70,170,3871
"18035000800",2860,1193,87,57,106,131,76,58,4568
"18035000902",4,107,0,0,26,110,0,0,247
"18035000903",1442,1345,132,28,107,91,34,88,3267
"18035000904",4609,810,61,1,227,298,124,0,6130
"18035001000",1830,1950,150,71,115,136,37,106,4395
"18035001100",2380,614,70,73,100,45,14,45,3341
"18035001200",337,264,649,422,248,182,71,25,2198
"18035001300",1893,990,77,93,125,7,12,30,3227
"18035001400",1102,474,24,139,4,89,4,12,1848
"18035001500",1849,382,359,0,141,0,21,0,2752
"18035001600",1386,628,11,51,76,92,5,0,2249
"18035001700",867,361,0,76,27,32,0,17,1380
"18035002000",3219,970,251,182,442,34,244,0,5342
"18035002100",1694,487,250,286,160,25,0,8,2910
"18035002200",5260,565,35,0,107,19,166,0,6152
"18035002301",3326,339,0,0,11,15,0,0,3691
"18035002302",3602,272,2,0,65,8,47,0,3996
"18035002401",4239,448,22,22,184,121,0,0,5036
"18035002402",7772,630,133,0,275,11,147,35,9003
"18035002500",4714,658,0,3,35,3,114,3,5530
"18035002601",6412,369,165,0,187,8,82,0,7223
"18035002602",2426,340,0,0,48,0,0,0,2814
"18035002700",4430,284,0,0,96,19,37,9,4875
"18035002800",1105,730,171,158,11,119,44,20,2358
"18035002900",3836,458,86,44,82,229,8,19,4762
"18037953200",6015,331,33,1,83,0,52,59,6574
"18037953300",5491,711,16,0,140,91,294,166,6909
"18037953400",4539,283,0,0,417,0,370,21,5630
"18037953500",4693,280,0,0,48,0,170,0,5191
"18037953600",5146,436,70,0,0,0,95,0,5747
"18037953700",6531,348,0,0,0,0,42,0,6921
"18037953800",4313,721,0,18,125,428,744,547,6896
"18039000100",1732,627,30,138,180,160,368,83,3318
"18039000200",3797,2001,31,0,373,614,631,1703,9150
"18039000301",3479,366,47,0,383,0,1017,86,5378
"18039000302",4134,984,0,82,109,0,943,383,6635
"18039000400",3476,507,49,3,449,44,228,346,5102
"18039000501",4485,1052,355,40,679,312,1709,768,9400
"18039000502",3312,671,160,16,477,293,1026,287,6242
"18039000600",8418,1077,0,0,329,0,454,360,10638
"18039000700",6052,601,75,10,193,32,283,5,7251
"18039000801",3030,298,0,0,167,21,314,40,3870
"18039000802",7582,930,0,0,217,137,267,225,9358
"18039000900",7160,304,0,2,115,49,105,2,7737
"18039001000",3845,397,6,0,83,4,90,12,4437
"18039001100",4510,464,11,0,37,4,146,167,5339
"18039001200",4585,322,47,0,80,0,132,0,5166
"18039001300",6627,416,127,0,260,0,65,71,7566
"18039001400",7886,927,320,0,258,64,443,148,10046
"18039001501",2802,1436,160,273,263,121,462,192,5709
"18039001502",5190,297,69,0,385,91,263,91,6386
"18039001601",3539,540,219,0,332,59,354,85,5128
"18039001602",3667,365,311,0,253,13,445,33,5087
"18039001701",3082,230,29,112,69,6,345,25,3898
"18039001702",3775,1072,64,0,626,0,251,255,6043
"18039001801",2830,320,75,0,221,120,149,101,3816
"18039001802",5212,295,527,0,402,136,330,52,6954
"18039001901",3989,1552,221,407,547,274,1264,826,9080
"18039001902",3353,167,54,0,293,13,445,37,4362
"18039002000",5519,476,233,251,254,0,592,64,7389
"18039002101",3057,226,66,79,152,208,307,296,4391
"18039002102",2383,836,278,584,652,351,1234,596,6914
"18039002200",3752,808,1153,565,1284,334,2326,609,10831
"18039002300",1064,371,316,339,391,137,518,208,3344
"18039002400",3122,430,141,124,264,17,515,0,4613
"18039002600",1056,701,930,1469,628,212,836,555,6387
"18039002700",892,605,119,183,61,60,185,279,2384
"18039002900",3531,354,64,95,299,67,607,99,5116
"18041954000",3401,546,0,0,8,0,0,0,3955
"18041954100",1683,759,45,0,0,0,60,24,2571
"18041954200",2729,688,25,14,5,0,5,67,3533
"18041954300",2038,410,45,0,25,36,11,14,2579
"18041954400",2848,1116,149,0,45,60,0,0,4218
"18041954500",2704,493,53,2,59,20,9,0,3340
"18041954600",2664,671,49,0,55,28,36,1,3504
"18043070200",966,650,43,53,25,28,63,61,1889
"18043070301",2557,291,38,0,94,52,164,7,3203
"18043070302",2962,165,53,155,312,0,69,0,3716
"18043070400",1444,530,116,79,143,11,82,0,2405
"18043070500",1566,792,116,186,191,183,209,77,3320
"18043070600",2107,147,21,0,36,12,0,0,2323
"18043070700",1224,337,351,240,54,56,83,24,2369
"18043070801",1542,868,109,185,204,201,172,138,3419
"18043070802",3031,641,129,110,75,162,95,66,4309
"18043070901",4938,566,400,0,64,0,42,0,6010
"18043070902",1027,416,9,16,79,0,86,0,1633
"18043071003",6157,224,163,0,130,0,66,0,6740
"18043071004",3810,128,0,0,61,18,22,0,4039
"18043071005",4511,204,111,0,474,0,32,23,5355
"18043071006",2696,726,233,147,201,19,45,330,4397
"18043071007",3655,190,330,61,132,32,29,0,4429
"18043071101",5248,212,10,0,129,8,47,0,5654
"18043071103",3988,57,12,1,86,0,0,0,4144
"18043071104",4321,152,5,5,68,0,43,0,4594
"18043071200",2097,160,9,0,89,0,0,1,2356
"18045957600",2539,228,0,0,42,7,142,2,2960
"18045957700",1882,416,26,5,28,13,32,7,2409
"18045957800",3353,296,6,14,83,4,13,0,3769
"18045957900",3706,539,0,0,42,0,72,14,4373
"18045958000",2915,390,13,2,36,101,47,64,3568
"18047960100",4350,482,7,0,47,0,51,6,4943
"18047969600",5267,699,0,0,57,74,61,0,6158
"18047969700",2203,445,0,0,13,0,5,38,2704
"18047969800",5043,439,29,0,118,0,21,0,5650
"18047969900",2651,881,0,0,22,58,29,25,3666
"18049953000",2883,421,0,0,12,62,14,0,3392
"18049953100",4327,1150,0,0,79,37,137,114,5844
"18049953200",2564,763,128,0,72,40,65,6,3638
"18049953300",1680,330,62,0,36,5,8,5,2126
"18049953400",2397,293,0,1,9,0,30,0,2730
"18049953500",2330,260,0,0,425,43,526,49,3633
"18051050100",3404,374,17,0,154,0,62,0,4011
"18051050200",7453,669,53,13,116,0,5,0,8309
"18051050300",4275,896,29,0,53,19,20,43,5335
"18051050401",3036,245,17,10,46,44,14,0,3412
"18051050402",3763,308,76,0,73,4,36,0,4260
"18051050501",2389,534,14,0,94,0,69,0,3100
"18051050502",3390,396,230,75,382,60,230,0,4763
"18053000100",2014,606,338,228,209,42,42,73,3552
"18053000200",1413,896,848,484,250,86,264,135,4376
"18053000400",2235,1097,226,118,187,188,194,33,4278
"18053000500",3987,384,98,25,318,113,32,22,4979
"18053000600",1874,550,52,32,68,29,231,50,2886
"18053000700",2062,856,307,246,36,25,78,170,3780
"18053000800",2350,1045,538,294,59,0,242,0,4528
"18053000900",1453,552,106,75,105,90,153,82,2616
"18053010100",4831,482,15,0,254,22,155,130,5889
"18053010200",3778,399,1,14,69,2,32,0,4295
"18053010300",3397,616,8,0,109,54,34,0,4218
"18053010400",2339,555,0,0,55,12,36,12,3009
"18053010500",4191,835,35,0,234,97,109,87,5588
"18053010600",2809,393,85,0,12,12,58,0,3369
"18053010700",3717,376,21,22,4,27,14,7,4188
"18053010800",4223,468,0,0,168,0,65,0,4924
"18055954701",4207,763,12,0,152,0,0,0,5134
"18055954702",3222,337,5,0,0,0,0,0,3564
"18055954800",2663,475,0,0,29,5,31,5,3208
"18055954900",4555,469,0,6,109,3,76,8,5226
"18055955000",2292,752,0,0,0,8,31,0,3083
"18055955100",2589,512,0,0,36,0,0,0,3137
"18055955200",1639,366,23,0,63,0,19,52,2162
"18055955300",3450,340,0,0,61,2,36,14,3903
"18055955400",2891,441,5,0,83,0,97,0,3517
"18057110100",7990,926,654,364,740,220,645,39,11578
"18057110201",3760,355,10,8,29,12,35,46,4255
"18057110202",5758,222,0,0,171,36,357,0,6544
"18057110300",11686,679,155,4,480,483,177,434,14098
"18057110401",2926,89,0,0,285,0,300,0,3600
"18057110403",7927,615,512,0,1049,21,212,0,10336
"18057110404",4384,138,247,11,152,0,68,15,5015
"18057110505",6734,163,85,0,217,31,105,88,7423
"18057110506",8744,326,243,8,474,53,424,87,10359
"18057110507",10665,189,343,0,456,112,157,67,11989
"18057110508",7661,254,145,118,468,71,289,90,9096
"18057110509",4520,333,177,0,420,0,441,81,5972
"18057110511",4895,186,124,0,179,0,48,0,5432
"18057110512",4745,94,105,0,62,36,53,16,5111
"18057110600",3252,591,0,19,46,6,4,40,3958
"18057110700",2410,537,47,7,135,37,119,31,3323
"18057110804",11852,585,448,0,819,0,341,0,14045
"18057110805",7247,146,177,0,581,0,34,0,8185
"18057110806",10418,214,1044,29,1214,0,372,0,13291
"18057110807",4644,180,338,10,349,0,29,0,5550
"18057110808",15937,765,859,15,1950,261,678,0,20465
"18057110809",8599,445,218,41,587,19,429,153,10491
"18057110810",5472,102,426,0,350,12,27,0,6389
"18057110811",3452,130,245,5,338,6,256,0,4432
"18057110812",5403,93,217,36,729,56,566,13,7113
"18057110903",8097,309,370,0,2776,0,691,33,12276
"18057110904",4373,6,122,0,236,0,47,6,4790
"18057110905",2551,285,38,0,633,22,235,0,3764
"18057110906",5638,165,185,0,382,0,161,0,6531
"18057110907",4952,59,84,0,176,0,138,0,5409
"18057110908",8786,314,256,0,2036,108,454,0,11954
"18057111001",9618,201,151,16,1780,0,306,33,12105
"18057111003",4340,65,38,0,256,27,33,0,4759
"18057111004",2735,117,103,0,152,0,87,0,3194
"18057111006",3445,129,64,26,327,70,152,0,4213
"18057111007",2438,561,122,0,265,117,73,282,3858
"18057111008",4083,207,373,93,520,94,49,18,5437
"18057111101",3499,20,0,0,294,0,106,0,3919
"18057111102",6145,323,391,63,936,0,138,12,8008
"18059410100",3755,402,0,19,13,0,53,0,4242
"18059410200",8951,1179,519,50,419,12,438,96,11664
"18059410300",10305,339,0,1,400,22,220,0,11287
"18059410400",5634,934,0,84,98,33,0,0,6783
"18059410500",2271,335,0,0,72,19,18,19,2734
"18059410600",4465,451,37,0,124,13,112,45,5247
"18059410700",5408,230,0,0,47,0,0,0,5685
"18059410800",8600,279,0,0,141,42,100,23,9185
"18059410900",7489,376,319,0,256,19,62,20,8541
"18059411000",5008,469,266,0,88,12,109,0,5952
"18061060100",5346,796,0,0,129,22,55,0,6348
"18061060200",6719,847,126,0,67,28,11,0,7798
"18061060300",4281,556,0,2,104,43,61,75,5122
"18061060400",5724,1180,0,0,35,170,45,99,7253
"18061060500",5134,467,0,0,32,28,80,0,5741
"18061060600",6123,662,28,0,95,2,188,0,7098
"18063210102",14223,216,1636,0,1142,0,317,40,17574
"18063210103",3524,84,64,0,14,0,166,0,3852
"18063210104",6878,187,801,0,381,0,64,0,8311
"18063210201",3410,250,146,197,186,43,72,0,4304
"18063210202",7277,333,67,51,133,48,345,51,8305
"18063210300",5788,349,137,0,95,23,69,10,6471
"18063210400",4643,286,41,0,42,26,25,0,5063
"18063210501",6133,177,0,0,69,0,32,0,6411
"18063210502",4819,788,2,2,236,0,141,0,5988
"18063210603",7388,194,642,0,445,101,217,0,8987
"18063210604",11442,244,1014,31,596,27,299,41,13694
"18063210605",9769,254,54,0,447,8,151,0,10683
"18063210606",8986,1017,1240,192,1275,75,1372,471,14628
"18063210607",2888,618,527,0,151,494,201,106,4985
"18063210608",2635,193,81,0,262,0,160,0,3331
"18063210700",7739,359,121,0,441,0,76,0,8736
"18063210801",3232,60,133,0,188,0,148,0,3761
"18063210802",3799,204,10,0,107,3,51,0,4174
"18063210900",3075,352,79,0,57,2,83,0,3648
"18063211000",5108,553,67,0,161,21,150,0,6060
"18063211100",3059,492,18,5,23,0,0,0,3597
"18065975500",2699,477,0,0,4,0,0,0,3180
"18065975600",3628,440,2,0,124,4,98,1,4297
"18065975700",3908,497,1,0,9,7,89,0,4511
"18065975800",3601,760,35,0,24,18,6,18,4462
"18065975900",3659,657,0,0,60,0,0,0,4376
"18065976000",1956,576,64,7,112,20,81,0,2816
"18065976100",1906,511,9,0,114,0,0,13,2553
"18065976300",1088,503,27,23,0,8,0,0,1649
"18065976400",3382,984,19,10,53,26,0,0,4474
"18065976500",1818,698,12,42,20,19,81,98,2788
"18065976600",1802,296,2,0,64,23,25,0,2212
"18065976700",3701,741,0,0,28,0,2,0,4472
"18065976800",3987,530,4,3,17,13,6,0,4560
"18067000200",1121,541,910,578,229,20,248,20,3667
"18067000300",1847,697,137,24,82,100,48,0,2935
"18067000400",2028,654,93,96,75,333,23,39,3341
"18067000500",2478,709,45,101,41,116,103,80,3673
"18067000600",1846,315,364,23,48,32,57,0,2685
"18067000700",3980,475,210,59,140,37,0,0,4901
"18067000800",4999,363,456,23,54,40,272,39,6246
"18067000900",2733,1073,93,161,136,54,157,45,4452
"18067001000",1415,172,42,88,24,8,41,8,1798
"18067001100",3068,480,262,508,213,114,248,11,4904
"18067001200",1794,1239,190,170,125,118,49,131,3816
"18067001300",1639,232,68,167,328,52,21,0,2507
"18067001400",3775,624,304,0,23,77,179,0,4982
"18067001500",2735,509,155,167,257,0,96,19,3938
"18067010100",5839,513,0,0,149,11,76,10,6598
"18067010200",4448,1181,10,0,60,0,138,20,5857
"18067010300",3304,283,69,0,134,14,92,0,3896
"18067010400",3462,138,10,0,138,12,32,0,3792
"18067010500",4638,311,24,0,120,6,43,0,5142
"18067010600",3919,485,120,6,284,0,50,0,4864
"18069961300",4257,261,5,5,92,31,30,7,4688
"18069961400",3091,524,12,0,7,14,4,18,3670
"18069961500",3562,606,3,42,36,3,36,15,4303
"18069961600",2571,587,0,0,103,0,125,12,3398
"18069961700",4156,284,7,11,10,1,24,2,4495
"18069961800",2646,550,10,0,218,58,84,36,3602
"18069961900",3876,360,41,11,112,0,105,0,4505
"18069962000",3435,506,7,0,58,5,43,5,4059
"18069962100",2932,240,0,0,23,23,35,39,3292
"18071967500",6465,613,39,0,324,16,105,16,7578
"18071967600",2762,496,0,0,307,17,152,3,3737
"18071967700",3160,354,0,0,124,49,129,91,3907
"18071967800",1358,601,61,32,296,92,164,30,2634
"18071967901",2923,824,13,3,684,392,858,628,6325
"18071967902",2632,303,90,13,8,19,81,21,3167
"18071968000",4799,368,0,0,82,66,102,0,5417
"18071968100",3445,575,0,0,59,0,48,0,4127
"18071968200",3652,520,0,0,46,0,39,0,4257
"18071968300",2777,539,0,0,70,31,91,0,3508
"18073100400",1179,82,0,0,88,0,302,0,1651
"18073100800",4372,572,7,0,67,0,305,3,5326
"18073100901",2870,407,15,0,35,0,96,0,3423
"18073100902",5502,332,147,0,120,0,207,0,6308
"18073101000",5848,184,0,0,11,0,681,3,6727
"18073101100",3297,457,0,0,103,37,79,90,4063
"18073101200",2881,381,59,0,56,4,34,30,3445
"18073101300",3064,249,2,0,10,0,30,0,3355
"18075962700",3104,225,34,0,63,0,18,0,3444
"18075962800",2576,545,0,2,11,21,46,4,3205
"18075962900",2188,520,20,0,39,4,1,20,2792
"18075963000",1889,263,0,0,39,3,146,0,2340
"18075963100",3511,691,13,0,34,0,197,102,4548
"18075963200",2323,358,0,0,17,2,5,4,2709
"18075963300",1785,613,9,0,6,0,22,0,2435
"18077966000",3432,352,51,12,92,0,0,0,3939
"18077966100",4841,880,0,0,81,240,45,291,6378
"18077966200",4309,481,16,0,36,0,18,0,4860
"18077966300",1901,753,74,16,32,0,36,34,2846
"18077966400",4352,1002,182,5,44,12,53,192,5842
"18077966500",4254,710,19,5,169,52,24,0,5233
"18077966600",1590,96,9,0,69,14,23,0,1801
"18079960200",3947,725,36,0,0,0,0,35,4743
"18079960301",3090,343,0,0,50,0,0,0,3483
"18079960302",3351,1185,27,17,103,11,190,79,4963
"18079960400",5563,995,21,136,89,114,57,14,6989
"18079960500",2140,546,31,1,27,94,98,0,2937
"18079960600",4648,421,0,0,39,0,143,0,5251
"18081610100",10686,1290,198,265,1685,77,275,578,15054
"18081610201",4126,369,0,0,98,0,74,0,4667
"18081610202",7234,1429,454,0,990,166,359,667,11299
"18081610300",2612,720,0,0,48,147,0,115,3642
"18081610401",4523,883,364,76,306,103,304,33,6592
"18081610403",3700,1079,216,64,235,77,72,55,5498
"18081610404",4050,403,93,0,28,0,77,18,4669
"18081610500",7311,567,26,0,89,106,103,0,8202
"18081610603",6157,103,1,0,95,0,14,26,6396
"18081610604",7623,411,0,0,345,17,231,0,8627
"18081610605",4886,232,113,0,91,0,49,0,5371
"18081610606",4901,405,0,0,42,43,32,0,5423
"18081610701",11596,391,38,0,276,23,326,0,12650
"18081610702",4890,419,0,0,46,89,0,0,5444
"18081610801",6551,166,0,0,29,0,0,0,6746
"18081610802",5638,941,76,0,140,100,214,21,7130
"18081610900",3838,512,104,18,65,282,0,262,5081
"18081611000",2493,607,0,138,69,0,37,0,3344
"18081611100",3047,297,14,0,17,61,24,1,3461
"18081611200",3811,679,1,39,263,9,191,42,5035
"18081611300",2671,866,31,56,101,0,127,168,4020
"18081611400",6425,560,20,0,128,35,99,15,7282
"18083955000",2564,498,2,1,0,0,0,0,3065
"18083955100",2326,181,0,0,31,7,12,7,2564
"18083955200",5211,334,37,3,143,43,65,42,5878
"18083955300",1292,559,121,41,4,7,0,0,2024
"18083955400",1128,332,19,8,156,16,146,0,1805
"18083955500",2657,567,93,0,27,122,12,61,3539
"18083955600",2466,493,30,84,0,20,26,0,3119
"18083955700",3670,907,105,0,37,0,79,0,4798
"18083955800",3187,248,0,1,64,0,26,22,3548
"18083955900",4589,514,0,218,153,48,22,55,5599
"18085960900",2450,447,3,0,19,0,16,0,2935
"18085961000",3584,337,83,0,162,31,243,2,4442
"18085961100",4932,698,16,80,157,51,437,244,6615
"18085961200",4466,677,3,0,669,197,578,183,6773
"18085961300",2667,469,0,15,107,10,144,10,3422
"18085961400",2497,447,4,12,159,9,117,9,3254
"18085961500",2403,404,0,0,22,8,22,0,2859
"18085961600",1340,53,0,0,5,8,0,0,1406
"18085961700",3512,187,0,0,231,356,323,356,4965
"18085961800",4547,460,143,10,500,0,713,0,6373
"18085961900",1915,447,19,34,198,91,485,176,3365
"18085962000",3253,817,0,46,445,50,225,55,4891
"18085962100",6199,399,56,16,369,191,412,229,7871
"18085962200",3966,535,20,0,198,2,209,74,5004
"18085962300",4600,159,0,2,333,0,237,0,5331
"18085962400",2714,200,2,0,299,16,293,0,3524
"18085962500",2041,365,0,0,59,25,12,10,2512
"18085962600",2364,327,0,0,8,30,42,14,2785
"18085962700",2932,651,0,3,8,29,11,19,3653
"18087970100",4738,932,0,1,160,40,514,131,6516
"18087970200",4146,751,7,3,70,111,314,59,5461
"18087970300",6346,1479,1,0,31,4,77,61,7999
"18087970401",3761,623,0,0,0,0,0,0,4384
"18087970402",4118,523,0,0,200,27,124,0,4992
"18087970500",3265,503,0,0,32,0,84,0,3884
"18087970600",2254,171,0,0,31,3,15,3,2477
"18087970700",2337,555,0,0,94,0,31,0,3017
"18089010100",1425,204,2272,429,128,9,38,0,4505
"18089010201",369,273,2651,1838,44,209,114,12,5510
"18089010203",50,0,1441,1152,46,54,94,27,2864
"18089010205",51,18,371,731,50,0,77,13,1311
"18089010302",49,93,2111,1119,18,0,44,194,3628
"18089010304",253,0,1660,1042,56,129,329,129,3598
"18089010400",0,0,1707,1120,0,22,63,6,2918
"18089010500",62,49,341,414,20,23,27,41,977
"18089010600",66,21,421,640,106,11,115,0,1380
"18089010900",9,0,420,419,3,0,3,0,854
"18089011000",0,4,1068,504,80,0,19,17,1692
"18089011100",19,86,2820,1601,31,38,30,21,4646
"18089011200",21,22,2952,1045,29,107,13,35,4224
"18089011300",21,25,1004,920,15,30,23,30,2068
"18089011400",5,53,504,737,0,11,0,71,1381
"18089011500",172,109,1757,692,222,0,272,0,3224
"18089011600",0,0,1492,693,2,0,2,0,2189
"18089011700",40,19,490,204,24,9,7,1,794
"18089011800",0,0,957,568,18,0,0,20,1563
"18089011900",37,13,644,993,5,3,24,16,1735
"18089012000",3,9,581,315,0,0,0,55,963
"18089012100",37,0,479,440,0,7,0,7,970
"18089012200",5,0,601,1017,0,0,11,0,1634
"18089012300",248,238,1268,1468,59,9,106,40,3436
"18089012400",189,165,1820,1881,371,175,273,214,5088
"18089012500",371,103,2998,1188,70,55,208,28,5021
"18089012600",122,44,1307,961,219,24,285,33,2995
"18089012700",167,154,1665,940,196,55,149,94,3420
"18089012800",90,47,1226,917,46,0,64,76,2466
"18089020100",2921,356,47,49,1238,214,1527,280,6632
"18089020200",1450,210,40,27,392,264,500,266,3149
"18089020300",2654,603,118,57,1365,1337,2120,1404,9658
"18089020400",1382,498,238,277,1673,1045,2280,1258,8651
"18089020500",792,376,547,296,1088,527,1472,694,5792
"18089020600",194,420,303,778,196,255,202,275,2623
"18089020700",1140,235,1454,832,946,319,1241,440,6607
"18089020800",418,139,2055,847,648,290,757,210,5364
"18089020900",2127,177,611,136,513,136,544,170,4414
"18089021000",3008,601,371,223,771,542,1388,606,7510
"18089021100",1463,246,325,135,749,30,919,92,3959
"18089021300",1337,152,1297,185,900,45,1061,45,5022
"18089021400",2052,224,596,776,544,437,1261,479,6369
"18089021500",1149,145,179,53,225,387,306,404,2848
"18089021600",2159,260,382,1,462,187,1012,232,4695
"18089021700",2316,605,583,209,637,309,1104,406,6169
"18089021800",2043,335,513,343,502,81,692,224,4733
"18089021900",3292,359,588,82,891,227,1310,392,7141
"18089022000",2646,399,867,341,592,128,819,92,5884
"18089030100",0,0,178,745,15,100,23,115,1176
"18089030200",185,34,394,538,356,61,522,88,2178
"18089030300",38,129,786,1235,185,200,223,341,3137
"18089030400",576,415,353,334,1495,223,1823,408,5627
"18089030500",1017,495,572,548,1017,706,1690,1068,7113
"18089030600",1933,638,823,358,880,587,1938,759,7916
"18089030700",419,80,557,109,683,41,885,34,2808
"18089030800",744,229,895,689,1257,610,1918,814,7156
"18089030900",846,137,1267,174,793,266,1445,357,5285
"18089031000",89,20,411,604,82,66,156,86,1514
"18089040100",827,74,88,0,405,62,421,76,1953
"18089040200",1935,255,43,78,961,202,1221,324,5019
"18089040300",5613,452,463,30,559,756,629,602,9104
"18089040401",3888,287,89,22,339,29,423,21,5098
"18089040402",3285,108,248,6,786,2,318,33,4786
"18089040403",5080,243,25,0,715,13,663,29,6768
"18089040501",2378,206,409,68,327,35,338,8,3769
"18089040502",2541,230,147,12,123,16,285,8,3362
"18089040600",2843,240,0,74,458,0,382,28,4025
"18089040700",4300,147,98,8,723,53,984,38,6351
"18089040801",3087,232,20,0,527,0,600,157,4623
"18089040802",3418,96,0,0,499,14,680,14,4721
"18089040900",5904,277,28,1,687,120,619,121,7757
"18089041001",2175,128,1669,599,404,121,740,52,5888
"18089041002",3304,642,47,19,363,106,541,124,5146
"18089041100",1444,596,71,9,281,137,345,84,2967
"18089041200",1254,608,66,223,188,100,222,111,2772
"18089041302",1940,402,210,106,133,59,248,83,3181
"18089041400",1723,426,174,253,155,28,209,8,2976
"18089041500",270,255,396,532,43,81,65,172,1814
"18089041600",2823,807,83,60,528,199,1059,368,5927
"18089041700",2703,833,40,139,267,223,808,331,5344
"18089041800",4850,822,41,30,385,275,1625,327,8355
"18089041900",4252,304,15,23,177,0,482,96,5349
"18089042000",4759,771,360,0,408,34,496,59,6887
"18089042100",4659,464,317,0,451,17,943,0,6851
"18089042200",4900,906,119,0,767,0,1039,176,7907
"18089042300",4379,606,1112,17,429,18,589,137,7287
"18089042401",1678,290,3053,292,570,402,341,507,7133
"18089042402",2847,215,2551,469,617,56,984,113,7852
"18089042403",748,198,2663,483,150,173,302,240,4957
"18089042501",2858,576,1199,1730,297,46,853,10,7569
"18089042503",1424,194,816,219,268,0,386,8,3315
"18089042504",4445,371,1023,194,571,1,643,13,7261
"18089042505",2547,125,2614,281,487,139,563,176,6932
"18089042602",5504,107,197,1,459,37,796,6,7107
"18089042605",6618,383,54,0,402,54,822,54,8387
"18089042606",1987,226,347,36,468,26,524,43,3657
"18089042607",5535,80,20,0,556,194,548,2,6935
"18089042608",3816,178,0,0,779,6,795,37,5611
"18089042609",7990,243,0,16,334,180,641,170,9574
"18089042702",4164,182,550,0,307,12,341,0,5556
"18089042703",3402,83,209,10,347,245,387,234,4917
"18089042704",4103,234,67,13,387,11,484,7,5306
"18089042801",7657,224,564,14,942,20,959,1,10381
"18089042802",4863,184,0,1,231,1,481,35,5796
"18089042901",6041,78,14,0,36,98,167,98,6532
"18089042902",5411,386,58,0,471,45,456,103,6930
"18089043001",4008,298,58,11,35,5,169,12,4596
"18089043002",4903,489,11,0,225,10,353,0,5991
"18089043101",2402,235,9,17,213,0,287,12,3175
"18089043102",6398,81,57,0,372,14,357,10,7289
"18089043201",2967,336,0,0,346,22,265,55,3991
"18089043202",6858,347,146,16,469,189,396,0,8421
"18089043300",8317,384,505,0,876,30,1561,35,11708
"18089043401",6109,521,0,0,162,2,298,41,7133
"18089043403",5918,770,0,27,42,232,147,240,7376
"18089043404",1367,212,7,3,37,7,77,6,1716
"18089043405",4619,187,26,0,188,0,189,0,5209
"18089990000",0,0,0,0,0,0,0,0,0
"18091040100",667,206,352,350,32,73,30,51,1761
"18091040300",1251,640,247,113,166,220,38,100,2775
"18091040400",2610,136,180,173,66,120,166,2,3453
"18091040500",2600,332,94,214,106,45,109,11,3511
"18091040600",2805,832,496,416,117,9,29,209,4913
"18091040700",1050,87,78,194,141,78,218,78,1924
"18091040800",1956,420,166,196,272,59,224,48,3341
"18091040900",448,103,1038,617,86,88,6,0,2386
"18091041100",1890,100,130,5,95,1,60,0,2281
"18091041200",960,44,12,0,15,0,10,0,1041
"18091041300",1073,627,172,252,116,67,15,53,2375
"18091041400",1872,431,476,655,93,58,143,74,3802
"18091041500",4417,199,85,0,128,8,113,0,4950
"18091041600",5290,630,35,1,69,200,120,188,6533
"18091041700",2774,528,18,8,35,0,125,0,3488
"18091041800",5069,600,15,13,100,309,268,309,6683
"18091041900",4963,384,60,0,147,172,105,206,6037
"18091042000",1986,238,126,25,75,39,88,48,2625
"18091042100",4585,1191,63,0,435,134,582,253,7243
"18091042200",2780,414,17,33,0,30,241,62,3577
"18091042300",1098,842,4,0,43,6,200,48,2241
"18091042400",5247,1186,0,8,331,0,351,11,7134
"18091042500",4450,507,14,0,84,0,101,0,5156
"18091042600",3103,712,59,2,95,0,145,16,4132
"18091042700",4582,388,66,42,82,90,139,5,5394
"18091042800",2819,54,0,0,25,7,86,33,3024
"18091042900",3183,329,12,0,73,54,81,33,3765
"18091043000",1082,243,389,452,82,72,134,7,2461
"18091990000",0,0,0,0,0,0,0,0,0
"18093950400",3442,215,0,10,71,42,15,37,3832
"18093950500",4204,419,0,0,20,24,0,0,4667
"18093950600",6674,652,43,0,176,0,9,4,7558
"18093950700",6681,849,0,0,23,186,0,63,7802
"18093950800",2487,718,5,30,90,114,55,103,3602
"18093950900",1751,555,0,0,13,10,0,0,2329
"18093951000",2635,699,6,7,36,70,50,0,3503
"18093951100",2506,386,0,0,124,0,75,13,3104
"18093951200",4803,499,28,7,29,0,123,0,5489
"18093951300",2714,759,0,2,134,58,81,15,3763
"18095000300",1238,644,86,189,80,104,87,92,2520
"18095000400",532,372,643,545,109,155,26,60,2442
"18095000500",1241,865,566,391,158,296,238,289,4044
"18095000800",926,792,70,14,68,53,25,72,2020
"18095000900",997,599,41,78,107,30,61,61,1974
"18095001000",1521,872,21,78,131,118,84,152,2977
"18095001100",1264,329,146,67,139,11,55,36,2047
"18095001200",2239,550,107,0,59,4,72,0,3031
"18095001300",3456,396,285,109,27,77,84,0,4434
"18095001400",2855,615,103,13,104,45,145,148,4028
"18095001500",3066,485,164,32,226,12,2,37,4024
"18095001600",2452,93,72,13,28,0,11,43,2712
"18095001700",1901,286,988,686,69,9,20,17,3976
"18095001800",3587,445,261,41,196,249,195,118,5092
"18095001900",3784,1181,308,158,21,25,187,36,5700
"18095002000",2437,819,142,10,163,128,57,81,3837
"18095010100",2700,242,0,0,11,5,89,3,3050
"18095010200",3216,1066,1,0,412,70,178,35,4978
"18095010300",2746,464,0,0,16,11,68,11,3316
"18095010400",2332,318,0,0,67,24,52,0,2793
"18095010500",3049,381,6,24,45,21,28,21,3575
"18095010600",4127,896,63,10,0,1,139,216,5452
"18095010700",2835,277,0,5,56,0,0,5,3178
"18095010800",2986,229,10,32,71,22,73,0,3423
"18095010900",1788,225,0,0,67,0,86,39,2205
"18095011000",1705,188,0,0,47,0,0,1,1941
"18095011100",3376,290,0,0,107,53,22,0,3848
"18095011200",5913,211,33,28,46,29,146,29,6435
"18095011300",2019,326,18,0,148,8,10,0,2529
"18095011400",3261,449,0,0,22,71,0,8,3811
"18095011501",4207,123,27,0,79,85,0,0,4521
"18095011502",3470,132,36,0,32,10,0,0,3680
"18095011600",7,0,0,0,0,0,0,0,7
"18095011700",2152,109,0,0,102,182,0,0,2545
"18095011800",6570,533,146,14,226,9,89,0,7587
"18095011900",484,467,162,23,0,29,4,3,1172
"18095012000",1324,590,382,299,41,33,84,114,2867
"18097310103",4213,508,1512,33,480,14,33,0,6793
"18097310104",1898,222,996,66,469,0,213,0,3864
"18097310105",1738,173,1106,206,301,0,141,0,3665
"18097310106",1420,409,1647,42,381,124,306,197,4526
"18097310108",2345,109,558,52,165,0,58,0,3287
"18097310110",1159,25,935,175,246,233,110,221,3104
"18097310111",1250,133,1306,54,413,23,333,13,3525
"18097310201",1462,243,1430,165,604,15,460,15,4394
"18097310203",2118,351,916,938,740,374,683,179,6299
"18097310204",996,202,2771,381,1317,383,682,407,7139
"18097310305",1284,380,2968,766,1081,788,1171,902,9340
"18097310306",766,323,2550,983,1327,1098,1244,1243,9534
"18097310308",876,34,1349,623,494,82,400,82,3940
"18097310309",508,199,1688,755,552,189,456,175,4522
"18097310310",1843,42,1847,227,522,0,658,0,5139
"18097310311",1100,219,3201,99,333,141,310,273,5676
"18097310312",822,456,2565,402,528,356,460,768,6357
"18097320105",2716,364,603,325,144,0,121,17,4290
"18097320106",1657,77,342,50,281,81,219,62,2769
"18097320107",1397,81,49,6,72,22,6,0,1633
"18097320108",1209,287,2101,595,493,328,341,278,5632
"18097320109",1944,205,12,8,226,54,54,0,2503
"18097320202",3469,241,12,0,49,4,24,22,3821
"18097320203",2056,253,439,77,353,44,265,57,3544
"18097320204",2993,867,632,321,524,667,206,736,6946
"18097320301",2911,217,124,38,260,31,83,19,3683
"18097320303",1922,340,337,134,523,18,194,33,3501
"18097320304",5039,228,184,43,287,0,187,40,6008
"18097320400",1692,247,853,15,221,69,180,74,3351
"18097320500",1771,151,574,200,324,60,270,80,3430
"18097320600",1861,173,61,24,252,26,177,7,2581
"18097320700",1514,122,127,21,75,0,0,0,1859
"18097320800",2528,118,38,2,169,11,58,0,2924
"18097320901",3192,400,1612,267,394,257,109,347,6578
"18097320902",1728,301,1091,624,658,208,835,340,5785
"18097320903",757,108,2201,694,885,488,948,342,6423
"18097321001",901,291,1177,204,75,212,198,212,3270
"18097321002",1950,132,1401,241,155,355,109,55,4398
"18097321100",1853,100,1387,243,90,19,63,7,3762
"18097321200",4272,187,120,14,192,0,119,0,4904
"18097321300",1940,188,14,0,25,0,25,0,2192
"18097321400",3388,412,902,38,432,165,266,165,5768
"18097321600",1953,320,1845,562,313,3,117,3,5116
"18097321700",2858,111,234,24,387,11,94,0,3719
"18097321800",2815,168,133,0,103,14,57,0,3290
"18097321900",2135,540,575,24,105,42,71,27,3519
"18097322000",934,340,1608,452,33,128,0,26,3521
"18097322100",1213,57,1076,235,118,182,0,0,2881
"18097322200",1236,61,494,128,103,0,0,0,2022
"18097322300",1780,249,312,47,76,13,40,0,2517
"18097322400",1374,330,920,322,249,8,282,66,3551
"18097322500",356,138,528,382,80,125,38,87,1734
"18097322600",308,57,1865,1280,170,137,74,81,3972
"18097322700",306,62,1592,223,68,8,0,8,2267
"18097330103",3529,500,452,61,279,159,304,117,5401
"18097330105",3580,540,566,48,334,0,188,223,5479
"18097330106",2241,606,1015,224,91,187,125,333,4822
"18097330107",5214,113,448,0,159,0,92,0,6026
"18097330108",3201,87,125,0,283,0,9,0,3705
"18097330109",3747,129,366,24,243,22,164,17,4712
"18097330202",2995,593,4758,1276,343,79,810,244,11098
"18097330203",4918,265,423,21,317,0,149,0,6093
"18097330204",4002,80,1458,147,309,18,411,0,6425
"18097330206",3674,190,608,33,333,6,185,0,5029
"18097330208",2248,79,268,0,186,0,81,0,2862
"18097330209",6077,448,1732,213,164,387,292,122,9435
"18097330401",4544,110,1349,0,12,11,136,0,6162
"18097330500",1869,286,3158,322,704,86,557,0,6982
"18097330600",2502,315,560,1157,467,0,152,0,5153
"18097330700",3618,1619,131,14,436,178,1272,899,8167
"18097330803",527,446,1446,1535,112,225,203,606,5100
"18097330804",559,453,1240,962,149,64,344,444,4215
"18097330805",903,641,546,839,124,101,177,564,3895
"18097330806",757,343,1216,934,300,144,217,326,4237
"18097330900",636,258,2690,996,167,0,136,0,4883
"18097331000",215,64,3204,867,260,29,0,0,4639
"18097340101",2978,136,136,0,144,63,27,63,3547
"18097340102",1492,131,1360,580,216,0,154,10,3943
"18097340108",400,107,448,511,241,306,326,297,2636
"18097340109",501,10,454,66,365,144,369,137,2046
"18097340110",1914,222,1618,279,898,397,1123,391,6842
"18097340111",1603,133,737,44,304,122,258,96,3297
"18097340112",2432,428,1204,198,480,0,344,0,5086
"18097340113",2756,206,410,31,214,0,142,123,3882
"18097340114",3263,337,503,0,313,0,189,0,4605
"18097340201",1415,437,540,612,245,237,474,510,4470
"18097340202",1820,336,1170,177,269,295,237,331,4635
"18097340300",1722,858,877,1178,1682,1080,2083,1292,10772
"18097340400",1314,195,764,469,568,129,801,177,4417
"18097340500",691,98,2176,600,187,53,76,41,3922
"18097340600",1073,454,2291,421,583,292,519,517,6150
"18097340700",1320,539,863,968,220,345,320,634,5209
"18097340800",1278,247,16,0,87,16,9,0,1653
"18097340901",2322,88,1070,79,277,25,304,11,4176
"18097340902",2582,666,1684,617,222,728,155,570,7224
"18097341000",1710,122,59,0,16,0,44,0,1951
"18097341100",583,503,326,215,210,163,174,239,2413
"18097341200",221,231,946,427,41,118,162,139,2285
"18097341600",235,62,854,577,54,78,74,30,1964
"18097341700",2341,937,250,338,242,407,460,590,5565
"18097341902",2555,201,460,111,166,12,185,1,3691
"18097341903",1762,488,920,747,780,780,870,864,7211
"18097341904",771,266,236,114,387,559,514,664,3511
"18097342000",3663,302,1876,470,982,11,821,35,8160
"18097342101",2668,428,551,442,897,157,769,208,6120
"18097342200",3131,1041,325,318,469,237,698,446,6665
"18097342300",3370,2194,215,322,367,387,253,607,7715
"18097342400",1187,419,15,1,9,136,4,127,1898
"18097342500",2960,974,0,9,314,603,406,512,5778
"18097342600",1345,682,209,228,355,365,400,375,3959
"18097350100",165,26,815,234,19,48,0,0,1307
"18097350300",259,76,772,660,25,8,8,0,1808
"18097350400",527,93,1325,374,108,0,8,0,2435
"18097350500",18,24,1429,949,5,9,18,7,2459
"18097350600",156,119,3408,781,85,79,24,0,4652
"18097350700",10,33,664,595,138,29,67,37,1573
"18097350800",53,17,779,1102,18,74,0,74,2117
"18097350900",146,51,720,198,4,0,0,0,1119
"18097351000",420,126,716,1029,139,138,133,53,2754
"18097351200",33,110,1076,872,75,130,75,0,2371
"18097351500",337,97,560,348,107,57,27,45,1578
"18097351600",1169,242,488,304,123,8,59,67,2460
"18097351700",474,211,944,860,48,44,60,0,2641
"18097351900",158,47,1753,462,89,0,26,47,2582
"18097352100",77,173,1090,653,74,44,59,40,2210
"18097352300",33,34,947,479,107,24,104,0,1728
"18097352400",1324,371,505,674,64,94,142,22,3196
"18097352500",1795,550,206,145,141,79,96,45,3057
"18097352600",1237,668,240,615,164,221,89,462,3696
"18097352700",968,588,281,458,81,115,94,159,2744
"18097352800",58,48,593,309,23,0,1,0,1032
"18097353300",1354,369,292,236,107,125,96,8,2587
"18097353500",435,327,501,462,102,253,23,30,2133
"18097353600",83,315,879,605,101,67,63,12,2125
"18097354200",3020,953,395,368,229,111,338,39,5453
"18097354400",866,117,149,76,45,5,52,15,1325
"18097354500",1451,512,97,146,64,18,213,112,2613
"18097354700",565,245,198,174,94,46,178,92,1592
"18097354800",486,361,124,407,58,108,219,115,1878
"18097354900",842,454,380,437,343,29,332,79,2896
"18097355000",944,550,105,358,72,60,221,256,2566
"18097355100",718,578,133,408,52,99,96,189,2273
"18097355300",1370,666,171,180,45,97,137,99,2765
"18097355400",1434,727,343,443,84,323,108,460,3922
"18097355500",2139,700,157,196,110,92,102,479,3975
"18097355600",917,357,28,61,193,59,220,127,1962
"18097355700",1070,889,256,119,68,178,224,353,3157
"18097355900",1300,724,301,39,16,22,125,101,2628
"18097356200",995,172,53,62,165,14,44,4,1509
"18097356400",1625,1249,371,307,163,139,314,239,4407
"18097356900",1361,831,121,178,139,108,153,52,2943
"18097357000",1281,833,43,243,45,35,127,25,2632
"18097357100",1197,771,111,54,50,41,260,229,2713
"18097357200",1037,1680,109,115,30,89,71,355,3486
"18097357300",614,577,352,401,36,12,37,87,2116
"18097357400",2027,824,512,434,12,95,48,447,4399
"18097357500",3088,573,0,17,135,0,54,48,3915
"18097357600",4042,1745,889,671,176,2,269,443,8237
"18097357800",908,380,8,82,56,108,106,52,1700
"18097357900",2723,558,121,71,228,405,197,438,4741
"18097358000",868,248,136,52,47,3,93,49,1496
"18097358100",1393,965,217,7,110,140,158,110,3100
"18097360101",521,438,418,737,61,87,37,230,2529
"18097360102",168,246,947,835,44,20,27,46,2333
"18097360201",1240,549,1321,723,215,14,10,7,4079
"18097360202",1052,110,1367,588,196,0,213,67,3593
"18097360301",1930,215,812,257,79,181,399,240,4113
"18097360302",517,357,985,559,0,119,155,224,2916
"18097360401",1474,468,2895,666,192,15,143,0,5853
"18097360402",350,78,1074,506,30,9,91,31,2169
"18097360404",1775,741,2848,1356,460,166,482,614,8442
"18097360405",2108,200,2824,542,275,0,358,9,6316
"18097360501",4289,202,1313,330,457,101,644,101,7437
"18097360502",3007,404,1397,724,142,159,25,257,6115
"18097360601",3567,248,290,116,349,26,489,22,5107
"18097360602",3247,745,1184,318,219,31,347,0,6091
"18097360700",1342,166,186,25,47,6,18,34,1824
"18097360800",1375,378,202,214,15,49,217,131,2581
"18097360900",2658,601,955,514,93,8,400,273,5502
"18097361000",1769,150,12,0,27,2,70,0,2030
"18097361100",2437,330,133,146,157,11,146,8,3368
"18097361200",2327,584,171,53,83,0,101,0,3319
"18097361300",1853,351,20,42,71,0,133,23,2493
"18097361400",6833,880,1720,743,683,25,330,5,11219
"18097361600",5051,143,1764,37,743,50,30,0,7818
"18097370201",2894,494,118,41,320,0,122,0,3989
"18097370202",4351,1053,171,885,141,166,163,132,7062
"18097370301",6438,550,937,57,410,184,369,0,8945
"18097370302",7196,1072,150,0,344,182,148,269,9361
"18097380100",12695,1395,486,75,1465,295,1253,31,17695
"18097380200",1856,422,287,58,77,275,128,239,3342
"18097380300",2439,1763,137,502,110,243,464,65,5723
"18097380402",2716,1118,187,66,166,160,305,153,4871
"18097380403",3482,473,0,0,7,0,9,0,3971
"18097380404",3316,399,74,150,59,45,16,7,4066
"18097380501",1896,532,0,0,18,0,47,254,2747
"18097380502",2080,805,194,14,192,291,229,253,4058
"18097380600",2849,928,402,183,624,392,527,311,6216
"18097380700",3155,879,347,366,534,194,100,349,5924
"18097380800",1939,413,7,0,10,0,11,27,2407
"18097380901",4458,286,43,20,337,95,117,0,5356
"18097380902",5186,372,112,0,146,0,241,16,6073
"18097381001",3527,626,372,115,985,1284,202,97,7208
"18097381002",2463,175,2,0,14,173,19,186,3032
"18097381101",5143,472,69,0,184,0,0,72,5940
"18097381102",4347,639,0,0,665,229,107,42,6029
"18097381201",6251,207,138,31,376,0,277,0,7280
"18097381203",1619,480,43,113,213,621,22,461,3572
"18097381204",1369,739,28,63,338,67,61,159,2824
"18097381205",3999,826,229,186,1238,217,350,265,7310
"18097390101",6705,908,552,0,241,0,427,0,8833
"18097390102",3853,400,134,460,147,18,66,117,5195
"18097390200",2912,180,107,0,206,0,29,0,3434
"18097390300",4923,277,105,0,355,0,48,0,5708
"18097390402",10968,227,346,0,1022,55,379,0,12997
"18097390403",9363,410,248,0,725,0,106,0,10852
"18097390404",4666,419,37,9,229,39,380,106,5885
"18097390405",2726,159,207,0,506,46,113,46,3803
"18097390500",157,34,1134,1146,34,68,48,21,2642
"18097390600",2006,116,1541,696,348,37,329,53,5126
"18097390700",903,991,261,137,490,216,579,715,4292
"18097390800",3340,268,39,28,70,158,105,177,4185
"18097390900",921,201,474,383,82,30,72,9,2172
"18097391000",2145,741,197,214,272,261,108,141,4079
"18099020101",4386,530,6,6,242,65,408,65,5708
"18099020102",3184,296,22,0,50,0,36,0,3588
"18099020201",3753,348,0,0,159,2,145,2,4409
"18099020202",2514,111,36,0,139,0,17,0,2817
"18099020301",3473,314,46,0,87,8,90,39,4057
"18099020302",2581,283,48,7,78,31,125,9,3162
"18099020400",2045,542,19,51,141,14,258,104,3174
"18099020500",1919,990,0,8,652,210,1081,535,5395
"18099020600",3888,551,0,0,171,234,345,324,5513
"18099020701",3111,371,0,2,296,0,216,41,4037
"18099020702",2569,429,16,0,84,0,121,22,3241
"18099020800",4320,742,30,0,49,2,57,32,5232
"18101950100",1987,370,0,0,11,14,17,0,2399
"18101950200",2976,633,0,0,115,14,22,0,3760
"18101950300",3663,367,0,0,23,15,0,0,4068
"18103952000",3938,710,0,0,135,41,16,13,4853
"18103952100",3936,377,32,0,86,0,49,0,4480
"18103952200",1923,483,68,12,7,90,21,0,2604
"18103952300",1811,361,425,68,62,79,70,39,2915
"18103952400",1534,626,413,0,62,3,17,0,2655
"18103952500",1578,463,17,0,54,23,16,20,2171
"18103952600",3025,303,0,0,25,0,19,0,3372
"18103952700",6213,811,11,44,316,235,309,210,8149
"18103952800",1497,533,7,2,49,0,0,0,2088
"18103952900",1134,462,83,0,53,7,18,25,1782
"18105000100",1357,3129,0,17,158,259,14,99,5033
"18105000201",79,77,17,12,129,652,0,0,966
"18105000202",17,37,0,0,0,9,0,0,63
"18105000301",2134,1782,89,33,193,294,51,49,4625
"18105000302",1654,1108,7,0,147,38,20,14,2988
"18105000401",2874,1237,45,82,77,277,46,286,4924
"18105000402",2471,1132,139,46,462,57,80,34,4421
"18105000501",2855,665,140,116,476,31,130,27,4440
"18105000502",2485,660,122,0,209,8,58,52,3594
"18105000601",1628,1646,118,240,277,255,188,60,4412
"18105000602",933,1209,2,233,373,158,310,94,3312
"18105000700",2363,137,61,5,120,0,95,0,2781
"18105000800",4229,588,99,0,401,400,98,40,5855
"18105000901",1407,950,33,13,219,197,184,47,3050
"18105000903",3010,1332,154,97,243,385,90,170,5481
"18105000904",2840,832,64,216,481,1205,5,85,5728
"18105001001",4127,177,299,0,620,37,238,0,5498
"18105001002",4217,197,136,0,646,148,163,45,5552
"18105001101",3317,955,187,102,181,206,64,11,5023
"18105001102",3118,577,272,89,269,107,84,0,4516
"18105001103",2571,299,37,0,246,0,85,0,3238
"18105001200",5413,216,0,0,165,0,74,0,5868
"18105001301",4981,466,0,0,89,59,0,34,5629
"18105001303",5420,151,27,0,117,80,92,41,5928
"18105001304",3371,353,120,0,273,0,179,0,4296
"18105001305",2019,64,17,0,66,0,0,0,2166
"18105001401",1805,116,5,0,51,0,15,0,1992
"18105001402",4687,564,28,0,191,0,55,0,5525
"18105001501",5116,297,0,0,98,17,0,0,5528
"18105001502",2216,368,0,0,15,0,20,0,2619
"18105001600",855,3774,60,52,187,199,42,251,5420
"18107956700",2754,200,6,2,21,0,28,0,3011
"18107956800",2850,254,0,0,48,5,32,6,3195
"18107956900",4444,685,1,0,109,42,378,0,5659
"18107957000",2780,814,116,183,22,0,62,0,3977
"18107957100",3380,1027,0,0,20,82,27,106,4642
"18107957200",2977,1181,15,0,338,32,722,177,5442
"18107957300",3716,416,0,22,69,0,10,89,4322
"18107957400",4217,191,0,0,11,5,0,23,4447
"18107957500",2995,354,0,0,97,0,12,5,3463
"18109510100",9202,262,0,0,62,185,62,40,9813
"18109510201",3583,379,0,0,77,0,132,0,4171
"18109510202",3117,451,37,0,44,0,0,0,3649
"18109510300",4371,677,11,17,12,1,55,13,5157
"18109510401",3671,315,0,0,72,0,0,5,4063
"18109510402",4924,404,24,0,61,38,142,0,5593
"18109510500",3743,490,5,0,66,1,119,0,4424
"18109510600",6676,805,8,0,153,2,30,11,7685
"18109510701",2459,364,28,2,120,0,105,0,3078
"18109510702",5598,242,0,0,92,0,5,0,5937
"18109510800",2857,704,0,0,63,37,0,0,3661
"18109510900",2454,1462,0,20,0,27,16,40,4019
"18109511000",6481,1103,0,0,144,157,22,90,7997
"18111100400",5338,519,10,0,47,23,476,20,6433
"18111100500",2635,364,0,0,78,35,33,36,3181
"18111100600",2029,388,0,0,46,44,25,77,2609
"18111100700",2018,278,0,0,57,0,93,21,2467
"18113971700",5243,512,0,0,273,24,376,0,6428
"18113971800",2476,719,0,2,69,47,70,6,3389
"18113971900",3775,873,1,0,84,0,327,80,5140
"18113972000",2438,354,0,0,77,32,42,47,2990
"18113972100",4122,488,0,0,166,0,519,25,5320
"18113972200",3582,829,0,26,357,0,2002,505,7301
"18113972300",3712,855,93,0,136,30,223,215,5264
"18113972400",4216,536,0,12,4,0,57,11,4836
"18113972500",5877,353,0,1,134,11,7,36,6419
"18113972600",3671,226,0,0,10,0,15,0,3922
"18115965700",1965,312,104,0,18,10,7,0,2416
"18115965800",3330,181,8,0,6,0,21,0,3546
"18117951300",2659,476,21,33,12,18,0,0,3219
"18117951400",2727,512,5,0,41,0,32,0,3317
"18117951500",2066,706,86,73,114,30,30,69,3174
"18117951600",2899,548,32,0,26,20,0,0,3525
"18117951700",2352,499,8,0,15,34,5,55,2968
"18117951800",2646,599,0,0,27,0,32,0,3304
"18119955500",3128,352,22,0,3,9,34,9,3557
"18119955600",3118,487,0,0,90,48,0,0,3743
"18119955700",3965,729,0,89,57,26,0,0,4866
"18119955800",3502,600,9,5,82,9,56,9,4272
"18119955900",3871,743,0,0,21,13,111,14,4773
"18121030100",3618,398,0,0,27,0,10,0,4053
"18121030200",2852,553,0,0,9,10,27,27,3478
"18121030300",2272,505,0,28,80,14,0,37,2936
"18121030400",4373,833,0,12,52,2,67,2,5341
"18123952200",3525,479,7,0,7,0,0,6,4024
"18123952300",3086,138,0,0,69,0,12,23,3328
"18123952400",3304,639,0,1,8,71,0,0,4023
"18123952500",3499,259,31,7,5,99,0,93,3993
"18123952600",1761,540,0,0,103,8,58,5,2475
"18125953900",3114,205,0,0,8,0,0,0,3327
"18125954000",2412,458,0,0,0,0,0,0,2870
"18125954100",2573,200,0,0,8,9,0,0,2790
"18125954200",2893,580,0,3,20,3,0,0,3499
"18127050101",7767,825,93,0,546,121,520,0,9872
"18127050103",7384,334,9,20,367,2,220,24,8360
"18127050202",5108,630,322,29,67,20,205,10,6391
"18127050203",5463,646,0,2,232,75,312,134,6864
"18127050300",5743,1071,8,3,91,58,263,204,7441
"18127050402",6839,728,354,238,248,78,1288,322,10095
"18127050405",1142,50,4,0,40,0,19,5,1260
"18127050407",2714,850,288,49,102,3,519,145,4670
"18127050501",4444,608,151,129,174,61,659,101,6327
"18127050503",4274,659,110,17,61,14,505,0,5640
"18127050505",2175,222,43,2,116,25,418,24,3025
"18127050506",4703,290,450,91,229,39,1220,201,7223
"18127050507",2895,685,375,73,190,24,662,81,4985
"18127050508",3307,640,611,71,246,156,304,245,5580
"18127050509",3709,478,186,39,124,136,333,235,5240
"18127050602",3670,797,0,6,200,0,205,386,5264
"18127050603",3234,37,0,0,37,26,149,0,3483
"18127050604",7409,620,65,0,309,0,484,0,8887
"18127050702",5876,896,129,388,233,251,712,137,8622
"18127050703",3019,217,88,12,22,0,181,0,3539
"18127050704",4001,474,165,33,147,20,184,46,5070
"18127050800",5128,726,114,21,106,153,419,62,6729
"18127050900",1399,662,60,63,123,61,132,124,2624
"18127051002",7285,359,18,18,373,159,497,159,8868
"18127051005",4062,203,50,0,110,11,231,11,4678
"18127051006",3789,453,7,0,283,0,314,101,4947
"18127051007",6431,342,49,0,199,0,497,22,7540
"18127051008",2197,150,58,0,0,55,148,55,2663
"18127051101",5384,487,9,277,38,0,60,0,6255
"18127051102",4196,126,37,0,73,30,152,16,4630
"18127980001",0,0,0,0,0,0,0,0,0
"18127980002",0,0,0,0,0,0,0,0,0
"18127990000",0,0,0,0,0,0,0,0,0
"18129040100",5170,540,0,0,75,10,10,10,5815
"18129040200",2089,87,12,0,49,0,4,10,2251
"18129040300",2448,110,0,0,27,0,15,0,2600
"18129040400",4727,676,81,0,39,0,14,0,5537
"18129040500",2691,323,0,0,0,0,0,9,3023
"18129040600",2610,647,41,0,86,16,16,0,3416
"18129040700",2153,284,18,120,175,66,158,0,2974
"18131958900",2030,409,30,0,0,0,59,0,2528
"18131959000",2955,519,24,0,58,61,148,29,3794
"18131959100",3073,499,0,0,188,0,81,3,3844
"18131959200",2636,315,0,0,23,13,21,5,3013
"18133956000",2856,357,0,0,14,0,2,0,3229
"18133956100",2071,186,0,0,0,0,0,0,2257
"18133956200",3707,256,2,4,47,11,9,5,4041
"18133956300",4595,772,0,5,170,44,67,16,5669
"18133956400",6856,570,14,44,38,46,35,52,7655
"18133956500",5470,625,11,0,44,7,28,7,6192
"18133956600",3001,100,0,0,133,3,59,33,3329
"18135951400",2385,410,17,5,17,0,12,4,2850
"18135951500",2399,426,0,0,16,4,128,0,2973
"18135951600",2650,932,6,0,82,150,203,189,4212
"18135951700",2118,740,0,0,19,0,0,0,2877
"18135951800",2060,211,0,0,33,51,0,11,2366
"18135951900",3661,593,4,0,48,20,42,0,4368
"18135952000",2747,316,12,0,99,0,136,10,3320
"18135952100",2548,395,17,4,135,9,22,43,3173
"18137968400",6404,553,12,0,169,7,57,63,7265
"18137968500",4183,187,5,8,176,0,61,0,4620
"18137968600",4382,380,3,2,124,70,117,65,5143
"18137968700",3082,528,4,0,19,0,9,0,3642
"18137968800",2707,349,57,0,15,7,62,0,3197
"18137968900",4322,281,0,0,61,0,19,0,4683
"18139974100",2544,261,0,0,23,0,0,0,2828
"18139974200",3073,629,0,0,52,0,34,0,3788
"18139974300",2777,684,39,0,102,0,16,0,3618
"18139974400",2240,444,84,8,0,32,82,75,2965
"18139974500",3264,570,0,0,28,21,0,0,3883
"18141000100",947,81,459,372,161,9,201,17,2247
"18141000200",732,533,978,864,210,173,142,283,3915
"18141000301",1527,412,194,167,152,39,4,197,2692
"18141000302",1182,214,433,630,186,62,62,148,2917
"18141000400",479,205,596,905,49,149,58,143,2584
"18141000500",426,38,772,350,49,0,85,0,1720
"18141000600",609,267,413,391,242,55,315,50,2342
"18141000700",837,123,79,195,143,21,94,0,1492
"18141000800",1506,118,35,10,51,9,82,0,1811
"18141000900",486,317,93,35,100,11,6,30,1078
"18141001000",966,315,640,764,183,73,133,122,3196
"18141001100",2904,304,633,629,208,153,207,131,5169
"18141001200",2018,60,154,10,116,5,145,0,2508
"18141001300",1526,180,442,210,157,20,158,9,2702
"18141001400",2227,521,282,207,134,17,154,326,3868
"18141001500",1386,331,286,476,44,174,21,19,2737
"18141001600",2012,72,72,27,108,0,82,0,2373
"18141001700",480,337,411,348,19,27,10,26,1658
"18141001900",320,108,270,355,25,25,18,49,1170
"18141002000",215,274,597,604,28,193,61,87,2059
"18141002100",256,148,240,412,18,36,84,85,1279
"18141002200",1627,321,237,192,506,172,1418,365,4838
"18141002300",162,325,577,265,4,194,60,182,1769
"18141002400",953,601,485,239,344,216,653,620,4111
"18141002500",826,200,475,443,109,138,390,189,2770
"18141002600",1649,367,394,239,244,112,465,324,3794
"18141002700",411,329,74,73,135,80,368,190,1660
"18141002800",1007,417,509,149,152,120,465,428,3247
"18141002900",148,100,354,287,90,48,115,34,1176
"18141003000",528,107,453,154,107,153,78,128,1708
"18141003100",1761,1139,270,289,225,266,256,63,4269
"18141003200",3622,219,408,41,512,60,308,77,5247
"18141003300",1556,487,454,342,53,23,54,22,2991
"18141003400",1428,682,569,541,259,159,617,117,4372
"18141003500",1553,330,310,252,213,184,95,108,3045
"18141010100",1956,629,87,1,45,149,115,15,2997
"18141010200",3376,1330,119,177,151,0,232,0,5385
"18141010300",4083,516,290,63,161,216,88,0,5417
"18141010400",2730,396,35,8,104,28,96,28,3425
"18141010500",2609,195,48,0,153,0,90,0,3095
"18141010600",2343,594,52,100,134,90,96,38,3447
"18141010700",2604,503,14,60,188,21,110,0,3500
"18141010800",4147,308,14,0,97,4,157,8,4735
"18141010900",6562,563,368,0,160,20,526,20,8219
"18141011000",5127,366,538,31,313,0,345,21,6741
"18141011100",4871,742,354,32,355,342,552,128,7376
"18141011201",369,135,45,6,72,58,23,3,711
"18141011202",520,267,5,10,38,62,1,16,919
"18141011301",2936,1019,210,271,407,54,120,57,5074
"18141011302",5124,325,651,24,239,0,272,23,6658
"18141011303",3781,349,242,319,300,11,484,0,5486
"18141011304",1909,41,133,0,36,0,48,0,2167
"18141011305",3340,85,104,57,227,0,171,0,3984
"18141011306",2134,113,76,0,242,0,75,0,2640
"18141011403",4753,374,88,55,682,0,67,20,6039
"18141011404",5972,156,168,0,968,0,189,0,7453
"18141011405",3324,97,90,0,121,0,111,0,3743
"18141011406",4493,144,81,0,82,0,0,0,4800
"18141011501",1401,681,591,444,71,433,53,820,4494
"18141011503",1611,91,0,0,43,13,36,0,1794
"18141011504",1316,129,71,0,126,0,89,0,1731
"18141011505",1900,184,62,83,350,8,281,0,2868
"18141011506",3607,510,384,80,129,105,151,226,5192
"18141011601",7859,267,25,0,71,18,154,67,8461
"18141011602",6600,440,30,7,269,28,231,0,7605
"18141011701",2994,896,45,48,65,34,43,10,4135
"18141011702",6140,559,698,277,377,315,46,4,8416
"18141011801",1459,31,38,0,50,5,35,5,1623
"18141011802",5313,386,371,10,293,88,212,16,6689
"18141011900",3676,182,32,4,53,28,141,49,4165
"18141012000",3364,284,115,0,84,44,180,40,4111
"18141012100",3229,498,39,9,41,0,77,0,3893
"18141012200",2534,279,0,0,52,21,66,43,2995
"18141012300",2982,587,8,6,14,19,21,58,3695
"18141012400",1944,64,23,0,27,5,35,5,2103
"18143966700",3782,719,0,0,51,47,78,0,4677
"18143966800",2921,926,7,86,31,0,20,77,4068
"18143966900",3612,751,0,0,13,0,38,9,4423
"18143967000",3760,1243,0,1,69,27,100,52,5252
"18143967100",4422,785,0,13,147,12,0,12,5391
"18145710100",3301,351,0,0,29,0,21,0,3702
"18145710200",5281,366,0,2,63,0,46,2,5760
"18145710300",4144,438,0,0,102,0,60,1,4745
"18145710400",2165,492,0,3,314,213,335,175,3697
"18145710500",3315,532,106,0,294,127,189,127,4690
"18145710601",2261,592,1,5,410,108,347,71,3795
"18145710602",1829,654,138,28,156,31,87,31,2954
"18145710700",5294,668,123,59,73,3,88,30,6338
"18145710800",4135,213,0,3,81,0,0,0,4432
"18145710900",4604,418,0,0,11,10,0,0,5043
"18147952700",6779,414,37,0,306,185,252,185,8158
"18147952800",2288,557,13,3,102,1,71,0,3035
"18147952900",2288,257,4,0,10,16,10,0,2585
"18147953000",3748,339,0,0,9,0,0,0,4096
"18147953100",2443,652,57,0,46,0,0,5,3203
"18149953600",1979,497,0,0,81,0,76,0,2633
"18149953700",3079,575,0,0,81,2,81,0,3818
"18149953800",3045,405,28,20,40,49,0,0,3587
"18149953900",1794,259,0,0,100,0,36,0,2189
"18149954000",2614,836,0,14,26,106,85,165,3846
"18149954100",2725,653,0,6,47,60,67,53,3611
"18149954200",3129,600,27,12,106,101,129,101,4205
"18151970800",3207,368,0,0,245,71,92,0,3983
"18151970900",1938,114,0,0,205,0,44,0,2301
"18151971000",3085,335,0,0,245,5,111,0,3781
"18151971100",2304,224,0,0,154,0,19,0,2701
"18151971200",2787,165,8,0,118,106,119,0,3303
"18151971300",3862,769,42,0,314,34,64,0,5085
"18151971400",3047,654,0,4,162,100,253,10,4230
"18151971500",2961,210,45,0,147,0,67,25,3455
"18151971600",4019,448,0,46,138,50,88,20,4809
"18153050100",4747,1172,143,62,12,4,24,17,6181
"18153050200",2587,358,0,0,19,21,0,21,3006
"18153050300",4054,1182,0,0,60,25,50,3,5374
"18153050400",2063,208,0,0,9,0,5,1,2286
"18153050500",1822,452,0,0,12,0,0,0,2286
"18155965700",3536,1195,2,3,108,78,113,0,5035
"18155965800",2561,344,9,0,12,0,0,0,2926
"18155965900",1987,458,3,0,51,19,1,41,2560
"18157000100",1366,484,67,367,21,20,132,35,2492
"18157000200",1182,375,0,99,28,33,71,135,1923
"18157000300",2471,122,222,0,162,0,250,0,3227
"18157000400",1874,1361,493,389,287,180,182,189,4955
"18157000700",1727,597,125,309,81,0,179,143,3161
"18157000800",1398,225,82,0,107,0,268,0,2080
"18157001000",1164,174,0,6,89,0,40,11,1484
"18157001100",2735,104,0,28,101,0,119,0,3087
"18157001200",2277,404,258,38,220,49,483,89,3818
"18157001300",3380,767,92,0,122,71,236,50,4718
"18157001400",3134,200,88,105,212,37,897,83,4756
"18157001501",2704,722,291,550,164,27,422,38,4918
"18157001502",4685,1315,222,74,212,43,514,406,7471
"18157001600",9116,894,89,74,599,2,792,164,11730
"18157001700",4806,1808,371,226,574,131,856,661,9433
"18157001800",2396,868,257,0,264,42,575,434,4836
"18157001900",3304,287,114,41,121,19,235,103,4224
"18157005101",1749,244,87,3,790,414,67,75,3429
"18157005102",3755,163,0,0,956,153,172,0,5199
"18157005200",2664,663,80,54,563,29,79,0,4132
"18157005300",1151,979,76,0,414,222,27,16,2885
"18157005400",700,2317,0,99,217,1120,21,128,4602
"18157005500",441,2108,18,26,231,659,30,117,3630
"18157010100",5173,316,14,0,194,86,170,0,5953
"18157010201",4949,298,72,0,218,0,168,0,5705
"18157010203",5110,2646,332,178,640,450,259,384,9999
"18157010204",7131,4202,123,253,695,967,240,545,14156
"18157010300",159,194,0,23,5,352,15,37,785
"18157010400",0,0,0,0,0,0,0,0,0
"18157010500",142,184,51,0,813,503,77,25,1795
"18157010600",5133,260,6,4,89,2,68,0,5562
"18157010700",4065,657,200,0,229,114,490,281,6036
"18157010800",4434,184,54,0,39,8,45,0,4764
"18157010901",6884,212,26,21,291,73,421,21,7949
"18157010902",3688,251,16,18,29,0,78,79,4159
"18157011000",3814,180,0,0,111,0,100,0,4205
"18157011100",2623,693,185,106,99,103,76,243,4128
"18159020100",2508,440,0,1,4,0,41,134,3128
"18159020200",2909,121,12,3,114,0,121,2,3282
"18159020300",2460,152,0,0,16,51,0,0,2679
"18159020400",5825,691,7,0,170,0,80,9,6782
"18161960700",3377,420,2,0,139,7,27,2,3974
"18161960800",2906,350,0,0,89,0,0,0,3345
"18163000100",1408,198,4,8,19,192,17,144,1990
"18163000201",6320,375,500,94,283,0,0,0,7572
"18163000202",1440,162,99,47,107,0,47,0,1902
"18163000300",1709,574,107,90,29,89,39,70,2707
"18163000400",1725,232,26,11,7,0,17,0,2018
"18163000500",1825,134,71,5,117,9,89,15,2265
"18163000600",1559,127,56,108,80,107,50,33,2120
"18163000800",1558,252,324,127,108,36,5,0,2410
"18163000900",4007,622,751,131,229,108,175,266,6289
"18163001000",2165,667,449,869,481,20,297,0,4948
"18163001100",706,561,626,512,22,104,0,0,2531
"18163001200",686,182,294,305,65,33,0,6,1571
"18163001300",449,280,462,275,16,91,0,0,1573
"18163001400",786,313,398,468,69,0,132,9,2175
"18163001500",379,166,764,455,19,33,0,0,1816
"18163001700",828,381,424,279,16,66,11,0,2005
"18163001800",224,92,5,19,5,28,0,28,401
"18163001900",498,226,30,90,83,37,18,0,982
"18163002000",505,244,43,14,16,0,0,0,822
"18163002100",1534,626,143,15,22,53,182,29,2604
"18163002300",1763,892,30,28,18,47,9,0,2787
"18163002400",2753,532,51,32,130,0,0,0,3498
"18163002500",1352,379,138,84,38,75,117,19,2202
"18163002600",1883,1077,352,166,31,73,1,131,3714
"18163002800",2039,319,125,51,57,0,54,0,2645
"18163002900",927,164,0,0,0,0,0,0,1091
"18163003000",4203,668,0,0,13,14,24,14,4936
"18163003100",2153,434,10,0,28,0,0,0,2625
"18163003200",3235,792,16,8,18,52,42,43,4206
"18163003300",2580,711,54,178,175,6,22,26,3752
"18163003400",2720,180,0,0,0,36,0,0,2936
"18163003500",2049,355,30,0,72,4,70,15,2595
"18163003600",3397,571,319,275,22,53,243,25,4905
"18163003701",1411,177,56,33,118,6,110,58,1969
"18163003702",2369,685,330,637,145,220,50,150,4586
"18163003801",4020,403,353,49,369,85,364,50,5693
"18163003803",4198,261,161,0,297,40,191,26,5174
"18163003804",4762,271,488,334,385,16,0,0,6256
"18163003900",2632,234,289,0,18,0,30,0,3203
"18163010100",4083,888,419,127,430,186,31,54,6218
"18163010201",9590,191,310,2,789,2,82,2,10968
"18163010202",2656,240,206,0,148,16,32,29,3327
"18163010203",7259,1076,189,0,326,89,55,55,9049
"18163010403",3152,549,54,88,78,48,32,1,4002
"18163010404",5931,495,0,18,175,0,61,0,6680
"18163010500",6974,464,0,0,52,0,0,0,7490
"18163010600",1761,133,0,0,36,0,0,21,1951
"18163010700",7729,418,83,24,403,24,114,0,8795
"18163980100",0,0,0,0,0,0,0,0,0
"18165020100",2863,281,0,7,90,0,11,2,3254
"18165020200",2853,191,1,0,11,3,1,15,3075
"18165020300",2552,349,8,2,24,17,23,2,2977
"18165020400",1686,120,0,0,0,0,9,0,1815
"18165020500",3415,1013,19,3,86,0,97,0,4633
"18167000300",789,464,0,11,99,153,15,8,1539
"18167000400",2119,1074,152,175,61,56,112,76,3825
"18167000500",664,520,94,194,138,144,29,15,1798
"18167000600",1085,842,304,177,13,96,6,145,2668
"18167000700",856,557,232,188,77,186,26,30,2152
"18167000900",1885,554,11,164,9,0,32,9,2664
"18167001000",2906,570,52,21,136,43,15,0,3743
"18167001100",1795,768,116,14,50,54,29,54,2880
"18167001200",2005,309,119,48,162,13,31,0,2687
"18167001300",1593,371,8,0,106,6,0,7,2091
"18167001400",2387,213,110,0,75,245,67,58,3155
"18167001500",2736,461,4,23,64,71,87,0,3446
"18167001600",4536,204,142,1,25,1,106,1,5016
"18167001700",3278,400,116,148,117,81,44,61,4245
"18167001800",1529,661,113,224,106,16,15,4,2668
"18167001900",904,584,22,139,22,178,62,8,1919
"18167010100",4081,483,87,0,88,22,0,0,4761
"18167010201",3953,294,72,0,49,122,16,0,4506
"18167010202",2663,613,11,0,45,0,0,0,3332
"18167010300",2862,320,28,0,73,0,22,0,3305
"18167010400",3310,180,0,0,126,0,0,0,3616
"18167010500",1923,656,23,0,5,4,69,0,2680
"18167010600",4475,953,133,108,151,32,63,3,5918
"18167010701",4882,772,286,16,204,0,132,2,6294
"18167010702",4133,749,309,0,369,16,74,0,5650
"18167011000",3594,280,0,0,116,0,146,0,4136
"18167011100",1428,1014,216,224,112,359,54,98,3505
"18167011200",4765,703,129,44,599,180,25,27,6472
"18169102200",4051,570,38,64,0,192,19,122,5056
"18169102300",3002,707,0,0,152,20,33,69,3983
"18169102400",2934,376,0,0,48,22,8,0,3388
"18169102500",3719,370,0,0,80,16,108,22,4315
"18169102600",2333,665,0,0,108,19,120,0,3245
"18169102700",3227,671,0,0,63,70,1,0,4032
"18169102800",2746,528,0,0,74,0,24,48,3420
"18169102900",3258,264,0,0,162,13,93,12,3802
"18171951000",4314,348,0,0,140,0,83,0,4885
"18171951100",3205,220,0,0,35,0,11,0,3471
"18173030100",2916,476,0,0,9,17,10,9,3437
"18173030200",3100,235,0,0,16,4,11,0,3366
"18173030300",4625,157,0,0,34,9,33,0,4858
"18173030400",1887,533,0,0,18,120,3,28,2589
"18173030500",6435,281,0,0,117,83,85,14,7015
"18173030600",5390,973,0,68,44,29,82,161,6747
"18173030702",5625,251,301,52,490,0,0,0,6719
"18173030703",4245,729,244,0,147,155,38,45,5603
"18173030704",3678,290,77,102,208,0,105,0,4460
"18173030705",7409,309,0,0,421,0,71,0,8210
"18173030800",6022,555,10,0,358,0,307,0,7252
"18175967200",4250,420,0,13,170,0,72,8,4933
"18175967300",3831,758,5,44,0,8,0,0,4646
"18175967400",3479,796,0,0,48,21,12,18,4374
"18175967500",2229,634,0,0,31,15,51,36,2996
"18175967600",3700,536,0,0,48,38,96,38,4456
"18175967700",5543,884,0,24,9,0,27,0,6487
"18177000200",1657,1115,66,135,51,126,95,175,3420
"18177000400",2022,692,129,147,128,0,0,12,3130
"18177000500",2505,1219,161,195,246,83,206,158,4773
"18177000600",1435,417,92,4,3,2,59,8,2020
"18177000700",4806,759,139,75,177,152,21,0,6129
"18177000800",2585,550,43,6,257,161,16,108,3726
"18177000900",3032,1302,414,203,35,243,38,89,5356
"18177001000",2236,1198,208,41,417,268,217,109,4694
"18177001100",5035,700,518,30,361,116,116,11,6887
"18177010100",2369,486,7,0,21,0,0,76,2959
"18177010200",2894,452,46,0,42,5,0,0,3439
"18177010300",2632,469,18,0,3,23,0,19,3164
"18177010400",3081,276,0,13,38,18,16,0,3442
"18177010500",2204,235,0,1,28,0,15,0,2483
"18177010600",3648,953,2,0,33,14,35,0,4685
"18177010700",3536,360,14,17,18,53,0,0,3998
"18177010800",2331,418,21,35,144,95,34,65,3143
"18179040100",5078,483,7,0,106,0,199,47,5920
"18179040200",3554,208,0,0,25,0,51,7,3845
"18179040300",3507,335,2,0,52,0,40,1,3937
"18179040400",2935,377,5,0,104,15,24,15,3475
"18179040500",2352,409,13,5,18,0,23,0,2820
"18179040600",2892,759,6,21,53,68,66,91,3956
"18179040700",3294,374,0,0,25,11,37,6,3747
"18181958100",1929,310,0,0,146,0,236,0,2621
"18181958200",2051,571,0,0,109,122,231,369,3453
"18181958300",1997,207,4,0,59,49,50,47,2413
"18181958400",1872,70,0,0,113,0,133,0,2188
"18181958500",3339,281,0,0,139,0,217,0,3976
"18181958600",3964,516,0,0,235,22,450,35,5222
"18181958700",2404,333,7,0,68,0,9,0,2821
"18181958800",2909,185,20,0,65,0,11,0,3190
"18183050100",4658,472,0,0,137,2,61,6,5336
"18183050200",4903,102,0,0,10,0,0,0,5015
"18183050300",4619,613,12,2,93,8,70,4,5421
"18183050400",5994,780,36,0,230,35,64,0,7139
"18183050500",4013,414,0,10,173,159,217,100,5086
"18183050600",1853,236,0,0,37,0,0,0,2126
"18183050700",3049,79,0,0,33,0,25,0,3186
"19001960100",2374,262,14,10,0,6,58,0,2724
"19001960200",1586,102,0,0,12,0,3,9,1712
"19001960300",2644,244,7,0,34,7,31,12,2979
"19003950100",1597,58,0,1,20,2,5,1,1684
"19003950200",1797,314,6,23,19,25,26,6,2216
"19005960100",1685,140,1,0,44,0,49,0,1919
"19005960200",2324,221,0,0,8,49,0,0,2602
"19005960300",3194,546,0,0,110,8,30,10,3898
"19005960400",2174,143,0,0,16,1,2,1,2337
"19005960500",2498,434,12,34,120,26,470,203,3797
"19007950100",2382,389,3,0,79,0,12,15,2880
"19007950200",1536,214,0,2,2,2,3,2,1761
"19007950300",2146,308,35,2,71,3,106,6,2677
"19007950400",2609,692,0,0,55,2,15,6,3379
"19007950500",1875,145,0,0,24,11,4,0,2059
"19009070100",1778,146,0,0,23,0,12,0,1959
"19009070200",1936,162,0,0,32,31,0,28,2189
"19009070300",1394,190,12,0,18,9,0,0,1623
"19011960100",2765,147,23,0,11,0,0,0,2946
"19011960200",2712,328,0,0,51,33,90,0,3214
"19011960300",4613,537,0,29,49,41,0,0,5269
"19011960400",2746,377,0,0,0,0,0,0,3123
"19011960500",5467,176,70,0,64,0,30,0,5807
"19011960600",2481,110,0,0,82,9,43,9,2734
"19011960700",2038,429,19,0,195,2,80,60,2823
"19013000100",433,449,167,367,30,48,14,131,1639
"19013000200",1751,352,345,315,158,144,231,53,3349
"19013000300",943,937,348,181,103,46,43,86,2687
"19013000400",1185,248,26,9,14,10,0,0,1492
"19013000500",769,455,365,120,240,20,224,10,2203
"19013000700",440,240,296,531,132,2,327,189,2157
"19013000800",3065,412,404,10,360,78,618,36,4983
"19013000900",1006,336,260,95,104,17,140,68,2026
"19013001000",3330,192,46,0,150,24,91,43,3876
"19013001100",2459,263,141,170,0,61,306,61,3461
"19013001200",2187,59,40,0,83,9,100,0,2478
"19013001301",2874,321,82,67,100,268,165,88,3965
"19013001302",2948,370,103,232,241,0,26,0,3920
"19013001400",3857,278,143,167,212,0,119,39,4815
"19013001501",2448,202,149,157,116,109,52,0,3233
"19013001502",3437,373,32,254,127,10,79,0,4312
"19013001503",2917,474,16,14,112,52,14,26,3625
"19013001600",1790,179,458,262,159,74,7,0,2929
"19013001701",495,104,860,545,100,26,101,27,2258
"19013001702",1402,52,705,148,78,0,87,14,2486
"19013001800",144,25,827,346,11,2,42,0,1397
"19013001900",946,209,660,161,205,47,205,47,2480
"19013002000",4358,518,255,0,262,1,111,46,5551
"19013002200",3331,538,93,127,73,10,56,22,4250
"19013002301",1672,334,71,5,86,12,72,0,2252
"19013002303",533,777,16,0,0,77,0,32,1435
"19013002304",1455,877,0,0,147,12,18,12,2521
"19013002400",3684,158,72,2,99,12,86,0,4113
"19013002500",4450,387,69,140,521,0,14,23,5604
"19013002601",2947,829,0,147,130,110,56,13,4232
"19013002603",7864,2291,21,13,301,49,70,192,10801
"19013002604",3826,161,38,17,68,10,10,0,4130
"19013002700",3304,297,40,0,59,4,37,4,3745
"19013002800",2926,118,92,0,44,0,64,0,3244
"19013002901",1235,67,0,0,20,0,4,0,1326
"19013002902",3515,206,0,0,150,0,172,9,4052
"19013003001",3368,705,61,36,56,51,68,17,4362
"19013003002",3567,93,0,0,65,0,29,0,3754
"19015020100",2642,167,3,0,18,0,45,0,2875
"19015020200",3710,282,0,0,16,14,78,0,4100
"19015020300",5173,486,0,227,130,60,221,1,6298
"19015020400",1765,480,0,0,43,10,10,10,2318
"19015020500",4065,320,0,0,7,8,52,0,4452
"19015020600",1662,360,0,0,23,0,7,75,2127
"19015020700",3605,314,0,0,34,11,20,0,3984
"19017004000",1165,226,0,0,39,0,9,0,1439
"19017004100",3106,91,57,2,42,14,33,5,3350
"19017004200",3592,308,0,0,63,0,103,0,4066
"19017004300",1684,88,0,0,27,0,16,0,1815
"19017004400",2644,282,0,0,39,70,40,4,3079
"19017004500",2256,144,14,1,12,58,2,39,2526
"19017004600",4414,269,1,3,41,0,0,6,4734
"19017004700",1749,247,0,0,44,9,5,0,2054
"19019950100",2087,267,3,0,55,36,14,27,2489
"19019950200",3219,470,7,3,46,0,8,3,3756
"19019950300",3261,234,16,0,55,0,33,0,3599
"19019950400",2219,152,0,0,48,24,17,0,2460
"19019950500",3380,441,43,0,65,6,135,5,4075
"19019950600",4258,202,19,13,4,12,7,5,4520
"19021960100",1215,239,32,0,39,12,10,8,1555
"19021960200",1483,203,19,0,43,0,52,0,1800
"19021960300",1671,238,0,0,136,16,90,65,2216
"19021960400",3585,364,138,126,1585,441,2360,298,8897
"19021960500",2840,322,37,89,862,38,1475,185,5848
"19021960600",3190,246,4,0,110,3,225,64,3842
"19023070100",3019,273,30,0,17,0,0,0,3339
"19023070200",1701,239,0,0,0,8,13,8,1969
"19023070300",2458,317,1,0,73,0,13,4,2866
"19023070400",3251,352,19,0,29,0,53,0,3704
"19023070500",2685,167,0,0,53,0,47,0,2952
"19025950100",1946,274,17,0,31,9,20,11,2308
"19025950200",2580,464,0,25,56,15,44,31,3215
"19025950300",1561,214,0,0,19,6,16,2,1818
"19025950400",1778,336,9,12,7,24,16,0,2182
"19027960100",3577,243,8,7,26,19,27,19,3926
"19027960200",2179,72,0,0,25,30,5,30,2341
"19027960300",5159,465,98,136,95,0,80,10,6043
"19027960400",3437,341,14,0,0,80,82,80,4034
"19027960500",1640,239,0,18,3,9,20,0,1929
"19027960600",2079,269,2,0,17,13,20,33,2433
"19029190100",2151,187,0,0,2,0,24,8,2372
"19029190200",2062,353,0,0,50,18,11,6,2500
"19029190300",1341,263,14,0,24,2,2,0,1646
"19029190400",3489,362,29,0,44,14,117,78,4133
"19029190500",2367,562,11,2,49,32,60,0,3083
"19031450100",2353,283,6,0,91,22,43,0,2798
"19031450200",3300,212,0,0,30,25,47,5,3619
"19031450300",3218,315,0,0,60,0,8,0,3601
"19031450400",2576,239,0,0,23,11,50,5,2904
"19031450500",4875,329,28,0,146,23,105,41,5547
"19033950102",3164,834,55,1,265,1,312,1,4633
"19033950200",4903,1036,11,0,463,16,248,98,6775
"19033950300",3208,1075,75,83,77,34,137,102,4791
"19033950402",3380,378,44,7,138,0,72,43,4062
"19033950600",2042,191,36,0,30,4,21,4,2328
"19033950700",3419,328,46,0,30,0,79,24,3926
"19033950800",3776,779,0,20,142,43,95,131,4986
"19033950900",1719,114,0,0,21,0,27,0,1881
"19033951000",2483,217,20,0,35,15,67,19,2856
"19033951400",3118,204,12,1,78,32,12,0,3457
"19033951600",3797,396,48,67,39,0,240,0,4587
"19035080100",4476,489,9,0,116,20,153,31,5294
"19035080200",2266,126,0,0,94,5,17,0,2508
"19035080300",1592,169,0,0,4,1,16,4,1786
"19035080400",1843,284,0,0,59,6,81,19,2292
"19037070100",3062,323,3,1,27,15,39,0,3470
"19037070200",2246,134,5,0,29,0,5,0,2419
"19037070300",2413,226,0,0,33,4,77,53,2806
"19037070400",3130,430,0,29,16,30,84,25,3744
"19039960100",3639,1142,0,1,52,0,481,493,5808
"19039960200",1812,152,7,0,73,2,48,0,2094
"19039960300",1810,270,3,0,15,34,0,0,2132
"19041080100",1789,225,0,0,26,16,1,0,2057
"19041080200",4215,712,0,0,145,17,159,49,5297
"19041080300",5289,461,0,0,193,47,173,74,6237
"19041080400",2613,222,0,16,134,5,13,2,3005
"19043070100",2532,303,2,0,81,10,71,15,3014
"19043070200",2903,437,55,33,72,6,36,56,3598
"19043070300",2835,311,0,20,20,0,67,0,3253
"19043070400",2085,250,0,0,36,0,0,13,2384
"19043070500",1942,285,2,0,17,20,23,17,2306
"19043070600",2949,372,0,2,15,0,7,0,3345
"19045000100",1815,582,144,179,57,104,61,26,2968
"19045000200",1457,356,7,43,47,77,168,21,2176
"19045000300",3280,991,258,57,124,181,51,34,4976
"19045000400",3250,296,34,29,83,19,62,18,3791
"19045000500",3792,555,131,0,92,16,27,14,4627
"19045000600",3077,309,106,121,102,120,63,0,3898
"19045000700",3192,385,119,43,160,0,200,0,4099
"19045000800",4127,960,30,0,58,23,42,237,5477
"19045000900",5915,480,1,22,66,36,86,60,6666
"19045001000",3717,283,5,0,18,8,21,1,4053
"19045001100",2027,343,0,0,59,2,36,2,2469
"19045001200",3624,190,20,0,70,9,68,6,3987
"19047070100",1517,170,73,0,139,30,121,49,2099
"19047070200",1772,298,0,2,77,32,52,74,2307
"19047070300",2069,281,0,0,8,6,111,30,2505
"19047070400",5659,1839,0,159,650,142,2627,1364,12440
"19047070500",1804,97,12,0,65,51,57,51,2137
"19049050100",4249,253,40,0,172,2,3,7,4726
"19049050200",3788,136,0,0,9,6,52,6,3997
"19049050300",3251,712,92,0,593,85,1172,290,6195
"19049050400",2521,283,0,28,352,100,1098,96,4478
"19049050500",1789,105,0,0,31,63,32,63,2083
"19049050600",2707,184,10,0,94,22,9,0,3026
"19049050700",4059,288,0,5,62,9,118,0,4541
"19049050803",5828,126,126,0,597,0,92,0,6769
"19049050805",5590,150,23,0,391,0,402,19,6575
"19049050807",6588,225,22,0,482,46,212,0,7575
"19049050809",5742,801,66,0,382,21,275,8,7295
"19049050811",6741,747,161,56,1060,0,205,27,8997
"19049050812",1822,20,155,0,69,16,57,0,2139
"19049050901",3075,168,0,0,49,0,123,0,3415
"19049050902",3777,265,0,0,56,78,39,15,4230
"19051080100",3068,706,0,0,79,4,46,30,3933
"19051080200",3516,1219,9,0,19,0,24,0,4787
"19053960100",1906,365,0,5,49,19,9,8,2361
"19053960200",2346,590,78,8,63,33,63,15,3196
"19053960300",1643,397,13,0,30,0,15,0,2098
"19055950100",3515,306,10,0,84,12,26,34,3987
"19055950200",2580,108,0,0,49,1,8,0,2746
"19055950300",4302,654,0,14,61,22,50,22,5125
"19055950400",5097,339,0,0,8,1,2,25,5472
"19057000200",2010,470,156,35,14,0,72,61,2818
"19057000300",2488,585,66,492,129,20,76,0,3856
"19057000400",2667,553,233,350,285,25,278,93,4484
"19057000500",3400,950,509,122,128,0,13,17,5139
"19057000600",3382,496,24,12,57,0,134,122,4227
"19057000700",2299,349,57,10,67,0,14,0,2796
"19057000800",2425,484,0,97,76,0,78,0,3160
"19057000900",2959,386,17,0,146,0,0,0,3508
"19057001000",3829,444,34,0,42,0,76,0,4425
"19057001100",3313,112,135,0,50,39,29,6,3684
"19057001200",2359,116,0,0,75,0,29,0,2579
"19059450200",1898,37,4,0,34,7,24,0,2004
"19059450500",4302,464,0,0,134,5,51,0,4956
"19059450800",3008,262,2,0,10,23,23,9,3337
"19059451000",2352,62,0,0,41,0,13,0,2468
"19059451100",3506,254,15,0,81,21,82,16,3975
"19061000100",1437,480,201,214,136,144,122,72,2806
"19061000300",1627,200,39,0,96,0,38,0,2000
"19061000400",2946,795,0,2,158,136,46,6,4089
"19061000500",2070,705,136,110,307,327,118,123,3896
"19061000600",2128,453,49,16,226,116,4,29,3021
"19061000701",1746,746,0,87,20,69,36,55,2759
"19061000702",2019,361,5,60,222,0,51,0,2718
"19061000801",3730,425,0,0,73,46,12,0,4286
"19061000802",3100,181,0,0,56,0,100,0,3437
"19061000900",2651,219,0,0,49,161,61,23,3164
"19061001101",3256,231,0,0,102,7,31,21,3648
"19061001102",5986,725,6,0,29,0,42,16,6804
"19061001201",3096,363,5,0,64,23,44,0,3595
"19061001202",1419,239,26,12,29,5,34,15,1779
"19061001204",1980,29,4,166,120,5,0,0,2304
"19061001205",3823,117,37,42,353,13,18,0,4403
"19061010101",1577,200,0,0,27,0,26,0,1830
"19061010103",2605,235,0,0,20,0,0,0,2860
"19061010104",4218,81,32,0,308,15,153,0,4807
"19061010105",3500,176,5,0,95,0,36,0,3812
"19061010201",5271,184,7,33,159,26,27,37,5744
"19061010202",3964,245,6,0,81,11,10,0,4317
"19061010300",2942,230,2,0,21,4,27,38,3264
"19061010400",3224,404,0,0,67,0,5,89,3789
"19061010500",4050,391,0,0,0,0,7,60,4508
"19061010600",2955,217,0,1,14,14,191,14,3406
"19063070100",1671,184,0,7,31,0,12,0,1905
"19063070200",1511,113,2,0,14,23,13,3,1679
"19063070300",2325,276,0,0,269,0,519,103,3492
"19063070400",2461,499,19,0,13,0,173,64,3229
"19065080100",2260,316,0,0,45,29,0,0,2650
"19065080200",2319,521,0,52,91,27,80,18,3108
"19065080300",2320,123,0,0,21,0,5,3,2472
"19065080400",2589,242,0,4,77,18,133,0,3063
"19065080500",2761,527,14,0,35,58,4,113,3512
"19065080600",2109,273,0,0,22,3,9,0,2416
"19065080700",2656,323,0,4,30,38,16,18,3085
"19067480100",2525,346,0,0,16,0,31,68,2986
"19067480200",2406,246,3,12,18,18,32,7,2742
"19067480300",2178,207,43,0,42,0,3,0,2473
"19067480400",2413,537,0,31,92,40,54,26,3193
"19067480500",3851,448,84,236,40,49,30,95,4833
"19069360100",2847,310,4,0,105,29,80,29,3404
"19069360200",3761,532,0,68,55,173,486,483,5558
"19069360300",2107,317,11,2,96,9,102,23,2667
"19071970100",1975,167,0,0,27,1,11,0,2181
"19071970200",2208,292,13,6,48,19,64,4,2654
"19071970300",1954,239,3,0,59,0,70,35,2360
"19073080100",1654,387,1,0,11,0,32,10,2095
"19073080200",2161,256,0,0,22,35,32,0,2506
"19073080300",2404,321,0,0,22,24,20,75,2866
"19073080500",1543,164,0,0,32,24,56,0,1819
"19075960100",3908,263,18,8,86,5,87,0,4375
"19075960200",2833,170,0,0,45,15,0,0,3063
"19075960300",2622,266,0,0,0,0,0,0,2888
"19075960400",1805,124,0,0,44,0,45,9,2027
"19077950100",3690,351,1,0,125,16,75,29,4287
"19077950200",1914,307,0,2,17,6,25,15,2286
"19077950300",3587,510,10,9,36,9,60,18,4239
"19079960100",1703,133,12,0,82,3,12,9,1954
"19079960200",2887,207,0,5,116,220,121,220,3776
"19079960300",2534,446,32,0,61,143,68,75,3359
"19079960400",4103,478,0,0,215,0,225,48,5069
"19079960500",1506,167,0,0,39,6,0,6,1724
"19081270100",3382,295,0,0,84,0,49,62,3872
"19081270200",2320,213,0,23,10,30,22,8,2626
"19081270300",2225,133,0,17,77,57,62,77,2648
"19081270400",1911,174,0,9,15,17,89,26,2241
"19083480100",2296,244,0,0,13,21,47,49,2670
"19083480200",1655,327,62,0,21,0,265,0,2330
"19083480300",3179,262,0,0,32,0,18,51,3542
"19083480400",2599,172,0,0,60,4,60,4,2899
"19083480500",2492,244,10,0,73,7,109,12,2947
"19083480600",2278,259,0,0,209,6,9,12,2773
"19085290100",2054,298,7,0,93,3,14,1,2470
"19085290200",3001,327,0,0,76,0,57,8,3469
"19085290300",2575,287,0,2,100,12,62,0,3038
"19085290400",2837,314,0,0,11,0,52,5,3219
"19085290500",2140,120,0,0,24,8,0,0,2292
"19087970100",3195,309,0,78,274,62,304,7,4229
"19087970200",2700,369,0,15,50,13,3,0,3150
"19087970300",2776,725,49,66,280,2,13,145,4056
"19087970400",2986,736,110,28,170,140,136,197,4503
"19087970500",3146,503,0,0,77,5,17,0,3748
"19089960100",3163,583,0,6,57,25,84,42,3960
"19089960200",2423,283,31,0,16,0,0,0,2753
"19089960300",2451,261,0,0,18,2,5,0,2737
"19091970100",2014,162,4,0,32,4,41,0,2257
"19091970200",1571,179,0,0,17,55,32,57,1911
"19091970300",2295,471,0,0,54,51,69,31,2971
"19091970400",2393,200,0,0,36,1,133,0,2763
"19093090100",2255,141,0,0,36,0,57,3,2492
"19093090200",1775,423,0,0,37,0,0,0,2235
"19093090300",1812,359,0,30,28,3,12,53,2297
"19095960100",3400,126,23,0,46,26,75,0,3696
"19095960200",3117,435,32,0,25,10,183,0,3802
"19095960300",2944,344,12,1,2,27,9,2,3341
"19095960400",4803,571,15,0,22,16,80,0,5507
"19097950100",2321,203,0,0,8,8,0,0,2540
"19097950200",3183,277,19,0,28,14,76,19,3616
"19097950300",3026,351,0,0,44,20,37,1,3479
"19097950400",3459,231,1,0,9,5,14,6,3725
"19097950500",3315,588,1,0,38,106,64,0,4112
"19097950600",1706,315,3,15,119,27,26,9,2220
"19099040100",3432,309,1,0,18,13,51,13,3837
"19099040200",3252,263,0,0,30,1,37,117,3700
"19099040300",1878,436,0,0,28,24,14,0,2380
"19099040400",3740,792,86,0,94,0,18,0,4730
"19099040500",4431,646,35,28,70,37,43,18,5308
"19099040600",2322,267,0,16,149,14,0,0,2768
"19099040700",4450,494,5,0,69,2,40,21,5081
"19099040800",3721,461,1,0,16,10,23,4,4236
"19099040900",2857,104,0,4,6,5,6,0,2982
"19101090100",2598,419,0,0,118,5,7,0,3147
"19101090200",3079,318,1,0,4,0,29,11,3442
"19101090300",3576,533,63,33,309,110,193,66,4883
"19101090400",3046,453,36,79,336,189,0,63,4202
"19103000100",4230,1000,46,96,549,18,464,29,6432
"19103000200",1729,278,280,92,172,69,139,0,2759
"19103000301",6795,491,449,14,891,0,255,150,9045
"19103000302",3314,602,723,114,601,246,372,136,6108
"19103000400",3563,817,120,707,1260,731,60,12,7270
"19103000500",4744,1342,198,227,1093,91,263,84,8042
"19103000600",1666,987,21,26,533,98,90,29,3450
"19103001100",1287,1991,59,29,15,182,10,44,3617
"19103001200",1686,142,3,21,38,38,65,0,1993
"19103001300",2651,237,9,0,188,0,109,0,3194
"19103001400",3695,292,107,90,366,58,178,0,4786
"19103001500",2237,198,55,0,122,87,22,73,2794
"19103001600",1647,4124,139,171,213,575,17,138,7024
"19103001700",2286,551,122,0,77,0,29,0,3065
"19103001801",3318,190,557,193,836,226,749,218,6287
"19103001802",2353,214,545,233,358,83,450,88,4324
"19103002100",402,880,0,41,31,164,7,25,1550
"19103002300",1495,570,0,8,124,145,22,24,2388
"19103010100",6631,179,55,0,119,5,57,0,7046
"19103010200",4531,87,6,0,103,0,0,0,4727
"19103010301",8744,637,30,260,614,126,454,132,10997
"19103010302",10805,629,570,53,618,21,566,180,13442
"19103010400",6089,377,58,39,57,97,239,0,6956
"19103010500",6181,379,9,20,729,45,633,45,8041
"19105070100",3795,430,17,26,56,25,68,0,4417
"19105070300",2915,446,0,17,53,9,35,0,3475
"19105070400",4256,413,12,0,7,17,54,3,4762
"19105070500",2103,316,2,0,94,3,19,5,2542
"19105070600",3906,244,0,0,41,0,0,12,4203
"19107080100",1764,244,0,0,23,18,36,0,2085
"19107080200",2087,333,0,0,49,8,6,16,2499
"19107080300",2439,363,1,0,52,1,61,0,2917
"19107080400",2415,352,0,0,23,0,7,0,2797
"19109950100",2146,158,0,0,28,9,36,1,2378
"19109950200",2256,131,3,2,35,4,19,22,2472
"19109950300",1808,295,8,0,93,29,34,0,2267
"19109950400",2149,352,0,0,92,0,5,91,2689
"19109950500",3084,214,0,1,0,0,23,0,3322
"19109950600",2052,98,1,0,12,0,30,0,2193
"19111490100",3205,596,70,146,170,93,126,8,4414
"19111490200",3328,659,89,11,153,68,268,52,4628
"19111490300",1825,302,0,0,13,0,17,0,2157
"19111490400",2539,209,1,0,13,0,45,0,2807
"19111490500",2998,309,0,0,11,0,36,0,3354
"19111490600",3010,282,6,0,57,0,0,0,3355
"19111490700",3704,362,77,0,177,19,148,0,4487
"19111490800",1103,1131,20,0,26,51,22,11,2364
"19111490900",1450,510,68,56,53,73,77,70,2357
"19111491000",1599,326,124,21,112,19,83,0,2284
"19111491100",2754,373,258,0,112,0,147,0,3644
"19113000100",10919,847,189,0,466,159,69,40,12689
"19113000201",4229,519,238,84,411,83,77,36,5677
"19113000203",6869,150,163,2,529,0,6,0,7719
"19113000205",3935,121,61,0,82,27,0,0,4226
"19113000206",6616,157,127,0,668,0,86,77,7731
"19113000207",4092,455,290,191,492,42,123,228,5913
"19113000300",5095,342,142,36,120,0,188,0,5923
"19113000400",4584,130,31,0,320,0,167,0,5232
"19113000500",5077,460,221,65,223,0,182,0,6228
"19113000600",2863,151,7,0,62,33,36,13,3165
"19113000700",1694,343,50,7,116,44,145,41,2440
"19113000800",3459,566,145,58,553,16,370,0,5167
"19113000901",4535,321,198,105,181,14,29,66,5449
"19113000902",5332,165,118,19,446,0,352,0,6432
"19113001001",3831,148,227,1,94,0,92,6,4399
"19113001002",2957,163,95,0,171,0,47,51,3484
"19113001003",4104,867,325,714,371,181,343,157,7062
"19113001101",3865,248,28,0,48,14,27,12,4242
"19113001102",2810,318,117,17,214,11,147,0,3634
"19113001200",1047,240,90,25,124,0,116,0,1642
"19113001300",2359,192,43,98,275,57,0,31,3055
"19113001400",2908,349,0,65,127,21,63,0,3533
"19113001500",2685,91,14,27,168,10,35,0,3030
"19113001600",4749,263,122,0,343,0,71,0,5548
"19113001700",4024,191,858,89,637,124,214,10,6147
"19113001800",2752,377,39,179,136,43,10,0,3536
"19113001900",748,377,166,237,118,142,94,98,1980
"19113002200",982,226,71,148,70,163,48,74,1782
"19113002300",2939,450,104,0,84,78,29,0,3684
"19113002400",3252,138,190,337,286,0,121,1,4325
"19113002500",2322,358,100,66,164,0,34,0,3044
"19113002600",2188,478,104,34,40,12,7,86,2949
"19113002700",719,357,161,206,164,8,5,0,1620
"19113002800",3398,189,73,94,125,8,87,0,3974
"19113002900",3870,515,421,132,234,13,143,13,5341
"19113003001",7972,745,236,48,281,39,269,90,9680
"19113003002",4865,1283,18,280,239,83,109,47,6924
"19113010100",2730,294,0,0,0,0,3,17,3044
"19113010200",4209,264,35,6,43,0,22,0,4579
"19113010300",3402,264,0,0,78,0,11,31,3786
"19113010400",2655,157,0,0,27,0,6,0,2845
"19113010500",3348,287,0,0,76,7,55,0,3773
"19113010600",5838,116,39,0,49,0,51,1,6094
"19113010700",5790,95,34,10,86,0,54,20,6089
"19113010800",5427,402,10,11,480,13,337,18,6698
"19115450100",2597,204,8,5,38,6,178,60,3096
"19115450200",3194,374,36,26,453,158,1033,297,5571
"19115450300",3386,481,5,0,94,75,119,130,4290
"19117950100",1641,279,0,0,8,8,0,0,1936
"19117950200",2190,191,1,3,35,0,8,31,2459
"19117950300",1670,202,0,0,0,23,0,0,1895
"19117950400",1699,639,0,0,52,0,18,0,2408
"19119950100",2331,316,0,0,56,7,52,0,2762
"19119950200",3024,208,0,0,22,32,24,6,3316
"19119950300",5045,326,3,0,120,19,152,26,5691
"19121060100",5874,361,24,22,44,20,44,10,6399
"19121060200",4236,668,0,0,115,0,112,0,5131
"19121060300",3689,244,12,8,72,10,31,9,4075
"19123950100",2742,296,0,0,52,1,40,2,3133
"19123950200",3123,243,0,0,65,3,47,0,3481
"19123950300",3204,292,0,5,14,0,17,0,3532
"19123950400",2547,252,0,0,39,16,0,0,2854
"19123950500",2579,582,5,25,95,27,47,5,3365
"19123950600",2016,591,0,42,31,105,31,73,2889
"19123950700",1750,623,165,0,113,56,28,48,2783
"19125030100",6720,376,0,0,281,42,57,1,7477
"19125030200",5935,309,58,0,173,99,0,76,6650
"19125030300",1534,253,36,24,81,0,48,0,1976
"19125030401",3676,667,16,0,0,40,193,48,4640
"19125030402",3577,288,0,0,8,0,15,0,3888
"19125030500",1386,316,10,0,72,28,80,16,1908
"19125030600",2373,309,2,0,21,0,0,0,2705
"19125030700",2576,277,17,5,49,7,3,5,2939
"19127950100",2611,185,4,0,24,3,18,0,2845
"19127950200",2761,245,0,3,82,14,186,17,3308
"19127950300",3273,172,11,0,84,6,72,7,3625
"19127950400",2733,197,9,0,20,5,96,0,3060
"19127950500",2184,871,227,49,888,472,1625,841,7157
"19127950600",2720,542,45,0,703,253,902,127,5292
"19127950700",3294,339,31,0,360,92,745,125,4986
"19127950800",5791,84,0,0,607,0,716,17,7215
"19127950900",2696,364,9,0,370,113,1189,195,4936
"19127951000",2826,266,84,136,535,319,372,310,4848
"19129040100",2653,223,7,0,17,0,27,3,2930
"19129040201",1873,210,25,0,25,0,54,3,2190
"19129040202",3250,105,0,0,86,59,174,0,3674
"19129040301",2475,68,0,13,97,0,0,0,2653
"19129040302",3030,368,21,8,21,7,120,0,3575
"19131560100",3022,272,0,0,8,12,11,14,3339
"19131560200",3069,361,0,0,60,0,11,9,3510
"19131560300",3119,487,2,27,44,0,52,0,3731
"19133960100",1965,234,0,0,6,3,16,7,2231
"19133960200",1834,169,0,0,11,2,21,11,2048
"19133960300",2120,494,21,0,208,20,57,0,2920
"19133960400",1713,93,0,0,17,1,18,0,1842
"19135070100",2864,337,0,0,3,0,0,0,3204
"19135070200",2249,297,0,0,38,0,8,0,2592
"19135070300",1783,220,2,0,32,0,31,0,2068
"19137960100",1951,68,0,0,10,0,3,0,2032
"19137960200",1934,358,0,0,82,122,26,78,2600
"19137960300",2174,847,0,0,45,27,126,47,3266
"19137960400",2360,315,0,0,20,6,55,3,2759
"19139050100",2857,377,0,0,46,0,165,0,3445
"19139050200",4569,328,7,0,37,0,186,0,5127
"19139050300",3903,576,32,0,483,61,1592,379,7026
"19139050400",3369,606,4,0,120,9,338,113,4559
"19139050500",3722,416,72,193,95,33,288,42,4861
"19139050600",4240,509,52,13,128,26,153,84,5205
"19139050700",3891,887,63,0,630,6,756,262,6495
"19139050800",2736,454,70,61,475,26,1493,13,5328
"19139050900",2132,391,41,0,100,52,172,69,2957
"19139051000",2245,634,0,0,265,0,641,226,4011
"19141490100",2210,375,0,6,58,44,66,73,2832
"19141490200",3305,210,1,0,31,53,60,51,3711
"19141490300",4253,377,14,0,351,19,247,0,5261
"19141490400",2191,262,0,18,65,39,21,46,2642
"19143460100",2656,321,0,1,203,0,211,87,3479
"19143460200",2755,164,20,3,6,11,107,3,3069
"19145490100",2420,159,0,0,40,0,5,0,2624
"19145490200",1600,570,0,0,125,69,141,46,2551
"19145490300",2415,324,0,0,117,16,82,30,2984
"19145490400",1953,282,33,10,73,8,9,8,2376
"19145490500",2014,299,12,0,13,0,0,75,2413
"19145490600",1861,199,13,0,58,4,0,16,2151
"19147960100",1712,204,0,0,11,1,13,29,1970
"19147960200",1648,129,30,0,5,1,12,1,1826
"19147960300",3202,356,50,0,53,10,27,33,3731
"19147960400",1286,167,0,0,20,17,2,0,1492
"19149970100",5549,406,34,0,262,113,205,0,6569
"19149970200",2963,363,26,0,150,69,211,199,3981
"19149970300",2930,201,5,0,0,0,32,15,3183
"19149970400",2885,132,0,0,32,0,34,0,3083
"19149970500",2861,193,0,0,21,19,15,22,3131
"19149970600",4865,355,0,0,111,0,104,17,5452
"19151780100",1501,318,49,13,39,36,21,40,2017
"19151780200",2492,364,14,5,8,20,41,24,2968
"19151780300",1850,284,5,0,2,20,42,45,2248
"19153000101",1921,1021,336,161,164,95,149,47,3894
"19153000102",3259,368,145,21,205,12,308,33,4351
"19153000103",1700,241,27,0,13,118,102,0,2201
"19153000201",2299,88,46,8,309,86,474,0,3310
"19153000202",2597,411,241,0,283,11,220,142,3905
"19153000300",2221,228,294,0,488,105,449,58,3843
"19153000400",3322,362,480,20,465,160,916,123,5848
"19153000500",2768,628,538,82,433,358,559,278,5644
"19153000600",2774,484,171,82,294,77,352,68,4302
"19153000701",1213,205,419,594,703,121,180,90,3525
"19153000702",2136,227,314,193,475,22,28,75,3470
"19153000703",2377,274,46,37,150,8,100,61,3053
"19153000704",2387,117,94,9,319,66,101,0,3093
"19153000801",4133,516,346,87,546,108,263,119,6118
"19153000802",2931,140,40,0,41,30,20,0,3202
"19153000803",2976,190,82,141,577,159,100,8,4233
"19153000901",2765,301,93,26,174,11,17,24,3411
"19153000902",2673,179,52,93,101,11,32,2,3143
"19153001000",2628,535,365,15,256,274,149,53,4275
"19153001100",1411,785,599,727,145,338,674,451,5130
"19153001200",1030,416,891,554,314,402,767,300,4674
"19153001500",2270,303,167,28,241,81,338,29,3457
"19153001700",988,296,614,248,470,50,760,101,3527
"19153001800",1371,303,70,6,182,7,74,34,2047
"19153001900",2920,605,169,58,100,293,360,281,4786
"19153002100",3116,674,122,261,323,181,671,176,5524
"19153002600",831,339,369,274,340,177,435,244,3009
"19153002700",1470,502,322,479,99,82,100,11,3065
"19153002800",2204,570,154,10,305,290,147,188,3868
"19153002900",2644,531,96,87,80,486,117,307,4348
"19153003001",1668,118,55,35,18,42,40,27,2003
"19153003002",3092,106,0,14,149,0,64,1,3426
"19153003100",1610,129,0,0,78,6,18,6,1847
"19153003200",2181,93,31,0,69,43,62,0,2479
"19153003901",1756,594,415,315,552,260,552,726,5170
"19153003902",2905,717,567,191,663,335,691,192,6261
"19153004001",2302,475,385,646,127,6,40,0,3981
"19153004004",2772,66,131,0,268,36,147,36,3456
"19153004100",2519,412,110,0,149,17,67,17,3291
"19153004200",1179,448,204,7,93,0,233,168,2332
"19153004300",4222,458,390,341,70,33,85,221,5820
"19153004400",2519,630,165,278,132,352,357,384,4817
"19153004501",2910,453,67,78,471,192,295,70,4536
"19153004502",2111,179,2,13,188,53,114,15,2675
"19153004602",4332,778,589,154,280,142,975,218,7468
"19153004603",2409,355,287,10,134,44,146,0,3385
"19153004701",3387,596,57,0,211,135,356,351,5093
"19153004702",1543,511,161,260,301,115,440,63,3394
"19153004800",1249,284,268,453,496,342,759,304,4155
"19153004900",690,518,120,153,277,79,257,233,2327
"19153005000",659,431,781,627,915,138,694,233,4478
"19153005100",2484,774,199,288,340,382,563,87,5117
"19153005200",1955,621,210,269,219,168,940,152,4534
"19153005300",1540,288,147,32,439,11,183,0,2640
"19153010101",3925,214,0,0,15,5,7,5,4171
"19153010102",6029,299,0,0,195,0,272,0,6795
"19153010203",19673,753,172,0,1523,0,516,31,22668
"19153010205",5282,875,53,0,159,0,87,42,6498
"19153010207",4272,200,0,0,169,14,68,0,4723
"19153010208",3808,128,43,0,176,40,42,0,4237
"19153010209",5050,587,75,54,156,55,34,14,6025
"19153010211",3346,221,67,0,91,14,33,0,3772
"19153010212",3819,273,39,0,137,0,61,0,4329
"19153010404",3965,96,98,0,382,0,252,0,4793
"19153010405",5195,795,273,6,494,3,70,5,6841
"19153010406",3508,144,231,31,91,37,243,0,4285
"19153010407",4318,172,36,0,12,13,82,0,4633
"19153010408",3421,215,258,132,185,24,153,0,4388
"19153010409",3868,256,19,0,89,0,125,0,4357
"19153010500",4718,541,34,20,123,17,211,272,5936
"19153010600",6710,905,0,0,666,119,252,53,8705
"19153010702",4610,445,7,4,93,8,112,3,5282
"19153010703",4275,313,36,0,89,0,157,29,4899
"19153010705",3921,58,7,0,28,0,71,0,4085
"19153010706",6061,429,37,0,274,29,244,0,7074
"19153010802",6899,1494,255,260,832,58,503,432,10733
"19153010803",4261,135,195,130,195,93,142,109,5260
"19153010804",3969,275,43,0,315,0,237,200,5039
"19153011001",2473,423,305,37,214,14,488,80,4034
"19153011021",4270,124,173,0,203,12,107,0,4889
"19153011025",3380,89,52,14,329,11,36,0,3911
"19153011026",5474,183,0,0,119,90,214,0,6080
"19153011027",6236,358,194,1,786,12,403,0,7990
"19153011028",4103,177,92,12,634,0,318,0,5336
"19153011111",3999,354,191,80,375,350,316,191,5856
"19153011112",3830,217,11,0,112,47,287,0,4504
"19153011113",1871,119,130,77,210,105,51,12,2575
"19153011114",2734,163,321,144,926,0,608,46,4942
"19153011201",3949,485,72,3,244,246,31,156,5186
"19153011203",3414,49,0,0,185,0,13,0,3661
"19153011205",2474,229,230,21,723,76,1140,79,4972
"19153011206",3255,20,13,0,203,0,56,0,3547
"19153011300",14061,682,129,2,797,89,205,85,16050
"19153011404",5650,274,70,69,304,0,140,0,6507
"19153011500",5676,126,0,0,110,0,19,0,5931
"19153011600",0,0,0,0,0,0,0,0,0
"19153011701",8131,364,0,0,451,0,27,84,9057
"19153011702",2795,203,0,0,148,14,27,0,3187
"19155021200",3004,427,90,0,111,101,338,11,4082
"19155021400",3026,124,0,0,28,0,28,0,3206
"19155021501",2272,189,0,0,16,0,54,0,2531
"19155021502",2283,258,0,0,50,0,41,0,2632
"19155021602",2536,91,0,0,40,0,3,0,2670
"19155021603",2355,118,0,0,30,0,17,0,2520
"19155021701",2098,137,0,0,147,0,125,6,2513
"19155021702",1854,149,0,0,49,11,5,0,2068
"19155030100",5195,557,26,0,38,0,159,0,5975
"19155030200",2662,296,2,25,108,81,53,15,3242
"19155030300",2781,161,0,51,99,9,112,0,3213
"19155030401",3193,607,20,60,230,19,653,276,5058
"19155030402",2308,506,0,15,82,64,66,46,3087
"19155030501",1816,198,61,6,107,0,84,19,2291
"19155030502",2236,232,44,0,51,0,353,56,2972
"19155030601",1606,401,0,28,21,7,95,0,2158
"19155030602",1537,657,0,0,212,319,294,48,3067
"19155030700",1915,666,0,0,38,181,275,157,3232
"19155030800",2825,603,0,0,0,6,325,117,3876
"19155030900",1075,587,0,14,93,13,126,124,2032
"19155031000",1675,399,70,6,58,0,84,9,2301
"19155031100",2069,639,0,0,151,12,389,211,3471
"19155031200",2748,347,48,18,41,0,171,8,3381
"19155031300",1966,367,0,0,109,120,379,0,2941
"19155031400",2592,608,0,19,198,7,213,31,3668
"19155031601",4140,213,20,0,124,0,89,0,4586
"19155031602",2481,134,0,0,88,98,94,0,2895
"19155031700",3152,400,32,35,209,0,131,36,3995
"19155031800",2775,447,11,0,69,50,33,0,3385
"19155031900",3583,92,35,0,6,0,200,0,3916
"19157370100",2626,284,3,0,37,4,48,2,3004
"19157370200",2688,230,0,0,31,3,6,73,3031
"19157370300",3704,314,26,16,86,9,61,47,4263
"19157370400",2808,547,0,27,264,63,52,26,3787
"19157370500",2810,416,6,4,22,13,11,11,3293
"19159950100",1721,397,0,0,19,0,24,8,2169
"19159950200",2271,411,9,1,75,0,27,0,2794
"19161080100",2388,215,10,5,42,13,131,29,2833
"19161080200",2404,206,7,11,0,0,14,0,2642
"19161080300",1988,127,12,0,0,3,40,0,2170
"19161080400",2226,190,27,6,55,0,21,0,2525
"19163010101",3430,103,0,9,37,30,13,0,3622
"19163010102",6215,194,64,0,304,60,136,0,6973
"19163010201",5577,269,105,0,39,0,69,0,6059
"19163010202",5701,318,33,0,121,0,208,1,6382
"19163010300",2324,181,13,0,26,0,0,0,2544
"19163010401",5107,282,21,0,51,0,144,0,5605
"19163010402",3425,189,0,12,84,0,27,16,3753
"19163010600",914,634,317,301,167,128,285,94,2840
"19163010700",617,289,371,272,137,170,198,28,2082
"19163010800",1272,542,210,202,336,150,332,283,3327
"19163010900",799,271,115,37,109,116,257,53,1757
"19163011000",1364,538,160,106,30,67,256,77,2598
"19163011100",3009,134,110,41,92,16,251,57,3710
"19163011200",1051,444,239,166,137,9,193,109,2348
"19163011300",1464,365,707,313,384,108,130,45,3516
"19163011400",1483,585,238,123,230,84,217,130,3090
"19163011500",1261,194,574,57,92,101,158,70,2507
"19163011600",2558,444,65,70,125,376,26,252,3916
"19163011700",2580,157,8,156,141,33,218,69,3362
"19163011800",1632,342,0,0,74,0,160,0,2208
"19163011900",2144,117,196,58,64,39,133,0,2751
"19163012000",3159,208,80,125,138,28,211,17,3966
"19163012100",3140,160,179,52,320,37,265,41,4194
"19163012200",1678,372,122,0,52,8,152,53,2437
"19163012300",1151,173,35,100,67,15,143,49,1733
"19163012400",970,197,4,0,42,0,33,19,1265
"19163012501",2745,280,334,331,297,27,338,29,4381
"19163012502",2792,526,226,45,165,10,242,259,4265
"19163012601",3610,778,415,251,170,62,79,3,5368
"19163012602",2420,727,372,634,284,133,56,107,4733
"19163012701",2012,530,273,69,456,17,146,0,3503
"19163012702",2602,137,59,97,65,84,175,1,3220
"19163012801",3031,354,569,370,267,46,345,0,4982
"19163012802",3493,454,490,18,185,0,491,0,5131
"19163012901",3465,551,459,53,77,39,33,74,4751
"19163012902",4542,260,302,141,287,77,395,0,6004
"19163013000",4030,409,161,46,194,0,223,71,5134
"19163013100",1622,117,27,0,15,0,65,0,1846
"19163013200",1487,71,4,0,91,0,73,0,1726
"19163013300",3090,249,85,67,19,0,65,0,3575
"19163013400",2702,293,0,0,29,12,97,47,3180
"19163013500",2469,336,268,242,75,24,81,0,3495
"19163013600",2410,100,65,0,99,0,110,0,2784
"19163013702",4940,142,99,0,512,68,24,0,5785
"19163013703",2704,0,7,0,119,4,168,0,3002
"19163013705",4257,304,130,2,432,13,191,12,5341
"19163013706",3841,78,216,0,430,0,237,0,4802
"19165960100",2671,236,0,0,33,9,7,17,2973
"19165960200",2696,282,0,1,57,0,5,2,3043
"19165960300",2903,199,0,0,260,35,173,35,3605
"19165960400",1724,612,8,0,6,0,0,0,2350
"19167070100",3568,176,0,0,75,8,146,61,4034
"19167070200",3601,337,4,1,174,94,225,79,4515
"19167070300",5058,587,41,5,105,0,104,49,5949
"19167070400",3394,437,6,0,141,178,285,441,4882
"19167070500",2603,83,17,0,127,61,196,63,3150
"19167070600",4406,245,4,0,244,153,218,204,5474
"19167070700",4890,232,11,0,627,101,737,221,6819
"19169000100",8780,616,335,0,1023,163,397,0,11314
"19169000200",2854,204,179,16,332,42,129,0,3756
"19169000300",2526,523,108,0,212,79,51,33,3532
"19169000400",2157,284,0,0,34,29,19,0,2523
"19169000500",404,1435,56,143,289,691,70,122,3210
"19169000600",3479,626,170,15,313,20,88,5,4716
"19169000700",1139,1453,18,54,207,432,8,53,3364
"19169000800",0,4,0,0,0,0,0,0,4
"19169000900",2712,295,120,73,161,0,40,4,3405
"19169001000",2122,858,106,120,500,759,64,108,4637
"19169001100",1533,1798,14,0,165,390,50,32,3982
"19169001200",70,12,0,0,0,0,0,0,82
"19169001301",4883,3869,118,203,686,242,133,209,10343
"19169001302",3600,654,59,57,269,12,169,102,4922
"19169010100",6522,408,25,0,104,0,144,8,7211
"19169010200",3508,274,0,0,87,17,63,13,3962
"19169010300",3663,508,34,0,98,76,18,90,4487
"19169010400",2462,247,20,7,16,0,181,0,2933
"19169010500",1622,159,3,0,34,18,0,0,1836
"19169010600",4803,301,5,22,181,14,87,0,5413
"19171290100",2786,247,0,0,33,0,12,0,3078
"19171290200",2608,265,0,0,43,0,91,6,3013
"19171290300",2318,143,37,0,36,1,2,0,2537
"19171290400",1755,443,6,2,304,95,239,225,3069
"19171290500",1883,597,12,3,724,214,372,322,4127
"19171290600",2247,75,5,0,210,32,83,18,2670
"19173180100",1893,379,0,0,35,47,223,147,2724
"19173180200",1667,257,11,3,29,59,15,41,2082
"19173180300",1600,92,0,0,11,2,0,0,1705
"19175190100",1909,320,8,0,19,4,52,18,2330
"19175190200",3049,748,11,88,32,9,101,0,4038
"19175190300",2068,105,0,0,4,0,0,0,2177
"19175190400",3439,348,45,2,45,0,98,0,3977
"19177950100",3450,765,0,4,20,12,72,14,4337
"19177950200",2774,281,1,0,58,27,5,0,3146
"19179960100",2649,211,19,19,0,70,136,0,3104
"19179960200",1314,767,0,0,332,57,528,47,3045
"19179960300",3484,180,0,0,146,44,140,44,4038
"19179960400",2693,709,113,59,211,92,397,18,4292
"19179960500",1301,877,135,0,112,0,216,380,3021
"19179960600",2039,457,0,8,221,0,309,91,3125
"19179960700",2855,576,35,0,36,0,105,201,3808
"19179960800",2578,453,0,10,117,34,176,0,3368
"19179960900",1930,652,26,100,160,121,214,136,3339
"19179961000",2658,655,14,0,52,5,74,92,3550
"19179961100",2540,409,5,0,72,10,36,12,3084
"19181020100",1974,79,25,0,16,0,107,2,2203
"19181020200",6921,85,0,0,162,22,260,22,7472
"19181020300",4630,94,0,0,155,0,27,0,4906
"19181020400",3695,225,0,150,73,35,26,0,4204
"19181020500",2158,83,0,0,43,0,21,0,2305
"19181020600",2814,119,0,0,35,0,0,26,2994
"19181020700",3336,194,0,0,90,77,84,56,3837
"19181020800",2643,125,0,0,28,0,24,6,2826
"19181020900",2779,450,53,24,131,0,73,0,3510
"19181021000",2299,395,0,0,6,20,6,0,2726
"19181021100",4483,326,0,0,104,11,140,25,5089
"19181021200",3725,312,0,0,68,3,43,25,4176
"19183960100",5726,589,7,0,79,13,38,9,6461
"19183960200",4357,260,12,3,52,12,82,0,4778
"19183960300",2787,346,29,37,210,16,345,71,3841
"19183960400",3178,248,67,19,193,41,188,19,3953
"19183960500",2836,222,0,5,96,9,236,100,3504
"19185070100",2020,250,4,0,29,13,43,0,2359
"19185070200",1467,152,0,0,23,9,14,0,1665
"19185070300",1888,364,2,8,8,31,0,0,2301
"19187000100",5465,325,72,0,166,0,78,0,6106
"19187000200",3030,318,30,0,160,0,51,0,3589
"19187000300",951,348,0,0,3,41,14,85,1442
"19187000400",1592,440,123,192,58,136,135,177,2853
"19187000500",1109,400,0,194,32,0,61,63,1859
"19187000600",3689,679,30,0,257,43,152,0,4850
"19187000700",862,390,82,130,54,27,56,110,1711
"19187000900",1756,645,46,157,39,49,0,233,2925
"19187010100",2146,115,0,0,22,0,68,0,2351
"19187010200",1800,46,8,0,0,0,60,0,1914
"19187010300",2848,420,39,0,73,0,44,7,3431
"19187010400",2803,391,0,0,17,4,13,12,3240
"19189680100",3376,346,11,0,142,0,97,0,3972
"19189680200",2495,275,0,8,36,24,41,24,2903
"19189680300",2876,350,38,3,88,20,102,105,3582
"19191950100",3248,203,0,0,20,25,0,16,3512
"19191950200",3011,407,109,0,102,0,67,0,3696
"19191950300",3156,249,26,0,133,0,64,23,3651
"19191950400",4238,211,0,0,131,6,181,0,4767
"19191950500",2882,342,26,0,21,7,55,1,3334
"19193000100",2761,697,83,0,518,207,602,187,5055
"19193000200",5425,383,0,19,328,346,273,372,7146
"19193000300",5861,195,47,29,377,184,899,131,7723
"19193000400",4072,219,19,0,209,83,208,0,4810
"19193000500",2435,266,13,9,371,58,58,48,3258
"19193000600",2331,227,21,0,33,7,171,7,2797
"19193000700",1895,510,5,19,253,290,437,157,3566
"19193000800",2205,419,279,178,440,318,611,616,5066
"19193000900",1752,103,17,17,237,15,203,6,2350
"19193001000",977,272,286,121,273,19,320,0,2268
"19193001100",2431,692,163,40,574,482,743,697,5822
"19193001200",1054,418,113,0,788,628,1039,760,4800
"19193001300",434,246,84,119,291,171,259,56,1660
"19193001400",2482,810,121,126,917,269,1729,420,6874
"19193001500",638,369,116,35,322,411,247,250,2388
"19193001800",4361,838,34,0,326,272,681,109,6621
"19193001900",2419,225,15,2,166,32,223,5,3087
"19193002000",4033,488,149,0,55,14,230,37,5006
"19193002101",2712,93,0,0,89,0,0,0,2894
"19193002102",5362,364,25,0,281,32,282,231,6577
"19193003100",3419,514,0,0,75,26,68,26,4128
"19193003200",4307,307,18,1,82,0,61,0,4776
"19193003300",5821,1104,0,0,306,0,91,0,7322
"19193003500",3594,197,36,0,65,57,79,0,4028
"19193003600",1053,607,381,31,720,204,532,363,3891
"19193940200",0,0,0,0,0,0,0,0,0
"19195690100",1905,345,0,27,14,18,52,0,2361
"19195690200",1987,191,0,0,24,0,38,0,2240
"19195690300",2457,376,0,0,63,9,43,45,2993
"19197680100",3213,210,11,0,33,7,230,53,3757
"19197680200",1444,108,1,0,7,17,0,42,1619
"19197680300",2370,435,7,5,143,47,174,95,3276
"19197680400",1028,104,3,0,25,7,37,2,1206
"19197680500",2927,438,11,0,73,70,351,286,4156
"20001952600",1866,223,0,2,17,1,43,0,2152
"20001952700",1539,407,0,0,125,14,33,0,2118
"20001952800",2720,503,43,90,37,55,0,33,3481
"20001952900",1660,668,74,0,66,83,47,0,2598
"20001953000",2070,217,24,0,195,33,190,47,2776
"20003953600",3714,699,0,1,227,81,47,2,4771
"20003953700",2712,360,2,1,16,15,2,4,3112
"20005081600",3898,338,0,4,93,36,79,7,4455
"20005081700",3704,533,361,51,98,109,81,57,4994
"20005081800",2029,631,108,32,73,2,34,0,2909
"20005081900",2070,1045,129,28,173,39,9,5,3498
"20007968100",2570,358,0,1,40,24,31,68,3092
"20007968200",1573,169,8,2,77,10,43,2,1884
"20009971100",3483,400,0,17,93,22,171,0,4186
"20009971200",1552,186,0,0,23,0,8,0,1769
"20009971300",2512,434,0,18,43,42,0,60,3109
"20009971400",2351,166,98,9,133,13,56,9,2835
"20009971500",2829,475,89,45,100,0,170,118,3826
"20009971600",3206,387,11,107,139,9,123,70,4052
"20009971700",1834,771,60,18,530,140,1064,631,5048
"20009971800",3460,681,0,0,117,370,564,664,5856
"20011955600",2110,463,15,0,3,43,53,2,2689
"20011955700",1956,198,0,3,74,85,5,1,2322
"20011955800",2968,322,69,0,29,0,84,1,3473
"20011955900",2519,674,65,218,43,20,25,130,3694
"20011956000",1821,519,189,0,82,10,0,8,2629
"20013480600",1814,353,80,3,529,233,46,61,3119
"20013480700",2498,721,44,9,163,22,97,15,3569
"20013480800",2532,476,31,3,199,73,69,55,3438
"20015020100",4413,422,0,0,141,11,75,3,5065
"20015020201",5525,711,18,0,88,27,276,0,6645
"20015020202",7109,273,312,0,260,0,479,86,8519
"20015020203",5663,243,12,0,476,0,230,21,6645
"20015020300",2909,212,27,0,145,21,103,46,3463
"20015020400",2072,387,14,0,71,139,54,69,2806
"20015020500",3956,1319,0,0,121,0,196,0,5592
"20015020600",6151,665,78,58,268,49,84,10,7363
"20015020700",3539,361,0,0,154,49,124,29,4256
"20015020800",2331,322,18,46,227,124,186,92,3346
"20015020901",3944,120,19,0,258,8,168,0,4517
"20015020902",3723,21,9,31,187,0,187,26,4184
"20015020903",3410,266,9,0,77,0,37,16,3815
"20017960600",2249,293,9,0,61,4,83,2,2701
"20019964600",2641,470,8,3,272,83,49,47,3573
"20021958100",2008,367,0,0,167,113,5,0,2660
"20021958200",1637,374,0,0,61,94,40,11,2217
"20021958300",3007,504,0,0,303,62,70,52,3998
"20021958400",2749,632,66,32,206,197,15,0,3897
"20021958500",3256,596,5,0,36,0,216,0,4109
"20021958600",3133,681,0,0,502,72,31,0,4419
"20023950200",2362,220,0,0,56,14,167,0,2819
"20025967100",1739,197,10,3,69,89,203,60,2370
"20027458100",3430,388,43,0,22,3,114,6,4006
"20027458200",3673,530,27,0,177,1,77,8,4493
"20029977100",2127,176,0,6,10,3,10,0,2332
"20029977200",1631,442,1,0,31,100,22,15,2242
"20029977300",2369,621,0,0,21,27,75,135,3248
"20029977400",1164,161,0,5,17,3,12,9,1371
"20031966100",2374,187,23,5,62,6,8,22,2687
"20031966200",2645,186,5,0,54,16,29,0,2935
"20031966300",2407,277,0,13,60,29,141,0,2927
"20033967600",1686,89,0,0,58,6,84,0,1923
"20035493100",2416,342,0,0,100,5,134,11,3008
"20035493200",2613,316,68,0,96,25,69,16,3203
"20035493300",2161,129,52,0,38,0,82,0,2462
"20035493400",2087,290,74,6,129,0,155,12,2753
"20035493500",2625,696,87,53,381,171,276,125,4414
"20035493600",2882,684,9,3,494,87,136,66,4361
"20035493700",2330,656,59,32,214,76,454,155,3976
"20035493800",2932,704,126,145,366,292,242,479,5286
"20035493900",2799,384,8,0,282,0,13,71,3557
"20035494000",1104,344,0,0,292,116,264,147,2267
"20035494100",1118,323,14,35,159,80,235,96,2060
"20037956600",3355,795,2,0,87,36,36,19,4330
"20037956700",3325,458,8,0,68,4,192,0,4055
"20037956800",2589,239,4,7,152,48,148,42,3229
"20037956900",3382,513,2,0,73,115,235,0,4320
"20037957000",2759,606,17,15,62,26,79,164,3728
"20037957100",1440,482,18,10,196,138,110,44,2438
"20037957200",1984,323,14,0,15,4,25,29,2394
"20037957300",2083,669,33,47,144,31,120,0,3127
"20037957400",1823,291,31,30,35,17,256,6,2489
"20037957500",1082,771,65,59,241,175,120,38,2551
"20037957600",3855,1902,272,47,74,244,63,84,6541
"20039951100",787,154,2,0,31,2,0,0,976
"20039951200",1534,263,7,0,35,0,46,10,1895
"20041084100",3442,423,0,0,231,11,176,3,4286
"20041084200",1974,256,0,0,135,0,102,36,2503
"20041084300",2010,144,26,1,60,141,53,1,2436
"20041084400",4162,570,0,0,109,24,163,24,5052
"20041084500",2887,264,2,0,61,12,81,31,3338
"20041084600",1839,313,21,0,110,28,136,22,2469
"20043020100",1469,228,16,4,130,13,31,0,1891
"20043020200",1881,152,1,0,16,2,17,0,2069
"20043020300",2699,369,47,86,63,71,73,61,3469
"20045000100",2464,216,92,0,146,13,118,4,3053
"20045000200",4096,1534,133,199,515,338,312,78,7205
"20045000300",1887,3181,199,14,121,14,166,93,5675
"20045000400",164,142,0,3,220,108,32,13,682
"20045000501",1974,512,257,40,308,28,52,91,3262
"20045000502",2299,1216,53,52,339,72,212,30,4273
"20045000603",4890,312,185,9,714,65,158,55,6388
"20045000604",4158,432,113,0,148,0,143,0,4994
"20045000702",3938,1507,238,45,670,348,529,40,7315
"20045000797",4187,432,74,46,329,81,372,0,5521
"20045000801",3391,671,352,82,785,419,195,155,6050
"20045000802",4103,1684,83,74,464,189,456,468,7521
"20045000901",2838,1273,310,85,1023,305,484,259,6577
"20045000902",1187,229,189,92,237,112,91,19,2156
"20045001001",1311,191,78,6,300,7,26,15,1934
"20045001002",4076,624,301,31,665,123,434,46,6300
"20045001201",1575,71,13,8,20,0,7,0,1694
"20045001202",6450,462,145,0,240,77,91,0,7465
"20045001203",5504,369,16,0,152,52,105,43,6241
"20045001400",4045,373,36,0,162,82,46,0,4744
"20045001500",1860,195,36,0,155,28,52,17,2343
"20045001600",7008,307,405,39,948,105,211,36,9059
"20047969600",1234,138,0,0,67,24,224,61,1748
"20047969700",1203,186,1,1,36,2,202,71,1702
"20049965100",2142,393,16,0,103,21,51,40,2766
"20051072600",2422,222,0,0,39,1,0,25,2709
"20051072701",4584,858,81,15,59,46,17,210,5870
"20051072702",2122,295,12,0,55,2,47,0,2533
"20051072800",6250,917,167,0,181,305,138,404,8362
"20051072900",3597,1513,0,0,353,269,367,126,6225
"20051073000",3154,111,7,4,27,39,130,0,3472
"20053086600",1791,101,2,0,19,0,77,10,2000
"20053086700",2984,329,7,1,113,48,89,3,3574
"20055960100",3462,412,20,15,250,101,670,164,5094
"20055960200",4491,883,208,113,999,86,3191,624,10595
"20055960300",2173,164,4,1,238,51,698,95,3424
"20055960401",1280,174,15,0,218,110,179,110,2086
"20055960403",1943,203,0,0,273,20,696,42,3177
"20055960404",2077,344,215,14,239,205,630,194,3918
"20055960501",1254,407,0,0,474,142,1147,438,3862
"20055960503",1043,53,0,0,125,112,287,162,1782
"20055960505",923,220,0,0,268,127,705,283,2526
"20055960507",914,323,3,0,370,4,690,231,2535
"20055960508",1240,201,0,0,967,168,1445,340,4361
"20055960600",3465,1254,15,95,1030,250,3262,1219,10590
"20057961600",1877,255,0,0,43,9,128,86,2398
"20057961700",1786,276,4,8,131,14,112,35,2366
"20057961800",5455,1838,123,22,806,281,2555,1610,12690
"20057961900",6184,825,21,151,450,156,3252,712,11751
"20057962000",4163,757,0,0,160,264,2715,752,8811
"20057962101",2829,748,97,116,646,52,2982,619,8089
"20057962102",2389,195,0,155,388,125,2152,230,5634
"20059954100",5743,674,18,36,170,55,61,2,6759
"20059954200",1855,607,49,6,104,23,124,23,2791
"20059954300",4142,501,18,36,412,103,241,103,5556
"20059954400",3654,553,9,69,79,55,93,25,4537
"20059954500",5105,592,18,0,217,127,83,123,6265
"20061000100",992,349,277,217,284,218,258,200,2795
"20061000200",1232,704,657,75,419,163,377,290,3917
"20061000300",2840,288,845,76,557,164,535,19,5324
"20061000400",4267,422,1025,209,576,51,619,64,7233
"20061000500",1149,379,460,33,429,107,70,154,2781
"20061000600",4203,438,734,39,709,72,1029,27,7251
"20061000700",2106,221,420,45,376,31,252,23,3474
"20061000800",4809,260,853,33,757,39,865,86,7702
"20063955100",1452,127,12,1,20,4,7,2,1625
"20063955200",1004,63,14,0,17,6,8,1,1113
"20065952100",792,113,11,45,7,0,0,0,968
"20065952200",1340,113,31,40,61,15,54,16,1670
"20067963600",1382,86,0,0,25,42,149,65,1749
"20067963700",4016,547,0,0,1264,415,2643,682,9567
"20069962600",2554,352,0,0,54,4,467,191,3622
"20069962700",2724,193,0,0,49,17,182,35,3200
"20071958100",991,53,5,4,37,105,141,105,1441
"20073965600",1681,312,0,0,27,5,94,54,2173
"20073965700",2173,259,0,0,50,49,59,29,2619
"20073965800",1373,307,0,0,91,19,0,0,1790
"20075958600",1984,375,0,0,223,41,608,243,3474
"20077961600",1570,256,0,2,48,15,122,32,2045
"20077961700",1095,190,0,0,95,8,88,34,1510
"20077961800",1992,406,0,0,42,15,0,71,2526
"20079030100",2989,814,68,42,320,189,436,213,5071
"20079030200",4799,520,60,0,146,23,509,34,6091
"20079030300",4280,667,25,8,310,164,843,354,6651
"20079030400",3597,906,141,7,332,58,774,162,5977
"20079030500",5170,338,7,10,128,56,186,44,5939
"20079030600",6207,754,60,0,148,70,168,8,7415
"20081463100",3199,332,0,0,482,143,866,306,5328
"20083461100",1783,103,0,0,18,3,191,0,2098
"20085082600",4821,353,14,0,232,59,174,32,5685
"20085082700",3064,377,37,0,240,103,156,27,4004
"20085082800",2793,160,33,0,686,213,50,47,3982
"20087020101",5414,194,25,0,261,12,111,15,6032
"20087020102",2496,220,5,3,133,5,41,0,2903
"20087020200",3567,351,0,0,78,10,68,6,4080
"20087020300",4906,623,20,0,177,23,118,12,5879
"20089576100",928,196,0,2,6,2,10,21,1165
"20089576200",1640,175,3,0,28,46,23,13,1928
"20091050000",4530,120,17,2,202,5,364,28,5268
"20091050100",3364,445,94,0,167,43,413,133,4659
"20091050200",3153,154,202,6,238,0,360,7,4120
"20091050301",2637,347,524,63,385,14,196,46,4212
"20091050302",1318,65,0,13,78,0,51,0,1525
"20091050400",3462,576,149,70,391,196,521,156,5521
"20091050500",2245,145,45,6,128,0,256,0,2825
"20091050600",4104,122,14,0,174,1,321,1,4737
"20091050700",4454,126,28,0,191,51,113,36,4999
"20091050800",2669,59,0,0,86,0,84,0,2898
"20091050900",4145,94,26,46,53,0,81,13,4458
"20091051000",3389,130,12,6,136,0,130,0,3803
"20091051100",3021,157,89,38,184,28,623,110,4250
"20091051200",3295,305,117,0,180,158,374,35,4464
"20091051300",3241,330,99,0,285,171,130,38,4294
"20091051400",2961,26,0,0,43,0,18,0,3048
"20091051500",3461,263,149,15,78,2,99,6,4073
"20091051600",5066,171,20,0,104,11,0,17,5389
"20091051700",4175,171,11,0,135,0,82,1,4575
"20091051801",3240,92,0,0,106,0,36,0,3474
"20091051802",5039,211,169,0,659,160,980,34,7252
"20091051803",3463,217,280,0,211,30,143,71,4415
"20091051804",4108,846,253,35,230,0,491,491,6454
"20091051805",4901,134,134,0,161,58,300,83,5771
"20091051806",4465,70,94,45,136,18,164,0,4992
"20091051902",3533,59,234,22,255,5,209,0,4317
"20091051903",1998,217,566,0,267,12,295,9,3364
"20091051904",4666,344,141,0,196,15,153,13,5528
"20091051906",4097,256,382,416,486,142,1060,86,6925
"20091051907",2434,701,481,80,389,51,262,414,4812
"20091051908",1252,44,60,256,59,0,44,0,1715
"20091051909",5018,170,54,52,360,44,208,0,5906
"20091052001",1683,300,179,15,88,25,97,0,2387
"20091052003",4744,791,394,63,519,104,913,199,7727
"20091052004",1300,92,102,4,48,0,185,56,1787
"20091052101",1711,174,89,0,49,8,37,29,2097
"20091052102",2231,267,58,12,64,2,195,0,2829
"20091052201",2549,355,248,88,375,38,408,38,4099
"20091052202",3105,27,86,0,112,0,136,5,3471
"20091052303",5508,313,339,426,608,260,732,225,8411
"20091052304",3864,260,163,0,313,29,183,40,4852
"20091052305",4033,191,95,9,83,51,386,0,4848
"20091052306",3038,83,165,0,219,64,56,0,3625
"20091052405",5719,699,149,20,525,38,976,563,8689
"20091052410",4212,223,242,0,269,10,129,0,5085
"20091052411",2711,37,98,0,357,21,163,0,3387
"20091052414",3852,23,57,0,189,22,146,0,4289
"20091052415",2496,51,310,0,197,0,118,0,3172
"20091052416",4205,428,28,28,61,1,410,17,5178
"20091052417",2058,519,520,76,360,44,389,302,4268
"20091052418",1721,560,238,163,234,272,281,113,3582
"20091052419",3313,704,306,89,525,68,308,180,5493
"20091052421",3376,78,35,0,175,0,46,0,3710
"20091052502",1466,18,0,0,144,0,39,0,1667
"20091052504",4109,337,494,0,626,69,93,152,5880
"20091052601",6706,248,171,0,631,0,92,19,7867
"20091052603",15114,321,381,33,1192,46,299,50,17436
"20091052604",1412,42,16,0,27,0,54,0,1551
"20091052606",1511,112,110,0,144,19,137,11,2044
"20091052607",1852,55,10,0,0,0,37,0,1954
"20091052700",5570,899,161,125,673,157,696,206,8487
"20091052801",8919,79,354,0,426,44,490,0,10312
"20091052802",7737,21,72,0,864,31,725,0,9450
"20091052803",2494,247,312,6,623,34,475,30,4221
"20091052904",2851,124,363,0,190,8,269,45,3850
"20091052905",2713,879,239,150,445,10,1086,715,6237
"20091052906",3743,421,343,32,273,264,523,143,5742
"20091052907",3128,264,553,88,331,128,248,221,4961
"20091052908",4725,756,88,3,224,92,629,564,7081
"20091052910",2968,178,167,0,525,62,259,0,4159
"20091053002",3924,151,323,108,377,0,139,19,5041
"20091053004",3226,129,303,17,57,7,262,0,4001
"20091053005",1101,97,256,6,240,6,30,0,1736
"20091053006",2634,163,181,22,279,0,44,10,3333
"20091053007",4231,159,234,48,478,22,331,44,5547
"20091053008",3685,308,280,0,390,45,190,14,4912
"20091053009",3959,129,177,37,319,36,160,0,4817
"20091053010",4332,44,30,0,391,73,37,42,4949
"20091053011",1733,70,53,0,313,0,29,22,2220
"20091053101",3387,87,172,28,383,63,213,12,4345
"20091053102",3470,133,198,9,640,36,255,0,4741
"20091053105",2012,255,445,96,777,97,365,28,4075
"20091053108",3133,237,127,0,810,0,159,0,4466
"20091053109",1702,25,154,0,495,0,114,0,2490
"20091053110",3086,90,29,0,656,0,141,0,4002
"20091053201",1710,28,28,0,134,0,27,0,1927
"20091053202",2643,169,177,26,110,57,55,0,3237
"20091053203",3712,160,309,0,813,1,171,1,5167
"20091053301",4969,101,26,0,289,34,79,0,5498
"20091053302",6359,176,27,0,451,0,149,0,7162
"20091053403",2875,100,133,0,724,0,440,35,4307
"20091053406",7518,160,239,1,1017,2,103,44,9084
"20091053409",2982,85,51,134,246,0,41,0,3539
"20091053410",9117,218,229,49,1031,38,535,0,11217
"20091053411",4377,165,22,7,310,45,131,0,5057
"20091053413",3305,63,156,0,574,0,0,0,4098
"20091053414",2461,65,152,0,873,152,49,0,3752
"20091053415",2619,55,73,8,478,33,52,0,3318
"20091053417",3154,43,76,0,836,0,187,0,4296
"20091053418",2789,140,105,0,764,0,372,0,4170
"20091053419",1307,43,22,13,87,11,20,0,1503
"20091053421",3175,72,300,0,553,0,71,0,4171
"20091053422",2025,15,87,0,127,0,66,0,2320
"20091053423",4817,57,36,0,581,10,154,0,5655
"20091053424",4000,73,33,0,396,65,56,0,4623
"20091053502",1786,312,232,1,205,0,249,121,2906
"20091053505",6923,80,178,56,601,38,625,0,8501
"20091053506",3219,174,24,19,349,0,188,9,3982
"20091053507",4674,267,192,1,221,9,133,4,5501
"20091053508",5423,272,226,0,384,145,110,79,6639
"20091053509",5447,500,478,0,454,0,175,201,7255
"20091053510",5001,65,85,0,574,0,590,0,6315
"20091053555",1335,370,114,22,29,13,252,45,2180
"20091053556",2160,401,179,19,228,75,1172,305,4539
"20091053557",1424,495,15,32,119,114,294,196,2689
"20091053601",1357,386,218,0,116,7,235,277,2596
"20091053602",4256,716,407,0,947,213,776,321,7636
"20091053701",2039,301,0,1,57,9,66,9,2482
"20091053703",2387,41,369,0,173,0,119,0,3089
"20091053705",2838,62,103,3,255,15,243,0,3519
"20091053707",4054,283,128,0,289,0,219,0,4973
"20091053709",5003,201,72,0,206,0,269,36,5787
"20091053711",3338,121,17,0,184,0,274,0,3934
"20091053712",3353,12,7,0,189,0,355,0,3916
"20091053801",4894,173,28,56,134,0,13,0,5298
"20091053803",3227,192,0,0,111,0,135,0,3665
"20091053804",2170,36,20,0,47,0,64,0,2337
"20091980001",0,0,0,0,0,0,0,0,0
"20091980002",0,0,0,0,0,0,0,0,0
"20091980003",0,0,0,0,0,0,0,0,0
"20093959100",3102,235,32,0,397,82,964,178,4990
"20095961100",2184,146,8,0,38,0,9,0,2385
"20095961200",2739,618,0,0,95,26,152,7,3637
"20095961300",1543,182,1,2,25,5,35,11,1804
"20097969100",1936,359,0,0,48,18,91,38,2490
"20099950100",2139,471,85,0,181,156,48,212,3292
"20099950200",1483,361,117,66,80,0,78,14,2199
"20099950300",2043,319,73,45,35,68,2,62,2647
"20099950400",2670,500,151,77,125,38,98,139,3798
"20099950500",2847,298,0,2,382,8,121,0,3658
"20099950600",1867,274,0,0,114,154,27,15,2451
"20099950700",1704,221,31,17,257,11,40,13,2294
"20099950800",842,266,19,0,96,30,0,7,1260
"20101956600",1383,162,6,0,74,0,122,2,1749
"20103070100",708,643,86,94,325,43,104,20,2023
"20103070200",1831,454,203,85,108,189,95,34,2999
"20103070300",4619,231,519,24,214,120,217,0,5944
"20103070400",2366,337,215,43,307,75,169,70,3582
"20103070500",2465,629,508,434,267,331,171,26,4831
"20103070700",3520,289,440,71,368,123,205,95,5111
"20103070900",2534,232,20,0,192,15,107,0,3100
"20103071000",3384,179,96,0,171,15,70,0,3915
"20103071101",7154,748,799,53,458,0,595,0,9807
"20103071102",2638,285,32,65,203,135,66,7,3431
"20103071202",3156,45,136,0,95,0,217,21,3670
"20103071203",6601,490,108,0,201,39,168,119,7726
"20103071400",3542,322,0,0,111,0,99,46,4120
"20103071600",2365,99,24,0,35,2,13,0,2538
"20103071800",5205,515,20,0,414,0,393,0,6547
"20103981900",4162,219,564,13,533,57,492,78,6118
"20105086100",2642,371,14,5,17,24,38,37,3148
"20107955100",4202,724,44,4,171,25,142,16,5328
"20107955200",3554,609,4,0,86,0,45,0,4298
"20109954600",2389,241,0,0,100,7,107,4,2848
"20111000100",2243,696,62,90,483,267,726,109,4676
"20111000200",5426,1046,123,63,208,104,1170,175,8315
"20111000300",3387,1348,72,0,568,59,1444,781,7659
"20111000400",1540,1095,59,1,71,225,215,84,3290
"20111000500",2940,961,127,0,309,156,1113,666,6272
"20111000600",1987,198,1,0,82,90,93,0,2451
"20111000700",2076,409,4,0,65,38,46,98,2736
"20111000800",3195,285,9,2,93,13,51,20,3668
"20113788100",2863,336,7,3,82,0,19,5,3315
"20113788200",2821,178,0,23,76,12,317,9,3436
"20113788300",2543,280,4,0,76,2,109,39,3053
"20113788400",5245,431,59,0,158,19,39,35,5986
"20113788500",1468,137,4,0,58,1,113,11,1792
"20113788600",4715,348,61,1,380,9,291,0,5805
"20113788700",4908,457,3,0,80,29,23,7,5507
"20115489500",1620,221,3,2,31,29,18,1,1925
"20115489600",2978,161,47,8,54,9,107,1,3365
"20115489700",2092,489,0,0,10,34,9,95,2729
"20115489800",3155,407,3,25,140,23,90,6,3849
"20117040701",1423,141,0,0,18,65,8,0,1655
"20117060510",3077,374,16,5,60,32,120,0,3684
"20117070182",1805,373,0,0,53,0,43,11,2285
"20117090186",2093,274,2,0,27,2,32,2,2432
"20119966600",2004,325,0,0,360,43,439,120,3291
"20119966700",1399,126,30,0,23,11,38,13,1640
"20121100100",3174,108,142,7,88,0,34,0,3553
"20121100200",4108,89,21,0,240,0,124,0,4582
"20121100300",3041,73,0,0,16,0,73,0,3203
"20121100400",3368,343,0,0,69,4,77,4,3865
"20121100500",3978,240,19,0,112,34,120,15,4518
"20121100601",4951,671,68,39,39,117,235,30,6150
"20121100602",1713,55,0,0,45,0,82,12,1907
"20121100700",3727,1175,15,0,87,18,87,0,5109
"20123176600",3537,469,0,0,43,44,23,60,4176
"20123176700",1790,110,0,2,20,3,5,7,1937
"20125950100",1908,165,0,0,80,33,22,14,2222
"20125950200",1783,410,0,0,97,87,29,0,2406
"20125950300",2862,386,144,9,385,76,232,0,4094
"20125950400",1403,391,79,8,45,3,90,208,2227
"20125950500",742,248,166,57,69,61,111,37,1491
"20125950600",2787,698,73,30,68,91,304,136,4187
"20125950700",3243,224,3,0,456,100,45,16,4087
"20125950800",3822,436,21,110,390,19,16,107,4921
"20125950900",759,72,25,210,38,45,175,0,1324
"20125951000",845,535,240,43,179,78,95,41,2056
"20125951100",1629,456,149,45,252,72,20,43,2666
"20125951200",593,195,211,29,185,81,134,0,1428
"20125951300",1523,594,0,0,165,5,38,0,2325
"20127963600",2761,214,0,0,112,9,113,0,3209
"20127963700",2275,247,0,0,63,7,87,17,2696
"20129964600",2220,284,38,0,489,35,596,37,3699
"20131480100",2986,405,43,15,22,0,63,0,3534
"20131480200",3467,322,8,17,17,7,43,25,3906
"20131480300",2035,348,4,0,60,35,10,5,2497
"20133951600",2938,524,1,0,122,24,34,20,3663
"20133951700",1942,482,45,16,78,30,81,21,2695
"20133951800",2963,493,0,0,42,42,102,185,3827
"20133951900",2810,487,27,22,71,72,184,21,3694
"20133952000",2094,441,0,0,114,8,68,10,2735
"20135956100",1204,179,2,0,42,0,67,94,1588
"20135956200",1436,132,0,8,37,0,125,3,1741
"20137951700",4125,406,14,6,136,21,130,2,4840
"20139010100",3685,375,0,0,94,34,79,45,4312
"20139010200",2515,306,0,0,44,19,46,0,2930
"20139010300",1784,188,0,0,72,30,8,17,2099
"20139010400",2271,478,3,8,111,0,36,0,2907
"20139010500",3317,488,0,1,117,3,125,14,4065
"20141474100",2988,620,6,0,59,11,37,14,3735
"20143085600",2015,145,4,0,31,0,81,0,2276
"20143085700",3262,339,0,0,78,54,68,0,3801
"20145970200",3721,135,78,17,197,12,316,15,4491
"20145970300",1541,268,1,0,28,1,30,1,1870
"20147475100",1030,92,2,0,38,6,24,3,1195
"20147475200",1318,194,1,0,56,14,48,11,1642
"20147475300",2420,174,0,0,32,39,34,20,2719
"20149000100",6039,916,222,22,241,7,167,151,7765
"20149000200",5149,316,0,0,200,38,232,38,5973
"20149000300",3574,444,50,0,287,62,354,9,4780
"20149000400",3982,281,30,3,109,24,113,9,4551
"20151968600",1968,153,14,0,32,39,67,3,2276
"20151968700",2872,426,0,1,61,0,152,21,3533
"20151968800",3221,324,13,0,79,156,239,82,4114
"20153950600",2175,283,7,5,38,12,47,55,2622
"20155000100",2642,576,23,4,62,70,72,170,3619
"20155000200",3347,117,6,0,133,0,329,0,3932
"20155000300",5979,629,0,0,203,17,447,65,7340
"20155000400",2641,354,93,107,146,137,103,107,3688
"20155000500",4930,498,108,0,161,109,415,95,6316
"20155000600",1586,497,14,12,205,61,408,107,2890
"20155000700",4018,851,225,221,560,190,986,257,7308
"20155000800",1306,409,45,61,256,72,367,78,2594
"20155001000",1793,489,76,0,56,97,368,0,2879
"20155001100",4419,71,0,0,78,0,203,0,4771
"20155001200",3075,230,14,0,97,46,57,0,3519
"20155001300",2091,240,7,12,71,10,176,16,2623
"20155001400",4336,346,39,0,183,0,80,3,4987
"20155001500",2952,195,4,0,73,8,51,7,3290
"20155001600",1545,383,0,0,48,0,3,22,2001
"20155001700",1853,367,19,10,43,52,81,34,2459
"20155001800",1855,153,0,0,40,31,41,0,2120
"20157978100",983,201,0,0,2,0,0,5,1191
"20157978200",1530,150,0,0,15,2,5,4,1706
"20157978300",1510,258,0,0,64,41,24,29,1926
"20159967100",1962,317,28,4,126,71,68,35,2611
"20159967200",2587,623,28,0,283,183,593,250,4547
"20159967300",2739,353,34,0,81,3,38,17,3265
"20161000200",6327,1105,744,23,790,134,531,0,9654
"20161000303",473,436,0,81,166,202,71,85,1514
"20161000304",3186,1144,154,76,409,225,461,61,5716
"20161000500",1668,2331,37,72,165,338,136,192,4939
"20161000600",7073,336,418,23,885,55,228,12,9030
"20161000700",2594,618,72,117,331,60,66,96,3954
"20161000801",2269,1670,141,207,133,128,116,83,4747
"20161000802",1428,663,112,7,42,22,236,32,2542
"20161000900",4188,642,580,29,307,0,416,154,6316
"20161001002",3756,739,703,61,227,228,746,224,6684
"20161001100",3134,1435,129,81,550,543,307,38,6217
"20161001301",2443,416,151,0,488,27,439,127,4091
"20161001302",4305,290,40,2,183,33,94,0,4947
"20161980000",0,0,0,0,0,0,0,0,0
"20163974600",1484,419,0,0,20,22,4,10,1959
"20163974700",2602,356,0,0,95,16,25,0,3094
"20165972100",1103,68,0,0,10,13,12,2,1208
"20165972200",1679,216,0,14,35,15,8,9,1976
"20167973800",3530,716,50,74,60,42,92,26,4590
"20167973900",2098,205,13,0,55,1,20,5,2397
"20169000100",3864,1024,93,58,159,107,202,249,5756
"20169000200",1294,540,177,55,120,65,361,86,2698
"20169000300",3719,1148,57,85,116,585,384,797,6891
"20169000400",2543,318,35,12,142,67,269,77,3463
"20169000500",3129,1125,169,51,685,839,783,602,7383
"20169000600",1695,427,76,13,336,31,241,85,2904
"20169000700",4594,248,188,81,638,31,518,21,6319
"20169000800",3589,207,49,7,217,36,87,48,4240
"20169000900",4840,1382,129,0,78,11,28,268,6736
"20169001000",4275,421,91,0,232,44,77,24,5164
"20169001100",3595,150,25,0,271,12,326,0,4379
"20169001200",3397,342,0,4,124,0,75,6,3948
"20171957100",4458,293,0,0,118,8,772,61,5710
"20173000100",1225,1019,90,31,592,299,1343,1226,5825
"20173000200",2535,522,0,0,167,101,858,240,4423
"20173000300",2089,739,73,138,1032,461,1886,816,7234
"20173000400",1071,586,740,139,395,216,911,545,4603
"20173000600",109,148,706,706,76,40,74,93,1952
"20173000700",325,365,1353,906,38,137,311,170,3605
"20173000800",243,319,917,735,20,98,54,292,2678
"20173000900",381,210,799,320,181,276,181,59,2407
"20173001000",2021,320,1124,334,244,309,457,323,5132
"20173001100",751,154,541,414,90,117,234,122,2423
"20173001400",3179,148,109,0,290,0,408,0,4134
"20173001500",1532,756,42,3,456,138,657,300,3884
"20173001800",553,477,390,264,322,142,469,344,2961
"20173001900",1261,257,132,48,135,185,249,191,2458
"20173002000",1802,192,0,0,17,4,56,0,2071
"20173002100",2782,116,285,0,80,0,161,0,3424
"20173002200",1658,160,26,16,62,12,103,113,2150
"20173002300",1525,295,54,29,166,73,252,79,2473
"20173002400",890,281,117,290,42,31,89,108,1848
"20173002600",822,546,95,31,120,82,438,195,2329
"20173002700",1064,181,22,5,150,91,352,110,1975
"20173002800",1932,618,49,30,288,126,265,201,3509
"20173002900",2219,361,93,131,273,94,782,142,4095
"20173003000",1398,542,113,43,84,13,332,170,2695
"20173003100",1255,519,90,160,153,66,472,112,2827
"20173003200",1677,962,38,132,79,490,747,528,4653
"20173003400",1375,732,0,116,777,20,882,264,4166
"20173003500",1170,156,59,175,191,12,185,0,1948
"20173003600",1626,443,359,139,380,130,569,239,3885
"20173003700",960,357,36,153,215,267,307,276,2571
"20173003800",1414,468,233,14,360,148,207,232,3076
"20173003900",2769,791,232,87,317,106,1159,273,5734
"20173004000",2387,827,264,345,381,320,677,327,5528
"20173004300",1606,614,198,80,273,51,226,185,3233
"20173005100",2876,602,171,306,349,306,676,233,5519
"20173005200",2708,565,162,448,376,153,367,205,4984
"20173005300",4726,523,244,0,575,22,834,128,7052
"20173005400",3668,1403,141,22,827,147,348,337,6893
"20173005501",3922,435,0,0,396,0,329,25,5107
"20173005502",4697,352,44,0,223,125,137,146,5724
"20173005600",3994,350,88,9,386,69,429,32,5357
"20173005700",3973,922,9,0,761,65,502,28,6260
"20173005800",2051,1479,33,31,757,34,498,241,5124
"20173005900",2895,699,272,22,487,232,865,33,5505
"20173006000",2107,1205,301,429,706,251,256,584,5839
"20173006100",1886,1026,65,0,373,116,649,822,4937
"20173006200",1673,452,409,94,435,190,701,252,4206
"20173006300",1484,460,261,62,313,13,267,91,2951
"20173006400",1248,153,83,0,123,30,63,61,1761
"20173006500",1177,1322,198,53,1028,401,999,1226,6404
"20173006600",1264,282,247,203,167,119,457,110,2849
"20173006700",1545,283,204,62,146,53,247,141,2681
"20173006800",1766,926,591,947,98,116,558,721,5723
"20173006900",1107,324,434,187,428,113,320,150,3063
"20173007000",1712,273,1132,523,251,225,495,96,4707
"20173007101",989,382,457,72,324,155,108,266,2753
"20173007102",2500,393,1356,243,784,0,750,76,6102
"20173007201",2540,566,120,0,704,104,355,209,4598
"20173007203",3348,348,773,88,1677,179,608,82,7103
"20173007204",4304,130,828,94,2897,143,805,0,9201
"20173007301",3213,247,11,29,188,102,95,10,3895
"20173007302",2204,136,547,91,241,0,93,0,3312
"20173007400",687,19,0,8,12,2,0,0,728
"20173007500",349,190,1238,477,140,200,204,80,2878
"20173007600",2541,214,682,234,217,46,37,11,3982
"20173007700",2927,581,2848,216,1146,455,326,294,8793
"20173007800",108,60,1272,992,92,126,53,132,2835
"20173008000",4560,451,238,2,399,82,367,44,6143
"20173008100",3740,710,0,0,175,0,150,182,4957
"20173008200",2686,956,127,147,849,980,1705,1360,8810
"20173008300",3394,454,181,0,425,22,925,86,5487
"20173008400",2182,387,44,13,572,145,454,164,3961
"20173008500",2017,178,0,0,158,14,87,20,2474
"20173008600",2591,218,59,7,543,0,715,33,4166
"20173008700",2566,712,183,46,311,186,398,300,4702
"20173008800",3549,552,37,12,477,108,741,107,5583
"20173008900",2029,1017,77,0,343,135,305,95,4001
"20173009000",1786,426,79,8,183,25,287,44,2838
"20173009100",4343,1199,452,286,713,169,1091,166,8419
"20173009200",2172,490,0,0,170,0,106,0,2938
"20173009301",5188,270,294,0,265,0,546,0,6563
"20173009302",4326,407,119,177,575,96,334,0,6034
"20173009401",3670,158,17,0,74,0,319,0,4238
"20173009402",1995,156,32,44,68,0,135,0,2430
"20173009503",8754,131,28,0,1001,19,725,0,10658
"20173009504",3714,315,22,0,203,0,214,0,4468
"20173009505",2865,47,38,0,106,7,117,0,3180
"20173009506",4224,220,163,0,317,0,354,22,5300
"20173009507",4771,73,113,0,520,115,400,0,5992
"20173009508",2961,297,9,0,112,35,343,35,3792
"20173009509",5741,144,0,10,351,10,258,16,6530
"20173009510",4045,23,24,0,370,32,117,0,4611
"20173009511",6084,172,360,0,300,98,570,2,7586
"20173009512",3945,116,139,0,243,22,230,0,4695
"20173009513",4255,248,0,0,466,13,712,0,5694
"20173009603",2316,93,9,14,308,221,271,12,3244
"20173009604",2486,176,0,0,23,0,0,24,2709
"20173009605",4589,111,59,1,310,0,465,0,5535
"20173009700",5825,221,0,0,248,0,377,0,6671
"20173009801",3914,438,26,0,300,26,339,25,5068
"20173009802",6542,674,81,0,405,2,357,0,8061
"20173009900",9970,257,103,0,505,0,384,0,11219
"20173010001",3930,10,149,0,246,0,39,0,4374
"20173010002",2653,236,164,0,475,33,60,0,3621
"20173010003",1495,27,414,11,399,0,206,9,2561
"20173010004",5670,151,109,0,350,44,531,10,6865
"20173010005",3373,156,241,11,212,0,281,14,4288
"20173010106",1955,180,242,0,302,63,43,0,2785
"20173010107",3000,258,410,8,158,50,127,0,4011
"20173010108",1889,37,153,1,331,28,157,0,2596
"20173010109",1314,432,213,97,199,55,174,163,2647
"20173010110",1273,23,0,7,91,0,59,7,1460
"20173010111",5391,228,714,104,553,4,303,0,7297
"20173010113",2966,290,286,0,354,0,135,232,4263
"20173010115",5829,110,256,1,817,0,138,0,7151
"20173010116",1901,261,103,4,97,11,48,32,2457
"20173010200",8556,426,19,0,229,125,348,0,9703
"20173010300",10705,709,215,0,373,442,645,327,13416
"20173010400",1895,312,16,0,44,6,56,3,2332
"20173010500",3885,200,0,0,66,3,57,0,4211
"20173010600",3508,90,0,0,28,13,73,4,3716
"20173010700",3125,141,9,0,67,0,247,0,3589
"20173010801",1800,63,403,51,246,139,160,9,2871
"20173010802",1329,175,391,181,426,68,91,26,2687
"20175965600",1773,188,0,2,505,5,1041,162,3676
"20175965700",3142,377,78,0,625,76,1090,270,5658
"20175965800",2193,287,113,7,975,727,1494,923,6719
"20175965900",2522,946,713,31,2415,173,3523,927,11250
"20175966000",1527,504,91,22,1938,817,2768,1199,8866
"20177000400",1496,1225,640,316,342,452,618,786,5875
"20177000500",761,616,208,21,438,151,371,126,2692
"20177000600",1234,445,284,107,69,165,96,264,2664
"20177000700",1717,672,43,2,108,188,84,99,2913
"20177000800",1778,918,48,130,495,104,548,127,4148
"20177000900",2239,593,46,0,390,184,424,238,4114
"20177001000",1945,316,125,0,826,154,1179,191,4736
"20177001100",866,682,341,365,89,264,630,552,3789
"20177001200",601,328,458,252,490,341,493,318,3281
"20177001300",1923,492,470,97,440,391,605,358,4776
"20177001500",952,229,415,202,165,45,138,58,2204
"20177001601",1619,523,115,1,160,19,93,40,2570
"20177001603",1725,365,303,334,184,65,255,43,3274
"20177001604",2613,283,67,52,372,5,86,31,3509
"20177001800",2449,519,63,33,315,0,203,27,3609
"20177001900",2853,69,41,0,62,33,93,8,3159
"20177002100",2278,486,190,77,282,210,174,110,3807
"20177002200",2005,350,8,12,119,10,171,40,2715
"20177002400",4121,726,102,36,348,29,262,0,5624
"20177002500",2154,235,141,42,147,0,151,100,2970
"20177002601",2403,224,382,53,259,48,236,0,3605
"20177002602",4682,529,305,102,385,330,416,232,6981
"20177002701",3323,460,140,321,209,0,302,0,4755
"20177002702",3350,231,213,19,412,22,168,10,4425
"20177002800",2491,728,198,57,229,265,78,53,4099
"20177002900",1085,840,696,233,308,310,237,529,4238
"20177003001",1614,266,903,231,268,201,648,222,4353
"20177003002",4318,222,879,39,332,37,813,0,6640
"20177003100",2360,1116,714,361,530,243,694,571,6589
"20177003301",2259,137,52,0,97,0,59,19,2623
"20177003302",3257,156,0,0,31,47,73,0,3564
"20177003400",8617,522,101,53,657,41,435,41,10467
"20177003500",5520,201,14,0,382,19,317,38,6491
"20177003601",4406,188,11,0,204,3,275,9,5096
"20177003604",3343,138,112,24,200,0,189,8,4014
"20177003605",3635,101,42,0,290,19,101,0,4188
"20177003606",3457,330,48,16,219,0,426,0,4496
"20177003607",5557,115,40,0,422,42,326,51,6553
"20177003700",6659,1429,171,35,270,106,280,284,9234
"20177003901",6346,231,47,10,267,23,282,23,7229
"20177003902",4146,164,59,16,88,6,165,40,4684
"20177004000",842,700,435,213,115,353,277,138,3073
"20177004100",2679,463,167,0,162,37,211,99,3818
"20179952600",935,122,8,0,50,0,10,0,1125
"20179952700",1247,89,0,0,46,0,51,28,1461
"20181453600",931,100,0,0,12,0,19,15,1077
"20181453700",3504,988,122,0,260,6,525,149,5554
"20183475800",1376,305,0,17,6,7,5,22,1738
"20183475900",1603,299,3,0,38,54,7,0,2004
"20185470600",1474,335,20,0,33,12,25,130,2029
"20185470700",1946,286,18,0,115,3,345,60,2773
"20187964100",1396,91,12,0,585,61,677,118,2940
"20189965100",1292,40,21,0,148,58,293,58,1910
"20189965200",2832,196,0,0,629,440,1129,414,5640
"20191962100",4063,490,8,0,127,24,111,6,4829
"20191962200",4482,684,2,0,215,53,27,14,5477
"20191962300",1860,350,0,3,118,52,25,5,2413
"20191962400",3645,305,0,5,84,56,303,21,4419
"20191962500",3141,698,0,0,315,58,337,273,4822
"20191962600",2175,147,0,0,80,44,43,3,2492
"20193953100",4989,476,95,0,89,20,253,0,5922
"20193953400",1740,155,0,1,27,2,88,30,2043
"20195955800",2608,178,1,1,78,9,35,6,2916
"20197483100",4084,328,18,0,155,8,134,24,4751
"20197483200",2141,87,22,0,21,12,11,4,2298
"20199954100",1387,141,2,0,3,8,55,8,1604
"20201978600",2765,290,4,0,52,5,34,4,3154
"20201978700",2096,300,19,1,15,22,58,66,2577
"20203957600",1867,221,0,0,87,0,454,88,2717
"20205097100",1701,385,0,0,43,5,22,13,2169
"20205097200",1215,184,0,0,50,23,49,0,1521
"20205097300",1937,532,5,0,134,40,52,11,2711
"20205097400",2086,481,7,0,92,29,45,11,2751
"20207096600",1237,364,0,9,51,49,14,39,1763
"20207096700",1242,166,0,0,26,2,3,0,1439
"20209040001",0,0,0,0,0,0,0,0,0
"20209040002",0,0,0,0,0,0,0,0,0
"20209040200",55,88,573,399,109,22,124,110,1480
"20209040300",0,0,393,257,0,0,0,0,650
"20209040400",91,247,881,337,179,9,175,201,2120
"20209040500",547,191,525,368,278,23,263,100,2295
"20209040600",429,354,1073,490,39,37,290,370,3082
"20209040700",443,162,795,469,46,97,456,241,2709
"20209040800",46,0,262,139,111,1,155,0,714
"20209040900",226,82,213,429,104,36,111,64,1265
"20209041000",76,10,241,816,63,75,90,41,1412
"20209041100",104,49,324,811,234,80,150,97,1849
"20209041200",305,91,547,402,52,10,271,53,1731
"20209041300",1601,920,966,320,450,518,1378,965,7118
"20209041500",1264,441,214,149,249,126,967,333,3743
"20209041600",2113,786,708,217,338,260,1537,805,6764
"20209041700",1325,414,108,130,395,162,1054,542,4130
"20209041800",49,108,250,210,58,140,15,12,842
"20209041900",1236,442,95,9,260,138,697,244,3121
"20209042001",246,191,17,95,296,278,309,312,1744
"20209042002",405,353,26,88,537,293,694,463,2859
"20209042100",1136,571,114,102,421,227,942,519,4032
"20209042200",994,626,85,0,166,89,743,639,3342
"20209042300",1198,750,180,108,451,348,1132,708,4875
"20209042400",894,243,64,227,848,295,1358,435,4364
"20209042501",0,0,0,0,0,0,0,0,0
"20209042502",0,0,0,0,0,0,0,0,0
"20209042600",1347,352,0,9,485,261,1029,437,3920
"20209042700",1659,730,229,531,281,195,1304,560,5489
"20209042800",1742,650,450,420,213,75,1063,485,5098
"20209043000",46,27,0,3,0,0,11,0,87
"20209043301",1979,672,219,346,492,70,1097,442,5317
"20209043400",1455,423,112,0,84,55,389,333,2851
"20209043500",1372,138,13,0,96,7,291,0,1917
"20209043600",4206,992,252,299,476,257,1207,811,8500
"20209043700",1482,126,134,0,380,36,429,16,2603
"20209043802",1120,152,0,0,11,34,43,80,1440
"20209043803",2202,333,123,131,293,0,286,40,3408
"20209043804",5,0,0,0,0,0,5,0,10
"20209043903",1220,730,517,35,440,259,664,348,4213
"20209043904",771,509,1189,482,315,90,226,266,3848
"20209043905",707,383,276,370,80,18,118,74,2026
"20209044001",1976,203,637,178,433,33,448,67,3975
"20209044003",1989,728,95,161,103,10,286,379,3751
"20209044004",217,258,0,0,50,6,72,49,652
"20209044101",306,43,452,283,21,6,50,6,1167
"20209044102",1574,233,405,49,306,0,509,187,3263
"20209044103",1379,99,898,104,315,20,206,0,3021
"20209044104",627,88,1345,554,284,185,320,85,3488
"20209044201",2441,139,956,98,189,6,316,16,4161
"20209044202",1602,145,1496,277,198,54,200,34,4006
"20209044301",1128,167,513,213,129,37,268,42,2497
"20209044302",807,84,640,149,43,40,312,25,2100
"20209044303",851,198,861,168,279,19,413,93,2882
"20209044400",869,185,883,190,360,246,177,123,3033
"20209044500",663,89,948,184,172,0,9,6,2071
"20209044601",1860,217,442,0,134,81,163,31,2928
"20209044602",0,0,0,0,0,0,0,0,0
"20209044603",0,0,0,0,0,0,0,0,0
"20209044702",3291,511,124,54,201,9,236,9,4435
"20209044703",1434,41,536,0,164,0,202,0,2377
"20209044704",932,111,457,7,134,1,88,98,1828
"20209044803",4125,195,657,0,233,20,197,114,5541
"20209044804",3623,113,736,0,141,0,264,104,4981
"20209044805",2095,403,121,0,134,41,290,38,3122
"20209044806",582,16,0,0,76,0,0,0,674
"20209044900",3302,153,400,0,64,34,631,19,4603
"20209045000",1792,859,110,411,673,120,1182,526,5673
"20209045100",696,397,298,338,303,335,410,433,3210
"20209045200",2040,604,209,83,297,88,324,355,4000
"21001970100",1178,303,0,0,58,0,16,31,1586
"21001970200",1323,120,37,16,6,15,6,6,1529
"21001970300",2346,786,0,0,38,29,0,0,3199
"21001970401",3160,785,227,0,29,69,36,52,4358
"21001970402",2980,358,30,23,17,78,147,1,3634
"21001970500",1796,479,9,0,22,48,0,0,2354
"21001970600",1026,422,11,0,0,0,0,0,1459
"21003920100",2728,439,29,0,88,5,28,0,3317
"21003920200",2206,548,0,0,5,0,17,62,2838
"21003920300",3712,747,97,118,0,0,6,12,4692
"21003920400",3101,1026,122,0,11,17,91,0,4368
"21003920500",1045,246,0,0,88,0,70,0,1449
"21003920600",2713,724,0,0,75,0,53,0,3565
"21005950100",6740,865,346,81,3,0,0,0,8035
"21005950201",4658,414,16,0,196,0,58,88,5430
"21005950202",2857,697,0,23,38,117,0,0,3732
"21005950300",1802,206,4,0,27,0,113,0,2152
"21005950400",2055,220,46,0,20,21,0,57,2419
"21007950100",3301,576,109,63,23,33,41,15,4161
"21007950200",1165,341,2,38,0,23,3,18,1590
"21007950300",1912,229,40,5,38,17,8,13,2262
"21009950100",2845,438,27,17,43,0,0,0,3370
"21009950200",2411,930,214,53,78,60,22,46,3814
"21009950300",2018,481,268,64,2,118,0,0,2951
"21009950400",3600,1660,482,99,134,52,74,39,6140
"21009950500",2439,530,130,16,44,11,217,0,3387
"21009950600",4083,1190,119,182,61,58,177,54,5924
"21009950700",5664,580,11,0,24,30,138,0,6447
"21009950800",2802,815,0,0,21,0,166,6,3810
"21009950900",2837,595,0,0,65,8,86,6,3597
"21009951000",2800,475,23,0,61,0,10,137,3506
"21011970100",1250,551,101,39,0,26,8,4,1979
"21011970200",4389,1399,68,11,115,27,107,0,6116
"21011970300",2623,1046,0,0,20,22,0,22,3733
"21013960100",1611,958,0,0,28,0,0,0,2597
"21013960200",2965,1415,5,4,48,31,0,0,4468
"21013960300",1836,501,0,5,0,0,0,0,2342
"21013960400",1333,253,6,0,34,25,34,25,1710
"21013960500",1643,626,29,48,0,0,38,0,2384
"21013960600",2247,1895,142,59,222,39,0,2,4606
"21013960700",1707,743,165,96,56,58,0,0,2825
"21013960800",2429,1199,0,0,13,99,13,0,3753
"21013961100",1745,817,0,15,11,0,0,0,2588
"21015070100",4854,682,509,286,155,25,129,50,6690
"21015070200",4885,942,424,42,163,0,27,98,6581
"21015070301",2912,1376,88,234,288,140,442,511,5991
"21015070305",5003,443,79,0,467,0,460,18,6470
"21015070307",9895,239,448,0,896,0,104,0,11582
"21015070308",8352,695,112,94,1168,0,139,217,10777
"21015070309",5445,179,77,0,561,0,305,0,6567
"21015070311",1902,427,12,0,109,0,60,0,2510
"21015070312",2492,267,209,0,143,70,17,30,3228
"21015070313",3385,20,0,0,45,0,169,0,3619
"21015070314",4029,250,258,7,101,0,208,0,4853
"21015070401",8352,363,120,0,788,0,231,0,9854
"21015070402",7461,761,215,0,194,0,380,233,9244
"21015070502",4155,352,0,5,23,0,31,22,4588
"21015070503",5834,416,0,51,189,21,317,0,6828
"21015070504",6689,344,198,0,60,212,21,73,7597
"21015070601",2534,369,0,0,0,0,0,0,2903
"21015070604",2356,372,25,0,6,0,6,0,2765
"21015070605",5110,203,15,0,256,0,194,0,5778
"21015070606",3446,454,68,0,21,0,72,13,4074
"21015070607",3538,212,60,0,43,0,0,0,3853
"21015980100",0,0,0,0,0,0,0,0,0
"21017030100",2342,722,521,383,38,12,169,128,4315
"21017030200",4214,878,76,204,161,0,484,0,6017
"21017030300",2473,173,40,0,123,111,201,111,3232
"21017030400",2231,167,58,1,15,0,0,0,2472
"21017030500",1627,447,40,23,26,7,19,0,2189
"21017030600",2098,326,60,5,30,13,208,24,2764
"21019030200",560,482,58,30,47,0,50,0,1227
"21019030300",1328,622,62,21,40,16,97,0,2186
"21019030400",1446,523,5,14,99,41,9,11,2148
"21019030500",3503,558,16,23,225,0,37,15,4377
"21019030600",3672,358,97,20,18,0,0,18,4183
"21019030700",2749,559,26,62,57,52,59,0,3564
"21019030800",2160,1532,22,86,22,101,11,0,3934
"21019030900",4230,755,0,32,17,138,0,0,5172
"21019031001",977,280,0,30,18,0,0,0,1305
"21019031002",4409,1192,3,2,177,27,88,0,5898
"21019031100",6636,816,0,0,84,0,53,0,7589
"21019031200",2996,341,0,0,0,0,102,0,3439
"21019031300",1831,525,3,2,9,6,25,0,2401
"21021930100",3231,544,275,161,180,0,25,0,4416
"21021930200",3415,309,115,95,178,53,44,53,4262
"21021930300",1204,406,282,23,43,11,110,60,2139
"21021930400",2717,597,420,71,165,34,48,158,4210
"21021930500",3024,289,67,27,80,4,174,84,3749
"21021930600",3216,499,26,8,51,2,28,0,3830
"21021930700",3593,963,101,40,38,59,30,1,4825
"21023950100",1919,490,0,0,0,61,5,107,2582
"21023950200",1673,226,0,0,15,0,5,2,1921
"21023950300",3357,654,0,0,0,0,0,0,4011
"21025920100",899,343,0,0,22,0,0,0,1264
"21025920200",1598,486,0,21,0,6,42,0,2153
"21025920300",1819,1312,0,0,70,1,0,7,3209
"21025920400",961,483,0,0,9,8,0,0,1461
"21025920500",944,372,0,0,38,14,0,0,1368
"21025920600",1175,654,0,0,0,10,0,10,1849
"21025920700",1568,489,0,0,9,0,0,3,2069
"21027960100",3662,1101,156,12,159,55,24,55,5224
"21027960200",4405,840,238,25,33,0,0,30,5571
"21027960300",2382,480,0,42,10,7,14,0,2935
"21027960400",1260,147,0,0,0,0,0,0,1407
"21027960501",1287,268,0,0,0,0,58,0,1613
"21027960502",2472,586,0,0,22,11,46,0,3137
"21029020101",3280,244,0,0,55,0,10,0,3589
"21029020102",2496,856,0,0,119,13,34,0,3518
"21029020103",2919,159,0,0,52,0,96,0,3226
"21029020201",5775,466,40,0,98,0,61,0,6440
"21029020202",3634,228,0,0,47,0,19,0,3928
"21029020300",4113,346,28,0,6,0,29,156,4678
"21029020400",6069,300,33,0,108,0,0,60,6570
"21029020500",5153,393,6,0,105,158,28,137,5980
"21029020601",4643,621,11,0,187,68,89,0,5619
"21029020602",1241,70,15,0,127,26,0,26,1505
"21029020701",4357,1102,248,58,170,79,66,0,6080
"21029020702",1832,165,3,0,18,0,14,0,2032
"21029020800",4204,968,24,0,98,0,0,0,5294
"21029020900",2340,289,0,0,30,0,28,0,2687
"21029021101",5625,623,0,0,305,0,101,0,6654
"21029021102",3718,283,0,0,5,0,12,0,4018
"21029021200",3858,646,0,0,158,24,203,20,4909
"21029980100",0,0,0,0,0,0,0,0,0
"21031930100",2672,815,5,0,0,0,0,13,3505
"21031930200",1187,576,0,0,0,0,0,30,1793
"21031930300",2834,1420,52,33,8,78,185,185,4795
"21031930400",1440,227,0,0,0,0,0,14,1681
"21031930500",883,268,0,0,10,0,0,0,1161
"21033920100",1554,319,17,0,22,0,11,0,1923
"21033920200",3843,708,305,130,61,16,64,44,5171
"21033920300",4206,1115,42,272,52,0,37,0,5724
"21035010100",3277,676,141,0,28,31,26,31,4210
"21035010200",3619,606,24,27,68,0,38,0,4382
"21035010301",193,84,0,0,0,158,0,0,435
"21035010302",3390,2329,235,12,158,226,21,58,6429
"21035010400",1164,547,262,57,55,25,98,96,2304
"21035010500",2262,617,69,106,29,83,12,35,3213
"21035010600",5650,780,176,0,156,122,84,107,7075
"21035010700",3010,307,23,27,143,80,133,19,3742
"21035010800",2822,431,0,0,129,10,86,28,3506
"21037050100",712,376,121,216,64,41,100,93,1723
"21037050400",1508,281,89,32,43,39,56,22,2070
"21037050500",989,495,170,48,21,71,0,0,1794
"21037050600",817,838,120,121,6,14,16,66,1998
"21037051101",1714,724,0,0,25,14,18,28,2523
"21037051102",1063,76,0,0,205,8,0,0,1352
"21037051200",884,470,0,0,14,50,0,17,1435
"21037051300",4027,176,0,0,8,0,157,0,4368
"21037051901",4508,192,33,0,55,0,0,0,4788
"21037051903",4338,307,0,0,255,11,82,0,4993
"21037051904",4038,558,61,10,35,0,49,0,4751
"21037052001",3885,564,38,0,202,11,85,0,4785
"21037052002",2681,158,8,0,0,0,0,0,2847
"21037052100",2967,367,0,0,91,0,149,0,3574
"21037052200",1973,247,0,0,43,0,0,0,2263
"21037052301",4051,371,0,1,63,23,0,16,4525
"21037052302",4515,298,0,0,298,0,32,0,5143
"21037052400",1988,573,18,53,63,0,0,125,2820
"21037052500",4128,562,254,323,145,76,0,55,5543
"21037052800",2804,278,17,266,44,0,9,0,3418
"21037052900",4655,354,11,1,17,18,41,1,5098
"21037053100",5169,865,0,0,75,83,80,20,6292
"21037053200",1574,161,51,27,83,30,120,10,2056
"21037053301",4368,380,40,165,103,136,26,0,5218
"21037053302",3580,568,0,68,14,117,34,0,4381
"21039960100",1263,153,0,0,23,0,21,0,1460
"21039960200",1477,393,30,0,4,21,8,20,1953
"21039960300",1150,363,40,0,11,25,55,4,1648
"21041950100",2033,514,32,18,54,30,82,0,2763
"21041950200",3351,1725,36,47,171,178,126,524,6158
"21041950300",1408,833,0,0,0,0,0,0,2241
"21043960100",2629,437,8,0,0,0,39,0,3113
"21043960200",3159,1344,0,7,0,7,0,0,4517
"21043960300",2291,457,0,0,22,20,51,18,2859
"21043960400",1490,288,0,0,0,0,0,0,1778
"21043960500",2909,819,0,33,31,38,0,0,3830
"21043960600",5195,855,0,27,265,31,0,0,6373
"21043960700",3560,584,0,0,67,15,0,0,4226
"21045950100",848,438,0,0,0,25,0,25,1336
"21045950200",1802,288,14,0,85,0,46,12,2247
"21045950300",3974,2279,15,48,63,0,64,101,6544
"21045950400",2400,765,0,3,13,14,7,32,3234
"21045950500",1869,602,49,22,0,22,119,16,2699
"21047200100",1031,332,1009,844,133,164,112,67,3692
"21047200200",1653,662,608,435,111,17,267,213,3966
"21047200300",1086,797,403,1165,84,177,88,11,3811
"21047200400",340,394,1135,972,116,0,107,121,3185
"21047200500",3444,280,145,122,259,128,314,89,4781
"21047200600",3360,422,514,21,251,45,181,34,4828
"21047200700",4546,610,509,26,193,53,210,53,6200
"21047200800",1032,185,971,526,17,0,0,0,2731
"21047200900",4644,239,405,70,577,21,287,0,6243
"21047201000",1395,239,37,17,28,18,6,0,1740
"21047201100",2994,831,103,49,65,54,38,59,4193
"21047201200",2202,415,66,0,94,0,57,0,2834
"21047201301",2302,238,246,46,56,21,52,9,2970
"21047201302",4071,895,944,270,861,103,330,124,7598
"21047201400",2114,98,113,42,164,28,84,0,2643
"21047201501",3171,602,929,64,570,86,329,155,5906
"21047201502",2540,1001,720,114,398,69,549,626,6017
"21047201503",0,0,0,0,0,0,0,0,0
"21047980100",0,0,0,0,0,0,0,0,0
"21049020101",4549,632,19,29,145,0,25,55,5454
"21049020103",3737,84,117,0,60,0,23,0,4021
"21049020105",2656,273,32,0,40,0,17,0,3018
"21049020106",1988,559,93,48,40,17,59,87,2891
"21049020201",1505,884,746,406,0,0,42,181,3764
"21049020202",2659,1028,39,27,54,18,34,30,3889
"21049020300",2140,233,0,1,40,0,24,9,2447
"21049020400",2655,300,43,0,0,26,0,0,3024
"21049020500",2474,272,47,0,44,0,133,99,3069
"21049020600",3386,542,158,0,74,54,129,0,4343
"21051950100",1183,601,18,0,17,7,0,0,1826
"21051950200",4075,2206,7,0,0,101,0,0,6389
"21051950300",3032,1285,134,62,10,2,10,0,4535
"21051950400",1953,1134,0,0,0,20,0,20,3127
"21051950500",1474,1008,35,0,16,0,0,0,2533
"21051950600",589,519,0,1,14,19,0,0,1142
"21053970100",2340,579,0,0,26,0,6,0,2951
"21053970201",2422,1056,10,0,19,50,17,56,3630
"21053970202",2603,735,0,3,179,7,166,9,3702
"21055930100",1560,278,0,0,10,50,4,0,1902
"21055930200",3033,930,12,55,28,0,14,0,4072
"21055930300",1247,319,0,0,13,0,10,23,1612
"21055930400",1133,352,0,0,7,36,0,14,1542
"21057950100",2472,993,128,83,4,10,5,0,3695
"21057950200",2339,606,1,0,33,57,17,0,3053
"21059000100",1573,973,501,27,102,35,212,27,3450
"21059000200",1758,805,251,143,65,291,191,182,3686
"21059000300",655,315,55,202,53,171,14,85,1550
"21059000400",4718,1703,201,443,314,34,170,0,7583
"21059000500",1271,401,209,114,0,0,98,17,2110
"21059000600",3945,634,344,42,80,42,0,0,5087
"21059000700",3518,301,66,22,309,35,9,0,4260
"21059000800",3122,412,102,173,103,39,143,22,4116
"21059000900",3608,991,37,11,118,0,19,0,4784
"21059001000",2108,358,143,53,201,7,100,110,3080
"21059001100",1813,229,4,0,24,4,14,28,2116
"21059001200",3032,159,201,0,161,0,143,0,3696
"21059001300",4642,768,119,43,54,0,0,0,5626
"21059001401",4167,377,36,0,167,0,0,0,4747
"21059001402",4313,556,12,36,63,12,71,0,5063
"21059001501",3315,440,0,0,0,7,56,7,3825
"21059001502",3283,197,0,2,186,0,53,0,3721
"21059001601",4060,55,0,0,259,0,34,0,4408
"21059001602",3800,687,3,5,11,3,0,0,4509
"21059001701",4003,834,176,116,188,38,161,18,5534
"21059001702",2687,380,136,0,145,59,49,146,3602
"21059001703",3924,559,0,0,59,7,54,9,4612
"21059001800",5317,632,39,13,43,21,0,342,6407
"21061920200",3812,871,0,0,17,0,0,0,4700
"21061920300",981,276,39,93,0,43,0,23,1455
"21061920400",5055,718,38,4,47,11,64,115,6052
"21061980100",0,4,1,0,0,1,0,3,9
"21063920100",3202,1327,0,0,0,4,5,0,4538
"21063920200",1525,652,0,0,0,0,24,0,2201
"21065920100",1049,430,0,0,10,2,0,0,1491
"21065920200",4133,1685,0,0,57,53,5,0,5933
"21065920300",3782,1615,0,0,38,16,0,0,5451
"21065920400",1107,331,8,67,24,4,0,0,1541
"21067000101",1414,969,341,200,71,112,0,36,3143
"21067000102",1013,421,145,236,60,0,54,14,1943
"21067000200",1037,470,556,490,102,92,79,0,2826
"21067000300",516,462,1087,1053,156,23,120,111,3528
"21067000400",612,263,283,420,17,63,205,37,1900
"21067000500",2863,239,48,0,129,47,0,0,3326
"21067000600",4026,282,1,3,0,0,0,1,4313
"21067000700",1037,1088,22,74,145,32,34,69,2501
"21067000801",53,48,0,6,160,137,20,11,435
"21067000802",437,1394,0,96,95,170,24,18,2234
"21067000900",935,3115,364,282,242,476,31,87,5532
"21067001000",651,318,198,246,88,8,69,32,1610
"21067001100",659,882,1566,706,185,493,326,954,5771
"21067001300",779,614,388,114,153,117,282,330,2777
"21067001400",1309,320,383,303,95,34,169,189,2802
"21067001500",1426,414,76,54,36,33,365,0,2404
"21067001600",1602,345,192,136,172,53,355,47,2902
"21067001700",1567,233,104,10,76,0,0,0,1990
"21067001800",543,1518,153,114,307,149,0,60,2844
"21067001900",1485,1632,326,580,84,692,103,319,5221
"21067002001",1397,632,345,163,1582,641,1656,558,6974
"21067002002",1113,110,223,86,550,303,698,370,3453
"21067002200",1172,138,147,21,135,221,30,111,1975
"21067002302",3870,833,74,0,280,113,53,0,5223
"21067002303",2861,386,316,78,166,356,116,0,4279
"21067002304",2003,6,10,0,21,0,30,0,2070
"21067002400",2927,402,155,35,447,177,66,20,4229
"21067002500",2712,978,0,0,35,72,9,0,3806
"21067002600",3180,927,205,0,390,62,182,128,5074
"21067002700",2847,393,147,86,309,41,54,0,3877
"21067002800",2862,462,65,0,154,161,167,187,4058
"21067002900",3324,454,49,0,217,9,122,0,4175
"21067003000",4115,487,126,94,925,601,835,572,7755
"21067003101",1845,385,369,255,40,4,65,38,3001
"21067003102",1076,120,952,82,91,79,41,0,2441
"21067003201",1531,150,117,15,65,0,115,0,1993
"21067003202",4268,716,841,421,78,75,114,201,6714
"21067003300",1937,118,430,188,15,64,154,0,2906
"21067003402",2405,993,434,479,707,89,72,35,5214
"21067003404",2070,613,474,976,180,134,54,42,4543
"21067003405",3654,466,799,689,131,28,322,48,6137
"21067003406",5053,661,742,107,84,43,215,16,6921
"21067003407",2541,146,241,143,416,5,109,0,3601
"21067003501",2318,929,482,66,155,50,224,104,4328
"21067003503",1719,268,178,76,110,73,260,63,2747
"21067003504",1790,344,1081,86,170,8,159,0,3638
"21067003600",4165,92,32,0,115,8,109,0,4521
"21067003701",940,197,18,14,16,82,139,66,1472
"21067003702",2074,117,295,125,312,115,118,155,3311
"21067003703",3589,99,565,24,281,15,308,0,4881
"21067003704",2906,76,1225,18,188,0,166,0,4579
"21067003802",1360,150,108,86,172,69,211,158,2314
"21067003803",1552,105,1298,16,320,28,221,50,3590
"21067003804",607,823,2121,1008,232,747,389,1316,7243
"21067003906",3649,172,129,0,135,51,203,0,4339
"21067003908",2851,176,456,128,380,5,70,0,4066
"21067003909",1717,318,319,333,555,27,147,16,3432
"21067003910",641,229,536,129,376,206,447,284,2848
"21067003911",1836,214,620,379,173,15,307,91,3635
"21067003912",2888,141,474,429,213,21,63,0,4229
"21067003913",4932,87,568,54,586,0,375,0,6602
"21067003914",1232,86,235,274,142,0,67,7,2043
"21067003915",2460,88,264,23,289,0,11,0,3135
"21067003916",551,29,7,0,0,0,0,0,587
"21067003917",792,0,292,21,16,0,44,0,1165
"21067003918",1969,164,210,172,185,2,31,0,2733
"21067004001",3409,1006,448,460,350,259,89,160,6181
"21067004003",3776,420,234,0,455,0,56,0,4941
"21067004005",1701,36,42,0,33,19,43,0,1874
"21067004006",1127,0,39,0,13,7,0,0,1186
"21067004007",1640,65,17,0,167,0,24,0,1913
"21067004103",1180,90,46,9,75,94,70,0,1564
"21067004104",2946,532,403,147,151,21,73,17,4290
"21067004105",3786,503,284,32,112,74,88,171,5050
"21067004106",3355,210,326,45,405,12,18,0,4371
"21067004107",4378,259,80,64,652,0,145,0,5578
"21067004204",4705,417,385,34,211,62,155,16,5985
"21067004205",5381,30,335,20,436,26,227,0,6455
"21067004207",3407,127,110,7,187,40,47,9,3934
"21067004208",5497,270,109,0,1325,54,117,0,7372
"21067004209",3706,50,23,0,160,0,100,0,4039
"21067004210",3544,71,211,17,695,57,134,0,4729
"21069920100",3155,683,114,92,158,42,94,28,4366
"21069920200",2997,432,0,0,13,0,0,0,3442
"21069920300",2009,645,0,14,10,0,40,0,2718
"21069920400",3122,907,0,6,24,9,0,9,4077
"21071920100",2179,891,0,20,105,28,21,56,3300
"21071920200",1596,644,0,0,13,8,0,0,2261
"21071920300",3447,1259,116,0,31,22,72,49,4996
"21071920400",3206,1340,0,0,0,0,0,0,4546
"21071920500",1493,1127,30,27,69,17,0,0,2763
"21071920600",2246,715,0,0,0,6,0,0,2967
"21071920700",2196,1061,0,0,0,17,0,0,3274
"21071920800",4228,1519,7,2,2,7,12,0,5777
"21071920900",1358,440,0,0,0,11,0,0,1809
"21071921000",4640,2078,7,77,74,26,0,46,6948
"21073070100",3861,334,563,145,752,165,658,80,6558
"21073070401",1776,207,182,1,64,0,21,0,2251
"21073070402",4043,982,324,79,138,32,32,0,5630
"21073070500",1165,286,315,157,93,28,74,26,2144
"21073070600",1761,359,650,442,253,142,20,78,3705
"21073070701",2896,362,361,116,25,87,7,0,3854
"21073070702",3938,299,248,65,377,150,226,0,5303
"21073070800",4114,612,98,20,62,34,9,0,4949
"21073071000",4340,553,162,148,305,0,65,0,5573
"21073071100",5398,444,9,16,220,25,10,34,6156
"21073071200",1622,804,77,43,121,38,23,7,2735
"21075960100",2324,414,519,232,93,25,0,0,3607
"21075960200",1396,319,276,502,30,25,82,0,2630
"21077960101",4531,959,80,40,245,72,62,74,6063
"21077960102",2091,269,12,0,117,0,36,0,2525
"21079970100",4977,944,0,0,128,14,11,119,6193
"21079970200",3108,1002,87,0,57,16,117,3,4390
"21079970300",2068,1038,140,25,95,0,8,29,3403
"21079970400",2502,403,5,0,118,20,81,20,3149
"21081920100",5769,1011,0,0,174,135,104,0,7193
"21081920200",5944,946,3,0,468,13,255,17,7646
"21081920300",5217,1715,11,0,230,11,191,0,7375
"21081920400",1869,588,23,0,70,0,28,1,2579
"21083020100",2275,751,132,266,142,137,54,161,3918
"21083020200",3317,306,389,392,22,93,463,20,5002
"21083020300",3658,2005,168,37,60,63,369,375,6735
"21083020400",2803,366,0,0,189,0,104,11,3473
"21083020500",3171,600,87,1,111,10,57,4,4041
"21083020600",2243,272,20,0,37,0,25,0,2597
"21083020700",3816,555,0,39,100,14,89,22,4635
"21083020800",4492,577,0,0,115,0,0,49,5233
"21083020900",2447,323,3,4,160,0,252,127,3316
"21085950100",2255,605,0,0,37,72,21,0,2990
"21085950200",2486,612,20,0,10,0,71,0,3199
"21085950300",2408,975,0,0,50,0,11,0,3444
"21085950400",5223,1290,87,96,24,155,20,0,6895
"21085950500",1890,494,0,0,0,0,12,0,2396
"21085950600",2921,1215,4,0,47,0,33,12,4232
"21085950700",1954,232,0,0,73,125,13,125,2522
"21087930100",2115,665,33,40,43,0,0,0,2896
"21087930200",2843,794,63,94,52,31,0,0,3877
"21087930300",1969,524,36,0,60,0,10,36,2635
"21087930400",1440,166,35,9,16,0,0,0,1666
"21089040100",3700,401,17,0,131,0,78,0,4327
"21089040201",2142,215,39,0,0,0,0,0,2396
"21089040202",3516,944,0,0,67,73,92,0,4692
"21089040300",3420,667,3,0,138,0,12,30,4270
"21089040400",4636,893,3,0,21,143,38,0,5734
"21089040501",2690,678,0,0,19,9,9,12,3417
"21089040502",3483,1006,86,90,65,10,39,4,4783
"21089040600",2506,609,0,0,41,17,0,33,3206
"21089040700",2822,702,0,0,25,25,0,0,3574
"21091960100",2313,333,23,4,82,12,0,0,2767
"21091960200",2561,558,47,10,32,49,33,63,3353
"21091960300",2137,406,0,0,2,0,12,6,2563
"21093000100",679,257,0,0,40,21,46,11,1054
"21093000201",732,4,151,0,18,5,19,5,934
"21093000202",2573,354,858,158,412,84,617,128,5184
"21093000300",2258,188,1004,309,643,53,210,0,4665
"21093000400",2556,604,665,482,372,193,429,224,5525
"21093000500",906,224,408,296,279,98,230,28,2469
"21093000600",1808,441,579,162,232,142,157,88,3609
"21093000700",2420,748,826,316,479,164,313,183,5449
"21093000800",3385,39,928,137,352,86,160,72,5159
"21093000901",8549,773,582,14,571,17,296,14,10816
"21093000902",2705,249,1191,30,491,132,329,45,5172
"21093001001",5296,828,295,87,354,98,606,24,7588
"21093001002",7149,1035,211,209,206,65,70,0,8945
"21093001100",2316,306,320,286,238,216,126,19,3827
"21093001200",4004,418,680,18,441,27,187,6,5781
"21093001300",4300,697,149,0,257,28,92,187,5710
"21093001401",2792,583,300,11,362,66,29,0,4143
"21093001402",2278,936,109,18,305,45,148,0,3839
"21093001500",1040,338,428,215,121,24,53,32,2251
"21093001600",6995,1306,74,3,197,1,195,18,8789
"21093001700",7148,792,133,8,30,0,10,0,8121
"21093980100",3,0,0,0,0,0,0,0,3
"21095970100",1181,260,134,91,18,4,0,0,1688
"21095970200",1848,1231,45,7,19,9,1,3,3163
"21095970300",757,284,0,0,0,3,0,0,1044
"21095970400",986,141,11,0,4,0,4,0,1146
"21095970500",1196,234,4,6,33,0,18,2,1493
"21095970600",1860,659,0,0,87,17,41,18,2682
"21095970700",2393,1450,0,0,37,0,3,21,3904
"21095970800",815,368,57,9,43,65,0,4,1361
"21095970900",2998,1260,55,79,11,120,0,82,4605
"21095971000",2470,1738,53,42,29,133,0,26,4491
"21095971300",1989,825,0,0,0,0,0,0,2814
"21097950100",2349,515,0,0,17,152,6,140,3179
"21097950200",2342,356,0,0,29,0,0,0,2727
"21097950300",3639,1119,112,115,21,124,9,0,5139
"21097950400",1983,606,60,71,36,62,67,127,3012
"21097950500",3593,845,18,0,95,0,12,0,4563
"21099970100",1434,306,0,0,0,0,17,0,1757
"21099970200",1862,702,24,4,31,10,15,0,2648
"21099970300",3351,1014,103,126,18,32,112,35,4791
"21099970400",3061,1481,275,160,90,15,38,11,5131
"21099970500",2966,757,116,40,104,40,59,0,4082
"21101020100",997,401,72,134,41,13,9,19,1686
"21101020200",845,481,139,31,21,8,45,0,1570
"21101020300",956,387,313,115,133,78,34,21,2037
"21101020400",1127,564,313,265,45,93,88,18,2513
"21101020500",1447,474,236,69,152,87,31,0,2496
"21101020601",5075,895,160,20,292,40,291,0,6773
"21101020602",3051,658,258,290,73,261,26,42,4659
"21101020701",4278,788,54,29,214,55,6,0,5424
"21101020702",6024,466,75,67,109,30,50,0,6821
"21101020800",3734,609,22,2,57,19,171,24,4638
"21101020900",6224,826,379,43,71,86,68,2,7699
"21103090100",1981,254,26,10,12,6,3,49,2341
"21103090200",2402,787,41,21,43,76,6,74,3450
"21103090301",2374,284,82,0,99,0,28,0,2867
"21103090302",2504,666,188,85,169,115,166,106,3999
"21103090400",2485,360,47,0,11,0,19,34,2956
"21105970100",3432,591,303,121,104,21,23,13,4608
"21107970100",2919,156,10,0,18,0,3,0,3106
"21107970200",3221,387,12,3,77,0,5,12,3717
"21107970300",4939,468,486,110,234,154,160,17,6568
"21107970400",1068,338,441,197,48,54,32,0,2178
"21107970500",3749,588,48,82,25,70,175,44,4781
"21107970600",1626,721,368,167,294,62,58,84,3380
"21107970700",3790,437,88,35,131,13,68,0,4562
"21107970800",2384,443,164,41,82,17,81,13,3225
"21107970900",2308,779,293,71,87,5,19,0,3562
"21107971000",2380,323,0,0,0,0,0,0,2703
"21107971100",2159,859,0,15,60,51,16,0,3160
"21107971300",3951,1160,53,42,68,19,10,9,5312
"21109960100",3268,1950,0,0,105,4,10,10,5347
"21109960200",2130,600,0,0,0,0,44,14,2788
"21109960300",3556,1604,0,0,0,40,0,0,5200
"21111000200",1219,852,222,252,16,0,6,13,2580
"21111000300",644,331,848,434,42,0,0,0,2299
"21111000400",803,355,2804,972,160,15,33,0,5142
"21111000600",21,21,809,672,33,57,0,0,1613
"21111000700",248,143,1572,901,17,0,0,0,2881
"21111000800",16,4,1679,529,9,2,0,0,2239
"21111000900",22,12,1548,450,25,0,0,0,2057
"21111001000",44,32,1383,1039,45,53,24,0,2620
"21111001100",48,39,2424,724,51,30,0,0,3316
"21111001200",14,33,1968,823,12,38,0,0,2888
"21111001400",7,0,1578,902,15,0,22,0,2524
"21111001500",111,0,1806,871,27,0,0,0,2815
"21111001600",106,186,1351,816,0,0,0,38,2497
"21111001700",58,51,1347,620,35,15,0,0,2126
"21111001800",17,55,795,591,15,67,33,14,1587
"21111002100",887,792,140,393,9,19,14,23,2277
"21111002300",798,814,490,315,34,67,24,0,2542
"21111002400",99,97,2752,1844,41,342,0,0,5175
"21111002700",21,134,1123,1284,86,102,0,0,2750
"21111002800",112,162,847,516,16,44,0,0,1697
"21111003000",29,143,373,2559,24,74,0,11,3213
"21111003500",533,411,394,1736,20,84,0,11,3189
"21111003600",2099,765,935,1737,40,55,332,70,6033
"21111003700",567,378,371,187,89,26,124,63,1805
"21111003800",1891,503,563,144,317,84,76,30,3608
"21111003900",1593,816,773,526,44,121,90,51,4014
"21111004000",1045,341,363,0,0,71,85,0,1905
"21111004100",1249,596,354,287,210,14,58,195,2963
"21111004301",699,759,1300,1439,265,84,52,183,4781
"21111004302",425,321,431,148,93,144,56,0,1618
"21111004400",2838,447,274,572,361,19,250,91,4852
"21111004500",2230,538,259,152,93,69,532,38,3911
"21111004600",2428,263,224,36,423,139,434,0,3947
"21111004900",733,389,323,589,92,48,55,28,2257
"21111005000",457,175,305,632,20,50,33,10,1682
"21111005100",1339,793,373,605,65,8,110,17,3310
"21111005200",1662,588,445,273,143,115,130,66,3422
"21111005300",487,277,79,66,99,6,8,0,1022
"21111005600",1600,425,637,525,617,706,641,120,5271
"21111005900",904,487,1084,1202,38,158,0,12,3885
"21111006200",173,116,581,858,77,32,5,0,1842
"21111006300",1304,352,32,48,48,6,11,0,1801
"21111006400",1265,221,55,0,29,6,35,16,1627
"21111006500",839,381,894,784,23,162,23,0,3106
"21111006600",899,265,253,168,70,65,20,0,1740
"21111006800",1613,317,54,81,5,0,36,0,2106
"21111006900",1541,297,80,63,27,0,182,0,2190
"21111007000",1783,289,8,6,15,0,15,0,2116
"21111007100",2198,1168,482,184,616,336,187,152,5323
"21111007400",1459,358,18,77,51,46,26,0,2035
"21111007501",4918,90,20,0,63,2,17,2,5112
"21111007502",4282,302,147,0,344,0,26,0,5101
"21111007601",1444,258,174,10,98,7,42,0,2033
"21111007602",1683,860,531,157,267,17,17,82,3614
"21111007603",1585,261,299,91,149,15,45,0,2445
"21111007700",2477,474,152,0,134,212,20,0,3469
"21111007800",2729,237,80,0,40,0,26,0,3112
"21111007900",1586,141,12,17,66,7,0,10,1839
"21111008100",2580,338,93,18,82,10,51,10,3182
"21111008200",3410,311,115,0,216,18,40,76,4186
"21111008300",2061,247,29,0,148,0,0,0,2485
"21111008400",2475,271,0,0,22,20,28,9,2825
"21111008500",1841,153,40,20,57,0,88,0,2199
"21111008700",3584,80,8,2,108,0,72,0,3854
"21111008800",2663,279,34,0,97,9,23,0,3105
"21111008900",3038,114,134,1,186,0,101,0,3574
"21111009000",3633,1053,569,108,843,175,664,279,7324
"21111009103",916,76,283,122,181,117,6,12,1713
"21111009105",1078,774,560,234,250,470,285,81,3732
"21111009106",3799,421,468,1,426,0,159,0,5274
"21111009300",4137,336,6,32,96,22,7,0,4636
"21111009400",5514,779,19,288,146,41,79,147,7013
"21111009600",3742,505,10,0,75,17,16,0,4365
"21111009700",2299,204,71,8,85,0,56,0,2723
"21111009800",2420,81,2,0,13,10,12,10,2548
"21111009900",2328,185,95,43,141,0,28,3,2823
"21111010001",4042,187,150,0,151,0,95,0,4625
"21111010004",3143,262,327,82,129,12,162,0,4117
"21111010005",3369,386,191,4,308,29,240,52,4579
"21111010006",2594,280,492,78,157,12,172,46,3831
"21111010007",3437,124,117,0,184,22,166,6,4056
"21111010008",2809,318,360,74,274,47,72,57,4011
"21111010102",3716,45,125,0,115,5,28,0,4034
"21111010103",3354,363,372,34,272,44,71,217,4727
"21111010104",2288,132,277,57,102,89,312,95,3352
"21111010307",4451,263,465,0,337,10,176,10,5712
"21111010309",3582,81,494,8,586,0,61,0,4812
"21111010311",4294,390,1353,160,1009,334,230,263,8033
"21111010312",3012,62,62,0,0,0,45,0,3181
"21111010313",3366,114,247,0,368,20,145,0,4260
"21111010314",5614,54,339,46,507,0,248,0,6808
"21111010315",2512,125,95,0,516,70,182,13,3513
"21111010316",3780,204,278,21,399,47,73,12,4814
"21111010317",4088,51,17,11,370,0,81,0,4618
"21111010318",5172,169,241,0,335,51,248,0,6216
"21111010319",3533,323,666,0,260,25,287,123,5217
"21111010320",1899,77,822,49,509,62,179,46,3643
"21111010402",5041,239,405,50,346,228,61,0,6370
"21111010403",3259,89,205,48,212,7,191,0,4011
"21111010405",3067,581,171,54,207,66,77,0,4223
"21111010406",4550,211,280,330,263,3,35,33,5705
"21111010500",3092,365,155,1,135,23,42,29,3842
"21111010601",2442,459,14,10,78,0,37,31,3071
"21111010602",2935,339,224,0,257,190,336,126,4407
"21111010701",3729,283,185,1,781,0,117,81,5177
"21111010702",4182,166,424,37,517,101,124,60,5611
"21111010705",4179,313,924,0,487,0,150,75,6128
"21111010706",2997,138,36,0,140,136,68,136,3651
"21111010800",2832,372,317,79,86,15,67,17,3785
"21111010901",2824,351,786,134,94,165,170,220,4744
"21111010902",3230,304,299,72,289,0,147,31,4372
"21111011002",1946,667,1290,518,268,303,412,152,5556
"21111011003",4187,311,792,166,141,0,185,4,5786
"21111011004",4023,715,906,307,341,0,189,231,6712
"21111011005",1660,318,570,50,48,76,56,83,2861
"21111011102",5239,498,210,15,391,22,472,118,6965
"21111011106",4798,611,433,186,475,0,312,107,6922
"21111011109",1747,42,293,50,83,0,46,0,2261
"21111011110",4913,269,286,0,194,100,119,0,5881
"21111011111",3614,332,1059,148,269,31,256,93,5802
"21111011112",2408,84,529,187,206,0,20,39,3473
"21111011113",1886,233,329,7,170,0,33,0,2658
"21111011114",3207,242,1235,366,293,37,0,0,5380
"21111011200",2564,505,861,795,390,92,398,296,5901
"21111011301",622,424,949,233,173,16,268,139,2824
"21111011302",838,648,3390,1457,254,233,308,123,7251
"21111011403",1338,278,3,10,41,2,50,2,1724
"21111011404",1162,632,659,342,203,165,431,260,3854
"21111011405",1795,456,1902,599,754,124,1030,182,6842
"21111011406",2580,208,1068,418,253,78,616,114,5335
"21111011505",3910,445,1368,333,230,51,348,172,6857
"21111011506",3794,584,545,240,377,14,218,229,6001
"21111011508",3214,407,1115,95,142,59,151,0,5183
"21111011509",2618,288,783,125,142,156,305,14,4431
"21111011513",3177,430,590,107,227,42,295,25,4893
"21111011514",2389,123,571,4,111,63,94,0,3355
"21111011515",3809,230,571,54,298,0,54,0,5016
"21111011516",3560,336,353,0,32,0,176,0,4457
"21111011517",4363,459,655,0,268,18,214,0,5977
"21111011518",2349,7,88,0,114,0,108,0,2666
"21111011519",4090,175,550,0,319,0,142,0,5276
"21111011520",3323,83,90,0,134,0,33,0,3663
"21111011601",5246,50,532,20,293,18,60,0,6219
"21111011603",4170,141,31,0,79,10,41,0,4472
"21111011604",2444,53,96,0,27,0,76,0,2696
"21111011706",3441,82,183,9,87,0,213,0,4015
"21111011707",3908,430,504,97,38,126,57,0,5160
"21111011708",3881,178,551,0,155,0,193,56,5014
"21111011709",3733,152,120,12,28,37,64,9,4155
"21111011710",2061,425,135,137,126,0,31,0,2915
"21111011711",4591,300,332,29,134,14,190,0,5590
"21111011712",3315,319,315,84,329,0,317,13,4692
"21111011713",1816,576,55,0,160,11,11,161,2790
"21111011800",1464,280,522,161,115,35,171,59,2807
"21111011901",449,565,0,0,331,127,563,482,2517
"21111011904",1911,194,88,103,183,194,426,88,3187
"21111011905",4485,1194,602,470,676,350,306,234,8317
"21111011906",1298,711,542,375,144,83,426,549,4128
"21111011907",3617,205,254,64,107,67,128,5,4447
"21111012001",2594,571,2,11,119,5,111,5,3418
"21111012002",4877,1015,86,22,117,108,280,344,6849
"21111012003",2874,709,0,0,250,6,145,380,4364
"21111012103",2407,425,96,63,134,0,65,0,3190
"21111012104",2776,596,275,4,56,11,13,29,3760
"21111012105",4271,394,102,0,165,0,122,0,5054
"21111012106",6876,620,278,0,115,0,282,0,8171
"21111012107",5037,803,11,81,0,59,56,238,6285
"21111012202",4049,824,1334,50,380,83,333,0,7053
"21111012203",4782,444,438,72,398,18,80,0,6232
"21111012204",3244,310,183,249,86,0,98,0,4170
"21111012301",2797,117,569,33,48,90,141,87,3882
"21111012302",3565,454,468,260,313,29,82,13,5184
"21111012406",5242,326,215,24,143,0,67,0,6017
"21111012407",3593,351,556,249,108,0,60,0,4917
"21111012408",1755,106,336,8,104,0,47,0,2356
"21111012409",2390,609,249,38,85,31,120,0,3522
"21111012410",3187,182,771,38,64,0,17,0,4259
"21111012411",5329,408,952,278,70,15,75,0,7127
"21111012501",1197,311,434,161,147,0,0,0,2250
"21111012502",3562,771,287,298,128,371,106,371,5894
"21111012503",2766,308,412,136,80,24,0,0,3726
"21111012601",1850,129,3465,1262,400,0,291,0,7397
"21111012603",1073,142,869,287,229,0,12,0,2612
"21111012604",2490,262,1780,516,74,197,259,0,5578
"21111012701",1035,372,1319,526,88,37,34,22,3433
"21111012702",1152,383,189,6,30,0,3,13,1776
"21111012703",3977,1051,583,303,286,0,160,20,6380
"21111012801",360,239,1895,861,43,40,0,0,3438
"21111012802",529,313,1307,323,84,125,65,253,2999
"21111013100",1903,34,7,3,64,6,16,0,2033
"21111980100",0,0,0,0,0,0,0,0,0
"21113060101",6369,1067,155,86,92,20,226,119,8134
"21113060102",4907,1313,206,48,86,13,19,0,6592
"21113060200",3156,643,25,18,65,4,136,39,4086
"21113060300",1776,446,75,0,17,126,0,0,2440
"21113060400",5232,1002,34,20,427,119,148,0,6982
"21113060502",4618,809,455,31,206,283,33,161,6596
"21113060503",3232,837,81,34,48,160,31,198,4621
"21113060504",2389,684,24,40,64,0,88,130,3419
"21113060600",5309,266,59,0,259,23,33,0,5949
"21115960100",2204,901,0,0,29,0,21,0,3155
"21115960200",1875,715,0,0,0,0,0,0,2590
"21115960300",2755,719,36,0,37,0,28,0,3575
"21115960400",4060,1606,0,0,27,163,0,39,5895
"21115960500",2299,521,0,0,0,0,0,0,2820
"21115960600",3570,1143,3,6,126,0,28,0,4876
"21117060300",908,336,115,41,66,19,86,23,1594
"21117060700",838,184,216,52,71,146,15,86,1608
"21117060900",1034,719,76,161,83,238,34,208,2553
"21117061000",1021,303,208,221,20,55,34,11,1873
"21117061100",1160,269,25,60,29,0,55,0,1598
"21117061200",1844,437,0,5,60,0,58,0,2404
"21117061300",1511,387,97,32,139,15,66,6,2253
"21117061400",3136,458,57,59,34,54,100,0,3898
"21117061600",732,308,77,49,59,99,58,66,1448
"21117063603",6853,1041,100,26,643,140,611,184,9598
"21117063604",5022,623,53,0,159,120,284,0,6261
"21117063605",9949,814,403,0,316,0,166,0,11648
"21117063606",4087,244,57,0,14,0,11,0,4413
"21117063701",2806,125,0,0,56,0,128,0,3115
"21117063702",3367,621,0,0,3,25,0,0,4016
"21117063800",2571,520,21,65,59,12,17,0,3265
"21117064000",5212,442,66,0,322,47,109,39,6237
"21117064100",4638,333,31,39,396,45,47,0,5529
"21117064200",1263,107,0,0,83,0,0,0,1453
"21117064300",2737,231,34,12,82,29,76,29,3230
"21117064400",2343,900,263,112,311,98,86,64,4177
"21117064500",3201,272,19,0,22,0,12,19,3545
"21117064600",4504,375,303,102,131,192,103,204,5914
"21117064700",5097,91,0,0,442,0,0,0,5630
"21117064800",2774,240,54,0,151,39,59,0,3317
"21117064900",2296,265,0,165,237,34,222,8,3227
"21117065000",2571,711,163,40,143,257,104,159,4148
"21117065100",1239,778,344,752,16,251,0,92,3472
"21117065200",3301,235,67,0,135,76,140,3,3957
"21117065300",8225,1178,37,12,37,86,21,86,9682
"21117065400",989,22,43,0,6,0,0,0,1060
"21117065501",4153,91,32,0,53,0,9,0,4338
"21117065502",3785,43,11,1,51,0,10,0,3901
"21117065600",3989,361,497,338,180,205,85,205,5860
"21117065700",1621,342,0,0,66,10,3,0,2042
"21117065800",2672,202,14,0,18,0,0,0,2906
"21117065900",1326,200,0,0,26,3,0,0,1555
"21117066800",7512,582,157,0,390,39,140,0,8820
"21117066900",3079,1089,29,2,9,21,12,0,4241
"21117067000",1504,530,227,110,76,10,52,0,2509
"21117067100",329,342,329,544,0,63,0,12,1619
"21119960100",1503,841,0,0,57,33,55,33,2522
"21119960200",2078,510,0,0,22,12,0,0,2622
"21119960300",2767,1173,5,7,49,0,22,7,4030
"21119960400",1855,762,0,0,2,2,0,0,2621
"21119960500",2979,632,18,106,14,19,0,0,3768
"21121930100",1249,817,0,22,10,0,4,0,2102
"21121930200",2483,1493,55,0,0,56,0,0,4087
"21121930300",1727,1323,0,0,9,0,0,0,3059
"21121930400",4732,2188,0,0,73,20,0,0,7013
"21121930500",3392,1306,0,0,79,12,0,44,4833
"21121930601",3895,1971,0,67,0,13,182,72,6200
"21121930602",1545,366,145,142,18,0,0,0,2216
"21121930700",1154,699,0,0,17,0,0,3,1873
"21123960101",1305,334,38,0,15,0,0,0,1692
"21123960102",4130,896,292,95,238,21,216,0,5888
"21123960200",2299,357,10,0,23,0,17,0,2706
"21123960300",2927,624,8,26,103,126,73,110,3997
"21125970100",2201,613,0,0,11,0,122,0,2947
"21125970200",4803,1973,74,80,129,101,45,0,7205
"21125970300",3641,680,0,0,0,0,0,0,4321
"21125970400",2842,492,0,0,58,0,26,0,3418
"21125970500",3298,1251,92,65,9,17,22,13,4767
"21125970600",1867,858,65,16,46,45,62,166,3125
"21125970700",4557,1245,39,0,151,26,193,0,6211
"21125970800",3664,796,0,0,79,0,0,0,4539
"21125970900",2463,806,0,0,0,10,0,0,3279
"21125971001",2960,1162,0,0,9,0,0,0,4131
"21125971002",3968,1711,0,0,105,23,0,0,5807
"21125971101",2083,194,0,0,96,0,105,0,2478
"21125971102",5574,1378,0,0,93,132,42,0,7219
"21127930100",5483,1354,7,0,19,0,5,0,6868
"21127930200",1160,457,0,0,26,8,0,0,1651
"21127930300",1196,368,0,0,0,33,0,38,1635
"21127930400",2174,866,0,0,0,0,0,0,3040
"21127930500",1821,503,0,0,109,103,9,0,2545
"21129950100",2371,1182,23,0,15,38,0,26,3655
"21129950200",1082,417,0,1,35,0,0,15,1550
"21129950300",945,620,0,16,58,0,0,0,1639
"21131920100",4073,1102,0,4,2,7,0,0,5188
"21131920200",2109,695,0,0,0,0,0,0,2804
"21131920300",2059,687,0,0,36,105,0,97,2984
"21133950100",2079,774,5,9,27,0,32,0,2926
"21133950200",3566,852,22,41,10,9,13,9,4522
"21133950300",952,440,0,0,16,0,6,0,1414
"21133950401",2192,413,0,0,13,18,16,0,2652
"21133950402",2878,1623,0,26,97,0,64,0,4688
"21133950500",1449,117,0,31,31,0,7,0,1635
"21133950600",4452,1407,0,0,0,0,0,0,5859
"21135930100",2523,1498,0,0,6,24,0,2,4053
"21135930200",2453,1260,0,3,64,15,0,0,3795
"21135930300",2649,885,0,0,42,60,9,60,3705
"21135930400",1325,726,0,0,0,0,0,15,2066
"21137920101",1432,429,83,20,22,0,0,0,1986
"21137920102",3173,590,219,81,170,26,182,33,4474
"21137920103",1194,865,0,85,0,32,0,0,2176
"21137920200",5283,756,0,3,25,0,50,0,6117
"21137920300",3524,1776,0,27,126,0,71,0,5524
"21137920400",2824,1350,72,0,62,17,3,34,4362
"21139040100",2420,455,22,0,88,43,50,8,3086
"21139040200",5310,943,0,0,48,0,45,33,6379
"21141960100",4339,615,63,20,345,16,141,11,5550
"21141960200",2529,782,25,12,24,0,0,0,3372
"21141960300",3815,1273,459,48,39,0,282,51,5967
"21141960400",3758,882,217,32,89,0,8,0,4986
"21141960500",2484,769,195,497,110,18,24,18,4115
"21141960600",2187,623,94,98,48,0,84,55,3189
"21143960100",4403,584,83,17,11,58,35,0,5191
"21143960200",1573,306,0,0,10,15,7,15,1926
"21143980100",0,0,0,0,0,0,0,0,0
"21145030100",536,410,70,48,72,13,107,10,1266
"21145030200",582,328,408,286,96,51,0,18,1769
"21145030300",580,218,62,22,26,22,18,22,970
"21145030400",389,147,253,907,29,68,22,21,1836
"21145030500",533,168,475,70,29,23,0,9,1307
"21145030600",1941,762,360,324,42,154,11,27,3621
"21145030700",2078,835,512,380,176,27,46,0,4054
"21145030800",4003,225,392,0,249,0,106,0,4975
"21145030900",1798,493,375,98,119,40,53,44,3020
"21145031000",3408,674,96,104,90,23,142,0,4537
"21145031100",4630,616,114,102,117,0,83,0,5662
"21145031200",3960,527,26,59,114,8,0,6,4700
"21145031301",3900,452,192,140,80,27,129,0,4920
"21145031302",5245,223,291,44,137,46,89,22,6097
"21145031400",5019,561,129,9,340,116,360,46,6580
"21145031500",5632,1008,380,0,134,27,32,0,7213
"21145031600",2753,285,0,0,37,0,27,0,3102
"21147960100",1388,992,0,0,8,0,0,0,2388
"21147960200",542,499,0,0,36,7,0,0,1084
"21147960300",3891,2275,0,0,0,0,0,0,6166
"21147960400",4337,2250,41,153,16,21,43,18,6879
"21149970100",2393,668,16,0,72,0,71,4,3224
"21149970200",2630,691,2,0,2,25,0,6,3356
"21149970500",2419,402,23,4,48,13,35,4,2948
"21151010101",1926,163,0,0,12,0,0,0,2101
"21151010102",6243,966,53,0,132,45,79,25,7543
"21151010200",2110,1348,55,209,264,41,86,15,4128
"21151010300",4199,1861,343,443,350,302,54,109,7661
"21151010400",746,416,151,111,48,37,4,0,1513
"21151010500",133,75,3,9,45,51,0,0,316
"21151010600",4064,876,118,44,18,133,57,0,5310
"21151010701",2902,918,136,474,20,19,40,7,4516
"21151010702",3292,327,37,0,50,0,133,23,3862
"21151010800",3992,619,14,0,77,47,39,25,4813
"21151010901",2979,229,29,0,36,0,132,108,3513
"21151010902",2308,226,26,0,208,0,53,0,2821
"21151010903",2515,965,136,171,187,85,160,11,4230
"21151011000",4645,883,168,0,39,0,55,0,5790
"21151011100",5545,1080,1,0,48,26,78,0,6778
"21151011200",3684,1222,157,90,111,178,22,113,5577
"21151011301",1489,799,13,15,23,35,53,153,2580
"21151011302",2469,1018,53,2,82,58,61,81,3824
"21151011400",3405,573,18,0,218,0,15,0,4229
"21153970100",1163,592,0,0,0,0,11,0,1766
"21153970200",4711,1153,0,0,0,47,108,0,6019
"21153970300",2113,898,0,0,0,0,0,0,3011
"21153970400",1416,743,0,0,53,33,0,0,2245
"21155970200",2738,468,632,216,132,7,77,0,4270
"21155970300",1700,176,71,0,103,11,95,0,2156
"21155970400",2291,665,25,4,41,0,0,3,3029
"21155970500",1526,232,0,0,0,0,0,0,1758
"21155970700",4042,883,375,323,57,0,254,0,5934
"21155970800",1773,202,0,0,18,1,37,0,2031
"21157950100",4168,594,0,14,115,69,67,13,5040
"21157950200",4179,518,0,22,68,28,47,0,4862
"21157950300",4057,262,0,0,63,0,206,0,4588
"21157950400",4593,594,0,0,24,0,0,0,5211
"21157950500",4800,439,21,0,58,4,26,22,5370
"21157950600",5166,719,0,1,39,0,0,0,5925
"21159950100",2446,845,0,0,8,46,0,0,3345
"21159950200",4082,2630,0,14,2,0,62,14,6804
"21159950300",853,267,0,0,28,0,0,0,1148
"21161960100",2318,806,14,12,66,40,9,0,3265
"21161960200",2227,602,333,127,163,8,0,8,3468
"21161960300",2569,451,330,181,90,121,43,9,3794
"21161960400",3998,761,47,0,63,27,0,0,4896
"21161960500",1364,234,72,17,2,5,0,0,1694
"21163970100",669,317,11,86,61,29,47,15,1235
"21163970200",1740,152,558,0,376,24,364,15,3229
"21163970301",2690,515,81,11,46,25,52,0,3420
"21163970302",4366,975,10,27,243,82,82,0,5785
"21163970401",3970,905,50,180,8,7,15,82,5217
"21163970402",6108,815,63,95,145,39,323,30,7618
"21163970500",2924,343,78,0,42,0,40,0,3427
"21163980100",49,21,0,0,0,0,0,0,70
"21165960100",2487,995,0,0,27,92,33,70,3704
"21165960200",1861,610,8,23,0,55,0,15,2572
"21167960100",3504,374,24,0,310,9,224,0,4445
"21167960200",4055,1026,250,203,59,0,140,0,5733
"21167960300",2842,445,207,0,26,40,0,0,3560
"21167960400",2952,973,26,54,81,36,71,44,4237
"21167960500",2970,472,19,16,6,96,13,0,3592
"21169960100",1634,365,55,11,26,0,22,0,2113
"21169960200",2281,534,0,25,34,124,0,72,3070
"21169960300",3663,979,0,36,58,68,26,21,4851
"21171930100",1474,220,0,0,0,0,12,0,1706
"21171930200",1614,786,7,4,53,10,65,37,2576
"21171930300",1806,627,91,0,24,55,110,6,2719
"21171930400",2724,1023,87,20,39,14,79,0,3986
"21173920100",2295,604,58,12,10,0,60,35,3074
"21173920200",4631,1791,448,79,317,158,365,116,7905
"21173920301",2468,294,6,29,67,0,0,0,2864
"21173920302",4189,1318,64,12,119,14,68,0,5784
"21173920400",3098,1550,0,8,3,2,14,0,4675
"21173920500",2084,766,31,0,10,58,34,7,2990
"21175950100",1586,594,0,0,0,40,0,0,2220
"21175950200",1371,617,0,0,23,0,0,0,2011
"21175950300",1263,360,0,0,9,23,0,0,1655
"21175950400",2396,1133,20,0,142,4,29,23,3747
"21175950500",1410,715,0,0,53,10,27,0,2215
"21177960100",810,268,10,21,10,0,0,0,1119
"21177960200",4296,1493,95,409,100,77,79,34,6583
"21177960300",3480,644,0,0,18,31,4,0,4177
"21177960400",3641,659,98,140,171,144,111,113,5077
"21177960500",2868,404,91,13,50,6,35,0,3467
"21177960600",2162,661,22,19,6,22,0,0,2892
"21177960700",2554,850,51,0,21,53,13,0,3542
"21177960800",1661,308,85,0,4,0,0,0,2058
"21177960900",1258,126,0,0,63,0,0,0,1447
"21179930100",2837,471,102,10,19,72,6,100,3617
"21179930200",6602,664,125,1,101,7,41,4,7545
"21179930301",4103,513,230,2,0,0,0,0,4848
"21179930302",6116,1454,207,396,169,0,49,300,8691
"21179930303",1760,1196,356,145,124,141,55,219,3996
"21179930400",2613,571,333,138,26,16,0,0,3697
"21179930500",5208,547,125,0,25,71,106,0,6082
"21179930600",2319,531,0,0,67,19,0,0,2936
"21179930700",2693,581,0,9,47,17,14,11,3372
"21181960100",1767,335,0,1,0,0,9,0,2112
"21181960200",3997,771,24,2,0,3,0,14,4811
"21183920100",2342,648,0,0,3,33,0,82,3108
"21183920200",2648,719,0,0,174,0,170,56,3767
"21183920300",2831,676,54,17,68,0,46,43,3735
"21183920400",1136,481,0,0,0,14,0,0,1631
"21183920500",5542,1721,319,164,54,27,281,0,8108
"21183920600",1589,466,0,0,29,60,53,60,2257
"21183920700",1494,193,10,0,0,13,37,0,1747
"21185030100",1801,56,66,0,74,0,27,0,2024
"21185030200",1003,66,18,10,56,0,11,0,1164
"21185030301",2032,216,62,20,377,15,356,70,3148
"21185030302",3336,938,59,0,212,318,159,307,5329
"21185030401",5615,288,225,7,285,71,18,0,6509
"21185030402",2582,9,135,43,34,50,0,0,2853
"21185030501",3585,230,56,18,180,98,165,98,4430
"21185030502",4681,120,33,0,72,17,141,0,5064
"21185030601",5189,258,315,15,337,108,163,104,6489
"21185030602",4624,200,11,0,228,0,197,0,5260
"21185030701",2140,109,0,0,104,0,24,0,2377
"21185030702",4779,243,122,18,189,0,69,0,5420
"21185030801",3946,95,67,0,189,0,121,0,4418
"21185030802",4351,71,150,0,171,0,140,0,4883
"21187970100",2613,403,71,0,79,0,72,0,3238
"21187970200",3905,597,96,6,128,23,132,0,4887
"21187970300",2189,588,0,0,0,0,53,0,2830
"21189930100",1646,947,20,8,0,97,0,0,2718
"21189930200",1114,718,0,9,9,18,0,35,1903
"21191930100",5764,610,6,10,51,61,73,0,6575
"21191930200",2353,390,5,0,10,0,27,14,2799
"21191930300",4026,993,4,44,19,36,41,0,5163
"21193970300",2352,511,0,0,40,0,0,0,2903
"21193970400",2697,825,51,10,126,33,0,20,3762
"21193970500",3876,1426,85,0,353,0,12,0,5752
"21193970600",3381,1560,104,11,0,0,0,0,5056
"21193970700",1186,752,0,0,81,14,0,0,2033
"21193970800",1997,638,0,0,0,0,0,0,2635
"21193970900",1307,488,0,0,18,0,0,0,1813
"21193971000",2454,966,22,3,0,69,30,2,3546
"21195930100",2334,970,0,0,5,0,0,0,3309
"21195930200",4969,746,19,24,212,18,149,8,6145
"21195930300",1589,939,151,52,75,6,11,0,2823
"21195930400",2613,971,21,19,68,0,0,43,3735
"21195930500",2350,602,66,0,34,37,68,48,3205
"21195930600",2717,785,0,29,9,0,0,0,3540
"21195930700",1979,606,0,0,14,0,20,0,2619
"21195930800",2156,934,0,0,2,17,0,0,3109
"21195930900",1365,474,0,0,14,1,0,0,1854
"21195931000",1868,328,0,0,23,0,0,0,2219
"21195931100",3912,872,0,0,6,0,0,22,4812
"21195931200",3378,920,0,0,0,0,0,0,4298
"21195931300",2264,800,0,0,0,0,0,11,3075
"21195931400",1990,534,60,0,222,52,0,37,2895
"21195931500",2702,867,46,14,0,73,0,10,3712
"21195931600",1050,442,0,0,19,0,0,5,1516
"21195931700",2917,1381,0,0,0,0,0,0,4298
"21195931800",2347,940,0,0,22,0,0,0,3309
"21195931900",2256,782,5,0,34,3,9,0,3089
"21197970100",4189,1045,0,0,118,15,27,65,5459
"21197970200",4424,2287,0,15,112,0,60,0,6898
"21199930100",3965,1987,51,6,91,43,0,268,6411
"21199930200",3795,1479,0,3,26,0,58,32,5393
"21199930300",4014,705,0,24,56,21,0,0,4820
"21199930401",2437,790,14,2,83,0,51,0,3377
"21199930402",4804,865,50,12,29,0,0,51,5811
"21199930501",4829,734,0,36,222,5,37,15,5878
"21199930502",4362,1671,61,10,194,152,229,0,6679
"21199930600",2077,1553,90,2,56,9,133,104,4024
"21199930700",3121,1179,80,99,79,17,19,0,4594
"21199930800",3809,1854,107,0,96,136,17,194,6213
"21199930900",1986,930,0,0,111,48,18,0,3093
"21199931000",1167,419,3,0,63,0,0,0,1652
"21199931101",2421,491,0,0,38,12,177,12,3151
"21199931102",1830,912,9,0,20,17,0,0,2788
"21201970100",1597,573,0,0,10,9,0,0,2189
"21203950100",2647,431,0,0,48,35,0,3,3164
"21203950200",4929,1846,7,0,119,62,0,0,6963
"21203950300",2939,1030,0,0,53,0,60,0,4082
"21203950400",1713,751,0,0,0,0,0,0,2464
"21205950100",4222,786,0,14,44,17,26,0,5109
"21205950200",4742,1247,27,0,111,120,39,34,6320
"21205950300",2887,1897,157,35,226,131,39,0,5372
"21205950400",2761,1106,47,0,55,12,0,0,3981
"21207960101",2638,754,0,3,67,0,65,0,3527
"21207960102",3384,1349,0,0,35,190,225,68,5251
"21207960200",1499,207,0,0,24,0,21,10,1761
"21207960300",2801,1151,32,2,24,18,90,73,4191
"21207960400",2125,1023,36,0,34,0,0,0,3218
"21209040100",3633,431,239,134,145,298,59,298,5237
"21209040203",3956,28,194,90,153,0,159,0,4580
"21209040204",3027,340,76,263,190,0,19,0,3915
"21209040205",2867,313,130,9,287,312,338,254,4510
"21209040206",2004,979,298,246,54,45,27,45,3698
"21209040301",2356,129,21,100,277,42,317,40,3282
"21209040302",1400,0,0,0,17,0,0,0,1417
"21209040303",1171,57,72,19,145,26,6,35,1531
"21209040400",2602,331,24,0,39,0,83,8,3087
"21209040501",1951,375,5,3,40,5,23,7,2409
"21209040502",3744,109,46,7,54,11,23,7,4001
"21209040601",2550,98,88,2,43,0,29,0,2810
"21209040602",3520,32,68,0,142,0,0,0,3762
"21209040603",4187,178,184,0,401,0,193,0,5143
"21211040101",3349,276,0,6,15,0,0,0,3646
"21211040102",4447,513,0,0,20,0,85,3,5068
"21211040200",5539,387,379,0,448,50,464,284,7551
"21211040301",2764,1211,515,151,589,240,680,762,6912
"21211040302",2016,564,412,113,240,27,481,322,4175
"21211040401",4708,447,482,35,362,142,155,142,6473
"21211040402",3088,74,190,68,175,7,61,0,3663
"21211040501",2142,26,56,0,88,0,72,0,2384
"21211040502",4392,469,367,334,203,78,235,106,6184
"21213970100",1777,206,36,12,29,6,8,11,2085
"21213970200",3034,735,167,0,163,65,24,65,4253
"21213970300",3251,589,446,211,110,51,38,82,4778
"21213970400",4251,1026,286,436,225,17,12,59,6312
"21215080101",3714,162,85,0,45,0,77,75,4158
"21215080102",4741,218,95,2,109,0,0,0,5165
"21215080103",1754,265,0,0,58,0,0,0,2077
"21215080200",5215,518,101,5,111,17,128,17,6112
"21217920100",2007,733,0,0,0,0,21,0,2761
"21217920200",2326,336,18,10,15,0,0,0,2705
"21217920300",3518,620,115,98,48,118,42,6,4565
"21217920400",5260,1486,245,0,125,134,26,42,7318
"21217920500",4330,1666,255,228,192,60,188,44,6963
"21219950100",2327,497,0,0,0,17,20,0,2861
"21219950200",3972,780,192,198,268,8,227,4,5649
"21219950300",1638,472,392,142,51,133,47,88,2963
"21219950400",937,78,62,29,19,98,7,92,1322
"21221970100",2118,287,226,27,0,0,0,0,2658
"21221970200",4638,1018,645,224,184,14,209,4,6936
"21221970300",4061,609,0,0,85,0,0,0,4755
"21221980100",0,5,0,8,0,3,0,0,16
"21221980200",0,0,0,0,0,0,0,0,0
"21223100100",2906,343,0,0,60,1,36,1,3347
"21223100200",4188,961,16,103,16,17,116,120,5537
"21225950100",1146,276,37,36,39,0,0,0,1534
"21225950201",2774,1345,176,735,30,125,14,212,5411
"21225950202",1994,490,400,221,85,30,9,0,3229
"21225950300",3772,764,111,203,48,12,31,0,4941
"21227010100",777,646,58,280,67,65,65,4,1962
"21227010200",713,557,803,862,222,471,149,115,3892
"21227010300",1232,1120,265,311,341,683,330,538,4820
"21227010400",126,114,25,0,49,47,0,2,363
"21227010500",1235,759,191,23,60,10,19,0,2297
"21227010600",2535,456,205,8,279,227,85,235,4030
"21227010701",2872,692,125,385,586,494,206,71,5431
"21227010702",4310,410,493,0,399,238,235,208,6293
"21227010801",2231,118,22,0,428,279,79,301,3458
"21227010802",5648,142,54,0,243,72,72,0,6231
"21227010803",4220,1116,371,206,32,203,63,158,6369
"21227010900",2561,621,328,93,87,21,51,0,3762
"21227011001",1694,1102,390,129,506,141,184,119,4265
"21227011002",2904,657,870,353,458,422,235,103,6002
"21227011100",4242,772,278,29,579,0,330,0,6230
"21227011200",2307,1063,446,207,413,30,523,67,5056
"21227011300",2902,701,226,78,194,51,97,66,4315
"21227011401",5599,484,54,0,254,14,141,19,6565
"21227011402",2470,131,0,21,73,23,0,0,2718
"21227011500",6012,609,0,0,19,25,87,0,6752
"21227011600",4461,481,249,2,145,0,109,0,5447
"21227011700",5929,1107,538,0,246,0,218,35,8073
"21227011800",5139,379,0,0,78,36,133,0,5765
"21227011900",4880,214,431,21,62,0,41,0,5649
"21229930100",2408,316,7,1,77,123,131,123,3186
"21229930200",4762,729,525,123,71,241,17,137,6605
"21229930300",1692,384,0,15,28,5,11,0,2135
"21231920100",4227,247,357,0,67,23,39,23,4983
"21231920200",3147,1508,11,36,166,309,111,380,5668
"21231920300",2936,1244,0,0,35,20,18,0,4253
"21231920400",2310,1226,0,0,0,0,0,0,3536
"21231920700",1892,579,0,0,16,0,13,0,2500
"21233960100",3372,464,4,0,247,56,324,137,4604
"21233960200",2130,275,38,2,34,0,30,6,2515
"21233960300",2122,311,0,0,3,7,28,6,2477
"21233960400",2847,600,373,174,105,11,53,9,4172
"21235920100",1912,708,2,3,55,0,40,0,2720
"21235920200",2138,570,0,0,165,11,101,0,2985
"21235920300",4340,1493,66,1,92,109,0,64,6165
"21235920400",4391,1034,18,0,38,23,0,0,5504
"21235920500",5076,1431,8,0,26,0,0,0,6541
"21235920600",3395,875,9,14,6,0,0,27,4326
"21235920700",2637,1161,0,39,71,41,17,0,3966
"21235920800",1248,657,0,18,32,0,51,0,2006
"21237930100",2094,1522,0,0,15,17,0,0,3648
"21237930200",1845,1613,0,0,13,8,0,0,3479
"21239050103",1589,492,237,134,645,49,565,169,3880
"21239050104",3157,360,197,40,44,22,64,0,3884
"21239050105",2684,176,6,137,161,16,179,0,3359
"21239050106",2782,259,74,27,66,2,0,0,3210
"21239050107",2763,428,266,0,95,9,125,9,3695
"21239050200",3022,377,23,0,105,222,0,406,4155
"21239050300",1971,187,9,0,12,0,12,0,2191
"21239050400",1578,179,72,3,46,82,49,80,2089
"22001960100",2972,992,825,887,100,133,101,74,6084
"22001960200",5368,265,86,170,50,0,0,0,5939
"22001960300",3124,311,177,0,78,0,39,0,3729
"22001960400",5679,637,56,85,88,19,0,26,6590
"22001960500",4863,892,423,146,271,215,172,62,7044
"22001960600",3926,537,1169,209,242,7,76,5,6171
"22001960700",1746,454,1100,620,81,13,0,0,4014
"22001960800",2896,466,403,370,141,115,0,32,4423
"22001960900",1652,333,1533,1233,119,6,18,0,4894
"22001961000",2472,1606,377,390,140,120,343,108,5556
"22001961100",3056,428,164,44,37,2,84,14,3829
"22001961200",3159,380,155,1,47,0,5,0,3747
"22003950100",4231,742,2,10,91,20,6,0,5102
"22003950200",2107,462,278,142,77,63,0,41,3170
"22003950300",1148,458,596,149,138,71,4,50,2614
"22003950400",3212,333,289,345,300,22,35,0,4536
"22003950500",4086,386,831,162,367,225,78,24,6159
"22005030101",6017,592,367,306,82,0,317,127,7808
"22005030102",4260,488,188,58,11,0,154,246,5405
"22005030103",5348,535,19,50,35,18,156,42,6203
"22005030203",8997,332,1524,0,347,141,169,0,11510
"22005030204",9211,661,1349,430,98,141,276,9,12175
"22005030205",7680,528,1659,0,346,152,661,0,11026
"22005030206",6872,447,996,353,463,147,780,144,10202
"22005030300",9084,579,3368,210,218,22,829,0,14310
"22005030401",2771,476,877,417,63,48,240,194,5086
"22005030402",2587,402,1947,1292,197,261,333,3,7022
"22005030500",7267,856,519,17,250,190,70,107,9276
"22005030600",3317,411,998,379,111,91,268,235,5810
"22005030900",1190,257,1406,1107,38,0,143,3,4144
"22005031000",1537,116,3245,1669,0,0,0,0,6567
"22007050100",1636,130,1613,450,36,0,102,48,4015
"22007050200",4937,512,0,0,83,32,0,0,5564
"22007050300",1556,200,1395,397,31,7,10,0,3596
"22007050400",2010,185,651,353,6,67,13,0,3285
"22007050500",1093,173,740,672,135,0,145,0,2958
"22007050600",2675,528,294,186,129,7,151,55,4025
"22009030100",1685,806,42,45,34,34,20,0,2666
"22009030200",2381,178,0,0,32,0,6,0,2597
"22009030300",2468,483,269,175,21,11,82,13,3522
"22009030400",2943,709,1488,1174,395,201,14,16,6940
"22009030500",4181,529,1348,483,196,52,186,0,6975
"22009030600",1916,481,2054,723,18,6,49,28,5275
"22009030700",3504,517,707,572,181,14,9,5,5509
"22009030800",2056,390,0,3,20,31,98,32,2630
"22009030900",1130,236,519,551,34,3,0,0,2473
"22011960100",4998,1171,0,0,213,0,0,0,6382
"22011960200",3240,530,152,0,91,116,105,50,4284
"22011960300",1636,346,1140,756,281,77,211,29,4476
"22011960400",1500,314,777,308,60,55,50,69,3133
"22011960500",3261,747,794,63,303,131,153,217,5669
"22011960600",2270,456,146,70,165,6,57,140,3310
"22011960700",7266,1378,0,0,85,0,56,0,8785
"22013970100",1023,236,954,1148,71,30,54,0,3516
"22013970200",459,78,782,296,31,30,0,0,1676
"22013970300",1311,283,775,759,0,96,7,87,3318
"22013970400",1932,388,166,55,13,6,58,0,2618
"22013970500",1774,134,666,256,38,5,3,10,2886
"22015010400",378,125,664,653,28,24,45,50,1967
"22015010500",2726,257,704,739,162,27,254,53,4922
"22015010601",2239,1085,3184,870,726,101,476,429,9110
"22015010602",1215,492,606,378,157,1,147,108,3104
"22015010701",1901,256,930,327,386,198,348,20,4366
"22015010702",1854,191,788,401,375,144,569,200,4522
"22015010801",1455,357,419,330,323,87,437,188,3596
"22015010804",5504,175,1348,0,656,0,324,0,8007
"22015010805",1607,260,578,293,275,23,44,11,3091
"22015010806",3444,260,237,51,312,41,151,12,4508
"22015010900",2015,21,198,30,301,91,241,0,2897
"22015011001",5870,387,788,564,237,98,206,26,8176
"22015011002",3727,292,319,70,96,0,269,17,4790
"22015011103",6042,367,626,176,123,0,281,0,7615
"22015011105",5577,663,580,1,487,46,622,214,8190
"22015011106",6027,834,1230,122,76,157,201,52,8699
"22015011107",796,114,616,275,91,15,47,15,1969
"22015011108",10683,438,1031,83,1132,38,816,34,14255
"22015011109",6134,269,333,178,262,0,217,0,7393
"22015011110",5600,696,1093,148,233,90,255,0,8115
"22015011200",3481,543,1307,392,41,4,37,0,5805
"22015011300",292,77,750,812,39,27,88,13,2098
"22017020500",139,0,1658,924,26,12,7,25,2791
"22017020600",0,2,447,414,16,0,0,0,879
"22017020700",0,0,789,263,3,7,0,0,1062
"22017021000",773,261,143,417,77,24,78,0,1773
"22017021100",716,247,1114,606,23,16,43,17,2782
"22017021200",1893,435,661,154,102,16,64,38,3363
"22017021300",279,36,1208,863,123,95,127,85,2816
"22017021400",1174,132,532,66,245,0,219,0,2368
"22017021500",1580,232,221,74,55,21,89,21,2293
"22017021600",2849,287,133,76,129,19,145,0,3638
"22017021700",199,25,644,561,44,7,26,0,1506
"22017021800",38,10,656,712,0,0,0,0,1416
"22017021900",52,10,1199,372,48,0,48,0,1729
"22017022000",7,0,1212,924,75,9,0,0,2227
"22017022100",73,44,3431,2290,23,54,23,0,5938
"22017022200",556,37,2670,1932,42,19,95,0,5351
"22017022300",128,87,1203,969,0,0,39,6,2432
"22017022400",185,103,1957,1321,117,27,0,0,3710
"22017022500",451,41,2781,1698,133,71,138,32,5345
"22017022600",2904,71,114,19,65,0,62,0,3235
"22017022700",2206,166,17,0,12,0,30,31,2462
"22017022800",3915,267,68,5,24,39,38,47,4403
"22017022900",3539,435,458,385,349,55,222,56,5499
"22017023000",4069,180,363,21,243,79,137,79,5171
"22017023100",1068,19,263,66,34,0,0,0,1450
"22017023200",267,168,660,388,58,41,0,0,1582
"22017023300",29,33,1160,785,0,5,0,7,2019
"22017023400",497,70,4198,1892,153,11,93,0,6914
"22017023500",0,0,2380,1188,26,0,0,0,3594
"22017023600",38,0,1933,1073,0,7,13,24,3088
"22017023700",397,112,3422,2565,44,0,33,0,6573
"22017023800",1581,378,2658,990,401,0,409,146,6563
"22017023901",4172,235,1138,161,336,0,121,0,6163
"22017023903",2631,220,405,386,162,99,92,17,4012
"22017023904",1977,334,434,191,283,49,56,30,3354
"22017023905",2737,457,678,240,616,61,57,36,4882
"22017024000",9354,462,544,23,628,7,450,0,11468
"22017024102",2503,183,875,231,324,0,202,24,4342
"22017024104",2208,380,2211,1535,352,129,384,0,7199
"22017024106",3095,196,3035,804,309,61,245,41,7786
"22017024107",2586,250,2805,111,197,8,58,0,6015
"22017024108",3835,193,2010,670,176,27,0,0,6911
"22017024109",2925,80,277,385,92,0,186,15,3960
"22017024201",957,97,2290,332,444,0,259,0,4379
"22017024202",4668,199,1233,107,308,0,130,0,6645
"22017024203",2982,393,566,45,140,41,47,0,4214
"22017024301",1481,290,4457,984,266,25,218,0,7721
"22017024303",2079,156,3204,795,53,75,222,0,6584
"22017024304",2851,353,1558,139,142,60,95,39,5237
"22017024400",2031,104,2348,619,9,13,0,0,5124
"22017024503",2757,627,1380,386,156,33,129,33,5501
"22017024504",4397,832,335,197,227,35,121,29,6173
"22017024601",289,38,2381,2086,18,0,8,54,4874
"22017024602",23,29,2494,1908,35,37,19,37,4582
"22017024700",1365,71,341,125,53,128,9,0,2092
"22017024800",589,25,175,72,40,24,27,37,989
"22017024900",2594,346,193,156,41,13,30,16,3389
"22017025000",1604,734,922,253,234,58,111,10,3926
"22017025100",1011,140,281,326,74,53,15,0,1900
"22017025200",42,11,448,384,0,0,0,0,885
"22017025300",187,280,321,481,10,25,0,17,1321
"22017025405",3164,290,494,195,124,3,64,7,4341
"22017025406",3211,643,402,45,324,20,79,0,4724
"22017980000",0,0,0,0,0,0,0,0,0
"22019000100",862,246,606,298,21,0,57,0,2090
"22019000200",93,9,824,691,14,51,16,0,1698
"22019000300",139,6,723,930,5,21,143,21,1988
"22019000400",1,2,831,705,43,0,7,0,1589
"22019000500",2238,199,403,254,103,38,61,38,3334
"22019000600",459,157,4015,1791,191,37,74,29,6753
"22019000700",1283,485,1490,747,121,105,318,21,4570
"22019000800",1504,311,640,393,83,62,93,0,3086
"22019000900",923,29,2571,285,121,0,73,0,4002
"22019001000",3047,384,51,44,193,0,47,22,3788
"22019001100",1618,791,386,611,311,106,15,30,3868
"22019001201",1126,299,1892,1010,186,172,107,0,4792
"22019001202",317,48,1791,1168,52,18,85,21,3500
"22019001300",4869,513,547,178,274,116,367,0,6864
"22019001400",525,84,3525,1319,67,87,1,40,5648
"22019001500",3,29,992,542,9,62,0,0,1637
"22019001600",326,138,1830,779,39,12,11,0,3135
"22019001700",5150,1055,1815,216,308,128,102,108,8882
"22019001801",8321,462,600,384,430,129,342,4,10672
"22019001901",2742,270,105,0,59,0,95,0,3271
"22019001903",4662,512,665,90,675,41,0,59,6704
"22019001904",4311,133,463,24,601,0,170,0,5702
"22019002000",6189,900,1217,91,54,52,121,0,8624
"22019002100",1782,185,587,353,106,0,39,0,3052
"22019002201",7269,305,106,0,71,0,61,5,7817
"22019002203",5677,307,421,0,548,84,389,84,7510
"22019002204",4768,150,236,44,195,0,27,18,5438
"22019002300",2410,78,55,0,0,0,40,0,2583
"22019002400",4106,946,708,101,116,54,7,26,6064
"22019002500",3497,196,66,38,80,0,22,0,3899
"22019002600",3134,697,838,136,22,93,74,46,5040
"22019002700",5948,1193,643,91,391,19,136,0,8421
"22019002800",2763,1329,161,118,27,41,317,214,4970
"22019002900",1654,263,56,15,14,11,199,7,2219
"22019003000",3751,713,121,223,47,0,15,0,4870
"22019003101",4555,377,40,2,38,0,47,0,5059
"22019003102",2058,54,59,91,92,0,77,0,2431
"22019003200",2013,271,43,97,23,12,62,40,2561
"22019003300",3942,963,279,47,61,0,48,0,5340
"22019003400",4165,397,0,0,78,72,147,72,4931
"22019003500",2172,559,442,405,17,0,262,42,3899
"22019003600",2858,894,75,69,86,10,75,0,4067
"22019980000",0,0,0,0,0,0,0,0,0
"22019980100",0,0,0,0,0,0,0,0,0
"22021000100",1775,482,339,31,24,0,97,45,2793
"22021000200",1762,323,591,167,47,33,19,8,2950
"22021000300",3000,606,126,252,37,0,49,29,4099
"22023970100",4227,453,198,8,0,0,63,2,4951
"22023970201",1658,94,0,0,23,0,75,0,1850
"22023990000",0,0,0,0,0,0,0,0,0
"22025000100",2463,357,503,370,17,26,17,37,3790
"22025000200",695,214,964,589,88,3,15,2,2570
"22025000300",2418,364,215,0,24,28,23,4,3076
"22027950100",2090,202,616,974,89,0,0,19,3990
"22027950200",1131,184,647,208,0,61,0,69,2300
"22027950300",1044,164,644,687,61,13,0,24,2637
"22027950400",741,98,1343,1122,6,93,0,0,3403
"22027950500",1368,208,725,380,113,0,29,47,2870
"22029000100",1347,277,576,345,34,0,0,0,2579
"22029000200",1089,160,1562,2542,22,0,0,0,5375
"22029000300",1985,597,543,458,41,10,42,9,3685
"22029000400",2900,356,609,560,59,25,97,16,4622
"22029000500",1991,568,27,141,0,0,1,0,2728
"22031950100",5749,912,1313,620,337,97,115,112,9255
"22031950200",2656,602,542,337,188,55,119,59,4558
"22031950300",1169,163,614,625,41,19,13,0,2644
"22031950400",798,68,1117,403,30,203,31,183,2833
"22031950500",289,121,991,742,0,4,0,14,2161
"22031950600",332,153,1174,1161,33,0,13,0,2866
"22031950700",2251,183,283,214,43,0,19,16,3009
"22033000100",45,7,947,619,0,7,0,0,1625
"22033000200",435,142,3884,2016,30,87,0,0,6594
"22033000300",87,3,1011,523,10,9,10,0,1653
"22033000400",173,2,2131,861,52,0,0,0,3219
"22033000500",50,17,2211,1767,24,6,4,20,4099
"22033000601",182,38,1967,1078,0,0,0,0,3265
"22033000602",31,0,3114,1438,0,0,0,0,4583
"22033000701",313,28,1412,478,99,35,163,24,2552
"22033000702",91,16,2228,878,15,0,8,0,3236
"22033000900",32,4,3066,1323,64,108,16,0,4613
"22033001000",0,1,2689,1526,42,0,0,0,4258
"22033001102",343,71,1934,597,88,17,18,14,3082
"22033001103",295,8,1668,953,0,0,14,0,2938
"22033001104",108,84,1958,2095,35,48,16,45,4389
"22033001600",1630,252,1036,435,131,26,76,12,3598
"22033001700",3055,95,984,372,247,0,18,0,4771
"22033001800",1440,369,507,201,335,75,288,124,3339
"22033001900",1945,60,40,11,66,0,4,9,2135
"22033002000",2531,71,534,0,331,118,34,0,3619
"22033002200",152,46,797,252,75,11,11,9,1353
"22033002300",2436,133,158,1,116,6,119,0,2969
"22033002400",282,518,838,613,144,65,46,120,2626
"22033002500",428,773,1337,767,86,159,10,85,3645
"22033002601",2538,440,164,10,90,56,53,0,3351
"22033002602",2594,337,555,110,81,0,21,0,3698
"22033002700",462,0,803,317,0,0,10,0,1592
"22033002801",252,510,242,155,835,525,92,71,2682
"22033002802",312,408,28,76,44,99,31,39,1037
"22033003000",0,0,1843,1336,0,0,0,0,3179
"22033003101",30,0,2747,1633,0,13,0,0,4423
"22033003103",0,0,653,449,0,0,0,0,1102
"22033003201",724,19,2329,644,26,0,35,0,3777
"22033003202",1242,55,2036,146,45,0,14,0,3538
"22033003300",1,11,3157,2032,91,11,0,0,5303
"22033003400",214,30,3491,1642,51,79,71,68,5646
"22033003501",713,357,1855,188,126,39,474,202,3954
"22033003504",290,16,4652,1257,93,0,0,0,6308
"22033003505",538,137,2482,879,61,6,300,48,4451
"22033003506",630,5,5848,1142,417,100,229,100,8471
"22033003507",681,143,3911,411,215,160,0,0,5521
"22033003601",770,106,2032,214,338,39,196,32,3727
"22033003603",727,272,791,690,42,100,134,42,2798
"22033003604",634,282,2842,1967,175,311,146,239,6596
"22033003701",3758,230,882,123,330,0,417,122,5862
"22033003702",2213,89,1140,226,129,77,57,0,3931
"22033003703",3382,131,1481,128,1364,27,160,0,6673
"22033003801",3657,523,1776,365,441,5,109,99,6975
"22033003802",3498,315,888,39,132,21,87,0,4980
"22033003804",3506,445,309,68,281,0,287,0,4896
"22033003805",5056,532,660,345,366,30,0,0,6989
"22033003904",2408,222,2160,1187,492,132,166,0,6767
"22033003906",6329,155,1566,78,570,9,163,73,8943
"22033003907",3384,166,1778,242,764,68,313,0,6715
"22033003908",2645,123,796,89,122,6,57,59,3897
"22033003909",1935,135,1155,1166,429,28,265,67,5180
"22033003910",879,498,729,304,532,62,600,544,4148
"22033004005",2669,350,2135,129,523,11,233,64,6114
"22033004006",5930,489,944,449,738,0,648,88,9286
"22033004009",4852,249,1883,357,669,0,395,19,8424
"22033004010",3776,103,468,519,248,21,103,26,5264
"22033004011",2054,1132,1431,1038,219,263,751,536,7424
"22033004013",1422,850,297,728,438,228,47,39,4049
"22033004014",4348,4732,1045,409,208,287,11,289,11329
"22033004015",2321,393,2650,1444,314,143,795,143,8203
"22033004016",5252,105,560,249,760,41,100,0,7067
"22033004201",689,61,3740,1080,256,0,34,49,5909
"22033004203",530,203,1695,605,39,0,21,0,3093
"22033004204",707,321,2683,583,136,12,111,211,4764
"22033004205",899,31,3821,1134,95,15,57,14,6066
"22033004301",4828,210,1090,151,103,0,29,0,6411
"22033004302",4509,406,0,3,46,22,150,0,5136
"22033004401",3731,267,771,22,159,0,124,0,5074
"22033004402",4913,423,360,236,216,0,0,0,6148
"22033004403",4324,411,789,212,82,35,90,7,5950
"22033004503",2378,156,3039,530,61,323,885,390,7762
"22033004504",3190,339,1188,41,649,91,199,237,5934
"22033004505",3937,106,2034,1134,717,66,169,24,8187
"22033004507",3756,94,1066,105,125,54,136,0,5336
"22033004508",7027,143,599,0,209,0,132,0,8110
"22033004509",4140,216,1283,257,462,46,145,13,6562
"22033004510",6195,174,760,20,378,0,129,0,7656
"22033004602",2778,246,2785,265,78,19,87,0,6258
"22033004603",2196,74,1978,402,97,0,96,0,4843
"22033004604",6658,479,3506,256,258,9,68,12,11246
"22033004700",3941,347,1332,1209,44,0,181,0,7054
"22033004800",1872,1061,92,24,268,177,73,31,3598
"22033004900",3616,401,147,32,377,0,394,8,4975
"22033005000",2546,184,371,12,167,0,72,0,3352
"22033005100",851,217,1195,579,12,64,34,0,2952
"22033005200",375,88,917,757,25,0,0,0,2162
"22033005300",486,226,1083,823,124,46,26,21,2835
"22033980000",0,0,0,0,0,0,0,0,0
"22035000100",687,68,484,1083,0,29,0,0,2351
"22035000200",814,260,178,114,11,10,0,112,1499
"22035000300",36,21,1193,1387,18,8,43,8,2714
"22037951300",1132,203,1520,452,0,0,0,0,3307
"22037951400",1444,196,959,616,29,9,24,0,3277
"22037951501",820,74,241,25,22,28,4,0,1214
"22037951502",2461,340,1467,355,40,24,95,0,4782
"22037951600",2810,428,1397,449,54,0,52,25,5215
"22039950100",4488,682,293,0,60,0,35,0,5558
"22039950200",1469,397,43,0,15,11,0,0,1935
"22039950300",2933,561,573,230,50,136,2,51,4536
"22039950400",3566,1061,519,782,138,14,53,4,6137
"22039950500",808,173,780,1429,48,4,0,0,3242
"22039950600",692,257,798,1159,0,17,45,7,2975
"22039950700",2835,189,225,148,21,0,2,3,3423
"22039950800",2185,308,974,515,22,4,0,11,4019
"22041950100",2834,578,377,476,9,0,22,0,4296
"22041950200",2331,287,368,325,0,6,0,0,3317
"22041950300",1129,810,1312,1836,0,121,0,0,5208
"22041950400",2068,488,124,39,0,0,0,11,2730
"22041950500",1164,278,33,12,22,0,0,0,1509
"22041950600",1087,199,327,549,0,0,3,3,2168
"22043020100",2134,308,11,2,36,13,10,4,2518
"22043020200",2404,376,136,64,88,12,0,0,3080
"22043020300",958,92,942,603,52,13,5,12,2677
"22043020401",4608,1047,66,3,79,2,54,37,5896
"22043020402",3862,774,21,19,166,103,21,0,4966
"22045030100",2883,653,1989,1488,93,14,0,0,7120
"22045030200",4868,427,1247,197,295,6,91,14,7145
"22045030301",2177,354,693,16,207,34,17,0,3498
"22045030302",4351,939,101,239,637,314,469,10,7060
"22045030400",3963,752,1298,725,399,110,187,0,7434
"22045030500",2486,339,631,525,197,73,206,33,4490
"22045030600",4960,147,729,237,360,0,213,0,6646
"22045030700",3096,332,310,135,194,62,199,0,4328
"22045030800",46,47,1583,809,30,11,0,0,2526
"22045030900",949,310,1019,799,220,143,323,23,3786
"22045031000",382,64,1740,826,54,34,0,34,3134
"22045031100",2354,423,1076,898,162,78,196,175,5362
"22045031200",1899,617,629,73,38,30,141,7,3434
"22045031300",4095,359,947,245,140,121,156,0,6063
"22045031600",978,55,1055,616,92,44,39,0,2879
"22045990000",0,0,0,0,0,0,0,0,0
"22047952600",929,123,1320,455,2,8,46,6,2889
"22047952700",3530,260,2345,160,115,13,130,0,6553
"22047952900",2820,633,1388,802,117,0,129,74,5963
"22047953000",1075,119,339,560,14,0,6,14,2127
"22047953101",1898,221,2171,1174,89,0,198,19,5770
"22047953102",908,88,1064,489,10,0,12,0,2571
"22047953200",2135,308,1310,359,199,21,29,62,4423
"22049970100",1336,395,857,333,30,0,12,45,3008
"22049970200",2400,135,482,475,19,12,21,0,3544
"22049970300",3068,457,63,133,32,144,140,0,4037
"22049970400",1049,365,870,887,35,0,0,0,3206
"22049970500",1144,299,133,128,5,0,0,0,1709
"22051020101",2262,192,44,139,194,1,244,125,3201
"22051020102",2408,329,57,10,131,0,150,0,3085
"22051020201",1389,434,208,67,206,29,221,225,2779
"22051020202",843,425,724,324,484,199,539,389,3927
"22051020203",6115,262,147,1,271,442,1574,306,9118
"22051020301",2941,75,44,0,222,259,129,0,3670
"22051020302",4496,222,29,13,919,15,1013,76,6783
"22051020303",3063,191,0,3,387,79,392,38,4153
"22051020400",2846,67,0,1,247,0,480,13,3654
"22051020502",4340,505,636,63,682,186,2147,75,8634
"22051020505",205,39,1198,403,0,0,196,34,2075
"22051020506",3343,303,0,368,350,73,1065,174,5676
"22051020507",3020,376,264,0,380,24,682,98,4844
"22051020508",5480,507,814,83,1034,27,1550,395,9890
"22051020511",2582,288,304,234,573,48,490,95,4614
"22051020512",1894,180,86,38,169,103,806,143,3419
"22051020513",3094,199,547,552,595,164,945,150,6246
"22051020514",3164,139,0,0,499,0,498,0,4300
"22051020515",2352,107,251,32,297,30,987,11,4067
"22051020516",2283,276,1148,484,274,290,1012,508,6275
"22051020517",3371,27,188,0,271,0,371,5,4233
"22051020600",762,291,2134,1013,98,152,507,360,5317
"22051020700",267,61,326,102,61,169,29,189,1204
"22051021000",1261,200,579,255,192,4,259,36,2786
"22051021100",1585,345,170,21,99,31,451,26,2728
"22051021200",1369,186,263,119,347,19,592,17,2912
"22051021300",2312,168,265,0,150,19,415,0,3329
"22051021400",1767,146,37,25,145,14,47,17,2198
"22051021500",788,420,605,350,238,121,257,129,2908
"22051021600",4241,932,554,308,310,341,1114,819,8619
"22051021700",3641,657,394,31,325,291,711,327,6377
"22051021801",1571,135,125,54,167,70,215,85,2422
"22051021803",1266,805,958,881,383,307,555,691,5846
"22051021804",697,421,329,62,287,11,622,275,2704
"22051021900",874,221,185,72,356,17,307,133,2165
"22051022001",1559,597,1664,421,1111,16,424,116,5908
"22051022002",2301,100,83,1,151,1,56,1,2694
"22051022101",1269,29,0,2,67,0,18,0,1385
"22051022102",1904,225,87,127,188,0,101,32,2664
"22051022200",1823,259,23,0,9,0,77,0,2191
"22051022301",2351,195,0,25,150,0,462,0,3183
"22051022302",1233,133,137,38,167,0,130,21,1859
"22051022303",1954,625,274,63,373,91,564,424,4368
"22051022400",3197,213,46,1,58,23,199,0,3737
"22051022500",2172,235,71,20,16,2,196,26,2738
"22051022600",2865,142,0,97,64,0,74,0,3242
"22051022700",2356,202,0,0,48,38,105,49,2798
"22051022800",2446,404,0,1,58,37,332,11,3289
"22051022900",1922,586,154,11,115,0,169,239,3196
"22051023001",1595,51,42,0,80,0,206,0,1974
"22051023002",4207,256,177,3,85,42,581,95,5446
"22051023003",2603,112,33,33,89,0,136,0,3006
"22051023100",2036,364,11,30,99,0,220,32,2792
"22051023200",2123,362,84,7,93,43,196,137,3045
"22051023300",1175,172,26,2,93,0,138,21,1627
"22051023400",2786,120,63,0,169,0,139,0,3277
"22051023500",3647,138,85,23,260,7,419,80,4659
"22051023600",3695,351,496,189,521,17,727,212,6208
"22051023700",0,43,1473,629,12,7,34,43,2241
"22051023800",1959,282,1039,448,93,0,190,72,4083
"22051023901",2299,171,10,0,8,0,67,5,2560
"22051023902",2127,75,53,0,124,0,141,0,2520
"22051023903",2192,80,0,0,27,1,226,0,2526
"22051023904",2561,153,94,1,38,0,375,71,3293
"22051024001",2645,253,0,0,24,16,47,0,2985
"22051024002",2524,313,0,3,165,10,17,0,3032
"22051024100",2892,256,43,10,37,0,132,0,3370
"22051024201",1697,135,303,20,108,0,156,0,2419
"22051024202",1694,99,777,49,484,21,291,13,3428
"22051024300",2228,337,197,11,5,26,229,72,3105
"22051024400",1801,393,486,104,85,54,116,168,3207
"22051024500",1163,180,57,29,93,0,60,14,1596
"22051024600",245,51,691,281,55,0,73,51,1447
"22051024700",964,181,310,31,117,34,256,50,1943
"22051024800",3060,313,13,0,80,0,151,41,3658
"22051024900",986,141,267,55,74,16,156,58,1753
"22051025001",1824,314,3369,1360,896,269,592,0,8624
"22051025002",1660,240,513,114,519,40,532,154,3772
"22051025003",2120,64,581,255,545,118,852,176,4711
"22051025102",2542,241,973,75,431,16,192,10,4480
"22051025103",1377,135,1315,386,543,199,432,54,4441
"22051025104",1734,346,1399,24,396,38,757,0,4694
"22051025201",659,10,618,859,401,55,523,56,3181
"22051025202",2385,494,1060,1081,1121,157,1246,311,7855
"22051025300",1508,183,107,73,313,12,412,94,2702
"22051025400",1403,152,1322,351,782,423,1015,331,5779
"22051025500",587,259,790,773,364,227,311,236,3547
"22051025600",721,265,141,179,102,54,132,82,1676
"22051025700",133,133,668,261,121,19,35,22,1392
"22051025800",775,98,482,360,20,0,30,0,1765
"22051025900",1332,168,538,289,52,12,93,55,2539
"22051026000",901,392,123,129,222,21,197,13,1998
"22051026100",1191,422,946,853,258,304,375,463,4812
"22051026200",32,0,719,536,10,15,5,0,1317
"22051026300",2141,249,91,43,30,47,38,0,2639
"22051026400",1343,61,113,0,86,36,61,0,1700
"22051026500",1095,291,120,183,88,2,77,21,1877
"22051026600",1374,185,90,6,213,68,362,45,2343
"22051026700",865,335,471,123,165,37,74,113,2183
"22051026800",279,108,1210,748,138,117,71,180,2851
"22051026900",12,50,2064,876,46,0,16,0,3064
"22051027000",2207,207,1648,782,744,18,51,0,5657
"22051027100",1831,408,343,8,89,12,67,12,2770
"22051027200",3096,610,737,526,184,52,133,52,5390
"22051027501",2408,468,2273,1115,98,27,62,0,6451
"22051027502",0,1,3012,500,21,0,0,0,3534
"22051027601",2222,457,958,1072,391,237,159,105,5601
"22051027602",623,92,1632,1064,210,103,279,44,4047
"22051027701",77,18,3674,2406,27,13,12,83,6310
"22051027703",1211,234,1378,965,286,76,267,229,4646
"22051027803",697,524,899,444,226,235,422,454,3901
"22051027804",3113,89,3606,15,1424,134,1066,89,9536
"22051027805",2026,262,3870,762,1539,202,622,107,9390
"22051027806",4252,575,702,704,781,31,899,89,8033
"22051027807",5370,289,1986,0,1064,29,755,33,9526
"22051027809",3485,660,1615,352,522,0,370,49,7053
"22051027810",681,14,2831,439,494,50,361,0,4870
"22051027811",290,99,2551,336,126,40,85,40,3567
"22051027812",359,112,1834,1656,61,23,56,21,4122
"22051027901",2273,365,14,5,251,36,65,8,3017
"22051027902",1841,468,0,0,1,0,0,0,2310
"22051028000",2877,406,764,209,586,16,181,107,5146
"22051028100",257,51,1105,715,47,19,0,0,2194
"22051028200",1715,631,964,319,331,75,454,194,4683
"22051980000",0,0,0,0,0,0,0,0,0
"22051990000",0,0,0,0,0,0,0,0,0
"22051990100",0,0,0,0,0,0,0,0,0
"22053000100",2997,783,663,199,179,139,128,53,5141
"22053000200",3730,625,139,12,167,5,30,0,4708
"22053000300",3135,540,649,256,182,36,55,0,4853
"22053000400",4729,1061,288,345,88,0,184,23,6718
"22053000500",2956,595,427,270,46,44,7,7,4352
"22053000600",1668,525,605,575,16,49,16,105,3559
"22053000700",983,194,520,330,32,3,7,0,2069
"22055000100",1305,344,212,240,2,10,5,28,2146
"22055000200",365,107,1044,532,24,3,96,15,2186
"22055000500",1919,425,27,42,99,3,150,0,2665
"22055000602",2615,685,670,806,98,115,59,122,5170
"22055000603",1730,450,466,132,42,0,414,139,3373
"22055000604",4217,802,1223,132,319,72,338,31,7134
"22055000700",337,201,1195,1048,270,89,334,79,3553
"22055000800",126,34,2026,1032,35,10,30,0,3293
"22055000900",0,79,1072,695,3,0,0,0,1849
"22055001001",2514,623,1257,597,268,123,272,45,5699
"22055001002",1181,198,1103,646,136,34,132,49,3479
"22055001003",1835,103,1510,106,30,8,12,17,3621
"22055001100",972,606,2809,2226,207,37,135,0,6992
"22055001200",974,195,4732,1139,29,12,27,57,7165
"22055001300",1018,493,1901,1249,58,22,28,8,4777
"22055001401",7670,431,388,148,303,113,127,31,9211
"22055001402",6351,337,295,0,340,148,0,0,7471
"22055001403",4010,175,168,126,374,13,305,0,5171
"22055001404",8167,386,408,78,175,0,251,0,9465
"22055001405",5757,678,1389,465,102,0,370,84,8845
"22055001406",3549,424,555,593,99,0,75,223,5518
"22055001407",4337,269,198,1,404,0,124,0,5333
"22055001409",6506,397,1202,633,448,119,455,43,9803
"22055001410",10702,507,772,457,409,143,196,0,13186
"22055001411",1558,190,172,34,15,0,13,0,1982
"22055001500",4598,359,36,192,100,0,189,76,5550
"22055001600",2897,140,0,0,40,0,32,0,3109
"22055001700",5779,336,295,138,99,21,373,0,7041
"22055001801",2080,411,595,313,173,122,367,122,4183
"22055001802",2715,533,407,488,297,0,372,6,4818
"22055001901",4291,427,590,148,103,153,45,60,5817
"22055001902",5524,599,646,232,208,169,368,76,7822
"22055001903",4079,605,1045,341,218,75,650,355,7368
"22055001904",3121,211,472,236,348,94,290,49,4821
"22055001905",3394,903,968,83,296,163,179,0,5986
"22055002001",2959,569,1021,776,374,44,88,48,5879
"22055002002",3841,483,2110,37,41,0,76,75,6663
"22055002101",2960,367,1280,631,46,98,42,17,5441
"22055002102",3422,440,919,206,21,1,168,42,5219
"22055002103",2124,152,1013,373,75,26,5,11,3779
"22055002104",4501,122,790,193,97,0,134,17,5854
"22055002200",2526,820,206,130,231,116,65,0,4094
"22055980000",19,0,0,0,0,0,0,0,19
"22057020100",1793,154,496,112,142,13,18,0,2728
"22057020202",2610,248,548,17,62,0,81,0,3566
"22057020400",535,86,1035,521,42,0,4,0,2223
"22057020500",3268,390,1711,402,52,33,0,12,5868
"22057020600",1530,221,294,321,7,12,31,46,2462
"22057020702",1859,452,116,409,201,215,18,0,3270
"22057020703",3632,167,613,587,146,0,134,0,5279
"22057020704",4606,498,267,62,276,19,133,0,5861
"22057020800",2797,382,33,0,92,58,60,0,3422
"22057020900",961,72,919,326,52,18,24,0,2372
"22057021000",2471,287,89,85,170,0,18,0,3120
"22057021100",5896,632,1,43,625,17,296,1,7511
"22057021200",3025,706,39,23,513,212,242,99,4859
"22057021300",1935,246,0,0,368,16,237,0,2802
"22057021400",2866,496,6,36,364,92,242,36,4138
"22057021500",3219,396,114,66,309,460,207,284,5055
"22057021601",5709,389,159,402,67,49,96,0,6871
"22057021602",3173,170,0,0,884,178,816,43,5264
"22057021700",2844,570,100,28,206,42,173,0,3963
"22057021800",2667,335,913,417,62,105,126,55,4680
"22057021901",5355,826,626,0,309,46,237,0,7399
"22057021902",3616,456,242,1,45,33,0,0,4393
"22057022000",1035,122,156,48,0,0,10,0,1371
"22057990000",0,0,0,0,0,0,0,0,0
"22059970100",3039,385,3,151,27,51,62,2,3720
"22059970200",3638,853,863,342,44,10,38,0,5788
"22059970300",3622,615,0,0,79,0,22,0,4338
"22061960100",2776,494,398,161,107,2,46,1,3985
"22061960200",2177,320,832,239,226,83,336,5,4218
"22061960300",366,13,2390,1697,4,0,0,40,4510
"22061960400",2525,976,637,618,280,335,10,36,5417
"22061960500",2825,496,312,267,160,150,14,195,4419
"22061960600",2488,641,948,994,68,183,113,64,5499
"22061960700",4304,810,512,121,74,55,49,109,6034
"22061960800",466,392,1313,1374,42,85,9,0,3681
"22061960900",131,71,1101,971,10,0,10,0,2294
"22061961000",1783,365,936,1577,26,59,0,71,4817
"22063040100",7299,2468,588,69,109,0,95,21,10649
"22063040201",4366,1159,41,80,21,0,24,0,5691
"22063040202",3594,753,77,4,83,3,85,17,4616
"22063040301",7892,832,125,12,146,0,360,0,9367
"22063040303",9130,479,257,0,368,0,466,0,10700
"22063040304",4734,786,56,0,151,0,174,44,5945
"22063040401",5891,1226,0,216,154,24,41,0,7552
"22063040402",6482,555,478,44,181,8,8,8,7764
"22063040500",9965,1183,633,64,415,187,905,139,13491
"22063040600",5544,837,856,703,355,105,99,71,8570
"22063040700",2895,854,0,5,0,21,126,25,3926
"22063040802",4912,539,7,104,151,0,42,0,5755
"22063040804",12722,935,1407,99,661,141,516,149,16630
"22063040805",4067,457,55,0,107,0,102,31,4819
"22063040806",6212,828,30,6,0,0,293,161,7530
"22063040901",4362,1130,765,225,49,22,61,121,6735
"22063040902",3937,787,353,19,42,0,19,0,5157
"22065960100",1107,212,158,283,19,0,50,3,1832
"22065960200",952,474,393,479,0,0,0,0,2298
"22065960300",0,0,1263,1150,25,130,0,0,2568
"22065960400",10,52,942,675,0,17,0,0,1696
"22065960500",697,124,896,375,15,109,11,109,2336
"22067950100",1071,138,241,105,5,61,0,48,1669
"22067950200",3815,490,995,211,78,0,78,0,5667
"22067950300",1566,384,365,102,6,0,0,26,2449
"22067950400",345,92,1253,1596,5,0,0,0,3291
"22067950500",1638,349,1752,1057,75,54,0,0,4925
"22067950600",1271,438,421,394,32,0,0,56,2612
"22067950700",1509,176,760,174,8,53,40,7,2727
"22067950800",203,26,1730,1294,55,9,0,38,3355
"22069000100",1647,271,259,196,136,1,16,0,2526
"22069000200",1912,231,581,352,71,15,0,0,3162
"22069000300",2852,373,474,438,192,79,103,74,4585
"22069000400",485,84,2319,1302,106,8,51,0,4355
"22069000500",2451,534,654,203,223,0,101,0,4166
"22069000600",2075,978,2374,1885,124,126,39,148,7749
"22069000700",433,479,1383,1102,45,10,28,0,3480
"22069000800",2958,741,538,188,161,20,14,37,4657
"22069000900",2310,272,834,429,347,85,105,10,4392
"22071000100",1703,234,364,126,74,169,126,135,2931
"22071000200",234,45,600,288,28,18,91,16,1320
"22071000300",61,64,612,364,0,5,10,0,1116
"22071000400",280,20,1272,830,56,2,34,0,2494
"22071000601",0,0,288,649,0,0,0,0,937
"22071000602",196,29,1660,1027,41,7,34,5,2999
"22071000603",51,29,487,346,235,14,167,43,1372
"22071000604",597,91,2458,1397,51,49,169,9,4821
"22071000605",587,25,741,656,8,0,77,0,2094
"22071000606",1661,189,1889,414,214,22,259,85,4733
"22071000607",2323,109,1877,165,0,55,247,0,4776
"22071000611",72,54,2811,550,656,223,380,109,4855
"22071000612",862,33,234,102,297,0,82,0,1610
"22071000613",351,78,2290,2146,34,9,40,49,4997
"22071000615",880,99,1798,512,219,0,60,0,3568
"22071000616",1300,84,1954,573,83,0,46,13,4053
"22071000617",564,0,2432,587,40,0,0,0,3623
"22071000618",1456,36,1762,305,365,0,59,9,3992
"22071000701",14,4,343,210,0,0,0,1,572
"22071000702",84,37,920,621,34,0,3,82,1781
"22071000800",105,7,655,507,46,0,0,0,1320
"22071000901",66,0,480,244,0,0,0,0,790
"22071000902",0,1,573,115,0,0,0,0,689
"22071000903",0,0,306,170,0,0,0,0,476
"22071000904",0,11,432,356,43,0,22,2,866
"22071001100",795,134,498,167,82,14,29,19,1738
"22071001200",1024,244,197,18,78,28,27,4,1620
"22071001301",291,49,739,477,29,8,0,0,1593
"22071001302",21,35,436,388,9,0,0,6,895
"22071001401",10,0,685,498,55,0,0,0,1248
"22071001402",91,29,986,579,76,7,44,0,1812
"22071001500",133,20,489,179,9,8,20,1,859
"22071001600",0,0,0,0,0,0,0,0,0
"22071001701",27,0,1232,510,14,0,9,0,1792
"22071001702",214,87,1998,407,14,85,60,0,2865
"22071001720",15,0,1919,1322,109,0,21,0,3386
"22071001722",52,10,2857,1096,181,14,186,0,4396
"22071001723",184,50,2998,1552,185,34,0,0,5003
"22071001724",161,69,2205,1731,233,76,79,34,4588
"22071001725",162,6,4293,2230,63,194,67,194,7209
"22071001730",33,0,496,359,14,0,11,0,913
"22071001734",702,13,0,0,94,26,11,0,846
"22071001735",2,61,1144,748,10,4,15,32,2016
"22071001736",8,51,1371,580,22,0,17,51,2100
"22071001737",116,43,1931,1043,17,11,17,0,3178
"22071001739",0,19,1391,298,0,0,0,0,1708
"22071001740",42,29,3218,1026,190,121,38,18,4682
"22071001741",64,9,558,372,512,96,0,0,1611
"22071001743",34,0,1349,964,19,0,0,0,2366
"22071001744",58,0,2178,1916,47,12,41,0,4252
"22071001745",110,32,1842,1181,42,159,12,129,3507
"22071001746",33,17,2850,1468,18,0,20,0,4406
"22071001747",29,0,2880,45,759,108,31,0,3852
"22071001748",101,10,3199,1066,295,221,3,77,4972
"22071001749",57,109,529,447,1528,303,124,284,3381
"22071001750",309,166,615,232,1185,934,392,554,4387
"22071001751",72,74,104,380,51,20,79,66,846
"22071001800",1002,200,19,56,149,8,131,0,1565
"22071001900",218,177,538,360,37,0,143,43,1516
"22071002000",148,1,462,438,13,21,0,0,1083
"22071002100",20,2,398,297,0,0,0,0,717
"22071002200",29,8,510,278,0,0,9,5,839
"22071002300",4,60,1135,461,40,14,44,0,1758
"22071002401",125,76,1450,270,55,57,36,12,2081
"22071002402",280,82,1682,825,27,0,85,0,2981
"22071002501",276,11,1066,334,4,0,122,0,1813
"22071002502",61,15,1395,680,7,12,13,0,2183
"22071002503",548,75,1452,172,72,0,38,17,2374
"22071002504",484,55,1250,363,98,0,158,0,2408
"22071002600",938,155,40,104,14,66,21,0,1338
"22071002700",282,38,749,414,0,14,36,35,1568
"22071002800",5,0,1006,509,15,1,0,0,1536
"22071002900",25,9,813,589,0,0,40,0,1476
"22071003000",46,4,510,556,17,12,37,4,1186
"22071003100",1,0,449,498,130,15,4,12,1109
"22071003301",842,66,670,209,46,0,110,14,1957
"22071003302",216,79,2445,745,102,0,86,6,3679
"22071003303",361,89,911,387,78,102,122,31,2081
"22071003304",157,38,1000,651,10,0,17,26,1899
"22071003307",10,5,991,290,37,0,49,0,1382
"22071003308",30,0,2181,649,131,122,65,107,3285
"22071003400",294,95,467,340,25,22,34,18,1295
"22071003500",139,18,692,341,5,0,0,0,1195
"22071003600",182,55,764,730,42,27,27,6,1833
"22071003701",517,52,1223,416,56,0,55,5,2324
"22071003702",885,142,1053,1128,95,30,20,19,3372
"22071003800",1073,123,20,2,8,0,49,35,1310
"22071003900",501,88,279,336,149,13,222,9,1597
"22071004000",239,160,980,598,27,13,152,49,2218
"22071004100",1230,73,135,53,14,72,63,72,1712
"22071004401",65,37,353,768,41,0,18,0,1282
"22071004402",0,0,0,78,0,0,0,0,78
"22071004500",492,47,674,727,143,0,150,9,2242
"22071004600",2285,272,113,107,92,9,181,29,3088
"22071004800",0,1,130,867,51,1,0,0,1050
"22071004900",226,125,280,694,99,33,142,24,1623
"22071005000",523,120,262,516,91,180,300,238,2230
"22071005400",1249,204,199,121,52,28,306,11,2170
"22071005500",2092,253,151,0,149,6,269,18,2938
"22071005601",1818,153,65,0,199,35,227,13,2510
"22071005602",2431,120,47,0,19,0,92,0,2709
"22071005603",1157,146,84,0,7,0,121,5,1520
"22071005604",1400,60,43,0,29,5,40,0,1577
"22071006000",136,180,654,398,18,9,50,146,1591
"22071006300",417,189,334,469,169,8,333,161,2080
"22071006400",848,240,702,353,137,36,234,44,2594
"22071006500",1407,220,317,485,174,76,330,24,3033
"22071006900",0,7,230,560,0,0,0,7,804
"22071007000",30,48,121,259,0,0,0,6,464
"22071007101",277,238,849,470,28,13,212,74,2161
"22071007200",75,43,848,964,176,49,80,29,2264
"22071007501",50,104,1733,837,38,0,16,39,2817
"22071007502",0,113,1367,1002,41,53,0,8,2584
"22071007604",1553,63,62,0,53,0,68,42,1841
"22071007605",121,92,720,505,37,0,33,21,1529
"22071007606",2870,285,366,45,254,39,363,24,4246
"22071007700",1832,206,296,106,131,6,328,43,2948
"22071007800",1046,252,110,4,174,45,322,123,2076
"22071008200",1027,136,103,52,63,19,102,89,1591
"22071008300",923,67,105,24,23,5,72,34,1253
"22071008400",445,109,435,187,52,0,58,0,1286
"22071008500",17,13,502,560,117,46,29,56,1340
"22071008600",16,23,352,370,38,50,43,18,910
"22071008800",1144,167,382,96,92,7,94,0,1982
"22071009000",1559,148,66,0,163,15,13,5,1969
"22071009100",856,140,504,665,128,129,120,96,2638
"22071009200",20,9,834,595,19,11,11,0,1499
"22071009400",20,44,595,640,0,0,87,22,1408
"22071009600",1031,75,406,46,34,2,135,1,1730
"22071009700",559,120,651,96,123,117,39,83,1788
"22071009900",2027,414,142,55,111,19,173,76,3017
"22071010000",275,99,603,903,30,0,51,4,1965
"22071010100",1087,327,327,88,33,25,62,34,1983
"22071010200",161,42,689,543,10,33,0,6,1484
"22071010300",250,29,1622,883,15,68,25,11,2903
"22071010600",635,77,343,87,105,0,102,5,1354
"22071010700",1186,80,269,19,45,92,89,5,1785
"22071010800",1092,73,55,26,74,0,61,10,1391
"22071010900",1620,324,1302,145,116,0,107,0,3614
"22071011100",358,58,565,397,54,45,36,55,1568
"22071011200",751,168,347,123,151,40,191,0,1771
"22071011400",1612,133,35,1,39,9,58,1,1888
"22071011500",1144,86,21,40,33,0,96,0,1420
"22071011600",1183,73,0,0,109,0,11,0,1376
"22071011700",2257,132,0,14,102,0,113,12,2630
"22071011900",1347,353,67,49,36,30,92,40,2014
"22071012000",1021,212,24,69,68,0,120,10,1524
"22071012101",1487,477,28,62,157,138,144,68,2561
"22071012102",624,431,9,1,37,38,55,50,1245
"22071012200",1727,215,193,14,150,0,190,9,2498
"22071012300",878,111,602,331,65,36,101,66,2190
"22071012400",868,42,345,449,46,0,84,9,1843
"22071012500",864,156,150,138,153,31,86,31,1609
"22071012600",1235,330,87,47,99,70,52,0,1920
"22071012700",1398,246,272,275,21,12,140,0,2364
"22071012800",1417,165,333,64,153,53,140,2,2327
"22071012900",765,97,191,202,90,65,29,5,1444
"22071013000",630,154,416,622,20,0,6,0,1848
"22071013100",153,127,515,647,19,6,129,85,1681
"22071013200",939,362,860,367,61,11,95,52,2747
"22071013301",3173,146,68,0,189,0,228,0,3804
"22071013302",1235,161,423,108,178,77,46,14,2242
"22071013400",1140,219,169,365,178,167,97,25,2360
"22071013500",1721,239,49,3,64,21,84,100,2281
"22071013600",448,34,425,112,17,0,80,0,1116
"22071013700",15,64,900,1285,5,12,24,64,2369
"22071013800",51,16,1229,692,21,0,0,0,2009
"22071013900",560,136,572,127,174,25,126,2,1722
"22071014000",92,37,430,1024,25,0,92,28,1728
"22071014100",711,166,670,540,28,3,66,0,2184
"22071014200",1015,110,436,118,59,0,30,6,1774
"22071014300",144,38,581,928,12,1,138,0,1842
"22071014400",693,138,672,95,287,95,316,33,2329
"22071014500",0,0,0,0,0,0,0,0,0
"22071980000",1,0,0,1,1,1,0,0,4
"22071980100",0,0,0,0,0,0,0,0,0
"22071990000",0,0,0,0,0,0,0,0,0
"22073000100",2670,587,947,207,308,79,231,52,5081
"22073000200",3936,448,496,52,48,0,14,0,4994
"22073000401",339,193,708,208,52,37,3,0,1540
"22073000402",582,131,704,639,126,25,99,0,2306
"22073000500",1388,250,498,618,49,20,70,2,2895
"22073000600",7,0,2019,1762,0,0,0,0,3788
"22073000700",0,16,939,1113,0,0,0,0,2068
"22073000900",3,0,670,878,6,1,0,1,1559
"22073001100",60,0,1476,2034,49,81,19,81,3800
"22073001400",54,73,1168,995,39,0,10,0,2339
"22073001500",99,94,612,767,0,6,0,0,1578
"22073001700",1646,240,625,288,301,191,164,0,3455
"22073005100",1455,264,10,58,62,0,24,10,1883
"22073005201",3165,282,0,1,52,16,26,0,3542
"22073005203",2463,303,154,297,120,0,11,0,3348
"22073005204",5044,429,0,0,80,0,0,0,5553
"22073005301",5486,267,154,100,87,0,73,0,6167
"22073005302",4347,1059,204,171,119,47,123,62,6132
"22073005400",1299,163,92,218,81,0,99,0,1952
"22073005500",1180,383,630,616,94,54,12,0,2969
"22073005800",1231,458,599,211,151,35,171,142,2998
"22073005900",1522,1035,47,26,11,91,25,48,2805
"22073010101",3130,442,425,545,154,0,54,0,4750
"22073010102",2600,568,2085,569,173,54,92,30,6171
"22073010201",1655,387,2365,647,331,0,60,0,5445
"22073010202",4904,169,684,30,214,0,108,0,6109
"22073010301",2443,134,281,116,98,75,94,0,3241
"22073010302",2580,276,1124,170,61,19,129,0,4359
"22073010400",8356,1125,194,133,97,0,328,0,10233
"22073010502",3879,353,28,0,25,0,25,59,4369
"22073010503",1460,136,0,0,0,49,57,0,1702
"22073010504",5837,1620,321,101,93,14,212,14,8212
"22073010603",333,139,1922,1624,30,7,0,0,4055
"22073010604",1170,118,492,225,16,0,14,0,2035
"22073010700",14,1,1180,1263,0,5,0,0,2463
"22073010800",126,107,722,445,0,4,0,0,1404
"22073010900",122,15,3047,1656,49,0,7,0,4896
"22073011000",66,57,2306,2309,15,0,23,41,4817
"22073011100",544,382,946,971,26,37,0,44,2950
"22073980000",0,0,0,0,0,0,0,0,0
"22075050100",403,87,789,231,0,0,21,0,1531
"22075050200",6969,564,140,0,708,104,648,104,9237
"22075050300",3334,259,453,20,526,0,383,7,4982
"22075050400",1824,203,1468,122,87,173,111,0,3988
"22075050500",381,46,627,452,56,36,0,0,1598
"22075050600",612,20,297,75,38,56,15,0,1113
"22075050700",667,91,0,0,71,73,0,0,902
"22075050800",345,284,114,153,165,136,26,5,1228
"22075990000",0,0,0,0,0,0,0,0,0
"22077951900",1269,49,2909,1213,0,0,0,0,5440
"22077952000",1130,187,641,586,32,0,72,45,2693
"22077952100",3420,290,686,252,83,114,51,34,4930
"22077952200",2507,245,476,37,52,0,47,46,3410
"22077952300",817,53,265,386,69,0,70,0,1660
"22077952400",3445,520,439,122,80,67,157,10,4840
"22079010100",8042,1308,323,4,40,51,246,51,10065
"22079010300",3494,1268,172,2,100,0,62,141,5239
"22079010400",1835,106,103,1,25,0,24,0,2094
"22079010500",2101,548,2220,1623,187,3,99,0,6781
"22079010600",3919,553,5,10,238,19,41,3,4788
"22079010700",3284,268,574,10,90,32,89,0,4347
"22079011000",162,177,1416,835,268,63,24,7,2952
"22079011300",1588,282,207,55,63,24,0,0,2219
"22079011500",4850,712,1420,144,239,0,315,12,7692
"22079011600",1477,367,200,144,159,32,49,0,2428
"22079011700",721,262,579,341,117,17,33,0,2070
"22079012000",0,0,1240,712,37,4,0,0,1993
"22079012100",709,140,1323,534,63,240,0,5,3014
"22079012200",1197,296,1064,1233,83,19,24,0,3916
"22079012301",3517,286,896,101,227,0,0,0,5027
"22079012302",2947,122,244,118,103,136,17,62,3749
"22079012400",3116,148,711,82,49,87,193,0,4386
"22079012500",1893,780,2787,1073,296,7,197,188,7221
"22079012600",629,77,935,170,202,14,42,0,2069
"22079012700",33,29,2202,1328,12,8,0,0,3612
"22079012800",0,0,679,128,37,0,0,0,844
"22079012900",16,0,1513,1165,13,0,0,0,2707
"22079013000",233,24,1626,569,8,15,33,6,2514
"22079013100",1168,218,612,471,92,23,11,0,2595
"22079013200",6394,1040,405,3,201,16,107,0,8166
"22079013300",3018,377,1144,504,0,51,81,0,5175
"22079013400",2941,183,146,0,100,12,12,6,3400
"22079013500",4841,616,519,294,155,100,932,183,7640
"22079013600",2319,455,0,0,48,11,0,0,2833
"22079013700",2301,824,45,10,100,159,60,8,3507
"22079013800",1764,243,919,567,319,54,121,0,3987
"22079013900",307,149,1093,1050,0,8,7,0,2614
"22079980000",26,9,0,0,0,0,0,0,35
"22081960100",3595,551,539,236,41,4,36,0,5002
"22081960300",865,180,1659,948,139,1,86,0,3878
"22083970100",916,80,1293,612,34,16,64,19,3034
"22083970200",1209,250,494,150,7,0,101,5,2216
"22083970300",2378,249,265,75,16,27,21,0,3031
"22083970400",2573,269,53,153,5,5,0,0,3058
"22083970500",1331,99,1692,1564,83,5,51,0,4825
"22083970600",2795,470,488,214,53,6,129,6,4161
"22085000100",1930,281,260,188,285,123,74,49,3190
"22085000200",2095,571,5,6,789,375,117,49,4007
"22085000300",735,190,524,414,481,109,120,78,2651
"22085000400",3336,470,297,120,487,124,120,84,5038
"22085000500",989,281,715,918,80,46,0,15,3044
"22085000600",2461,542,298,120,116,98,97,26,3758
"22085000700",2492,280,130,0,12,0,30,0,2944
"22087030103",2824,714,805,104,45,0,253,0,4745
"22087030104",1310,278,20,0,114,0,185,17,1924
"22087030105",153,62,9,9,0,0,31,17,281
"22087030203",1937,379,96,110,199,205,190,210,3326
"22087030204",1206,139,2183,801,62,31,239,26,4687
"22087030206",1291,280,156,0,146,0,68,16,1957
"22087030207",2648,405,267,67,391,20,198,20,4016
"22087030208",2282,186,254,17,385,0,203,5,3332
"22087030209",2583,89,422,84,0,0,360,0,3538
"22087030300",1134,176,135,79,37,7,229,45,1842
"22087030400",823,162,42,0,44,10,91,7,1179
"22087030500",1133,279,297,41,91,31,102,44,2018
"22087030601",594,111,238,163,182,12,34,38,1372
"22087030602",1607,539,317,49,24,16,203,167,2922
"22087030603",701,133,394,260,0,6,138,84,1716
"22087030700",1148,147,104,46,7,0,41,6,1499
"22087030800",2348,298,276,418,281,11,580,24,4236
"22087990000",0,0,0,0,0,0,0,0,0
"22089060100",1449,86,436,45,20,14,56,23,2129
"22089062100",3400,722,1830,348,98,9,506,310,7223
"22089062200",810,23,1723,402,41,12,31,4,3046
"22089062301",4436,110,968,0,423,0,484,0,6421
"22089062302",3357,256,810,429,110,1,400,11,5374
"22089062400",937,45,337,145,14,0,20,0,1498
"22089062500",2529,290,73,108,29,9,46,0,3084
"22089062700",1406,311,1431,601,158,10,116,76,4109
"22089062800",1730,385,1803,922,138,22,281,2,5283
"22089062900",1757,124,215,0,58,15,106,0,2275
"22089063000",930,5,391,36,0,0,23,0,1385
"22089063100",6336,295,175,25,249,109,158,22,7369
"22089063200",4521,586,145,0,149,0,74,94,5569
"22091951100",1843,175,1244,646,28,29,0,0,3965
"22091951200",2344,393,2012,1783,174,52,14,0,6772
"22093040100",1676,151,1004,699,44,0,32,12,3618
"22093040200",1913,53,735,605,0,0,33,37,3376
"22093040300",2725,63,410,106,60,0,48,0,3412
"22093040400",771,125,893,725,22,14,20,13,2583
"22093040500",85,14,1635,566,0,0,0,0,2300
"22093040600",656,17,1787,233,21,73,37,73,2897
"22093040700",2058,165,1362,21,0,0,0,0,3606
"22095070100",1849,55,406,105,56,10,152,10,2643
"22095070200",1514,24,4799,820,222,0,567,18,7964
"22095070300",3186,376,1312,463,476,0,166,218,6197
"22095070400",2725,104,1004,288,155,0,245,0,4521
"22095070500",1909,13,3147,743,163,0,428,0,6403
"22095070600",939,208,505,865,0,0,0,0,2517
"22095070700",2496,295,1177,159,146,24,257,0,4554
"22095070800",193,8,1293,857,0,8,0,0,2359
"22095070900",855,175,901,720,8,29,55,0,2743
"22095071000",1169,299,791,311,85,17,112,7,2791
"22095071100",364,75,2228,666,0,0,0,0,3333
"22097960100",1038,275,564,679,18,27,0,34,2635
"22097960200",2532,230,739,382,21,29,0,11,3944
"22097960300",1987,496,827,507,22,0,46,0,3885
"22097960400",1580,493,0,0,11,15,14,15,2128
"22097960500",3795,854,296,169,56,0,73,90,5333
"22097960600",2063,324,1788,2327,77,0,0,0,6579
"22097960700",3367,344,1176,684,90,0,15,0,5676
"22097960800",2333,667,511,168,73,47,24,0,3823
"22097960900",1247,361,1452,806,15,30,75,38,4024
"22097961000",1436,263,224,84,78,47,188,0,2320
"22097961100",2052,586,272,409,49,121,88,0,3577
"22097961200",2776,254,1636,866,94,10,336,0,5972
"22097961300",444,90,1293,2082,125,66,9,0,4109
"22097961400",771,80,2029,1258,19,0,0,0,4157
"22097961500",1610,114,1269,1401,41,0,9,110,4554
"22097961600",233,108,1809,1568,42,4,21,4,3789
"22097961700",3592,818,1163,364,228,158,0,56,6379
"22097961800",5033,801,573,276,95,319,125,64,7286
"22097961900",1360,135,1366,568,39,55,2,0,3525
"22099020100",4226,1013,76,182,37,137,35,137,5843
"22099020200",4883,399,1654,691,320,0,14,0,7961
"22099020301",2908,681,966,61,38,0,196,0,4850
"22099020302",4907,701,1011,249,251,119,244,99,7581
"22099020400",3347,292,945,711,186,38,63,13,5595
"22099020501",2338,308,1575,1097,6,13,0,0,5337
"22099020502",2010,154,680,802,79,117,10,0,3852
"22099020600",2157,118,2110,1058,168,51,174,0,5836
"22099020800",1578,95,1191,72,144,63,118,0,3261
"22099020900",845,127,462,225,12,9,72,5,1757
"22099021000",1221,218,0,0,40,0,37,0,1516
"22101040100",1200,193,521,476,559,45,548,60,3602
"22101040200",3385,341,277,328,186,173,160,163,5013
"22101040300",1361,252,767,402,144,82,266,102,3376
"22101040400",2178,709,545,307,224,172,104,55,4294
"22101040500",3367,436,222,425,220,222,186,84,5162
"22101040600",3561,741,117,299,265,118,345,118,5564
"22101040700",1363,268,1112,514,173,68,127,52,3677
"22101040800",3045,266,1004,210,151,81,31,17,4805
"22101040900",1685,194,582,204,225,33,59,0,2982
"22101041000",2165,167,668,226,667,38,146,13,4090
"22101041100",614,167,618,431,9,33,58,23,1953
"22101041200",535,164,678,446,55,42,38,0,1958
"22101041300",820,150,536,141,159,44,66,106,2022
"22101041400",898,334,1428,610,144,70,14,71,3569
"22101041500",936,139,659,132,70,14,19,37,2006
"22101041600",114,27,818,773,21,41,0,0,1794
"22101990000",0,0,0,0,0,0,0,0,0
"22103040102",7407,1143,201,89,209,87,189,24,9349
"22103040103",4184,318,0,0,0,0,82,0,4584
"22103040104",5505,579,73,0,233,35,336,119,6880
"22103040201",7160,780,482,78,784,17,347,11,9659
"22103040202",5244,724,22,17,143,11,139,15,6315
"22103040303",7818,507,186,131,443,103,460,86,9734
"22103040304",6380,50,0,0,54,15,234,6,6739
"22103040305",10161,337,268,176,266,0,228,0,11436
"22103040400",6373,610,50,152,144,0,173,0,7502
"22103040501",1015,179,1160,784,0,0,32,22,3192
"22103040502",2330,218,695,478,39,93,95,25,3973
"22103040601",1887,62,0,0,115,19,3,0,2086
"22103040602",2238,156,0,0,55,4,323,24,2800
"22103040604",6883,1100,241,5,231,131,596,238,9425
"22103040605",5414,358,425,133,256,164,330,85,7165
"22103040701",6607,232,1886,201,427,0,466,19,9838
"22103040704",2909,1309,794,477,109,290,99,287,6274
"22103040705",4816,241,681,133,110,41,115,43,6180
"22103040706",4425,779,199,0,258,51,304,5,6021
"22103040708",5140,179,491,25,335,14,249,0,6433
"22103040709",3510,110,173,15,184,8,362,0,4362
"22103040710",4790,210,456,122,416,5,266,6,6271
"22103040801",2777,450,536,271,565,225,581,81,5486
"22103040802",5809,379,347,0,247,0,166,86,7034
"22103040803",3084,1227,4334,580,542,108,391,242,10508
"22103040900",1066,159,1267,441,52,0,110,2,3097
"22103041002",2174,549,87,2,72,27,157,122,3190
"22103041003",4442,290,529,103,41,19,130,19,5573
"22103041004",3755,208,91,1,184,0,249,0,4488
"22103041101",2968,221,228,333,63,6,85,0,3904
"22103041102",3752,1183,1542,282,168,143,285,250,7605
"22103041103",1401,523,781,285,107,75,91,133,3396
"22103041104",2407,319,623,19,112,0,77,40,3597
"22103041202",1323,327,411,434,137,48,132,4,2816
"22103041204",5503,549,1023,248,82,110,253,93,7861
"22103041207",3714,126,124,0,396,6,131,13,4510
"22103041208",4058,113,0,0,200,4,158,0,4533
"22103041209",4556,243,106,8,165,10,255,0,5343
"22103041210",2241,39,102,0,88,0,2,0,2472
"22103041211",5597,170,106,1,391,0,373,0,6638
"22103041212",3396,48,66,34,55,0,290,7,3896
"22103041300",5060,361,544,0,386,58,327,168,6904
"22103990000",0,0,0,0,0,0,0,0,0
"22105953200",1736,373,204,719,0,15,13,0,3060
"22105953300",1058,208,1256,1047,5,13,0,27,3614
"22105953400",2034,258,2229,949,89,101,27,5,5692
"22105953500",5000,712,980,126,220,62,79,0,7179
"22105953600",1544,256,2548,1836,39,202,232,108,6765
"22105953700",8635,976,576,197,394,36,129,0,10943
"22105953800",3023,965,624,470,62,15,133,283,5575
"22105953900",4971,1405,1929,380,317,93,600,33,9728
"22105954001",1901,566,504,777,177,42,148,40,4155
"22105954002",2962,523,1533,315,41,0,111,170,5655
"22105954101",2490,336,1153,978,104,36,100,0,5197
"22105954102",7080,707,733,1089,367,16,197,195,10384
"22105954200",1753,575,148,432,99,66,121,41,3235
"22105954300",895,18,1757,1193,8,0,8,0,3879
"22105954400",1217,420,1353,791,0,37,168,223,4209
"22105954501",3227,477,1134,307,130,46,102,117,5540
"22105954502",3878,710,1738,808,416,0,286,0,7836
"22105954600",9298,1133,505,464,35,0,470,134,12039
"22105954700",3123,336,751,619,68,0,111,16,5024
"22105954800",3341,669,541,220,224,17,152,17,5181
"22107000100",892,74,377,437,9,10,14,0,1813
"22107000200",545,175,100,249,0,0,5,5,1079
"22107000300",368,22,740,749,0,10,36,12,1937
"22109000101",4292,659,1319,108,343,96,213,0,7030
"22109000102",1781,227,936,432,123,9,153,0,3661
"22109000201",1761,396,410,513,161,438,102,265,4046
"22109000202",5301,592,327,479,417,158,402,41,7717
"22109000300",3036,232,780,412,146,110,128,41,4885
"22109000401",3118,242,475,261,462,77,289,66,4990
"22109000402",3473,118,276,49,100,51,104,25,4196
"22109000500",3019,373,1032,1149,277,97,531,86,6564
"22109000600",3923,776,616,179,843,116,236,173,6862
"22109000700",1835,605,2056,703,423,191,502,113,6428
"22109000800",3726,878,318,421,379,107,234,0,6063
"22109000900",2375,365,1444,534,203,32,88,82,5123
"22109001000",4107,622,385,214,580,0,24,58,5990
"22109001100",2720,371,1,1,260,275,5,0,3633
"22109001201",2257,246,168,219,166,43,0,0,3099
"22109001202",3060,780,18,0,256,56,58,0,4228
"22109001300",2577,409,708,531,1844,1074,44,144,7331
"22109001400",1604,345,411,474,239,86,13,29,3201
"22109001500",6054,352,320,50,412,0,337,0,7525
"22109001600",1128,297,585,416,8,0,58,0,2492
"22109001700",8110,349,466,569,355,41,83,113,10086
"22109990000",0,0,0,0,0,0,0,0,0
"22111960100",2805,363,690,697,25,0,146,0,4726
"22111960200",1529,440,606,586,160,78,245,163,3807
"22111960300",1422,571,230,468,26,0,35,213,2965
"22111960400",980,175,694,1337,54,165,32,39,3476
"22111960500",3732,793,84,35,55,82,0,0,4781
"22111960600",2653,353,88,68,25,9,76,10,3282
"22113950100",7592,973,366,210,311,39,508,0,9999
"22113950200",4542,495,170,53,8,0,0,4,5272
"22113950400",3061,832,203,473,221,89,62,30,4971
"22113950500",5006,597,44,2,136,40,53,12,5890
"22113950600",2865,401,53,0,227,0,12,0,3558
"22113950700",1834,304,573,432,214,73,5,37,3472
"22113950800",1362,225,1815,1557,108,40,128,2,5237
"22113950901",1956,97,275,180,171,142,121,0,2942
"22113950902",4928,667,1249,36,301,228,109,0,7518
"22113951001",3352,652,108,11,215,99,114,32,4583
"22113951002",2977,340,238,117,65,4,109,2,3852
"22113951100",1209,617,0,0,52,7,66,233,2184
"22113990000",0,0,0,0,0,0,0,0,0
"22115950100",4500,831,172,38,392,15,146,31,6125
"22115950200",3765,543,92,3,243,8,74,10,4738
"22115950300",3417,503,131,3,393,25,93,2,4567
"22115950400",1420,235,1204,513,159,14,130,42,3717
"22115950500",2989,564,1416,333,684,130,485,68,6669
"22115950600",2360,438,670,19,536,86,382,35,4526
"22115950701",112,0,0,0,0,0,38,0,150
"22115950702",2475,241,720,114,322,14,749,96,4731
"22115950703",1634,148,497,51,283,12,331,113,3069
"22115950704",2655,198,440,7,427,36,817,36,4616
"22115950800",3442,487,132,38,103,10,141,8,4361
"22115950900",5091,866,439,96,408,24,393,61,7378
"22117950101",1331,507,777,328,8,47,32,2,3032
"22117950102",2886,654,681,407,29,0,0,10,4667
"22117950200",3536,771,1226,243,246,0,0,0,6022
"22117950300",1054,286,1645,644,0,32,35,18,3714
"22117950400",2551,662,372,406,81,0,0,21,4093
"22117950500",4300,1153,206,241,32,0,0,0,5932
"22117950600",3550,637,338,45,32,31,28,0,4661
"22117950700",2862,744,344,460,153,180,664,48,5455
"22117950800",1000,47,1236,1529,30,30,7,7,3886
"22117950900",278,263,260,196,48,0,28,0,1073
"22117951000",1428,292,759,780,29,0,3,0,3291
"22119031100",1484,207,52,54,18,7,4,14,1840
"22119031200",1387,211,395,443,11,0,9,3,2459
"22119031300",2827,813,585,892,13,104,22,104,5360
"22119031400",2316,224,408,108,110,3,27,5,3201
"22119031500",3495,595,412,188,166,4,207,0,5067
"22119031600",2676,307,133,7,8,13,7,7,3158
"22119031700",307,69,1723,1345,0,17,0,0,3461
"22119031800",1380,237,924,164,0,41,62,0,2808
"22119031900",199,118,1484,579,112,7,0,7,2506
"22119032000",1711,307,445,443,87,0,26,0,3019
"22119032100",3825,735,1604,911,80,15,183,0,7353
"22121020100",1632,150,1742,719,26,20,45,0,4334
"22121020200",952,232,1094,501,126,49,74,62,3090
"22121020300",4454,200,859,447,58,109,238,0,6365
"22121020401",2145,379,1209,1104,102,9,46,58,5052
"22121020402",3832,393,832,160,168,0,77,0,5462
"22123000100",3160,648,200,327,46,0,59,104,4544
"22123000200",2346,1097,180,120,11,109,45,59,3967
"22123000300",1523,317,325,195,11,29,17,3,2420
"22125951701",1329,159,1510,341,39,0,9,0,3387
"22125951702",435,106,43,6,0,0,0,5,595
"22125951800",4855,506,1386,939,60,25,104,67,7942
"22127960100",2706,318,120,107,2,9,90,5,3357
"22127960200",2963,614,476,487,103,9,46,0,4698
"22127960300",1334,486,247,468,0,41,0,0,2576
"22127960400",893,247,933,519,6,81,0,106,2785
"23001010100",832,445,0,12,53,158,0,31,1531
"23001010200",3736,384,5,0,266,57,99,0,4547
"23001010300",1212,531,50,195,228,34,15,79,2344
"23001010400",2048,193,11,0,62,0,32,0,2346
"23001010500",1343,608,6,15,81,63,7,21,2144
"23001010600",2311,375,0,0,45,44,14,31,2820
"23001010700",2458,350,32,0,193,24,0,0,3057
"23001010800",3349,278,15,11,198,11,47,0,3909
"23001020100",585,433,17,195,46,65,0,45,1386
"23001020200",946,217,20,0,22,44,9,0,1258
"23001020300",3103,1881,65,401,232,293,195,244,6414
"23001020400",1054,1319,107,204,45,264,10,204,3207
"23001020500",3105,668,6,35,63,121,0,75,4073
"23001020600",2188,213,0,0,65,0,1,0,2467
"23001020700",4401,249,0,0,307,0,132,0,5089
"23001020800",5970,648,35,0,554,120,0,0,7327
"23001020900",2969,545,61,42,124,119,5,0,3865
"23001030100",3871,273,7,0,218,40,15,0,4424
"23001030200",3921,372,11,0,134,24,14,0,4476
"23001040000",3418,306,0,0,96,59,0,0,3879
"23001041000",4564,485,11,0,248,87,13,0,5408
"23001041500",4951,466,3,3,124,47,99,0,5693
"23001042000",5099,383,17,10,155,3,76,7,5750
"23001043000",1884,142,0,0,21,0,18,0,2065
"23001044000",2371,664,0,0,104,2,11,18,3170
"23001045000",1613,282,0,0,69,23,15,0,2002
"23001046000",3723,467,0,0,132,8,19,0,4349
"23001046500",5924,725,0,0,210,21,16,3,6899
"23003950100",2105,333,11,0,46,23,31,5,2554
"23003950200",2071,630,10,0,28,0,25,0,2764
"23003950300",3399,385,0,77,42,10,0,8,3921
"23003950400",1390,168,0,2,18,15,4,0,1597
"23003950600",3168,549,0,0,94,74,7,5,3897
"23003950700",2150,413,9,0,55,16,17,0,2660
"23003950900",1808,299,0,0,69,3,6,0,2185
"23003951000",3001,381,1,2,57,51,46,25,3564
"23003951100",2448,257,0,0,78,20,11,0,2814
"23003951200",1938,519,38,0,20,116,16,0,2647
"23003951300",2503,391,43,14,51,91,16,18,3127
"23003951400",1759,261,0,3,117,38,85,0,2263
"23003951600",1143,474,52,7,40,14,0,38,1768
"23003951700",3514,981,0,0,72,42,52,5,4666
"23003951800",2940,776,3,0,244,7,6,0,3976
"23003951900",2359,270,1,0,28,0,6,0,2664
"23003952000",1501,653,17,1,60,156,0,11,2399
"23003952100",2305,476,18,0,33,28,15,2,2877
"23003952300",2023,319,17,2,172,26,16,14,2589
"23003952400",2925,436,20,0,140,196,12,46,3775
"23003952500",1674,258,0,0,25,44,1,22,2024
"23003952600",2378,509,6,0,34,37,11,0,2975
"23003952700",2052,387,2,1,59,17,14,0,2532
"23003952900",2511,463,4,20,86,3,3,3,3093
"23005000100",1734,365,16,36,121,42,35,0,2349
"23005000200",1856,432,102,13,46,29,30,2,2510
"23005000300",1259,759,95,203,51,56,10,49,2482
"23005000500",1026,409,266,430,256,170,268,38,2863
"23005000600",1508,686,171,283,58,35,103,36,2880
"23005001000",1419,627,179,214,57,18,46,6,2566
"23005001100",2027,546,9,30,78,43,65,12,2810
"23005001200",854,509,63,30,38,55,32,40,1621
"23005001300",2022,738,61,270,121,44,82,5,3343
"23005001500",2925,363,28,21,162,96,139,29,3763
"23005001700",3665,416,38,192,61,55,45,16,4488
"23005001800",3213,173,0,0,44,7,64,0,3501
"23005001900",3545,353,23,0,194,101,131,2,4349
"23005002001",2658,338,66,61,639,204,0,52,4018
"23005002002",1598,281,38,66,292,48,57,11,2391
"23005002101",4522,583,54,260,118,223,56,0,5816
"23005002102",3429,651,417,515,295,105,191,269,5872
"23005002200",3507,562,43,0,413,12,0,0,4537
"23005002300",2356,406,207,172,255,162,156,37,3751
"23005002400",1142,105,0,2,20,2,16,30,1317
"23005002501",3230,134,103,0,99,39,106,0,3711
"23005002502",7187,157,9,0,285,14,65,11,7728
"23005002600",3636,126,55,90,32,0,104,28,4071
"23005002700",3258,627,295,33,276,73,184,81,4827
"23005002800",2095,455,0,30,55,80,91,0,2806
"23005002900",4993,989,0,68,147,100,35,0,6332
"23005003000",4490,859,37,203,646,0,177,0,6412
"23005003100",2809,643,38,120,198,2,20,146,3976
"23005003200",2725,402,39,0,25,0,14,2,3207
"23005003300",2663,90,11,62,271,41,12,9,3159
"23005003400",4270,177,25,1,255,20,40,10,4798
"23005003500",2970,432,8,16,61,19,0,19,3525
"23005003701",4049,98,0,0,92,23,59,12,4333
"23005003702",4394,179,157,24,66,0,48,0,4868
"23005004001",2750,85,70,0,151,0,7,25,3088
"23005004002",5827,254,38,52,236,42,0,0,6449
"23005004100",5346,133,14,0,225,1,15,0,5734
"23005004200",7197,205,0,0,300,14,64,14,7794
"23005004401",4464,145,15,0,151,0,167,0,4942
"23005004402",3070,361,21,0,76,14,10,33,3585
"23005004501",2613,174,24,3,104,8,7,8,2941
"23005004502",4448,319,51,3,167,0,22,0,5010
"23005004600",3289,115,0,1,195,0,10,0,3610
"23005004701",1724,187,0,0,42,0,55,0,2008
"23005004702",4737,883,26,3,217,28,61,0,5955
"23005004801",5658,668,180,20,162,0,36,10,6734
"23005004802",4147,348,105,6,72,15,0,0,4693
"23005004803",4685,350,0,0,79,0,38,3,5155
"23005011100",3905,335,34,0,149,26,34,0,4483
"23005011201",5962,644,24,0,59,37,34,0,6760
"23005011202",3994,723,0,21,337,13,41,81,5210
"23005011300",2085,200,11,0,34,0,34,0,2364
"23005011500",6426,441,0,0,111,22,100,14,7114
"23005012000",4109,284,10,0,48,9,0,0,4460
"23005013000",3109,474,0,0,85,122,37,47,3874
"23005014000",3260,556,30,1,48,0,36,0,3931
"23005015000",2401,264,0,19,73,0,0,0,2757
"23005016000",3829,1044,23,0,211,0,0,21,5128
"23005016500",2822,227,0,5,45,12,3,5,3119
"23005017001",5765,369,78,1,71,0,0,0,6284
"23005017002",2854,206,0,1,0,0,2,0,3063
"23005017101",1699,107,0,0,18,0,0,0,1824
"23005017102",2376,537,0,0,0,35,10,0,2958
"23005017301",7274,389,11,164,755,0,217,0,8810
"23005017303",3935,232,0,0,110,0,0,0,4277
"23005017304",5445,258,41,25,254,13,143,15,6194
"23005990000",0,0,0,0,0,0,0,0,0
"23007970101",1639,214,0,0,77,0,0,0,1930
"23007970102",559,104,0,0,15,0,8,0,686
"23007970601",1624,150,3,0,23,13,65,17,1895
"23007970602",1972,567,2,0,25,0,22,14,2602
"23007971000",3528,498,13,6,99,21,54,5,4224
"23007971100",2450,308,0,0,42,2,0,0,2802
"23007971200",4959,1466,8,36,110,0,63,0,6642
"23007971300",3110,732,6,0,112,85,35,0,4080
"23007971400",4351,293,0,0,166,0,17,32,4859
"23009965100",1602,258,2,0,34,0,7,5,1908
"23009965200",1935,218,0,0,7,8,40,0,2208
"23009965300",3964,929,0,12,31,0,0,14,4950
"23009965400",2293,311,0,3,65,8,5,29,2714
"23009965503",2832,521,14,0,46,23,22,0,3458
"23009965504",3696,329,43,67,14,9,76,0,4234
"23009965700",2154,463,0,3,101,65,0,25,2811
"23009965800",1754,374,2,2,5,6,0,0,2143
"23009965900",4135,476,0,23,265,67,122,0,5088
"23009966000",1934,180,3,0,56,0,15,0,2188
"23009966100",1666,305,0,0,48,66,17,67,2169
"23009966200",1722,310,6,0,48,47,13,1,2147
"23009966300",3531,671,19,9,78,32,20,15,4375
"23009966400",1532,343,0,0,27,1,0,0,1903
"23009966500",2456,279,14,0,66,3,40,46,2904
"23009966600",2623,398,10,0,46,2,3,18,3100
"23009966700",4573,649,5,5,126,38,71,4,5471
"23009990000",0,0,0,0,0,0,0,0,0
"23011010100",3935,651,48,0,159,0,122,138,5053
"23011010200",3421,557,69,0,78,12,0,0,4137
"23011010300",2161,781,33,0,14,153,27,0,3169
"23011010400",1443,642,0,0,113,29,40,28,2295
"23011010500",3323,432,0,0,183,19,43,21,4021
"23011010600",6087,824,8,0,103,0,54,0,7076
"23011010700",1994,217,0,0,138,16,10,0,2375
"23011010801",2323,230,5,0,13,4,0,0,2575
"23011010802",5266,867,0,0,157,84,18,65,6457
"23011010900",911,461,0,0,21,0,0,0,1393
"23011011000",3604,437,25,0,195,33,153,16,4463
"23011012000",3119,290,0,0,162,0,0,0,3571
"23011013000",3564,428,0,0,84,0,73,15,4164
"23011014000",5508,343,0,0,96,21,126,41,6135
"23011014500",1961,169,0,0,63,0,0,0,2193
"23011015000",2337,158,0,11,61,0,0,0,2567
"23011015500",2813,513,5,0,29,9,14,0,3383
"23011016000",2781,275,0,0,52,0,38,0,3146
"23011017000",3691,407,0,0,31,22,60,0,4211
"23011018000",3680,520,15,0,58,10,10,0,4293
"23011019000",2339,224,0,0,9,0,10,18,2600
"23011020000",3738,361,61,0,74,54,55,0,4343
"23011020500",1550,251,0,0,32,0,27,0,1860
"23011021000",3052,349,0,11,0,0,22,11,3445
"23011022000",2282,373,0,0,33,8,12,0,2708
"23011023001",2868,562,0,18,93,26,23,0,3590
"23011023002",3540,434,23,0,103,0,0,0,4100
"23011024101",3028,780,0,0,205,39,120,0,4172
"23011024102",2867,1623,84,314,95,129,0,97,5209
"23011024200",4210,268,78,0,140,8,56,35,4795
"23011025000",5559,402,0,21,120,11,13,0,6126
"23013970200",4354,429,0,0,6,0,6,0,4795
"23013970300",5754,750,20,0,124,7,23,7,6685
"23013970400",5680,882,27,57,62,42,39,78,6867
"23013970500",2893,277,24,0,73,24,116,27,3434
"23013970600",1965,389,9,0,112,16,23,16,2530
"23013970700",3832,547,46,0,133,0,10,0,4568
"23013970800",2687,362,23,1,68,12,8,2,3163
"23013970900",2335,137,0,0,114,0,17,0,2603
"23013971000",2199,225,0,0,22,4,5,4,2459
"23013971100",1585,158,2,0,68,24,6,3,1846
"23013990000",0,0,0,0,0,0,0,0,0
"23015975100",4636,545,10,0,46,6,40,0,5283
"23015975200",4029,911,0,13,58,24,0,86,5121
"23015975300",3056,448,0,0,63,3,28,7,3605
"23015975400",3178,301,23,6,60,3,6,0,3577
"23015975500",5114,559,3,13,364,28,4,8,6093
"23015975600",3359,251,26,0,25,0,66,0,3727
"23015975700",847,84,0,0,0,0,10,0,941
"23015975800",2639,446,0,0,17,0,44,0,3146
"23015976200",2272,247,7,0,35,3,0,5,2569
"23015990000",0,0,0,0,0,0,0,0,0
"23017965100",924,127,0,0,7,0,0,0,1058
"23017965400",2005,866,0,6,122,32,0,0,3031
"23017965500",1470,432,0,0,18,1,18,1,1940
"23017965600",2792,798,0,0,7,137,101,2,3837
"23017965700",2622,566,0,0,44,14,0,38,3284
"23017965800",3256,441,0,0,89,15,84,0,3885
"23017965900",2565,302,0,0,8,0,17,0,2892
"23017966000",2741,473,36,0,40,15,28,18,3351
"23017966100",1431,251,14,3,17,27,27,0,1770
"23017966200",3830,905,0,31,120,36,137,0,5059
"23017966300",2780,516,0,26,124,160,0,46,3652
"23017966400",5541,538,0,2,9,91,11,0,6192
"23017966500",4116,672,0,0,27,38,0,0,4853
"23017966600",2576,401,7,0,81,10,51,18,3144
"23017966700",2830,293,0,0,9,0,0,0,3132
"23017966800",2087,249,73,0,50,0,6,0,2465
"23017966900",2864,481,15,0,97,14,0,0,3471
"23019000200",2216,1149,39,10,169,7,77,19,3686
"23019000300",3213,368,106,74,294,30,49,48,4182
"23019000400",1737,599,0,43,91,9,128,48,2655
"23019000500",2187,996,26,27,66,5,41,0,3348
"23019000600",1566,666,14,0,0,0,0,0,2246
"23019000700",2294,276,66,9,20,0,7,0,2672
"23019000900",3736,2533,38,44,220,145,31,93,6840
"23019002000",6758,315,0,0,165,42,121,0,7401
"23019003000",3438,238,0,0,45,0,9,0,3730
"23019004100",1414,369,0,12,23,43,12,0,1873
"23019004200",2289,53,0,53,0,46,0,0,2441
"23019004300",4530,333,0,0,55,39,0,0,4957
"23019005000",1500,337,0,0,79,32,11,0,1959
"23019006100",1548,1098,12,0,84,62,0,0,2804
"23019006200",2455,253,0,0,135,0,58,0,2901
"23019006300",643,384,0,0,75,53,0,0,1155
"23019007100",2814,1770,42,26,165,119,5,1,4942
"23019007200",2243,385,4,0,144,40,0,0,2816
"23019008001",3849,482,25,0,73,17,32,3,4481
"23019009000",5614,484,63,54,144,0,68,0,6427
"23019010000",5014,325,7,0,132,0,0,0,5478
"23019011000",2535,173,0,0,51,10,0,0,2769
"23019012000",1339,85,4,0,55,4,13,0,1500
"23019012500",2142,259,0,0,63,21,10,0,2495
"23019013000",2443,728,30,0,16,37,0,0,3254
"23019013500",2220,283,0,4,19,4,8,11,2549
"23019014000",1685,222,0,0,0,0,9,26,1942
"23019015000",2885,775,0,15,44,46,11,22,3798
"23019015500",1708,430,0,4,8,54,6,49,2259
"23019018000",2487,313,0,0,55,0,0,0,2855
"23019020500",2034,408,17,0,117,9,30,16,2631
"23019021500",1585,205,0,0,21,12,0,0,1823
"23019022500",1447,311,12,1,31,25,3,3,1833
"23019024500",2164,349,14,14,53,23,18,0,2635
"23019025500",1448,366,0,0,21,18,14,7,1874
"23019026500",1599,225,2,0,46,6,2,0,1880
"23019027000",3677,1253,0,0,67,0,0,0,4997
"23019028000",1427,191,0,0,89,0,22,0,1729
"23019028500",1167,291,0,0,39,45,15,0,1557
"23019029000",1606,315,0,0,33,25,16,3,1998
"23019030000",3696,448,0,0,225,0,72,0,4441
"23019031000",1437,315,0,0,23,28,20,0,1823
"23019031100",4719,593,3,0,331,123,93,0,5862
"23019031200",3174,517,0,14,50,69,62,1,3887
"23019031300",5249,365,0,0,227,36,124,0,6001
"23019940000",45,40,2,0,471,257,26,48,889
"23021960301",1373,369,0,1,47,92,1,11,1894
"23021960302",528,16,0,0,0,4,0,0,548
"23021960400",1043,160,0,0,10,0,9,0,1222
"23021960500",1319,273,0,0,16,46,21,35,1710
"23021960600",2246,656,0,21,23,18,15,28,3007
"23021960700",3305,533,0,0,30,54,21,0,3943
"23021960800",2661,851,0,0,97,38,42,7,3696
"23021960900",850,243,0,0,77,0,3,0,1173
"23023970100",3051,260,7,0,33,14,26,0,3391
"23023970200",5379,376,61,0,102,35,98,4,6055
"23023970301",3911,149,18,0,354,32,74,23,4561
"23023970302",3546,458,0,0,157,22,45,0,4228
"23023970400",4135,320,43,0,26,22,3,15,4564
"23023970500",3670,1414,33,0,175,9,14,131,5446
"23023970600",2319,471,36,45,63,45,20,24,3023
"23023970700",3633,385,6,0,48,2,12,10,4096
"23023990000",0,0,0,0,0,0,0,0,0
"23025965301",784,132,0,0,23,0,18,0,957
"23025965302",1071,147,0,0,30,10,0,0,1258
"23025965600",1449,450,0,0,35,0,0,0,1934
"23025965700",2312,499,7,0,40,11,0,0,2869
"23025965800",2435,484,0,0,92,11,39,0,3061
"23025965900",1365,398,0,0,25,10,10,55,1863
"23025966000",3546,342,17,26,74,0,12,0,4017
"23025966100",2921,412,0,0,20,17,13,14,3397
"23025966200",1473,370,0,0,176,6,10,0,2035
"23025966300",1649,309,26,0,15,15,0,0,2014
"23025966400",1909,568,0,0,25,61,25,0,2588
"23025966500",3763,723,13,42,9,17,47,10,4624
"23025966600",3266,925,21,0,39,6,0,0,4257
"23025966700",3060,901,10,0,136,21,16,37,4181
"23025966800",5355,921,0,0,201,99,0,78,6654
"23025966900",2785,507,20,0,18,0,18,0,3348
"23025967000",1855,270,10,0,58,4,65,0,2262
"23027041000",3566,154,11,4,24,0,0,0,3759
"23027042000",4916,828,19,0,104,71,58,12,6008
"23027043000",4559,1690,11,12,165,60,12,50,6559
"23027044000",3937,361,0,0,50,43,43,3,4437
"23027045000",4926,799,6,4,77,37,59,24,5932
"23027046001",1917,182,7,0,25,24,10,6,2171
"23027046002",3768,964,3,7,75,35,67,5,4924
"23027047000",3457,935,0,27,57,118,11,5,4610
"23029955100",1431,478,40,15,443,431,17,62,2917
"23029955300",1148,224,0,0,30,4,8,0,1414
"23029955400",1254,134,3,0,7,2,7,1,1408
"23029955500",2357,539,0,3,9,0,23,12,2943
"23029955600",1137,201,0,0,479,317,7,0,2141
"23029955700",983,262,7,2,132,3,12,5,1406
"23029955800",1883,528,2,7,51,41,25,5,2542
"23029955900",2173,346,0,0,102,28,6,0,2655
"23029956100",1987,300,4,2,21,2,16,2,2334
"23029956200",2006,437,2,0,40,25,28,2,2540
"23029956300",1984,452,3,4,22,38,9,34,2546
"23029956400",2741,383,1,0,58,4,67,8,3262
"23029956500",2766,727,8,8,105,15,110,17,3756
"23029990000",0,0,0,0,0,0,0,0,0
"23031005100",4518,250,0,0,263,0,102,0,5133
"23031005200",3285,219,121,0,207,113,38,0,3983
"23031005300",5246,1264,49,0,354,24,298,0,7235
"23031005400",2271,251,0,32,22,0,6,0,2582
"23031006101",4523,291,47,30,153,0,61,9,5114
"23031006102",2594,743,36,50,153,31,55,32,3694
"23031020000",6735,857,195,0,235,0,211,0,8233
"23031021000",3903,405,0,0,25,0,31,0,4364
"23031022000",3288,389,0,0,15,0,46,34,3772
"23031022500",2343,646,0,0,71,41,9,0,3110
"23031023000",2367,415,73,0,50,0,0,0,2905
"23031023500",5762,565,11,0,141,135,56,47,6717
"23031024000",6711,633,45,0,327,0,43,0,7759
"23031024500",5705,441,0,0,175,0,143,0,6464
"23031025100",3433,200,6,0,19,0,20,10,3688
"23031025201",3764,782,0,0,360,0,56,15,4977
"23031025202",4901,2104,0,16,218,285,0,298,7822
"23031025300",2719,112,0,8,25,0,13,0,2877
"23031025400",1070,142,2,8,23,0,0,0,1245
"23031026000",3473,251,98,52,165,1,59,0,4099
"23031027000",3306,96,0,0,67,0,48,0,3517
"23031028001",3185,102,22,0,8,0,4,0,3321
"23031028002",7169,265,0,0,56,40,16,0,7546
"23031029000",2422,340,2,6,15,2,5,12,2804
"23031030100",3365,765,0,0,203,54,21,0,4408
"23031030201",2290,588,43,0,96,94,58,0,3169
"23031030202",4011,1334,0,0,67,37,129,48,5626
"23031030203",3506,430,17,0,110,42,57,0,4162
"23031030300",3087,273,0,0,89,8,42,0,3499
"23031031000",5349,626,9,0,0,0,0,0,5984
"23031032000",6457,518,36,8,285,30,166,10,7510
"23031033000",4119,280,20,6,76,0,84,0,4585
"23031034001",5441,269,0,0,88,0,0,0,5798
"23031034002",4748,283,29,0,11,0,36,0,5107
"23031035000",6487,456,11,0,258,60,7,23,7302
"23031036001",6595,525,0,0,93,0,60,0,7273
"23031036002",4982,319,0,2,97,48,0,0,5448
"23031037000",5515,477,31,0,158,0,115,0,6296
"23031038001",5650,404,41,1,123,0,201,0,6420
"23031038002",2819,133,38,0,192,0,9,0,3191
"23031990100",0,0,0,0,0,0,0,0,0
"24001000100",3207,207,79,0,47,30,27,0,3597
"24001000200",2435,364,0,1,15,25,64,25,2929
"24001000300",1987,457,106,14,19,62,0,0,2645
"24001000400",2263,339,234,33,33,0,8,0,2910
"24001000500",973,944,25,195,17,154,0,20,2328
"24001000600",2277,325,6,7,57,6,12,6,2696
"24001000700",2182,867,113,158,27,49,0,61,3457
"24001000800",1375,657,90,9,76,120,74,31,2432
"24001001000",2038,366,85,24,46,0,53,0,2612
"24001001100",1225,131,37,33,27,8,0,0,1461
"24001001200",2324,214,167,23,176,0,0,0,2904
"24001001300",1691,336,0,0,13,0,0,0,2040
"24001001401",3655,291,25,0,76,21,23,0,4091
"24001001402",1124,215,68,0,30,3,5,3,1448
"24001001502",1643,197,0,8,37,0,56,24,1965
"24001001503",1727,126,28,4,38,0,26,0,1949
"24001001600",1407,208,14,0,7,3,0,0,1639
"24001001700",3133,1149,87,0,129,27,0,0,4525
"24001001800",2184,946,15,253,90,58,9,20,3575
"24001001900",2498,287,8,0,69,5,0,0,2867
"24001002000",5223,548,0,1,38,35,93,0,5938
"24001002100",2999,436,46,0,32,10,12,0,3535
"24001002200",2942,500,0,0,27,0,25,1,3495
"24003701101",3774,163,38,0,82,0,214,0,4271
"24003701102",6445,406,49,91,489,191,304,157,8132
"24003701200",7786,213,154,0,379,0,178,0,8710
"24003701300",6684,132,404,122,245,20,91,0,7698
"24003701400",3061,32,402,27,58,0,102,0,3682
"24003702100",6097,287,85,0,110,0,168,0,6747
"24003702204",3659,93,162,0,231,27,236,0,4408
"24003702205",4489,77,523,60,298,25,123,0,5595
"24003702206",4626,83,785,0,778,53,398,11,6734
"24003702208",4915,80,1490,0,785,53,375,21,7719
"24003702209",3740,252,262,39,297,19,253,0,4862
"24003702300",5435,89,52,0,121,0,77,18,5792
"24003702402",5474,92,194,3,760,0,618,0,7141
"24003702500",2601,83,2073,650,651,166,661,291,7176
"24003702601",4347,47,611,373,194,0,293,0,5865
"24003702602",4279,166,636,32,499,0,295,0,5907
"24003702701",4268,185,365,0,219,36,237,12,5322
"24003702702",3245,80,213,0,167,0,53,0,3758
"24003706101",2531,103,354,127,62,54,128,62,3421
"24003706301",2898,119,744,89,288,0,229,14,4381
"24003706302",2856,119,110,37,185,11,208,0,3526
"24003706401",3064,361,1006,77,2649,75,2936,143,10311
"24003706402",1698,69,494,347,109,0,205,5,2927
"24003706500",3524,206,1123,171,447,147,1020,273,6911
"24003706600",3912,367,739,335,50,0,324,286,6013
"24003706700",318,4,41,0,249,10,218,0,840
"24003707001",5391,270,820,166,51,0,111,111,6920
"24003707002",4006,294,183,2,302,32,350,1,5170
"24003708001",3500,123,103,23,102,20,53,0,3924
"24003708004",3850,508,796,113,374,124,356,76,6197
"24003730100",6161,238,852,0,642,43,399,42,8377
"24003730203",3286,498,1007,179,611,142,689,185,6597
"24003730204",3442,221,1625,287,474,6,314,36,6405
"24003730300",2130,390,217,116,356,0,415,0,3624
"24003730401",3096,193,692,249,531,0,173,61,4995
"24003730402",3049,439,1440,275,812,339,159,67,6580
"24003730502",3784,130,1017,270,624,26,173,41,6065
"24003730504",3928,418,1963,82,946,92,399,135,7963
"24003730505",1894,90,1844,109,949,15,773,0,5674
"24003730506",1241,235,1858,35,315,158,212,57,4111
"24003730601",6299,70,0,0,570,0,324,0,7263
"24003730603",2370,136,121,2,313,0,58,1,3001
"24003730604",5794,163,344,18,324,19,37,0,6699
"24003730700",6522,58,309,0,460,0,243,0,7592
"24003730800",2315,89,3,0,55,11,34,0,2507
"24003730901",1971,18,324,7,49,9,41,0,2419
"24003730902",3764,68,85,0,139,10,243,60,4369
"24003731002",2751,121,300,11,191,16,270,89,3749
"24003731003",3802,53,73,0,241,0,219,10,4398
"24003731004",3839,152,134,0,345,0,292,0,4762
"24003731102",6992,197,187,0,378,65,357,46,8222
"24003731103",3861,278,338,36,219,157,21,119,5029
"24003731104",3968,15,242,0,549,0,238,0,5012
"24003731105",2977,85,30,2,203,86,139,1,3523
"24003731201",5898,141,120,0,298,0,73,0,6530
"24003731202",6587,232,84,2,49,6,109,1,7070
"24003731203",5956,378,471,36,526,0,114,45,7526
"24003731204",5201,339,268,6,251,0,267,0,6332
"24003731303",6458,133,185,0,234,0,0,0,7010
"24003731306",5446,297,236,0,190,25,158,0,6352
"24003731307",5596,160,337,3,257,36,193,3,6585
"24003731308",3149,171,90,1,105,0,7,0,3523
"24003731309",5112,152,277,175,123,40,103,0,5982
"24003731310",4426,149,293,0,258,0,287,0,5413
"24003731311",6583,210,378,32,1047,112,366,19,8747
"24003740102",4098,352,1604,85,1773,37,458,0,8407
"24003740103",4258,247,2335,242,1269,47,815,0,9213
"24003740104",2707,119,2938,593,914,528,486,127,8412
"24003740105",518,39,2244,251,288,168,305,11,3824
"24003740201",3481,172,2417,56,754,85,127,0,7092
"24003740203",4216,158,677,20,595,40,403,17,6126
"24003740303",2945,271,426,38,673,15,322,43,4733
"24003740304",2793,144,715,10,435,23,223,5,4348
"24003740305",3397,176,5499,476,1726,46,665,126,12111
"24003740400",0,0,0,0,0,0,0,0,0
"24003740500",3107,31,5436,213,1335,22,528,0,10672
"24003740601",2658,150,892,0,563,9,568,98,4938
"24003740602",2206,199,795,94,407,4,621,0,4326
"24003740603",505,46,194,0,56,0,125,0,926
"24003740701",3606,111,840,110,242,68,142,0,5119
"24003740702",7315,313,1342,64,1267,38,488,0,10827
"24003740800",3471,143,378,1,388,44,315,0,4740
"24003740900",5348,111,1154,42,953,0,715,0,8323
"24003741000",1855,13,184,0,251,12,68,0,2383
"24003750101",2456,352,232,459,515,85,146,14,4259
"24003750102",1686,259,265,88,232,71,15,5,2621
"24003750201",1561,222,807,112,128,72,142,0,3044
"24003750202",2370,196,225,5,193,2,173,2,3166
"24003750203",1042,42,144,0,197,0,59,0,1484
"24003750300",2134,248,38,5,99,13,0,0,2537
"24003750400",3694,149,33,25,350,19,74,0,4344
"24003750801",4960,94,454,0,622,0,224,0,6354
"24003750803",3008,360,2471,69,1894,264,2277,84,10427
"24003750804",2623,227,534,69,430,286,275,0,4444
"24003750900",2419,86,177,1,248,73,430,35,3469
"24003751000",3051,259,331,0,231,6,397,0,4275
"24003751102",2029,188,1066,99,220,8,125,62,3797
"24003751103",4406,218,250,293,212,12,229,0,5620
"24003751200",3342,327,222,32,118,0,74,0,4115
"24003751400",2624,221,551,19,496,21,104,21,4057
"24003751500",3252,109,2240,152,877,0,1508,10,8148
"24003751600",4349,159,140,58,151,0,15,0,4872
"24003751700",2200,34,215,10,155,6,55,6,2681
"24003980000",4,0,0,0,10,0,10,0,24
"24003990000",0,0,0,0,0,0,0,0,0
"24005400100",3073,173,614,101,456,0,51,0,4468
"24005400200",2051,84,118,150,101,7,134,14,2659
"24005400400",4610,327,245,18,272,17,154,17,5660
"24005400500",2349,52,31,14,42,0,29,21,2538
"24005400600",1711,121,353,134,319,33,0,0,2671
"24005400701",1656,57,694,7,464,13,234,2,3127
"24005400702",1160,24,463,30,182,2,118,0,1979
"24005400800",1418,98,663,108,353,0,233,56,2929
"24005400900",1438,174,335,140,115,9,445,121,2777
"24005401000",1759,20,420,44,75,0,45,0,2363
"24005401101",784,88,4790,323,388,74,0,0,6447
"24005401102",160,24,722,60,104,30,30,1,1131
"24005401200",650,16,2155,158,183,8,111,8,3289
"24005401301",771,83,2414,177,122,13,88,0,3668
"24005401302",465,22,1751,191,146,34,59,0,2668
"24005401400",1478,50,1,0,111,0,40,0,1680
"24005401503",5568,230,122,51,772,13,329,54,7139
"24005401504",2553,289,2626,70,990,107,167,0,6802
"24005401505",2060,134,1743,67,338,61,825,0,5228
"24005401506",724,28,3235,75,839,209,46,83,5239
"24005401507",815,78,2469,289,1513,357,389,92,6002
"24005402201",1763,99,1287,440,139,11,51,11,3801
"24005402202",921,0,457,3,199,0,65,0,1645
"24005402302",288,20,4452,209,172,57,94,0,5292
"24005402303",709,179,5757,275,57,140,673,112,7902
"24005402304",224,43,3417,342,7,4,108,17,4162
"24005402305",450,30,1279,299,15,1,85,0,2159
"24005402306",272,51,2747,325,237,46,105,44,3827
"24005402307",864,13,3369,1082,203,0,315,0,5846
"24005402403",150,9,1801,146,19,26,81,0,2232
"24005402404",316,47,4417,461,90,0,78,0,5409
"24005402405",595,45,2041,159,130,0,245,24,3239
"24005402406",325,7,4861,687,478,61,343,37,6799
"24005402407",491,51,864,16,32,67,28,0,1549
"24005402503",547,39,3189,916,296,43,134,9,5173
"24005402504",613,10,3044,333,190,0,98,0,4288
"24005402505",131,166,2749,156,29,2,0,1,3234
"24005402506",539,33,3082,166,191,11,56,0,4078
"24005402509",2293,92,5466,44,932,27,383,0,9237
"24005402602",332,27,1376,154,81,33,65,21,2089
"24005402603",1142,123,4528,169,139,0,124,0,6225
"24005402604",760,121,4011,577,124,0,246,28,5867
"24005403100",490,23,1587,64,212,13,169,0,2558
"24005403201",390,69,2231,161,143,0,233,16,3243
"24005403202",141,0,1597,107,77,77,0,0,1999
"24005403300",1028,49,1067,0,214,0,91,0,2449
"24005403401",1628,94,1041,116,199,13,220,3,3314
"24005403402",1840,459,1620,207,294,45,341,37,4843
"24005403500",4177,182,95,73,743,78,30,0,5378
"24005403601",4060,144,142,12,365,0,19,0,4742
"24005403602",3772,157,606,351,771,27,147,38,5869
"24005403701",4626,228,1276,449,387,64,60,0,7090
"24005403702",3064,70,709,107,341,0,87,0,4378
"24005403801",1413,65,18,0,127,0,19,0,1642
"24005403802",2513,117,66,1,53,0,10,0,2760
"24005403803",2957,79,110,0,212,13,28,0,3399
"24005404101",2355,25,1774,374,462,0,150,0,5140
"24005404102",2345,340,2193,71,557,164,345,0,6015
"24005404201",2388,181,2154,421,1091,136,623,35,7029
"24005404202",1836,203,4053,321,1093,142,744,249,8641
"24005404402",4501,62,738,60,546,0,88,0,5995
"24005404403",2128,310,1457,548,408,445,611,206,6113
"24005404404",2824,166,891,240,496,59,168,75,4919
"24005404501",4278,358,1409,216,671,196,661,99,7888
"24005404502",2152,144,662,385,348,86,343,0,4120
"24005404600",2367,103,55,12,36,0,118,24,2715
"24005404800",1658,15,264,0,94,0,61,0,2092
"24005404900",3901,360,209,17,299,0,99,0,4885
"24005405000",4037,241,96,9,142,0,14,101,4640
"24005406000",5290,115,74,1,65,0,126,0,5671
"24005407001",2842,117,186,0,110,0,38,0,3293
"24005407002",5577,87,21,19,355,18,307,0,6384
"24005408100",4568,137,543,0,561,0,200,0,6009
"24005408200",1881,0,99,0,82,17,37,0,2116
"24005408302",2359,69,25,0,473,40,17,0,2983
"24005408303",3012,57,144,0,286,0,82,0,3581
"24005408304",4123,133,173,0,407,34,129,0,4999
"24005408400",510,33,49,0,69,38,38,0,737
"24005408502",4182,70,181,1,482,0,203,0,5119
"24005408503",1793,359,333,27,478,166,379,16,3551
"24005408505",2883,231,200,86,591,35,253,108,4387
"24005408506",2040,270,1203,170,748,154,445,0,5030
"24005408507",2632,439,1327,0,1761,377,418,0,6954
"24005408601",3600,13,0,0,361,7,194,0,4175
"24005408602",1801,26,9,0,213,0,157,7,2213
"24005408702",2249,23,31,0,110,0,32,0,2445
"24005408703",5248,179,142,20,516,0,156,0,6261
"24005408704",4401,99,66,0,1274,0,133,0,5973
"24005408800",1852,128,9,17,302,66,98,8,2480
"24005408900",2373,78,273,48,114,0,0,0,2886
"24005410100",4981,259,58,17,130,0,91,0,5536
"24005410200",4327,200,32,124,287,0,74,0,5044
"24005411101",2083,80,87,0,60,0,37,0,2347
"24005411102",2937,48,27,2,7,12,10,15,3058
"24005411201",3155,27,33,0,33,0,35,0,3283
"24005411202",3140,17,66,39,154,0,23,0,3439
"24005411302",2446,177,311,11,628,156,97,0,3826
"24005411303",4678,148,381,133,266,211,197,188,6202
"24005411306",3720,67,1022,0,702,87,0,0,5598
"24005411307",2258,111,491,1,944,39,116,0,3960
"24005411308",2705,33,250,49,346,0,18,0,3401
"24005411309",6476,203,733,0,1383,72,106,0,8973
"24005411404",3193,63,140,32,303,12,38,0,3781
"24005411406",3949,228,193,1,191,7,103,0,4672
"24005411407",6272,706,1146,104,887,39,106,0,9260
"24005411408",2208,131,391,14,650,6,208,11,3619
"24005411409",3875,103,453,234,587,42,214,62,5570
"24005411410",3593,41,259,70,798,35,74,0,4870
"24005420100",3044,274,83,29,128,0,48,14,3620
"24005420200",1742,197,110,9,206,0,105,13,2382
"24005420301",1823,203,124,295,256,37,12,0,2750
"24005420302",2333,202,70,0,99,0,186,40,2930
"24005420303",1172,90,5,0,18,0,4,0,1289
"24005420401",4156,367,810,0,682,23,0,23,6061
"24005420402",1731,152,15,49,228,35,94,9,2313
"24005420500",2245,317,57,30,523,0,392,10,3574
"24005420600",3054,791,226,37,70,70,182,70,4500
"24005420701",2173,396,202,0,759,87,139,0,3756
"24005420702",1500,192,93,0,149,78,150,7,2169
"24005420800",2420,348,328,0,236,118,155,103,3708
"24005420900",2264,314,134,193,142,159,125,0,3331
"24005421000",1168,400,138,37,67,58,18,0,1886
"24005421101",1946,256,261,10,368,51,219,0,3111
"24005421102",1695,210,131,0,81,17,63,17,2214
"24005421200",1431,120,75,14,33,0,15,0,1688
"24005421300",431,107,1549,487,195,29,20,0,2818
"24005430101",1585,280,975,417,708,32,963,109,5069
"24005430104",2036,359,184,0,287,21,216,156,3259
"24005430200",1561,266,526,248,228,41,79,0,2949
"24005430300",2963,277,1055,1174,181,169,619,67,6505
"24005430400",3413,337,183,348,163,41,342,120,4947
"24005430600",1927,109,98,45,109,5,37,7,2337
"24005430700",4234,108,250,51,302,66,111,0,5122
"24005430800",2581,214,218,1,395,40,10,13,3472
"24005430900",2438,164,1358,1,1402,465,235,0,6063
"24005440100",3682,359,208,1,372,84,111,10,4827
"24005440200",1686,154,341,78,130,0,10,0,2399
"24005440300",1056,109,495,98,333,8,111,22,2232
"24005440400",3296,231,1132,77,530,0,281,0,5547
"24005440500",2450,63,113,0,371,44,102,9,3152
"24005440600",1474,46,398,0,275,14,23,0,2230
"24005440701",1830,441,2724,390,1118,56,652,173,7384
"24005440702",3231,60,910,116,762,11,313,0,5403
"24005440800",1564,51,841,21,678,52,58,0,3265
"24005440900",1221,266,1568,279,301,18,73,60,3786
"24005441000",784,13,1995,451,86,68,20,55,3472
"24005441101",1356,51,556,71,61,0,95,0,2190
"24005441102",2707,263,1006,283,483,101,342,80,5265
"24005450100",3485,258,203,4,90,0,121,15,4176
"24005450200",2778,237,151,0,105,6,53,0,3330
"24005450300",2568,221,155,61,225,12,36,0,3278
"24005450400",1638,247,23,0,150,0,46,0,2104
"24005450501",2623,431,346,189,323,77,118,6,4113
"24005450503",1573,307,2510,339,619,51,799,49,6247
"24005450504",1921,178,2332,505,250,80,225,11,5502
"24005450800",1966,656,630,275,217,45,139,236,4164
"24005450900",3159,226,430,43,38,0,9,0,3905
"24005451000",1531,113,51,5,17,0,34,0,1751
"24005451100",929,80,850,37,135,0,93,0,2124
"24005451200",3119,193,316,0,160,33,105,14,3940
"24005451300",2201,389,557,69,153,14,97,114,3594
"24005451401",1221,189,1581,183,568,12,246,0,4000
"24005451402",2995,1201,1380,662,121,40,665,488,7552
"24005451500",2438,90,1158,120,299,2,108,19,4234
"24005451600",1798,171,59,0,114,21,26,2,2191
"24005451701",2174,170,393,23,10,0,10,54,2834
"24005451702",1916,44,0,0,21,7,0,0,1988
"24005451801",3785,332,742,155,139,7,61,30,5251
"24005451802",3406,185,36,6,178,0,26,0,3837
"24005451803",3301,261,353,49,110,98,102,34,4308
"24005451900",2232,146,9,0,20,13,0,0,2420
"24005452000",1943,328,100,21,0,0,29,0,2421
"24005452100",2641,407,256,0,16,74,153,0,3547
"24005452300",2070,595,291,0,110,33,287,252,3638
"24005452400",2759,237,193,20,129,12,0,0,3350
"24005452500",2595,431,116,0,293,35,119,53,3642
"24005490100",3631,209,86,5,161,0,141,10,4243
"24005490200",2391,86,80,14,253,1,47,2,2874
"24005490301",3139,1129,528,50,312,259,327,126,5870
"24005490302",1873,135,161,44,95,25,26,0,2359
"24005490400",1447,48,8,4,137,0,27,0,1671
"24005490500",3331,107,0,0,210,0,44,0,3692
"24005490601",1928,0,1,3,215,0,109,0,2256
"24005490602",2362,260,30,0,249,65,228,0,3194
"24005490603",1893,51,24,24,153,6,20,5,2176
"24005490605",33,269,0,20,0,39,0,6,367
"24005490701",1326,48,9,3,17,0,0,0,1403
"24005490703",2450,112,291,50,256,29,128,0,3316
"24005490800",2626,399,55,30,340,60,25,0,3535
"24005490900",2714,561,520,85,340,149,155,8,4532
"24005491000",1893,12,83,22,170,0,59,0,2239
"24005491100",2672,136,610,143,378,0,255,17,4211
"24005491201",1322,128,167,13,213,0,52,0,1895
"24005491202",1359,16,221,99,97,23,21,0,1836
"24005491300",1365,251,495,484,538,226,112,33,3504
"24005491401",702,62,3997,781,42,0,44,0,5628
"24005491402",908,133,1809,351,148,33,135,0,3517
"24005491500",1963,394,552,102,203,281,111,375,3981
"24005491600",1610,42,614,56,266,15,35,0,2638
"24005491701",2722,181,722,67,317,58,552,11,4630
"24005491900",1487,191,55,27,176,0,96,0,2032
"24005492001",1185,36,143,0,134,33,77,0,1608
"24005492002",2682,230,560,118,291,38,327,38,4284
"24005492101",2623,259,449,50,117,14,201,1,3714
"24005492102",1858,129,186,2,141,0,7,0,2323
"24005492200",3820,63,686,120,98,10,91,45,4933
"24005492300",3241,277,473,5,75,10,144,10,4235
"24005492401",363,137,2860,125,381,125,34,54,4079
"24005492402",2237,75,3236,409,699,8,218,46,6928
"24005492500",48,76,8,9,0,22,0,0,163
"24005492600",2053,115,753,144,490,96,73,0,3724
"24005980000",0,0,0,0,0,0,0,0,0
"24005980100",0,0,0,0,0,0,0,0,0
"24005980200",0,0,0,0,0,0,0,0,0
"24009860101",2422,193,378,11,272,0,56,0,3332
"24009860102",2224,41,231,0,83,0,82,11,2672
"24009860200",5087,99,918,36,135,7,175,9,6466
"24009860300",3260,56,384,50,177,22,0,24,3973
"24009860401",7509,655,570,63,822,184,509,0,10312
"24009860402",2755,183,321,0,181,0,12,0,3452
"24009860501",4754,84,694,11,235,0,22,0,5800
"24009860502",2542,230,262,13,174,0,195,0,3416
"24009860600",6262,124,931,31,501,0,87,0,7936
"24009860701",1998,152,270,11,156,1,92,0,2680
"24009860702",1730,266,725,336,196,16,15,162,3446
"24009860703",2334,41,1177,131,140,47,74,7,3951
"24009860801",5517,134,835,134,241,35,183,0,7079
"24009860802",4122,203,399,63,169,13,233,13,5215
"24009860900",4864,207,955,354,157,3,280,3,6823
"24009861001",1099,16,50,0,13,0,18,0,1196
"24009861003",4608,401,537,109,295,9,191,0,6150
"24009861004",5992,344,667,19,504,32,230,115,7903
"24009990100",0,0,0,0,0,0,0,0,0
"24011955000",1784,961,134,0,462,66,550,524,4481
"24011955100",4555,345,323,12,132,10,50,24,5451
"24011955201",2686,412,358,154,167,17,110,17,3921
"24011955202",1848,105,283,47,65,52,17,8,2425
"24011955301",2865,229,331,0,24,0,133,4,3586
"24011955302",1554,324,462,232,277,36,274,42,3201
"24011955400",1722,199,214,59,55,10,7,0,2266
"24011955500",3254,409,461,15,100,20,0,17,4276
"24011955600",2312,460,731,674,79,80,24,0,4360
"24013501001",3894,287,229,0,251,13,106,42,4822
"24013501002",4287,443,82,62,65,157,66,0,5162
"24013502000",3778,127,84,0,116,0,53,0,4158
"24013503000",4816,346,115,0,40,0,11,0,5328
"24013504100",4487,211,208,0,223,0,176,0,5305
"24013504201",5217,238,63,0,610,0,194,0,6322
"24013504202",5524,71,147,18,34,15,257,15,6081
"24013505101",4054,32,240,0,120,0,84,0,4530
"24013505102",4907,130,34,7,276,0,45,0,5399
"24013505203",2597,87,51,8,148,16,71,0,2978
"24013505205",3062,0,53,0,262,0,195,0,3572
"24013505206",3261,29,21,0,154,0,111,0,3576
"24013505207",3067,93,140,0,328,23,102,0,3753
"24013505208",5242,241,120,28,226,16,139,16,6028
"24013506101",3896,45,174,0,332,52,226,0,4725
"24013506102",3883,36,22,13,22,1,80,2,4059
"24013506200",4438,203,85,2,118,0,0,0,4846
"24013507500",2735,165,175,56,178,0,72,58,3439
"24013507601",3869,809,90,69,185,85,272,149,5528
"24013507602",3452,162,106,92,100,0,27,3,3942
"24013507702",2916,243,387,18,193,28,187,8,3980
"24013507703",2663,191,26,16,0,0,0,0,2896
"24013507704",5164,337,261,30,122,147,209,33,6303
"24013507801",4525,688,272,108,153,66,334,255,6401
"24013507802",4079,152,35,34,32,77,16,0,4425
"24013508101",4187,163,44,0,111,0,44,0,4549
"24013508102",2870,163,45,17,89,0,70,7,3261
"24013508200",6493,329,25,0,152,0,125,112,7236
"24013509001",3901,97,0,25,43,0,62,12,4140
"24013509002",2487,244,0,0,5,0,27,0,2763
"24013510000",1130,72,0,0,13,0,6,0,1221
"24013511000",3128,130,60,0,116,6,40,0,3480
"24013512000",1133,127,133,30,28,15,11,15,1492
"24013513001",4118,243,48,0,162,0,76,59,4706
"24013513002",4758,232,91,0,330,32,27,61,5531
"24013514100",3410,139,43,2,94,1,12,0,3701
"24013514201",4704,212,64,6,125,0,148,0,5259
"24013514202",2837,142,138,0,232,0,46,0,3395
"24015030100",3973,696,155,2,129,54,39,11,5059
"24015030200",4356,150,134,14,29,0,29,0,4712
"24015030400",2833,1081,406,237,69,8,34,267,4935
"24015030501",3399,171,83,10,39,20,1,0,3723
"24015030503",3981,558,262,0,364,63,341,131,5700
"24015030505",2745,78,362,140,261,0,392,0,3978
"24015030506",5587,321,637,10,446,62,107,0,7170
"24015030601",3624,122,26,0,52,0,317,0,4141
"24015030602",3833,247,1119,11,216,0,82,39,5547
"24015030700",4667,298,88,0,102,8,32,0,5195
"24015030903",3897,573,855,137,85,81,90,0,5718
"24015030904",6160,214,78,0,214,0,0,18,6684
"24015030905",2411,501,55,12,38,17,46,0,3080
"24015030906",7246,1369,567,25,266,35,214,77,9799
"24015031201",5558,712,321,10,112,33,340,4,7090
"24015031202",3368,782,506,76,460,45,289,443,5969
"24015031301",3294,233,54,51,149,0,208,43,4032
"24015031302",6318,580,13,1,229,12,95,47,7295
"24015031400",3300,752,32,0,80,0,35,0,4199
"24017850101",1929,27,3303,234,342,27,234,0,6096
"24017850102",1392,134,827,45,151,67,30,0,2646
"24017850201",690,0,115,0,120,0,87,0,1012
"24017850202",2040,201,1992,185,379,66,63,11,4937
"24017850300",1335,28,642,158,119,15,0,15,2312
"24017850400",2136,243,1117,200,0,15,12,0,3723
"24017850500",2178,30,263,89,152,0,12,0,2724
"24017850600",2481,33,1321,35,428,17,53,0,4368
"24017850706",1749,68,2805,6,436,516,215,31,5826
"24017850708",1945,61,2714,205,450,24,88,13,5500
"24017850709",1350,61,4893,316,606,39,408,44,7717
"24017850710",1775,76,2921,255,330,10,328,10,5705
"24017850711",1224,88,2653,388,817,8,344,2,5524
"24017850712",2396,113,2597,86,259,10,127,0,5588
"24017850713",2879,179,3013,136,737,15,521,44,7524
"24017850801",2671,57,1548,176,375,13,63,0,4903
"24017850802",1856,151,1596,71,295,53,292,88,4402
"24017850901",1457,196,2597,871,629,0,226,48,6024
"24017850902",2471,361,1982,283,823,103,549,267,6839
"24017850904",1958,95,3526,118,763,0,267,0,6727
"24017850905",2183,117,1608,130,466,128,518,25,5175
"24017850906",1284,270,2208,682,220,173,44,34,4915
"24017851001",1881,166,325,3,76,0,54,0,2505
"24017851002",5607,252,1746,539,510,68,464,28,9214
"24017851100",2177,48,208,30,156,0,151,8,2778
"24017851200",3271,405,584,131,172,0,51,17,4631
"24017851301",3732,93,408,10,226,0,306,0,4775
"24017851302",3309,182,273,39,268,0,33,0,4104
"24017851400",6064,305,1714,218,721,33,257,40,9352
"24017851500",2324,61,4594,56,958,83,537,8,8621
"24017990000",0,0,0,0,0,0,0,0,0
"24019970100",1764,201,631,68,73,0,41,0,2778
"24019970200",2791,322,1065,409,172,122,69,76,5026
"24019970300",4009,294,382,66,164,0,136,67,5118
"24019970400",2045,484,314,254,230,26,228,8,3589
"24019970500",684,92,1360,1469,167,50,129,67,4018
"24019970600",1709,259,1834,698,187,100,102,30,4919
"24019970702",3473,189,91,36,85,1,65,32,3972
"24019970804",1864,80,45,20,48,19,105,57,2238
"24019970900",1243,142,182,7,97,9,78,0,1758
"24019990000",0,0,0,0,0,0,0,0,0
"24021740200",4264,23,204,56,188,25,153,13,4926
"24021750100",949,107,153,5,109,5,70,9,1407
"24021750200",1431,84,24,0,55,0,14,0,1608
"24021750300",718,194,355,192,44,22,123,46,1694
"24021750503",2656,405,1531,120,1161,0,1816,0,7689
"24021750504",2514,148,1230,588,1281,84,1442,18,7305
"24021750505",2778,638,561,119,1836,657,1816,1015,9420
"24021750506",2412,157,601,0,562,20,542,25,4319
"24021750600",1689,92,42,18,161,0,69,15,2086
"24021750701",3563,111,1124,50,501,31,596,27,6003
"24021750702",2071,191,597,176,437,65,441,68,4046
"24021750801",2099,305,303,67,82,69,61,84,3070
"24021750802",3249,51,333,107,301,23,279,0,4343
"24021750803",4702,144,810,32,444,80,817,42,7071
"24021751001",544,0,327,36,149,0,28,36,1120
"24021751002",3773,83,498,234,328,56,476,56,5504
"24021751003",3043,269,773,322,916,187,356,159,6025
"24021751004",2761,208,891,9,98,7,417,106,4497
"24021751201",3429,37,561,36,714,29,480,0,5286
"24021751202",3923,233,639,151,931,113,415,0,6405
"24021751203",1667,69,78,0,45,0,32,0,1891
"24021751301",2802,69,33,0,86,0,98,0,3088
"24021751302",2462,141,37,0,179,0,151,0,2970
"24021751600",2828,149,37,0,71,0,111,0,3196
"24021751701",2237,36,25,0,26,0,53,4,2381
"24021751702",3336,267,1,9,180,97,29,20,3939
"24021751801",3567,224,185,10,319,0,383,8,4696
"24021751802",3695,14,65,0,119,5,54,5,3957
"24021751901",4110,25,193,0,132,55,136,47,4698
"24021751902",4910,317,53,19,449,125,363,19,6255
"24021751903",5785,0,186,9,340,24,58,0,6402
"24021751904",2916,17,376,0,142,8,149,0,3608
"24021752001",4548,30,179,0,225,0,33,0,5015
"24021752101",3163,10,35,0,138,0,79,0,3425
"24021752102",4276,12,86,0,46,0,238,0,4658
"24021752201",2041,56,85,13,154,0,154,1,2504
"24021752202",2424,28,366,0,1133,0,176,0,4127
"24021752204",4284,193,393,12,1538,61,473,0,6954
"24021752301",2421,270,800,114,922,69,427,93,5116
"24021752302",3758,100,125,11,202,0,185,9,4390
"24021752303",2342,80,372,0,218,0,75,3,3090
"24021752501",4561,168,20,22,131,21,90,10,5023
"24021752502",2405,22,58,4,33,0,6,10,2538
"24021752601",3524,34,59,15,291,0,36,0,3959
"24021752602",2377,38,0,16,48,15,51,0,2545
"24021752603",3856,15,48,0,119,0,261,0,4299
"24021752801",1989,105,0,0,14,0,6,0,2114
"24021752802",3194,147,26,0,63,0,131,0,3561
"24021752900",2726,306,0,10,42,0,42,0,3126
"24021753001",4408,259,79,0,83,29,113,47,5018
"24021753002",2733,164,6,11,73,0,41,0,3028
"24021765100",2216,337,578,155,492,61,218,12,4069
"24021766800",3648,362,56,52,38,97,34,7,4294
"24021767500",2398,76,18,0,334,0,51,0,2877
"24021767600",3250,172,22,2,177,1,299,0,3923
"24021770700",3156,156,18,0,71,9,80,0,3490
"24021772200",1202,109,281,198,35,144,171,26,2166
"24021773500",3314,190,308,23,391,37,247,0,4510
"24021775302",3349,239,307,0,154,0,243,35,4327
"24021775400",2975,590,97,0,54,0,44,6,3766
"24021775600",3466,110,115,0,389,0,289,0,4369
"24023000100",3477,588,0,0,17,8,54,0,4144
"24023000200",3446,471,0,0,38,4,20,0,3979
"24023000300",2427,186,0,9,64,18,40,0,2744
"24023000400",2625,331,0,0,9,67,17,44,3093
"24023000500",3222,412,9,0,55,7,0,0,3705
"24023000600",5373,535,0,22,113,15,33,0,6091
"24023000700",4376,1192,3,0,60,32,1,3,5667
"24025301102",2630,339,269,27,339,91,108,0,3803
"24025301105",3634,61,169,39,145,60,159,0,4267
"24025301106",3559,100,91,11,156,22,27,18,3984
"24025301107",1928,182,587,1,337,22,161,1,3219
"24025301108",2507,59,402,56,329,0,64,0,3417
"24025301201",1825,189,79,0,0,0,24,0,2117
"24025301202",5051,451,440,0,940,9,131,0,7022
"24025301204",3375,86,293,91,232,0,124,0,4201
"24025301205",3079,162,468,0,360,0,642,0,4711
"24025301301",3059,317,1004,12,427,22,248,22,5111
"24025301302",2263,339,2500,1732,573,90,172,192,7861
"24025301401",5558,627,761,215,305,0,456,172,8094
"24025301402",1852,173,364,6,109,81,157,90,2832
"24025301601",3377,369,2290,368,473,1,840,39,7757
"24025301602",3656,499,2518,344,958,0,366,0,8341
"24025301702",4886,539,2493,227,585,140,537,216,9623
"24025301703",2930,270,1218,1,452,0,174,43,5088
"24025301704",2082,212,696,32,508,0,163,0,3693
"24025302100",1964,116,32,0,7,0,16,6,2141
"24025302200",1988,237,274,2,73,0,0,0,2574
"24025302400",1820,559,399,111,61,0,0,1,2951
"24025302801",2487,266,742,70,197,0,85,0,3847
"24025302802",2789,281,1271,190,273,112,348,83,5347
"24025302901",912,428,464,433,226,120,170,98,2851
"24025302902",2239,207,1469,19,466,144,250,0,4794
"24025303101",5065,249,284,56,219,0,114,0,5987
"24025303102",2787,10,66,10,258,0,164,0,3295
"24025303201",5034,180,252,0,175,24,39,0,5704
"24025303203",2925,103,75,0,142,0,132,0,3377
"24025303204",4310,30,82,0,314,41,145,0,4922
"24025303205",1491,50,7,0,0,0,31,0,1579
"24025303206",3140,35,21,73,0,0,6,0,3275
"24025303300",5681,80,0,0,57,16,66,0,5900
"24025303400",3912,28,55,18,100,0,111,0,4224
"24025303501",5236,229,282,13,307,64,76,0,6207
"24025303502",3313,85,182,3,172,0,60,0,3815
"24025303602",3360,110,25,0,204,11,31,0,3741
"24025303603",5535,384,266,0,578,0,247,0,7010
"24025303605",4569,347,503,0,310,82,112,149,6072
"24025303606",3205,10,49,0,113,0,164,0,3541
"24025303700",3416,151,23,2,162,0,99,0,3853
"24025303801",2001,354,155,52,29,0,19,72,2682
"24025303802",1107,164,59,4,58,0,33,0,1425
"24025303803",4376,174,152,20,372,0,106,27,5227
"24025303900",1899,67,92,0,141,0,11,18,2228
"24025304101",4046,154,33,0,26,0,94,0,4353
"24025304102",3413,93,110,0,49,0,0,0,3665
"24025304201",5806,222,18,1,68,0,110,2,6227
"24025304202",6235,395,148,202,139,0,114,0,7233
"24025305100",6381,474,167,3,95,11,3,11,7145
"24025305200",2106,361,44,2,120,0,0,0,2633
"24025305300",2115,71,28,0,114,0,82,0,2410
"24025306100",1906,432,724,333,202,114,132,95,3938
"24025306200",1674,209,178,101,94,12,14,84,2366
"24025306300",1674,114,302,0,333,21,67,0,2511
"24025306400",4947,200,1137,0,413,38,147,0,6882
"24025306500",916,112,632,15,457,25,117,0,2274
"24027601103",3714,77,765,3,1458,104,185,0,6306
"24027601104",3853,73,798,36,1170,0,249,0,6179
"24027601105",2562,7,374,11,1223,0,88,0,4265
"24027601107",1948,358,349,77,2032,106,897,26,5793
"24027601108",1843,53,964,43,910,48,66,0,3927
"24027601201",5199,301,1644,119,853,16,560,1,8693
"24027601203",931,88,1469,138,551,76,147,151,3551
"24027601204",3475,88,636,12,1027,117,645,0,6000
"24027602100",6018,31,375,1,1573,77,179,1,8255
"24027602201",2384,31,143,132,666,94,71,17,3538
"24027602202",4036,39,238,40,1024,40,248,0,5665
"24027602302",3509,133,1332,295,1559,16,336,16,7196
"24027602303",2164,22,334,0,1341,7,101,0,3969
"24027602304",3489,45,358,8,1149,0,134,0,5183
"24027602305",2904,10,184,0,694,0,91,0,3883
"24027602306",3693,89,573,22,1128,67,194,1,5767
"24027602600",2771,114,554,177,2882,280,828,5,7611
"24027602700",4008,57,374,16,747,27,260,28,5517
"24027602800",3272,104,452,12,1921,358,117,0,6236
"24027602900",1616,125,771,135,1539,263,152,29,4630
"24027603001",3792,36,233,1,1518,0,26,0,5606
"24027603003",3244,40,126,2,533,0,87,10,4042
"24027603004",5663,211,286,3,1127,121,157,0,7568
"24027604001",5646,77,39,5,268,4,228,4,6271
"24027604002",6770,93,224,4,844,18,90,16,8059
"24027605102",6271,403,649,94,1812,48,472,23,9772
"24027605103",4111,139,219,4,774,5,199,5,5456
"24027605104",3907,73,123,8,1014,0,25,10,5160
"24027605401",2710,321,1302,139,670,77,496,249,5964
"24027605402",3288,156,1740,266,1109,56,584,15,7214
"24027605502",2935,132,1290,170,808,124,246,3,5708
"24027605503",2624,612,2070,334,789,31,337,592,7389
"24027605504",1606,0,166,0,1033,0,85,0,2890
"24027605505",3574,128,505,11,1770,50,100,0,6138
"24027605601",3317,254,1386,537,1109,9,284,0,6896
"24027605602",4235,117,1353,26,1229,108,417,22,7507
"24027606601",1980,15,558,11,409,12,232,0,3217
"24027606603",3441,104,2357,223,1438,271,819,188,8841
"24027606604",2319,41,1225,38,468,114,429,19,4653
"24027606606",1839,85,1441,245,1020,78,259,17,4984
"24027606607",2591,19,1077,39,998,63,911,63,5761
"24027606701",2359,7,167,1,251,0,102,0,2887
"24027606704",3126,322,1934,209,1634,301,673,189,8388
"24027606705",1295,66,363,9,319,0,97,0,2149
"24027606706",2330,37,1089,30,1334,100,300,8,5228
"24027606707",1680,50,1109,576,468,38,280,18,4219
"24027606803",3501,140,1670,161,587,33,308,62,6462
"24027606804",2331,22,578,8,410,0,122,1,3472
"24027606805",2611,78,323,36,1134,7,119,1,4309
"24027606806",4317,101,751,13,1378,134,222,0,6916
"24027606901",2418,104,1571,66,1421,0,531,0,6111
"24027606904",1628,78,1781,12,1052,116,179,131,4977
"24027606905",3506,93,1403,418,1425,39,389,23,7296
"24027606906",2859,126,1947,90,895,0,550,0,6467
"24027606907",1590,12,2478,80,826,223,336,0,5545
"24029950100",3429,191,350,2,64,40,509,74,4659
"24029950200",3402,415,751,85,100,19,27,28,4827
"24029950300",2502,441,498,600,101,20,94,0,4256
"24029950400",2210,115,388,51,52,55,7,0,2878
"24029950500",2302,105,168,44,18,0,109,0,2746
"24029990000",0,0,0,0,0,0,0,0,0
"24031700101",3346,128,271,0,666,83,335,83,4912
"24031700103",3983,37,406,180,1158,24,432,7,6227
"24031700104",2624,54,1566,0,1313,141,1094,151,6943
"24031700105",3445,70,1648,0,1055,118,956,37,7329
"24031700204",1809,135,16,1,178,0,137,0,2276
"24031700205",5300,23,449,83,1350,87,631,15,7938
"24031700206",4810,76,227,93,570,0,444,0,6220
"24031700207",3684,307,566,116,756,177,824,191,6621
"24031700208",1967,11,118,0,107,12,80,0,2295
"24031700304",3185,53,1142,572,3111,70,1049,62,9244
"24031700306",3462,0,1089,77,2213,112,1062,0,8015
"24031700308",2882,45,1190,146,1272,109,899,0,6543
"24031700309",2812,320,1298,278,761,118,1217,183,6987
"24031700310",3333,112,1315,100,1079,23,1094,23,7079
"24031700311",4002,36,888,94,3189,30,886,1,9126
"24031700312",3245,57,552,0,1417,67,433,0,5771
"24031700400",1714,124,99,2,135,7,68,0,2149
"24031700500",5210,100,462,62,508,18,520,16,6896
"24031700604",5032,70,244,0,1484,0,429,0,7259
"24031700606",2794,37,21,4,1571,1,186,8,4622
"24031700607",3026,73,240,89,4250,101,222,24,8025
"24031700608",3201,252,123,16,2039,30,364,54,6079
"24031700610",1449,72,140,0,416,47,307,22,2453
"24031700611",2487,58,396,0,3555,62,881,26,7465
"24031700613",2806,50,626,160,2281,135,578,0,6636
"24031700614",2675,181,736,77,1186,33,1097,108,6093
"24031700615",2294,25,85,0,553,0,169,0,3126
"24031700616",2773,74,478,0,1177,11,399,0,4912
"24031700704",1505,162,180,38,1075,113,803,96,3972
"24031700706",1387,117,773,35,1482,94,1011,53,4952
"24031700710",3530,159,948,92,1812,78,1943,100,8662
"24031700711",3295,108,449,163,1611,222,1222,5,7075
"24031700713",2151,99,1243,63,1844,341,2217,308,8266
"24031700715",2212,55,1464,99,2386,96,1653,63,8028
"24031700716",3358,299,1169,159,2856,181,2012,316,10350
"24031700717",2708,74,1218,36,2245,168,3013,142,9604
"24031700718",2426,147,549,32,1053,64,254,21,4546
"24031700719",2641,694,1773,222,2787,1229,2089,1615,13050
"24031700720",1759,0,482,257,1187,22,1211,0,4918
"24031700721",1099,73,751,74,775,29,601,10,3412
"24031700722",1812,88,792,230,1099,126,810,35,4992
"24031700723",1599,416,595,69,394,108,294,292,3767
"24031700724",693,386,760,52,1099,507,1046,300,4843
"24031700810",2231,419,1246,105,1003,46,666,297,6013
"24031700811",2189,77,1270,88,1100,21,1575,67,6387
"24031700812",2556,107,462,97,768,82,1022,81,5175
"24031700813",2935,449,1131,177,1202,351,1447,577,8269
"24031700815",2826,111,2167,299,1843,240,1462,22,8970
"24031700816",2826,179,1449,358,3427,121,2066,50,10476
"24031700817",2626,238,532,160,1424,66,329,0,5375
"24031700818",2013,208,1957,694,1687,81,1469,42,8151
"24031700819",4013,156,1406,237,1168,239,1533,344,9096
"24031700820",816,236,854,226,704,115,509,170,3630
"24031700822",816,167,91,83,466,14,291,130,2058
"24031700823",2131,75,88,0,884,0,197,3,3378
"24031700824",2198,66,391,32,401,0,176,37,3301
"24031700826",4332,46,321,0,920,0,359,0,5978
"24031700828",1630,21,24,0,563,86,110,0,2434
"24031700829",1846,77,50,24,1442,21,445,0,3905
"24031700830",875,93,841,25,771,53,499,60,3217
"24031700832",1352,65,608,39,828,129,1016,21,4058
"24031700833",1522,144,702,33,1632,282,1232,9,5556
"24031700834",2234,175,987,216,1394,40,1384,120,6550
"24031700835",2120,144,717,5,1620,0,666,21,5293
"24031700901",1985,154,374,0,980,490,339,0,4322
"24031700902",2067,44,571,170,1116,21,1264,1,5254
"24031700903",921,56,195,112,508,32,400,44,2268
"24031700904",1015,76,311,25,1368,153,888,46,3882
"24031700905",2335,70,166,0,1586,50,264,0,4471
"24031701001",3448,422,486,0,1383,95,603,100,6537
"24031701002",2613,29,68,0,690,22,266,0,3688
"24031701004",3291,161,473,36,924,224,430,25,5564
"24031701005",2741,34,146,95,806,0,507,17,4346
"24031701006",3424,125,82,1,1387,0,370,22,5411
"24031701007",1830,19,384,11,810,27,72,2,3155
"24031701101",2856,102,272,42,1511,138,1289,184,6394
"24031701102",3842,293,330,247,1474,56,1819,215,8276
"24031701201",3485,374,456,0,1322,118,1171,207,7133
"24031701202",2464,70,85,10,133,5,401,0,3168
"24031701205",5385,100,115,86,984,21,291,19,7001
"24031701206",5402,106,174,3,1386,33,1019,35,8158
"24031701210",3168,11,121,7,600,15,221,11,4154
"24031701211",3423,219,683,177,1897,61,569,0,7029
"24031701212",1850,36,244,6,526,1,188,32,2883
"24031701213",5076,278,311,38,750,0,539,72,7064
"24031701214",2141,237,240,54,702,10,362,28,3774
"24031701215",3243,142,393,19,766,0,424,0,4987
"24031701216",2670,153,313,17,1409,47,255,18,4882
"24031701218",1353,112,195,18,587,43,303,0,2611
"24031701219",1348,159,240,194,1540,292,1043,193,5009
"24031701220",2214,44,340,31,1403,156,221,33,4442
"24031701221",2204,167,305,30,1535,84,73,38,4436
"24031701303",2937,45,326,0,378,0,143,16,3845
"24031701304",4383,97,760,0,868,0,704,0,6812
"24031701306",2706,89,40,1,219,0,83,0,3138
"24031701307",2212,9,457,63,1018,194,402,1,4356
"24031701308",2175,9,361,8,576,69,80,0,3278
"24031701312",4646,205,430,71,949,56,407,0,6764
"24031701313",2056,12,778,0,731,0,310,0,3887
"24031701314",1906,66,555,0,610,0,390,2,3529
"24031701315",3249,0,699,78,690,0,589,0,5305
"24031701316",4225,114,958,17,596,115,563,0,6588
"24031701317",3061,33,479,17,818,0,149,0,4557
"24031701407",2590,28,1636,10,1208,116,400,56,6044
"24031701408",3658,35,961,6,1725,0,484,17,6886
"24031701409",1933,36,815,28,1583,17,542,0,4954
"24031701410",1856,76,3355,140,1738,138,745,68,8116
"24031701414",2004,21,2981,340,1770,361,706,151,8334
"24031701415",2284,5,2368,416,2753,0,1293,0,9119
"24031701417",1040,38,2636,709,1332,0,375,0,6130
"24031701418",1070,8,1422,89,918,34,450,0,3991
"24031701420",3285,131,1566,166,1245,133,461,122,7109
"24031701421",162,54,1279,51,448,26,529,72,2621
"24031701422",229,17,2127,234,184,147,135,49,3122
"24031701423",548,0,2251,629,1159,192,462,52,5293
"24031701503",2295,6,2220,34,2484,26,1083,0,8148
"24031701505",2588,180,2260,575,774,109,510,98,7094
"24031701506",2184,234,1453,166,1122,29,512,68,5768
"24031701507",2264,54,998,66,1130,70,379,0,4961
"24031701508",219,103,2354,366,701,269,440,194,4646
"24031701509",1196,191,2395,442,1736,226,1553,304,8043
"24031701601",147,0,943,121,859,182,786,62,3100
"24031701602",914,136,1091,293,4049,606,3600,710,11399
"24031701701",2126,64,554,43,383,40,392,44,3646
"24031701702",955,108,531,104,287,141,468,142,2736
"24031701703",1403,47,1230,122,766,1,720,10,4299
"24031701704",1659,21,878,15,440,0,514,0,3527
"24031701800",2256,66,1736,468,356,35,249,11,5177
"24031701900",1211,137,603,36,955,198,1118,137,4395
"24031702000",1174,185,1082,80,1660,1219,2171,1086,8657
"24031702101",919,99,1670,191,2288,543,1930,440,8080
"24031702102",2565,47,97,0,317,10,128,0,3164
"24031702200",2812,114,547,0,1217,0,977,14,5681
"24031702301",1663,257,832,114,576,402,1227,576,5647
"24031702302",2007,113,939,44,1044,65,959,76,5247
"24031702401",1511,62,652,10,377,0,361,0,2973
"24031702402",2079,105,1187,395,545,52,502,38,4903
"24031702500",1966,284,2066,364,730,195,156,58,5819
"24031702601",1891,213,1502,97,624,138,387,129,4981
"24031702602",2050,427,1079,255,760,82,685,0,5338
"24031702700",3167,396,1468,203,1727,129,1323,378,8791
"24031702800",2866,124,1000,96,672,0,485,37,5280
"24031702900",3871,41,829,70,657,17,349,27,5861
"24031703000",1360,25,320,5,206,22,373,0,2311
"24031703100",2785,68,662,0,852,59,1156,19,5601
"24031703201",4343,146,654,98,2111,81,1880,46,9359
"24031703202",4359,85,342,25,1057,31,837,31,6767
"24031703206",1840,115,658,106,1001,3,693,23,4439
"24031703207",1601,133,947,281,2817,658,3013,638,10088
"24031703208",3735,189,589,4,443,37,170,0,5167
"24031703209",2693,188,1375,0,1440,666,949,634,7945
"24031703210",1548,76,593,3,913,539,598,498,4768
"24031703212",2570,100,2815,17,3161,87,2149,75,10974
"24031703213",1063,447,1831,589,1987,368,2000,633,8918
"24031703214",1325,39,3213,411,1897,578,2166,548,10177
"24031703215",1184,66,704,115,1277,56,1146,0,4548
"24031703216",1903,95,957,63,497,181,374,11,4081
"24031703218",1511,74,121,0,60,9,28,0,1803
"24031703219",2646,175,381,0,223,101,59,25,3610
"24031703220",1787,119,1836,170,830,158,968,34,5902
"24031703221",1952,38,1390,243,1301,141,380,45,5490
"24031703301",2440,105,320,0,1819,168,2146,101,7099
"24031703302",1299,52,473,34,2520,160,2473,147,7158
"24031703401",1818,113,369,195,2555,350,2210,234,7844
"24031703402",1056,9,372,2,1920,85,1484,25,4953
"24031703403",962,210,643,136,1383,275,1373,329,5311
"24031703404",659,9,536,20,1546,262,1621,224,4877
"24031703501",1892,186,1881,540,2442,319,2703,305,10268
"24031703502",1630,301,160,65,677,258,418,453,3962
"24031703601",2725,39,312,194,1183,0,1007,9,5469
"24031703602",2470,0,122,0,568,0,714,0,3874
"24031703701",1262,152,512,11,1840,205,1991,297,6270
"24031703702",1377,57,504,1,1648,529,1052,529,5697
"24031703800",988,68,582,237,1032,211,698,181,3997
"24031703901",1851,58,339,5,815,9,393,26,3496
"24031703902",3041,302,1484,2,2265,400,1927,384,9805
"24031704000",3278,156,1463,153,1706,103,1505,87,8451
"24031704100",4034,68,151,0,247,12,136,15,4663
"24031704200",1489,34,131,11,195,33,106,0,1999
"24031704300",3467,13,47,1,324,0,361,0,4213
"24031704401",2437,198,154,48,476,7,480,139,3939
"24031704403",1168,37,114,10,243,0,116,0,1688
"24031704404",3632,106,193,54,862,0,243,30,5120
"24031704501",2826,91,59,0,447,33,447,63,3966
"24031704502",2214,18,11,0,346,5,85,2,2681
"24031704503",3551,52,52,31,386,9,425,9,4515
"24031704600",4043,89,43,35,846,62,232,0,5350
"24031704700",3665,7,24,10,416,66,237,0,4425
"24031704803",2534,145,132,13,681,104,545,23,4177
"24031704804",1205,69,25,0,406,1,99,40,1845
"24031704805",1272,93,111,79,278,54,51,22,1960
"24031704806",2236,103,155,5,506,20,218,13,3256
"24031705000",2948,120,197,13,418,45,260,19,4020
"24031705100",4490,86,244,3,471,3,282,7,5586
"24031705200",3081,57,35,0,164,6,315,31,3689
"24031705300",1806,39,0,0,81,3,35,9,1973
"24031705400",2651,27,7,9,213,0,140,0,3047
"24031705501",1903,66,37,0,177,166,140,159,2648
"24031705502",3584,80,23,0,194,0,206,3,4090
"24031705601",2481,23,43,0,386,21,234,0,3188
"24031705602",3714,173,85,0,744,19,515,0,5250
"24031705701",3747,110,86,5,378,32,157,8,4523
"24031705702",4529,92,0,0,145,0,473,1,5240
"24031705800",5238,134,144,0,586,18,163,0,6283
"24031705901",3150,7,100,0,513,11,257,11,4049
"24031705902",3140,25,118,0,841,33,205,0,4362
"24031705903",3391,52,0,0,858,16,232,0,4549
"24031706005",3474,184,251,1,940,8,382,38,5278
"24031706007",5000,91,331,0,1918,0,472,0,7812
"24031706008",4037,41,51,0,998,0,276,0,5403
"24031706009",4529,91,124,7,743,74,352,1,5921
"24031706010",1727,106,583,0,522,17,60,0,3015
"24031706011",3394,208,267,88,1096,28,352,20,5453
"24031706012",1734,194,204,83,836,151,440,11,3653
"24031706013",2382,68,21,0,493,26,535,0,3525
"24033800102",1376,35,901,73,496,161,579,172,3793
"24033800103",781,193,497,56,427,29,284,43,2310
"24033800105",1142,124,1877,40,572,0,547,26,4328
"24033800106",575,35,1676,64,295,44,199,0,2888
"24033800108",881,57,1571,280,396,26,259,38,3508
"24033800109",1001,63,1233,135,1020,251,1129,234,5066
"24033800203",3322,35,636,4,361,0,453,0,4811
"24033800206",1046,8,2243,128,486,49,251,21,4232
"24033800208",2039,43,3938,86,1286,43,740,43,8218
"24033800209",642,9,1821,295,620,246,575,203,4411
"24033800210",361,0,2105,198,380,44,165,17,3270
"24033800211",601,13,1735,158,219,0,313,0,3039
"24033800212",1129,22,2458,144,718,248,390,45,5154
"24033800213",869,180,2101,109,849,37,481,155,4781
"24033800214",534,40,1521,242,223,0,197,0,2757
"24033800215",305,27,1386,91,681,22,472,22,3006
"24033800401",1527,27,427,9,369,22,299,0,2680
"24033800402",3602,81,582,34,475,0,209,0,4983
"24033800403",2277,77,1250,145,346,9,350,20,4474
"24033800408",1395,71,4575,464,411,223,676,221,8036
"24033800409",2280,132,2737,96,747,8,355,19,6374
"24033800410",1594,88,2696,22,1126,62,225,50,5863
"24033800411",1061,48,1987,114,495,0,391,0,4096
"24033800412",639,71,1924,267,328,0,213,58,3500
"24033800413",410,1,2791,415,207,0,113,0,3937
"24033800504",3314,40,1000,1,524,98,561,71,5609
"24033800505",1694,93,652,28,105,0,182,12,2766
"24033800507",914,15,1713,23,257,18,311,0,3251
"24033800509",393,0,8395,339,584,80,66,62,9919
"24033800511",1685,25,2771,155,553,0,371,0,5560
"24033800513",2935,39,2094,96,459,11,520,0,6154
"24033800514",845,32,3603,17,782,0,127,0,5406
"24033800515",1247,107,2036,83,613,0,325,39,4450
"24033800516",1027,44,2542,47,224,0,63,1,3948
"24033800517",462,9,4557,75,342,0,23,0,5468
"24033800518",498,0,2598,57,182,0,188,0,3523
"24033800519",932,99,2247,135,343,2,143,88,3989
"24033800520",77,0,1600,51,80,0,29,0,1837
"24033800601",162,79,1599,122,83,0,0,0,2045
"24033800604",107,4,1342,40,35,4,73,0,1605
"24033800605",624,111,3356,5,112,19,89,19,4335
"24033800606",341,0,4328,150,174,0,0,0,4993
"24033800607",424,9,5128,40,432,45,635,14,6727
"24033800608",231,0,3864,91,191,0,71,0,4448
"24033800701",544,43,4207,105,447,15,135,9,5505
"24033800704",585,13,4214,37,119,0,47,0,5015
"24033800705",681,3,3376,159,288,0,16,0,4523
"24033800706",396,15,3128,54,145,0,0,0,3738
"24033800707",338,0,2272,109,108,0,16,0,2843
"24033800800",2134,73,1135,13,123,7,368,0,3853
"24033800900",766,46,686,14,47,0,12,0,1571
"24033801003",1387,168,3266,9,341,28,370,116,5685
"24033801004",1255,19,3061,34,257,0,221,0,4847
"24033801005",585,0,2774,183,429,0,39,17,4027
"24033801006",576,0,2827,150,249,1,76,0,3879
"24033801104",1776,158,524,45,599,39,382,8,3531
"24033801207",611,82,3366,113,320,0,126,55,4673
"24033801208",218,18,3326,54,155,0,100,0,3871
"24033801209",263,1,4521,373,319,0,270,0,5747
"24033801210",553,0,3653,182,357,0,385,0,5130
"24033801211",274,19,2739,0,65,21,120,0,3238
"24033801212",377,63,2749,39,354,20,208,20,3830
"24033801213",292,88,2941,113,277,0,110,88,3909
"24033801214",938,59,2226,308,264,0,341,0,4136
"24033801215",193,6,2029,207,114,0,47,204,2800
"24033801216",378,47,2592,25,142,195,116,86,3581
"24033801217",268,2,2781,79,415,0,190,8,3743
"24033801302",1123,25,1075,21,179,0,82,0,2505
"24033801305",436,399,4224,250,690,38,481,424,6942
"24033801307",471,2,2827,56,391,19,83,15,3864
"24033801308",307,12,2816,129,543,36,222,0,4065
"24033801309",870,30,2447,82,391,2,279,0,4101
"24033801310",893,79,4566,36,472,0,216,0,6262
"24033801311",525,116,5164,246,328,2,366,1,6748
"24033801312",442,41,1956,400,556,0,345,0,3740
"24033801313",609,123,2140,86,134,28,284,0,3404
"24033801404",637,27,2585,538,940,90,476,22,5315
"24033801405",869,35,1980,391,1519,189,1372,166,6521
"24033801406",67,0,1771,283,350,0,244,0,2715
"24033801407",356,135,5156,174,237,55,449,0,6562
"24033801408",80,41,2960,266,160,12,76,31,3626
"24033801409",398,0,2045,47,525,50,419,0,3484
"24033801410",535,9,1660,44,861,14,314,0,3437
"24033801411",571,0,1582,100,1068,10,409,0,3740
"24033801500",153,17,1728,162,527,31,369,23,3010
"24033801600",84,32,1709,457,84,0,80,26,2472
"24033801701",271,41,3348,495,79,0,33,0,4267
"24033801702",113,55,3380,344,96,16,46,46,4096
"24033801704",244,0,4561,878,262,16,355,16,6332
"24033801706",111,130,1157,41,115,0,76,130,1760
"24033801707",386,21,4809,446,723,431,1061,436,8313
"24033801708",171,57,2913,223,281,0,195,21,3861
"24033801801",66,42,1555,184,168,13,128,42,2198
"24033801802",38,8,3154,204,9,51,0,0,3464
"24033801804",120,22,1634,306,10,0,62,0,2154
"24033801805",99,45,1648,258,68,71,45,0,2234
"24033801807",146,2,3914,319,36,0,105,0,4522
"24033801808",174,8,3322,224,122,0,167,0,4017
"24033801901",707,62,3520,95,377,8,443,0,5212
"24033801904",423,45,2000,110,179,168,194,119,3238
"24033801905",542,14,4133,77,431,0,48,0,5245
"24033801906",391,18,1021,207,116,14,206,0,1973
"24033801907",126,58,2366,159,132,1,52,1,2895
"24033801908",88,0,2723,526,44,0,0,0,3381
"24033802001",335,0,4368,807,202,66,417,16,6211
"24033802002",27,2,3018,352,189,62,207,34,3891
"24033802103",564,18,2184,117,217,74,334,21,3529
"24033802104",218,5,1384,261,10,0,166,0,2044
"24033802106",187,0,3318,247,75,0,258,0,4085
"24033802107",56,8,3024,396,87,0,54,0,3625
"24033802201",324,5,1225,125,66,43,26,0,1814
"24033802203",421,23,3382,241,102,1,369,1,4540
"24033802204",74,32,5054,540,90,0,0,0,5790
"24033802301",172,53,3031,170,113,0,63,0,3602
"24033802404",37,11,3135,557,18,57,47,15,3877
"24033802405",113,0,3564,360,29,35,88,35,4224
"24033802406",70,19,1576,293,138,52,126,0,2274
"24033802407",171,29,2977,627,25,0,142,0,3971
"24033802408",187,23,955,86,74,0,113,0,1438
"24033802501",37,0,2521,192,7,0,0,0,2757
"24033802502",307,26,2019,142,78,0,229,20,2821
"24033802600",126,0,2808,296,89,0,100,0,3419
"24033802700",269,37,1794,537,74,14,298,26,3049
"24033802803",232,122,4079,355,22,1,207,106,5124
"24033802804",46,1,4624,633,187,17,176,0,5684
"24033802805",64,90,3961,582,80,18,194,83,5072
"24033802901",305,15,2995,543,146,12,370,27,4413
"24033803001",526,54,1799,306,148,18,550,53,3454
"24033803002",17,4,2457,259,38,0,121,0,2896
"24033803100",229,31,2138,265,19,5,199,28,2914
"24033803200",128,10,2166,484,59,34,196,44,3121
"24033803300",350,105,3008,633,373,40,700,133,5342
"24033803401",183,19,885,167,94,49,272,49,1718
"24033803402",22,14,3723,612,73,17,52,0,4513
"24033803508",147,0,2914,1052,206,59,150,8,4536
"24033803509",169,58,2079,425,150,195,308,246,3630
"24033803512",245,14,5437,326,215,14,116,0,6367
"24033803513",103,18,3045,522,248,64,16,0,4016
"24033803514",150,1,3448,571,148,0,11,0,4329
"24033803516",596,13,3410,182,692,0,386,0,5279
"24033803519",174,0,4063,187,77,0,141,0,4642
"24033803520",464,30,3335,28,146,0,100,0,4103
"24033803521",264,26,4457,251,298,31,92,31,5450
"24033803522",184,1,3035,289,239,0,219,0,3967
"24033803523",191,0,3478,202,210,57,0,0,4138
"24033803524",59,0,3391,180,70,0,130,0,3830
"24033803525",87,0,1531,438,229,0,83,0,2368
"24033803526",192,0,2601,196,98,0,39,0,3126
"24033803527",138,17,2656,156,111,66,123,0,3267
"24033803601",205,1,2896,182,369,0,164,0,3817
"24033803602",140,0,1520,328,224,12,305,12,2541
"24033803605",1762,235,3296,445,1045,60,1666,278,8787
"24033803606",1053,147,2696,62,910,216,1047,304,6435
"24033803607",606,9,2311,105,301,0,506,0,3838
"24033803608",958,287,3180,50,1213,234,1632,505,8059
"24033803610",566,103,1587,278,588,0,786,114,4022
"24033803612",621,0,1869,257,335,19,685,19,3805
"24033803613",442,233,3435,419,400,82,647,173,5831
"24033803700",1164,75,847,70,287,26,1121,56,3646
"24033803801",806,18,1177,74,363,82,947,89,3556
"24033803803",1066,21,3060,409,1179,97,1445,105,7382
"24033803900",1649,425,949,18,719,131,2141,543,6575
"24033804001",423,263,3037,776,281,116,630,321,5847
"24033804002",815,39,1617,61,1672,374,2176,405,7159
"24033804101",480,132,2335,260,108,11,109,65,3500
"24033804102",863,240,3736,428,742,7,1108,215,7339
"24033804200",1406,51,1068,16,212,5,370,24,3152
"24033804300",596,64,1932,414,144,31,607,8,3796
"24033804400",1097,180,834,207,428,60,1093,208,4107
"24033804600",793,253,1011,95,832,92,1262,303,4641
"24033804700",1575,60,1268,118,447,58,1171,13,4710
"24033804801",302,26,1320,369,196,194,390,115,2912
"24033804802",637,166,1006,238,726,99,1281,257,4410
"24033804900",231,53,2215,434,681,172,671,216,4673
"24033805000",365,131,2758,315,1843,48,2123,156,7739
"24033805101",582,111,1088,184,1502,450,1910,543,6370
"24033805201",407,25,2023,256,1728,329,2278,329,7375
"24033805202",396,2,2281,428,472,33,760,33,4405
"24033805500",807,118,779,134,1980,635,2485,669,7607
"24033805601",1042,285,353,219,3769,997,4654,1250,12569
"24033805602",1070,145,330,51,3625,825,4482,895,11423
"24033805700",996,140,1152,178,3077,764,3656,768,10731
"24033805801",500,188,1083,144,2388,196,2575,313,7387
"24033805802",719,172,1075,143,1579,872,2148,1034,7742
"24033805904",673,236,627,168,1506,142,1472,103,4927
"24033805906",552,272,796,171,1208,182,1239,397,4817
"24033805907",316,52,1808,280,1216,399,1095,398,5564
"24033805908",156,57,1481,144,551,90,463,19,2961
"24033805909",1169,127,2032,500,926,161,936,143,5994
"24033806000",1005,191,1847,313,1698,510,1881,498,7943
"24033806100",1691,104,1191,53,894,117,900,168,5118
"24033806200",2002,90,1128,267,306,0,695,16,4504
"24033806300",870,127,593,74,329,26,709,129,2857
"24033806400",2531,162,241,86,503,118,249,109,3999
"24033806501",3031,874,1126,128,327,183,2598,889,9156
"24033806601",2515,479,798,119,671,107,2614,637,7940
"24033806602",1568,374,2070,200,259,231,1280,151,6133
"24033806706",694,84,1416,196,864,143,474,46,3917
"24033806708",1710,309,1175,290,601,148,284,0,4517
"24033806710",814,66,3625,230,1004,0,293,0,6032
"24033806711",610,17,3176,222,997,48,722,0,5792
"24033806712",384,12,2468,136,341,0,162,0,3503
"24033806713",817,150,1398,348,526,365,834,351,4789
"24033806714",932,118,1635,355,547,88,1233,190,5098
"24033806800",2360,178,671,32,918,121,1019,51,5350
"24033806900",2505,146,595,47,773,122,1199,41,5428
"24033807000",2423,910,773,628,717,529,706,80,6766
"24033807102",1542,314,297,44,157,73,279,7,2713
"24033807200",717,2094,74,42,161,325,75,100,3588
"24033807301",1142,138,881,172,835,316,336,72,3892
"24033807304",776,50,418,40,552,6,700,21,2563
"24033807305",601,45,1288,133,1270,59,1052,68,4516
"24033807404",2279,102,1066,132,1091,125,1158,70,6023
"24033807405",2920,177,1221,198,1286,196,978,0,6976
"24033807407",1435,65,2145,119,2265,447,1225,425,8126
"24033807408",2455,255,1479,39,1261,0,449,0,5938
"24033807409",712,25,1178,391,1182,364,1151,243,5246
"24033807410",405,58,2160,243,1048,392,789,283,5378
"24035810100",2220,334,425,40,218,41,232,257,3767
"24035810200",2000,157,182,0,62,5,73,35,2514
"24035810300",3687,421,414,295,59,9,85,34,5004
"24035810400",5728,121,349,68,90,0,33,0,6389
"24035810500",3761,169,213,223,68,0,25,0,4459
"24035810600",4195,405,149,0,268,1,161,69,5248
"24035810700",2804,361,451,31,168,9,132,36,3992
"24035810800",5483,147,32,0,54,0,58,0,5774
"24035810901",4392,158,68,0,74,0,51,17,4760
"24035810902",2760,83,38,0,133,0,57,0,3071
"24035811000",3395,350,164,82,296,42,145,77,4551
"24035990000",0,0,0,0,0,0,0,0,0
"24035990100",0,0,0,0,0,0,0,0,0
"24035990200",0,0,0,0,0,0,0,0,0
"24037875000",5416,231,636,13,419,24,247,0,6986
"24037875100",3941,192,421,28,282,15,97,0,4976
"24037875201",4488,185,197,0,90,0,55,0,5015
"24037875202",5368,100,452,104,135,12,110,0,6281
"24037875300",2447,307,720,27,96,0,100,8,3705
"24037875400",5853,230,343,270,192,7,9,0,6904
"24037875500",7369,121,650,53,442,0,327,19,8981
"24037875600",7180,215,884,91,528,0,133,0,9031
"24037875700",5878,332,203,26,514,0,174,0,7127
"24037875801",847,34,93,9,121,2,164,2,1272
"24037875802",3556,67,162,15,209,0,95,0,4104
"24037875901",4496,118,888,254,991,66,616,0,7429
"24037875902",4133,482,2265,780,940,126,694,213,9633
"24037876001",2572,162,1413,833,316,65,459,39,5859
"24037876002",5298,402,1734,352,714,48,312,278,9138
"24037876100",6457,351,419,38,181,64,240,63,7813
"24037876200",4828,108,317,233,404,1,57,0,5948
"24037990000",0,0,0,0,0,0,0,0,0
"24039930101",1751,346,1770,881,63,68,118,80,5077
"24039930102",1896,233,770,254,291,162,111,156,3873
"24039930200",970,292,143,62,5,26,8,0,1506
"24039930300",1529,346,284,16,42,0,22,0,2239
"24039930500",2663,490,519,78,63,98,93,0,4004
"24039930600",1285,522,484,535,88,127,0,51,3092
"24039980400",22,15,2,3,0,1,2,3,48
"24039990100",0,0,0,0,0,0,0,0,0
"24041960100",3573,363,316,29,96,0,7,0,4384
"24041960201",3355,39,202,148,142,10,47,0,3943
"24041960300",2109,263,817,323,93,80,295,165,4145
"24041960400",3445,463,773,207,219,36,895,109,6147
"24041960501",3911,244,185,0,321,64,93,13,4831
"24041960502",3092,290,637,137,169,57,182,147,4711
"24041960600",1353,97,173,23,41,7,23,0,1717
"24041960700",2772,239,263,29,67,8,88,0,3466
"24041960800",1723,90,106,0,72,17,43,0,2051
"24041960900",2898,521,509,126,105,3,52,50,4264
"24041990000",0,0,0,0,0,0,0,0,0
"24043000100",2647,150,112,52,229,0,31,0,3221
"24043000200",2711,159,208,79,303,0,77,0,3537
"24043000301",2302,578,148,91,186,6,89,63,3463
"24043000302",1554,462,371,215,174,68,17,9,2870
"24043000400",433,366,441,508,60,78,31,23,1940
"24043000500",2626,592,965,438,473,337,491,72,5994
"24043000601",1291,304,446,96,233,141,142,138,2791
"24043000602",2453,207,248,115,40,0,3,0,3066
"24043000700",1368,860,220,160,144,75,0,58,2885
"24043000800",2389,384,392,270,89,14,182,5,3725
"24043000900",1703,962,236,266,161,165,22,180,3695
"24043001001",2869,930,410,301,381,153,181,107,5332
"24043001002",3311,475,97,67,129,6,100,27,4212
"24043010100",1209,49,0,1,8,39,0,0,1306
"24043010200",4214,324,17,1,53,0,0,45,4654
"24043010300",6226,265,383,41,363,0,275,0,7553
"24043010400",6165,698,702,0,540,30,240,18,8393
"24043010500",5681,250,74,28,173,88,28,0,6322
"24043010600",4556,247,44,0,118,54,73,3,5095
"24043010700",3021,462,26,0,28,31,13,5,3586
"24043010801",3877,174,130,6,123,0,32,0,4342
"24043010802",1967,377,36,0,126,32,7,0,2545
"24043010900",7322,137,358,122,189,0,591,41,8760
"24043011000",0,0,0,0,0,0,0,0,0
"24043011100",4519,813,211,326,122,8,193,194,6386
"24043011201",6625,720,846,136,532,41,576,0,9476
"24043011202",3288,486,361,32,252,28,301,163,4911
"24043011301",4401,308,68,23,234,0,164,15,5213
"24043011302",3613,149,48,27,146,0,65,0,4048
"24043011400",4617,374,73,3,150,3,134,0,5354
"24043011500",7145,449,107,32,169,0,73,17,7992
"24043011600",2677,197,14,11,130,9,36,4,3078
"24045000100",1952,853,1457,1102,201,170,495,454,6684
"24045000200",973,266,644,178,60,9,72,92,2294
"24045000300",78,36,727,523,54,13,56,21,1508
"24045000400",2111,812,572,289,201,91,280,141,4497
"24045000500",929,251,943,249,82,168,64,0,2686
"24045010101",3824,568,911,164,264,213,56,129,6129
"24045010102",2224,199,686,35,45,8,91,0,3288
"24045010200",612,274,3814,854,417,117,333,256,6677
"24045010300",4972,157,1125,140,1343,282,329,161,8509
"24045010400",3836,904,690,54,20,32,203,0,5739
"24045010501",2514,236,642,572,782,51,248,0,5045
"24045010502",3396,1892,1207,735,473,311,80,63,8157
"24045010603",4968,599,1078,173,403,0,141,0,7362
"24045010604",3967,607,279,2,297,11,195,0,5358
"24045010605",3588,45,354,15,62,15,61,0,4140
"24045010606",3425,265,212,0,69,28,47,28,4074
"24045010701",3028,283,613,97,67,68,70,0,4226
"24045010702",5336,599,1314,513,360,16,478,38,8654
"24045010800",4825,450,701,170,10,0,0,0,6156
"24047950000",1594,63,3,17,11,3,33,7,1731
"24047950100",1907,103,29,9,11,0,223,0,2282
"24047950300",3068,150,0,0,18,89,35,128,3488
"24047950400",2289,358,48,105,159,0,88,230,3277
"24047950600",2629,225,86,0,67,0,258,0,3265
"24047950700",1676,166,0,0,121,0,13,0,1976
"24047950800",4255,524,577,0,73,0,106,0,5535
"24047950900",1237,179,88,16,130,0,31,0,1681
"24047951000",2451,110,1255,310,172,11,196,75,4580
"24047951100",5389,204,273,0,76,5,128,0,6075
"24047951200",2861,314,280,74,0,9,17,0,3555
"24047951300",1351,341,693,279,47,20,7,0,2738
"24047951400",2746,308,294,201,74,0,53,0,3676
"24047951500",1802,436,1877,651,371,21,5,0,5163
"24047951700",3000,323,18,38,64,0,34,4,3481
"24047980000",0,0,0,0,0,0,0,0,0
"24047990000",0,0,0,0,0,0,0,0,0
"24510010100",2411,358,38,11,116,0,89,42,3065
"24510010200",2589,202,265,79,102,97,390,149,3873
"24510010300",2002,159,17,0,203,9,166,0,2556
"24510010400",1935,119,19,3,188,0,60,1,2325
"24510010500",1742,101,35,42,48,11,109,6,2094
"24510020100",1527,108,57,131,211,23,168,24,2249
"24510020200",1322,274,242,18,183,40,481,169,2729
"24510020300",2693,235,49,0,383,194,242,192,3988
"24510030100",430,234,829,1327,123,134,168,312,3557
"24510030200",1173,113,487,419,317,19,107,0,2635
"24510040100",1488,705,451,82,460,274,113,45,3618
"24510040200",104,122,88,90,29,26,5,5,469
"24510060100",946,252,848,492,287,15,452,102,3394
"24510060200",1372,141,925,759,78,205,388,276,4144
"24510060300",709,50,526,360,119,19,40,5,1828
"24510060400",242,71,551,360,77,9,0,0,1310
"24510070100",244,3,1757,800,99,0,171,0,3074
"24510070200",15,34,1766,1115,253,0,194,9,3386
"24510070300",13,39,310,555,0,0,0,36,953
"24510070400",4,38,674,407,64,20,0,0,1207
"24510080101",829,0,2242,515,143,0,25,0,3754
"24510080102",49,0,1547,340,7,0,0,0,1943
"24510080200",0,0,1000,386,10,0,0,0,1396
"24510080301",17,18,1058,440,15,5,11,0,1564
"24510080302",0,33,1757,840,47,86,13,18,2794
"24510080400",0,60,729,365,0,18,0,11,1183
"24510080500",0,0,1093,489,22,0,22,0,1626
"24510080600",4,30,1767,583,0,47,0,0,2431
"24510080700",1,2,555,215,0,0,0,0,773
"24510080800",24,0,399,696,84,57,84,0,1344
"24510090100",468,253,2640,990,63,33,35,32,4514
"24510090200",528,27,2293,555,56,0,60,0,3519
"24510090300",879,221,2051,496,203,239,15,12,4116
"24510090400",41,6,925,447,22,9,0,0,1450
"24510090500",308,120,1265,357,55,34,0,0,2139
"24510090600",15,34,2316,510,56,0,56,0,2987
"24510090700",24,77,2197,802,18,33,0,77,3228
"24510090800",88,96,1874,1177,22,136,49,0,3442
"24510090900",65,2,1306,682,0,6,169,0,2230
"24510100100",43,19,1355,670,0,0,0,0,2087
"24510100200",0,6,1272,1454,11,0,0,0,2743
"24510100300",0,0,0,0,0,0,0,0,0
"24510110100",1625,472,496,225,323,103,121,0,3365
"24510110200",2500,589,933,316,331,265,137,112,5183
"24510120100",2865,277,92,164,988,359,88,95,4928
"24510120201",1053,338,155,103,168,123,52,61,2053
"24510120202",1079,714,239,100,877,637,105,73,3824
"24510120300",843,139,1094,906,178,26,83,17,3286
"24510120400",123,40,798,607,89,0,33,10,1700
"24510120500",495,96,890,451,94,49,54,0,2129
"24510120600",689,231,420,763,93,87,49,37,2369
"24510120700",1327,231,419,305,144,213,54,31,2724
"24510130100",206,25,1550,967,150,39,7,18,2962
"24510130200",433,35,1246,1331,115,191,0,80,3431
"24510130300",78,7,1494,526,12,6,18,11,2152
"24510130400",32,2,1664,527,9,22,1,4,2261
"24510130600",3025,321,214,24,218,15,127,9,3953
"24510130700",3535,388,212,67,458,0,137,13,4810
"24510130803",1587,94,190,11,471,16,151,11,2531
"24510130804",1440,198,30,65,120,25,83,13,1974
"24510130805",92,5,666,83,31,0,2,0,879
"24510130806",905,130,203,12,35,0,0,0,1285
"24510140100",1979,299,1024,414,393,154,38,0,4301
"24510140200",78,89,797,1823,0,0,5,33,2825
"24510140300",78,57,1491,906,54,69,4,38,2697
"24510150100",2,5,1859,1541,0,0,0,0,3407
"24510150200",0,0,2029,652,27,26,0,0,2734
"24510150300",0,0,1486,457,29,0,0,0,1972
"24510150400",0,0,2791,606,0,7,0,0,3404
"24510150500",15,0,1320,462,5,126,0,0,1928
"24510150600",0,0,1664,787,0,0,0,0,2451
"24510150701",0,6,1147,173,7,12,0,0,1345
"24510150702",11,0,1558,358,27,0,27,0,1981
"24510150800",0,34,2601,890,129,11,49,0,3714
"24510150900",77,11,2145,591,0,0,30,11,2865
"24510151000",158,107,3385,955,156,132,2,0,4895
"24510151100",173,78,5005,1202,453,0,42,0,6953
"24510151200",100,59,3083,1745,44,73,72,36,5212
"24510151300",38,79,2829,2256,45,44,33,7,5331
"24510160100",13,9,1190,1024,64,114,56,0,2470
"24510160200",0,8,1734,884,0,0,0,2,2628
"24510160300",39,17,1017,504,0,7,0,0,1584
"24510160400",0,1,1952,1093,19,0,0,0,3065
"24510160500",0,0,3203,863,0,0,99,0,4165
"24510160600",0,0,1317,913,19,122,56,124,2551
"24510160700",61,1,2847,1258,39,30,17,17,4270
"24510160801",11,39,2362,991,40,14,45,0,3502
"24510160802",11,142,2293,866,10,0,0,20,3342
"24510170100",293,83,636,367,124,36,49,0,1588
"24510170200",60,41,1309,1701,15,67,0,4,3197
"24510170300",8,0,1313,579,51,30,0,0,1981
"24510180100",35,24,728,1287,5,0,29,24,2132
"24510180200",19,29,479,357,17,0,0,0,901
"24510180300",351,247,553,386,116,22,13,0,1688
"24510190100",189,4,1145,656,3,30,167,11,2205
"24510190200",664,115,641,572,116,32,157,32,2329
"24510190300",280,230,1117,428,146,66,129,10,2406
"24510200100",14,12,781,757,26,0,0,6,1596
"24510200200",22,0,1274,989,127,0,0,0,2412
"24510200300",135,149,697,552,54,151,13,72,1823
"24510200400",45,21,948,540,26,73,0,37,1690
"24510200500",726,434,502,802,117,314,198,81,3174
"24510200600",379,554,1173,457,48,189,0,64,2864
"24510200701",75,35,3235,1051,170,0,140,23,4729
"24510200702",10,15,802,510,16,0,0,0,1353
"24510200800",246,27,1452,702,23,0,38,0,2488
"24510210100",591,234,909,379,150,26,38,8,2335
"24510210200",981,248,895,604,342,26,46,8,3150
"24510220100",2966,465,400,187,195,94,177,0,4484
"24510230100",1025,86,382,211,192,0,41,26,1963
"24510230200",1809,84,140,11,103,0,111,0,2258
"24510230300",965,80,7,14,26,0,43,0,1135
"24510240100",2551,152,57,4,91,7,118,2,2982
"24510240200",2462,107,131,0,255,0,75,0,3030
"24510240300",1699,127,43,59,61,62,67,7,2125
"24510240400",2302,80,73,20,314,40,174,33,3036
"24510250101",249,0,2927,650,108,126,86,0,4146
"24510250102",70,14,2139,528,115,9,0,0,2875
"24510250103",2174,346,560,177,239,16,284,17,3813
"24510250203",94,0,1273,380,100,58,162,0,2067
"24510250204",0,88,1384,2528,170,8,10,104,4292
"24510250205",1167,644,1980,665,221,8,513,159,5357
"24510250206",1352,312,161,21,82,79,70,9,2086
"24510250207",104,18,1788,319,136,66,123,6,2560
"24510250301",142,49,1571,716,6,27,116,0,2627
"24510250303",1113,599,288,86,220,59,240,137,2742
"24510250401",1714,641,567,276,104,89,68,82,3541
"24510250402",1108,516,1406,1062,575,258,681,105,5711
"24510250500",2461,756,1015,746,772,260,447,126,6583
"24510250600",0,0,0,0,0,0,0,0,0
"24510260101",1082,346,2446,396,320,153,189,138,5070
"24510260102",547,100,3651,682,148,0,165,0,5293
"24510260201",702,34,2581,743,437,58,262,58,4875
"24510260202",547,137,3360,770,494,344,0,0,5652
"24510260203",100,50,1898,428,38,65,12,1,2592
"24510260301",194,38,3039,1249,43,11,28,0,4602
"24510260302",424,81,4348,1439,0,1,55,0,6348
"24510260303",196,56,375,180,8,3,58,0,876
"24510260401",1910,522,44,224,584,16,590,158,4048
"24510260402",34,6,2327,330,84,14,0,0,2795
"24510260403",118,56,1364,248,11,11,0,0,1808
"24510260404",641,134,862,145,594,167,978,250,3771
"24510260501",3412,435,686,77,474,180,1248,165,6677
"24510260604",286,33,295,535,121,45,132,26,1473
"24510260605",2579,657,497,179,390,290,582,397,5571
"24510260700",1378,474,0,37,584,166,702,351,3692
"24510260800",1381,157,314,737,297,98,767,198,3949
"24510260900",2114,195,126,2,115,20,182,29,2783
"24510261000",982,207,828,648,149,8,500,160,3482
"24510261100",1682,140,79,62,45,0,42,62,2112
"24510270101",705,60,587,325,80,0,58,0,1815
"24510270102",823,122,2536,112,129,7,60,0,3789
"24510270200",976,64,539,29,210,18,32,5,1873
"24510270301",859,129,1331,236,286,0,63,0,2904
"24510270302",686,21,588,175,149,12,10,0,1641
"24510270401",990,93,4206,334,67,102,58,78,5928
"24510270402",1248,92,1424,189,136,28,23,1,3141
"24510270501",2537,60,1302,179,103,0,92,0,4273
"24510270502",1225,199,2394,253,187,55,10,0,4323
"24510270600",1862,136,1734,599,343,0,93,0,4767
"24510270701",65,48,1931,630,32,83,76,78,2943
"24510270702",542,112,1242,205,127,80,97,80,2485
"24510270703",1413,154,777,78,92,17,65,0,2596
"24510270801",433,0,3191,674,101,0,67,0,4466
"24510270802",235,16,4293,1023,120,31,59,139,5916
"24510270803",393,98,4647,1075,140,63,14,31,6461
"24510270804",1092,116,1119,484,61,5,34,2,2913
"24510270805",147,0,3818,782,277,9,214,0,5247
"24510270901",54,0,3699,423,91,0,0,0,4267
"24510270902",76,5,3503,382,29,7,0,0,4002
"24510270903",203,0,1928,437,162,39,28,19,2816
"24510271001",58,17,1696,557,33,2,7,2,2372
"24510271002",187,31,2681,965,72,0,37,0,3973
"24510271101",839,80,300,361,108,36,80,0,1804
"24510271102",1041,36,97,0,6,0,36,0,1216
"24510271200",4459,268,528,105,601,32,164,0,6157
"24510271300",2215,168,244,0,165,0,36,0,2828
"24510271400",2817,185,77,51,260,135,146,0,3671
"24510271501",3007,300,445,72,317,40,127,13,4321
"24510271503",795,34,47,0,54,0,0,0,930
"24510271600",10,43,2975,1769,101,8,83,12,5001
"24510271700",34,10,3753,1082,12,8,0,0,4899
"24510271801",20,11,2241,780,180,74,112,74,3492
"24510271802",7,0,1936,951,0,13,66,0,2973
"24510271900",766,220,2375,488,58,89,0,128,4124
"24510272003",3967,27,1147,67,193,127,19,20,5567
"24510272004",2726,572,499,127,491,19,43,0,4477
"24510272005",2313,414,401,14,136,10,0,0,3288
"24510272006",1350,489,1799,285,105,123,87,83,4321
"24510272007",1367,235,1804,648,519,126,344,160,5203
"24510280101",188,94,2496,857,135,40,54,40,3904
"24510280102",52,61,4275,1223,123,0,0,0,5734
"24510280200",116,49,3489,1024,87,38,43,0,4846
"24510280301",330,148,2344,820,112,76,37,55,3922
"24510280302",86,0,1470,463,15,0,0,0,2034
"24510280401",414,75,2616,448,78,0,51,0,3682
"24510280402",9,0,1596,178,63,0,9,0,1855
"24510280403",1175,71,3086,299,121,278,67,123,5220
"24510280404",18,17,1575,526,22,18,0,0,2176
"24510280500",33,101,517,1492,21,19,0,10,2193
"25001010100",2275,321,91,20,168,56,130,20,3081
"25001010206",2535,359,25,15,16,47,0,3,3000
"25001010208",1476,228,0,0,34,0,28,0,1766
"25001010304",1898,63,0,0,26,2,10,0,1999
"25001010306",2709,185,0,0,43,0,76,18,3031
"25001010400",2900,73,29,0,27,0,90,9,3128
"25001010500",2573,198,0,5,23,5,7,0,2811
"25001010600",2698,213,223,67,45,9,64,52,3371
"25001010700",2385,216,59,4,44,26,7,9,2750
"25001010800",4472,434,23,0,49,18,0,22,5018
"25001010900",4225,208,36,0,31,0,45,0,4545
"25001011002",3471,307,75,0,170,5,75,0,4103
"25001011100",4200,209,15,0,278,0,111,0,4813
"25001011200",2636,342,142,0,153,9,7,28,3317
"25001011300",2665,158,0,0,41,10,98,34,3006
"25001011400",2472,392,0,81,0,0,0,28,2973
"25001011500",2919,330,59,286,264,0,41,0,3899
"25001011600",1816,661,18,0,34,0,0,0,2529
"25001011700",1478,252,6,0,63,0,79,0,1878
"25001011801",2087,125,14,0,76,0,33,0,2335
"25001011802",3650,200,39,0,88,0,69,13,4059
"25001012001",5233,469,21,26,82,0,48,0,5879
"25001012002",2087,387,86,0,167,156,48,63,2994
"25001012101",4761,385,263,1,151,21,166,0,5748
"25001012102",2707,152,0,10,65,12,27,12,2985
"25001012200",3882,711,49,1,43,14,52,0,4752
"25001012502",2076,325,108,0,207,84,107,16,2923
"25001012601",2652,369,53,1,115,92,42,0,3324
"25001012602",2406,1362,242,532,337,91,508,249,5727
"25001012700",3852,194,20,0,150,0,87,0,4303
"25001012800",3790,289,0,0,179,0,36,0,4294
"25001012900",3870,161,6,0,113,39,75,1,4265
"25001013002",2835,181,40,26,50,0,71,0,3203
"25001013100",4892,232,19,1,145,24,55,0,5368
"25001013200",4284,115,36,0,63,25,104,0,4627
"25001013300",2744,146,0,0,137,0,50,0,3077
"25001013400",3603,152,0,0,159,0,90,0,4004
"25001013500",6275,218,47,1,74,30,83,0,6728
"25001013600",6064,587,0,0,47,0,149,28,6875
"25001013700",3230,309,137,0,103,11,110,4,3904
"25001013800",3881,748,49,0,53,0,72,38,4841
"25001013900",4541,617,93,80,0,28,0,0,5359
"25001014002",3532,323,136,48,193,13,83,0,4328
"25001014100",552,37,18,0,328,0,177,0,1112
"25001014300",3959,155,12,6,179,61,51,80,4503
"25001014402",5415,616,72,19,282,2,98,2,6506
"25001014500",4479,357,435,91,329,40,292,0,6023
"25001014600",3057,172,155,24,350,198,21,2,3979
"25001014700",2903,219,143,3,258,40,26,0,3592
"25001014800",2447,209,183,66,401,100,31,0,3437
"25001014900",3333,187,0,0,139,8,32,1,3700
"25001015001",3799,112,37,0,263,233,33,0,4477
"25001015002",2793,276,62,0,247,12,42,0,3432
"25001015100",3105,441,119,0,169,0,208,0,4042
"25001015200",2114,51,0,0,46,0,104,0,2315
"25001015300",1584,524,290,55,237,336,73,120,3219
"25001990000",0,0,0,0,0,0,0,0,0
"25003900100",1751,834,196,181,101,132,236,207,3638
"25003900200",2252,784,269,47,406,110,206,97,4171
"25003900300",2182,237,84,0,55,33,124,16,2731
"25003900400",3510,569,140,395,181,104,118,215,5232
"25003900500",2940,84,41,0,51,2,40,2,3160
"25003900600",1944,854,401,241,203,228,225,54,4150
"25003900700",2243,380,39,10,63,6,40,0,2781
"25003900800",4591,286,143,13,59,24,46,12,5174
"25003900900",3901,515,201,0,443,77,456,65,5658
"25003901100",3082,100,13,0,138,33,16,0,3382
"25003911100",2882,41,0,0,127,5,0,0,3055
"25003912100",5400,1102,16,30,84,0,215,0,6847
"25003913100",3967,579,0,0,146,52,47,44,4835
"25003914100",5043,485,0,10,216,59,111,59,5983
"25003920101",2749,131,18,4,189,3,44,0,3138
"25003920102",1774,180,0,21,191,17,4,58,2245
"25003921300",2978,645,9,142,161,49,86,13,4083
"25003921400",1482,272,0,0,23,53,24,18,1872
"25003921500",2546,469,9,0,51,0,74,50,3199
"25003922100",2062,370,15,0,72,44,42,0,2605
"25003922200",3450,290,26,0,64,19,5,1,3855
"25003922300",1689,225,10,7,24,1,32,0,1988
"25003923100",2950,215,0,23,0,7,11,9,3215
"25003924100",1679,224,35,24,101,0,34,0,2097
"25003925100",4686,490,25,0,865,28,787,74,6955
"25003926100",2805,328,10,1,85,0,21,0,3250
"25003931100",1436,123,5,0,12,1,0,0,1577
"25003931300",1335,65,33,0,39,16,25,0,1513
"25003931400",1567,115,11,0,55,0,8,6,1762
"25003932200",2131,130,10,0,49,2,21,8,2351
"25003932300",2036,61,21,0,21,22,9,7,2177
"25003933200",1028,128,0,11,5,11,13,0,1196
"25003933300",1298,116,3,0,45,0,16,0,1478
"25003933400",1983,194,0,9,128,0,37,8,2359
"25003934200",1134,68,26,0,96,16,12,0,1352
"25003934300",1558,85,10,4,23,4,12,4,1700
"25003935100",2340,79,8,2,36,27,25,3,2520
"25003935200",4309,756,90,14,210,39,14,39,5471
"25003935300",2793,656,4,24,42,44,103,28,3694
"25005600100",3306,138,137,0,116,32,58,0,3787
"25005600202",3717,181,275,19,386,4,151,8,4741
"25005600203",5098,59,62,37,141,22,201,58,5678
"25005600204",3526,137,199,7,103,27,146,10,4155
"25005610100",4517,248,105,0,504,34,137,0,5545
"25005610202",5191,170,44,10,169,14,102,47,5747
"25005610203",5646,153,431,0,446,44,55,0,6775
"25005610204",4434,240,89,13,816,28,198,28,5846
"25005611101",4078,180,12,1,181,0,8,0,4460
"25005611102",2934,332,13,18,80,10,32,29,3448
"25005611201",2809,105,0,17,146,0,17,8,3102
"25005611202",5920,299,20,26,153,53,12,0,6483
"25005612100",3837,231,6,1,280,48,60,38,4501
"25005612200",6940,529,523,46,812,110,218,33,9211
"25005613100",5924,540,92,0,55,0,47,0,6658
"25005613300",6531,269,275,108,122,48,253,33,7639
"25005613400",3177,237,117,0,85,16,80,61,3773
"25005613600",2677,550,299,35,55,353,83,218,4270
"25005613700",2884,474,198,0,94,22,51,76,3799
"25005613800",3246,825,110,12,279,71,725,210,5478
"25005613901",1858,394,117,62,96,133,5,139,2804
"25005613902",3941,283,162,1,234,71,184,77,4953
"25005614000",2262,997,405,48,448,291,450,349,5250
"25005614101",4764,886,455,157,446,31,139,186,7064
"25005614102",6176,307,412,0,78,31,211,50,7265
"25005615100",6615,321,0,0,163,12,135,3,7249
"25005616100",5951,380,15,0,136,1,187,0,6670
"25005617101",4634,182,14,6,73,31,10,0,4950
"25005617102",3584,206,15,0,101,2,35,0,3943
"25005630101",2081,340,98,12,196,4,60,12,2803
"25005630102",3494,273,7,0,195,0,27,0,3996
"25005630200",7640,133,15,1,334,0,55,0,8178
"25005630300",7792,279,296,11,454,27,294,61,9214
"25005630400",4622,122,57,0,157,1,55,1,5015
"25005631100",6501,524,418,104,803,99,718,251,9418
"25005631200",5985,459,73,0,454,38,57,74,7140
"25005631300",4888,287,101,0,268,0,77,0,5621
"25005631400",1176,613,198,9,357,159,353,0,2865
"25005631500",2133,193,11,0,127,4,140,14,2622
"25005631600",2888,439,81,0,566,53,458,213,4698
"25005631700",4939,147,711,0,356,53,291,17,6514
"25005631800",5630,762,259,6,324,33,182,33,7229
"25005632100",6166,233,101,24,196,0,70,0,6790
"25005632200",6694,456,60,0,168,0,123,0,7501
"25005633100",4946,242,0,0,80,0,22,0,5290
"25005633200",6169,130,28,0,95,0,31,0,6453
"25005640100",3541,646,53,0,180,60,292,124,4896
"25005640200",3630,1243,18,115,171,214,186,204,5781
"25005640300",2681,501,63,255,376,269,454,188,4787
"25005640400",2201,505,38,7,43,6,152,0,2952
"25005640500",2948,1122,17,24,292,186,222,121,4932
"25005640600",3144,959,129,2,200,276,262,250,5222
"25005640700",2353,219,183,0,88,23,25,12,2903
"25005640800",2670,528,105,0,400,154,279,253,4389
"25005640901",2794,1167,32,98,428,529,23,662,5733
"25005641000",1111,791,27,27,79,61,0,139,2235
"25005641101",842,943,137,36,132,20,161,568,2839
"25005641200",1800,881,244,35,213,184,56,114,3527
"25005641300",2104,1247,290,384,644,335,252,430,5686
"25005641400",1613,447,6,0,151,203,186,100,2706
"25005641500",1646,341,27,0,115,150,49,120,2448
"25005641600",1848,293,24,94,58,10,27,0,2354
"25005641700",4190,532,130,18,331,95,324,34,5654
"25005641800",1683,218,63,32,111,48,42,29,2226
"25005641900",1288,472,61,28,192,27,32,0,2100
"25005642000",1585,602,279,20,239,215,102,158,3200
"25005642100",2975,1054,173,1,190,0,63,153,4609
"25005642200",2303,457,54,63,305,208,216,168,3774
"25005642300",2050,96,0,0,51,0,106,0,2303
"25005642400",2699,309,0,11,101,40,107,23,3290
"25005642500",3945,194,56,0,83,14,80,0,4372
"25005644101",5310,352,159,0,219,0,0,0,6040
"25005644102",4543,279,0,2,181,24,20,44,5093
"25005644200",5975,758,1,1,169,0,34,0,6938
"25005645101",4071,270,7,0,89,20,7,10,4474
"25005645102",5157,219,0,0,135,0,95,0,5606
"25005645103",5358,313,27,0,84,0,0,50,5832
"25005646101",7113,197,36,1,143,18,12,0,7520
"25005646103",5334,212,0,0,37,20,0,0,5603
"25005646104",2427,76,0,0,8,0,0,0,2511
"25005650101",4879,385,54,1,228,35,95,15,5692
"25005650102",3415,558,163,22,407,170,635,241,5611
"25005650201",2880,144,25,14,44,33,61,12,3213
"25005650202",1673,285,17,102,105,0,81,18,2281
"25005650300",2666,260,231,6,207,29,350,60,3809
"25005650400",2459,373,66,37,252,169,73,152,3581
"25005650500",1957,538,144,61,272,91,292,129,3484
"25005650600",1394,641,213,63,64,252,59,417,3103
"25005650700",952,329,91,37,487,387,579,377,3239
"25005650800",1457,746,196,239,399,334,514,367,4252
"25005650900",1200,610,130,197,274,467,356,644,3878
"25005651001",2092,193,75,25,270,145,91,34,2925
"25005651002",2459,388,138,26,281,239,168,179,3878
"25005651100",1761,810,91,148,674,661,594,739,5478
"25005651200",843,395,202,77,350,512,467,428,3274
"25005651300",904,373,115,101,376,142,336,83,2430
"25005651400",1635,388,312,98,429,148,399,47,3456
"25005651500",1528,290,241,40,624,369,446,259,3797
"25005651600",1848,329,671,29,1299,252,516,38,4982
"25005651700",487,409,199,188,385,331,149,294,2442
"25005651800",656,402,96,227,116,188,140,108,1933
"25005651900",389,234,235,118,404,407,233,219,2239
"25005652000",1229,397,245,10,431,71,396,91,2870
"25005652100",1758,314,88,0,400,71,221,67,2919
"25005652200",2379,262,115,0,186,19,65,41,3067
"25005652300",1929,516,131,61,370,196,278,145,3626
"25005652400",1544,346,17,15,412,98,341,86,2859
"25005652500",1117,596,96,24,233,242,221,387,2916
"25005652600",917,713,196,11,414,798,647,921,4617
"25005652700",1812,907,144,47,431,148,617,416,4522
"25005652800",2778,144,107,13,53,0,73,0,3168
"25005653101",5038,721,102,13,283,50,94,145,6446
"25005653102",4061,102,12,0,180,0,0,0,4355
"25005653203",4594,166,23,0,336,55,40,5,5219
"25005653204",2778,166,10,0,195,32,38,7,3226
"25005653301",4363,318,42,0,458,25,40,0,5246
"25005653304",3166,115,10,0,60,0,0,0,3351
"25005654100",6360,213,0,0,394,0,269,9,7245
"25005654200",2972,205,0,2,64,0,0,0,3243
"25005655100",3465,227,0,0,107,49,29,0,3877
"25005655200",3426,676,21,1,319,127,77,1,4648
"25005655300",2614,390,0,1,185,9,48,0,3247
"25005655400",3733,207,0,0,62,0,0,0,4002
"25005985500",1115,121,16,0,45,0,18,11,1326
"25005985600",3227,77,113,6,158,0,281,0,3862
"25005990000",0,0,0,0,0,0,0,0,0
"25007200100",3067,707,81,0,141,26,0,7,4029
"25007200200",3791,483,87,33,149,0,0,0,4543
"25007200300",3766,239,65,0,91,0,11,0,4172
"25007200400",3459,343,35,0,163,60,23,17,4100
"25007990000",0,0,0,0,0,0,0,0,0
"25009201100",3062,170,86,0,81,0,129,0,3528
"25009202101",1807,28,3,0,133,0,23,0,1994
"25009202102",5110,413,75,0,45,0,396,13,6052
"25009202200",5616,175,64,1,251,36,201,0,6344
"25009203100",6342,175,33,0,52,41,179,85,6907
"25009203200",4445,165,36,0,140,0,82,0,4868
"25009203301",3733,377,42,0,68,0,66,0,4286
"25009203302",4058,207,30,0,87,16,89,16,4503
"25009204101",3228,446,42,44,212,212,182,287,4653
"25009204102",3214,115,317,13,432,28,387,0,4506
"25009204200",3405,970,26,170,400,181,603,201,5956
"25009204300",1840,474,269,438,763,50,1496,383,5713
"25009204400",2657,179,23,6,432,36,358,39,3730
"25009204500",2614,131,55,0,180,11,104,11,3106
"25009204600",3832,348,227,25,193,156,185,181,5147
"25009204701",4171,565,207,184,852,444,903,462,7788
"25009204702",4306,158,364,42,373,422,369,395,6429
"25009205100",4067,238,17,0,806,0,630,72,5830
"25009205200",2962,445,540,0,1131,358,588,474,6498
"25009205300",3757,148,195,31,296,119,356,0,4902
"25009205400",4475,47,155,0,201,0,245,0,5123
"25009205500",1962,195,522,9,1520,560,1864,518,7150
"25009205600",2029,599,347,320,337,268,383,349,4632
"25009205700",2769,501,606,89,653,175,657,287,5737
"25009205800",1037,255,245,81,1379,406,1127,287,4817
"25009205900",1497,433,618,78,1088,712,1025,844,6295
"25009206000",765,171,526,130,891,600,866,524,4473
"25009206100",916,283,433,162,1458,868,1248,490,5858
"25009206200",1286,430,433,51,2148,964,1787,812,7911
"25009206300",1650,314,515,191,1035,207,1324,414,5650
"25009206400",2579,478,771,183,1034,373,1123,603,7144
"25009206500",822,330,541,184,1091,241,1009,410,4628
"25009206600",2284,397,300,29,833,306,770,386,5305
"25009206700",1489,735,401,203,957,315,1122,683,5905
"25009206800",809,453,422,156,904,627,874,682,4927
"25009206900",1742,479,520,54,1273,264,1694,189,6215
"25009207000",468,324,229,77,544,470,540,487,3139
"25009207100",844,472,361,121,1197,293,1427,539,5254
"25009207200",755,311,363,143,874,480,973,428,4327
"25009208101",4431,189,182,3,301,25,282,0,5413
"25009208102",2733,220,115,8,283,62,275,71,3767
"25009208200",4707,418,26,14,116,0,59,16,5356
"25009208300",6325,595,97,0,222,4,253,4,7500
"25009208400",5547,89,120,0,335,0,33,63,6187
"25009209100",5654,73,140,0,403,0,177,0,6447
"25009209200",5474,41,0,3,217,52,61,0,5848
"25009210100",6005,206,22,145,397,19,342,149,7285
"25009210200",4612,346,143,0,119,0,14,0,5234
"25009210300",6939,420,111,0,457,29,186,0,8142
"25009210400",6455,224,286,0,60,0,206,0,7231
"25009210500",5989,229,135,2,83,81,201,0,6720
"25009210600",3033,256,171,0,801,201,802,191,5455
"25009210700",3063,394,24,10,846,111,775,162,5385
"25009210800",3219,619,64,121,681,101,580,99,5484
"25009210900",3379,307,32,0,316,157,271,81,4543
"25009211100",3283,121,1,1,231,97,123,24,3881
"25009211200",5434,340,119,0,224,1,81,1,6200
"25009211300",6752,180,9,0,82,9,72,7,7111
"25009211401",2689,268,47,70,426,55,209,44,3808
"25009211402",5677,168,88,0,101,0,143,0,6177
"25009212100",6695,325,121,0,441,33,132,51,7798
"25009213100",7370,227,0,0,508,0,144,0,8249
"25009214100",5510,321,0,3,332,2,0,2,6170
"25009215101",4186,141,194,0,265,36,106,0,4928
"25009215102",2799,73,0,0,147,3,63,3,3088
"25009216100",3401,133,0,0,39,0,0,0,3573
"25009217100",6333,316,173,13,591,35,126,17,7604
"25009217201",3873,212,67,95,114,13,74,0,4448
"25009217202",3368,50,0,0,36,0,0,0,3454
"25009217300",3503,618,32,0,157,28,221,1,4560
"25009217400",4063,807,96,0,101,130,167,311,5675
"25009217500",5294,659,13,0,229,0,364,0,6559
"25009217600",6202,233,0,0,22,0,0,0,6457
"25009218100",4779,334,0,0,105,9,112,0,5339
"25009220101",3765,191,9,0,14,18,72,40,4109
"25009220102",2627,155,103,0,110,17,41,0,3053
"25009221100",4187,281,18,12,73,9,48,47,4675
"25009221300",4256,307,0,0,18,2,205,2,4790
"25009221400",2630,258,99,0,226,49,24,101,3387
"25009221500",2276,447,0,0,63,16,57,46,2905
"25009221600",2058,192,10,32,76,148,41,166,2723
"25009221700",1804,258,0,0,59,0,62,0,2183
"25009221800",1417,83,0,0,16,2,20,2,1540
"25009221901",3264,238,0,0,33,0,14,0,3549
"25009221902",3371,491,48,0,171,0,14,0,4095
"25009222100",3343,134,0,0,103,0,26,0,3606
"25009223100",3717,345,13,9,55,30,73,14,4256
"25009223200",3191,319,9,0,82,0,55,0,3656
"25009223300",5464,76,0,1,68,0,38,1,5648
"25009250100",541,251,151,45,977,473,1173,692,4303
"25009250200",1664,324,355,12,2376,822,3247,1003,9803
"25009250300",526,76,100,141,1034,397,1505,567,4346
"25009250400",617,623,122,62,1147,1176,1695,1806,7248
"25009250500",375,369,65,109,1934,1013,2198,1430,7493
"25009250600",1802,619,269,99,2371,582,3720,1056,10518
"25009250700",1422,384,327,42,1833,1147,3006,1421,9582
"25009250800",2528,500,291,48,2028,852,2987,1112,10346
"25009250900",463,334,119,107,888,368,1416,767,4462
"25009251000",374,176,96,9,520,305,888,446,2814
"25009251100",459,467,114,54,810,882,1146,1245,5177
"25009251200",372,201,35,0,492,307,736,403,2546
"25009251300",587,273,297,0,1304,678,1870,886,5895
"25009251400",1600,233,409,140,1723,1014,2774,1262,9155
"25009251500",1924,476,190,133,2844,952,3700,1353,11572
"25009251600",1377,394,156,250,2126,1557,2532,1770,10162
"25009251700",1794,405,355,2,2213,928,2644,998,9339
"25009251800",3564,449,464,189,2252,358,2240,640,10156
"25009252101",2348,175,151,63,570,135,679,215,4336
"25009252102",3567,68,0,34,383,53,237,88,4430
"25009252201",2890,204,21,37,270,5,263,65,3755
"25009252202",2974,41,0,0,98,8,102,0,3223
"25009252300",3591,635,70,29,1798,324,2219,406,9072
"25009252400",1253,308,272,108,1839,416,2389,596,7181
"25009252501",2552,232,279,41,677,137,1008,180,5106
"25009252502",3780,248,103,0,204,79,502,43,4959
"25009252601",5792,433,300,0,606,241,362,298,8032
"25009252602",3857,172,54,0,237,8,215,0,4543
"25009252603",2593,110,83,0,249,0,420,0,3455
"25009253100",4209,284,116,0,657,101,335,188,5890
"25009253201",2293,181,60,0,263,0,67,24,2888
"25009253202",4919,187,156,0,387,176,531,54,6410
"25009253203",3819,41,0,0,257,0,99,10,4226
"25009253204",4569,94,39,0,740,13,44,0,5499
"25009253205",3864,96,70,0,218,109,60,0,4417
"25009254100",5132,282,28,0,742,152,381,167,6884
"25009254200",3495,292,21,0,280,125,218,126,4557
"25009254301",3138,44,140,0,559,9,11,9,3910
"25009254302",3769,89,36,10,711,25,77,8,4725
"25009254401",2622,11,114,0,621,8,120,8,3504
"25009254402",5317,195,148,1,1138,16,86,1,6902
"25009254403",3279,199,31,0,431,1,184,0,4125
"25009260100",2599,715,127,31,1459,708,1575,818,8032
"25009260200",2220,590,95,26,272,103,370,308,3984
"25009260301",3748,606,12,0,6,19,39,57,4487
"25009260302",2360,137,0,0,244,0,0,0,2741
"25009260401",3446,89,11,0,302,0,164,0,4012
"25009260402",5015,97,110,14,457,34,522,14,6263
"25009260500",3228,238,76,18,280,0,233,92,4165
"25009260600",1821,680,63,0,781,144,913,398,4800
"25009260700",3243,446,115,43,481,156,635,379,5498
"25009260800",2692,930,249,8,1209,234,1665,645,7632
"25009260900",3694,435,0,0,550,94,916,152,5841
"25009261000",3066,237,77,15,363,19,213,0,3990
"25009261101",4125,130,104,9,112,0,181,0,4661
"25009261102",3812,254,226,17,338,85,250,94,5076
"25009262100",6188,306,21,0,0,0,134,0,6649
"25009263100",3937,369,0,2,62,0,0,149,4519
"25009264100",6518,140,45,0,61,41,175,0,6980
"25009265101",3647,67,0,0,129,0,29,0,3872
"25009265102",4181,154,39,0,162,0,56,0,4592
"25009266100",3690,130,0,0,61,0,52,0,3933
"25009266200",4821,248,106,0,265,12,17,6,5475
"25009266300",2909,102,12,0,462,0,165,0,3650
"25009266400",3262,192,14,10,33,0,0,8,3519
"25009267101",3103,402,13,0,209,43,18,0,3788
"25009267102",4255,254,61,0,101,0,34,12,4717
"25009268100",2505,20,0,0,34,3,28,3,2593
"25009268200",5345,334,75,0,252,48,121,25,6200
"25009268300",3486,497,33,1,85,1,158,2,4263
"25009268400",4172,384,16,0,57,2,96,26,4753
"25009269100",6371,311,0,20,75,0,34,0,6811
"25009270100",5292,528,63,1,22,0,51,0,5957
"25009990100",0,0,0,0,0,0,0,0,0
"25011040100",3820,505,14,4,140,36,48,12,4579
"25011040200",4008,210,5,7,112,44,141,39,4566
"25011040300",2779,116,1,1,97,0,70,0,3064
"25011040400",2833,329,104,2,89,38,68,15,3478
"25011040501",3565,655,51,4,61,15,24,0,4375
"25011040502",2907,282,0,0,125,0,81,10,3405
"25011040600",4134,315,36,44,145,44,94,54,4866
"25011040701",2992,846,4,12,132,238,249,108,4581
"25011040702",3436,284,30,11,184,54,35,12,4046
"25011040800",3690,762,43,21,466,45,168,34,5229
"25011040900",4417,288,27,0,261,23,84,28,5128
"25011041000",2577,315,0,0,154,33,50,10,3139
"25011041100",3115,292,0,5,69,68,81,4,3634
"25011041200",2651,308,60,0,37,5,90,47,3198
"25011041300",3655,739,31,32,176,55,161,123,4972
"25011041400",1716,419,46,82,111,176,140,255,2945
"25011041501",3088,193,6,5,77,14,23,0,3406
"25011041502",3484,335,5,0,44,10,8,0,3886
"25013800101",1915,687,428,224,272,551,652,848,5577
"25013800102",2261,1195,483,194,482,344,1238,1157,7354
"25013800201",3841,478,648,110,658,658,1814,725,8932
"25013800202",922,63,21,0,192,34,395,49,1676
"25013800300",1995,209,406,119,1013,474,1564,454,6234
"25013800400",2350,817,784,174,1042,415,1858,853,8293
"25013800500",1562,211,278,67,701,536,1365,695,5415
"25013800600",501,640,184,373,349,1040,879,1621,5587
"25013800700",946,779,295,432,779,852,1796,1854,7733
"25013800800",491,394,170,41,321,567,779,889,3652
"25013800900",860,1323,347,224,497,824,1273,2037,7385
"25013801101",543,692,73,181,115,423,458,1027,3512
"25013801102",411,189,89,56,178,154,168,282,1527
"25013801200",378,395,417,337,202,669,470,1009,3877
"25013801300",620,450,1197,526,1171,956,1140,1173,7233
"25013801401",144,488,1096,560,929,374,994,909,5494
"25013801402",742,90,623,74,495,73,431,106,2634
"25013801501",1814,331,2032,180,1059,461,1701,596,8174
"25013801502",1057,362,908,308,463,248,838,469,4653
"25013801503",1868,379,681,130,567,309,930,509,5373
"25013801601",1981,576,761,99,271,30,456,212,4386
"25013801602",2819,333,828,188,213,127,698,218,5424
"25013801603",2700,403,489,180,396,166,453,374,5161
"25013801604",3049,122,389,10,128,41,246,9,3994
"25013801605",2545,428,598,389,319,168,546,388,5381
"25013801700",559,718,2549,835,454,449,948,856,7368
"25013801800",347,336,1099,1014,359,793,511,1075,5534
"25013801901",673,637,613,171,983,925,1355,1221,6578
"25013801902",603,800,326,579,416,646,540,1369,5279
"25013802000",411,280,239,351,564,802,695,981,4323
"25013802100",3231,718,577,178,743,561,1661,829,8498
"25013802200",662,715,542,165,689,720,867,1178,5538
"25013802300",2360,877,772,481,1354,1186,1837,1434,10301
"25013802400",2661,193,511,14,250,22,523,163,4337
"25013802500",5541,246,530,36,295,0,830,67,7545
"25013802601",3456,718,1203,151,841,371,1709,611,9060
"25013802602",1545,120,31,6,183,9,28,5,1927
"25013810100",5686,486,0,1,18,13,95,0,6299
"25013810200",2410,263,10,0,39,0,0,0,2722
"25013810300",2449,452,41,0,61,11,136,66,3216
"25013810403",3425,688,45,12,83,42,84,33,4412
"25013810404",3581,86,53,1,59,14,182,14,3990
"25013810412",5464,141,0,0,102,0,108,0,5815
"25013810414",6242,170,64,0,60,55,335,0,6926
"25013810601",3546,264,109,1,315,14,583,69,4901
"25013810602",2285,66,18,0,58,0,15,0,2442
"25013810700",5038,790,265,101,419,232,457,403,7705
"25013810800",2789,393,34,45,321,259,479,267,4587
"25013810901",1064,270,68,73,106,120,168,169,2038
"25013810902",3014,391,8,45,370,95,675,374,4972
"25013811000",3837,286,17,0,341,42,523,51,5097
"25013811101",3537,545,191,90,333,301,862,506,6365
"25013811102",3739,590,74,0,1004,434,1377,547,7765
"25013811200",4641,181,0,0,576,0,835,1,6234
"25013811301",4431,540,223,0,126,162,249,415,6146
"25013811302",4537,411,99,249,205,88,38,130,5757
"25013811400",1085,1120,10,34,244,255,1169,1346,5263
"25013811500",548,1110,13,59,132,394,640,1424,4320
"25013811600",1128,1742,36,46,220,283,1224,1854,6533
"25013811700",917,1123,99,75,143,204,682,1134,4377
"25013811800",2542,1083,122,34,340,148,1556,966,6791
"25013811900",3205,182,81,0,93,17,280,17,3875
"25013812001",1560,861,61,110,176,142,508,628,4046
"25013812002",2799,482,66,190,501,289,1243,433,6003
"25013812101",4347,51,0,0,523,0,712,0,5633
"25013812103",1321,631,598,0,591,246,725,576,4688
"25013812104",3051,708,71,20,703,116,1136,515,6320
"25013812201",3407,98,202,163,1070,194,725,82,5941
"25013812202",2341,414,203,2,697,111,265,269,4302
"25013812300",3769,977,136,0,371,182,380,274,6089
"25013812401",5747,211,114,0,274,0,359,0,6705
"25013812403",3157,277,28,13,204,1,121,1,3802
"25013812404",3314,325,0,15,124,133,58,148,4117
"25013812500",6170,807,226,66,63,111,228,278,7949
"25013812600",5974,182,10,0,211,0,172,0,6549
"25013812701",2984,321,107,30,206,68,109,156,3981
"25013812702",3530,652,148,54,847,248,584,309,6372
"25013812800",6025,511,0,0,587,104,823,191,8241
"25013812901",2777,129,0,0,63,381,29,1,3380
"25013812902",3889,410,37,0,157,76,169,286,5024
"25013812903",67,7,0,0,0,0,0,0,74
"25013813000",6677,391,21,8,172,11,176,3,7459
"25013813101",5248,231,0,1,275,0,19,7,5781
"25013813102",3694,44,0,3,41,0,23,0,3805
"25013813204",2963,160,11,0,93,0,112,14,3353
"25013813205",6080,444,53,0,299,105,308,118,7407
"25013813206",3600,269,65,12,107,0,163,9,4225
"25013813207",3863,884,68,0,212,39,230,238,5534
"25013813208",2459,190,85,0,281,0,76,32,3123
"25013813209",4768,476,28,0,371,26,263,0,5932
"25013813301",6559,210,11,0,270,0,122,0,7172
"25013813303",3489,240,29,0,416,42,153,14,4383
"25013813304",3320,127,16,0,308,189,275,0,4235
"25013813401",4345,287,66,16,147,23,50,50,4984
"25013813403",3860,243,60,0,16,58,54,6,4297
"25013813404",5698,139,375,24,159,0,283,0,6678
"25013813500",4798,216,18,0,51,0,51,0,5134
"25013813601",6795,420,227,63,205,10,214,0,7934
"25013813602",6020,174,0,14,158,0,55,42,6463
"25013813701",3387,305,0,0,99,0,35,0,3826
"25013813702",4234,330,0,24,95,35,74,0,4792
"25013813801",3975,299,32,29,55,8,80,18,4496
"25013813802",3544,110,0,0,0,0,45,0,3699
"25015820101",5554,568,17,2,88,67,25,0,6321
"25015820102",2584,803,0,0,105,18,173,13,3696
"25015820202",1223,56,19,20,25,0,105,17,1465
"25015820203",7539,552,40,40,237,176,113,201,8898
"25015820204",5393,369,89,0,218,0,0,30,6099
"25015820300",2955,2116,306,0,790,383,278,54,6882
"25015820400",116,71,0,0,7,46,18,34,292
"25015820500",3169,1788,84,73,365,200,300,24,6003
"25015820600",55,0,0,0,5,18,0,0,78
"25015820700",2410,1264,42,33,854,179,247,312,5341
"25015820801",3320,708,129,254,477,556,441,20,5905
"25015820802",0,0,0,0,0,0,0,0,0
"25015820900",5836,365,0,0,48,0,302,16,6567
"25015821000",3775,294,16,0,221,12,82,127,4527
"25015821100",5707,599,338,62,17,1,286,30,7040
"25015821200",132,0,0,0,54,0,0,0,186
"25015821300",3521,339,80,0,45,106,42,118,4251
"25015821400",4547,319,42,62,108,0,236,11,5325
"25015821500",2799,365,40,2,87,0,14,26,3333
"25015821601",2130,293,13,33,656,230,328,249,3932
"25015821602",2941,492,59,54,189,181,378,76,4370
"25015821700",2832,311,17,22,163,136,98,95,3674
"25015821901",2396,258,0,14,144,50,30,17,2909
"25015821903",2089,728,92,50,216,72,150,109,3506
"25015821904",1955,312,38,0,98,0,118,27,2548
"25015822000",93,29,3,4,5,0,8,26,168
"25015822200",4835,393,48,0,464,10,144,77,5971
"25015822300",4748,411,0,1,226,29,116,105,5636
"25015822401",4886,217,0,2,446,0,295,2,5848
"25015822402",4005,495,102,16,307,167,200,0,5292
"25015822500",5523,269,17,21,115,0,6,12,5963
"25015822601",1673,160,69,0,87,39,8,39,2075
"25015822603",1469,73,0,0,29,9,56,20,1656
"25015822605",1119,87,0,0,13,2,10,0,1231
"25015822606",3352,295,12,0,75,0,124,0,3858
"25015822700",2830,174,38,2,103,17,22,12,3198
"25017300100",2896,187,17,0,27,14,49,0,3190
"25017301101",3612,188,0,0,158,33,31,0,4022
"25017301102",4728,161,7,0,179,25,82,13,5195
"25017310100",2270,645,269,79,750,644,473,860,5990
"25017310200",4303,377,476,0,1540,100,1103,70,7969
"25017310300",2963,522,439,210,1224,472,765,460,7055
"25017310400",1729,597,98,46,440,462,761,367,4500
"25017310500",1956,179,179,72,356,350,166,126,3384
"25017310601",3489,230,466,0,1593,124,755,46,6703
"25017310602",3555,250,44,52,937,496,504,427,6265
"25017310700",1474,421,228,39,1683,475,502,439,5261
"25017311100",699,251,122,2,888,539,457,289,3247
"25017311200",800,214,191,300,1504,417,457,200,4083
"25017311300",1431,301,271,3,1415,280,338,50,4089
"25017311400",2002,650,872,130,2218,334,556,99,6861
"25017311500",1052,79,153,0,1482,583,213,262,3824
"25017311600",2801,419,261,13,1693,91,470,173,5921
"25017311700",1646,290,84,41,2343,502,546,162,5614
"25017311800",1225,125,54,26,1323,499,420,85,3757
"25017311900",947,553,139,113,213,302,244,275,2786
"25017312000",1023,356,126,59,985,458,379,390,3776
"25017312100",1083,235,136,16,909,349,521,214,3463
"25017312200",1923,333,606,9,1487,178,576,94,5206
"25017312300",2982,380,0,0,1394,11,380,87,5234
"25017312400",1028,336,179,81,679,275,740,374,3692
"25017312501",3344,156,26,96,281,171,242,129,4445
"25017312502",3081,125,135,0,362,61,130,0,3894
"25017313101",5044,250,0,30,521,0,189,0,6034
"25017313102",5163,347,32,0,215,213,102,39,6111
"25017314101",4888,249,92,0,577,0,88,0,5894
"25017314102",5902,264,128,0,1004,64,342,80,7784
"25017314200",4958,418,144,4,29,0,145,0,5698
"25017314301",7158,262,436,0,529,123,661,0,9169
"25017314302",2650,71,51,21,234,46,143,77,3293
"25017315100",5683,132,101,19,332,0,216,21,6504
"25017315200",6529,242,334,0,399,0,61,0,7565
"25017315401",2879,274,0,6,266,17,57,9,3508
"25017315402",2705,104,37,0,72,0,80,0,2998
"25017315403",1546,45,5,0,49,0,11,0,1656
"25017315500",7018,302,0,0,139,29,45,0,7533
"25017316101",4533,55,27,0,222,10,217,0,5064
"25017316102",5925,798,0,0,198,11,125,0,7057
"25017316201",3771,209,26,0,104,13,36,0,4159
"25017316202",3710,142,53,39,490,0,81,0,4515
"25017316300",6521,452,204,30,829,17,16,0,8069
"25017316400",4838,224,157,0,355,71,205,28,5878
"25017316500",5656,174,86,0,434,19,210,41,6620
"25017317101",5320,224,0,0,475,62,227,85,6393
"25017317102",3600,166,0,0,583,65,246,0,4660
"25017317103",4615,93,17,0,314,65,8,0,5112
"25017317201",2503,60,0,0,191,0,37,0,2791
"25017317202",3245,82,64,0,226,0,67,0,3684
"25017317203",3567,82,11,0,448,28,31,0,4167
"25017317301",2291,67,0,2,424,5,177,0,2966
"25017317302",4721,196,50,0,498,0,59,0,5524
"25017318100",5267,80,0,0,1389,4,42,61,6843
"25017318200",3112,210,27,0,592,61,155,44,4201
"25017318300",6599,112,18,0,1204,24,164,0,8121
"25017318400",3225,76,83,0,630,58,139,0,4211
"25017320102",4629,82,28,0,611,11,103,0,5464
"25017320103",2332,121,14,0,291,0,37,0,2795
"25017320104",7051,113,68,3,144,4,105,4,7492
"25017321100",5088,347,165,22,1271,70,400,70,7433
"25017321200",5167,282,56,0,929,101,732,101,7368
"25017321300",5514,472,188,1,1427,285,1737,401,10025
"25017321400",2417,39,51,0,387,11,274,3,3182
"25017321500",5513,290,21,35,1272,157,690,114,8092
"25017321600",5281,449,232,22,906,271,381,59,7601
"25017322100",4354,58,0,0,310,42,70,8,4842
"25017322200",3360,105,34,17,318,37,63,0,3934
"25017322300",4861,506,78,0,642,0,248,125,6460
"25017322400",3887,466,43,10,281,0,184,10,4881
"25017323100",6251,207,0,0,378,0,232,0,7068
"25017324101",4104,242,20,0,159,0,10,0,4535
"25017324102",3875,84,0,0,528,25,84,0,4596
"25017325100",5923,894,235,16,528,73,131,280,8080
"25017326101",3634,195,31,0,158,0,35,0,4053
"25017326102",6255,157,82,0,365,54,143,0,7056
"25017327101",3726,93,19,0,188,0,79,0,4105
"25017327102",3767,251,55,4,98,4,202,29,4410
"25017327103",3178,229,0,0,161,0,39,0,3607
"25017328100",3087,44,0,0,168,0,9,0,3308
"25017330100",7104,253,24,0,723,8,104,0,8216
"25017330200",5892,407,104,5,599,0,154,0,7161
"25017331101",3008,59,68,0,259,0,51,0,3445
"25017331102",6144,138,60,0,439,0,41,0,6822
"25017331200",4580,256,15,0,374,0,55,5,5285
"25017331300",6686,48,51,2,410,0,222,0,7419
"25017332100",5116,2,43,0,831,0,53,0,6045
"25017332200",5837,595,468,0,1368,80,231,118,8697
"25017332300",5033,206,336,0,1140,93,44,0,6852
"25017332400",3114,173,86,0,574,34,53,0,4034
"25017333100",6370,217,629,0,757,0,354,0,8327
"25017333200",4341,382,60,87,113,0,272,28,5283
"25017333300",3184,175,211,40,403,21,165,69,4268
"25017333400",5073,400,79,38,588,14,208,0,6400
"25017333501",4472,161,34,1,269,129,88,23,5177
"25017333502",2771,193,85,9,127,23,199,41,3448
"25017333600",5124,222,213,336,1081,166,175,27,7344
"25017334100",6343,182,106,0,363,84,401,0,7479
"25017334200",3484,68,0,0,289,0,112,0,3953
"25017334300",7276,84,107,0,200,0,72,0,7739
"25017334400",5718,175,66,0,463,0,114,0,6536
"25017335100",5167,179,24,3,169,15,55,15,5627
"25017335200",5308,269,0,0,341,0,218,0,6136
"25017335301",3439,254,53,0,145,253,60,0,4204
"25017335302",4842,120,14,0,170,3,128,4,5281
"25017335400",4443,57,35,0,159,29,155,29,4907
"25017336100",4743,168,384,17,202,39,206,0,5759
"25017336200",5624,194,11,0,117,4,102,0,6052
"25017336300",6023,89,49,0,505,0,314,0,6980
"25017336401",3542,215,91,9,400,25,298,0,4580
"25017336402",4278,199,76,75,165,18,121,18,4950
"25017337101",2812,234,75,1,81,114,49,11,3377
"25017337102",4497,87,74,11,163,0,80,13,4925
"25017337201",2742,67,13,0,93,124,0,42,3081
"25017337202",4791,39,30,0,32,0,156,19,5067
"25017337300",4624,171,106,0,390,125,141,106,5663
"25017338100",2237,9,36,0,750,0,22,0,3054
"25017338200",2788,66,44,0,824,54,44,0,3820
"25017338300",2878,11,25,1,181,22,56,1,3175
"25017338400",4835,230,41,0,628,0,42,0,5776
"25017338500",5365,174,23,1,342,83,151,11,6150
"25017339100",4945,448,81,82,353,32,69,0,6010
"25017339200",5031,111,0,0,245,31,112,17,5547
"25017339300",1651,125,877,34,246,17,44,0,2994
"25017339400",2297,439,59,42,222,83,96,207,3445
"25017339500",2846,401,448,0,344,12,46,0,4097
"25017339600",3520,773,855,25,327,80,46,0,5626
"25017339700",2824,322,346,180,451,81,170,44,4418
"25017339801",2978,299,335,0,1028,113,473,16,5242
"25017339802",2435,433,243,277,713,74,193,85,4453
"25017339900",3765,757,442,3,257,4,436,76,5740
"25017340000",1805,158,117,28,456,57,58,0,2679
"25017340100",5014,219,601,0,754,0,291,0,6879
"25017341101",1891,97,74,37,1124,266,181,6,3676
"25017341102",2351,178,228,177,1068,570,266,87,4925
"25017341200",2995,717,497,112,2351,863,525,362,8422
"25017341300",1722,658,181,190,2159,608,189,88,5795
"25017341400",2960,344,962,145,1266,135,566,0,6378
"25017341500",2072,276,1472,103,1259,580,936,144,6842
"25017341600",3740,337,360,333,1566,162,468,0,6966
"25017341700",2864,192,684,0,876,343,189,67,5215
"25017341800",3121,748,508,408,1105,519,1130,185,7724
"25017341901",1003,214,136,0,167,0,327,0,1847
"25017341902",4669,460,1058,298,1559,32,934,59,9069
"25017342101",2138,702,602,18,645,261,604,436,5406
"25017342102",2534,321,203,212,348,67,499,223,4407
"25017342201",3021,369,371,206,716,196,788,216,5883
"25017342202",2836,177,585,146,494,0,579,87,4904
"25017342300",3738,623,1224,130,1352,221,1454,156,8898
"25017342400",3531,667,1467,82,852,195,1472,130,8396
"25017342500",4456,504,1191,0,696,1,1015,117,7980
"25017342600",2133,355,652,31,904,365,811,314,5565
"25017350103",1047,81,151,0,22,12,0,0,1313
"25017350104",3275,450,1226,983,1278,298,774,250,8534
"25017350200",4377,358,448,32,708,159,340,0,6422
"25017350300",1826,84,176,21,300,41,100,0,2548
"25017350400",4081,792,170,0,323,28,322,51,5767
"25017350500",1289,73,20,10,133,11,48,3,1587
"25017350600",1475,440,18,10,334,55,51,0,2383
"25017350700",4322,657,462,411,482,476,75,360,7245
"25017350800",1553,125,48,0,265,34,133,17,2175
"25017350900",2746,212,68,0,321,34,87,23,3491
"25017351000",4874,1298,107,77,804,273,318,252,8003
"25017351100",4280,380,25,15,802,270,288,24,6084
"25017351203",2765,408,40,18,817,133,313,104,4598
"25017351204",2709,547,98,21,631,149,81,213,4449
"25017351300",2970,450,56,52,418,160,248,18,4372
"25017351403",2482,323,264,241,470,66,885,215,4946
"25017351404",2272,357,194,37,911,147,820,120,4858
"25017351500",1446,201,182,15,653,113,465,105,3180
"25017352101",660,264,149,6,639,255,147,156,2276
"25017352102",1694,204,36,46,470,60,113,37,2660
"25017352200",1018,187,207,26,321,106,57,50,1972
"25017352300",1782,404,176,11,869,167,215,159,3783
"25017352400",623,205,396,205,394,175,196,73,2267
"25017352500",1786,267,247,161,359,0,86,24,2930
"25017352600",1293,344,204,154,366,287,73,45,2766
"25017352700",1197,179,420,106,298,61,188,48,2497
"25017352800",1508,210,79,4,500,27,152,51,2531
"25017352900",2221,111,42,24,316,141,80,0,2935
"25017353000",1989,364,285,105,437,293,147,124,3744
"25017353101",996,330,144,46,307,137,148,131,2239
"25017353102",313,39,0,0,118,159,15,0,644
"25017353200",2514,254,260,162,374,111,224,60,3959
"25017353300",2461,158,227,43,394,29,123,13,3448
"25017353400",1260,192,718,88,778,12,295,9,3352
"25017353500",1281,213,216,628,434,11,29,11,2823
"25017353600",2116,131,171,0,431,162,226,43,3280
"25017353700",1820,264,13,124,393,153,111,123,3001
"25017353800",3015,512,98,42,769,187,358,31,5012
"25017353900",1356,425,66,61,801,94,109,230,3142
"25017354000",2037,231,27,0,557,105,109,0,3066
"25017354100",1888,75,33,0,322,32,77,17,2444
"25017354200",2786,155,30,30,220,0,96,0,3317
"25017354300",1776,289,300,51,882,221,73,181,3773
"25017354400",1378,91,59,6,151,43,56,26,1810
"25017354500",1521,228,106,12,209,20,132,0,2228
"25017354600",2903,229,996,274,526,1,47,68,5044
"25017354700",2001,82,179,41,256,0,132,0,2691
"25017354800",1641,87,77,0,198,19,123,2,2147
"25017354900",2328,119,1283,543,1204,458,415,75,6425
"25017355000",2048,137,380,44,206,107,299,60,3281
"25017356100",2537,111,0,0,435,9,145,0,3237
"25017356300",3942,116,318,0,561,86,585,20,5628
"25017356400",5913,262,161,0,664,24,132,0,7156
"25017356500",6193,155,1,10,685,0,100,14,7158
"25017356601",3443,99,17,10,583,16,191,0,4359
"25017356602",3348,128,26,0,524,23,144,9,4202
"25017356701",4724,389,104,0,1026,87,118,0,6448
"25017356702",5501,226,180,46,668,131,167,21,6940
"25017357100",3499,83,167,0,673,24,128,0,4574
"25017357200",2666,78,6,10,493,0,252,8,3513
"25017357300",2521,54,43,15,329,107,93,0,3162
"25017357400",1954,72,18,0,177,11,120,0,2352
"25017357500",1578,35,55,17,483,199,64,5,2436
"25017357600",1892,61,50,0,321,82,164,3,2573
"25017357700",2588,177,102,13,422,171,312,17,3802
"25017357800",3016,212,76,9,316,16,82,37,3764
"25017358100",3781,70,77,11,932,0,90,0,4961
"25017358300",4018,112,105,0,1348,163,76,0,5822
"25017358400",3650,198,43,0,1104,53,187,0,5235
"25017358500",3144,361,50,0,1466,93,37,2,5153
"25017358600",4107,117,0,45,1714,67,148,0,6198
"25017358700",3659,96,17,2,1284,0,37,0,5095
"25017359100",5190,168,18,0,845,52,484,34,6791
"25017359300",5612,249,195,0,922,86,71,0,7135
"25017360100",1427,96,95,0,192,0,296,0,2106
"25017360200",4385,110,189,1,592,73,150,62,5562
"25017361100",4941,320,7,0,378,0,112,0,5758
"25017361200",4601,285,31,0,593,31,123,19,5683
"25017361300",4997,195,10,3,478,3,51,2,5739
"25017362100",4111,245,36,14,547,14,69,0,5036
"25017363102",3658,282,114,0,1745,0,21,0,5820
"25017363103",2562,46,0,0,875,0,17,0,3500
"25017363104",4763,82,0,4,1341,38,264,22,6514
"25017363201",2642,80,0,0,581,22,67,2,3394
"25017363202",2949,74,0,33,585,21,46,0,3708
"25017364101",4515,217,0,0,304,157,163,0,5356
"25017364102",4014,299,38,239,434,50,170,50,5294
"25017365100",6983,56,0,0,810,0,101,0,7950
"25017365201",4987,83,0,0,518,99,169,0,5856
"25017365202",3779,100,0,0,573,0,82,14,4548
"25017366100",3533,167,118,0,625,133,64,0,4640
"25017366201",3199,36,0,0,278,0,102,9,3624
"25017366202",4351,215,1,2,557,12,153,3,5294
"25017367100",3279,97,43,28,547,2,176,0,4172
"25017367200",5597,166,151,9,1038,15,242,17,7235
"25017368101",4195,241,74,84,875,303,181,0,5953
"25017368102",2576,47,256,6,799,8,181,9,3882
"25017368200",3223,155,271,2,506,96,207,77,4537
"25017368300",3956,288,402,9,731,153,1406,135,7080
"25017368400",3965,189,263,334,334,423,281,16,5805
"25017368500",1719,360,200,15,423,99,659,90,3565
"25017368600",3554,575,88,0,1070,271,1193,416,7167
"25017368700",1571,389,144,109,172,93,695,211,3384
"25017368800",2820,374,288,7,956,66,967,271,5749
"25017368901",3706,237,211,10,613,18,146,89,5030
"25017368902",1890,162,338,47,1071,259,229,240,4236
"25017369000",916,112,78,7,209,79,33,26,1460
"25017369100",4357,54,32,0,317,56,335,18,5169
"25017370101",5612,382,181,0,595,30,601,62,7463
"25017370102",5348,596,250,0,788,153,602,117,7854
"25017370201",2967,150,81,2,513,65,114,1,3893
"25017370202",3637,89,95,0,528,35,416,18,4818
"25017370300",3635,549,258,0,782,0,327,45,5596
"25017370400",4022,280,138,33,674,15,415,15,5592
"25017373100",3370,353,222,66,654,18,189,17,4889
"25017373200",3208,400,161,0,597,90,358,183,4997
"25017373300",2155,120,178,15,166,52,27,0,2713
"25017373400",2716,95,11,0,460,165,100,0,3547
"25017373500",4407,159,106,0,665,13,175,13,5538
"25017373600",2169,227,90,0,158,24,123,5,2796
"25017373700",3074,55,29,0,510,18,61,0,3747
"25017373800",3793,358,36,0,1105,28,151,186,5657
"25017373900",4992,301,254,0,1178,0,342,0,7067
"25017374000",3070,85,27,305,956,29,126,0,4598
"25017374100",2824,126,29,126,1021,299,138,8,4571
"25017374200",3493,92,110,12,655,0,138,0,4500
"25017374300",2906,114,58,1,431,1,124,0,3635
"25017374400",4672,157,179,1,861,16,256,16,6158
"25017374500",3309,71,233,6,708,23,160,23,4533
"25017374600",3889,117,89,0,757,58,674,15,5599
"25017374700",3550,153,114,32,1100,18,322,11,5300
"25017374800",2677,54,7,0,510,10,65,0,3323
"25017382100",4052,155,48,0,494,0,119,0,4868
"25017382200",4471,66,108,0,652,17,221,0,5535
"25017382300",4783,320,114,14,451,18,129,0,5829
"25017382400",4247,242,21,0,235,19,173,0,4937
"25017382500",3887,109,112,39,401,0,176,0,4724
"25017382601",3098,154,0,2,1012,120,118,0,4504
"25017382602",3690,40,52,1,619,30,114,10,4556
"25017383101",1378,484,241,156,580,297,428,373,3937
"25017383102",1924,946,601,237,1114,333,2057,821,8033
"25017383200",3398,520,455,171,1220,259,1152,565,7740
"25017383300",2291,203,26,4,223,62,240,78,3127
"25017383400",3728,295,407,134,779,14,464,201,6022
"25017383501",2281,522,365,23,1534,144,526,249,5644
"25017383502",1659,156,117,0,269,2,215,0,2418
"25017383600",3655,300,245,638,949,28,466,210,6491
"25017383700",4891,149,18,0,177,14,260,0,5509
"25017383800",4633,94,120,27,464,1,433,1,5773
"25017383901",6314,224,447,102,644,1,159,16,7907
"25017383902",4307,109,393,0,525,8,132,0,5474
"25017384001",1176,42,32,0,247,1,58,0,1556
"25017384002",3213,544,262,223,1774,41,348,81,6486
"25017385100",5545,136,166,0,589,7,139,13,6595
"25017385201",1932,281,55,0,130,47,119,18,2582
"25017385202",6556,192,241,17,1044,0,240,0,8290
"25017386100",3907,46,0,0,208,39,42,0,4242
"25017387100",3796,205,70,3,181,7,69,4,4335
"25017387201",5292,143,28,1,206,50,130,0,5850
"25017387202",3716,122,0,0,126,24,146,0,4134
"25017388100",3859,149,19,0,1000,75,27,0,5129
"25017388200",4317,552,97,96,541,37,393,64,6097
"25017388300",1109,786,142,179,929,1395,552,1395,6487
"25017980000",0,0,0,0,0,0,0,0,0
"25019950100",1113,88,11,0,210,0,18,0,1440
"25019950200",3541,455,671,150,204,60,233,158,5472
"25019950307",331,7,0,0,5,2,0,0,345
"25019950400",1890,22,0,0,280,0,280,0,2472
"25019950500",1080,137,0,2,6,24,30,12,1291
"25019990000",0,0,0,0,0,0,0,0,0
"25021400100",3086,741,58,21,593,166,181,164,5010
"25021400200",3239,745,83,50,1147,289,279,66,5898
"25021400300",3194,320,0,2,656,122,216,1,4511
"25021400400",3970,803,78,0,756,102,337,78,6124
"25021400500",3460,581,81,15,911,137,173,30,5388
"25021400600",3701,420,36,0,1009,16,308,15,5505
"25021400700",2510,107,32,0,637,98,96,19,3499
"25021400800",3313,454,78,0,1061,150,273,27,5356
"25021400900",2584,156,235,156,705,250,399,23,4508
"25021401000",2176,245,146,94,283,187,138,11,3280
"25021401100",3792,106,26,13,595,20,230,0,4782
"25021401200",4897,135,188,0,1391,85,135,0,6831
"25021402101",2958,264,312,0,151,26,96,0,3807
"25021402102",2979,249,285,35,302,153,241,158,4402
"25021402200",1760,22,194,0,170,0,213,0,2359
"25021402300",3662,26,90,0,336,4,168,0,4286
"25021402400",5190,151,426,6,501,29,477,43,6823
"25021402500",3503,81,49,1,149,12,84,1,3880
"25021403100",6107,205,52,0,383,2,264,1,7014
"25021403300",3732,57,0,0,206,0,51,0,4046
"25021403400",5049,179,144,51,804,58,77,71,6433
"25021403500",4829,93,109,149,809,21,144,4,6158
"25021404100",2932,61,96,0,966,122,176,52,4405
"25021404201",3556,69,0,0,184,1,66,0,3876
"25021404202",2836,78,11,1,175,10,33,1,3145
"25021404301",4533,172,19,7,615,55,60,42,5503
"25021404302",2893,113,0,0,466,0,205,8,3685
"25021404400",3896,69,67,20,243,67,284,10,4656
"25021405100",4955,17,204,0,551,0,153,9,5889
"25021406101",5035,216,0,0,346,0,55,0,5652
"25021406102",5728,298,0,0,575,0,478,0,7079
"25021407100",7150,490,0,0,300,15,251,30,8236
"25021408101",7226,286,0,0,479,28,467,17,8503
"25021408102",4501,66,29,8,222,8,10,0,4844
"25021409101",3958,199,0,1,63,0,18,0,4239
"25021409102",4771,213,20,0,97,12,42,7,5162
"25021410100",5286,248,43,0,183,0,38,13,5811
"25021410300",4184,75,69,12,354,0,77,0,4771
"25021410400",5824,371,85,16,348,0,258,14,6916
"25021411100",7217,167,344,78,274,0,105,0,8185
"25021411200",6153,165,0,46,674,76,106,0,7220
"25021411301",4985,158,94,0,55,0,21,12,5325
"25021411302",3043,120,0,0,272,0,71,0,3506
"25021412100",5670,229,0,0,406,0,195,0,6500
"25021412200",3205,106,9,0,170,0,48,0,3538
"25021412300",4314,75,36,0,561,1,164,0,5151
"25021413100",5169,282,133,0,352,63,110,121,6230
"25021413200",4858,508,0,63,310,0,17,1,5757
"25021413300",4362,260,124,0,232,43,173,132,5326
"25021413401",2630,170,129,0,43,6,175,6,3159
"25021413402",2628,202,213,43,1165,54,102,0,4407
"25021413500",2487,251,535,0,669,379,126,405,4852
"25021414100",3917,50,132,0,1135,34,191,0,5459
"25021414200",5162,89,391,18,1699,39,191,17,7606
"25021414300",4079,243,210,0,622,0,52,0,5206
"25021415101",3584,147,218,77,501,104,223,0,4854
"25021415102",6287,496,476,88,689,19,362,0,8417
"25021415200",4247,287,413,62,380,0,288,0,5677
"25021415300",3225,70,19,0,310,0,0,0,3624
"25021416101",4633,282,172,43,426,0,103,26,5685
"25021416102",1860,60,188,0,234,0,42,7,2391
"25021416200",3358,298,2184,35,650,57,259,104,6945
"25021416300",3491,118,778,111,261,17,334,11,5121
"25021416400",5753,38,29,0,352,62,262,0,6496
"25021417100",2906,109,95,1,1257,134,69,1,4572
"25021417200",3684,407,425,150,2992,411,86,41,8196
"25021417300",2090,149,159,0,410,10,105,0,2923
"25021417400",2006,149,48,17,89,0,40,17,2366
"25021417501",2691,118,47,0,1676,322,67,68,4989
"25021417502",1691,208,263,1,2263,412,12,9,4859
"25021417601",2968,129,170,0,1616,85,70,0,5038
"25021417602",2897,336,70,0,1191,511,21,1,5027
"25021417701",2920,265,127,0,1743,113,46,0,5214
"25021417702",2008,206,390,37,259,8,65,8,2981
"25021417801",4438,89,64,0,213,0,171,0,4975
"25021417802",926,531,147,56,950,424,5,111,3150
"25021417901",3775,735,574,0,1210,139,203,65,6701
"25021417902",2178,299,138,61,878,53,73,23,3703
"25021418002",3952,102,291,29,2095,222,192,0,6883
"25021418003",1458,272,116,0,826,57,242,0,2971
"25021418004",2451,409,223,71,1058,154,76,44,4486
"25021418101",2880,342,436,60,1098,0,82,20,4918
"25021418102",2295,86,204,29,521,113,384,0,3632
"25021418200",4066,504,701,1,1442,33,315,83,7145
"25021419100",4739,94,321,0,340,84,139,0,5717
"25021419200",4208,164,243,63,538,12,236,12,5476
"25021419300",2504,343,385,106,487,107,104,11,4047
"25021419400",2961,157,0,0,311,16,38,7,3490
"25021419500",2368,24,112,1,323,0,73,0,2901
"25021419600",5657,276,418,0,667,140,231,0,7389
"25021419700",2970,153,0,0,491,0,16,0,3630
"25021419800",3677,154,30,0,341,8,117,3,4330
"25021420100",3302,292,2254,701,1007,370,134,244,8304
"25021420201",1259,133,923,490,504,63,164,10,3546
"25021420202",2282,101,2616,444,1170,0,256,38,6907
"25021420301",3159,167,2157,101,848,120,768,44,7364
"25021420302",2359,255,4172,351,995,157,395,120,8804
"25021421100",3953,426,555,93,223,36,576,18,5880
"25021421200",4652,310,239,8,323,16,307,0,5855
"25021422100",4869,233,222,24,553,33,107,17,6058
"25021422200",6296,299,174,0,231,55,67,0,7122
"25021422301",2928,48,18,0,122,0,48,0,3164
"25021422302",5022,141,391,0,583,0,0,23,6160
"25021422400",5547,690,566,42,416,40,355,0,7656
"25021422501",3675,379,376,0,381,188,217,61,5277
"25021422502",3556,696,185,0,915,52,113,41,5558
"25021422600",6012,306,63,2,536,0,226,85,7230
"25021422700",3237,145,0,0,138,0,24,0,3544
"25021422800",3617,138,5,0,120,49,0,7,3936
"25021423100",7608,329,13,0,91,0,44,0,8085
"25021440100",7624,454,22,0,481,0,28,0,8609
"25021441202",2764,75,4,3,33,0,55,0,2934
"25021441203",3366,237,4,0,51,0,23,0,3681
"25021441204",4129,260,0,0,40,0,14,19,4462
"25021442101",4640,78,62,0,188,1,41,0,5010
"25021442102",6490,132,63,0,372,12,180,0,7249
"25021442103",6513,18,31,0,668,0,208,0,7438
"25021442201",3621,65,78,0,204,0,74,0,4042
"25021442202",7031,857,0,1,221,19,365,77,8571
"25021443101",7130,53,50,0,462,0,179,0,7874
"25021443102",8046,413,50,0,295,28,54,18,8904
"25021456101",3322,60,430,0,106,32,37,0,3987
"25021456102",3778,260,473,0,256,149,143,156,5215
"25021456200",2196,100,576,39,342,12,48,12,3325
"25021456301",1069,413,97,0,100,9,17,0,1705
"25021456302",3733,510,679,20,223,0,0,80,5245
"25021456401",2185,125,223,42,206,20,95,0,2896
"25021456402",4699,68,395,0,410,83,137,83,5875
"25021457100",3440,47,601,0,333,0,146,0,4567
"25021457200",5097,87,61,0,362,1,102,0,5710
"25023500101",3226,326,49,0,298,0,235,0,4134
"25023500103",2130,83,0,0,58,0,0,0,2271
"25023500104",3811,179,30,0,116,18,86,0,4240
"25023501101",3029,193,0,0,31,10,41,0,3304
"25023501102",7466,264,70,2,451,7,0,0,8260
"25023501201",3508,79,0,0,86,8,86,7,3774
"25023501202",6562,307,13,0,192,6,69,0,7149
"25023502101",5512,148,135,7,280,41,60,0,6183
"25023502102",4783,223,384,0,195,50,73,0,5708
"25023502200",4953,448,164,0,111,0,68,0,5744
"25023503101",6773,453,0,0,148,0,92,0,7466
"25023503102",6103,149,36,0,319,0,0,0,6607
"25023504101",4909,113,3,0,293,0,73,0,5391
"25023504102",4958,103,0,0,42,24,15,24,5166
"25023505101",5964,130,17,0,342,0,97,0,6550
"25023505102",4799,113,0,4,117,0,51,0,5084
"25023505200",5944,178,13,61,338,50,98,0,6682
"25023506101",6180,318,0,11,239,12,0,12,6772
"25023506102",5353,107,0,0,359,170,90,17,6096
"25023506202",2255,207,0,0,67,0,11,0,2540
"25023506203",4548,115,13,0,201,64,100,0,5041
"25023506204",4797,336,8,0,22,35,14,0,5212
"25023507101",4914,136,91,0,90,0,165,0,5396
"25023507103",4195,166,0,2,66,0,25,0,4454
"25023507104",5143,178,18,4,104,0,0,0,5447
"25023508101",6064,177,52,0,349,103,210,58,7013
"25023508102",4748,199,0,0,135,11,92,10,5195
"25023508200",5762,253,0,0,116,0,49,0,6180
"25023509101",5611,454,0,8,328,0,144,0,6545
"25023509102",5753,78,249,0,111,0,124,0,6315
"25023510100",3489,28,617,93,277,0,192,0,4696
"25023510200",3636,842,1542,301,444,10,1129,157,8061
"25023510300",622,366,1643,460,676,214,458,155,4594
"25023510400",578,142,1660,414,475,142,290,89,3790
"25023510501",1433,186,858,176,236,64,54,41,3048
"25023510502",1899,222,2326,248,588,82,645,10,6020
"25023510503",1453,350,1421,373,252,35,270,63,4217
"25023510600",1899,34,463,124,243,17,119,0,2899
"25023510700",2457,361,1424,334,508,383,372,284,6123
"25023510800",549,675,2149,1478,847,200,245,370,6513
"25023510900",174,593,412,740,188,111,79,308,2605
"25023511000",811,377,1393,261,219,201,116,189,3567
"25023511100",2958,416,1285,62,528,107,209,0,5565
"25023511200",2167,461,1774,252,405,146,321,203,5729
"25023511301",2049,160,1868,430,959,156,489,32,6143
"25023511302",1969,189,907,238,267,101,402,59,4132
"25023511400",972,258,1779,269,679,56,389,32,4434
"25023511500",957,165,1854,360,746,223,427,225,4957
"25023511600",2498,569,2088,651,629,156,423,232,7246
"25023511701",2824,156,878,293,279,13,90,0,4533
"25023511702",1958,66,442,17,358,5,170,7,3023
"25023520100",6165,147,0,0,134,0,0,0,6446
"25023520201",3311,185,50,0,206,12,29,0,3793
"25023520202",5071,126,328,0,251,0,252,0,6028
"25023521101",4006,194,34,0,111,33,79,33,4490
"25023521102",3098,126,0,0,117,48,90,36,3515
"25023521201",2502,258,0,14,95,82,0,5,2956
"25023521202",3698,129,50,7,37,0,25,14,3960
"25023522101",4299,196,172,3,45,9,70,0,4794
"25023522102",5185,175,16,0,192,8,141,0,5717
"25023523100",2884,120,18,0,153,20,71,20,3286
"25023523201",2697,53,7,0,108,0,33,0,2898
"25023523202",7440,244,11,0,93,19,112,0,7919
"25023524101",2511,44,210,0,110,0,104,0,2979
"25023524102",3309,138,197,53,149,40,124,45,4055
"25023525101",5185,586,410,45,277,0,14,0,6517
"25023525104",5334,350,8,19,144,61,79,190,6185
"25023525203",4852,404,206,0,88,15,104,0,5669
"25023525204",3165,13,378,19,76,0,13,0,3664
"25023525300",0,0,0,0,0,0,0,0,0
"25023526100",7148,145,0,0,228,0,282,0,7803
"25023530100",3146,161,36,103,239,72,244,10,4011
"25023530200",3109,407,59,6,150,11,91,20,3853
"25023530300",3337,380,42,1,166,0,35,5,3966
"25023530400",5250,140,35,1,269,0,77,0,5772
"25023530500",4168,430,95,28,263,100,0,0,5084
"25023530600",4410,285,235,0,210,0,28,0,5168
"25023530700",4163,273,0,0,9,0,23,0,4468
"25023530801",5046,254,0,0,155,9,147,9,5620
"25023530802",4820,415,26,3,40,9,94,2,5409
"25023530901",7525,214,48,0,503,0,156,0,8446
"25023530902",3910,452,72,0,124,0,9,0,4567
"25023540101",3728,196,38,7,55,0,0,0,4024
"25023540102",2455,102,0,7,38,0,103,7,2712
"25023540103",3883,109,35,0,90,67,67,25,4276
"25023541100",4625,290,41,0,325,67,92,1,5441
"25023542101",6937,224,135,0,174,0,152,0,7622
"25023542102",2113,92,79,40,0,0,5,0,2329
"25023542200",5555,159,183,0,157,0,18,0,6072
"25023542300",5595,1143,42,16,209,189,148,36,7378
"25023543100",2677,101,0,0,56,6,52,0,2892
"25023544100",4961,376,94,0,171,21,0,12,5635
"25023544200",5396,228,183,0,103,0,21,0,5931
"25023545100",6026,229,123,15,736,73,259,19,7480
"25023545200",4306,579,121,2,622,24,55,0,5709
"25023545300",3049,364,23,1,231,137,12,0,3817
"25023545400",4031,648,96,36,455,51,28,16,5361
"25023560100",5687,293,31,0,127,0,9,0,6147
"25023561100",4289,147,6,53,299,24,73,0,4891
"25023561200",207,82,0,0,21,0,0,0,310
"25023990003",0,0,0,0,0,0,0,0,0
"25025000100",2072,354,115,57,513,144,655,48,3958
"25025000201",2312,209,63,74,293,122,194,114,3381
"25025000202",1815,307,167,199,709,285,275,275,4032
"25025000301",1670,255,18,12,314,61,124,52,2506
"25025000302",1610,322,52,62,355,196,11,0,2608
"25025000401",2934,756,103,32,755,494,347,157,5578
"25025000402",1544,535,19,46,701,103,207,45,3200
"25025000502",1568,679,22,1,277,166,104,88,2905
"25025000503",1105,412,31,0,163,133,53,52,1949
"25025000504",2357,999,129,32,396,255,186,149,4503
"25025000601",1736,506,18,13,639,157,105,154,3328
"25025000602",1535,791,275,101,550,191,250,291,3984
"25025000701",1725,448,145,137,499,468,232,108,3762
"25025000703",695,677,25,207,258,250,72,77,2261
"25025000704",2209,660,250,103,676,407,188,280,4773
"25025000802",2779,1615,254,257,1530,476,1063,537,8511
"25025000803",505,253,110,46,309,192,137,117,1669
"25025010103",228,112,13,22,138,150,49,58,770
"25025010104",1804,367,29,35,199,333,153,124,3044
"25025010203",2024,1432,85,112,427,523,217,347,5167
"25025010204",637,371,12,0,386,299,26,28,1759
"25025010300",172,82,35,10,115,30,104,11,559
"25025010403",1015,890,77,39,478,427,180,194,3300
"25025010404",709,1623,122,58,256,327,105,166,3366
"25025010405",579,399,81,115,141,312,148,56,1831
"25025010408",966,165,48,7,156,165,59,29,1595
"25025010500",1248,633,270,26,292,312,102,191,3074
"25025010600",2106,264,88,93,204,68,77,51,2951
"25025010701",1963,193,10,0,428,22,133,9,2758
"25025010702",1968,164,30,11,78,3,62,63,2379
"25025010801",2502,131,0,2,266,19,88,32,3040
"25025010802",2336,242,3,0,214,23,96,69,2983
"25025020101",3589,182,69,0,281,0,0,18,4139
"25025020200",2785,529,79,17,396,102,244,58,4210
"25025020301",1546,157,29,0,627,140,28,2,2529
"25025020302",900,121,0,15,28,4,18,6,1092
"25025020303",1579,276,35,59,771,208,208,169,3305
"25025030100",1757,332,0,0,48,49,29,0,2215
"25025030200",1408,214,7,18,80,27,121,28,1903
"25025030300",3438,631,135,149,552,120,241,139,5405
"25025030400",2172,249,13,2,152,0,66,0,2654
"25025030500",2247,173,0,9,184,35,21,1,2670
"25025040100",2201,49,0,0,58,0,137,10,2455
"25025040200",930,86,181,145,159,412,380,254,2547
"25025040300",3346,177,13,241,84,244,32,90,4227
"25025040401",1668,332,101,0,271,140,0,110,2622
"25025040600",2420,208,81,4,135,2,91,1,2942
"25025040801",1920,193,356,570,474,614,584,175,4886
"25025050101",2357,835,216,26,1700,417,2426,1025,9002
"25025050200",2864,255,203,9,1712,429,3095,614,9181
"25025050300",820,405,191,203,416,324,602,501,3462
"25025050400",1803,131,55,17,400,99,1289,163,3957
"25025050500",1364,277,23,0,392,145,1063,237,3501
"25025050600",1185,204,27,18,797,153,1566,266,4216
"25025050700",2064,629,42,76,1614,513,2475,1028,8441
"25025050901",2053,625,96,0,1735,436,2681,848,8474
"25025051000",2646,629,31,65,1277,7,1689,336,6680
"25025051101",3707,556,156,175,1003,675,1934,675,8881
"25025051200",1323,314,79,70,578,218,621,258,3461
"25025060101",3133,369,0,0,104,24,79,24,3733
"25025060200",1997,143,0,1,91,22,10,2,2266
"25025060301",2909,220,0,2,39,3,29,0,3202
"25025060400",4335,427,63,0,55,35,57,65,5037
"25025060501",3334,191,15,10,150,106,75,81,3962
"25025060600",2097,120,1,5,315,0,33,0,2571
"25025060700",321,329,506,182,544,399,430,361,3072
"25025060800",3745,297,0,0,385,81,12,0,4520
"25025061000",1076,571,162,289,571,566,270,599,4104
"25025061101",310,352,84,421,498,604,419,564,3252
"25025061200",2918,216,102,35,108,77,103,13,3572
"25025070101",2685,441,45,97,871,479,162,71,4851
"25025070200",449,108,92,8,1765,1198,19,36,3675
"25025070300",3230,443,100,0,610,117,103,227,4830
"25025070402",63,79,24,116,634,644,20,42,1622
"25025070500",3626,321,172,164,1279,390,627,282,6861
"25025070600",1920,60,53,3,339,2,50,0,2427
"25025070700",1421,171,960,41,341,53,153,47,3187
"25025070800",2218,474,444,132,287,137,61,170,3923
"25025070900",1586,226,514,170,435,270,459,188,3848
"25025071101",1532,499,411,232,688,576,327,365,4630
"25025071201",991,376,522,329,693,404,332,475,4122
"25025080100",161,101,558,414,295,115,197,175,2016
"25025080300",123,151,749,473,479,64,444,163,2646
"25025080401",436,100,1085,553,267,380,590,484,3895
"25025080500",367,220,871,431,618,566,888,710,4671
"25025080601",315,305,463,487,302,222,382,298,2774
"25025080801",230,210,654,560,657,449,635,474,3869
"25025080900",1675,1091,349,51,292,270,98,10,3836
"25025081001",1373,987,370,435,918,582,377,368,5410
"25025081100",1670,766,323,187,770,346,444,101,4607
"25025081200",525,310,557,845,940,351,1061,660,5249
"25025081300",716,575,1475,860,1209,682,1516,958,7991
"25025081400",636,382,1050,341,407,103,215,162,3296
"25025081500",235,83,934,439,264,199,295,272,2721
"25025081700",77,104,1730,768,192,566,140,492,4069
"25025081800",116,58,1585,846,295,300,515,324,4039
"25025081900",198,112,1530,841,260,201,539,367,4048
"25025082000",89,154,1564,726,84,102,154,242,3115
"25025082100",318,89,1929,1424,479,774,831,950,6794
"25025090100",288,89,2674,1051,620,410,626,502,6260
"25025090200",92,44,523,370,1113,384,988,273,3787
"25025090300",46,134,1711,655,527,548,580,404,4605
"25025090400",191,405,1692,391,449,285,493,611,4517
"25025090600",120,39,1036,339,417,148,213,108,2420
"25025090700",2212,266,223,174,891,781,337,450,5334
"25025090901",717,521,317,329,735,1079,444,396,4538
"25025091001",1700,97,328,78,795,136,36,29,3199
"25025091100",2478,372,170,100,1490,667,190,139,5606
"25025091200",959,192,540,240,848,370,299,463,3911
"25025091300",225,150,827,190,906,262,390,217,3167
"25025091400",307,82,973,209,511,507,343,489,3421
"25025091500",348,107,1056,479,2145,468,523,201,5327
"25025091600",374,131,1473,215,654,506,351,235,3939
"25025091700",207,128,1587,506,1008,357,495,423,4711
"25025091800",243,389,1524,497,644,498,305,585,4685
"25025091900",179,132,2624,408,350,196,393,223,4505
"25025092000",359,281,2665,853,928,399,791,691,6967
"25025092101",1468,433,956,405,2654,704,437,238,7295
"25025092200",719,87,1231,136,841,135,318,160,3627
"25025092300",126,72,2122,755,257,44,197,134,3707
"25025092400",228,58,3379,1203,362,328,891,556,7005
"25025100100",337,499,3435,1342,450,308,973,674,8018
"25025100200",117,33,1983,467,166,175,247,89,3277
"25025100300",365,122,2282,493,94,25,405,146,3932
"25025100400",489,56,2727,701,580,158,414,0,5125
"25025100500",991,192,2920,1422,611,437,594,309,7476
"25025100601",1940,96,1183,395,1434,351,413,34,5846
"25025100603",1332,115,268,31,164,5,38,12,1965
"25025100700",3996,160,172,17,107,17,102,0,4571
"25025100800",3050,302,1767,122,1139,0,0,13,6393
"25025100900",1041,151,2104,223,426,227,375,86,4633
"25025101001",144,119,4248,1058,136,14,313,79,6111
"25025101002",344,125,3167,746,105,201,691,550,5929
"25025101101",178,90,2855,498,75,8,605,132,4441
"25025101102",84,472,3173,1222,146,29,157,516,5799
"25025110103",2839,381,980,412,1191,400,1215,512,7930
"25025110201",754,108,728,125,427,95,657,139,3033
"25025110301",931,142,764,12,661,0,692,59,3261
"25025110401",1543,263,1409,61,581,125,950,321,5253
"25025110403",2048,196,1349,444,843,60,1196,298,6434
"25025110501",2246,379,493,31,438,12,535,40,4174
"25025110502",2954,193,609,0,434,34,764,95,5083
"25025110601",2261,186,85,28,92,0,98,0,2750
"25025110607",3929,516,112,5,182,176,455,191,5566
"25025120103",1222,59,49,10,136,20,81,13,1590
"25025120104",1400,208,102,80,231,150,211,299,2681
"25025120105",1592,164,88,5,232,32,51,48,2212
"25025120201",2215,430,377,89,475,486,672,683,5427
"25025120301",2289,194,851,280,1072,269,1088,483,6526
"25025120400",4055,629,412,287,768,81,790,86,7108
"25025120500",1227,121,229,202,396,197,629,221,3222
"25025120600",1855,232,215,13,252,37,207,31,2842
"25025120700",1235,151,48,23,507,68,205,53,2290
"25025130100",4908,186,49,0,778,13,186,0,6120
"25025130200",4082,200,81,0,566,17,368,14,5328
"25025130300",4222,6,82,5,380,0,299,0,4994
"25025130402",4226,299,211,0,347,2,215,129,5429
"25025130404",2357,115,117,4,524,22,678,12,3829
"25025130406",1754,372,2088,390,588,50,778,397,6417
"25025140102",1971,46,1770,268,581,133,660,132,5561
"25025140105",1692,73,1469,27,745,85,1105,62,5258
"25025140106",409,165,685,218,237,112,277,223,2326
"25025140107",889,115,1325,46,410,113,688,202,3788
"25025140201",1394,148,443,13,372,46,674,57,3147
"25025140202",2569,259,1608,124,1134,170,1428,182,7474
"25025140300",1560,183,2942,631,800,171,1248,288,7823
"25025140400",865,151,6166,608,704,231,969,445,10139
"25025160101",2983,742,368,131,3191,1790,5251,2120,16576
"25025160200",981,373,136,52,1921,638,2517,881,7499
"25025160300",1474,117,225,0,421,91,387,80,2795
"25025160400",964,259,208,96,1104,200,1526,424,4781
"25025160501",1981,358,225,79,1600,821,2794,945,8803
"25025160502",2639,446,103,57,920,320,1935,692,7112
"25025160601",1633,380,258,155,1232,413,1129,503,5703
"25025160602",2193,349,193,70,1346,320,1690,370,6531
"25025170100",5147,798,408,0,1453,235,2002,252,10295
"25025170200",2708,657,358,13,646,46,779,199,5406
"25025170300",7065,463,389,11,1003,29,1025,0,9985
"25025170400",3531,733,236,3,810,184,1258,200,6955
"25025170501",2281,328,66,51,552,292,723,138,4431
"25025170502",2198,253,28,11,467,104,330,0,3391
"25025170601",4034,767,121,25,797,37,1503,395,7679
"25025170701",1226,513,33,58,285,0,492,4,2611
"25025170702",2576,1130,564,161,1530,435,1975,998,9369
"25025170800",2874,859,192,1,1204,0,1475,182,6787
"25025180101",4290,285,112,0,108,53,810,53,5711
"25025180200",3306,346,21,25,88,162,217,25,4190
"25025180301",2948,144,0,8,157,4,34,37,3332
"25025180400",1794,82,18,0,33,4,116,4,2051
"25025180500",3374,366,97,23,76,30,212,44,4222
"25025980101",18,171,6,92,16,26,16,25,370
"25025980300",18,43,13,115,0,44,5,52,290
"25025980700",10,0,0,0,0,0,0,0,10
"25025981000",0,0,0,0,0,0,0,0,0
"25025981100",31,8,60,138,33,0,33,0,303
"25025981201",0,0,0,0,0,0,0,0,0
"25025981202",0,0,0,0,0,0,0,0,0
"25025981300",279,12,38,0,151,0,173,0,653
"25025981501",0,0,0,0,0,0,0,0,0
"25025981502",0,0,0,0,0,0,0,0,0
"25025981600",0,0,0,0,0,0,0,0,0
"25025981700",0,0,0,0,0,0,0,0,0
"25025981800",20,0,0,0,0,0,0,0,20
"25025990101",0,0,0,0,0,0,0,0,0
"25027700100",5320,440,29,22,158,46,37,23,6075
"25027701100",6747,1004,15,25,515,110,186,102,8704
"25027702200",2709,269,11,0,167,4,46,19,3225
"25027703100",3139,1141,12,0,121,85,119,324,4941
"25027703200",2820,540,10,10,97,56,214,44,3791
"25027703300",3026,110,0,0,234,49,126,0,3545
"25027704200",2642,154,5,3,78,4,64,0,2950
"25027705100",6992,832,0,0,40,0,21,0,7885
"25027706100",4020,290,114,0,28,0,0,0,4452
"25027707100",2689,1025,83,0,113,67,78,211,4266
"25027707200",1334,311,55,0,165,15,279,17,2176
"25027707300",2937,1019,7,20,72,14,137,26,4232
"25027707400",3955,240,55,12,206,81,156,78,4783
"25027707500",3694,568,0,3,424,4,386,4,5083
"25027708100",6943,187,67,0,54,25,107,13,7396
"25027709100",3302,305,38,0,271,71,196,55,4238
"25027709201",5174,838,76,0,376,65,422,273,7224
"25027709202",5158,380,377,44,1140,72,1133,145,8449
"25027709400",2623,715,162,25,482,305,719,672,5703
"25027709501",1903,31,109,0,136,14,126,1,2320
"25027709502",4593,325,345,40,726,3,521,19,6572
"25027709600",1737,345,328,34,295,20,520,102,3381
"25027709701",3412,597,427,19,454,160,612,278,5959
"25027709702",1793,296,39,25,338,0,344,25,2860
"25027710100",2309,333,126,5,941,178,964,183,5039
"25027710200",5153,487,148,194,312,593,475,579,7941
"25027710300",2693,498,69,8,160,20,422,200,4070
"25027710400",1783,139,6,0,266,12,370,57,2633
"25027710500",1672,495,169,68,489,208,656,283,4040
"25027710600",4048,1031,0,53,887,411,1544,854,8828
"25027710700",643,469,0,42,142,72,276,255,1899
"25027710800",2159,601,133,27,291,581,705,718,5215
"25027711000",1715,539,145,39,585,91,616,195,3925
"25027711100",3131,276,166,48,382,45,60,82,4190
"25027712101",5190,737,126,1,200,98,180,74,6606
"25027712102",3852,150,45,0,158,55,155,66,4481
"25027713100",5450,810,63,0,256,0,153,23,6755
"25027715100",4724,108,3,10,147,16,148,33,5189
"25027716100",6648,367,101,0,574,49,564,197,8500
"25027716200",1960,254,108,15,365,89,412,89,3292
"25027716300",2429,408,9,5,246,16,217,42,3372
"25027717100",2738,75,10,3,91,0,82,0,2999
"25027718100",4011,130,43,1,205,3,42,21,4456
"25027719100",7186,365,69,0,170,3,199,0,7992
"25027720100",2981,225,30,6,190,0,201,6,3639
"25027721101",1685,92,0,0,14,0,11,0,1802
"25027721102",7749,131,12,15,216,42,229,5,8399
"25027722100",5008,224,0,0,103,0,58,0,5393
"25027723100",3419,428,7,0,98,42,48,55,4097
"25027724100",3136,257,128,0,64,0,34,0,3619
"25027725100",4239,300,82,1,67,9,25,0,4723
"25027726100",5406,370,0,12,170,118,120,101,6297
"25027726200",4614,807,7,32,205,0,360,14,6039
"25027727100",3739,77,50,77,367,0,469,3,4782
"25027728100",3775,168,17,0,60,0,38,0,4058
"25027728200",3491,54,10,16,244,16,110,16,3957
"25027728300",4442,84,118,2,77,8,135,13,4879
"25027728400",4580,97,44,1,321,18,32,6,5099
"25027729100",3059,164,30,0,69,7,29,0,3358
"25027729200",2127,96,71,8,56,31,0,5,2394
"25027730100",3605,391,1216,100,603,61,174,196,6346
"25027730200",4353,348,401,95,169,0,485,0,5851
"25027730300",3686,537,166,0,181,23,206,53,4852
"25027730401",2712,740,393,134,1081,91,1398,328,6877
"25027730402",1203,52,171,66,131,0,369,12,2004
"25027730500",1728,713,600,127,221,193,123,300,4005
"25027730600",6076,280,504,0,660,56,401,56,8033
"25027730700",4891,403,650,49,786,33,746,13,7571
"25027730801",3052,109,91,10,372,10,115,0,3759
"25027730802",1606,107,46,0,86,10,8,15,1878
"25027730901",2973,295,135,5,207,53,277,13,3958
"25027730902",2392,315,218,43,57,0,184,25,3234
"25027731001",1768,53,115,39,283,102,294,0,2654
"25027731002",3147,795,1161,123,711,319,516,258,7030
"25027731101",2119,689,200,238,432,54,564,345,4641
"25027731102",1767,190,391,6,187,50,119,115,2825
"25027731202",0,0,0,0,0,0,0,0,0
"25027731203",1810,2001,270,161,977,822,987,1438,8466
"25027731204",978,468,164,65,329,256,812,324,3396
"25027731300",1086,903,322,253,760,339,982,813,5458
"25027731400",1560,1213,264,369,442,604,1056,1287,6795
"25027731500",1378,1032,637,352,546,539,1116,1043,6643
"25027731600",1556,1064,321,120,401,530,170,62,4224
"25027731700",690,746,326,89,108,131,184,376,2650
"25027731800",2556,1135,608,167,961,707,1102,942,8178
"25027731900",1959,819,1040,253,579,515,820,552,6537
"25027732001",922,855,158,319,398,802,985,1397,5836
"25027732002",2261,383,636,25,586,114,354,120,4479
"25027732201",1916,202,382,41,185,66,151,16,2959
"25027732202",2230,504,160,0,205,20,36,197,3352
"25027732203",1425,297,193,238,528,29,204,127,3041
"25027732301",3116,139,373,0,319,31,138,9,4125
"25027732302",2424,360,454,74,462,37,396,210,4417
"25027732400",2781,2114,422,404,602,212,912,1889,9336
"25027732500",985,491,208,9,146,137,513,241,2730
"25027732600",2161,854,468,231,744,283,1466,448,6655
"25027732700",1639,701,381,480,338,161,390,454,4544
"25027732801",3398,287,643,91,344,1,111,146,5021
"25027732802",2720,291,543,38,779,63,249,204,4887
"25027732901",4137,965,878,147,870,249,937,392,8575
"25027732902",20,18,0,0,0,0,0,0,38
"25027733000",1913,758,216,46,1007,250,1052,470,5712
"25027733101",1672,95,116,15,221,0,208,23,2350
"25027733102",1562,122,183,27,251,16,310,55,2526
"25027735100",6033,347,13,3,22,49,280,20,6767
"25027735200",3855,92,63,0,164,49,237,39,4499
"25027736100",2366,124,34,0,77,0,34,44,2679
"25027736200",3264,142,214,0,85,0,12,6,3723
"25027736300",2397,148,24,0,74,13,123,20,2799
"25027736400",2520,126,167,7,22,3,55,3,2903
"25027736500",4185,137,0,12,39,0,230,0,4603
"25027737100",4897,256,0,68,77,59,43,124,5524
"25027737200",1612,65,0,1,20,15,68,0,1781
"25027737300",5382,320,85,0,320,18,168,1,6294
"25027738100",3053,295,151,62,1002,27,231,128,4949
"25027738201",3893,77,23,0,163,0,51,0,4207
"25027738202",4575,540,275,13,408,67,0,0,5878
"25027739100",6327,452,240,52,2155,397,84,108,9815
"25027739200",4255,290,329,0,1398,0,120,0,6392
"25027739300",3068,145,55,45,511,7,64,0,3895
"25027739400",6692,227,57,28,1588,16,500,21,9129
"25027739500",6211,87,182,0,1135,53,299,53,8020
"25027740101",4521,100,1,2,691,0,206,1,5522
"25027740102",5203,226,48,2,733,0,251,0,6463
"25027740200",2367,76,163,1,362,7,81,7,3064
"25027741101",3237,169,80,33,983,0,61,0,4563
"25027741102",4448,90,24,25,663,9,19,9,5287
"25027742300",3252,137,0,1,533,29,122,0,4074
"25027742401",4453,60,52,10,683,10,98,10,5376
"25027742402",1527,24,384,0,1471,75,20,48,3549
"25027743100",6587,492,16,0,483,2,96,0,7676
"25027744101",5928,612,16,26,767,0,222,34,7605
"25027744102",4414,233,19,93,263,105,181,70,5378
"25027744200",6372,231,78,14,235,230,401,25,7586
"25027744300",2090,532,511,4,524,507,191,493,4852
"25027744400",3169,460,63,0,514,0,515,271,4992
"25027745100",5414,141,17,0,297,0,326,0,6195
"25027746100",5543,96,31,1,192,16,295,1,6175
"25027747101",4744,200,9,0,335,0,336,0,5624
"25027747102",3261,190,112,28,77,40,67,0,3775
"25027748100",2766,248,0,40,151,0,86,0,3291
"25027749100",6830,302,43,0,281,143,46,50,7695
"25027749200",5564,289,37,0,15,0,28,0,5933
"25027750100",5065,397,10,0,321,93,175,0,6061
"25027750200",6489,408,0,0,218,0,139,0,7254
"25027750300",2727,43,0,0,8,1,86,0,2865
"25027751101",5693,318,57,0,16,1,0,1,6086
"25027751102",2873,18,0,1,98,2,0,0,2992
"25027752100",7976,359,37,0,172,0,321,0,8865
"25027753100",6124,340,0,37,275,151,360,76,7363
"25027753200",6403,144,29,0,50,0,114,1,6741
"25027754100",5177,245,109,15,50,141,80,166,5983
"25027754200",2461,524,66,33,408,190,186,165,4033
"25027754300",2064,541,119,240,195,51,495,13,3718
"25027754400",3031,485,22,9,261,9,370,9,4196
"25027755100",2609,474,39,38,163,29,50,41,3443
"25027755200",6672,354,19,1,188,76,57,0,7367
"25027756101",3924,296,80,0,46,4,13,52,4415
"25027756102",8111,313,0,0,182,24,50,0,8680
"25027757100",3149,485,222,15,334,294,994,370,5863
"25027757200",1243,299,6,12,456,248,877,333,3474
"25027757300",1184,383,0,17,657,420,729,493,3883
"25027757400",1862,47,61,0,541,270,554,240,3575
"25027757500",3071,369,87,0,627,130,536,266,5086
"25027758101",1632,125,0,0,17,0,22,0,1796
"25027758102",6860,499,26,1,196,0,166,127,7875
"25027759100",2063,110,17,0,73,0,24,0,2287
"25027760100",3058,186,0,11,56,55,1,0,3367
"25027761100",4365,774,0,1,13,0,42,0,5195
"25027761200",3692,167,66,12,1199,280,655,248,6319
"25027761300",2887,119,0,0,205,87,124,91,3513
"25027761400",4601,339,69,159,356,1,195,9,5729
"26001000100",1604,167,0,0,4,7,0,0,1782
"26001970100",1918,301,0,8,54,8,22,10,2321
"26001970400",2152,573,1,0,68,13,34,0,2841
"26001970500",1623,388,0,2,34,3,49,8,2107
"26001970600",1388,154,5,4,16,24,5,11,1607
"26001990000",0,0,0,0,0,0,0,0,0
"26003000100",2952,368,0,0,251,68,2,8,3649
"26003000200",2112,455,0,2,196,41,29,5,2840
"26003000300",1745,241,0,0,71,11,13,0,2081
"26003990000",0,0,0,0,0,0,0,0,0
"26005030200",3209,103,8,0,31,0,168,0,3519
"26005030300",6540,560,0,0,273,5,198,10,7586
"26005030401",6827,405,40,0,95,134,173,8,7682
"26005030402",4302,420,0,0,146,12,0,0,4880
"26005030500",6077,817,5,0,293,38,86,78,7394
"26005030600",4236,573,0,7,203,4,33,7,5063
"26005030702",4299,343,5,0,169,11,112,18,4957
"26005030703",1594,669,48,8,108,34,554,283,3298
"26005030704",3879,666,57,2,181,58,594,378,5815
"26005030800",4247,457,9,5,93,0,101,30,4942
"26005030901",2054,629,10,37,96,27,239,49,3141
"26005030902",2077,361,10,4,73,47,199,144,2915
"26005031000",3299,1665,429,96,111,240,367,519,6726
"26005031100",5195,810,85,0,89,15,170,6,6370
"26005031200",4185,775,203,13,65,57,73,49,5420
"26005031300",4179,474,6,6,128,105,334,114,5346
"26005031800",3796,517,0,0,137,21,51,15,4537
"26005031900",4170,640,17,0,57,48,148,38,5118
"26005032000",4167,875,0,0,34,75,88,69,5308
"26005032100",4092,370,67,0,90,1,106,1,4727
"26005032200",3668,499,58,154,446,129,699,51,5704
"26005032401",1028,490,48,13,93,84,462,485,2703
"26005032402",3280,460,0,10,65,19,275,64,4173
"26005032600",1099,33,5,0,75,90,19,17,1338
"26005990000",0,0,0,0,0,0,0,0,0
"26007000100",3917,594,0,6,82,33,32,12,4676
"26007000200",3797,400,11,4,66,11,38,15,4342
"26007000300",2462,529,2,5,81,3,6,0,3088
"26007000400",2008,1012,23,0,54,15,17,0,3129
"26007000500",1245,358,7,2,85,68,50,16,1831
"26007000600",2491,430,0,0,56,20,21,11,3029
"26007000700",2432,410,10,4,0,9,6,21,2892
"26007000800",2485,613,0,30,4,25,30,14,3201
"26007000900",2219,422,1,4,77,6,54,4,2787
"26007990000",0,0,0,0,0,0,0,0,0
"26009960100",2214,292,0,0,49,6,43,46,2650
"26009960200",2919,446,3,0,39,22,58,6,3493
"26009960300",2391,286,0,0,66,2,9,15,2769
"26009960400",2635,385,1,6,117,53,78,10,3285
"26009960500",2800,271,18,0,107,25,44,6,3271
"26009960600",2609,364,3,0,109,28,68,11,3192
"26009960700",3626,1009,0,16,89,41,32,11,4824
"26009990000",0,0,0,0,0,0,0,0,0
"26011970100",1950,458,6,0,36,17,68,30,2565
"26011970200",2552,480,6,28,53,0,23,0,3142
"26011970300",2336,432,3,1,45,4,37,7,2865
"26011970400",2155,511,2,2,30,12,31,3,2746
"26011970500",3040,853,0,3,103,53,38,14,4104
"26011990000",0,0,0,0,0,0,0,0,0
"26011990100",0,0,0,0,0,0,0,0,0
"26013000100",3123,473,14,1,218,95,9,14,3947
"26013000200",1839,298,10,3,258,115,45,1,2569
"26013990100",0,0,0,0,0,0,0,0,0
"26015010100",4706,710,11,0,254,33,267,21,6002
"26015010200",5075,289,8,0,143,52,125,1,5693
"26015010300",7197,456,49,14,156,1,10,26,7909
"26015010401",2586,631,0,0,91,0,88,3,3399
"26015010402",3757,222,0,0,83,0,54,1,4117
"26015010500",2791,197,5,1,81,1,226,6,3308
"26015010600",5669,878,0,1,53,1,33,1,6636
"26015010700",4438,467,34,0,144,3,59,3,5148
"26015010800",2771,279,0,0,103,6,46,0,3205
"26015011300",6004,1524,0,1,142,0,224,21,7916
"26015011400",5091,766,52,15,304,0,172,38,6438
"26017280300",708,442,20,16,21,5,42,177,1431
"26017280400",1978,497,109,197,161,24,287,91,3344
"26017280500",2905,301,0,0,105,0,183,0,3494
"26017280600",1785,737,47,22,84,85,131,205,3096
"26017280700",1886,1027,82,54,57,122,149,9,3386
"26017280800",3196,330,33,23,98,151,129,54,4014
"26017280900",1760,784,0,15,219,260,186,193,3417
"26017281000",3198,648,9,32,115,48,339,40,4429
"26017281300",2268,592,32,27,38,5,64,114,3140
"26017285100",2861,294,134,0,128,1,153,0,3571
"26017285201",4673,925,73,18,23,56,173,188,6129
"26017285202",2734,645,0,15,79,108,100,43,3724
"26017285300",4168,326,2,0,29,0,219,8,4752
"26017285400",3106,272,48,11,94,0,53,0,3584
"26017285500",6095,431,0,0,58,0,79,0,6663
"26017285600",6395,464,0,0,262,24,125,63,7333
"26017285700",3218,399,0,1,266,50,137,29,4100
"26017285800",5076,903,0,15,77,347,80,59,6557
"26017285900",3741,770,35,0,192,0,110,19,4867
"26017286000",2907,162,0,0,103,0,119,0,3291
"26017286100",6836,552,0,0,152,36,95,46,7717
"26017286200",4291,642,0,3,30,48,90,32,5136
"26017286300",2941,545,18,13,79,24,83,26,3729
"26017286400",2282,262,0,7,46,48,24,51,2720
"26017286500",827,570,58,54,78,35,148,118,1888
"26017286600",3845,859,97,0,318,94,343,0,5556
"26017990000",0,0,0,0,0,0,0,0,0
"26019000100",6144,735,7,23,158,44,84,12,7207
"26019000200",2875,186,0,28,60,57,42,0,3248
"26019000300",1320,232,0,14,9,3,40,33,1651
"26019000400",1816,308,0,1,28,18,77,13,2261
"26019000500",2600,384,0,0,162,46,41,7,3240
"26019990000",0,0,0,0,0,0,0,0,0
"26021000300",109,37,1106,834,69,1,80,0,2236
"26021000400",55,48,704,1239,18,75,0,55,2194
"26021000500",107,53,1025,593,0,87,0,0,1865
"26021000600",151,107,1780,1076,219,84,0,7,3424
"26021000700",1963,125,799,201,40,0,12,0,3140
"26021000800",4132,540,185,0,170,0,0,0,5027
"26021000900",1562,43,51,0,161,9,31,9,1866
"26021001000",1572,67,0,4,45,0,23,0,1711
"26021001100",3607,48,79,0,298,20,28,0,4080
"26021001300",1695,65,67,3,124,28,24,29,2035
"26021001400",3671,332,35,31,193,9,54,0,4325
"26021001500",2674,165,53,54,234,23,86,14,3303
"26021001600",2627,26,16,0,20,0,16,0,2705
"26021001700",3746,223,24,1,426,0,160,2,4582
"26021001800",3953,273,131,49,247,12,86,106,4857
"26021001900",1468,133,105,9,198,47,195,67,2222
"26021002000",1171,202,1560,573,77,50,85,0,3718
"26021002100",561,513,362,695,324,228,279,129,3091
"26021002200",250,54,966,1581,53,0,128,0,3032
"26021002300",517,238,296,695,134,226,177,192,2475
"26021002400",1255,132,165,13,95,3,173,17,1853
"26021002500",1263,74,294,248,37,0,43,7,1966
"26021010100",2733,490,167,24,86,147,76,134,3857
"26021010200",5911,411,7,8,236,126,27,14,6740
"26021010300",3847,644,3,14,364,143,330,72,5417
"26021010400",2256,195,14,44,43,240,96,325,3213
"26021010500",1850,343,51,15,98,13,121,134,2625
"26021010600",3454,712,166,52,399,134,375,174,5466
"26021011000",2365,248,0,26,129,0,98,6,2872
"26021011100",4285,406,24,36,57,16,32,2,4858
"26021011200",2835,157,73,0,29,0,40,0,3134
"26021011300",3388,526,15,110,108,4,124,8,4283
"26021011400",2023,307,13,0,146,28,60,10,2587
"26021011500",1172,208,0,0,54,9,5,12,1460
"26021011600",1474,121,0,2,135,13,98,0,1843
"26021020100",2117,137,0,135,35,49,1,0,2474
"26021020200",4103,750,340,80,176,0,164,3,5616
"26021020300",2393,163,9,0,67,12,86,0,2730
"26021020400",3097,229,102,1,240,120,182,139,4110
"26021020500",1378,829,281,188,56,57,227,160,3176
"26021020600",2571,486,0,167,45,66,34,12,3381
"26021020700",1492,649,281,169,56,33,68,181,2929
"26021020900",2699,811,129,120,108,197,142,15,4221
"26021021000",3771,783,96,58,191,157,21,47,5124
"26021021100",1446,256,6,157,120,0,91,0,2076
"26021021200",1107,280,30,10,23,14,11,0,1475
"26021021300",1185,139,670,329,622,158,186,21,3310
"26021021400",2287,474,282,59,264,186,261,264,4077
"26021990000",0,0,0,0,0,0,0,0,0
"26023950100",3221,673,16,0,44,5,72,5,4036
"26023950200",2888,514,0,0,74,11,7,8,3502
"26023950300",3244,563,0,0,63,40,53,4,3967
"26023950800",3347,1149,2,6,50,8,44,69,4675
"26023950900",1850,324,0,15,7,3,5,0,2204
"26023951000",1942,207,3,0,12,0,14,7,2185
"26023951100",2490,519,7,41,70,13,49,7,3196
"26023951200",2946,1242,0,11,226,20,231,209,4885
"26023951300",2942,179,0,0,16,6,4,6,3153
"26023951400",3357,564,39,69,207,33,139,261,4669
"26023951500",2271,634,0,2,47,13,72,172,3211
"26023951600",2522,654,0,5,24,16,116,153,3490
"26025000200",1733,629,348,430,181,53,99,59,3532
"26025000300",204,210,766,590,58,17,10,38,1893
"26025000500",1789,703,490,83,125,45,92,155,3482
"26025000600",1023,928,239,236,72,399,160,345,3402
"26025000700",1308,848,232,203,34,150,210,312,3297
"26025000800",1999,523,271,90,298,67,254,0,3502
"26025000900",2300,164,509,191,195,114,6,47,3526
"26025001000",944,304,1855,575,134,68,207,9,4096
"26025001100",2792,728,458,182,44,145,124,11,4484
"26025001200",1721,487,161,26,10,0,34,99,2538
"26025001300",2499,598,118,85,563,177,13,22,4075
"26025001400",3155,422,85,16,183,50,254,37,4202
"26025001500",4555,93,326,15,520,0,148,0,5657
"26025001600",1915,204,17,24,308,24,72,0,2564
"26025001700",3004,426,170,41,551,0,194,0,4386
"26025001800",4063,371,711,194,464,0,140,0,5943
"26025001900",3554,196,36,78,176,1,38,0,4079
"26025002000",4460,320,57,0,91,7,83,0,5018
"26025002100",737,204,0,8,14,57,39,0,1059
"26025002200",3025,224,9,0,94,80,142,3,3577
"26025002300",3085,524,118,55,104,62,108,50,4106
"26025002400",2269,243,217,0,21,0,31,0,2781
"26025002500",3216,235,85,33,181,34,118,0,3902
"26025002600",900,294,135,147,234,125,20,0,1855
"26025002700",5487,496,4,2,179,18,33,83,6302
"26025002800",3889,399,8,3,183,4,39,8,4533
"26025002900",2426,403,4,0,67,13,14,9,2936
"26025003000",1886,240,45,0,44,21,25,7,2268
"26025003100",2312,571,8,5,32,4,59,18,3009
"26025003200",1768,415,24,3,78,4,35,0,2327
"26025003300",791,281,438,498,34,4,22,37,2105
"26025003400",803,298,25,108,19,0,19,4,1276
"26025003500",1437,403,258,61,94,0,125,0,2378
"26025003600",598,390,531,594,58,148,98,57,2474
"26025003700",3844,656,29,0,101,35,92,56,4813
"26025003800",4167,154,0,2,64,5,265,12,4669
"26025003900",3548,296,7,51,144,16,105,15,4182
"26025004000",3571,372,39,38,129,9,319,78,4555
"26025004100",827,362,555,274,195,182,538,226,3159
"26027001000",2977,607,68,0,122,27,99,27,3927
"26027001100",2351,492,0,5,75,4,10,0,2937
"26027001200",2533,140,17,1,175,41,13,0,2920
"26027001500",3500,240,91,0,115,46,179,34,4205
"26027001600",2603,612,208,87,242,46,59,55,3912
"26027001700",4068,561,55,35,132,29,106,13,4999
"26027001800",7279,680,117,17,410,17,270,0,8790
"26027001900",3712,583,52,60,234,54,9,36,4740
"26027002000",3446,580,94,142,112,36,0,2,4412
"26027002100",3345,839,459,233,384,202,141,259,5862
"26027002200",4144,471,613,171,355,309,107,181,6351
"26029000100",1455,216,8,0,64,5,17,31,1796
"26029000200",1164,160,0,1,11,37,0,0,1373
"26029000300",1993,158,0,4,67,0,28,0,2250
"26029000400",2374,179,0,0,160,12,42,0,2767
"26029000500",546,33,0,0,6,2,1,0,588
"26029000800",2541,253,4,1,85,22,15,12,2933
"26029000900",1589,88,3,0,131,21,121,15,1968
"26029001000",1874,253,0,1,47,53,16,2,2246
"26029001100",1467,336,5,2,32,6,53,6,1907
"26029001200",2441,605,14,0,137,0,34,0,3231
"26029001300",1076,152,4,0,57,0,4,0,1293
"26029001400",1017,241,0,0,41,22,0,0,1321
"26029001500",1784,545,16,0,53,45,0,0,2443
"26029990000",0,0,0,0,0,0,0,0,0
"26031960100",2479,358,29,29,128,40,23,3,3089
"26031960200",1726,852,0,0,69,73,75,0,2795
"26031960300",2794,813,0,0,263,188,0,15,4073
"26031960400",3146,310,0,0,148,89,18,0,3711
"26031960500",2311,237,6,11,98,3,18,0,2684
"26031960600",2028,191,0,0,93,32,41,0,2385
"26031960700",2491,508,13,0,166,20,20,24,3242
"26031960800",2801,720,1,0,107,55,0,0,3684
"26031990000",0,0,0,0,0,0,0,0,0
"26033970100",2201,103,0,26,739,68,31,11,3179
"26033970200",1936,438,0,199,561,257,12,4,3407
"26033970300",1661,825,74,9,374,348,3,11,3305
"26033970400",1471,384,55,0,472,169,29,0,2580
"26033970500",2480,590,0,114,497,122,53,3,3859
"26033970600",2509,326,42,7,1642,255,18,2,4801
"26033970700",784,141,0,0,81,7,1,0,1014
"26033970800",3116,567,18,0,530,21,37,11,4300
"26033970900",1411,580,23,24,699,360,38,25,3160
"26033971000",2511,310,32,0,251,33,4,1,3142
"26033971100",1268,90,0,0,222,5,0,0,1585
"26033980100",0,0,0,0,0,0,0,0,0
"26033980200",0,0,0,0,0,0,0,0,0
"26033980300",0,0,0,0,0,0,0,0,0
"26033990000",0,0,0,0,0,0,0,0,0
"26033990100",0,0,0,0,0,0,0,0,0
"26035000100",1045,358,0,1,61,3,0,0,1468
"26035000200",1163,318,0,0,21,0,14,14,1530
"26035000300",1586,672,18,0,54,0,21,0,2351
"26035000400",2659,687,0,0,38,46,69,10,3509
"26035000500",1025,331,0,0,18,19,0,0,1393
"26035000600",2257,1256,0,2,30,123,9,8,3685
"26035000700",2742,584,6,0,68,35,16,23,3474
"26035000800",3369,809,5,3,145,0,136,5,4472
"26035000900",1187,661,1,9,25,19,15,6,1923
"26035001000",1858,1053,0,3,16,4,36,40,3010
"26035001300",2521,1195,32,0,105,23,58,7,3941
"26037010104",2666,167,197,0,223,9,190,0,3452
"26037010105",3219,290,0,0,13,4,70,0,3596
"26037010107",3500,169,0,0,97,4,97,0,3867
"26037010108",3892,180,0,0,189,8,46,107,4422
"26037010201",1820,141,66,1,113,1,120,0,2262
"26037010203",752,465,0,6,43,56,33,82,1437
"26037010204",1540,167,0,0,126,0,125,0,1958
"26037010300",4307,243,160,2,284,0,125,1,5122
"26037010400",4784,149,10,1,109,1,218,0,5272
"26037010500",3256,244,0,0,126,0,86,10,3722
"26037010600",2269,158,0,0,43,28,93,3,2594
"26037010701",1877,231,22,1,75,2,40,15,2263
"26037010702",1958,210,0,11,72,0,72,3,2326
"26037010801",3362,506,75,21,148,0,165,75,4352
"26037010802",2811,608,0,0,155,33,109,5,3721
"26037010901",2066,329,0,0,189,24,74,11,2693
"26037010902",4369,114,18,0,116,15,90,16,4738
"26037011001",3001,661,13,0,59,3,244,40,4021
"26037011002",3179,171,0,0,114,1,42,0,3507
"26037011101",3765,80,27,2,117,15,182,40,4228
"26037011104",4264,297,112,0,297,352,83,224,5629
"26037011200",432,1949,71,287,109,365,53,116,3382
"26039960100",1805,207,0,0,96,18,52,0,2178
"26039960200",2710,510,0,0,64,26,15,30,3355
"26039960300",2987,502,0,0,24,47,0,17,3577
"26039960400",2033,282,0,0,14,24,4,0,2357
"26039960500",1873,291,0,0,20,76,32,70,2362
"26041970100",1211,173,2,0,156,17,4,0,1563
"26041970200",2012,313,0,0,152,62,19,4,2562
"26041970300",2016,246,4,0,69,33,43,2,2413
"26041970400",4775,627,0,0,23,51,4,7,5487
"26041970500",3521,492,1,0,151,12,12,0,4189
"26041970600",3291,389,0,0,249,15,29,0,3973
"26041970700",3298,311,0,2,88,51,48,19,3817
"26041970800",2730,879,0,15,136,133,16,11,3920
"26041970900",1652,624,0,6,35,90,31,52,2490
"26041971000",1502,848,0,4,37,150,8,36,2585
"26041971100",2741,593,0,0,141,100,11,0,3586
"26041990000",0,0,0,0,0,0,0,0,0
"26041990100",0,0,0,0,0,0,0,0,0
"26043950100",1393,361,2,4,17,7,6,1,1791
"26043950200",3487,368,16,0,111,2,8,0,3992
"26043950300",4341,463,18,0,59,23,45,0,4949
"26043950400",3776,582,11,2,74,78,110,0,4633
"26043950500",2153,334,0,0,121,15,62,4,2689
"26043950600",3136,847,38,5,58,21,19,7,4131
"26043950700",3290,320,0,0,100,0,49,0,3759
"26045020101",2366,64,378,65,76,11,56,0,3016
"26045020102",2114,87,525,30,405,65,359,12,3597
"26045020103",2771,266,429,131,489,126,162,92,4466
"26045020104",2585,284,466,147,574,0,436,34,4526
"26045020201",1825,125,385,40,128,167,81,127,2878
"26045020202",1749,300,1097,625,279,123,465,199,4837
"26045020302",5479,238,52,0,494,3,425,0,6691
"26045020303",2392,279,134,14,285,0,133,59,3296
"26045020304",3210,255,666,23,618,92,327,74,5265
"26045020402",2768,164,6,37,46,0,30,0,3051
"26045020403",2352,102,13,0,56,75,29,56,2683
"26045020404",4056,182,0,1,59,0,154,25,4477
"26045020500",3421,347,1,1,19,20,169,12,3990
"26045020601",2854,465,49,33,142,0,103,33,3679
"26045020602",3331,228,37,3,63,30,120,11,3823
"26045020700",3269,482,0,4,69,17,111,55,4007
"26045020800",4301,381,34,0,284,10,97,21,5128
"26045020901",2761,756,0,5,136,3,120,104,3885
"26045020902",3232,465,0,0,153,81,69,0,4000
"26045021001",3558,271,26,0,151,37,42,35,4120
"26045021002",3459,441,7,13,48,6,73,29,4076
"26045021100",4081,410,26,4,110,22,170,14,4837
"26045021201",2877,102,39,0,29,0,74,0,3121
"26045021202",2691,471,29,0,302,0,48,0,3541
"26045021301",2408,412,0,1,0,0,134,0,2955
"26045021302",2191,922,43,0,34,0,43,0,3233
"26045021401",2425,235,476,141,262,16,190,20,3765
"26045021402",4110,142,167,16,251,0,109,8,4803
"26047970100",1804,231,5,2,172,35,26,1,2276
"26047970200",4293,521,15,2,311,111,68,2,5323
"26047970300",3702,383,11,0,199,30,42,10,4377
"26047970400",2192,149,13,0,120,36,14,10,2534
"26047970500",3805,518,0,0,224,5,20,3,4575
"26047970600",5372,300,19,0,357,11,97,0,6156
"26047970700",2956,566,35,21,91,42,15,0,3726
"26047970800",2795,451,11,27,268,98,121,20,3791
"26047990000",0,0,0,0,0,0,0,0,0
"26049000100",20,0,1588,973,30,92,30,28,2761
"26049000200",20,81,801,616,87,48,35,11,1699
"26049000300",14,50,1639,1434,110,10,0,0,3257
"26049000400",52,67,745,727,10,0,0,50,1651
"26049000500",45,4,1291,667,0,0,27,24,2058
"26049000600",33,17,986,735,53,25,53,1,1903
"26049000700",161,0,1399,774,32,0,0,0,2366
"26049000800",28,93,532,427,22,0,14,0,1116
"26049000900",266,69,1860,1181,182,23,48,0,3629
"26049001000",23,34,1166,557,80,140,0,8,2008
"26049001100",45,5,1041,1076,107,0,12,0,2286
"26049001200",98,74,1361,1333,22,251,9,0,3148
"26049001300",240,78,1238,926,90,172,0,0,2744
"26049001400",89,149,560,501,122,40,76,0,1537
"26049001500",158,278,318,520,44,23,28,31,1400
"26049001600",1758,655,1054,1173,224,169,77,142,5252
"26049001700",0,159,760,643,0,0,0,69,1631
"26049001800",143,216,395,925,0,61,10,0,1750
"26049001900",1078,461,244,852,38,192,145,60,3070
"26049002000",10,19,566,367,0,0,0,0,962
"26049002200",556,1097,40,120,76,163,62,114,2228
"26049002300",761,1148,106,147,144,88,115,198,2707
"26049002400",1365,637,357,230,178,20,129,0,2916
"26049002600",1484,1152,71,217,162,100,357,75,3618
"26049002700",2347,545,155,343,152,14,188,33,3777
"26049002800",384,351,363,449,79,99,7,8,1740
"26049002900",417,246,847,558,52,9,75,19,2223
"26049003000",2134,619,655,254,123,1,145,33,3964
"26049003100",114,19,1197,545,16,103,11,21,2026
"26049003200",113,329,945,821,18,157,11,0,2394
"26049003300",554,146,909,300,70,50,81,6,2116
"26049003400",195,253,324,1197,40,0,37,133,2179
"26049003500",2336,521,404,106,16,12,104,9,3508
"26049003600",3025,983,411,738,93,199,199,45,5693
"26049003700",933,773,219,121,87,79,20,124,2356
"26049003800",538,527,78,174,38,161,93,129,1738
"26049004000",1669,872,257,427,92,87,11,16,3431
"26049010110",1981,480,0,2,70,68,7,0,2608
"26049010111",829,220,1,7,43,6,14,11,1131
"26049010112",2232,75,0,0,118,0,81,7,2513
"26049010113",1428,621,253,16,66,35,49,53,2521
"26049010114",2406,171,9,2,45,16,37,2,2688
"26049010115",716,141,2,68,56,0,25,0,1008
"26049010201",1539,58,0,5,21,0,21,0,1644
"26049010202",1544,88,0,0,36,10,9,10,1697
"26049010304",796,272,1023,1163,133,116,85,35,3623
"26049010305",588,135,2182,1560,100,479,56,262,5362
"26049010501",945,930,286,74,62,131,110,70,2608
"26049010502",2275,116,410,532,118,31,88,39,3609
"26049010503",1750,423,157,2,19,2,60,3,2416
"26049010504",2575,527,852,231,56,27,101,6,4375
"26049010603",4262,666,100,18,188,2,150,51,5437
"26049010604",2264,502,0,0,22,27,134,0,2949
"26049010610",4605,321,105,29,216,0,212,2,5490
"26049010700",4320,451,21,8,341,31,102,1,5275
"26049010810",3347,79,1208,58,323,0,184,0,5199
"26049010811",680,68,820,343,128,0,18,0,2057
"26049010812",1340,353,601,662,101,86,0,16,3159
"26049010813",2753,463,966,33,505,66,182,0,4968
"26049010910",2411,353,649,151,38,0,49,73,3724
"26049010911",674,680,1447,498,267,52,274,8,3900
"26049010912",2162,694,214,78,76,9,30,0,3263
"26049011010",3511,812,124,78,285,108,70,11,4999
"26049011101",7152,582,549,79,478,37,170,15,9062
"26049011102",3920,379,357,47,366,32,143,0,5244
"26049011209",4514,596,435,299,308,0,102,0,6254
"26049011210",1422,319,92,111,11,86,19,5,2065
"26049011211",3625,568,1154,13,172,24,58,0,5614
"26049011212",3794,553,606,411,273,70,127,50,5884
"26049011213",4531,366,158,58,582,0,241,0,5936
"26049011214",3810,351,546,197,620,68,12,0,5604
"26049011301",2301,1381,389,307,119,133,35,96,4761
"26049011302",2566,1022,1,0,198,149,184,0,4120
"26049011401",2138,368,217,64,24,11,22,8,2852
"26049011402",3497,250,216,0,118,0,86,16,4183
"26049011502",2549,489,187,0,117,0,93,22,3457
"26049011503",4082,711,32,16,242,0,184,73,5340
"26049011505",1935,276,130,1,50,39,44,47,2522
"26049011508",2250,508,150,38,0,71,57,88,3162
"26049011601",2559,152,322,0,23,0,232,2,3290
"26049011610",4831,531,527,186,340,137,133,30,6715
"26049011710",2145,370,0,0,24,18,0,19,2576
"26049011711",2042,426,25,0,27,8,54,8,2590
"26049011712",2458,229,0,2,130,1,88,28,2936
"26049011713",2739,360,207,94,88,24,17,0,3529
"26049011714",3002,116,12,57,55,0,184,0,3426
"26049011800",3003,75,3,1,37,0,70,0,3189
"26049011901",1820,298,136,0,133,100,44,100,2631
"26049011902",2460,346,0,1,137,0,21,0,2965
"26049012003",2048,592,113,29,173,25,61,28,3069
"26049012006",1950,294,118,23,100,43,111,55,2694
"26049012007",1278,203,9,0,43,14,28,0,1575
"26049012008",2520,170,33,23,46,0,55,0,2847
"26049012009",2220,293,19,1,25,11,83,0,2652
"26049012100",2254,423,128,53,32,0,58,66,3014
"26049012201",1751,665,91,41,87,27,24,0,2686
"26049012202",262,133,503,272,88,0,3,0,1261
"26049012310",1585,759,119,348,38,183,35,0,3067
"26049012311",1343,153,132,109,18,90,12,20,1877
"26049012401",1677,133,12,0,38,28,44,11,1943
"26049012402",2381,254,0,0,0,0,15,0,2650
"26049012501",1575,183,58,0,8,0,38,0,1862
"26049012503",2061,576,223,0,32,63,122,49,3126
"26049012504",1829,175,17,16,15,0,36,35,2123
"26049012601",2432,767,17,24,75,28,172,25,3540
"26049012602",1296,367,2,31,20,5,18,3,1742
"26049012603",2239,380,7,18,61,6,59,47,2817
"26049012702",4770,516,104,150,88,0,170,0,5798
"26049012703",2534,356,79,13,161,74,178,0,3395
"26049012704",3687,89,121,123,210,0,96,66,4392
"26049012801",4092,417,0,2,74,0,217,16,4818
"26049012802",1798,221,9,21,57,17,73,0,2196
"26049012904",5287,362,199,6,270,98,11,83,6316
"26049012905",2862,187,297,89,144,250,215,0,4044
"26049012906",2097,137,103,4,93,0,50,3,2487
"26049012907",2046,244,0,0,82,5,27,5,2409
"26049013001",2488,117,0,0,27,0,39,0,2671
"26049013002",3324,665,0,0,28,34,62,18,4131
"26049013110",1939,144,12,0,4,0,34,0,2133
"26049013111",2425,401,0,0,203,0,19,0,3048
"26049013112",3941,195,44,0,196,9,89,0,4474
"26049013113",3628,179,0,0,10,0,14,0,3831
"26049013202",4315,852,51,0,156,34,201,20,5629
"26049013204",4964,816,0,0,143,18,281,0,6222
"26049013301",5258,391,0,0,140,20,100,0,5909
"26049013401",5701,296,0,0,44,0,49,0,6090
"26049013402",1682,124,1,1,11,0,20,0,1839
"26049013500",1804,673,2148,1014,53,100,59,94,5945
"26049013600",52,95,565,530,9,8,6,8,1273
"26049980000",0,0,0,0,0,0,0,0,0
"26049980100",0,0,0,0,0,0,0,0,0
"26051000100",2411,439,1,0,43,0,16,0,2910
"26051000200",1035,170,1,2,37,3,11,0,1259
"26051000300",1448,313,0,1,36,11,6,0,1815
"26051000400",2621,737,0,30,48,15,73,8,3532
"26051000500",2985,788,0,2,24,8,55,3,3865
"26051000600",1423,369,0,0,9,9,7,26,1843
"26051000700",3383,1077,0,0,83,25,23,0,4591
"26051000800",2936,795,2,0,36,38,37,53,3897
"26051000900",1640,200,0,0,46,8,6,0,1900
"26053950100",1000,73,1,1,262,73,12,0,1422
"26053950200",1824,380,16,0,47,41,11,3,2322
"26053950300",1951,486,0,8,38,37,8,0,2528
"26053950400",838,82,0,0,16,12,6,0,954
"26053950500",1506,662,0,0,24,38,25,12,2267
"26053950600",1995,796,56,0,30,0,26,0,2903
"26053950700",1911,239,1,0,21,5,0,20,2197
"26053990000",0,0,0,0,0,0,0,0,0
"26055550101",5496,196,22,5,52,0,77,17,5865
"26055550102",2861,164,7,9,78,79,14,0,3212
"26055550200",3818,291,22,1,136,8,39,2,4317
"26055550300",5420,814,2,0,167,35,62,19,6519
"26055550400",5773,757,7,145,268,46,265,99,7360
"26055550500",4389,507,1,0,100,66,59,93,5215
"26055550600",8189,775,53,34,308,23,236,0,9618
"26055550700",7568,936,0,44,379,44,506,0,9477
"26055550800",5168,348,6,0,61,59,2,5,5649
"26055550900",4484,282,0,0,0,0,0,0,4766
"26055551000",3343,400,0,47,84,21,25,0,3920
"26055551100",2653,531,0,5,271,44,39,0,3543
"26055551200",2573,494,8,13,52,0,15,42,3197
"26055551300",5142,1841,27,4,366,216,215,43,7854
"26055551400",3823,397,22,0,136,118,165,0,4661
"26055551500",2627,297,16,1,108,4,29,2,3084
"26055990000",0,0,0,0,0,0,0,0,0
"26057000100",2871,1016,42,7,26,13,90,19,4084
"26057000200",4153,574,0,20,139,17,228,21,5152
"26057000300",3365,903,34,20,82,118,249,60,4831
"26057000400",13,0,0,0,0,0,0,0,13
"26057000500",3095,1114,13,103,56,81,199,98,4759
"26057000600",2468,916,32,0,101,65,288,113,3983
"26057000700",2713,462,20,0,95,0,174,36,3500
"26057000800",3695,509,0,0,26,11,163,53,4457
"26057000900",2897,395,0,0,65,29,59,49,3494
"26057001000",3385,299,5,145,50,14,94,15,4007
"26059050100",4017,465,0,1,33,0,54,0,4570
"26059050200",2608,679,3,0,63,13,47,5,3418
"26059050300",1845,398,4,4,13,7,53,3,2327
"26059050400",3604,952,36,8,70,23,25,51,4769
"26059050500",3289,447,0,0,132,29,105,0,4002
"26059050600",3320,251,12,0,66,0,73,13,3735
"26059050700",2682,1352,28,12,110,32,141,22,4379
"26059050800",1430,489,0,16,27,25,17,17,2021
"26059050900",3718,754,0,5,64,16,64,18,4639
"26059051000",3336,704,53,2,106,0,75,14,4290
"26059051100",2646,1125,5,0,52,28,14,10,3880
"26059051200",2400,1186,2,2,25,8,4,48,3675
"26061000100",2172,466,9,0,102,50,42,0,2841
"26061000200",2177,561,0,0,26,61,19,37,2881
"26061000300",1825,576,0,7,76,0,56,22,2562
"26061000400",2704,648,0,0,56,3,20,0,3431
"26061000500",3067,327,1,15,42,17,17,5,3491
"26061000600",2513,797,0,2,93,26,0,15,3446
"26061000700",2822,339,3,0,9,18,0,13,3204
"26061000800",2240,1899,23,71,252,423,29,64,5001
"26061000900",3733,691,52,71,261,254,13,12,5087
"26061001000",2591,306,9,0,60,33,13,31,3043
"26061990000",0,0,0,0,0,0,0,0,0
"26061990100",0,0,0,0,0,0,0,0,0
"26063950100",1158,332,2,2,15,3,12,2,1526
"26063950200",1943,280,0,5,56,5,38,32,2359
"26063950300",1947,382,0,0,17,19,13,7,2385
"26063950400",876,146,0,0,6,0,8,0,1036
"26063950500",2038,262,0,0,26,14,52,6,2398
"26063950600",2303,442,0,0,27,16,16,29,2833
"26063950700",2848,473,0,4,31,0,34,8,3398
"26063950800",2884,303,0,0,82,65,91,61,3486
"26063950900",3139,387,16,0,42,0,45,5,3634
"26063951000",2653,954,30,0,61,0,83,23,3804
"26063951100",1808,147,30,1,71,11,39,0,2107
"26063951200",2893,679,6,0,102,47,25,38,3790
"26063990000",0,0,0,0,0,0,0,0,0
"26065000100",1113,454,156,12,216,30,365,118,2464
"26065000400",1419,270,220,172,201,144,184,68,2678
"26065000600",505,333,162,122,224,147,73,77,1643
"26065000700",757,642,82,291,214,243,225,214,2668
"26065000800",1243,482,264,236,799,218,548,349,4139
"26065001000",1253,330,57,138,210,64,104,29,2185
"26065001200",1016,465,366,127,376,115,165,132,2762
"26065001703",2024,295,831,177,373,128,310,138,4276
"26065002000",1545,792,334,552,190,200,248,119,3980
"26065002101",721,302,377,325,139,224,149,147,2384
"26065002200",1268,170,75,0,35,0,89,14,1651
"26065002300",2635,134,137,18,261,31,201,7,3424
"26065002600",921,370,26,177,147,161,98,197,2097
"26065002700",1546,687,481,193,312,98,399,192,3908
"26065002800",1783,207,216,13,226,33,255,6,2739
"26065002901",1535,331,685,207,443,128,139,0,3468
"26065002902",1092,1355,338,311,601,572,180,162,4611
"26065003103",4237,872,771,103,367,134,287,52,6823
"26065003200",948,351,132,242,241,139,186,103,2342
"26065003301",1492,331,447,487,447,164,274,198,3840
"26065003302",1508,151,452,1,187,73,165,9,2546
"26065003400",1662,74,185,145,232,0,399,17,2714
"26065003500",1506,376,348,94,264,225,426,209,3448
"26065003601",928,208,1334,201,324,517,125,61,3698
"26065003602",1143,367,858,179,365,363,399,269,3943
"26065003700",2315,936,942,511,385,229,563,446,6327
"26065003801",2441,397,478,251,585,220,84,24,4480
"26065003802",2196,707,161,327,244,252,155,0,4042
"26065003901",1504,90,84,34,127,49,66,0,1954
"26065003902",2161,1234,55,108,182,80,47,79,3946
"26065004000",2041,1156,138,0,412,28,80,20,3875
"26065004100",780,2716,11,75,15,74,9,62,3742
"26065004301",2621,2627,20,21,282,95,212,36,5914
"26065004302",182,1429,25,41,113,402,0,89,2281
"26065004402",239,181,65,121,498,411,104,32,1651
"26065004403",424,346,41,4,228,98,0,11,1152
"26065004490",0,0,0,0,0,0,0,0,0
"26065004491",0,0,0,0,0,0,0,0,0
"26065004492",0,0,0,0,0,0,0,0,0
"26065004493",0,0,0,0,0,0,0,0,0
"26065004494",0,0,0,0,0,0,0,0,0
"26065004500",2256,639,280,56,275,374,150,50,4080
"26065004600",3707,121,187,0,310,5,119,0,4449
"26065004700",2357,249,34,1,80,112,129,2,2964
"26065004801",3340,609,61,0,385,72,322,17,4806
"26065004802",2824,323,56,0,130,0,52,0,3385
"26065004901",4402,570,261,116,1202,72,71,18,6712
"26065004902",1968,989,132,8,534,211,63,0,3905
"26065005001",4308,366,158,0,1485,146,218,73,6754
"26065005002",2935,54,96,37,379,26,71,11,3609
"26065005100",1296,701,979,319,290,438,201,302,4526
"26065005201",2411,535,989,550,674,109,393,82,5743
"26065005202",2491,190,119,0,383,66,108,121,3478
"26065005302",4827,525,457,177,957,85,335,15,7378
"26065005303",2153,984,263,151,384,435,332,135,4837
"26065005304",1139,364,561,431,484,349,172,66,3566
"26065005401",2984,171,34,1,129,39,202,0,3560
"26065005402",3157,269,324,1,33,70,129,0,3983
"26065005501",4285,174,424,3,264,273,107,114,5644
"26065005502",4353,529,173,87,220,189,324,0,5875
"26065005600",2617,119,43,0,79,24,152,7,3041
"26065005700",5037,231,31,16,168,8,134,9,5634
"26065005800",4400,562,15,1,183,5,145,56,5367
"26065005900",4506,442,2,45,38,147,103,63,5346
"26065006001",2938,354,0,1,34,20,141,12,3500
"26065006002",3273,479,0,0,42,9,61,59,3923
"26065006100",3694,400,18,14,83,0,153,18,4380
"26065006200",4867,339,20,0,52,0,237,21,5536
"26065006301",3574,362,0,0,59,119,187,45,4346
"26065006302",3827,222,15,2,77,13,55,17,4228
"26065006401",3657,56,66,0,98,0,137,0,4014
"26065006402",2645,353,0,0,20,12,46,5,3081
"26065006500",1634,923,137,314,775,112,322,12,4229
"26065006600",1041,646,199,424,145,335,189,568,3547
"26065006700",1015,746,691,684,419,419,153,368,4495
"26065006800",1189,725,491,499,441,148,599,244,4336
"26065007000",3611,678,680,189,407,126,419,57,6167
"26065980000",0,11,0,18,0,0,0,0,29
"26065980100",19,0,0,0,3,0,0,0,22
"26065980200",0,0,0,0,0,0,0,0,0
"26065980300",0,0,0,0,0,0,0,0,0
"26067030100",5046,997,61,23,86,19,105,31,6368
"26067030200",2047,561,15,4,77,22,70,11,2807
"26067030300",2061,524,0,0,172,68,183,12,3020
"26067030400",5347,1020,82,0,265,176,217,214,7321
"26067031200",3918,701,62,0,239,9,329,10,5268
"26067031300",6888,849,22,0,108,331,102,28,8328
"26067031400",3957,358,286,4,49,5,121,17,4797
"26067031500",5032,413,1,3,132,32,183,30,5826
"26067031600",4288,1045,0,2,247,43,184,47,5856
"26067031700",2959,739,45,7,274,128,382,118,4652
"26067031900",5245,512,20,0,240,15,193,7,6232
"26067032100",1092,495,0,0,3,65,13,14,1682
"26067982200",0,0,0,0,0,0,0,0,0
"26069000100",1760,423,0,34,32,56,27,0,2332
"26069000200",3273,611,27,10,71,24,41,0,4057
"26069000300",2123,621,21,8,47,79,58,0,2957
"26069000400",2514,538,0,0,145,0,102,0,3299
"26069000500",2695,370,12,6,62,0,96,15,3256
"26069000600",2355,301,0,0,71,19,34,0,2780
"26069000700",2285,880,4,0,53,16,15,34,3287
"26069000800",1254,166,0,0,29,0,14,0,1463
"26069000900",1529,433,0,0,19,36,29,0,2046
"26069990000",0,0,0,0,0,0,0,0,0
"26071000100",2239,228,6,12,48,10,23,25,2591
"26071000200",1358,142,0,0,64,10,0,6,1580
"26071000300",1930,562,9,0,41,9,22,0,2573
"26071000400",1951,388,1,19,30,36,43,37,2505
"26071000500",1887,196,3,0,19,21,21,2,2149
"26073000100",2590,683,0,4,164,41,103,16,3601
"26073000200",3585,912,6,16,55,15,60,21,4670
"26073000300",4267,771,30,0,157,45,97,30,5397
"26073000400",1950,1362,42,49,141,405,59,0,4008
"26073000500",857,2043,0,74,75,112,12,16,3189
"26073000600",1822,1393,51,198,548,150,114,63,4339
"26073000700",1159,3820,109,223,145,266,56,190,5968
"26073000800",1408,1816,64,100,227,191,180,97,4083
"26073000900",3414,474,26,0,242,20,137,25,4338
"26073940100",3582,520,25,3,250,72,36,7,4495
"26073940200",3601,820,11,24,952,147,318,19,5892
"26073940300",3412,817,72,38,394,188,108,158,5187
"26073940400",2350,858,36,5,221,152,105,37,3764
"26073940500",1325,1024,3,41,82,100,76,94,2745
"26073940600",4169,354,6,11,234,51,57,1,4883
"26075000100",1973,502,69,0,53,0,105,70,2772
"26075000200",1078,789,102,491,121,31,77,110,2799
"26075000400",2672,988,256,161,66,101,152,77,4473
"26075000500",1032,555,138,53,130,39,99,0,2046
"26075000600",550,393,27,215,12,70,0,0,1267
"26075000800",3252,258,285,294,103,26,183,12,4413
"26075000900",1666,672,76,364,141,47,19,0,2985
"26075001000",587,727,403,469,43,123,93,33,2478
"26075001100",95,394,577,867,60,103,19,98,2213
"26075001200",1012,788,77,489,75,84,215,75,2815
"26075001300",556,450,1028,509,130,67,107,113,2960
"26075005000",1457,453,228,62,220,18,46,36,2520
"26075005100",3433,893,17,78,13,15,17,81,4547
"26075005200",5477,163,224,2,381,0,160,0,6407
"26075005301",3335,419,549,304,368,0,189,52,5216
"26075005302",3069,167,125,0,130,0,83,32,3606
"26075005400",4468,979,3,7,86,0,80,20,5643
"26075005500",3372,733,307,31,55,31,116,35,4680
"26075005600",6247,754,167,167,251,0,155,22,7763
"26075005700",2584,390,52,33,207,6,0,0,3272
"26075005800",0,0,0,0,0,0,0,0,0
"26075005900",1754,597,48,104,114,16,73,60,2766
"26075006000",5741,965,0,2,184,82,196,91,7261
"26075006100",4878,1237,8,0,88,46,119,63,6439
"26075006200",6085,456,0,9,79,9,53,0,6691
"26075006301",2796,101,9,4,12,5,6,5,2938
"26075006303",4256,246,1,0,125,23,53,2,4706
"26075006304",2233,478,0,0,19,0,39,1,2770
"26075006401",2590,179,0,0,35,2,71,0,2877
"26075006402",6365,609,18,6,102,31,37,3,7171
"26075006500",5733,454,95,38,273,5,38,12,6648
"26075006600",4147,608,14,7,58,0,50,6,4890
"26075006701",4336,473,96,5,125,40,84,35,5194
"26075006702",3705,800,6,13,182,33,154,0,4893
"26075006801",2849,207,12,0,65,0,28,15,3176
"26075006803",2358,318,1,44,18,6,57,0,2802
"26075006804",5073,353,72,1,91,6,42,45,5683
"26075006900",1609,613,443,183,122,53,201,9,3233
"26077000100",346,274,908,820,213,238,163,91,3053
"26077000201",737,562,125,183,34,100,29,50,1820
"26077000202",19,23,532,337,43,74,9,9,1046
"26077000300",128,239,1638,1584,342,203,63,57,4254
"26077000500",1658,811,306,441,169,64,135,67,3651
"26077000600",1990,1607,73,161,262,81,104,39,4317
"26077000900",386,619,31,17,9,55,34,349,1500
"26077001000",1985,991,742,1181,344,65,404,350,6062
"26077001100",1318,446,112,154,58,8,130,46,2272
"26077001200",2631,200,281,0,151,0,51,7,3321
"26077001300",1290,154,129,99,70,119,53,20,1934
"26077001501",2780,442,524,121,165,135,54,21,4242
"26077001502",2665,790,442,256,235,0,112,159,4659
"26077001503",3266,418,462,141,247,169,130,239,5072
"26077001504",156,257,5,284,28,123,6,119,978
"26077001506",3360,2482,225,132,346,476,68,148,7237
"26077001507",1799,3080,468,553,256,582,236,466,7440
"26077001601",1936,178,123,93,208,74,73,12,2697
"26077001603",844,229,8,7,169,3,36,0,1296
"26077001604",1367,175,37,127,127,6,30,6,1875
"26077001701",2219,347,383,154,302,17,138,0,3560
"26077001702",2384,779,448,200,150,43,292,290,4586
"26077001801",2166,462,416,56,227,41,137,0,3505
"26077001802",3109,752,476,191,290,1,192,105,5116
"26077001803",1143,406,255,129,127,89,110,60,2319
"26077001905",3990,660,107,321,295,51,130,74,5628
"26077001906",3433,467,150,0,350,16,25,0,4441
"26077001907",3046,345,183,171,338,59,63,60,4265
"26077002002",3039,407,59,1,158,3,69,4,3740
"26077002003",4460,371,514,29,264,25,105,0,5768
"26077002004",3596,302,80,10,498,29,144,8,4667
"26077002005",2953,214,171,482,263,37,63,64,4247
"26077002101",6741,414,175,0,427,66,341,115,8279
"26077002102",2715,148,35,0,36,0,52,0,2986
"26077002201",1664,524,72,0,76,12,121,1,2470
"26077002202",5495,964,814,230,417,144,227,0,8291
"26077002601",4331,205,64,4,102,0,94,4,4804
"26077002700",6981,292,223,68,123,32,283,0,8002
"26077002801",3870,317,0,2,61,0,114,76,4440
"26077002802",4580,688,254,16,427,10,0,0,5975
"26077002901",3322,245,13,30,16,80,151,11,3868
"26077002903",2050,1214,505,721,76,219,235,68,5088
"26077002904",6638,1285,672,69,660,162,301,19,9806
"26077002905",4893,893,989,138,399,192,128,221,7853
"26077003002",2163,149,11,13,24,0,44,0,2404
"26077003003",6997,249,111,189,341,52,127,0,8066
"26077003004",6087,243,248,0,815,111,276,0,7780
"26077003302",4926,973,33,0,282,0,194,0,6408
"26077003400",3523,247,26,0,91,0,30,0,3917
"26077003500",3304,422,182,48,218,55,91,0,4320
"26077005501",2684,222,545,139,172,37,306,2,4107
"26077005502",3228,503,1132,684,356,24,288,81,6296
"26077006102",3462,301,6,21,45,0,52,0,3887
"26077006103",3885,451,14,15,150,47,9,0,4571
"26077006601",3801,373,34,15,53,11,147,16,4450
"26077006701",1956,507,18,3,133,37,60,13,2727
"26077006702",5058,463,30,87,100,11,65,0,5814
"26079950200",3546,856,32,15,118,41,53,10,4671
"26079950300",3716,743,9,3,63,50,61,8,4653
"26079950400",2970,656,13,4,78,28,40,11,3800
"26079950601",1797,213,0,5,37,6,18,2,2078
"26079950602",1504,221,0,0,66,6,5,47,1849
"26081000100",1737,194,76,77,72,49,54,0,2259
"26081000200",1344,109,16,5,51,0,120,0,1645
"26081000300",3908,301,158,0,492,0,103,0,4962
"26081000400",2620,309,67,34,60,14,56,48,3208
"26081000500",3375,240,13,45,118,9,192,9,4001
"26081000600",3120,201,59,17,168,33,87,0,3685
"26081000700",2348,331,0,18,414,14,483,183,3791
"26081000800",1344,693,227,346,58,226,147,219,3260
"26081000900",1764,635,35,500,216,77,305,84,3616
"26081001000",2420,595,436,215,338,42,103,44,4193
"26081001101",2545,571,1261,600,318,22,215,234,5766
"26081001102",2357,362,499,629,116,28,29,80,4100
"26081001200",2258,440,281,272,178,76,200,82,3787
"26081001300",1321,678,401,620,336,268,415,273,4312
"26081001400",1234,668,38,276,131,33,189,108,2677
"26081001500",1547,1019,135,497,338,296,657,689,5178
"26081001600",3084,917,177,298,403,151,675,258,5963
"26081001700",3470,398,12,17,193,88,26,104,4308
"26081001800",5471,728,55,1,85,101,123,431,6995
"26081001900",2980,725,147,275,795,147,1080,267,6416
"26081002000",782,456,157,400,70,65,68,54,2052
"26081002100",1627,661,75,206,97,42,151,106,2965
"26081002200",2890,855,529,185,169,115,60,172,4975
"26081002300",3009,404,38,62,245,62,313,8,4141
"26081002400",1776,598,66,26,27,22,58,72,2645
"26081002500",2343,1063,290,214,104,52,95,306,4467
"26081002600",1255,691,314,410,154,496,1245,1012,5577
"26081002700",1701,973,115,369,65,117,399,434,4173
"26081002800",175,268,408,440,85,223,185,328,2112
"26081002900",788,291,300,161,53,27,139,132,1891
"26081003000",705,202,394,226,65,76,81,57,1806
"26081003100",300,112,1363,780,451,77,554,98,3735
"26081003200",386,318,1727,1974,228,167,155,200,5155
"26081003300",2139,451,553,300,125,21,285,111,3985
"26081003400",2814,565,1295,509,416,221,125,193,6138
"26081003500",1585,355,1842,1163,346,21,649,159,6120
"26081003600",394,445,928,492,99,321,610,545,3834
"26081003700",935,437,1573,1233,171,367,881,209,5806
"26081003800",929,1318,229,672,566,446,987,1695,6842
"26081003900",762,935,255,146,743,607,1297,1393,6138
"26081004000",1493,932,284,100,789,169,1909,909,6585
"26081004100",2787,410,561,376,374,158,312,317,5295
"26081004200",2787,118,559,221,136,39,236,39,4135
"26081004300",2672,273,443,11,199,40,132,0,3770
"26081004400",4523,509,358,19,56,72,30,0,5567
"26081004500",3745,469,1090,524,1127,163,401,13,7532
"26081004600",2594,244,1701,543,1032,243,332,301,6990
"26081010101",4716,623,0,3,241,9,238,68,5898
"26081010102",1938,426,0,0,56,30,36,12,2498
"26081010200",3077,842,29,12,152,35,83,0,4230
"26081010301",4039,486,77,44,283,58,428,98,5513
"26081010302",4782,402,93,0,381,61,269,0,5988
"26081010401",4034,685,34,124,98,125,153,149,5402
"26081010402",3440,395,78,31,117,14,183,14,4272
"26081010600",9569,891,0,0,221,76,232,0,10989
"26081010700",4489,648,0,112,81,27,59,81,5497
"26081010801",7201,373,0,6,287,27,85,27,8006
"26081010802",5186,479,30,14,127,0,150,85,6071
"26081010902",3549,183,41,0,36,0,52,0,3861
"26081010903",6273,110,103,0,262,0,273,0,7021
"26081010904",6163,477,59,6,172,0,178,0,7055
"26081011001",3551,115,0,9,63,1,43,35,3817
"26081011002",3432,233,0,0,73,0,68,0,3806
"26081011101",3915,217,59,0,27,6,68,0,4292
"26081011102",4613,202,21,7,372,12,100,0,5327
"26081011200",3660,439,26,15,102,0,134,47,4423
"26081011301",4043,383,10,15,277,12,364,0,5104
"26081011302",4674,620,294,196,154,10,228,7,6183
"26081011401",2077,64,14,40,32,0,58,2,2287
"26081011403",1985,275,67,8,125,6,73,0,2539
"26081011405",2458,132,50,0,170,150,182,126,3268
"26081011406",2662,1014,320,569,583,602,743,957,7450
"26081011500",5276,756,211,286,262,128,421,0,7340
"26081011600",6773,615,80,0,248,160,380,63,8319
"26081011701",4561,443,42,0,233,99,117,80,5575
"26081011702",3288,578,44,71,181,86,61,60,4369
"26081011801",6252,231,45,21,379,9,159,0,7096
"26081011803",3428,135,106,0,314,29,123,0,4135
"26081011804",4215,147,81,0,224,0,140,0,4807
"26081011901",5993,81,72,1,147,14,158,0,6466
"26081011902",6450,230,0,3,584,0,90,11,7368
"26081012002",5680,540,79,15,102,0,326,0,6742
"26081012003",5408,748,36,0,90,43,34,0,6359
"26081012004",3928,465,8,0,45,41,96,12,4595
"26081012201",6405,97,19,0,277,19,99,0,6916
"26081012202",6776,88,0,0,39,0,0,0,6903
"26081012203",3479,173,41,0,287,0,107,0,4087
"26081012300",3216,76,21,3,40,20,23,0,3399
"26081012400",3632,85,10,5,54,9,63,0,3858
"26081012500",4362,43,30,0,132,32,103,0,4702
"26081012604",3597,245,579,192,1016,21,201,24,5875
"26081012605",2104,300,222,45,337,61,93,0,3162
"26081012606",2437,627,723,693,522,369,239,504,6114
"26081012607",2972,588,1477,330,300,237,351,434,6689
"26081012608",2037,204,477,22,453,208,58,21,3480
"26081012701",3565,193,962,659,1002,396,644,96,7517
"26081012702",3130,182,510,25,667,47,208,0,4769
"26081012703",3048,122,613,602,583,32,376,17,5393
"26081012800",3257,151,541,0,333,28,270,11,4591
"26081012901",2262,764,149,224,628,476,624,328,5455
"26081012902",3081,356,364,141,531,46,342,144,5005
"26081013000",2639,346,66,1,251,76,201,128,3708
"26081013100",4290,432,175,115,216,76,382,20,5706
"26081013200",6071,282,59,75,270,44,196,3,7000
"26081013300",2442,1359,373,226,499,163,1408,901,7371
"26081013400",4352,360,166,49,238,137,371,140,5813
"26081013500",2160,835,126,209,674,261,733,667,5665
"26081013600",1224,236,211,6,282,89,464,121,2633
"26081013700",4726,840,134,43,392,116,448,399,7098
"26081013801",1106,135,65,60,105,27,190,27,1715
"26081013802",4257,816,380,413,658,562,1403,681,9170
"26081013900",5349,823,96,108,472,160,881,136,8025
"26081014000",5034,909,279,0,893,174,1131,462,8882
"26081014100",1538,202,61,17,63,20,225,42,2168
"26081014200",2324,318,413,60,791,138,1067,277,5388
"26081014300",2113,423,152,153,314,88,477,120,3840
"26081014501",8792,659,116,5,918,31,391,153,11065
"26081014502",6273,571,83,22,451,151,642,312,8505
"26081014601",7358,93,164,0,429,17,73,17,8151
"26081014602",8555,646,0,0,399,45,195,60,9900
"26081014701",1714,610,223,137,317,308,121,319,3749
"26081014703",2553,617,340,84,267,125,79,250,4315
"26081014704",2261,325,96,44,161,66,127,11,3091
"26081014803",2988,25,5,8,54,7,0,1,3088
"26081014804",5854,530,1162,138,709,170,292,58,8913
"26081014805",6094,160,177,1,479,0,283,0,7194
"26081014806",4921,284,4,7,152,0,56,11,5435
"26081014807",6445,297,33,6,367,25,315,13,7501
"26083000100",1757,383,4,6,3,1,8,0,2162
"26083980100",12,0,1,1,0,0,0,0,14
"26083990100",0,0,0,0,0,0,0,0,0
"26085960100",1518,505,12,12,36,3,11,2,2099
"26085961100",2064,801,338,199,69,59,22,3,3555
"26085961200",1503,567,85,193,57,153,112,32,2702
"26085961300",1939,846,6,9,45,12,19,31,2907
"26087330000",3061,366,21,6,111,14,70,19,3668
"26087330500",2608,375,14,5,122,24,94,9,3251
"26087331000",1502,207,0,4,30,17,75,32,1867
"26087331500",2345,249,0,0,100,18,55,9,2776
"26087332000",5020,606,0,0,61,0,69,0,5756
"26087332500",3096,464,0,0,87,0,180,20,3847
"26087333000",2794,274,12,6,13,11,88,11,3209
"26087333500",4921,717,0,0,48,15,1,0,5702
"26087334000",1771,219,0,2,115,1,138,10,2256
"26087334500",1923,110,0,1,141,0,81,0,2256
"26087336000",4700,302,57,30,17,0,66,0,5172
"26087336500",0,0,0,0,0,0,0,0,0
"26087337000",2511,838,0,44,68,16,9,11,3497
"26087337500",2693,1111,0,7,158,114,123,177,4383
"26087338000",4474,421,0,0,143,0,135,0,5173
"26087338500",4046,499,103,0,22,67,141,0,4878
"26087339000",2552,343,8,14,160,50,579,124,3830
"26087339500",2504,663,0,0,370,51,831,50,4469
"26087340000",3667,170,0,0,28,0,121,0,3986
"26087340500",2336,215,0,0,151,6,67,18,2793
"26087341000",4294,437,0,0,20,13,12,3,4779
"26087341500",3822,311,0,2,98,0,43,18,4294
"26087342000",4013,445,25,2,41,0,77,0,4603
"26087342100",3385,109,0,0,90,0,169,0,3753
"26089970100",1877,181,0,0,18,59,71,35,2241
"26089970200",3934,492,13,74,507,329,142,227,5718
"26089970300",2382,223,0,8,147,27,92,48,2927
"26089970400",1511,148,0,6,12,0,30,35,1742
"26089970500",4050,454,2,8,131,37,62,0,4744
"26089970600",4487,345,0,0,100,0,65,20,5017
"26089990000",0,0,0,0,0,0,0,0,0
"26091060100",3070,260,19,0,101,0,58,3,3511
"26091060301",4587,445,0,0,133,0,132,0,5297
"26091060302",3082,408,0,0,61,0,65,9,3625
"26091060401",3028,421,0,0,60,2,65,3,3579
"26091060402",2806,380,12,0,51,0,10,37,3296
"26091060500",2761,341,26,0,136,116,176,127,3683
"26091060600",4753,231,28,0,67,6,250,95,5430
"26091060700",6445,518,5,44,301,27,229,122,7691
"26091060800",2853,481,51,0,64,87,114,121,3771
"26091061200",1508,110,0,0,29,95,65,88,1895
"26091061301",2274,1107,17,55,119,114,731,223,4640
"26091061302",1606,876,66,112,190,172,342,423,3787
"26091061400",2471,520,57,20,167,69,327,83,3714
"26091061500",3900,530,60,50,135,19,346,82,5122
"26091061600",2090,1265,99,77,446,257,679,518,5431
"26091061700",5616,1019,51,14,394,127,474,148,7843
"26091061800",3057,684,12,10,108,0,172,21,4064
"26091061900",3779,601,32,12,106,20,98,86,4734
"26091062000",2367,318,7,2,70,132,96,41,3033
"26091062100",3822,347,0,0,106,4,156,18,4453
"26091062200",2004,293,0,0,119,93,45,83,2637
"26091062300",4658,280,13,0,131,0,104,10,5196
"26091062400",4100,425,16,32,158,0,107,26,4864
"26093710100",2331,48,23,1,50,0,34,0,2487
"26093710300",3524,294,0,0,192,0,42,19,4071
"26093710500",1527,121,0,0,161,0,16,0,1825
"26093710700",1758,64,0,0,13,0,6,0,1841
"26093711000",3743,210,18,0,220,24,29,0,4244
"26093712101",2627,13,0,1,157,0,24,0,2822
"26093712102",2286,108,0,0,138,0,73,0,2605
"26093712601",3349,103,25,0,90,0,0,0,3567
"26093712602",2936,109,39,0,89,9,169,0,3351
"26093713100",4229,162,0,0,62,24,42,0,4519
"26093713300",1445,60,33,1,29,0,11,0,1579
"26093713500",3524,299,0,0,91,0,95,5,4014
"26093713700",4565,167,0,0,109,10,68,0,4919
"26093720100",2906,494,8,0,173,0,143,8,3732
"26093721100",3080,197,19,0,73,2,1,2,3374
"26093722100",2643,292,0,1,0,0,23,0,2959
"26093722300",2527,382,0,0,0,17,147,1,3074
"26093722500",1929,224,12,0,45,0,0,81,2291
"26093724001",1784,151,0,0,18,0,34,0,1987
"26093724002",2263,61,0,0,163,0,0,0,2487
"26093724003",2097,79,1,0,22,15,60,0,2274
"26093725000",4209,636,0,0,175,0,136,0,5156
"26093725100",2737,908,25,29,201,100,136,84,4220
"26093730101",2550,79,0,0,21,0,136,42,2828
"26093730102",3567,314,1,1,24,0,63,0,3970
"26093730600",3309,159,25,0,118,0,46,0,3657
"26093731100",3719,67,15,0,34,7,85,10,3937
"26093732100",3107,202,0,3,95,0,49,2,3458
"26093733100",1734,134,20,11,76,19,0,48,2042
"26093733601",2365,147,0,1,86,0,62,0,2661
"26093733602",3418,225,0,0,33,54,77,8,3815
"26093740200",3314,123,18,23,128,5,160,0,3771
"26093740300",1661,97,16,3,15,0,0,0,1792
"26093740500",2143,85,0,0,39,0,0,5,2272
"26093740600",2919,136,0,1,19,0,11,0,3086
"26093740700",2334,53,23,0,52,5,16,0,2483
"26093740800",2352,171,0,0,214,5,35,0,2777
"26093740900",1815,60,1,0,66,15,16,15,1988
"26093741100",1968,264,16,0,9,0,88,12,2357
"26093741601",1648,87,0,21,5,0,5,0,1766
"26093741602",3233,120,0,0,86,0,21,9,3469
"26093742201",3001,105,0,0,37,0,19,0,3162
"26093742202",1730,168,37,1,13,0,48,1,1998
"26093742401",743,107,16,3,117,26,88,28,1128
"26093742402",3733,257,96,1,65,8,45,10,4215
"26093742500",2173,143,0,0,0,0,7,0,2323
"26093742700",3573,16,12,0,68,3,111,0,3783
"26093742900",3556,106,15,0,56,2,209,2,3946
"26093743300",2401,103,0,0,29,0,67,0,2600
"26093743400",3533,138,0,0,104,0,99,9,3883
"26093743500",1843,101,0,0,24,6,43,0,2017
"26093743600",2634,34,6,0,38,82,67,0,2861
"26093743700",2422,247,0,0,14,31,7,5,2726
"26093743800",3585,118,0,0,157,0,20,0,3880
"26093743900",3629,46,13,0,53,0,89,0,3830
"26093744200",3349,177,9,0,61,0,24,0,3620
"26093744400",2156,99,8,0,72,12,12,0,2359
"26093744600",1755,105,0,0,90,0,43,0,1993
"26093744700",2633,216,0,0,98,0,88,0,3035
"26093744800",3887,123,0,0,193,47,82,47,4379
"26093744900",2292,238,38,0,47,0,0,0,2615
"26095960100",2108,654,0,6,425,82,26,9,3310
"26095960200",1745,292,0,2,97,57,14,10,2217
"26095980000",0,0,0,0,0,0,0,0,0
"26095990000",0,0,0,0,0,0,0,0,0
"26097950100",1407,128,1,0,135,54,0,0,1725
"26097950200",1616,328,0,21,384,57,12,0,2418
"26097950300",1241,243,9,3,194,22,0,19,1731
"26097950400",1557,112,58,56,703,247,29,0,2762
"26097950500",1357,279,0,2,525,158,14,11,2346
"26097990000",0,0,0,0,0,0,0,0,0
"26099206700",2745,320,140,52,283,15,138,3,3696
"26099210000",3951,275,24,0,33,27,38,6,4354
"26099211000",4231,941,55,171,306,22,179,279,6184
"26099212000",5065,204,8,4,53,0,81,8,5423
"26099214000",2095,282,0,1,170,22,115,67,2752
"26099214500",4273,135,118,3,33,0,0,0,4562
"26099215000",4698,223,0,0,194,0,273,22,5410
"26099215200",6609,619,18,6,75,65,190,59,7641
"26099215300",3439,119,181,170,211,21,128,0,4269
"26099215500",6318,259,77,5,457,3,902,6,8027
"26099216000",3596,213,13,7,16,25,62,2,3934
"26099217000",2618,254,7,0,32,20,11,0,2942
"26099218000",4384,578,613,141,479,93,58,16,6362
"26099220001",6947,544,0,2,313,0,205,0,8011
"26099220002",3827,382,38,80,0,0,39,2,4368
"26099221100",5745,457,369,20,116,60,197,16,6980
"26099221200",5344,499,85,16,158,0,317,0,6419
"26099221500",895,133,0,0,138,0,24,0,1190
"26099221800",4540,49,258,0,202,1,78,0,5128
"26099222101",3527,878,519,12,166,70,80,0,5252
"26099222102",6421,406,665,217,297,254,191,251,8702
"26099222500",3436,142,11,0,60,0,13,0,3662
"26099222800",2816,220,145,14,57,0,85,0,3337
"26099223400",8332,181,407,69,302,35,285,0,9611
"26099223500",1017,133,25,1,54,1,5,1,1237
"26099223800",12663,337,206,1,909,0,106,0,14222
"26099223900",7447,276,93,1,364,0,227,0,8408
"26099224000",10354,677,526,0,847,16,210,0,12630
"26099224100",7582,163,330,48,866,0,247,0,9236
"26099224200",6328,612,492,43,437,20,18,0,7950
"26099224300",4518,159,124,0,155,0,0,0,4956
"26099224400",4736,98,26,0,289,21,69,0,5239
"26099224500",3341,131,108,0,341,0,0,0,3921
"26099224600",4768,605,230,101,117,44,194,388,6447
"26099225100",2332,343,181,79,70,19,39,0,3063
"26099225200",5200,192,47,2,211,0,1,0,5653
"26099225300",3670,418,30,16,172,47,65,4,4422
"26099225400",6945,526,35,0,179,52,112,20,7869
"26099225500",4918,408,21,0,115,31,90,24,5607
"26099225600",3463,503,166,0,302,30,211,14,4689
"26099225701",2993,921,482,285,666,193,79,30,5649
"26099225702",1166,165,21,0,79,0,43,0,1474
"26099225800",5335,303,35,7,488,18,91,0,6277
"26099225900",4374,244,0,0,297,0,68,0,4983
"26099226100",6751,548,160,9,283,0,65,0,7816
"26099226400",2163,119,0,1,54,7,94,0,2438
"26099226700",3851,611,18,6,107,5,150,0,4748
"26099227000",6161,422,95,4,471,28,154,0,7335
"26099227300",3541,186,115,265,109,18,23,0,4257
"26099228000",2726,283,155,41,71,34,74,0,3384
"26099228100",1144,152,0,20,69,15,139,12,1551
"26099230000",2993,324,392,106,232,72,18,0,4137
"26099230200",4295,283,99,0,212,0,106,12,5007
"26099230300",3105,1122,41,52,156,41,104,0,4621
"26099230400",3354,114,208,9,0,4,121,0,3810
"26099230500",2531,1022,116,62,96,34,316,64,4241
"26099230601",5795,115,187,0,946,28,100,0,7171
"26099230602",4445,730,75,10,922,0,84,0,6266
"26099230700",3824,453,40,0,939,251,78,0,5585
"26099230800",3475,727,0,0,221,54,49,39,4565
"26099230900",6107,930,413,34,154,48,311,0,7997
"26099231000",3430,455,164,16,95,67,82,45,4354
"26099231100",2250,228,416,52,354,59,95,2,3456
"26099231200",3185,168,94,19,279,0,25,0,3770
"26099231400",4566,927,131,44,586,47,7,0,6308
"26099231500",3713,925,21,0,682,41,116,0,5498
"26099231600",2331,577,342,213,651,210,60,0,4384
"26099231700",4247,398,474,34,1019,73,93,0,6338
"26099231800",3040,522,111,0,260,51,47,0,4031
"26099231900",4595,636,269,1,353,23,65,5,5947
"26099232000",1697,28,51,0,133,16,11,0,1936
"26099232100",4900,271,794,188,608,83,174,0,7018
"26099232200",2989,448,400,6,620,30,12,0,4505
"26099232300",2645,1307,397,62,392,120,99,58,5080
"26099232400",3902,1424,182,0,666,11,0,0,6185
"26099232500",3723,73,384,0,159,5,205,0,4549
"26099233000",5028,343,139,48,128,0,0,0,5686
"26099240000",1698,621,666,777,128,29,40,183,4142
"26099240300",3492,281,228,41,168,27,102,32,4371
"26099240400",4658,268,72,37,108,15,48,2,5208
"26099240500",1656,162,167,0,295,17,254,88,2639
"26099240600",5554,319,471,81,433,27,188,0,7073
"26099240700",3740,154,201,2,189,8,66,21,4381
"26099240800",4302,697,881,159,188,0,111,0,6338
"26099240900",1579,76,77,6,48,1,47,0,1834
"26099241000",2637,385,726,259,76,30,86,8,4207
"26099241200",3359,578,464,218,140,32,6,0,4797
"26099241300",1416,222,454,133,252,95,142,39,2753
"26099241400",2803,458,53,29,210,0,176,0,3729
"26099241500",2777,209,319,30,331,0,84,0,3750
"26099241600",1373,310,378,184,185,18,66,18,2532
"26099241700",2643,756,563,1,258,155,80,0,4456
"26099241800",2781,294,1583,689,222,12,18,0,5599
"26099241900",3330,298,575,100,139,20,17,0,4479
"26099242000",3930,599,811,272,193,89,102,0,5996
"26099242100",1590,151,481,309,51,12,135,0,2729
"26099242500",5002,346,410,22,97,23,26,0,5926
"26099243000",3988,228,274,13,302,6,40,0,4851
"26099243500",3929,450,589,101,246,17,75,0,5407
"26099244000",1867,220,21,0,126,0,9,0,2243
"26099245000",1137,357,1265,752,73,42,8,20,3654
"26099245100",2360,405,422,254,379,30,162,11,4023
"26099245200",1097,342,130,46,46,4,13,0,1678
"26099245300",3348,350,414,194,0,0,0,0,4306
"26099245400",484,97,513,127,109,0,67,0,1397
"26099247100",396,647,4,0,72,31,72,261,1483
"26099247200",5603,157,788,91,50,0,0,0,6689
"26099247300",5667,231,142,0,213,37,64,0,6354
"26099247400",2260,227,0,1,20,0,56,0,2564
"26099247500",1169,303,57,35,51,34,3,0,1652
"26099247601",861,65,536,289,72,54,0,45,1922
"26099247602",3188,438,427,164,282,1,195,147,4842
"26099250000",1946,407,34,5,17,0,35,0,2444
"26099250100",1885,196,79,0,19,49,37,0,2265
"26099250200",2403,368,0,0,49,0,0,0,2820
"26099250300",2641,135,114,117,42,115,68,36,3268
"26099250400",1256,77,12,0,110,6,29,0,1490
"26099250500",1779,138,29,1,14,59,0,3,2023
"26099250600",2592,156,17,0,43,0,140,0,2948
"26099250700",2359,216,114,0,31,30,23,9,2782
"26099250800",2566,149,224,0,103,0,121,0,3163
"26099250900",2311,203,13,51,88,0,46,0,2712
"26099251000",1260,334,7,0,2,66,9,23,1701
"26099251100",1803,96,0,0,49,0,53,0,2001
"26099251200",2939,159,0,0,57,26,30,0,3211
"26099251300",2136,123,12,0,120,0,97,1,2489
"26099251400",2447,232,0,0,125,29,65,0,2898
"26099251500",1483,156,121,14,91,0,57,0,1922
"26099251600",2542,240,181,46,99,17,46,6,3177
"26099251700",2380,255,151,62,70,42,0,57,3017
"26099251800",2682,281,451,176,185,155,51,0,3981
"26099251900",2228,296,41,0,34,51,34,51,2735
"26099252000",2107,205,274,13,95,12,74,0,2780
"26099252100",1913,93,213,20,78,0,44,0,2361
"26099252200",2197,195,220,0,72,6,5,0,2695
"26099254000",1402,174,61,5,75,6,56,0,1779
"26099254100",3519,167,239,94,130,13,70,1,4233
"26099254200",3542,316,262,45,205,8,74,10,4462
"26099254500",3089,560,452,42,12,8,36,26,4225
"26099255000",2926,352,824,122,175,68,8,52,4527
"26099255100",2474,258,76,11,177,156,56,0,3208
"26099255200",1997,333,344,568,280,47,97,0,3666
"26099255300",2402,272,738,317,264,35,106,25,4159
"26099255400",2316,187,31,0,80,73,108,64,2859
"26099255500",1248,219,94,1,55,3,48,6,1674
"26099255600",2442,580,77,56,234,0,56,0,3445
"26099255700",1113,165,251,5,108,6,30,1,1679
"26099255800",1663,409,107,11,84,0,31,0,2305
"26099255900",1215,199,91,101,144,117,32,0,1899
"26099256000",1490,208,271,8,225,60,16,8,2286
"26099256100",1508,417,257,222,67,148,0,114,2733
"26099256200",1356,240,208,97,0,1,26,0,1928
"26099256300",1274,201,518,19,77,73,52,88,2302
"26099256400",839,272,128,30,23,0,0,10,1302
"26099256500",1081,266,119,5,80,53,47,66,1717
"26099256600",1821,195,467,339,304,6,91,0,3223
"26099256700",1310,152,103,132,81,0,9,40,1827
"26099256800",1165,241,0,43,37,72,0,5,1563
"26099258000",1573,135,923,197,132,0,187,31,3178
"26099258100",2128,422,739,333,122,67,132,0,3943
"26099258200",1552,380,543,310,67,0,11,3,2866
"26099258300",1459,214,404,344,23,177,33,175,2829
"26099258400",2903,473,714,1005,90,43,103,0,5331
"26099258500",705,58,827,178,107,102,21,3,2001
"26099258600",1654,346,1064,739,82,119,96,0,4100
"26099258700",1190,227,670,207,349,32,84,9,2768
"26099258800",1017,141,1897,613,156,0,98,0,3922
"26099258900",1157,100,570,494,10,163,73,0,2567
"26099260000",2677,89,43,0,225,115,49,85,3283
"26099260100",2223,203,349,87,17,29,0,0,2908
"26099260200",2061,124,111,0,35,0,24,0,2355
"26099260300",2170,341,110,2,111,27,38,0,2799
"26099260400",3281,350,244,3,450,0,89,0,4417
"26099260600",2193,439,94,0,57,0,167,0,2950
"26099260700",2406,257,28,32,423,123,40,0,3309
"26099260800",2069,263,81,0,411,0,15,0,2839
"26099260900",3147,443,241,65,593,147,38,0,4674
"26099261000",2067,166,589,0,189,52,57,0,3120
"26099261100",2903,754,577,187,186,37,1,0,4645
"26099261200",2442,192,52,64,135,0,7,0,2892
"26099261300",2124,379,216,35,141,0,42,0,2937
"26099261400",2441,240,0,0,72,29,89,0,2871
"26099261500",2179,350,344,125,74,188,53,0,3313
"26099261600",1097,41,61,67,18,30,17,0,1331
"26099261700",1239,85,406,208,47,9,46,0,2040
"26099261800",1993,182,306,1,283,0,12,23,2800
"26099261900",1978,457,182,70,164,24,64,0,2939
"26099262000",2482,307,125,83,177,171,102,14,3461
"26099262100",705,339,77,87,23,71,30,16,1348
"26099262200",3676,202,210,2,170,170,117,0,4547
"26099262300",2392,372,388,16,825,279,61,7,4340
"26099262400",1541,537,369,45,360,149,0,22,3023
"26099262500",3519,583,610,50,412,147,43,1,5365
"26099262600",1621,156,411,65,69,0,8,0,2330
"26099262700",2967,306,900,331,288,119,0,78,4989
"26099262800",1448,277,248,122,224,38,14,7,2378
"26099262900",2399,854,363,68,108,262,28,0,4082
"26099263200",1536,604,413,292,59,75,48,0,3027
"26099263400",2510,569,100,39,456,231,18,36,3959
"26099263500",2795,597,561,44,247,219,21,191,4675
"26099263600",1512,708,1218,577,298,393,0,57,4763
"26099263700",2596,529,399,564,177,244,15,5,4529
"26099263800",1107,541,334,350,196,165,139,2,2834
"26099263900",1337,713,660,556,18,153,0,25,3462
"26099264000",603,237,553,378,51,98,36,9,1965
"26099264200",1771,635,650,629,113,48,87,226,4159
"26099267600",1152,58,118,0,70,12,11,0,1421
"26099268000",3670,663,461,167,191,130,61,17,5360
"26099268100",1512,358,267,287,344,30,12,67,2877
"26099268200",3520,511,42,43,35,36,0,0,4187
"26099268300",1207,305,550,934,0,187,15,0,3198
"26099268400",2036,362,58,683,41,40,61,0,3281
"26099982000",4,0,0,0,0,0,0,0,4
"26099982100",0,0,0,0,0,0,0,0,0
"26099982200",0,19,0,8,0,0,0,0,27
"26099982300",54,10,0,0,0,0,0,0,64
"26099990100",0,0,0,0,0,0,0,0,0
"26101000100",2478,786,0,0,54,7,65,14,3404
"26101000200",1505,250,13,1,25,1,15,15,1825
"26101000300",1755,241,3,15,93,3,105,32,2247
"26101000400",1739,263,5,7,155,62,63,5,2299
"26101000500",2020,389,0,41,131,8,25,3,2617
"26101000600",1194,467,0,0,19,0,8,0,1688
"26101000700",3322,497,13,2,217,69,28,3,4151
"26101000800",2518,636,18,76,80,38,68,90,3524
"26101000900",1620,249,0,1,132,41,80,0,2123
"26101990000",0,0,0,0,0,0,0,0,0
"26103000100",1349,730,0,9,8,16,24,17,2153
"26103000200",1495,705,3,11,17,55,0,0,2286
"26103000300",1361,322,4,6,55,42,19,18,1827
"26103000400",1465,452,12,4,72,26,9,0,2040
"26103000500",52,81,0,5,0,14,0,2,154
"26103000600",1157,744,17,8,136,178,0,0,2240
"26103000700",2621,564,0,71,80,0,43,0,3379
"26103001100",1528,71,11,0,40,16,11,0,1677
"26103001200",4692,396,12,5,316,83,42,8,5554
"26103001300",3394,476,13,0,62,18,102,0,4065
"26103001500",2815,224,0,0,56,18,0,0,3113
"26103001600",2183,111,4,0,101,0,40,18,2457
"26103001700",1717,256,14,0,57,78,28,0,2150
"26103001800",2304,225,0,0,107,4,59,0,2699
"26103001900",1269,347,0,1,2,1,0,0,1620
"26103002000",1462,837,0,1,1,45,0,0,2346
"26103002100",2734,151,0,1,47,0,33,0,2966
"26103002200",2912,319,0,0,65,2,29,0,3327
"26103002300",1735,379,0,0,16,7,39,4,2180
"26103002400",1637,898,8,18,148,218,53,98,3078
"26103002500",2146,251,0,0,84,16,13,0,2510
"26103002600",1746,169,0,15,37,10,0,0,1977
"26103002800",3176,548,0,0,284,49,0,0,4057
"26103002900",3239,267,24,0,324,23,43,19,3939
"26103990000",0,0,0,0,0,0,0,0,0
"26105950100",2113,357,12,2,96,13,105,0,2698
"26105950200",2997,453,7,0,37,20,18,2,3534
"26105950300",2914,343,0,0,40,36,81,26,3440
"26105950400",3412,645,5,9,183,84,75,80,4493
"26105950500",2553,721,0,1,91,84,71,286,3807
"26105950600",4054,739,21,42,179,73,159,31,5298
"26105950700",2478,576,33,4,84,25,51,13,3264
"26105950800",2417,235,24,0,46,29,93,43,2887
"26105990000",0,0,0,0,0,0,0,0,0
"26107960100",1928,494,4,15,54,20,61,14,2590
"26107960200",2127,424,30,14,124,12,23,46,2800
"26107960300",2426,349,2,0,72,15,20,2,2886
"26107960400",3754,516,8,0,171,51,27,9,4536
"26107960500",2352,1372,53,90,145,4,24,16,4056
"26107960600",1893,1370,86,125,42,201,59,138,3914
"26107960700",3990,1439,0,54,113,140,80,0,5816
"26107960800",3571,1337,27,0,65,19,83,4,5106
"26107960900",2476,405,96,48,120,49,22,2,3218
"26107961000",4674,749,196,0,112,48,94,39,5912
"26107981300",0,10,0,0,0,0,0,0,10
"26109960100",2805,457,12,8,67,31,9,1,3390
"26109960200",2840,414,5,6,346,206,50,47,3914
"26109960300",2082,319,5,4,12,14,59,17,2512
"26109960400",3196,228,1,1,106,19,27,0,3578
"26109960500",2512,302,0,0,49,20,0,6,2889
"26109960600",3135,635,8,0,95,56,19,0,3948
"26109960700",2583,816,0,0,65,0,87,9,3560
"26109990000",0,0,0,0,0,0,0,0,0
"26111290100",2443,800,34,19,155,57,76,47,3631
"26111290200",2808,751,0,0,171,0,148,44,3922
"26111290300",3410,197,17,5,119,0,66,12,3826
"26111290400",1496,214,0,1,28,0,60,0,1799
"26111290500",1727,128,0,8,56,8,34,0,1961
"26111290600",1709,568,0,0,150,0,110,0,2537
"26111290700",2136,620,170,68,438,202,40,31,3705
"26111290800",3865,802,15,0,291,19,43,0,5035
"26111290900",6420,516,81,0,449,0,181,0,7647
"26111291000",4953,633,257,0,411,65,38,57,6414
"26111291101",2963,398,75,3,60,16,46,0,3561
"26111291102",8254,644,108,24,188,100,60,34,9412
"26111291200",4434,507,0,0,278,17,91,14,5341
"26111291300",3952,360,0,6,70,21,77,2,4488
"26111291400",3538,487,0,5,116,12,133,29,4320
"26111291500",3434,697,10,7,108,3,77,58,4394
"26111291601",2144,340,0,0,34,0,0,0,2518
"26111291602",3960,613,0,0,174,0,37,68,4852
"26111291700",3461,810,0,2,66,74,70,77,4560
"26113960100",3034,657,0,0,68,25,40,11,3835
"26113960200",2522,605,2,2,70,50,15,74,3340
"26113960300",4063,629,24,0,88,15,78,17,4914
"26113960400",2494,376,1,4,61,21,114,4,3075
"26115830100",3008,365,11,0,84,25,124,13,3630
"26115830200",5069,404,67,0,135,0,314,4,5993
"26115830300",2997,521,22,0,148,1,39,69,3797
"26115830400",3461,385,61,6,141,7,49,5,4115
"26115830500",3445,317,63,17,55,1,24,1,3923
"26115830600",2406,299,171,33,85,0,38,0,3032
"26115830700",3064,216,30,1,89,0,124,0,3524
"26115830800",5751,739,0,0,241,1,65,6,6803
"26115830900",2513,31,0,0,19,0,71,0,2634
"26115831000",2641,481,37,1,44,7,15,77,3303
"26115831100",1936,338,0,0,4,11,69,74,2432
"26115831200",5755,896,61,0,51,19,122,28,6932
"26115831300",4237,276,30,5,39,86,139,54,4866
"26115831400",4957,1389,421,24,210,293,46,322,7662
"26115831500",2407,284,75,14,32,12,28,0,2852
"26115831600",2601,459,35,85,173,29,39,67,3488
"26115831700",2905,629,37,282,47,28,43,205,4176
"26115831800",865,232,163,146,89,70,299,30,1894
"26115831900",853,261,91,44,78,12,81,116,1536
"26115832000",1226,310,18,130,30,28,3,0,1745
"26115832100",1911,650,12,78,65,16,103,17,2852
"26115832200",1566,112,20,9,47,20,60,9,1843
"26115832300",3207,997,137,0,109,0,163,0,4613
"26115832400",3542,403,59,20,182,0,84,9,4299
"26115832500",3639,558,230,74,188,61,85,0,4835
"26115832600",1922,229,21,0,46,0,63,0,2281
"26115832700",2385,171,0,0,76,0,23,13,2668
"26115832800",4672,131,22,3,76,3,161,7,5075
"26115832900",4056,424,79,0,77,0,81,2,4719
"26115833000",4101,179,159,17,73,15,43,15,4602
"26115833100",4720,226,21,0,94,0,115,0,5176
"26115833200",3520,634,0,0,81,0,0,0,4235
"26115833300",6169,318,0,0,73,0,241,0,6801
"26115833500",3992,611,39,1,143,43,76,0,4905
"26115833600",2808,252,6,0,162,0,254,11,3493
"26115833700",2185,324,0,29,77,6,48,6,2675
"26115833800",4347,434,0,0,170,0,194,0,5145
"26115833900",4823,238,36,7,110,0,139,0,5353
"26115990000",0,0,0,0,0,0,0,0,0
"26117970100",3749,427,22,0,150,12,97,21,4478
"26117970200",2356,581,100,37,130,75,127,49,3455
"26117970300",2413,548,19,0,108,0,92,10,3190
"26117970400",2290,731,8,0,85,14,43,0,3171
"26117970500",6206,1366,3,0,186,116,81,132,8090
"26117970600",4452,650,21,13,83,11,55,7,5292
"26117970700",4105,752,1,1,37,70,124,15,5105
"26117970800",3535,986,15,108,39,17,52,47,4799
"26117970900",2635,563,36,0,3,9,104,19,3369
"26117971000",3924,895,33,0,134,45,115,55,5201
"26117971100",3669,853,5,0,209,141,223,161,5261
"26117971200",3909,1345,10,3,72,112,24,61,5536
"26117971300",3965,857,0,11,112,0,114,0,5059
"26119910100",1987,487,0,0,60,17,7,0,2558
"26119910200",1410,204,0,0,19,0,44,0,1677
"26119910300",1446,204,0,0,58,6,38,0,1752
"26119910400",1828,252,7,0,47,14,0,14,2162
"26119910500",1005,296,0,0,5,0,7,0,1313
"26121000100",1322,393,594,1171,344,1,43,14,3882
"26121000300",639,725,724,1037,272,100,256,69,3822
"26121000401",1997,1003,991,219,388,272,438,207,5515
"26121000402",157,118,210,194,117,40,0,0,836
"26121000500",1145,840,993,795,362,238,385,81,4839
"26121000601",479,298,309,274,65,92,120,12,1649
"26121000800",1702,572,140,452,242,58,187,160,3513
"26121000900",2422,702,80,153,134,27,65,0,3583
"26121001000",985,132,19,0,32,0,20,0,1188
"26121001200",87,131,1251,642,108,0,6,0,2225
"26121001300",21,82,1132,1253,75,108,0,18,2689
"26121001402",763,447,1456,1210,81,137,25,60,4179
"26121001500",3299,212,31,3,167,8,40,12,3772
"26121001600",2618,103,50,0,106,0,128,0,3005
"26121001700",4076,283,82,44,74,73,139,4,4775
"26121001800",3415,858,177,17,25,7,38,25,4562
"26121001901",2551,704,39,76,152,178,84,213,3997
"26121001902",3682,956,51,182,114,116,322,40,5463
"26121002000",2786,743,0,4,42,62,107,95,3839
"26121002100",2209,495,344,0,32,4,71,28,3183
"26121002200",3028,346,95,126,141,17,174,20,3947
"26121002300",4560,582,73,20,239,84,514,14,6086
"26121002400",2654,158,137,13,108,122,128,0,3320
"26121002500",6928,148,34,5,402,25,161,0,7703
"26121002601",2579,430,42,3,199,52,143,48,3496
"26121002602",3275,481,187,44,194,66,108,128,4483
"26121002700",6449,742,18,3,288,83,142,100,7825
"26121002800",5328,250,99,5,243,43,46,21,6035
"26121002900",4658,241,38,0,101,16,291,20,5365
"26121003000",3741,473,0,23,155,28,319,84,4823
"26121003100",2981,928,0,183,111,57,169,63,4492
"26121003200",3975,1070,56,0,199,121,206,93,5720
"26121003300",3548,1233,0,4,54,85,117,104,5145
"26121003400",2898,729,169,94,19,80,111,47,4147
"26121003500",3027,571,14,35,200,13,0,186,4046
"26121003600",5467,893,52,55,129,98,220,8,6922
"26121003700",4830,462,52,7,73,45,256,9,5734
"26121003800",2956,344,23,4,61,12,126,0,3526
"26121003900",1541,259,3,0,83,25,97,46,2054
"26121004000",1845,146,0,5,47,0,55,3,2101
"26121004200",1014,539,776,536,71,303,129,96,3464
"26121004300",238,45,688,696,62,22,14,7,1772
"26121990000",0,0,0,0,0,0,0,0,0
"26123970100",3367,909,117,43,123,30,66,48,4703
"26123970300",2672,715,48,0,224,22,138,60,3879
"26123970400",4389,746,15,2,164,35,193,199,5743
"26123970500",3532,804,45,2,64,117,81,172,4817
"26123970600",2802,605,0,0,156,12,105,22,3702
"26123970700",2728,1131,47,54,85,34,48,14,4141
"26123970800",2361,696,0,19,39,12,20,14,3161
"26123970900",3514,696,0,13,91,37,66,35,4452
"26123971000",3730,573,11,4,181,72,174,55,4800
"26123971100",3573,620,11,22,211,32,433,148,5050
"26123971200",3597,1065,21,21,84,19,248,292,5347
"26125120000",2591,290,108,47,105,0,0,101,3242
"26125120300",2872,248,70,0,71,0,72,5,3338
"26125121000",2264,381,0,0,138,13,231,56,3083
"26125121400",3884,58,78,0,160,6,100,6,4292
"26125121500",2989,467,32,0,0,0,33,0,3521
"26125121700",5001,196,19,2,255,34,83,0,5590
"26125121800",4249,375,0,49,141,0,205,37,5056
"26125122200",3430,137,11,0,98,13,152,0,3841
"26125122400",5574,1153,0,0,113,0,69,257,7166
"26125122700",2555,217,0,0,72,0,15,0,2859
"26125122900",1420,336,22,15,73,39,47,143,2095
"26125123000",1906,275,128,0,65,18,0,20,2412
"26125123100",2969,112,10,0,49,0,0,0,3140
"26125124000",4778,283,129,9,117,10,49,0,5375
"26125124500",4973,759,116,19,168,14,339,16,6404
"26125125000",3135,296,97,0,86,0,23,12,3649
"26125125600",2528,83,18,0,67,0,147,0,2843
"26125126200",2488,81,42,0,11,0,164,31,2817
"26125126300",4177,416,29,12,79,0,125,10,4848
"26125126400",3547,50,11,0,72,6,51,0,3737
"26125126500",2985,108,0,0,25,0,73,0,3191
"26125127000",5037,366,0,2,244,0,88,16,5753
"26125127100",4857,168,132,0,92,0,90,0,5339
"26125127200",1584,39,0,0,20,2,17,2,1664
"26125127300",3623,364,65,49,337,94,152,111,4795
"26125127400",1511,103,14,2,13,35,105,0,1783
"26125127500",5845,168,147,16,395,48,145,0,6764
"26125127600",3330,149,163,0,226,0,159,0,4027
"26125127700",5449,737,104,158,240,92,297,0,7077
"26125128000",2969,174,97,0,57,0,45,0,3342
"26125128100",2682,60,30,2,51,0,130,0,2955
"26125128200",2925,131,60,0,187,0,130,0,3433
"26125128300",3735,207,33,0,311,60,164,0,4510
"26125128400",2516,582,86,47,397,116,236,109,4089
"26125128500",2771,285,274,1,191,100,352,15,3989
"26125128600",2846,220,10,0,226,0,48,50,3400
"26125128700",1854,68,33,1,131,14,75,0,2176
"26125128800",1256,115,0,0,101,0,62,5,1539
"26125128900",3821,256,399,0,403,0,212,1,5092
"26125129000",2627,241,0,0,42,9,34,26,2979
"26125130000",2534,486,50,72,147,31,11,0,3331
"26125130100",1926,222,5,2,157,0,92,0,2404
"26125130200",5147,260,94,0,86,10,96,1,5694
"26125130300",3165,803,37,0,10,34,49,162,4260
"26125130400",2848,36,40,0,67,0,107,0,3098
"26125130500",2783,56,0,0,55,0,46,12,2952
"26125130600",2743,210,13,1,66,12,0,12,3057
"26125130700",5606,25,305,0,217,25,100,0,6278
"26125131100",1985,89,0,9,145,8,11,10,2257
"26125131300",4280,146,8,0,47,22,0,18,4521
"26125131400",1992,132,0,0,24,0,62,0,2210
"26125131500",3419,297,22,0,20,15,161,0,3934
"26125131600",2438,189,7,0,74,8,37,0,2753
"26125131800",3202,681,28,0,57,0,13,0,3981
"26125132100",4808,331,64,0,324,12,178,8,5725
"26125132500",2913,344,11,11,29,36,28,0,3372
"26125132600",3857,106,29,0,118,1,60,9,4180
"26125132700",2817,88,0,10,57,0,110,1,3083
"26125133001",2634,5,0,0,89,80,97,0,2905
"26125133002",2951,360,12,0,184,0,138,12,3657
"26125133003",2474,206,114,49,125,49,128,0,3145
"26125133100",1791,545,848,378,329,401,147,485,4924
"26125134000",4487,352,20,0,150,0,66,0,5075
"26125134300",4401,338,80,32,42,2,76,2,4973
"26125134400",3879,383,34,0,160,11,37,0,4504
"26125134500",2683,141,0,0,301,9,111,0,3245
"26125134600",3712,328,0,0,74,0,170,0,4284
"26125134700",2562,280,100,45,206,0,160,151,3504
"26125134800",2669,89,100,0,132,8,71,0,3069
"26125134900",2921,611,52,0,227,54,229,0,4094
"26125135000",2134,402,18,1,311,34,163,0,3063
"26125135100",4781,318,59,0,131,32,48,27,5396
"26125135200",2599,113,85,0,368,0,78,0,3243
"26125135300",4690,2,73,1,167,0,60,0,4993
"26125136000",1598,115,435,14,538,11,47,10,2768
"26125136101",2985,273,105,0,1157,108,209,0,4837
"26125136102",2453,372,375,269,455,36,90,0,4050
"26125136300",2959,111,650,8,1009,50,31,55,4873
"26125136500",3858,125,302,55,883,32,87,1,5343
"26125136600",4864,162,118,416,2267,67,162,0,8056
"26125136700",4218,178,175,0,1070,37,100,38,5816
"26125136800",3086,269,389,19,583,37,279,0,4662
"26125137100",5921,446,313,99,2248,148,228,5,9408
"26125137400",5129,43,243,0,1038,29,164,0,6646
"26125137700",1356,108,120,0,41,0,41,0,1666
"26125137800",2969,86,41,0,159,12,152,0,3419
"26125138100",4099,149,18,0,179,114,168,0,4727
"26125138301",3166,165,59,29,25,8,260,0,3712
"26125138302",4838,130,73,0,195,18,0,0,5254
"26125138600",2140,72,14,0,80,0,51,10,2367
"26125139200",5699,470,67,0,246,0,174,0,6656
"26125139400",4692,146,134,0,159,9,243,0,5383
"26125140100",926,28,17,18,73,32,129,32,1255
"26125140301",2032,803,512,128,548,125,185,477,4810
"26125140302",2116,385,307,0,481,94,215,41,3639
"26125140500",1524,224,139,29,199,0,162,0,2277
"26125140600",1424,87,804,37,165,23,61,22,2623
"26125140700",1653,168,264,154,270,15,271,26,2821
"26125140800",2432,99,611,93,1162,34,297,7,4735
"26125140900",832,677,970,398,117,65,281,508,3848
"26125141000",2286,555,1773,889,419,51,630,259,6862
"26125141100",1532,338,536,340,285,48,286,100,3465
"26125141200",844,617,1021,651,289,137,467,283,4309
"26125141300",1941,1000,207,134,71,151,505,599,4608
"26125141400",1632,573,820,428,478,315,1064,554,5864
"26125141500",449,588,2825,1601,367,110,308,278,6526
"26125141600",699,988,1176,621,370,325,310,526,5015
"26125141700",846,932,416,708,71,208,355,761,4297
"26125142000",407,456,814,455,121,140,150,418,2961
"26125142100",356,354,166,330,283,5,120,160,1774
"26125142200",222,293,715,1550,9,359,84,136,3368
"26125142300",160,112,772,969,43,242,18,0,2316
"26125142400",161,72,1644,917,50,223,77,53,3197
"26125142500",325,62,965,283,30,54,0,13,1732
"26125142600",1617,401,952,206,238,77,338,127,3956
"26125142700",35,34,2364,893,132,62,42,50,3612
"26125143500",5511,306,84,36,167,14,241,93,6452
"26125144100",3519,316,319,0,226,6,140,42,4568
"26125144200",3824,257,0,0,344,0,386,0,4811
"26125144300",3177,216,15,7,73,0,32,7,3527
"26125144400",3738,498,92,0,426,7,356,42,5159
"26125144500",2648,255,141,0,76,16,84,44,3264
"26125144600",3197,160,142,22,287,0,93,2,3903
"26125144701",1944,976,313,108,215,74,169,315,4114
"26125144800",1766,445,148,45,220,0,47,56,2727
"26125144900",2953,490,200,247,158,44,296,33,4421
"26125145100",2083,97,10,6,96,0,50,7,2349
"26125145200",2841,345,86,14,143,12,41,0,3482
"26125145300",3453,651,31,66,215,78,319,248,5061
"26125145400",2819,476,265,108,490,56,464,175,4853
"26125145501",3138,256,117,0,108,0,173,47,3839
"26125145502",2822,403,267,115,145,138,320,73,4283
"26125145600",3560,450,286,46,125,77,210,86,4840
"26125145700",1980,188,63,13,59,1,37,50,2391
"26125145900",1842,452,188,228,107,39,108,49,3013
"26125150000",3314,394,660,27,767,0,86,0,5248
"26125150100",2370,165,833,27,245,61,15,0,3716
"26125150200",1773,238,124,0,391,46,36,0,2608
"26125150300",3293,118,503,134,613,15,107,6,4789
"26125150400",2443,16,21,7,307,0,48,0,2842
"26125150500",2598,146,26,3,48,13,0,0,2834
"26125150600",2033,59,206,0,462,0,88,0,2848
"26125150700",3568,264,112,0,400,82,23,0,4449
"26125150800",3275,184,296,15,314,0,22,7,4113
"26125150900",2503,305,447,1,417,0,47,0,3720
"26125151000",4219,177,0,0,699,0,25,0,5120
"26125152000",3107,123,26,0,455,0,55,0,3766
"26125152600",3596,47,98,16,132,0,62,0,3951
"26125152700",2800,55,9,0,76,28,39,8,3015
"26125152900",3371,96,332,0,183,23,92,22,4119
"26125153000",1680,113,35,0,91,0,56,31,2006
"26125153100",1888,152,49,0,90,5,71,0,2255
"26125153200",1646,75,44,0,116,0,14,0,1895
"26125153300",3156,44,139,0,141,0,57,0,3537
"26125154000",1465,47,59,6,14,0,31,0,1622
"26125154100",2223,257,212,2,79,0,43,11,2827
"26125154200",1981,589,99,77,257,0,79,245,3327
"26125154500",1874,81,171,0,199,0,44,0,2369
"26125154600",2108,157,430,68,313,0,24,0,3100
"26125156000",1779,121,224,19,196,0,13,1,2353
"26125156100",3365,139,351,46,456,0,139,8,4504
"26125156200",5450,123,398,1,443,0,84,11,6510
"26125156300",3158,76,254,0,584,0,169,0,4241
"26125156400",2892,105,477,51,326,27,61,19,3958
"26125156500",3177,151,542,0,510,16,97,0,4493
"26125156900",1850,93,316,2,640,0,128,0,3029
"26125157000",1949,51,144,0,141,8,48,0,2341
"26125157100",1153,203,258,6,238,20,0,0,1878
"26125157200",2402,550,647,107,178,17,40,0,3941
"26125157300",1917,171,595,0,470,7,27,0,3187
"26125157400",1764,229,229,10,239,0,7,0,2478
"26125157500",1880,64,662,110,335,0,86,0,3137
"26125157600",2448,562,820,22,861,91,31,0,4835
"26125157700",1769,209,182,0,465,32,0,0,2657
"26125157800",2171,32,879,11,516,0,11,0,3620
"26125157900",1687,104,424,31,511,31,10,0,2798
"26125158000",3392,23,120,0,265,0,89,0,3889
"26125158100",2509,94,377,10,103,28,57,28,3206
"26125158200",2945,37,172,4,118,49,37,4,3366
"26125159000",3456,188,303,0,364,12,31,7,4361
"26125160000",1073,47,2581,191,159,0,11,0,4062
"26125160300",469,266,1496,693,84,93,121,23,3245
"26125160400",281,82,1952,296,64,0,42,0,2717
"26125160500",1494,490,1347,261,366,47,21,0,4026
"26125160600",1414,207,2441,130,274,0,128,23,4617
"26125160700",361,9,970,127,53,4,0,0,1524
"26125160800",1033,166,2400,208,85,128,17,1,4038
"26125160900",599,34,2814,410,300,0,12,0,4169
"26125161000",253,34,1261,396,71,0,17,0,2032
"26125161100",731,585,1466,195,184,50,0,0,3211
"26125161200",878,287,3253,128,177,8,21,0,4752
"26125161300",1046,283,1807,231,348,0,159,0,3874
"26125161400",1212,362,1325,427,24,13,8,1,3372
"26125161500",321,16,1150,238,96,12,11,0,1844
"26125161600",236,44,1352,232,113,0,0,0,1977
"26125161700",629,66,1911,34,96,43,7,0,2786
"26125161800",477,27,2851,491,124,2,62,5,4039
"26125161900",532,78,1298,80,67,0,0,18,2073
"26125162000",540,52,3034,187,57,6,9,0,3885
"26125162100",19,10,2174,888,74,10,10,0,3185
"26125162200",41,0,849,123,132,12,0,0,1157
"26125162300",350,79,2859,346,122,0,80,0,3836
"26125162400",301,33,1463,289,60,51,58,2,2257
"26125162500",968,282,1763,324,46,139,30,8,3560
"26125165000",2595,90,45,119,257,9,16,0,3131
"26125165100",2839,151,407,19,166,10,24,10,3626
"26125165200",1415,82,439,100,1596,53,135,0,3820
"26125166000",1467,241,504,63,94,22,43,40,2474
"26125166100",1850,246,1102,14,222,8,74,0,3516
"26125166200",2258,52,43,3,243,39,31,2,2671
"26125166400",2499,176,286,0,327,0,79,0,3367
"26125166500",2097,87,238,1,282,69,92,0,2866
"26125166600",1618,406,785,257,413,137,71,0,3687
"26125166700",1267,77,716,19,298,10,28,0,2415
"26125166800",1894,139,950,15,284,71,85,2,3440
"26125166900",2470,325,515,8,422,0,108,8,3856
"26125167000",3557,186,584,0,1071,46,55,29,5528
"26125167300",1970,275,494,46,415,53,87,53,3393
"26125167400",2730,767,1089,289,527,11,149,248,5810
"26125167500",3295,255,1331,0,612,40,207,0,5740
"26125167800",3022,443,563,62,746,12,286,0,5134
"26125167900",1957,65,457,93,286,9,79,0,2946
"26125168100",1618,122,244,0,310,0,111,0,2405
"26125168400",2344,71,379,0,647,0,53,0,3494
"26125168500",1338,167,546,22,376,21,113,0,2583
"26125168600",4092,121,1086,100,734,97,109,0,6339
"26125168700",2234,140,588,0,855,13,98,13,3941
"26125168800",1875,15,308,4,145,0,65,0,2412
"26125168900",1690,178,1023,49,1656,86,82,0,4764
"26125170000",2461,41,16,0,88,0,51,0,2657
"26125170100",2189,238,176,15,109,0,32,0,2759
"26125170200",2777,259,140,0,239,40,39,40,3534
"26125170300",2233,231,6,0,35,0,20,0,2525
"26125170400",3385,221,41,36,111,25,72,25,3916
"26125171000",2605,992,639,66,322,0,0,0,4624
"26125171100",1183,42,1379,175,355,6,77,0,3217
"26125171200",895,66,1055,96,171,11,29,3,2326
"26125171300",324,211,2238,224,233,55,0,12,3297
"26125171400",1580,237,3749,531,440,38,57,6,6638
"26125171500",244,120,3764,1193,438,20,117,0,5896
"26125171600",523,281,651,257,255,166,73,12,2218
"26125172400",196,376,804,340,41,0,0,0,1757
"26125172500",58,12,1609,826,48,133,8,0,2694
"26125173000",3073,693,297,191,71,117,274,81,4797
"26125173100",1108,186,100,0,69,16,31,0,1510
"26125173200",2293,124,48,14,177,0,83,0,2739
"26125173300",1204,60,189,35,117,8,37,22,1672
"26125173400",3655,965,391,311,331,10,164,0,5827
"26125173500",2191,216,40,10,85,180,36,20,2778
"26125173600",1089,125,87,87,42,69,27,0,1526
"26125175000",1867,611,95,26,43,47,40,0,2729
"26125175100",3963,808,54,324,38,124,0,0,5311
"26125175200",2352,1271,276,0,345,0,83,30,4357
"26125175300",2172,747,451,520,87,253,17,1,4248
"26125180000",2131,181,0,0,395,118,213,72,3110
"26125180100",2402,282,12,0,114,0,26,0,2836
"26125180200",3230,124,30,0,81,9,80,0,3554
"26125180300",2337,217,68,0,64,19,39,0,2744
"26125181000",1476,1289,448,170,611,154,99,0,4247
"26125181100",2675,195,94,144,87,28,27,0,3250
"26125181200",4820,635,210,176,591,26,0,0,6458
"26125181300",3943,597,275,175,274,94,115,0,5473
"26125181400",2235,570,70,31,80,18,11,0,3015
"26125181500",1855,216,81,64,145,8,16,0,2385
"26125181600",3573,1141,0,177,294,37,33,0,5255
"26125183000",2411,325,146,41,294,46,73,13,3349
"26125183100",4045,158,29,13,114,38,154,0,4551
"26125183200",2546,244,28,18,65,20,8,0,2929
"26125183300",2805,82,32,0,129,42,45,0,3135
"26125183400",1897,92,10,186,187,8,87,0,2467
"26125183500",1357,192,349,43,96,47,9,15,2108
"26125183600",3706,262,82,3,198,0,123,53,4427
"26125183700",4960,448,3,16,231,12,103,0,5773
"26125183800",3982,241,226,0,92,0,83,0,4624
"26125183900",2351,113,28,21,123,16,40,5,2697
"26125184000",2753,171,67,0,75,20,192,11,3289
"26125184100",2455,240,93,0,101,0,69,0,2958
"26125184200",3483,349,0,13,318,0,46,59,4268
"26125184300",2563,106,23,49,103,0,61,0,2905
"26125184400",2511,205,130,0,19,22,27,20,2934
"26125184500",1921,202,120,2,82,26,80,7,2440
"26125184600",2416,214,85,0,177,0,31,0,2923
"26125184700",1505,66,14,2,145,7,22,0,1761
"26125187000",2156,78,44,0,251,9,37,0,2575
"26125188000",3619,43,78,0,193,5,19,0,3957
"26125188100",2227,64,56,2,23,0,18,0,2390
"26125190200",3108,98,0,4,236,0,11,0,3457
"26125190400",3007,156,44,1,63,0,48,0,3319
"26125190500",2376,112,93,0,58,0,111,0,2750
"26125190700",3937,43,265,2,653,0,164,1,5065
"26125190800",2966,79,169,0,211,0,128,0,3553
"26125191000",1408,242,31,15,46,8,73,22,1845
"26125191100",2010,164,63,10,110,14,27,6,2404
"26125191200",3791,83,379,1,433,0,124,0,4811
"26125191300",3268,161,135,0,500,0,65,15,4144
"26125192000",4781,199,627,32,434,77,153,0,6303
"26125192200",4911,105,288,8,647,0,98,10,6067
"26125192400",4407,143,117,0,363,41,119,0,5190
"26125192500",2428,51,88,0,413,0,70,0,3050
"26125192700",2396,125,143,0,476,0,34,27,3201
"26125192800",353,65,184,17,93,9,45,0,766
"26125193000",2635,79,250,1,210,25,197,0,3397
"26125193100",3062,183,22,0,302,0,100,0,3669
"26125193300",3020,439,362,47,409,71,168,0,4516
"26125193400",3509,151,164,0,666,31,149,0,4670
"26125193500",1863,454,109,0,59,0,292,87,2864
"26125193600",1606,275,16,0,260,108,213,0,2478
"26125193700",3334,293,74,8,833,0,200,0,4742
"26125194000",2799,184,438,164,1196,122,73,0,4976
"26125194100",2367,90,57,4,434,1,60,1,3014
"26125194200",1535,43,160,1,152,0,0,0,1891
"26125194300",2611,87,407,18,516,12,62,0,3713
"26125194400",2574,335,13,0,459,7,176,0,3564
"26125194500",996,59,6,4,3,0,0,0,1068
"26125194600",3450,148,61,0,682,22,16,0,4379
"26125196000",4285,186,124,0,1330,0,131,9,6065
"26125196100",4006,315,454,35,1000,15,0,0,5825
"26125196200",2835,97,187,0,731,90,10,0,3950
"26125196300",2721,152,24,0,686,17,71,1,3672
"26125196400",2783,90,154,3,792,1,32,1,3856
"26125196500",3702,49,0,2,1491,164,126,0,5534
"26125196600",1704,22,22,2,433,33,26,0,2242
"26125196700",2530,60,7,1,160,0,25,0,2783
"26125196800",2804,59,67,0,1413,29,59,0,4431
"26125196900",2185,224,100,0,917,10,66,26,3528
"26125197000",3137,140,108,8,1162,124,109,0,4788
"26125197100",1573,51,46,0,652,46,8,4,2380
"26125197200",2725,35,54,0,715,105,73,0,3707
"26125197300",3950,451,154,8,269,156,189,0,5177
"26125197400",1304,312,78,63,200,76,165,0,2198
"26125197500",2071,325,482,116,1237,199,157,0,4587
"26125197600",1309,56,82,28,438,12,27,28,1980
"26125197701",2429,138,164,11,1692,126,109,31,4700
"26125197702",641,93,151,12,972,50,23,0,1942
"26125197900",2711,125,179,3,723,40,76,0,3857
"26125198000",2244,245,119,0,955,0,132,0,3695
"26125198100",1161,717,77,82,598,123,79,38,2875
"26125981000",0,0,0,0,0,0,0,0,0
"26127010300",5342,1234,29,0,233,108,1017,399,8362
"26127010400",2557,977,9,0,172,149,386,371,4621
"26127010500",2424,845,2,6,98,14,511,527,4427
"26127010600",4253,895,0,8,221,22,108,14,5521
"26127010800",2081,480,0,19,65,17,93,47,2802
"26127010900",1745,320,3,0,18,0,68,69,2223
"26127011000",1468,194,0,0,19,0,23,22,1726
"26127990000",0,0,0,0,0,0,0,0,0
"26129950100",1731,527,1,0,24,26,10,4,2323
"26129950200",2635,332,2,0,45,0,26,6,3046
"26129950300",1464,230,1,0,42,0,31,0,1768
"26129950400",2360,495,0,1,67,11,46,0,2980
"26129950500",3286,725,2,4,69,31,77,11,4205
"26129950600",2152,697,0,0,14,94,54,5,3016
"26129950900",2497,1279,13,10,106,59,27,63,4054
"26131970100",1450,305,0,0,23,11,17,0,1806
"26131970200",2194,404,4,7,65,21,8,8,2711
"26131970300",1525,275,1,0,45,9,29,3,1887
"26131990100",0,0,0,0,0,0,0,0,0
"26133970100",3056,947,0,6,81,44,54,5,4193
"26133970200",3272,528,0,10,103,4,17,22,3956
"26133970300",2353,528,9,13,62,16,3,0,2984
"26133970400",2076,912,8,0,20,31,63,16,3126
"26133970500",3575,688,0,19,50,31,43,16,4422
"26133970600",3102,1232,10,12,26,94,77,20,4573
"26135970201",1165,269,0,1,45,3,8,2,1493
"26135970202",1362,302,0,0,59,3,4,0,1730
"26135970300",1141,448,2,0,25,13,28,0,1657
"26135970400",1746,334,0,1,1,18,7,4,2111
"26135970500",1202,203,24,0,80,0,45,0,1554
"26137950100",2385,398,0,0,41,26,14,22,2886
"26137950200",4886,652,25,0,57,40,70,45,5775
"26137950300",3618,951,0,0,173,319,36,0,5097
"26137950400",1897,174,0,0,10,1,0,0,2082
"26137950500",2905,281,0,3,90,21,0,21,3321
"26137950600",4277,295,9,0,100,1,122,0,4804
"26139020100",4582,356,11,31,144,0,98,25,5247
"26139020200",3669,470,1,1,37,122,136,40,4476
"26139020400",3405,568,50,0,94,0,42,0,4159
"26139020501",2654,203,0,0,18,106,0,0,2981
"26139020503",3482,223,0,0,156,7,0,0,3868
"26139020504",1952,425,0,0,86,0,40,115,2618
"26139020600",3043,271,40,0,28,0,123,0,3505
"26139020900",3977,374,0,0,60,44,9,0,4464
"26139021000",4627,474,0,15,32,13,45,2,5208
"26139021100",4366,212,11,7,172,1,53,20,4842
"26139021201",4186,451,0,0,171,19,86,0,4913
"26139021202",5161,584,0,0,558,277,329,300,7209
"26139021301",2772,317,8,0,98,6,14,6,3221
"26139021303",2451,58,0,0,70,85,139,96,2899
"26139021304",4501,269,26,0,65,9,90,74,5034
"26139021400",6979,486,17,0,153,14,77,18,7744
"26139021500",6962,262,156,22,110,0,200,0,7712
"26139021603",4294,277,38,11,10,26,46,8,4710
"26139021604",6893,195,13,0,236,0,144,0,7481
"26139021605",3754,127,53,0,149,0,116,0,4199
"26139021606",4485,314,16,0,84,22,11,22,4954
"26139021700",3360,362,51,0,133,25,127,1,4059
"26139021801",3714,551,0,0,84,123,42,0,4514
"26139021802",3470,497,63,0,467,3,108,4,4612
"26139021901",3994,174,13,0,224,1,211,0,4617
"26139021902",6426,205,78,0,540,516,358,495,8618
"26139022001",3871,185,0,0,713,1,791,40,5601
"26139022002",3554,209,114,0,184,16,122,91,4290
"26139022103",1294,87,0,0,16,0,84,8,1489
"26139022105",4103,344,45,87,489,43,566,231,5908
"26139022106",3747,64,0,0,21,9,220,12,4073
"26139022107",1018,137,0,0,14,65,22,121,1377
"26139022108",5829,284,68,0,360,0,334,0,6875
"26139022203",5207,842,395,228,2396,686,2572,958,13284
"26139022206",3366,336,17,0,375,62,260,0,4416
"26139022600",1735,33,30,0,210,0,247,11,2266
"26139022900",4779,767,96,16,603,28,452,106,6847
"26139023001",5242,203,1,0,96,0,230,0,5772
"26139023002",5775,215,21,0,374,54,63,0,6502
"26139023100",6398,587,94,0,2940,577,2582,498,13676
"26139023200",2349,84,0,7,43,70,21,70,2644
"26139023500",4522,8,67,0,102,7,87,0,4793
"26139023600",2358,30,0,0,69,0,27,0,2484
"26139024300",4146,531,0,9,173,11,281,11,5162
"26139024400",6527,1625,92,54,469,129,275,211,9382
"26139024500",649,3320,90,137,129,81,81,224,4711
"26139024600",4455,163,0,0,347,0,154,0,5119
"26139024900",2840,1077,189,32,330,97,1128,350,6043
"26139025100",4482,386,206,26,1369,284,1511,126,8390
"26139025200",3392,755,136,81,510,310,561,443,6188
"26139025500",3498,264,16,25,140,94,141,135,4313
"26139025700",3726,647,123,15,625,31,491,220,5878
"26139025800",3905,780,241,28,952,275,2459,497,9137
"26139990000",0,0,0,0,0,0,0,0,0
"26141950100",1666,146,0,0,21,7,14,5,1859
"26141950200",2185,294,1,14,25,10,0,0,2529
"26141950300",1751,324,0,0,43,30,38,30,2216
"26141950400",1840,431,0,10,52,6,7,10,2356
"26141950500",2124,405,1,0,33,26,6,4,2599
"26141950600",1394,67,2,0,16,0,6,0,1485
"26141990000",0,0,0,0,0,0,0,0,0
"26143970100",1362,388,0,0,17,12,21,0,1800
"26143970200",1334,476,0,0,0,61,0,62,1933
"26143970300",1715,664,0,0,19,43,23,39,2503
"26143970400",1583,292,0,0,177,15,4,9,2080
"26143970500",724,200,0,3,2,0,2,0,931
"26143970600",1692,451,0,0,35,3,45,24,2250
"26143970700",2346,329,0,12,4,0,8,0,2699
"26143971000",3190,887,11,0,70,46,29,0,4233
"26143971100",2425,754,0,0,33,49,36,4,3301
"26143971200",1731,585,0,2,69,0,9,0,2396
"26145000100",49,201,412,600,0,14,0,19,1295
"26145000200",47,16,761,435,51,36,29,0,1375
"26145000400",65,44,490,521,30,13,27,9,1199
"26145000600",408,125,729,524,92,41,252,35,2206
"26145000700",241,142,595,516,66,144,173,178,2055
"26145000800",202,123,1314,1001,33,45,128,105,2951
"26145000900",124,62,1383,1654,150,96,117,27,3613
"26145001000",547,246,1713,1014,199,76,392,147,4334
"26145001100",442,406,771,1168,233,149,538,228,3935
"26145001200",1267,369,650,191,453,80,621,148,3779
"26145001300",844,446,304,480,173,66,288,115,2716
"26145001400",1836,142,138,206,190,0,279,115,2906
"26145001500",2258,475,404,160,263,26,506,37,4129
"26145001600",1595,1074,558,343,187,204,352,543,4856
"26145001700",1002,371,168,371,129,54,169,30,2294
"26145001800",726,456,557,153,0,37,6,217,2152
"26145001900",857,551,136,195,37,162,99,263,2300
"26145002000",1712,583,441,175,363,1,430,77,3782
"26145002100",2571,588,658,226,321,10,340,158,4872
"26145010100",7452,468,112,1,341,8,188,0,8570
"26145010200",2392,626,0,89,115,76,108,77,3483
"26145010302",6105,287,296,115,666,0,207,1,7677
"26145010303",3016,124,237,72,161,0,171,0,3781
"26145010304",2946,582,383,208,523,108,278,11,5039
"26145010401",2067,194,97,45,67,18,183,0,2671
"26145010402",4448,388,160,150,208,12,314,14,5694
"26145010403",4319,284,660,38,364,86,320,228,6299
"26145010501",2226,77,75,0,53,10,161,9,2611
"26145010502",3925,378,273,302,370,0,324,49,5621
"26145010600",1503,366,391,245,202,137,264,146,3254
"26145010700",4338,495,386,519,155,116,1036,47,7092
"26145010800",1611,332,254,265,53,5,200,32,2752
"26145011000",532,323,2117,1855,743,34,292,129,6025
"26145011100",1360,351,254,0,5,19,93,53,2135
"26145011200",1753,91,0,10,8,1,45,0,1908
"26145011300",6439,402,7,5,85,17,80,6,7041
"26145011500",1416,395,495,325,93,141,164,75,3104
"26145011600",1438,249,1034,212,296,93,327,18,3667
"26145011701",1314,53,215,0,59,0,136,0,1777
"26145011702",2060,328,28,1,23,0,132,0,2572
"26145011800",1537,157,278,5,137,2,218,64,2398
"26145011901",1722,86,0,0,34,0,49,33,1924
"26145011902",2086,136,7,0,29,19,84,0,2361
"26145012001",3002,236,22,23,118,6,98,0,3505
"26145012002",3573,76,44,0,94,4,99,0,3890
"26145012003",4110,243,11,0,110,32,145,14,4665
"26145012100",3727,235,22,18,64,0,178,0,4244
"26145012200",1409,161,3,4,10,30,71,38,1726
"26145012300",2695,288,0,0,90,3,57,6,3139
"26145012400",1773,230,5,1,12,21,28,12,2082
"26145012500",3212,672,0,1,85,48,91,59,4168
"26145012600",2990,401,0,2,42,44,71,38,3588
"26145012700",3728,483,12,0,171,53,169,0,4616
"26145012900",4083,436,9,0,30,45,88,11,4702
"26145013000",3827,441,63,9,55,62,159,0,4616
"26145013100",5285,383,46,1,193,18,378,8,6312
"26147620000",1972,888,434,214,147,215,216,141,4227
"26147621000",2184,960,205,26,22,112,43,99,3651
"26147622000",2301,819,79,351,223,200,146,43,4162
"26147623000",1645,779,272,127,107,106,23,10,3069
"26147624000",589,747,154,115,0,106,9,23,1743
"26147625000",769,558,4,112,14,152,40,40,1689
"26147626000",1590,383,0,82,55,33,129,27,2299
"26147627000",2421,255,70,5,123,11,34,46,2965
"26147628000",2650,358,132,0,317,45,132,83,3717
"26147629000",2129,565,0,15,72,55,95,0,2931
"26147630100",1109,74,0,26,58,32,22,0,1321
"26147630400",4638,715,49,184,82,17,95,0,5780
"26147631100",1561,64,2,2,87,0,19,0,1735
"26147631600",1903,237,39,1,106,0,79,11,2376
"26147632000",3501,281,14,0,88,70,55,3,4012
"26147633100",2516,137,0,0,158,0,140,3,2954
"26147633200",2542,67,1,0,40,26,70,0,2746
"26147634100",2812,605,41,0,109,84,6,34,3691
"26147634600",4722,572,56,0,187,45,239,0,5821
"26147635000",4896,960,191,0,46,163,79,0,6335
"26147636000",2351,1023,72,169,102,194,192,170,4273
"26147637100",3486,154,7,0,79,0,34,16,3776
"26147637200",3199,339,6,0,76,11,59,7,3697
"26147637300",2020,386,0,0,35,8,10,6,2465
"26147640100",1867,107,0,0,119,0,94,0,2187
"26147640200",2127,115,0,2,14,0,23,0,2281
"26147640600",2130,248,0,0,24,4,19,4,2429
"26147641000",3197,172,0,0,93,39,6,35,3542
"26147642000",4503,797,5,0,86,29,94,8,5522
"26147643000",3068,343,127,1,20,17,0,0,3576
"26147644000",3698,613,21,0,26,90,20,10,4478
"26147645000",2634,578,0,0,33,25,24,45,3339
"26147646000",4037,489,0,0,66,24,34,1,4651
"26147647000",2765,352,0,0,0,0,0,0,3117
"26147648000",1118,50,0,0,6,8,0,13,1195
"26147649000",3426,502,0,4,63,15,26,33,4069
"26147650100",2992,570,0,0,91,11,0,1,3665
"26147650200",1201,130,0,37,19,0,13,0,1400
"26147651100",1551,151,0,0,0,0,0,0,1702
"26147651200",1956,370,0,0,19,0,25,115,2485
"26147651600",3782,118,2,0,118,0,17,0,4037
"26147652100",2233,150,0,0,33,4,3,0,2423
"26147652600",2767,274,18,8,140,5,100,8,3320
"26147655100",4086,668,12,0,126,21,187,19,5119
"26147655600",3000,391,0,0,54,2,36,17,3500
"26147657100",1400,265,13,0,270,75,423,67,2513
"26147657200",4573,348,0,0,200,139,295,143,5698
"26147658100",2204,378,0,0,33,0,31,0,2646
"26147658500",3209,399,29,0,56,0,33,16,3742
"26147990000",0,0,0,0,0,0,0,0,0
"26149040100",3093,213,153,0,212,9,33,9,3722
"26149040200",739,584,98,165,32,23,8,177,1826
"26149040300",1840,545,114,36,157,51,44,63,2850
"26149040400",1009,401,234,293,23,126,27,94,2207
"26149040500",2176,525,41,0,163,70,228,164,3367
"26149040600",1775,615,15,87,249,78,384,149,3352
"26149040700",2342,755,0,16,128,81,713,429,4464
"26149040800",2274,580,13,2,126,78,291,214,3578
"26149040900",3344,425,24,4,162,81,69,0,4109
"26149041000",2844,369,14,10,67,6,80,2,3392
"26149041101",3225,740,118,30,84,53,193,22,4465
"26149041102",2960,162,12,0,54,0,40,0,3228
"26149041200",2576,207,67,8,242,14,164,10,3288
"26149041300",5617,706,6,14,70,47,14,70,6544
"26149041400",4030,1143,6,12,62,23,80,14,5370
"26149041500",3480,872,17,0,86,0,93,164,4712
"26149041600",3014,433,10,0,101,4,155,2,3719
"26151970100",1585,145,0,4,0,17,26,3,1780
"26151970200",2239,261,0,0,46,0,48,7,2601
"26151970300",3018,583,15,6,27,10,29,1,3689
"26151970400",3043,794,44,14,79,32,74,65,4145
"26151970500",1889,259,0,2,71,21,77,7,2326
"26151970600",1777,232,0,0,39,1,17,0,2066
"26151970700",1109,331,0,0,69,0,7,0,1516
"26151970800",5479,636,0,12,63,52,427,59,6728
"26151970900",3862,724,8,0,142,68,194,25,5023
"26151971000",3250,754,0,41,42,16,132,22,4257
"26151971100",2827,671,2,0,60,32,40,25,3657
"26151971200",4329,726,32,52,99,40,87,109,5474
"26151990000",0,0,0,0,0,0,0,0,0
"26153000100",1885,330,3,18,222,101,20,9,2588
"26153000200",1955,321,0,0,227,13,21,0,2537
"26153000300",1927,677,8,0,286,189,6,15,3108
"26153990000",0,0,0,0,0,0,0,0,0
"26155030100",5172,451,6,36,88,18,88,0,5859
"26155030200",3185,281,0,0,43,23,111,40,3683
"26155030300",3760,888,66,11,154,18,44,95,5036
"26155030400",2105,583,0,3,43,9,146,0,2889
"26155030500",2837,481,0,0,134,24,42,29,3547
"26155030600",1093,686,0,0,43,20,65,99,2006
"26155030700",2005,863,0,0,17,42,75,15,3017
"26155030800",2278,848,0,0,64,60,235,15,3500
"26155031301",3796,424,1,0,107,8,88,18,4442
"26155031302",3667,473,0,0,121,11,36,2,4310
"26155031401",5502,408,2,2,80,18,78,46,6136
"26155031402",3296,239,27,8,161,8,34,26,3799
"26155031500",5046,926,39,8,133,22,132,0,6306
"26155031600",2745,821,35,18,0,10,34,10,3673
"26155031700",3600,498,0,32,13,19,0,53,4215
"26155031800",3262,691,18,0,31,53,39,2,4096
"26155031900",3055,582,0,0,35,14,21,9,3716
"26157000100",3409,623,6,5,56,16,138,28,4281
"26157000200",2764,289,0,3,35,41,44,19,3195
"26157000300",2564,688,4,0,35,3,107,162,3563
"26157000400",2736,393,15,0,94,10,81,56,3385
"26157000500",4536,708,10,0,110,0,130,15,5509
"26157000600",2985,778,0,8,137,32,116,118,4174
"26157000700",2926,588,21,12,58,24,126,19,3774
"26157000800",3606,469,0,3,71,25,137,3,4314
"26157000900",3831,592,37,92,18,53,66,17,4706
"26157001000",4441,709,21,2,198,23,57,3,5454
"26157001100",2420,628,51,23,47,32,20,6,3227
"26157001200",3806,592,0,19,70,0,44,0,4531
"26157001300",4103,698,20,15,55,4,31,8,4934
"26157990000",0,0,0,0,0,0,0,0,0
"26159010100",5564,847,49,52,68,107,92,103,6882
"26159010200",3721,1207,236,59,486,206,792,682,7389
"26159010300",1485,197,87,32,122,0,34,8,1965
"26159010400",1782,264,244,295,168,22,110,0,2885
"26159010500",2551,419,165,114,193,8,249,22,3721
"26159010600",1036,465,221,471,550,91,577,253,3664
"26159010900",6194,938,83,0,166,51,210,71,7713
"26159011002",5964,586,0,27,419,13,440,19,7468
"26159011300",2912,1089,24,59,385,80,413,126,5088
"26159011400",3002,780,53,27,476,185,650,256,5429
"26159011500",2529,773,32,8,124,23,462,215,4166
"26159011600",4420,948,121,47,206,282,329,87,6440
"26159011800",4930,1476,47,0,145,219,169,106,7092
"26159011900",4377,234,44,1,217,38,234,37,5182
"26159012000",4010,1150,158,89,542,347,772,480,7548
"26159990000",0,0,0,0,0,0,0,0,0
"26161400100",500,551,30,14,283,309,10,46,1743
"26161400200",76,25,0,0,11,4,0,4,120
"26161400300",1031,2691,70,116,362,746,17,144,5177
"26161400400",2083,724,124,1,287,60,158,0,3437
"26161400500",1569,3340,179,34,323,658,101,166,6370
"26161400600",3271,525,27,44,359,69,44,0,4339
"26161400700",1583,408,186,67,227,96,50,100,2717
"26161400800",828,1171,7,4,138,281,83,81,2593
"26161402100",1275,407,75,46,534,223,74,0,2634
"26161402200",529,898,27,99,396,424,78,21,2472
"26161402300",1789,87,35,0,394,34,64,10,2413
"26161402500",1144,211,56,0,656,27,33,19,2146
"26161402600",650,242,22,73,772,341,115,128,2343
"26161402700",3380,204,89,138,1364,122,339,1,5637
"26161403100",1156,8,48,0,257,21,29,0,1519
"26161403200",2435,131,258,13,248,0,55,13,3153
"26161403300",2896,266,424,194,271,75,138,27,4291
"26161403400",2516,144,233,0,332,9,270,0,3504
"26161403500",2013,208,128,1,113,0,66,0,2529
"26161403600",1818,616,291,21,1623,922,89,0,5380
"26161403800",1499,267,485,191,542,144,47,2,3177
"26161404100",2790,189,290,31,150,0,276,60,3786
"26161404200",1115,216,211,351,172,93,69,0,2227
"26161404300",2551,34,7,1,140,10,102,0,2845
"26161404400",1745,19,116,71,163,60,44,0,2218
"26161404500",2481,473,200,0,1424,222,588,46,5434
"26161404600",2939,351,248,267,559,141,86,82,4673
"26161405100",1172,262,479,111,291,20,188,98,2621
"26161405200",3617,408,290,35,393,105,8,16,4872
"26161405300",3766,211,225,0,832,101,95,0,5230
"26161405400",1543,73,130,35,153,97,66,4,2101
"26161405500",1415,135,219,23,429,117,76,0,2414
"26161405600",2120,471,804,154,961,282,306,187,5285
"26161406000",2267,210,54,3,769,46,88,8,3445
"26161407000",3738,83,123,9,802,24,91,0,4870
"26161407400",2121,661,1467,609,666,313,334,264,6435
"26161407600",1128,27,1208,0,243,0,15,0,2621
"26161410100",592,373,886,518,378,177,226,139,3289
"26161410200",1254,247,189,147,180,72,56,21,2166
"26161410300",2547,469,592,226,192,44,220,40,4330
"26161410400",2171,332,671,137,297,25,453,0,4086
"26161410500",610,290,439,521,302,271,178,246,2857
"26161410600",170,331,878,686,100,154,28,32,2379
"26161410700",429,154,323,157,95,27,1,0,1186
"26161410800",596,195,217,483,126,46,21,12,1696
"26161410900",1152,47,18,25,54,61,5,0,1362
"26161411000",1444,613,190,105,153,151,62,62,2780
"26161411100",64,35,29,16,38,33,24,14,253
"26161411200",368,352,617,466,164,154,122,24,2267
"26161411700",1505,82,445,112,201,1,103,0,2449
"26161411900",1945,391,634,496,163,80,123,20,3852
"26161412000",2379,322,576,121,145,11,31,0,3585
"26161412100",1552,428,681,231,159,54,223,138,3466
"26161412300",527,34,1900,454,123,46,12,0,3096
"26161412600",1387,264,762,129,179,70,103,16,2910
"26161412700",2431,229,777,604,317,343,83,122,4906
"26161413000",1679,228,1248,480,73,45,87,0,3840
"26161413200",2672,485,499,132,337,78,172,57,4432
"26161413401",2567,149,823,294,615,0,284,0,4732
"26161413402",2972,171,1314,98,606,0,111,16,5288
"26161413403",1256,49,454,21,147,29,0,0,1956
"26161414000",1017,663,836,190,354,178,63,129,3430
"26161414200",1487,310,306,45,539,131,143,69,3030
"26161414300",1308,399,288,90,849,130,106,23,3193
"26161414500",1451,41,479,62,729,238,81,0,3081
"26161414700",919,104,69,0,345,16,40,30,1523
"26161414900",2284,11,35,0,1333,78,150,0,3891
"26161415200",1012,194,340,69,132,8,63,18,1836
"26161415400",1330,119,228,18,343,54,59,60,2211
"26161415600",1834,8,31,1,194,0,42,4,2114
"26161415800",2642,58,185,0,593,0,66,0,3544
"26161416000",1878,159,497,42,695,96,158,24,3549
"26161416200",3588,116,270,5,141,21,34,0,4175
"26161420000",2688,159,182,19,349,115,20,14,3546
"26161420200",2798,236,155,2,165,0,9,0,3365
"26161421100",3483,146,0,0,105,90,130,0,3954
"26161421900",11,0,0,0,0,4,0,0,15
"26161422200",6696,111,52,0,438,16,421,0,7734
"26161422900",11,63,0,54,0,5,0,10,143
"26161423400",5881,289,52,0,280,0,209,5,6716
"26161423600",2091,105,0,0,180,0,91,0,2467
"26161425000",3868,82,55,0,309,0,63,46,4423
"26161426000",3166,155,19,0,282,11,72,6,3711
"26161431000",4115,410,7,18,77,37,60,1,4725
"26161432000",4606,351,12,80,97,6,87,111,5350
"26161444000",5713,189,5,5,170,0,69,3,6154
"26161445000",2227,98,12,13,195,0,99,0,2644
"26161446200",1935,19,16,1,32,0,8,0,2011
"26161446400",2611,311,0,0,40,0,121,0,3083
"26161447000",2617,158,14,1,39,7,20,0,2856
"26161448000",3306,122,0,0,248,0,141,0,3817
"26161453000",4282,13,113,0,560,12,103,12,5095
"26161454000",4725,190,0,0,204,11,245,60,5435
"26161455000",3065,379,168,169,821,87,154,0,4843
"26161456000",3755,202,148,492,876,327,215,158,6173
"26161461000",6604,207,0,0,163,0,50,0,7024
"26161464000",5328,81,92,0,227,0,96,0,5824
"26161465000",4994,359,0,2,316,88,185,44,5988
"26161466000",2539,32,2,0,28,0,46,0,2647
"26161984000",15,4,0,0,0,0,0,0,19
"26163500100",362,0,1966,954,28,0,0,0,3310
"26163500200",87,0,1563,959,98,64,0,0,2771
"26163500300",77,3,1030,1045,13,69,0,11,2248
"26163500400",66,34,368,448,57,46,0,22,1041
"26163500500",13,0,1184,456,5,16,0,9,1683
"26163500600",185,14,1133,1534,10,230,0,0,3106
"26163500700",157,47,2396,1925,55,14,64,0,4658
"26163500800",255,14,1216,945,23,49,0,0,2502
"26163500900",49,0,2820,982,0,0,11,0,3862
"26163501000",74,58,1390,1341,145,175,10,78,3271
"26163501100",101,3,1540,1673,31,0,10,0,3358
"26163501200",42,10,1034,648,0,0,0,0,1734
"26163501300",104,6,1814,1745,0,10,9,10,3698
"26163501400",276,16,2888,935,34,0,43,2,4194
"26163501500",554,66,2385,1501,114,68,59,0,4747
"26163501600",339,80,824,575,103,78,0,68,2067
"26163501700",237,218,755,904,209,25,5,16,2369
"26163501800",778,105,2619,848,86,105,53,0,4594
"26163501900",107,6,1548,1275,18,122,0,0,3076
"26163502000",17,48,1714,863,0,0,0,0,2642
"26163503100",183,131,1902,694,32,97,0,0,3039
"26163503200",143,90,1426,1211,13,44,13,0,2940
"26163503300",110,55,2687,1310,160,31,78,0,4431
"26163503400",0,5,845,356,31,26,0,0,1263
"26163503500",82,24,1610,1561,60,0,60,0,3397
"26163503600",53,68,1034,395,86,47,0,1,1684
"26163503900",1,13,1294,829,18,33,0,43,2231
"26163504000",12,19,955,579,0,0,0,0,1565
"26163504100",0,0,603,836,5,0,0,0,1444
"26163504200",0,3,1259,682,0,34,0,1,1979
"26163504300",43,17,1242,872,0,0,0,3,2177
"26163504400",27,0,1022,702,0,125,0,0,1876
"26163504700",53,14,802,1191,99,0,0,0,2159
"26163504800",23,3,546,521,0,26,0,0,1119
"26163504900",242,30,1795,1083,11,16,0,0,3177
"26163505000",27,0,712,444,26,5,0,0,1214
"26163505100",138,11,1476,1042,71,25,17,16,2796
"26163505200",61,92,2110,1082,136,9,11,32,3533
"26163505400",41,2,1186,1185,38,3,0,0,2455
"26163505500",13,112,714,530,0,7,0,3,1379
"26163506100",46,78,876,822,107,0,0,0,1929
"26163506200",36,24,841,1431,0,11,9,6,2358
"26163506300",4,18,1220,822,0,74,0,0,2138
"26163506400",19,26,530,531,0,36,0,1,1143
"26163506500",0,28,1007,1219,0,20,0,0,2274
"26163506600",37,87,1450,912,6,75,0,0,2567
"26163506700",21,11,727,656,0,22,0,0,1437
"26163506800",73,61,2774,1122,8,86,32,24,4180
"26163506900",178,0,2497,1491,48,1,48,28,4291
"26163507000",0,0,1536,1269,0,0,0,0,2805
"26163507100",11,1,1449,1034,20,15,0,1,2531
"26163507200",33,5,566,486,20,22,33,14,1179
"26163507300",83,3,1842,358,41,0,0,0,2327
"26163507400",18,17,1935,597,25,22,18,7,2639
"26163507500",112,39,1177,823,0,67,19,0,2237
"26163507800",43,2,461,201,0,0,0,0,707
"26163507900",112,114,847,645,41,31,17,32,1839
"26163508000",52,108,537,428,15,36,0,0,1176
"26163508100",48,77,566,814,129,38,0,16,1688
"26163510400",4,12,461,185,0,0,0,0,662
"26163510500",254,124,302,892,1201,2030,0,0,4803
"26163510600",899,610,417,329,405,1598,0,0,4258
"26163510700",237,844,131,138,289,155,0,7,1801
"26163511000",35,43,1084,859,56,38,0,41,2156
"26163511200",110,18,749,469,15,17,0,0,1378
"26163511300",126,200,656,579,127,35,0,0,1723
"26163511400",31,2,1597,894,37,18,14,0,2593
"26163511900",36,37,901,747,19,6,0,0,1746
"26163512100",29,9,1657,1394,0,0,0,0,3089
"26163512200",35,63,203,947,0,0,0,51,1299
"26163512300",5,135,621,695,10,55,0,100,1621
"26163512400",37,5,593,637,27,0,0,0,1299
"26163512600",8,0,830,621,21,6,0,0,1486
"26163512900",20,12,416,713,30,72,0,0,1263
"26163513200",207,70,842,451,72,83,0,67,1792
"26163513300",182,79,1375,685,81,36,6,22,2466
"26163513600",39,25,683,728,47,0,13,0,1535
"26163513700",112,2,1850,1293,19,0,0,0,3276
"26163513900",16,38,1075,742,22,5,15,0,1913
"26163514100",6,27,1232,1806,0,70,6,51,3198
"26163514200",0,8,1095,1508,0,47,0,0,2658
"26163514300",0,6,1530,1983,0,6,0,0,3525
"26163514500",0,0,599,700,9,0,0,0,1308
"26163515200",18,46,728,389,1,15,15,0,1212
"26163515300",190,81,1080,1360,79,16,44,12,2862
"26163515400",424,46,566,404,89,0,44,0,1573
"26163515600",5,13,659,501,0,8,0,0,1186
"26163515700",250,81,2658,465,112,0,38,0,3604
"26163515900",26,1,591,645,0,0,0,0,1263
"26163516000",9,37,1282,678,11,13,0,13,2043
"26163516100",0,2,157,285,34,0,0,0,478
"26163516200",10,14,291,446,7,0,0,0,768
"26163516300",5,13,307,321,0,5,0,0,651
"26163516400",163,177,600,250,11,19,0,1,1221
"26163516500",231,96,672,336,45,53,16,0,1449
"26163516600",0,23,1173,1090,8,15,8,0,2317
"26163516700",15,37,1634,1202,134,24,0,0,3046
"26163516800",7,22,341,517,0,53,0,0,940
"26163516900",40,0,1814,736,19,0,0,0,2609
"26163517000",593,136,1606,341,76,9,10,10,2781
"26163517100",114,55,697,275,5,0,12,0,1158
"26163517200",407,94,260,71,82,3,29,0,946
"26163517300",285,132,857,648,48,17,19,5,2011
"26163517500",156,66,905,940,78,76,0,0,2221
"26163518000",302,183,931,466,89,9,10,0,1990
"26163518400",37,51,222,179,0,4,0,0,493
"26163518500",105,65,435,308,0,89,0,0,1002
"26163518600",10,2,338,362,0,0,0,1,713
"26163518800",79,18,364,324,11,11,0,0,807
"26163518900",60,17,664,1038,4,47,0,0,1830
"26163520200",300,380,115,161,361,167,0,5,1489
"26163520300",239,205,198,241,254,262,180,18,1597
"26163520400",285,240,436,733,52,26,3,24,1799
"26163520700",676,171,873,587,21,72,58,9,2467
"26163520800",281,27,582,106,155,48,87,0,1286
"26163521100",973,399,215,233,247,76,994,196,3333
"26163521300",133,15,462,210,36,14,98,3,971
"26163521400",641,126,230,183,55,5,234,88,1562
"26163521500",136,191,546,567,37,52,50,57,1636
"26163521800",10,0,682,571,10,0,10,4,1287
"26163521900",983,246,504,1099,108,89,218,5,3252
"26163522000",32,95,784,936,0,5,33,21,1906
"26163522100",0,101,366,276,0,7,0,0,750
"26163522200",96,28,195,280,6,19,66,19,709
"26163522300",68,11,374,797,21,11,0,4,1286
"26163522400",60,5,465,469,0,13,0,0,1012
"26163522500",123,248,256,965,7,48,29,6,1682
"26163523100",902,319,76,117,204,199,823,422,3062
"26163523200",1455,580,160,38,825,862,2006,1230,7156
"26163523300",1787,1071,35,121,590,249,2148,922,6923
"26163523400",788,503,320,333,649,96,1168,358,4215
"26163523800",1287,1264,147,14,775,616,1789,1365,7257
"26163524000",1331,1302,72,72,284,260,1147,1079,5547
"26163524100",1401,692,203,160,831,505,1832,804,6428
"26163524200",2405,1408,32,313,1008,316,2566,1189,9237
"26163524300",1290,706,220,23,378,304,1147,798,4866
"26163524500",135,298,22,30,211,35,243,287,1261
"26163524700",2,88,2684,978,3,56,0,80,3891
"26163524800",13,155,1298,1614,37,18,26,113,3274
"26163524900",589,379,192,48,48,299,274,414,2243
"26163525000",407,231,64,167,3,155,148,187,1362
"26163525400",427,193,635,617,570,257,848,435,3982
"26163525500",151,92,347,302,102,256,224,194,1668
"26163525600",499,880,62,25,287,320,530,1135,3738
"26163525700",2365,1114,21,37,1487,876,3142,1344,10386
"26163525800",308,509,92,81,68,526,280,917,2781
"26163526000",919,986,0,230,448,373,697,590,4243
"26163526100",935,946,195,69,208,380,317,371,3421
"26163526200",855,834,324,190,717,433,1003,560,4916
"26163526300",797,601,222,220,1000,624,1452,1027,5943
"26163526400",475,387,112,330,506,107,945,473,3335
"26163526500",159,35,1085,555,68,125,192,151,2370
"26163527200",0,56,516,271,0,1,0,53,897
"26163527300",0,2,315,708,2,50,0,8,1085
"26163530100",84,1,1358,815,45,62,0,0,2365
"26163530200",140,182,1811,1314,81,52,23,1,3604
"26163530300",0,53,809,1165,15,0,0,40,2082
"26163530400",49,0,1016,657,8,0,0,0,1730
"26163530500",24,31,1676,835,20,73,0,0,2659
"26163530800",15,7,1072,875,0,14,0,14,1997
"26163530900",9,5,1009,1347,27,13,0,0,2410
"26163531100",0,51,310,572,0,66,0,46,1045
"26163531200",65,25,2455,360,77,16,0,16,3014
"26163531300",8,16,940,286,0,14,0,0,1264
"26163531400",25,7,1108,428,0,22,18,7,1615
"26163531500",4,23,1282,1213,0,102,0,17,2641
"26163531600",0,43,974,517,37,22,27,0,1620
"26163531700",0,1,535,979,1,0,0,0,1516
"26163531800",18,67,1086,849,0,0,0,0,2020
"26163531900",0,138,289,422,32,7,13,0,901
"26163532200",56,34,658,490,17,17,0,0,1272
"26163532300",87,34,602,69,44,0,0,0,836
"26163532400",12,81,893,474,0,72,0,25,1557
"26163532600",49,47,764,1100,110,95,51,25,2241
"26163532700",20,18,394,286,0,0,0,6,724
"26163533000",9,60,680,643,37,20,0,56,1505
"26163533100",0,9,601,1078,50,9,0,9,1756
"26163533200",0,1,880,713,0,0,0,0,1594
"26163533300",0,20,696,844,0,76,0,0,1636
"26163533400",0,28,1181,1399,34,23,0,0,2665
"26163533500",0,0,557,530,19,0,0,0,1106
"26163533600",17,0,1349,837,0,0,54,0,2257
"26163533700",0,43,633,420,0,0,0,0,1096
"26163533900",391,223,1119,1088,76,22,0,0,2919
"26163534100",2,2,876,1022,0,54,0,0,1956
"26163534200",9,25,2071,1676,48,100,0,0,3929
"26163534300",0,5,809,574,0,9,0,0,1397
"26163534400",20,15,874,876,21,23,0,0,1829
"26163534500",14,0,294,547,47,0,0,0,902
"26163534600",71,42,987,573,33,8,83,23,1820
"26163534700",18,0,1832,1311,0,0,1,0,3162
"26163535000",119,27,1539,1079,81,109,0,0,2954
"26163535100",57,9,1076,619,22,0,0,0,1783
"26163535200",40,56,1221,1212,0,58,52,0,2639
"26163535300",59,3,2596,1110,40,0,31,43,3882
"26163535400",15,0,747,807,7,0,0,0,1576
"26163535500",157,8,1591,995,0,0,0,0,2751
"26163535600",63,0,2912,889,0,27,0,0,3891
"26163535700",0,0,986,519,26,17,0,43,1591
"26163536100",0,9,1937,962,40,127,23,64,3162
"26163536200",0,0,1186,688,30,6,0,0,1910
"26163536300",18,27,1574,1433,0,0,0,0,3052
"26163536400",25,0,1579,1133,71,0,0,0,2808
"26163536500",81,0,1566,627,70,0,27,0,2371
"26163536600",0,0,1878,799,39,0,16,0,2732
"26163536700",6,0,521,577,5,38,0,0,1147
"26163536800",34,5,1061,455,54,2,0,1,1612
"26163536900",53,22,1783,1202,5,72,88,0,3225
"26163537000",82,6,2006,1104,119,0,42,0,3359
"26163537100",9,0,1329,449,31,7,0,0,1825
"26163537200",4,9,347,509,22,5,4,0,900
"26163537300",0,1,1408,1402,23,1,0,24,2859
"26163537500",92,2,1438,1192,0,0,0,0,2724
"26163537600",78,0,2388,923,25,62,22,62,3560
"26163537700",17,0,2133,1117,37,7,11,0,3322
"26163537800",17,0,1110,557,22,0,0,0,1706
"26163538100",274,45,1604,344,124,0,27,0,2418
"26163538200",284,0,1468,185,53,0,41,0,2031
"26163538300",19,2,1092,416,0,26,0,26,1581
"26163538400",570,2,2696,352,115,13,0,0,3748
"26163538500",0,11,3993,1010,167,35,0,0,5216
"26163538600",9,1,3959,961,174,8,23,0,5135
"26163538700",8,18,2244,1526,45,49,4,0,3894
"26163538800",18,0,1225,421,50,15,4,0,1733
"26163538900",38,0,2894,410,51,0,9,0,3402
"26163539000",1,5,2192,802,48,24,0,43,3115
"26163539100",0,117,1264,603,13,27,0,0,2024
"26163539200",15,9,2849,1377,106,24,0,26,4406
"26163539300",58,9,2629,1475,40,0,23,0,4234
"26163539400",31,19,2295,1017,61,32,0,10,3465
"26163539500",26,0,2393,506,98,0,0,0,3023
"26163539600",40,66,2013,1139,24,0,24,0,3306
"26163539700",20,1,1374,636,7,14,0,0,2052
"26163540100",92,0,2267,1128,22,0,14,0,3523
"26163540200",33,1,1718,1603,27,0,0,0,3382
"26163540300",0,0,2786,1575,35,0,9,0,4405
"26163540400",36,2,1320,1179,14,0,17,0,2568
"26163540500",56,1,2186,1028,0,0,0,0,3271
"26163540600",6,0,2425,742,42,0,0,0,3215
"26163540700",37,7,2388,1117,18,7,11,17,3602
"26163540800",16,20,1528,529,27,1,9,0,2130
"26163540900",93,11,2475,849,18,0,0,0,3446
"26163541000",71,46,1987,1475,36,82,8,0,3705
"26163541100",61,421,1390,1059,81,0,9,0,3021
"26163541200",89,75,894,792,0,42,1,49,1942
"26163541300",428,185,949,934,68,15,12,72,2663
"26163541400",232,112,1334,643,21,0,0,0,2342
"26163541500",90,27,2427,1376,16,11,14,0,3961
"26163541700",44,3,1215,791,32,0,0,0,2085
"26163541800",221,42,1467,678,86,20,0,0,2514
"26163542100",49,14,2653,1336,59,40,49,0,4200
"26163542200",4,0,2228,1088,99,150,46,150,3765
"26163542300",28,7,1246,856,7,10,0,0,2154
"26163542400",36,1,1652,675,16,13,0,0,2393
"26163542500",33,6,2206,526,27,0,4,0,2802
"26163542600",0,0,1848,1262,9,19,0,0,3138
"26163542700",10,70,620,455,4,4,4,0,1167
"26163542800",171,38,1827,273,79,20,0,0,2408
"26163542900",202,19,2688,223,199,0,11,0,3342
"26163543000",141,32,1798,491,63,0,56,21,2602
"26163543100",185,42,2027,210,57,0,0,0,2521
"26163543200",84,67,1707,807,136,72,15,76,2964
"26163543400",34,6,2045,988,74,0,0,0,3147
"26163543500",50,20,476,1034,0,3,5,3,1591
"26163543600",193,74,374,656,17,17,8,0,1339
"26163543700",151,10,981,1091,92,35,0,35,2395
"26163543800",64,235,197,368,13,66,13,64,1020
"26163543900",46,15,496,167,6,14,0,1,745
"26163544000",200,23,1443,695,0,1,0,0,2362
"26163544100",164,4,1053,374,10,0,0,0,1605
"26163544200",292,249,891,858,87,0,3,88,2468
"26163544300",306,244,1025,792,47,66,12,5,2497
"26163545100",18,9,677,488,0,0,15,0,1207
"26163545200",11,2,1740,1419,33,0,9,0,3214
"26163545300",37,0,833,702,8,0,16,0,1596
"26163545400",46,9,246,442,0,5,0,34,782
"26163545500",522,568,1330,1610,229,100,157,83,4599
"26163545600",647,1924,671,568,32,206,166,271,4485
"26163545700",675,610,445,388,255,125,388,303,3189
"26163545800",1007,728,1166,1133,303,434,136,371,5278
"26163545900",298,341,1429,1625,45,24,61,80,3903
"26163546000",381,13,1550,1273,31,1,0,1,3250
"26163546100",287,271,1946,1600,24,137,26,96,4387
"26163546200",704,107,1670,480,86,134,51,120,3352
"26163546300",202,114,1198,212,59,0,0,0,1785
"26163546400",57,11,694,610,0,0,0,0,1372
"26163546500",0,0,1243,761,108,6,5,12,2135
"26163546600",70,22,983,1118,52,0,49,0,2294
"26163546700",112,27,1845,872,0,39,0,1,2896
"26163546800",120,78,1261,2045,0,10,0,0,3514
"26163546900",5,12,1015,162,0,12,0,0,1206
"26163550100",3486,92,428,57,99,0,59,9,4230
"26163550200",2890,229,449,127,245,0,237,17,4194
"26163550300",3095,57,52,0,106,0,51,0,3361
"26163550400",1183,87,31,0,206,6,24,0,1537
"26163550500",3484,73,0,0,264,0,89,0,3910
"26163550600",2220,58,0,0,57,6,81,0,2422
"26163550700",5152,214,75,14,112,0,122,0,5689
"26163550800",1237,4,33,0,141,0,34,0,1449
"26163550900",2681,78,34,0,112,10,41,0,2956
"26163551100",4269,168,42,0,102,2,17,16,4616
"26163551200",3418,128,344,0,147,7,38,0,4082
"26163551300",1950,185,1304,165,99,9,9,12,3733
"26163551400",1769,136,1809,247,277,72,160,0,4470
"26163551500",1096,65,1160,100,43,25,209,0,2698
"26163551600",1010,124,1558,644,46,0,5,0,3387
"26163551700",3341,62,17,0,74,3,25,0,3522
"26163551800",3006,201,406,103,81,10,41,0,3848
"26163552000",779,694,9,50,1033,214,4,36,2819
"26163552100",1410,824,385,654,618,900,7,0,4798
"26163552200",1657,631,158,96,676,273,66,0,3557
"26163552300",935,1275,80,183,689,333,34,27,3556
"26163552400",421,570,230,71,517,547,5,4,2365
"26163552800",1208,1953,69,603,182,535,0,9,4559
"26163553000",4,6,666,489,5,0,0,0,1170
"26163553100",132,52,724,632,75,52,0,0,1667
"26163553200",1,72,383,249,0,0,0,0,705
"26163553300",1,4,307,408,61,6,0,0,787
"26163553400",0,1,604,1504,101,0,0,0,2210
"26163553600",140,93,1337,824,25,0,0,5,2424
"26163553800",25,41,998,625,10,19,15,0,1733
"26163554100",2165,365,1172,342,212,0,78,28,4362
"26163554200",1702,260,596,77,51,0,35,22,2743
"26163554300",3902,139,729,168,298,52,129,7,5424
"26163554400",1572,252,901,242,171,16,174,16,3344
"26163554500",1730,152,474,154,311,0,161,0,2982
"26163554600",2852,287,165,91,154,69,179,13,3810
"26163554700",2054,91,109,34,80,95,202,25,2690
"26163554800",1319,409,1656,293,97,0,220,0,3994
"26163554900",1596,242,1104,150,117,41,39,0,3289
"26163555100",2784,362,746,204,124,198,80,65,4563
"26163555300",1526,188,1441,166,130,1,87,0,3539
"26163555400",418,216,1761,390,44,9,51,36,2925
"26163555500",1286,289,927,304,19,97,36,0,2958
"26163555600",1663,30,794,23,144,0,25,0,2679
"26163556100",2765,289,38,143,51,110,91,0,3487
"26163556200",1825,365,216,79,110,37,39,0,2671
"26163556300",2278,201,234,9,370,36,76,0,3204
"26163556400",3768,89,35,0,414,10,166,11,4493
"26163556500",1757,105,55,53,136,0,20,0,2126
"26163556600",3117,211,0,1,191,0,14,0,3534
"26163556700",2331,84,69,0,112,0,79,23,2698
"26163556800",1793,83,0,1,41,16,52,0,1986
"26163556900",3326,43,76,1,419,0,223,0,4088
"26163557000",2221,535,201,35,64,0,184,6,3246
"26163557100",2040,100,72,5,85,0,23,0,2325
"26163557200",1662,122,17,64,97,0,59,3,2024
"26163557300",1939,70,6,11,56,6,55,0,2143
"26163557400",3231,22,0,0,122,0,64,0,3439
"26163557500",3524,150,0,4,51,15,72,15,3831
"26163557600",2983,19,37,3,87,0,20,0,3149
"26163557700",4328,95,3,6,116,0,42,0,4590
"26163557900",4149,164,51,23,235,0,49,14,4685
"26163558000",3786,127,57,2,143,1,89,0,4205
"26163558100",3211,149,14,11,48,116,8,0,3557
"26163558200",3402,392,275,49,80,21,85,1,4305
"26163558300",1456,315,61,11,59,4,25,0,1931
"26163558400",3322,263,141,58,166,0,77,0,4027
"26163558500",3830,163,18,4,54,44,28,30,4171
"26163558600",1822,84,15,37,36,0,69,0,2063
"26163558700",2699,44,9,1,19,0,53,0,2825
"26163558800",2433,116,27,1,161,0,43,9,2790
"26163558900",1607,81,7,2,173,8,53,1,1932
"26163559000",2237,89,165,0,145,7,32,0,2675
"26163559100",2137,17,61,2,288,0,195,0,2700
"26163559200",1866,145,1,4,80,2,78,0,2176
"26163560100",2270,197,25,7,139,50,8,5,2701
"26163560200",3712,286,156,12,1023,0,113,23,5325
"26163560300",2604,81,200,0,431,0,36,0,3352
"26163560400",5262,179,76,0,206,0,180,0,5903
"26163561200",3933,85,157,1,2076,0,325,17,6594
"26163561300",6394,235,185,7,1181,0,460,62,8524
"26163561600",3496,166,64,1,148,20,66,0,3961
"26163561700",1651,200,109,1,129,50,82,25,2247
"26163561900",6114,205,77,19,612,0,66,0,7093
"26163562300",1630,72,54,0,188,32,30,0,2006
"26163562400",5014,142,51,4,206,0,53,0,5470
"26163562500",1532,156,68,66,136,47,40,56,2101
"26163562600",3205,112,0,40,127,10,31,0,3525
"26163562700",3159,98,7,5,91,9,116,12,3497
"26163562800",2813,35,124,3,151,0,7,0,3133
"26163562900",3075,290,86,12,117,60,31,0,3671
"26163563200",1457,375,584,94,278,60,11,245,3104
"26163563300",2296,62,367,337,266,39,81,9,3457
"26163563400",4138,338,260,40,320,33,141,0,5270
"26163563500",4987,111,163,2,796,49,128,0,6236
"26163563600",1638,34,52,0,329,14,37,8,2112
"26163563700",1331,21,75,0,156,0,47,0,1630
"26163563800",2329,140,95,23,316,0,86,0,2989
"26163563900",1689,68,204,19,412,0,29,8,2429
"26163564000",1089,62,150,49,338,13,133,0,1834
"26163564100",2476,153,326,40,982,35,166,0,4178
"26163564200",2471,234,447,137,363,64,118,0,3834
"26163564300",1842,18,182,9,380,48,43,0,2522
"26163564401",4165,134,0,0,890,84,168,0,5441
"26163564402",2282,6,475,0,1605,25,136,0,4529
"26163564501",3506,155,397,0,753,0,112,0,4923
"26163564502",2119,97,535,7,699,73,16,0,3546
"26163564503",1826,46,833,8,595,0,211,0,3519
"26163564504",4038,289,728,50,942,73,134,0,6254
"26163564600",5114,110,409,1,1544,0,145,0,7323
"26163564700",2767,144,595,274,1041,113,77,0,5011
"26163564800",3397,81,427,28,646,49,167,0,4795
"26163564900",1376,516,238,117,60,87,45,6,2445
"26163565000",2948,62,42,17,1345,242,72,0,4728
"26163565100",1658,192,689,313,317,7,28,7,3211
"26163565200",2888,299,908,242,665,0,0,0,5002
"26163565300",1755,287,2280,494,379,166,0,107,5468
"26163565600",1975,138,154,0,53,0,16,0,2336
"26163565700",2434,315,554,7,274,90,37,0,3711
"26163565800",2882,372,244,67,174,0,112,0,3851
"26163565900",1919,676,172,51,44,20,50,9,2941
"26163566400",467,102,211,137,4,0,38,0,959
"26163566500",1298,593,206,103,34,140,56,0,2430
"26163566600",1412,169,385,91,45,8,31,0,2141
"26163566700",2677,810,15,76,171,0,155,58,3962
"26163566800",2205,204,198,41,174,85,45,17,2969
"26163566900",3134,417,653,524,263,62,8,53,5114
"26163567000",1214,438,1200,220,227,0,49,72,3420
"26163567100",2536,611,256,178,100,0,99,71,3851
"26163567201",2509,244,1,12,652,36,228,36,3718
"26163567202",2244,108,289,149,28,180,60,43,3101
"26163567300",3513,556,392,98,170,11,167,0,4907
"26163567400",2506,95,239,17,121,0,21,0,2999
"26163567800",3474,327,568,231,393,0,37,12,5042
"26163567900",2174,190,290,15,111,9,73,0,2862
"26163568000",1775,226,31,16,100,11,32,0,2191
"26163568200",2963,135,359,7,231,13,26,0,3734
"26163568300",2302,644,560,252,167,0,32,51,4008
"26163568400",2566,396,287,83,204,35,143,0,3714
"26163568500",1670,1583,545,544,246,29,188,41,4846
"26163568700",2468,178,605,118,44,11,45,0,3469
"26163568800",1100,266,739,544,263,22,111,12,3057
"26163568900",1995,284,175,11,266,8,15,16,2770
"26163569100",2410,140,0,0,18,65,96,0,2729
"26163569200",2378,346,53,7,72,76,22,62,3016
"26163569300",2802,373,106,0,185,8,67,29,3570
"26163569400",2326,246,93,24,56,1,22,24,2792
"26163569500",2345,233,57,2,15,0,35,0,2687
"26163569600",3122,214,0,2,70,0,69,0,3477
"26163569700",3491,510,57,16,87,18,140,74,4393
"26163569800",2082,259,40,5,176,7,11,14,2594
"26163569900",1997,430,123,18,90,0,54,0,2712
"26163570100",1302,207,1514,434,254,0,159,0,3870
"26163570200",912,112,955,538,103,7,59,7,2693
"26163570400",765,296,1429,2076,4,67,0,100,4737
"26163570500",276,149,2079,1267,52,45,65,0,3933
"26163570600",17,65,1059,962,23,88,18,30,2262
"26163570800",42,57,1592,823,282,73,99,0,2968
"26163570900",79,26,1606,704,122,14,2,0,2553
"26163571000",158,101,998,982,49,110,13,6,2417
"26163571500",2656,1181,483,79,154,43,33,46,4675
"26163571600",1034,324,66,57,145,92,40,0,1758
"26163571700",1078,494,420,230,55,114,12,5,2408
"26163571800",2329,389,394,77,165,0,129,33,3516
"26163571900",1807,259,458,52,224,112,39,20,2971
"26163572000",1275,350,22,0,75,0,6,0,1728
"26163572100",4708,1197,1,24,428,119,255,0,6732
"26163572200",4349,805,386,64,263,108,193,0,6168
"26163572400",651,332,46,50,90,85,57,18,1329
"26163572500",1228,262,75,10,58,0,148,19,1800
"26163572600",2965,456,212,481,381,0,188,48,4731
"26163572700",3315,306,92,0,502,0,483,37,4735
"26163572800",4320,936,122,18,257,41,223,174,6091
"26163572900",1639,698,83,21,83,0,91,0,2615
"26163573000",2792,329,43,15,95,16,156,0,3446
"26163573100",2675,601,373,152,428,4,19,0,4252
"26163573300",2397,2090,20,62,114,138,79,0,4900
"26163573400",2190,1316,87,61,65,92,60,21,3892
"26163573500",2169,1802,0,0,280,183,7,15,4456
"26163573600",2601,3558,46,8,249,218,82,95,6857
"26163573701",1340,633,14,0,0,37,52,37,2113
"26163573702",2525,3032,71,0,176,36,16,0,5856
"26163573800",2175,2290,82,68,187,265,83,0,5150
"26163573900",2676,2033,18,112,260,237,0,0,5336
"26163574000",2554,2045,10,2,331,129,82,46,5199
"26163574100",1980,2075,56,18,196,148,60,103,4636
"26163574202",1794,152,553,9,316,50,89,9,2972
"26163574300",1578,1004,405,131,371,40,190,20,3739
"26163574600",4325,297,287,8,114,9,254,10,5304
"26163574700",3980,230,3,25,225,0,216,31,4710
"26163574800",3781,86,0,0,208,12,38,0,4125
"26163574900",1456,96,54,14,18,0,32,0,1670
"26163575000",3674,195,64,15,93,6,118,16,4181
"26163575100",1883,320,183,0,270,21,328,21,3026
"26163575200",3141,205,341,29,217,0,219,22,4174
"26163575300",2826,401,15,0,183,0,210,26,3661
"26163575400",2799,257,41,0,166,0,245,0,3508
"26163575500",3284,311,100,0,125,10,180,0,4010
"26163575600",1176,99,42,0,118,0,94,0,1529
"26163576000",1522,122,78,9,102,78,307,77,2295
"26163576100",5259,194,121,83,167,95,588,110,6617
"26163576200",2108,288,0,0,16,0,239,54,2705
"26163576300",2030,179,35,3,71,0,118,17,2453
"26163576400",3267,214,38,0,36,12,166,0,3733
"26163576500",3373,287,22,1,53,0,181,95,4012
"26163576600",3744,225,55,54,135,0,242,64,4519
"26163576700",3215,138,115,0,131,0,130,0,3729
"26163577000",1724,677,560,373,779,177,816,205,5311
"26163577100",1568,585,28,29,370,238,530,410,3758
"26163577200",2168,710,148,120,243,111,528,201,4229
"26163577300",2359,373,47,0,266,79,408,60,3592
"26163577400",2630,463,11,18,344,22,535,47,4070
"26163577500",2231,634,54,0,245,19,278,166,3627
"26163577600",2787,707,45,0,221,43,408,16,4227
"26163577700",2140,183,16,11,38,0,159,7,2554
"26163577800",3887,631,40,157,166,57,654,184,5776
"26163577900",2756,383,305,0,95,151,217,143,4050
"26163578000",1811,267,71,101,52,0,287,0,2589
"26163578500",2666,966,615,136,565,255,685,162,6050
"26163578600",3005,1327,541,85,163,257,279,206,5863
"26163579100",902,254,332,170,51,20,284,107,2120
"26163579200",1463,481,426,571,158,105,460,57,3721
"26163579300",2,0,1355,1442,13,8,13,24,2857
"26163579500",597,409,254,183,259,134,297,73,2206
"26163579600",137,1,1985,829,8,25,8,0,2993
"26163579700",1799,422,289,151,344,70,720,55,3850
"26163579800",751,298,160,50,55,73,126,88,1601
"26163579900",3176,739,299,22,288,40,141,8,4713
"26163580100",1489,134,68,26,15,0,129,0,1861
"26163580200",2252,266,0,9,113,0,142,0,2782
"26163580300",2838,96,0,0,15,7,163,7,3126
"26163580400",2240,124,0,0,122,0,193,0,2679
"26163580500",3113,113,1,2,59,0,101,0,3389
"26163580600",2442,540,0,25,129,145,179,177,3637
"26163580700",2841,813,13,16,67,9,119,0,3878
"26163580800",1217,175,59,26,33,0,1,6,1517
"26163580900",3204,385,62,0,126,0,90,0,3867
"26163581100",2710,223,337,162,201,20,272,38,3963
"26163581200",2965,233,160,28,153,2,235,25,3801
"26163581500",1997,210,9,12,102,21,95,0,2446
"26163581600",4354,482,247,85,484,168,364,57,6241
"26163581800",2228,272,0,0,75,0,189,8,2772
"26163581900",4366,424,41,2,58,82,287,87,5347
"26163582000",1932,332,313,165,111,7,128,34,3022
"26163582100",3377,330,15,1,83,0,90,0,3896
"26163583000",1743,584,142,93,78,75,90,81,2886
"26163583100",2892,738,42,35,230,0,109,19,4065
"26163583200",1858,585,28,19,151,0,340,0,2981
"26163583300",1753,423,58,193,298,11,180,38,2954
"26163583400",4013,366,66,127,208,22,273,16,5091
"26163583500",2168,252,94,0,89,0,39,0,2642
"26163583600",2013,355,22,1,187,0,181,0,2759
"26163583700",3125,368,155,117,144,0,395,13,4317
"26163583800",3640,315,441,17,225,12,155,10,4815
"26163583900",2155,548,730,296,58,97,116,56,4056
"26163584000",2573,371,647,541,127,8,116,0,4383
"26163584100",1612,117,24,1,51,13,76,0,1894
"26163584200",1786,182,390,468,169,139,7,0,3141
"26163584300",1281,123,360,69,54,57,104,16,2064
"26163584400",1840,152,454,101,168,1,200,15,2931
"26163584500",1765,249,333,55,397,6,346,109,3260
"26163584600",1033,263,261,136,110,196,35,0,2034
"26163584700",2233,130,15,7,313,46,284,68,3096
"26163584800",961,645,737,2728,265,292,93,222,5943
"26163585500",819,512,182,84,165,12,116,6,1896
"26163585600",261,231,2174,411,163,109,70,0,3419
"26163585700",611,138,853,126,125,43,125,0,2021
"26163585800",1439,553,1945,638,194,66,72,68,4975
"26163585900",1379,382,588,98,304,62,141,0,2954
"26163586200",2830,299,2479,460,729,33,68,0,6898
"26163586300",1620,340,26,49,31,0,13,5,2084
"26163587000",2888,561,240,43,77,0,200,28,4037
"26163587900",2814,448,2295,175,560,72,92,35,6491
"26163588000",3335,516,1824,251,103,42,133,0,6204
"26163588100",1501,563,186,0,219,7,99,0,2575
"26163588200",1295,301,956,263,178,28,28,100,3149
"26163588300",3777,395,850,15,210,0,20,13,5280
"26163588400",3309,159,1258,91,299,0,75,0,5191
"26163589300",2965,611,299,8,118,18,110,111,4240
"26163589400",3645,1001,427,101,65,69,47,288,5643
"26163590400",5785,525,270,21,152,55,136,40,6984
"26163590500",4924,843,82,172,360,67,84,45,6577
"26163590600",2275,74,17,19,48,7,32,7,2479
"26163591501",2000,187,208,219,255,65,96,3,3033
"26163591502",1669,187,332,77,558,0,29,0,2852
"26163591600",1651,80,96,12,245,0,245,5,2334
"26163591700",5386,196,184,110,433,0,507,0,6816
"26163591800",4474,577,356,202,652,184,380,49,6874
"26163591900",4239,493,364,2,220,44,334,0,5696
"26163592000",3912,82,204,1,317,0,249,0,4765
"26163593000",4462,307,132,213,371,50,196,0,5731
"26163593200",3333,139,109,0,121,0,81,0,3783
"26163593300",2842,248,106,0,116,0,161,0,3473
"26163594000",2025,365,0,0,67,0,152,150,2759
"26163594100",4051,103,16,2,87,0,15,0,4274
"26163594200",2557,10,0,0,60,0,50,0,2677
"26163594300",2752,230,41,8,69,0,139,0,3239
"26163594400",2010,489,72,42,59,19,174,16,2881
"26163594500",2633,236,67,189,115,20,126,15,3401
"26163595000",3059,552,30,3,182,0,153,90,4069
"26163595100",4496,465,216,44,105,15,456,83,5880
"26163595200",2286,108,96,49,83,26,65,10,2723
"26163596100",3325,190,0,0,21,7,16,0,3559
"26163596200",3702,111,0,1,261,0,228,0,4303
"26163596300",2424,82,54,4,80,1,91,0,2736
"26163597000",3728,559,63,53,131,23,66,0,4623
"26163598000",2828,225,0,9,181,0,100,0,3343
"26163599000",4030,697,463,161,151,15,182,135,5834
"26163599100",3641,422,42,134,74,21,196,43,4573
"26163985000",0,0,0,0,0,0,0,0,0
"26163985100",13,7,79,22,0,5,0,5,131
"26163985200",0,0,0,0,0,0,0,0,0
"26163985300",0,0,0,0,0,0,0,0,0
"26163985400",0,0,0,0,0,0,0,0,0
"26163985500",0,0,0,0,0,0,0,0,0
"26163985600",0,0,0,0,0,0,0,0,0
"26163985700",0,0,0,0,0,0,0,0,0
"26163985900",0,0,0,0,0,0,0,0,0
"26163990100",0,0,0,0,0,0,0,0,0
"26163990200",0,0,0,0,0,0,0,0,0
"26165380100",3925,977,16,12,136,19,204,39,5328
"26165380200",3647,858,30,9,67,71,31,2,4715
"26165380300",2092,569,0,13,38,20,39,6,2777
"26165380400",3625,533,0,24,47,14,27,33,4303
"26165380500",5317,1113,0,0,74,37,49,26,6616
"26165380600",2401,749,0,3,96,134,0,26,3409
"26165380700",1860,529,0,0,29,60,0,53,2531
"26165380800",2610,343,0,11,172,0,15,13,3164
"27001770100",2014,147,12,2,85,20,11,0,2291
"27001770200",1724,211,1,2,64,9,13,14,2038
"27001770300",2769,530,15,1,27,15,8,2,3367
"27001770400",2240,396,8,0,217,108,92,1,3062
"27001790501",1636,211,5,0,29,8,4,1,1894
"27001790502",2973,202,7,1,36,7,9,0,3235
"27003050107",2403,410,14,6,41,0,20,0,2894
"27003050108",4058,423,7,0,229,68,39,0,4824
"27003050109",4751,212,0,0,62,20,0,12,5057
"27003050110",2447,290,0,0,41,0,27,0,2805
"27003050111",3544,112,0,0,81,1,9,9,3756
"27003050114",2608,58,42,0,34,0,8,1,2751
"27003050115",4451,123,68,2,750,9,601,16,6020
"27003050116",3847,374,18,1,96,118,59,214,4727
"27003050208",2948,135,3,0,179,0,24,0,3289
"27003050210",3731,177,0,0,12,20,12,0,3952
"27003050215",3681,95,31,0,298,0,64,0,4169
"27003050216",5415,158,0,1,192,20,211,0,5997
"27003050217",2553,88,0,0,221,0,52,8,2922
"27003050218",3053,81,0,0,63,0,0,0,3197
"27003050219",2658,143,0,0,129,34,43,35,3042
"27003050220",5853,250,166,0,341,20,157,31,6818
"27003050221",6205,279,58,0,219,52,45,0,6858
"27003050222",4820,102,132,15,424,0,239,0,5732
"27003050223",2571,110,0,0,98,0,7,21,2807
"27003050224",2587,132,0,0,113,0,0,0,2832
"27003050225",5625,92,160,0,328,69,76,0,6350
"27003050226",2538,117,16,0,233,32,48,0,2984
"27003050227",3797,182,54,0,361,0,63,0,4457
"27003050228",4150,86,265,0,579,10,244,21,5355
"27003050229",3570,193,8,0,282,80,162,9,4304
"27003050230",2181,12,0,0,195,3,152,0,2543
"27003050232",3550,49,0,0,211,11,25,11,3857
"27003050233",2946,1,0,0,69,0,0,0,3016
"27003050234",2527,197,45,0,86,0,158,1,3014
"27003050235",2428,213,0,0,114,37,58,29,2879
"27003050236",3972,105,0,0,169,72,30,72,4420
"27003050237",4698,379,6,44,161,62,0,41,5391
"27003050401",2141,293,129,25,106,23,112,0,2829
"27003050402",2815,394,179,10,138,23,25,3,3587
"27003050501",2285,312,0,145,181,23,122,0,3068
"27003050504",2129,100,65,0,110,49,81,52,2586
"27003050505",3666,518,298,167,194,50,233,5,5131
"27003050602",1776,309,318,20,157,23,71,62,2736
"27003050605",4183,347,93,94,369,95,388,27,5596
"27003050606",1402,189,83,149,103,91,20,12,2049
"27003050607",3495,652,58,115,336,201,159,68,5084
"27003050608",3255,274,254,55,536,70,335,9,4788
"27003050609",3006,100,6,29,102,0,28,0,3271
"27003050610",5751,140,214,0,484,80,253,80,7002
"27003050702",2639,107,94,15,163,5,68,0,3091
"27003050704",4118,230,129,27,290,62,172,0,5028
"27003050706",2429,436,218,85,366,175,125,43,3877
"27003050707",5109,408,263,0,466,0,14,0,6260
"27003050709",1905,101,78,0,212,9,146,0,2451
"27003050710",2893,255,178,8,167,0,41,8,3550
"27003050711",3813,75,299,118,286,0,86,0,4677
"27003050712",3394,180,63,76,350,90,41,0,4194
"27003050805",5263,236,457,0,420,205,1,65,6647
"27003050806",4992,128,392,0,930,0,140,0,6582
"27003050807",2189,279,195,8,419,41,4,31,3166
"27003050808",1821,118,34,33,115,47,22,0,2190
"27003050809",4700,207,51,1,1096,45,333,0,6433
"27003050810",2948,408,185,22,415,28,101,0,4107
"27003050811",2077,149,5,85,412,0,359,0,3087
"27003050813",5211,221,242,19,875,148,504,4,7224
"27003050816",3839,22,185,38,298,20,48,0,4450
"27003050818",4232,49,32,0,649,0,114,0,5076
"27003050819",2991,37,215,0,598,9,28,0,3878
"27003050820",2777,101,17,31,265,9,20,0,3220
"27003050821",3792,130,83,15,729,115,48,0,4912
"27003050901",1491,297,36,20,120,55,17,0,2036
"27003050902",4141,223,36,0,515,0,66,25,5006
"27003051001",1930,248,203,0,227,141,34,76,2859
"27003051002",2779,174,92,0,419,19,307,31,3821
"27003051101",3633,219,312,47,564,0,33,0,4808
"27003051102",2885,224,287,203,673,154,427,194,5047
"27003051103",2145,97,442,328,427,118,155,100,3812
"27003051201",1892,257,429,439,420,110,230,44,3821
"27003051202",2313,310,144,123,307,29,296,3,3525
"27003051203",3842,325,609,65,435,15,95,15,5401
"27003051206",1147,178,321,34,615,50,77,0,2422
"27003051302",2258,392,123,235,551,131,127,310,4127
"27003051304",1614,217,106,87,279,105,239,113,2760
"27003051305",1252,484,238,103,890,203,386,209,3765
"27003051400",2998,232,755,255,661,18,619,19,5557
"27003051501",1647,103,513,668,342,10,244,8,3535
"27003051502",1891,205,346,136,153,36,102,5,2874
"27003051600",4795,279,0,0,98,0,104,0,5276
"27005450100",2559,270,4,1,51,14,10,4,2913
"27005450200",2007,305,0,3,62,10,15,3,2405
"27005450300",4144,288,7,24,311,102,77,18,4971
"27005450400",2112,91,1,7,126,60,52,0,2449
"27005450500",2672,780,26,32,283,134,106,43,4076
"27005450600",2788,549,0,0,125,5,0,30,3497
"27005450700",2911,194,0,0,163,28,22,0,3318
"27005450800",1892,177,0,2,106,80,9,6,2272
"27005450900",2659,232,0,0,71,25,9,21,3017
"27005940000",1780,185,21,1,1186,765,44,27,4009
"27007450100",4577,643,15,5,452,122,39,43,5896
"27007450200",5467,736,42,47,357,117,10,70,6846
"27007450300",3866,345,4,0,191,57,25,23,4511
"27007450400",2152,398,31,0,130,58,27,31,2827
"27007450500",1292,214,0,0,41,3,6,0,1556
"27007450600",2066,893,62,23,443,106,15,48,3656
"27007450701",3288,550,18,3,676,197,10,0,4742
"27007450702",3436,539,25,0,688,780,89,29,5586
"27007940001",110,45,14,39,3096,2545,52,234,6135
"27007940002",1086,57,0,0,658,306,13,25,2145
"27009020100",4919,564,31,10,98,47,36,20,5725
"27009020202",2530,183,0,0,64,0,32,0,2809
"27009020203",2359,60,23,0,41,13,81,0,2577
"27009020205",3014,81,0,0,12,1,22,0,3130
"27009020206",2011,289,9,0,91,5,63,0,2468
"27009020300",3103,48,0,0,74,0,80,4,3309
"27009021101",6314,1474,133,43,58,85,12,174,8293
"27009021102",3369,478,0,32,78,265,126,3,4351
"27009021200",4207,1245,267,369,96,150,24,32,6390
"27011950100",1362,112,0,0,0,17,13,6,1510
"27011950200",1321,224,0,0,15,6,3,4,1573
"27011950300",1659,292,3,0,25,17,9,19,2024
"27013170100",4079,340,201,69,50,8,56,21,4824
"27013170200",4691,620,60,66,129,4,160,106,5836
"27013170300",2340,542,35,19,30,8,49,0,3023
"27013170400",2962,227,15,0,110,8,73,0,3395
"27013170500",3373,411,167,125,218,169,115,0,4578
"27013170600",1227,339,0,21,99,70,12,38,1806
"27013170700",1683,1040,15,0,79,79,80,94,3070
"27013170800",4145,302,10,43,203,58,34,18,4813
"27013170900",2646,278,2,70,63,34,79,40,3212
"27013171000",3267,133,0,0,44,30,11,20,3505
"27013171101",1844,2061,16,305,205,175,36,71,4713
"27013171202",3388,1875,17,233,356,149,0,107,6125
"27013171300",3303,215,1,0,100,9,105,40,3773
"27013171400",3175,330,7,0,81,10,70,20,3693
"27013171500",2456,146,0,0,43,44,39,19,2747
"27013171600",2524,783,168,90,107,31,128,58,3889
"27015960101",1838,130,12,0,54,0,12,0,2046
"27015960102",1129,71,0,0,20,0,66,0,1286
"27015960200",3654,155,4,0,27,2,13,0,3855
"27015960300",2436,483,0,16,21,0,27,63,3046
"27015960400",3878,247,3,0,9,19,18,9,4183
"27015960500",3066,297,19,1,168,48,473,128,4200
"27015960600",2717,285,15,10,42,17,46,31,3163
"27015960700",3138,259,1,1,23,3,11,1,3437
"27017070100",4331,515,0,0,256,422,26,0,5550
"27017070200",3107,519,70,0,153,34,105,0,3988
"27017070300",4926,82,7,0,134,19,23,0,5191
"27017070400",6344,785,19,56,292,104,111,40,7751
"27017070500",4891,948,24,77,129,150,48,31,6298
"27017070600",2855,349,0,16,39,27,39,19,3344
"27017940000",1284,179,0,9,834,412,32,10,2760
"27019090100",5005,569,37,0,190,12,121,0,5934
"27019090200",3748,94,7,0,119,56,50,30,4104
"27019090301",6432,256,0,0,105,1,231,0,7025
"27019090302",4880,151,69,0,223,10,107,0,5440
"27019090401",4260,138,0,0,101,8,23,43,4573
"27019090402",5295,172,0,0,223,4,83,54,5831
"27019090501",2365,63,0,0,29,0,0,12,2469
"27019090502",2410,132,56,0,509,0,91,113,3311
"27019090503",2476,87,31,0,102,0,33,0,2729
"27019090601",3498,156,0,0,400,0,207,0,4261
"27019090602",2780,36,0,0,108,0,5,0,2929
"27019090701",5544,206,107,23,537,0,0,0,6417
"27019090702",2054,0,10,0,207,0,61,0,2332
"27019090800",7139,288,117,4,567,6,303,106,8530
"27019090900",5299,203,16,0,207,30,237,30,6022
"27019091000",8327,389,289,0,689,152,1278,24,11148
"27019091100",5267,121,194,2,455,0,31,0,6070
"27019091201",4037,166,21,12,123,418,54,381,5212
"27019091202",2516,64,0,4,71,31,62,0,2748
"27021940001",2649,437,0,23,418,482,38,58,4105
"27021940002",727,149,16,0,1171,803,54,60,2980
"27021960100",1493,303,0,17,124,20,30,13,2000
"27021960200",1648,223,0,0,189,309,20,0,2389
"27021960301",842,47,0,0,13,0,3,0,905
"27021960302",1061,83,0,0,36,0,6,0,1186
"27021960600",2412,439,27,2,84,59,6,6,3035
"27021960700",3174,566,3,1,43,8,8,0,3803
"27021960801",3337,239,0,0,43,7,24,0,3650
"27021960802",3654,562,4,0,124,2,63,12,4421
"27023950300",1582,137,3,0,174,28,77,0,2001
"27023950400",1861,220,0,0,20,5,57,10,2173
"27023950500",1917,128,30,0,152,74,62,42,2405
"27023950600",4836,636,0,43,94,68,323,76,6076
"27025110100",3350,238,15,6,108,11,40,5,3773
"27025110200",5296,514,35,19,176,10,34,0,6084
"27025110301",3335,369,0,0,178,0,104,0,3986
"27025110302",5497,232,97,5,214,24,149,22,6240
"27025110401",8188,366,0,6,445,39,160,0,9204
"27025110402",4095,287,0,0,119,7,20,4,4532
"27025110501",3566,244,0,2,154,0,38,0,4004
"27025110502",5758,463,0,35,30,0,145,24,6455
"27025110600",4608,177,43,0,21,17,73,2,4941
"27025110700",3535,284,6,0,64,13,30,0,3932
"27027020100",4146,405,70,19,253,0,265,78,5236
"27027020202",1812,147,14,47,194,72,244,23,2553
"27027020300",1702,659,0,6,123,305,94,120,3009
"27027020400",1113,700,63,42,155,101,47,179,2400
"27027020500",4479,482,11,66,230,10,76,0,5354
"27027020600",3483,427,29,34,98,50,81,18,4220
"27027030102",4377,708,11,74,87,180,133,31,5601
"27027030103",5844,760,159,28,396,383,427,37,8034
"27027030104",6692,672,19,0,209,103,80,127,7902
"27027030106",1829,189,98,0,38,1,23,5,2183
"27027030107",1561,60,0,0,10,0,12,3,1646
"27027030201",5029,305,22,0,125,23,32,15,5551
"27027030202",4317,166,24,0,145,0,50,0,4702
"27029000100",1931,385,15,2,162,99,7,19,2620
"27029000200",1866,232,0,0,375,313,55,17,2858
"27029000300",2689,383,0,0,131,28,33,0,3264
"27031480100",2578,241,47,0,458,87,71,1,3483
"27031480200",1568,106,0,0,52,12,11,0,1749
"27031990000",0,0,0,0,0,0,0,0,0
"27033270100",2393,255,0,0,281,51,213,9,3202
"27033270200",2082,231,0,7,25,1,83,19,2448
"27033270300",2704,201,0,0,28,365,4,326,3628
"27033270400",1895,592,37,20,71,123,41,101,2880
"27035950100",1805,103,0,0,29,13,5,13,1968
"27035950204",1560,69,1,0,22,0,0,1,1653
"27035950400",4643,538,35,21,51,6,49,12,5355
"27035950501",2755,80,0,0,99,0,0,0,2934
"27035950502",2187,130,3,0,32,0,30,0,2382
"27035950700",4589,1028,5,28,211,58,83,31,6033
"27035950800",4036,435,20,11,72,35,22,10,4641
"27035950900",4966,189,0,0,191,12,0,0,5358
"27035951000",3456,500,44,0,50,47,26,0,4123
"27035951100",2968,1244,22,95,51,82,94,46,4602
"27035951200",1888,432,48,68,8,26,27,58,2555
"27035951301",4229,298,0,0,40,0,0,0,4567
"27035951302",4953,899,13,0,23,89,0,119,6096
"27035951400",4690,364,0,0,129,8,47,3,5241
"27035951600",2231,209,0,0,117,19,19,4,2599
"27035951700",2470,191,0,0,15,3,5,0,2684
"27037060101",2700,135,305,8,581,99,671,78,4577
"27037060102",2293,103,37,9,206,0,320,9,2977
"27037060103",2246,44,9,0,214,0,164,0,2677
"27037060104",3486,492,408,21,761,356,369,403,6296
"27037060105",3014,527,218,351,579,217,1208,287,6401
"27037060201",2251,98,32,22,381,2,374,0,3160
"27037060202",2757,344,188,69,139,22,88,47,3654
"27037060301",2970,445,90,188,399,158,591,185,5026
"27037060302",2689,604,7,0,372,60,301,228,4261
"27037060401",2046,58,48,14,277,106,222,95,2866
"27037060402",2304,240,130,156,418,0,304,0,3552
"27037060502",3396,344,88,0,438,72,531,250,5119
"27037060503",3796,351,212,17,423,104,462,81,5446
"27037060505",3352,592,453,83,557,449,372,368,6226
"27037060506",4574,207,203,55,676,26,546,15,6302
"27037060507",2770,265,47,66,240,22,141,24,3575
"27037060508",5158,101,33,0,349,73,249,0,5963
"27037060509",4161,77,173,0,456,266,326,199,5658
"27037060603",3957,93,52,1,247,1,300,0,4651
"27037060604",3226,84,0,0,107,9,49,10,3485
"27037060605",1329,48,77,0,109,0,34,0,1597
"27037060606",2352,122,21,0,235,21,251,21,3023
"27037060709",4010,124,653,25,1036,10,524,0,6382
"27037060710",2524,242,136,229,378,93,271,156,4029
"27037060711",2738,247,460,475,195,85,186,65,4451
"27037060713",2566,62,138,59,270,12,241,0,3348
"27037060714",3484,236,205,13,627,2,339,0,4906
"27037060716",2777,353,6,61,627,91,178,84,4177
"27037060717",1648,108,8,16,400,0,109,0,2289
"27037060721",1929,109,99,50,463,21,189,9,2869
"27037060725",2604,149,342,69,392,168,275,109,4108
"27037060726",1665,203,312,25,451,33,184,0,2873
"27037060727",1922,173,111,33,655,64,50,8,3016
"27037060728",3507,147,230,34,633,98,156,99,4904
"27037060729",3412,36,93,0,469,11,89,0,4110
"27037060730",5579,118,83,0,366,193,83,177,6599
"27037060731",4196,185,40,0,202,19,77,0,4719
"27037060732",4725,79,198,120,406,54,74,0,5656
"27037060733",3192,178,72,163,358,13,57,0,4033
"27037060734",3650,81,34,0,545,0,129,0,4439
"27037060735",3469,151,395,121,634,134,323,22,5249
"27037060737",3080,221,459,146,771,151,239,114,5181
"27037060738",2167,96,175,0,602,186,348,199,3773
"27037060739",3542,450,300,108,1058,99,966,45,6568
"27037060741",4870,464,451,148,527,343,308,91,7202
"27037060742",3214,116,162,0,146,0,106,0,3744
"27037060743",793,121,193,109,187,37,44,0,1484
"27037060744",1160,15,164,0,198,0,127,0,1664
"27037060745",2516,272,298,569,385,292,118,328,4778
"27037060746",2780,393,51,198,69,61,82,309,3943
"27037060747",2426,133,783,259,302,0,118,0,4021
"27037060748",2395,56,431,106,411,0,142,0,3541
"27037060749",1161,26,59,0,229,29,174,6,1684
"27037060750",2478,216,467,151,233,219,31,219,4014
"27037060805",1851,512,208,30,267,432,406,451,4157
"27037060806",4936,98,96,0,291,35,139,0,5595
"27037060811",4098,154,294,174,371,143,0,0,5234
"27037060812",4687,61,390,438,374,28,215,0,6193
"27037060813",3812,201,23,13,509,199,314,170,5241
"27037060814",5374,141,59,0,387,246,242,17,6466
"27037060815",4088,191,48,0,346,59,70,0,4802
"27037060816",5329,89,80,16,302,0,156,0,5972
"27037060817",6495,180,213,327,550,64,267,9,8105
"27037060818",6119,422,52,0,718,279,106,154,7850
"27037060819",5794,515,28,10,464,0,70,113,6994
"27037060820",7350,105,0,0,220,0,120,0,7795
"27037060821",5219,317,204,0,316,186,260,31,6533
"27037060822",1144,10,38,12,16,14,0,0,1234
"27037060823",3412,14,89,0,471,0,0,0,3986
"27037060824",2965,238,147,111,294,0,28,0,3783
"27037060825",6038,95,58,82,546,56,112,0,6987
"27037060826",5444,266,266,123,742,28,241,51,7161
"27037060828",2723,92,229,0,698,82,164,73,4061
"27037060829",2693,42,98,14,226,14,222,11,3320
"27037060902",4415,64,194,0,71,3,19,0,4766
"27037060904",2793,379,13,12,190,34,27,84,3532
"27037060905",4384,147,64,59,437,0,112,0,5203
"27037060906",3159,10,82,9,269,27,96,10,3662
"27037060907",6498,4,16,2,514,17,364,0,7415
"27037061001",3093,130,2,0,105,18,10,0,3358
"27037061003",1040,111,4,1,12,9,44,0,1221
"27037061004",5559,95,242,0,385,22,152,0,6455
"27037061005",1950,229,34,0,205,20,166,11,2615
"27037061007",3889,143,447,0,194,0,38,81,4792
"27037061008",1482,476,315,49,193,19,463,0,2997
"27037061009",4311,68,138,0,747,18,31,0,5313
"27037061102",4171,338,76,30,199,10,180,24,5028
"27037061105",2076,205,17,1,34,69,43,57,2502
"27037061106",2604,222,0,26,75,0,41,14,2982
"27037061107",5371,433,0,0,312,0,345,0,6461
"27037061108",5390,333,23,11,255,5,126,6,6149
"27037061401",2866,129,6,4,100,0,16,0,3121
"27037061402",3341,265,0,0,110,47,50,36,3849
"27037061501",2329,72,0,0,23,0,11,0,2435
"27037061502",2619,87,16,0,54,2,6,0,2784
"27039950100",4338,163,12,1,83,0,83,17,4697
"27039950200",3378,467,0,10,189,18,331,134,4527
"27039950300",1957,313,15,0,117,18,143,91,2654
"27039950400",3148,151,16,47,10,26,49,0,3447
"27039950500",5464,118,5,0,45,17,109,0,5758
"27041450100",2786,275,1,1,16,0,24,18,3121
"27041450200",3321,297,0,0,76,2,56,8,3760
"27041450500",4140,197,16,3,66,4,26,22,4474
"27041450600",5072,795,18,20,106,0,0,0,6011
"27041450701",3672,869,66,0,89,57,34,41,4828
"27041450702",2432,210,0,4,28,23,0,0,2697
"27041450800",2913,483,22,5,69,13,58,42,3605
"27041450900",3157,128,0,0,26,1,38,0,3350
"27041451000",4019,165,8,9,23,3,34,4,4265
"27043460100",1702,129,0,0,30,0,22,4,1887
"27043460200",1860,251,0,0,26,1,153,4,2295
"27043460300",1672,187,2,2,21,4,40,9,1937
"27043460400",2468,553,19,0,101,0,66,169,3376
"27043460500",1966,282,2,0,15,27,60,28,2380
"27043460600",2171,409,0,0,40,0,184,100,2904
"27045960100",3135,315,3,22,32,6,25,5,3543
"27045960200",3829,377,10,0,61,26,49,79,4431
"27045960300",3085,397,3,0,48,10,8,0,3551
"27045960400",2595,339,9,0,13,7,5,3,2971
"27045960500",2537,467,3,5,16,0,23,0,3051
"27045960600",2655,337,11,0,37,19,25,0,3084
"27047180100",2661,141,6,0,85,6,155,18,3072
"27047180200",2281,162,1,2,36,2,25,2,2511
"27047180300",3070,234,0,0,47,15,98,14,3478
"27047180400",2849,141,33,0,34,21,135,21,3234
"27047180500",3434,384,1,0,82,17,172,54,4144
"27047180600",3058,720,15,58,170,47,718,313,5099
"27047180700",2191,189,3,0,55,55,52,4,2549
"27047180800",1972,262,46,78,24,75,209,73,2739
"27047180900",2459,652,0,18,264,91,415,208,4107
"27047181000",2099,142,0,0,71,2,113,0,2427
"27049080101",3260,500,0,35,76,22,19,0,3912
"27049080102",5098,369,0,11,153,2,145,0,5778
"27049080200",5497,756,9,129,391,237,375,54,7448
"27049080300",3482,237,0,1,48,50,25,6,3849
"27049080400",3647,196,10,0,91,3,121,38,4106
"27049080500",3161,147,23,0,65,19,44,15,3474
"27049080600",3875,391,25,46,60,88,27,64,4576
"27049080700",3041,341,7,10,95,13,191,119,3817
"27049080800",3479,412,35,0,105,16,31,14,4092
"27049080900",4813,582,5,75,102,50,90,14,5731
"27051070100",2857,202,0,6,43,5,35,8,3156
"27051070200",2362,338,0,0,49,34,38,24,2845
"27053000101",1516,124,423,166,825,92,240,30,3416
"27053000102",1918,179,680,523,1257,177,133,0,4867
"27053000300",2202,65,368,250,342,35,97,10,3369
"27053000601",3611,404,34,107,547,194,324,143,5364
"27053000603",2436,145,0,0,149,16,56,0,2802
"27053001100",1547,161,35,3,387,55,399,38,2625
"27053001700",1356,270,216,275,202,0,223,85,2627
"27053002200",150,27,295,200,287,451,104,67,1581
"27053002400",1477,299,114,187,245,47,75,88,2532
"27053002700",452,125,958,635,437,61,156,71,2895
"27053003200",465,16,618,415,134,62,172,0,1882
"27053003300",118,4,707,559,607,516,41,20,2572
"27053003800",1673,1619,133,55,207,223,8,63,3981
"27053005901",864,335,547,922,114,134,24,61,3001
"27053005902",721,679,306,841,127,247,335,569,3825
"27053006800",2545,783,370,121,251,88,431,14,4603
"27053007700",1595,189,299,754,285,222,209,114,3667
"27053007801",408,165,304,248,274,255,265,190,2109
"27053008100",3002,307,24,51,145,28,51,10,3618
"27053008200",1933,510,233,717,626,178,1018,85,5300
"27053008300",673,214,307,293,538,249,543,162,2979
"27053008400",1040,159,456,205,511,196,897,146,3610
"27053008500",2010,992,223,143,929,132,1253,635,6317
"27053009500",1492,562,463,208,361,66,591,521,4264
"27053009600",2348,356,341,367,243,35,389,296,4375
"27053010600",2607,57,145,0,143,0,75,0,3027
"27053010700",2107,64,0,7,115,17,64,0,2374
"27053011000",3071,193,107,151,88,39,127,106,3882
"27053011703",3442,137,146,0,223,41,112,17,4118
"27053011704",2862,189,117,0,216,22,277,16,3699
"27053011800",3882,221,207,11,234,0,587,14,5156
"27053011998",3357,127,203,0,387,61,208,0,4343
"27053012001",4675,373,110,3,303,28,262,8,5762
"27053012003",3373,328,551,174,630,299,722,87,6164
"27053012101",1561,261,68,481,579,172,591,183,3896
"27053012102",1984,135,279,62,312,33,181,0,2986
"27053020101",2705,50,64,3,328,0,47,0,3197
"27053020102",1813,90,48,0,187,35,34,0,2207
"27053020200",2554,299,2629,901,1506,192,581,205,8867
"27053020301",1182,515,299,196,384,98,114,277,3065
"27053020302",723,128,575,394,389,79,22,0,2310
"27053020303",1792,47,523,209,948,245,341,0,4105
"27053020304",1175,261,628,292,726,103,32,181,3398
"27053020400",1858,553,923,569,305,116,38,140,4502
"27053020500",1932,247,480,235,1030,74,636,30,4664
"27053020600",1287,153,58,59,304,132,112,10,2115
"27053020700",3074,241,186,135,350,54,194,28,4262
"27053020801",1371,107,119,164,188,37,153,7,2146
"27053020804",1555,384,469,96,276,55,124,166,3125
"27053020902",1889,78,27,0,135,34,100,0,2263
"27053020903",2619,97,357,21,255,39,481,7,3876
"27053021001",4312,317,489,174,415,0,159,18,5884
"27053021002",1473,93,38,84,105,34,100,0,1927
"27053021100",1283,176,131,100,115,15,35,13,1868
"27053021200",3744,145,409,87,278,62,221,0,4946
"27053021300",2952,392,579,316,183,28,108,9,4567
"27053021400",2391,96,234,175,147,36,44,17,3140
"27053021501",2544,166,701,168,284,14,108,26,4011
"27053021502",1633,388,809,109,213,239,379,264,4034
"27053021503",3511,280,600,72,384,71,660,185,5763
"27053021504",2485,137,387,257,164,54,66,0,3550
"27053021505",3116,227,476,214,312,191,48,14,4598
"27053021601",2963,111,326,95,431,78,124,0,4128
"27053021602",4141,356,425,308,134,324,67,0,5755
"27053021700",3987,480,237,4,476,73,109,0,5366
"27053021800",1624,68,117,9,220,0,19,0,2057
"27053021900",2842,67,45,12,288,26,141,0,3421
"27053022000",1250,121,33,15,149,0,54,0,1622
"27053022101",1749,101,182,56,455,52,124,20,2739
"27053022102",1939,239,106,98,218,0,172,0,2772
"27053022200",3836,142,33,0,397,24,136,0,4568
"27053022301",1816,40,72,2,152,3,63,0,2148
"27053022302",1721,121,305,303,141,76,51,22,2740
"27053022400",2644,147,0,435,599,54,202,7,4088
"27053022700",3091,138,385,25,592,97,634,0,4962
"27053022801",1955,47,28,0,74,0,38,0,2142
"27053022802",2301,297,69,22,313,16,56,9,3083
"27053022901",4088,262,94,7,169,114,160,0,4894
"27053022902",1639,31,35,4,0,0,65,6,1780
"27053023000",3408,85,369,73,383,15,137,0,4470
"27053023100",1602,19,9,0,130,0,70,0,1830
"27053023200",2612,321,543,505,1570,54,212,132,5949
"27053023300",3714,295,921,28,695,170,671,127,6621
"27053023400",3310,488,594,539,809,436,668,273,7117
"27053023501",3090,120,41,3,297,60,144,0,3755
"27053023502",4760,157,124,63,216,29,45,28,5422
"27053023600",3699,170,0,0,166,0,41,12,4088
"27053023700",3949,174,46,76,263,2,60,0,4570
"27053023801",4583,163,25,12,303,0,133,30,5249
"27053023802",2526,168,12,0,217,0,116,0,3039
"27053023901",3393,34,7,0,226,0,80,0,3740
"27053023902",1770,40,131,0,136,8,16,0,2101
"27053023903",2416,87,150,82,483,39,61,0,3318
"27053024003",3176,40,9,23,1565,38,605,38,5494
"27053024004",3063,185,64,10,629,0,15,0,3966
"27053024005",1336,111,92,40,249,33,35,0,1896
"27053024006",1504,53,12,0,254,12,23,1,1859
"27053024100",2454,109,191,158,512,11,433,11,3879
"27053024200",2765,73,69,0,141,23,148,0,3219
"27053024300",2424,586,677,25,841,73,728,312,5666
"27053024400",2454,200,584,73,388,20,349,0,4068
"27053024500",1633,37,104,14,304,227,141,170,2630
"27053024600",2428,247,89,163,551,186,209,109,3982
"27053024700",2078,307,166,201,402,87,325,112,3678
"27053024801",1647,86,179,27,232,27,349,27,2574
"27053024802",1855,385,147,41,566,183,1050,405,4632
"27053024901",830,20,10,7,49,3,155,5,1079
"27053024902",1363,385,157,115,319,404,392,550,3685
"27053024903",1164,138,408,66,455,90,635,78,3034
"27053025100",1335,141,582,278,373,73,262,98,3142
"27053025201",2891,327,665,244,827,252,762,380,6348
"27053025205",3752,267,63,27,873,242,538,282,6044
"27053025301",2489,55,91,0,227,10,141,0,3013
"27053025302",2929,278,274,248,508,133,316,32,4718
"27053025401",2385,186,590,63,590,125,480,10,4429
"27053025403",2522,333,362,162,368,15,200,70,4032
"27053025601",1442,231,81,16,498,36,115,0,2419
"27053025603",3223,368,151,18,185,36,154,165,4300
"27053025605",2880,141,209,27,292,0,54,0,3603
"27053025701",5162,352,351,3,844,27,336,0,7075
"27053025702",3107,303,235,110,642,41,389,28,4855
"27053025801",2231,290,138,22,269,47,105,198,3300
"27053025802",2083,42,12,7,190,1,8,6,2349
"27053025803",2226,212,98,15,292,101,28,44,3016
"27053025805",2342,86,147,0,114,34,61,0,2784
"27053025903",5120,307,182,76,492,116,152,70,6515
"27053025905",2974,81,66,0,403,0,35,0,3559
"27053025906",4940,241,230,35,662,18,316,18,6460
"27053025907",3963,29,40,1,426,0,152,0,4611
"27053026005",2879,159,196,72,315,105,90,18,3834
"27053026006",2392,193,84,118,232,1,163,0,3183
"27053026007",3364,263,462,62,356,98,105,0,4710
"27053026013",4129,60,153,1,239,1,10,0,4593
"27053026014",4532,141,89,0,269,80,78,1,5190
"27053026015",4546,238,0,165,494,14,242,0,5699
"27053026016",5616,256,207,89,621,89,244,52,7174
"27053026018",5513,184,50,0,1294,0,234,0,7275
"27053026019",2578,155,130,142,2709,48,457,0,6219
"27053026020",3039,43,884,165,288,33,0,0,4452
"27053026021",3382,148,184,0,640,6,96,0,4456
"27053026022",5623,56,149,0,1134,30,160,0,7152
"27053026101",2693,93,27,22,116,139,29,0,3119
"27053026103",2649,75,0,0,109,0,85,0,2918
"27053026104",2718,31,824,210,385,0,88,0,4256
"27053026201",2955,15,54,0,173,9,88,0,3294
"27053026202",2486,49,9,0,249,11,8,11,2823
"27053026205",2915,111,0,11,163,1,127,9,3337
"27053026206",2772,147,0,0,152,11,0,0,3082
"27053026207",3445,415,77,37,280,127,137,66,4584
"27053026208",2799,73,9,7,194,19,0,0,3101
"27053026301",2853,145,17,0,181,0,63,9,3268
"27053026302",2945,111,25,0,267,25,54,0,3427
"27053026402",4421,282,634,20,560,41,252,37,6247
"27053026403",2569,95,100,8,322,27,57,0,3178
"27053026404",4548,210,36,0,223,3,100,0,5120
"27053026505",3003,180,61,2,232,0,118,1,3597
"27053026507",3610,257,128,180,436,20,156,13,4800
"27053026508",3979,370,166,119,279,18,72,0,5003
"27053026509",3861,55,199,58,233,0,173,0,4579
"27053026510",2859,221,99,0,333,39,60,10,3621
"27053026511",2260,322,349,91,662,38,232,276,4230
"27053026512",4392,369,223,175,442,69,82,47,5799
"27053026514",3672,253,361,1,628,53,92,0,5060
"27053026605",2976,35,55,15,484,0,206,24,3795
"27053026606",4441,108,100,21,219,32,107,26,5054
"27053026609",2611,231,11,0,120,0,0,0,2973
"27053026610",3687,126,106,0,294,34,139,0,4386
"27053026611",3830,90,119,70,306,293,253,0,4961
"27053026612",7171,138,208,115,1617,29,149,0,9427
"27053026613",5396,159,322,0,1333,82,398,0,7690
"27053026702",1991,118,17,21,203,26,22,14,2412
"27053026706",3242,51,6,28,139,3,44,3,3516
"27053026707",4376,77,259,0,226,6,31,0,4975
"27053026708",5068,220,63,54,273,66,85,44,5873
"27053026710",6404,318,386,0,1025,40,167,0,8340
"27053026711",2494,53,22,120,130,1,7,1,2828
"27053026712",2687,106,38,175,104,0,145,0,3255
"27053026713",3805,151,90,90,296,0,83,0,4515
"27053026714",7862,304,376,125,961,28,224,0,9880
"27053026715",10316,1057,432,140,1885,0,536,0,14366
"27053026716",7315,22,25,1,690,38,0,0,8091
"27053026807",3210,358,1014,355,551,4,139,99,5730
"27053026809",1023,392,1786,382,887,472,731,628,6301
"27053026810",2123,316,1719,560,1045,664,641,243,7311
"27053026811",2799,83,987,723,1426,29,427,0,6474
"27053026812",2926,145,912,281,1537,100,107,9,6017
"27053026814",3478,354,1151,205,1256,11,602,183,7240
"27053026815",2830,69,653,10,1419,144,180,0,5305
"27053026816",2748,306,2043,303,883,243,258,51,6835
"27053026818",2273,209,999,614,596,34,404,0,5129
"27053026819",953,491,1548,810,454,408,264,252,5180
"27053026820",7064,177,1726,26,2421,306,374,0,12094
"27053026822",3615,97,383,63,592,0,61,0,4811
"27053026823",2712,81,656,83,950,13,20,0,4515
"27053026903",3469,248,298,2,300,79,90,7,4493
"27053026906",6230,181,653,27,379,0,295,21,7786
"27053026907",5136,77,135,0,287,0,85,7,5727
"27053026908",5476,74,117,1,379,0,99,0,6146
"27053026909",11116,259,235,0,536,1,142,0,12289
"27053026910",4184,327,0,0,251,9,377,21,5169
"27053027001",2954,106,0,0,56,0,10,0,3126
"27053027002",4926,206,16,4,164,17,174,15,5522
"27053027101",5420,171,26,0,134,103,70,91,6015
"27053027102",5124,111,16,0,223,24,224,0,5722
"27053027201",5865,217,102,0,197,68,69,17,6535
"27053027202",1561,128,10,3,56,3,34,0,1795
"27053027203",3187,129,18,34,145,4,21,0,3538
"27053027300",3486,205,95,43,162,0,98,0,4089
"27053027400",3928,86,0,2,126,1,78,0,4221
"27053027501",3901,269,24,0,106,16,98,0,4414
"27053027503",3772,187,23,1,121,12,76,11,4203
"27053027504",3109,98,13,0,75,0,58,0,3353
"27053027601",3275,279,68,21,158,19,187,31,4038
"27053027602",4804,317,0,0,176,60,22,0,5379
"27053027700",7925,554,78,0,427,34,188,34,9240
"27053100200",1611,179,857,348,248,67,186,0,3496
"27053100400",827,201,745,416,481,358,217,62,3307
"27053100500",1310,153,49,300,260,80,93,32,2277
"27053100700",1446,86,541,286,385,0,118,0,2862
"27053100800",922,116,717,716,637,352,0,96,3556
"27053100900",1225,114,1075,1226,539,385,237,56,4857
"27053101200",3380,145,143,88,418,4,395,0,4573
"27053101300",431,77,714,173,231,142,333,46,2147
"27053101600",299,190,530,397,676,277,192,129,2690
"27053101800",1745,472,304,556,975,363,849,258,5522
"27053101900",1827,287,258,93,245,83,91,0,2884
"27053102000",366,241,941,247,376,170,32,162,2535
"27053102100",303,54,687,589,606,286,157,0,2682
"27053102300",229,61,531,177,183,142,20,6,1349
"27053102500",1817,284,70,85,160,92,339,34,2881
"27053102600",728,235,198,76,425,107,223,19,2011
"27053102800",348,123,758,635,368,493,22,18,2765
"27053102900",221,96,282,306,360,144,185,67,1661
"27053103000",996,137,76,23,244,6,122,11,1615
"27053103100",1420,195,232,165,143,65,461,56,2737
"27053103400",226,156,635,1417,94,264,143,300,3235
"27053103600",1779,140,27,15,254,13,83,0,2311
"27053103700",1499,706,52,156,568,153,154,33,3321
"27053103900",258,1135,0,113,187,238,6,72,2009
"27053104000",2730,2065,304,863,1057,345,124,117,7605
"27053104100",1029,397,509,848,293,153,180,269,3678
"27053104400",1018,322,86,219,252,114,27,20,2058
"27053104800",854,557,1581,1636,235,743,78,120,5804
"27053104900",645,2456,116,483,468,946,0,274,5388
"27053105100",2254,75,145,0,230,21,17,0,2742
"27053105201",2039,342,69,83,251,14,42,0,2840
"27053105204",1190,401,125,460,152,66,114,40,2548
"27053105400",1581,170,267,383,273,74,82,34,2864
"27053105500",3046,302,119,0,392,61,70,61,4051
"27053105600",2314,564,169,175,499,108,324,162,4315
"27053105700",1265,423,272,538,76,118,135,35,2862
"27053106000",533,313,387,978,296,659,229,133,3528
"27053106200",908,632,984,790,188,182,26,22,3732
"27053106400",846,119,202,388,100,35,9,0,1699
"27053106500",3790,211,101,0,355,38,124,22,4641
"27053106600",2053,132,10,2,177,34,26,0,2434
"27053106700",3947,564,65,43,245,0,237,40,5141
"27053106900",1110,406,304,72,191,108,312,47,2550
"27053107000",2006,562,193,324,504,188,438,338,4553
"27053107400",929,78,178,46,230,53,210,64,1788
"27053107500",1535,144,36,86,130,9,67,21,2028
"27053107600",2913,194,119,1,541,39,216,29,4052
"27053108000",2975,263,0,13,253,51,94,0,3649
"27053108600",1035,483,313,244,587,181,507,488,3838
"27053108700",2009,247,218,23,778,98,23,59,3455
"27053108800",2165,394,399,213,251,46,122,253,3843
"27053108900",2090,83,28,0,110,0,101,0,2412
"27053109000",1512,61,95,1,52,0,30,0,1751
"27053109100",3812,426,99,0,422,40,114,0,4913
"27053109200",2509,295,31,63,428,0,273,13,3612
"27053109300",2547,226,311,82,616,59,397,36,4274
"27053109400",795,232,622,137,459,128,827,279,3479
"27053109700",1631,201,169,74,362,118,514,184,3253
"27053109800",3575,151,173,154,287,8,74,15,4437
"27053109900",3357,228,59,12,245,0,22,0,3923
"27053110000",598,365,256,333,301,9,501,155,2518
"27053110100",2240,94,216,20,225,0,289,26,3110
"27053110200",2584,190,74,40,493,196,168,114,3859
"27053110400",2085,246,228,17,255,148,48,104,3131
"27053110500",4080,405,82,6,213,2,108,232,5128
"27053110800",3675,219,119,27,464,125,184,16,4829
"27053110900",1937,72,663,210,423,24,282,33,3644
"27053111100",2679,136,82,9,278,9,126,0,3319
"27053111200",2878,18,33,0,111,0,72,0,3112
"27053111300",4000,85,128,195,162,80,120,0,4770
"27053111400",3480,128,66,40,233,0,54,0,4001
"27053111500",3892,160,227,116,387,54,109,0,4945
"27053111600",2792,74,255,26,178,1,62,0,3388
"27053122500",2401,165,250,184,472,80,54,0,3606
"27053122600",1875,18,52,117,123,44,26,0,2255
"27053125500",2495,199,163,382,334,64,83,0,3720
"27053125600",1660,251,32,0,325,256,54,0,2578
"27053125700",655,185,768,759,914,561,138,70,4050
"27053125800",1803,347,704,867,695,365,1331,322,6434
"27053125900",959,467,560,484,989,1116,794,932,6301
"27053126000",1020,386,921,1796,626,362,600,204,5915
"27053126100",2942,496,236,352,959,156,96,21,5258
"27053126200",2893,439,89,291,192,47,56,28,4035
"27053980000",149,89,31,5,25,59,78,135,571
"27055020100",4938,604,0,0,82,0,21,0,5645
"27055020200",3165,218,0,0,82,60,30,12,3567
"27055020300",2165,321,2,15,92,0,4,5,2604
"27055020500",2590,460,0,0,30,61,19,0,3160
"27055020900",3314,345,0,9,30,3,28,5,3734
"27057070100",3765,420,17,4,286,87,66,19,4664
"27057070200",2078,169,8,0,55,3,42,9,2364
"27057070300",1665,279,0,0,124,17,34,0,2119
"27057070400",2193,320,2,0,143,33,76,0,2767
"27057070500",2531,379,0,37,61,13,71,0,3092
"27057070600",2831,572,0,33,82,36,0,0,3554
"27057070700",1922,140,4,7,16,12,23,0,2124
"27059130100",3154,360,0,0,69,0,50,0,3633
"27059130200",2748,461,10,24,96,44,14,0,3397
"27059130301",7634,673,22,69,280,23,106,5,8812
"27059130302",2322,146,6,0,37,9,27,0,2547
"27059130400",3390,184,17,0,149,4,78,0,3822
"27059130501",4590,215,35,8,152,20,54,0,5074
"27059130502",6575,336,0,0,147,54,173,0,7285
"27059130600",3459,83,5,1,106,0,131,0,3785
"27061480100",2207,328,5,0,108,21,48,15,2732
"27061480300",3594,503,0,0,307,150,9,87,4650
"27061480400",3047,242,0,4,186,7,65,2,3553
"27061480500",1996,464,11,0,66,92,0,0,2629
"27061480600",2379,199,3,0,16,9,0,14,2620
"27061480700",4921,232,26,0,145,3,30,0,5357
"27061480801",1882,219,6,0,45,0,12,0,2164
"27061480802",4758,1111,0,0,150,23,0,12,6054
"27061480900",5207,965,50,0,229,34,30,0,6515
"27061481000",4840,634,11,8,238,120,36,52,5939
"27061940000",1543,160,0,3,541,298,46,31,2622
"27063480100",2136,124,0,0,46,8,13,0,2327
"27063480200",1954,150,0,3,71,38,92,75,2383
"27063480300",2107,178,0,0,51,6,47,4,2393
"27063480400",2458,552,0,0,156,59,57,34,3316
"27065480100",2867,366,3,8,132,27,25,9,3437
"27065480200",3010,676,3,4,65,29,28,40,3855
"27065480300",2893,626,0,0,83,0,52,54,3708
"27065480400",4423,585,7,0,77,35,32,13,5172
"27067770900",1916,357,198,52,192,66,565,167,3513
"27067780100",2316,147,0,0,37,3,15,0,2518
"27067780200",2191,137,1,0,8,0,18,5,2360
"27067780300",4017,162,0,0,74,27,21,30,4331
"27067780400",3559,192,0,3,56,0,122,9,3941
"27067780500",3207,535,113,289,259,175,701,191,5470
"27067780600",4500,194,0,9,184,33,257,59,5236
"27067780700",3428,271,0,0,181,48,368,102,4398
"27067780800",1064,575,62,78,157,115,390,220,2661
"27067781000",3049,1144,31,344,420,44,770,513,6315
"27067781100",2280,327,7,1,44,3,29,42,2733
"27067781200",2498,211,10,1,22,18,32,45,2837
"27069090100",2067,309,1,1,19,5,48,6,2456
"27069090200",1798,132,8,1,29,0,24,0,1992
"27071790100",1492,521,0,7,82,45,0,0,2147
"27071790200",4102,749,0,69,137,94,24,0,5175
"27071790300",2905,154,0,0,154,39,0,0,3252
"27071790500",1886,271,0,0,39,88,6,0,2290
"27073180100",1961,162,4,0,99,33,72,0,2331
"27073180200",1698,132,0,0,16,1,5,0,1852
"27073180300",2541,240,25,0,20,6,30,4,2866
"27075370100",4110,405,0,0,81,29,20,24,4669
"27075370300",1797,327,0,0,58,9,18,0,2209
"27075370400",3034,592,0,5,58,63,56,0,3808
"27075990100",0,0,0,0,0,0,0,0,0
"27077460300",1347,107,3,0,99,12,42,0,1610
"27077460400",2106,159,26,0,60,3,0,0,2354
"27079950100",6494,289,0,0,142,8,114,6,7053
"27079950200",3597,397,26,0,315,0,398,113,4846
"27079950300",3696,494,0,63,115,119,73,73,4633
"27079950400",3155,358,0,0,51,9,66,7,3646
"27079950500",3578,342,9,0,168,58,415,156,4726
"27079950600",3507,303,4,58,57,0,34,0,3963
"27081201001",2622,253,1,0,27,3,16,3,2925
"27081201002",2358,286,15,0,81,4,66,7,2817
"27083360100",3297,180,13,21,51,8,80,43,3693
"27083360200",2931,121,29,0,135,93,117,83,3509
"27083360300",4103,599,313,91,119,19,58,19,5321
"27083360400",3205,572,28,26,123,216,40,256,4466
"27083360500",2244,528,69,13,254,362,479,291,4240
"27083360600",2548,208,8,18,35,22,40,8,2887
"27083360700",1316,294,14,0,309,42,0,0,1975
"27085950100",4753,347,34,0,68,4,13,31,5250
"27085950200",3952,125,0,0,66,11,51,8,4213
"27085950300",5065,372,0,5,119,56,177,24,5818
"27085950400",6776,396,0,24,492,45,176,45,7954
"27085950500",2572,190,0,0,61,16,53,11,2903
"27085950600",4036,295,7,0,108,10,291,56,4803
"27085950700",4518,695,16,109,170,86,566,320,6480
"27087940100",1340,219,5,20,791,495,23,61,2954
"27087940300",964,118,0,6,860,587,30,21,2586
"27089080100",2036,152,1,1,66,4,20,5,2285
"27089080200",2097,159,0,0,30,0,20,3,2309
"27089080300",1981,155,2,5,10,3,156,0,2312
"27089080400",2293,215,9,5,55,19,141,18,2755
"27091790100",2660,221,4,6,45,13,36,16,3001
"27091790200",2242,339,3,0,66,15,15,33,2713
"27091790300",2074,156,3,8,18,2,2,0,2263
"27091790400",1732,125,1,2,36,30,39,14,1979
"27091790500",5655,380,0,0,111,5,85,0,6236
"27091790600",3351,828,28,18,38,0,350,158,4771
"27093560100",4488,352,0,0,54,41,76,20,5031
"27093560200",4324,391,0,0,81,0,52,0,4848
"27093560300",3155,475,12,0,121,0,128,11,3902
"27093560400",2536,472,17,14,22,0,80,209,3350
"27093560500",2941,166,6,0,79,22,54,18,3286
"27093560600",2485,397,28,0,43,3,91,16,3063
"27095170400",4632,470,0,0,111,13,48,1,5275
"27095170500",3621,528,3,0,116,5,91,23,4387
"27095170600",2617,119,10,0,70,3,56,0,2875
"27095170700",4469,668,22,0,210,50,55,41,5515
"27095970100",1635,233,32,4,137,53,17,9,2120
"27095970200",1368,291,35,6,719,430,14,16,2879
"27095970300",2196,281,0,0,61,81,14,15,2648
"27097780100",2595,309,0,0,29,0,62,0,2995
"27097780200",3477,412,0,0,42,48,38,42,4059
"27097780300",5343,459,26,5,148,13,57,41,6092
"27097780400",2365,188,16,0,30,19,8,0,2626
"27097780500",4167,448,0,0,107,10,75,10,4817
"27097780600",4196,1030,0,73,161,0,51,0,5511
"27097780700",2039,448,0,0,68,9,0,0,2564
"27097780800",3807,459,3,0,40,8,40,2,4359
"27099000100",1508,193,46,1,72,0,73,16,1909
"27099000200",2318,124,0,15,199,47,101,15,2819
"27099000300",2863,1510,264,85,181,41,233,824,6001
"27099000410",2864,932,55,8,570,0,661,95,5185
"27099000600",2626,178,92,80,150,38,615,52,3831
"27099000800",3090,652,0,1,270,20,290,323,4646
"27099000900",3566,436,100,112,120,46,291,236,4907
"27099001000",3334,325,0,3,40,39,95,77,3913
"27099001200",1645,185,7,23,26,7,27,16,1936
"27099001300",3892,438,7,0,52,8,117,38,4552
"27099001400",2948,160,18,51,59,0,1,6,3243
"27101900100",1848,125,6,0,18,9,21,10,2037
"27101900200",2795,265,10,4,121,27,149,7,3378
"27101900300",2744,414,8,0,52,0,26,49,3293
"27103480100",3147,103,5,0,19,1,21,12,3308
"27103480200",5189,149,17,5,89,13,230,0,5692
"27103480300",3348,725,40,16,98,165,195,187,4774
"27103480400",2614,787,16,135,366,46,152,32,4148
"27103480501",5876,486,185,140,71,43,273,19,7093
"27103480502",2901,126,98,0,32,0,103,0,3260
"27103480600",3059,249,56,38,37,36,52,0,3527
"27105105100",2451,219,4,0,44,47,82,26,2873
"27105105200",2853,268,14,2,60,3,49,9,3258
"27105105300",2094,164,6,0,62,2,80,9,2417
"27105105400",2773,466,140,90,942,293,1964,306,6974
"27105105500",1902,626,46,226,535,431,916,739,5421
"27105105600",3364,348,219,104,292,159,872,210,5568
"27107960100",2117,265,19,0,131,49,36,23,2640
"27107960200",1554,174,2,0,100,25,100,5,1960
"27107960300",1736,287,3,5,48,51,61,77,2268
"27109000100",712,180,18,132,122,63,12,9,1248
"27109000200",3178,571,114,187,693,16,352,156,5267
"27109000300",2180,278,199,95,151,50,131,108,3192
"27109000400",2467,269,51,13,312,17,115,0,3244
"27109000500",1690,498,139,96,297,73,71,270,3134
"27109000600",3107,453,228,216,409,15,606,0,5034
"27109000901",4261,309,677,287,359,23,770,93,6779
"27109000902",2403,203,51,311,347,0,140,0,3455
"27109000903",2889,78,64,0,65,18,52,0,3166
"27109001000",3805,231,103,138,448,53,214,10,5002
"27109001100",2682,171,0,65,175,0,131,58,3282
"27109001201",4002,146,93,13,477,20,262,20,5033
"27109001202",3083,120,117,0,292,0,92,0,3704
"27109001203",4360,65,68,0,543,0,133,0,5169
"27109001301",3464,209,97,30,699,111,214,0,4824
"27109001302",3900,148,23,0,403,17,116,0,4607
"27109001401",3085,431,202,226,149,131,0,0,4224
"27109001402",9382,358,470,0,1587,103,372,189,12461
"27109001501",2363,216,131,41,297,0,0,13,3061
"27109001502",1976,94,46,0,95,0,133,0,2344
"27109001503",2095,126,0,0,63,0,71,0,2355
"27109001601",3122,207,260,190,352,0,94,0,4225
"27109001602",2832,50,121,0,110,0,161,0,3274
"27109001603",3156,78,14,0,399,18,41,0,3706
"27109001701",2279,538,317,99,989,61,67,22,4372
"27109001702",2767,393,444,559,691,104,234,0,5192
"27109001703",4259,273,78,0,426,0,157,0,5193
"27109001800",4608,226,8,0,86,11,0,0,4939
"27109001900",6392,361,43,10,179,43,95,33,7156
"27109002000",6200,437,8,6,131,0,106,3,6891
"27109002100",5192,685,19,0,47,152,173,63,6331
"27109002200",3679,119,83,0,62,0,14,0,3957
"27109002300",4557,269,31,0,413,47,128,0,5445
"27111960102",2408,116,4,0,27,0,27,0,2582
"27111960103",1961,109,8,0,48,0,9,0,2135
"27111960300",2070,392,32,275,250,84,335,163,3601
"27111960400",1915,174,7,1,12,28,16,10,2163
"27111960500",4096,558,15,4,280,21,413,7,5394
"27111960600",3892,408,28,3,65,7,59,9,4471
"27111960700",2176,211,0,0,41,0,41,4,2473
"27111960800",2772,144,8,0,87,18,15,0,3044
"27111960900",4372,928,4,53,13,49,131,12,5562
"27111961000",3906,336,0,0,97,34,128,23,4524
"27111961100",3830,530,21,28,13,0,64,3,4489
"27111961200",2132,120,12,2,96,28,7,0,2397
"27111961300",3301,486,18,2,48,3,29,1,3888
"27111961400",1995,246,2,0,25,49,9,5,2331
"27111961500",2692,387,8,0,44,0,9,3,3143
"27111961600",1942,205,0,0,59,6,43,8,2263
"27111961700",3137,154,11,9,52,3,44,1,3411
"27113090100",2159,217,12,3,53,14,115,19,2592
"27113090200",1909,288,117,0,155,125,0,0,2594
"27113090300",1870,100,3,0,12,0,5,2,1992
"27113090400",2570,241,0,0,85,16,207,17,3136
"27113090500",3415,158,14,60,146,13,49,16,3871
"27115950100",1950,314,7,0,61,19,20,2,2373
"27115950200",2264,325,1,1,35,1,2,5,2634
"27115950300",2299,359,7,22,39,20,5,8,2759
"27115950400",2827,535,67,8,327,98,94,49,4005
"27115950500",3751,650,24,0,301,215,79,7,5027
"27115950600",3629,513,18,33,163,11,12,8,4387
"27115950700",2702,642,0,2,48,55,0,33,3482
"27115950800",2767,373,22,2,86,0,7,50,3307
"27117460100",1375,102,0,0,24,8,48,18,1575
"27117460200",1494,209,3,76,175,69,9,80,2115
"27117460300",1689,213,6,0,37,135,53,130,2263
"27117460400",1551,115,2,0,14,3,11,0,1696
"27117460500",1714,141,0,0,19,7,53,1,1935
"27119020100",3784,483,194,0,231,94,190,57,5033
"27119020200",896,194,12,11,50,42,25,36,1266
"27119020300",2672,100,0,0,32,0,50,0,2854
"27119020400",1985,76,0,0,57,4,66,0,2188
"27119020500",2474,248,8,11,66,14,69,52,2942
"27119020600",3600,873,0,0,361,148,361,62,5405
"27119020700",1562,275,0,11,286,28,371,141,2674
"27119020800",2008,226,2,0,101,11,81,41,2470
"27119020900",3044,479,0,15,87,34,54,30,3743
"27119021000",2800,523,9,4,130,53,45,21,3585
"27121970100",2158,171,0,2,41,16,20,20,2428
"27121970200",2417,217,3,0,36,5,51,8,2737
"27121970300",2188,183,3,0,38,3,8,0,2423
"27121970400",2742,436,41,0,24,0,2,2,3247
"27123030100",2933,339,96,28,519,114,164,0,4193
"27123030201",4215,267,151,145,163,99,150,17,5207
"27123030202",1296,424,199,13,120,59,75,76,2262
"27123030300",4641,207,64,35,259,117,197,0,5520
"27123030400",2637,605,701,375,1617,486,419,295,7135
"27123030500",763,261,655,718,1149,1919,495,82,6042
"27123030601",1379,175,571,417,2362,1152,830,309,7195
"27123030602",2645,127,121,53,840,209,189,0,4184
"27123030702",3081,210,119,330,927,285,158,13,5123
"27123030703",1850,279,301,30,837,445,193,101,4036
"27123030704",1764,194,444,154,1253,445,574,258,5086
"27123030800",1891,373,541,273,1239,668,406,15,5406
"27123030900",1311,231,117,351,895,763,335,113,4116
"27123031000",1437,616,87,205,1150,833,319,491,5138
"27123031100",1916,352,204,127,1013,134,57,0,3803
"27123031200",1968,375,278,269,190,54,247,34,3415
"27123031300",617,182,101,550,438,416,99,50,2453
"27123031400",750,203,239,520,558,640,300,88,3298
"27123031500",561,363,260,228,641,334,175,93,2655
"27123031600",1231,528,262,406,1298,819,506,64,5114
"27123031701",863,214,285,239,638,479,265,30,3013
"27123031702",1595,912,542,891,1912,1135,630,893,8510
"27123031801",1695,409,630,382,1029,516,429,267,5357
"27123031802",2123,230,214,248,712,96,439,10,4072
"27123031900",1158,432,272,67,174,204,16,6,2329
"27123032000",1901,405,346,242,172,117,140,0,3323
"27123032100",1399,203,352,90,187,124,122,69,2546
"27123032200",1803,447,231,22,73,0,26,4,2606
"27123032300",2362,260,190,123,258,125,150,166,3634
"27123032400",787,26,710,522,557,205,130,30,2967
"27123032500",836,123,462,391,1381,1252,223,32,4700
"27123032600",635,209,527,302,1187,520,271,152,3803
"27123032700",315,78,540,328,773,533,176,96,2839
"27123033000",448,243,149,139,226,349,250,110,1914
"27123033100",475,207,126,161,286,233,216,74,1778
"27123033200",1490,206,391,91,334,87,107,28,2734
"27123033300",2305,508,52,117,182,22,195,54,3435
"27123033400",754,347,508,631,223,111,171,74,2819
"27123033500",366,255,1397,669,586,260,246,0,3779
"27123033600",18,19,387,750,119,192,6,35,1526
"27123033700",104,118,224,312,145,376,14,64,1357
"27123033800",786,87,391,544,189,15,78,101,2191
"27123033900",686,38,282,366,100,93,53,11,1629
"27123034000",1164,92,109,83,41,68,8,30,1595
"27123034201",1171,385,45,55,169,34,0,0,1859
"27123034202",2929,573,449,444,411,104,137,40,5087
"27123034400",933,124,152,218,478,430,62,85,2482
"27123034500",1319,524,449,275,1454,584,170,210,4985
"27123034601",1981,200,367,335,1277,557,513,93,5323
"27123034602",1515,258,204,256,1364,780,515,111,5003
"27123034701",1411,223,677,195,1621,299,276,135,4837
"27123034702",1705,194,377,359,863,144,592,80,4314
"27123034900",1842,682,14,3,146,51,33,27,2798
"27123035000",2274,380,44,13,99,12,112,0,2934
"27123035100",1535,268,49,77,137,144,116,38,2364
"27123035200",2868,186,43,10,129,42,173,35,3486
"27123035300",3317,245,67,16,229,34,399,14,4321
"27123035500",1514,200,83,60,90,45,81,10,2083
"27123035700",2546,86,43,0,72,8,186,0,2941
"27123035800",2272,371,21,38,129,19,86,41,2977
"27123035900",432,129,37,13,67,11,47,6,742
"27123036000",1609,141,288,114,139,74,104,16,2485
"27123036100",378,145,89,205,578,339,312,171,2217
"27123036300",2728,195,5,5,36,114,63,11,3157
"27123036400",3162,152,131,34,286,150,56,0,3971
"27123036500",3256,210,102,0,266,0,85,0,3919
"27123036600",3562,182,204,37,267,343,63,359,5017
"27123036700",3795,196,105,64,340,50,410,0,4960
"27123036800",1688,217,79,34,115,34,51,11,2229
"27123036900",1314,216,169,99,87,53,23,53,2014
"27123037000",2191,115,65,78,169,158,293,91,3160
"27123037100",2425,425,398,460,812,509,983,439,6451
"27123037200",2049,622,1021,393,1172,733,1318,780,8088
"27123037402",2419,154,481,32,734,35,354,42,4251
"27123037403",2644,70,1439,1010,1258,121,437,19,6998
"27123037500",3958,131,408,14,497,47,220,48,5323
"27123037601",2897,163,170,19,259,64,169,11,3752
"27123037602",2444,791,1465,605,212,85,331,261,6194
"27123040100",6421,187,0,4,198,10,74,0,6894
"27123040200",1690,77,0,0,15,0,20,0,1802
"27123040301",1716,117,2,0,95,0,51,32,2013
"27123040302",4387,326,103,0,165,205,100,51,5337
"27123040401",2769,127,150,6,268,1,51,0,3372
"27123040402",4378,225,92,19,709,17,65,0,5505
"27123040502",2335,53,0,35,71,0,44,0,2538
"27123040503",3007,155,10,0,180,8,118,0,3478
"27123040504",3290,193,175,0,586,16,88,7,4355
"27123040601",4679,188,0,5,370,0,111,0,5353
"27123040603",4453,225,197,0,461,13,307,13,5669
"27123040604",5511,498,144,78,1047,143,270,44,7735
"27123040703",5749,212,162,0,736,0,0,20,6879
"27123040704",3858,576,88,77,803,17,228,89,5736
"27123040705",3592,159,94,0,458,14,98,0,4415
"27123040706",4038,69,90,16,507,53,76,28,4877
"27123040707",3968,92,0,0,227,0,55,0,4342
"27123040801",2520,129,0,1,392,18,151,18,3229
"27123040802",0,0,0,0,0,0,0,0,0
"27123040803",3978,284,43,0,222,56,53,0,4636
"27123040901",1765,112,36,41,217,43,29,40,2283
"27123040902",2747,271,252,42,305,424,178,22,4241
"27123041001",2654,308,31,35,145,53,81,119,3426
"27123041002",2659,119,130,39,160,17,225,25,3374
"27123041103",1839,349,415,44,382,24,198,40,3291
"27123041104",2358,120,50,2,306,19,0,0,2855
"27123041105",4300,333,137,22,353,34,106,12,5297
"27123041106",2536,119,391,197,219,12,171,0,3645
"27123041107",3496,670,757,323,625,184,31,29,6115
"27123041200",2606,487,389,63,233,114,153,328,4373
"27123041301",2749,161,181,64,515,87,192,13,3962
"27123041302",2422,68,24,0,458,101,171,2,3246
"27123041400",4230,591,579,13,416,6,178,125,6138
"27123041500",3690,135,247,0,161,89,159,15,4496
"27123041601",4704,186,549,0,559,29,286,0,6313
"27123041602",2158,308,209,30,247,801,202,214,4169
"27123041700",2378,66,57,48,75,76,91,8,2799
"27123041800",2727,488,168,25,219,59,149,177,4012
"27123041900",2746,149,146,34,219,14,110,10,3428
"27123042001",859,67,44,13,523,55,69,0,1630
"27123042002",1365,297,87,255,366,52,40,151,2613
"27123042101",3559,388,442,14,918,145,422,0,5888
"27123042102",2718,396,255,80,793,186,33,26,4487
"27123042201",1061,67,28,19,363,57,179,80,1854
"27123042202",3348,248,397,98,735,589,368,75,5858
"27123042301",2194,149,0,0,429,0,60,0,2832
"27123042302",3091,339,187,0,956,152,340,116,5181
"27123042401",3724,365,740,170,714,285,339,45,6382
"27123042402",3658,226,148,73,1388,94,159,25,5771
"27123042501",3794,286,117,177,477,311,99,86,5347
"27123042503",2560,15,165,0,433,0,91,0,3264
"27123042504",2670,102,524,30,493,20,148,0,3987
"27123042601",3197,273,223,262,391,95,152,0,4593
"27123042602",1476,222,85,92,186,17,88,19,2185
"27123042700",4045,402,77,33,527,271,328,79,5762
"27123042800",378,140,481,443,360,470,86,38,2396
"27123042900",2929,225,411,132,144,1,98,16,3956
"27123043000",5253,204,53,90,379,11,287,0,6277
"27123980000",0,0,0,0,0,0,0,0,0
"27125010100",1568,265,17,0,43,9,11,43,1956
"27125010200",1829,188,7,12,92,3,58,5,2194
"27127750100",2111,202,4,14,328,107,54,41,2861
"27127750200",2732,241,46,0,124,80,0,0,3223
"27127750300",1595,145,12,0,304,31,73,0,2160
"27127750400",2540,173,9,0,57,0,30,0,2809
"27127750500",2105,267,2,0,340,157,45,15,2931
"27127750600",1529,202,0,5,44,30,87,43,1940
"27129790100",2494,241,0,4,113,20,207,0,3079
"27129790200",1601,169,2,0,17,26,16,26,1857
"27129790300",1706,148,6,0,16,0,73,2,1951
"27129790400",2187,243,0,0,212,45,261,36,2984
"27129790500",2631,405,0,71,43,6,202,126,3484
"27129790600",2060,350,18,0,92,63,97,24,2704
"27131070100",5980,630,17,0,58,5,17,45,6752
"27131070200",4836,253,2,0,103,0,74,8,5276
"27131070300",4124,364,17,0,62,35,210,105,4917
"27131070400",3998,237,0,0,72,7,26,14,4354
"27131070501",1922,146,0,0,188,48,176,14,2494
"27131070503",2793,39,0,0,100,1,27,0,2960
"27131070504",2953,580,19,135,57,24,118,0,3886
"27131070601",2258,307,0,0,993,135,973,19,4685
"27131070602",1713,174,4,0,121,1,168,0,2181
"27131070700",3659,912,12,169,110,0,71,188,5121
"27131070800",5661,601,236,326,308,51,248,117,7548
"27131070901",4425,567,0,185,200,65,775,271,6488
"27131070902",2674,488,9,0,169,166,468,366,4340
"27133570100",2144,182,8,0,24,4,11,3,2376
"27133570200",3030,452,0,0,37,0,30,0,3549
"27133570300",2759,523,6,16,95,97,31,145,3672
"27135970100",3258,325,6,16,380,148,0,0,4133
"27135970200",1911,152,4,0,22,38,14,0,2141
"27135970300",3116,398,11,3,122,9,37,11,3707
"27135970400",3095,350,17,0,50,7,35,11,3565
"27135970500",1660,126,18,0,14,0,31,0,1849
"27137000100",3583,333,46,8,54,34,25,0,4083
"27137000200",3832,257,7,17,169,14,31,0,4327
"27137000300",5265,860,13,134,301,49,248,0,6870
"27137000400",2967,973,0,0,259,70,0,0,4269
"27137000500",2463,449,15,25,205,35,33,9,3234
"27137000600",4227,476,106,0,152,2,16,0,4979
"27137000700",2713,68,16,0,76,0,56,0,2929
"27137000900",2879,709,40,14,193,129,26,31,4021
"27137001000",1531,496,0,0,52,61,67,27,2234
"27137001100",1190,143,18,0,9,8,0,0,1368
"27137001200",749,547,5,92,94,128,25,14,1654
"27137001300",692,796,7,72,74,125,7,0,1773
"27137001400",1362,844,38,134,81,238,48,11,2756
"27137001600",635,554,76,67,41,63,77,8,1521
"27137001700",635,592,4,94,48,57,33,0,1463
"27137001800",1006,415,0,120,61,277,60,47,1986
"27137001900",656,506,55,147,41,177,10,14,1606
"27137002000",941,298,26,0,82,63,0,25,1435
"27137002200",876,77,0,4,15,22,0,3,997
"27137002300",3704,215,14,4,59,29,0,0,4025
"27137002400",739,83,0,0,82,12,13,9,938
"27137002600",1303,455,14,2,132,43,16,6,1971
"27137002900",1403,227,0,0,28,7,19,0,1684
"27137003000",1186,103,10,1,58,11,23,0,1392
"27137003300",1692,622,79,45,131,110,14,14,2707
"27137003400",871,344,15,0,58,16,0,11,1315
"27137003600",1350,288,0,0,25,0,17,11,1691
"27137003700",1311,496,2,9,69,7,25,1,1920
"27137003800",2557,283,3,0,51,43,28,0,2965
"27137010100",2486,224,21,0,76,0,0,0,2807
"27137010200",1491,66,0,0,38,0,0,0,1595
"27137010300",7733,635,60,0,130,41,30,11,8640
"27137010400",3200,274,29,0,48,6,0,0,3557
"27137010500",3371,318,5,0,72,6,70,0,3842
"27137010600",5766,279,6,2,215,63,69,15,6415
"27137011100",6567,322,6,10,208,15,80,0,7208
"27137011200",2279,405,11,24,386,225,21,0,3351
"27137011300",1779,232,2,0,22,11,4,0,2050
"27137011400",2731,243,0,0,14,15,29,2,3034
"27137012100",3986,539,0,0,71,18,11,162,4787
"27137012200",1168,403,0,21,144,21,52,0,1809
"27137012300",1907,468,0,0,6,0,6,0,2387
"27137012400",3061,1168,0,120,50,60,80,13,4552
"27137012500",2317,365,1,0,67,121,20,0,2891
"27137012600",4108,570,31,0,117,85,132,0,5043
"27137012700",1949,205,10,3,123,17,16,13,2336
"27137012800",2449,405,0,0,36,21,6,5,2922
"27137013000",1484,368,16,2,55,59,0,0,1984
"27137013100",1439,702,28,41,159,316,0,11,2696
"27137013200",2937,460,0,0,29,267,34,0,3727
"27137013300",2714,595,30,0,160,104,27,0,3630
"27137013400",2607,242,0,0,108,7,0,27,2991
"27137013500",1599,187,9,21,0,2,6,0,1824
"27137013600",1716,209,0,0,5,56,18,0,2004
"27137013800",1223,287,1,0,14,0,0,1,1526
"27137013900",2071,209,0,0,47,6,0,1,2334
"27137014000",1781,143,2,0,29,0,0,0,1955
"27137014100",1246,152,0,1,37,0,0,0,1436
"27137015100",2501,240,0,0,67,8,2,2,2820
"27137015200",2905,211,2,2,125,36,26,15,3322
"27137015300",2682,504,0,2,37,0,0,0,3225
"27137015400",2885,273,0,2,60,6,8,1,3235
"27137015500",2538,375,0,0,631,214,41,18,3817
"27137015600",1202,705,116,417,58,432,37,0,2967
"27137015700",1040,658,0,0,37,46,21,7,1809
"27137015800",3071,773,14,0,105,48,18,24,4053
"27137990100",0,0,0,0,0,0,0,0,0
"27139080100",1282,181,43,18,604,64,98,35,2325
"27139080201",2036,21,104,15,277,0,7,0,2460
"27139080202",3699,112,105,12,784,23,46,0,4781
"27139080203",6023,124,61,374,967,41,408,21,8019
"27139080204",2403,103,62,0,185,43,63,0,2859
"27139080205",6992,290,486,0,488,0,86,0,8342
"27139080301",7923,362,367,35,2088,315,711,188,11989
"27139080302",10464,344,636,24,2776,379,985,456,16064
"27139080400",2682,422,117,124,492,203,747,198,4985
"27139080500",1596,232,6,50,228,23,29,27,2191
"27139080600",3429,66,280,1,612,78,63,0,4529
"27139080700",2167,181,152,0,363,180,284,217,3544
"27139080800",7487,405,0,0,323,0,347,89,8651
"27139080903",5944,269,154,2,1018,46,133,0,7566
"27139080904",6058,345,19,236,476,169,172,0,7475
"27139080905",4770,91,0,0,170,81,25,0,5137
"27139080906",4513,234,72,0,232,0,143,0,5194
"27139081000",7410,301,145,24,91,1,217,0,8189
"27139081100",10120,316,33,5,269,16,48,27,10834
"27139081200",5696,252,0,0,81,4,143,2,6178
"27139081300",7819,261,1,10,169,108,16,0,8384
"27141030101",9900,747,17,0,249,48,203,104,11268
"27141030102",6939,395,0,0,320,0,46,0,7700
"27141030200",6886,210,3,0,194,0,95,0,7388
"27141030300",5668,224,16,9,59,9,12,14,6011
"27141030402",8366,490,156,22,457,0,777,0,10268
"27141030403",7990,1011,237,0,39,0,107,0,9384
"27141030404",7987,392,0,0,257,4,3,0,8643
"27141030502",9849,670,65,11,466,32,73,59,11225
"27141030503",5229,359,59,16,336,74,128,0,6201
"27141030504",4707,127,13,0,339,0,21,0,5207
"27141031500",3628,1324,366,451,33,201,130,106,6239
"27143170198",3892,369,9,2,84,0,73,0,4429
"27143170200",3045,456,14,0,71,39,160,184,3969
"27143170300",2719,271,0,0,74,0,258,84,3406
"27143170400",3277,443,4,3,60,26,259,123,4195
"27145000301",2305,672,44,91,147,63,23,0,3345
"27145000302",2720,2587,688,642,297,381,101,51,7467
"27145000401",3681,705,69,535,207,51,78,0,5326
"27145000402",4988,177,0,0,229,0,37,0,5431
"27145000500",5006,766,663,137,360,84,203,147,7366
"27145000601",2563,536,169,260,275,119,79,148,4149
"27145000602",2317,333,71,19,73,3,44,0,2860
"27145000701",2173,264,39,0,217,100,48,0,2841
"27145000801",2551,417,40,257,80,31,22,18,3416
"27145000901",3387,448,224,308,107,21,0,37,4532
"27145001001",6185,931,16,0,642,187,108,58,8127
"27145010101",6470,211,194,0,294,0,149,0,7318
"27145010102",7489,304,102,0,425,0,129,0,8449
"27145010200",5396,266,0,0,175,0,26,0,5863
"27145010401",3534,242,0,0,36,0,26,2,3840
"27145010402",3469,272,0,0,59,8,14,17,3839
"27145010403",2878,142,0,0,5,0,14,0,3039
"27145010500",3322,350,0,1,12,0,9,0,3694
"27145010600",3002,512,13,0,397,60,647,317,4948
"27145010900",3101,316,0,1,11,0,20,2,3451
"27145011000",3368,305,9,0,24,0,51,18,3775
"27145011100",6346,640,11,0,37,6,38,27,7105
"27145011200",5960,418,7,4,91,13,50,4,6547
"27145011301",4494,1477,37,56,170,110,47,112,6503
"27145011302",6199,619,3,0,33,22,159,97,7132
"27145011304",4330,197,33,0,113,130,132,137,5072
"27145011400",4468,225,46,7,86,30,123,0,4985
"27145011500",5521,509,0,0,172,254,145,451,7052
"27145011600",315,308,5,155,10,37,15,5,850
"27147960100",3990,558,0,4,167,45,259,147,5170
"27147960200",5288,340,0,85,122,43,97,0,5975
"27147960300",5105,456,0,402,422,174,623,247,7429
"27147960400",2888,368,131,99,292,94,550,29,4451
"27147960500",2563,118,7,0,47,1,16,0,2752
"27147960600",2671,493,83,12,215,110,126,74,3784
"27147960700",4694,134,0,0,169,4,190,7,5198
"27147960800",3059,360,0,0,3,32,68,74,3596
"27149480100",2083,142,0,11,7,7,43,15,2308
"27149480200",2803,855,22,0,95,137,57,38,4007
"27149480300",2423,304,0,0,221,134,104,91,3277
"27151960100",2067,258,0,0,64,0,170,59,2618
"27151960200",2792,274,23,0,49,18,110,0,3266
"27151960300",1539,75,16,0,15,0,7,2,1654
"27151960400",1828,288,6,41,43,29,19,12,2266
"27153790100",2371,521,8,2,95,5,37,4,3043
"27153790200",2065,561,4,4,74,11,19,9,2747
"27153790300",2365,544,12,3,84,10,75,23,3116
"27153790400",2785,646,13,14,72,39,23,3,3595
"27153790500",2085,294,0,0,32,5,2,0,2418
"27153790600",2495,593,0,0,622,0,808,291,4809
"27153790700",3460,469,3,6,66,9,5,0,4018
"27153790800",1576,157,0,0,46,0,10,0,1789
"27155460100",1842,125,0,5,27,50,25,21,2095
"27155460200",1059,101,0,0,123,31,9,0,1323
"27157490100",2419,278,47,0,49,32,140,10,2975
"27157490200",2985,187,0,0,33,11,25,0,3241
"27157490300",3791,222,0,0,23,0,166,0,4202
"27157490400",3906,257,8,1,96,13,68,4,4353
"27157490500",3147,264,13,0,87,25,66,0,3602
"27157490600",3035,316,0,3,20,3,33,95,3505
"27159480100",2585,526,17,11,20,53,32,15,3259
"27159480200",4726,537,56,52,102,33,94,1,5601
"27159480300",3602,1023,0,0,39,73,9,54,4800
"27161790100",3064,344,50,0,162,0,84,15,3719
"27161790200",2183,223,0,0,22,1,86,1,2516
"27161790300",2687,97,6,0,77,4,71,17,2959
"27161790400",4963,325,0,161,142,0,54,0,5645
"27161790500",2784,529,0,61,16,25,188,241,3844
"27163070103",3904,520,62,28,265,195,64,107,5145
"27163070104",2666,335,0,0,65,15,247,0,3328
"27163070105",3743,126,10,0,63,23,16,0,3981
"27163070106",6277,128,0,0,372,1,254,0,7032
"27163070203",6758,265,222,0,402,179,131,179,8136
"27163070204",5556,207,31,0,144,29,184,33,6184
"27163070205",3556,331,23,0,66,0,69,192,4237
"27163070206",3250,126,4,0,125,3,0,0,3508
"27163070301",1584,56,3,0,40,1,48,0,1732
"27163070303",4606,89,39,0,229,10,45,0,5018
"27163070304",4102,387,15,45,73,75,86,29,4812
"27163070403",3842,61,0,3,57,3,48,0,4014
"27163070404",3207,169,37,0,104,39,11,11,3578
"27163070405",4129,134,0,0,187,31,0,0,4481
"27163070406",3314,232,0,0,96,0,50,74,3766
"27163070501",3177,89,0,3,104,9,74,9,3465
"27163070502",3623,384,10,0,65,9,118,0,4209
"27163070601",5790,132,0,293,428,33,31,38,6745
"27163070602",2244,213,71,67,87,53,93,69,2897
"27163070701",5997,186,13,0,294,0,64,0,6554
"27163070703",2498,307,11,55,104,51,35,0,3061
"27163070704",2354,132,0,3,35,4,7,0,2535
"27163070801",0,0,0,0,0,0,0,0,0
"27163070802",0,0,0,0,0,0,0,0,0
"27163070906",3996,86,321,0,468,33,199,0,5103
"27163070907",3891,302,310,233,543,49,94,0,5422
"27163070909",4392,122,277,0,658,7,84,0,5540
"27163070910",3616,458,234,89,518,23,481,136,5555
"27163070911",3447,221,406,34,463,59,210,12,4852
"27163070912",1922,170,353,94,500,61,72,10,3182
"27163071001",3454,310,130,86,657,0,170,87,4894
"27163071003",2449,300,106,119,446,8,108,27,3563
"27163071006",3490,145,263,0,548,27,376,18,4867
"27163071010",4237,115,250,0,777,9,132,0,5520
"27163071011",2782,58,39,0,146,1,77,10,3113
"27163071012",3747,363,499,66,634,0,215,195,5719
"27163071013",4053,139,125,11,507,7,207,7,5056
"27163071014",3560,47,78,0,610,11,245,0,4551
"27163071015",4975,75,303,44,847,0,307,0,6551
"27163071016",3767,67,96,0,622,0,195,7,4754
"27163071017",4928,150,489,0,1079,48,55,48,6797
"27163071018",11348,381,1063,0,1914,81,591,0,15378
"27163071101",3335,148,11,0,74,0,54,14,3636
"27163071102",4222,163,0,1,230,0,267,1,4884
"27163071206",7430,688,568,30,1209,93,523,29,10570
"27163071207",6512,77,0,220,300,0,166,0,7275
"27163071208",3801,177,116,0,613,344,277,0,5328
"27163071209",5247,236,100,0,365,175,23,40,6186
"27163071300",4447,500,13,0,297,49,154,11,5471
"27163071400",5959,253,18,0,801,2,329,0,7362
"27165950100",3096,280,0,6,186,7,556,61,4192
"27165950200",3677,480,62,0,242,59,1338,281,6139
"27165950300",2504,230,13,2,127,19,158,34,3087
"27167950100",2854,209,10,0,53,0,67,19,3212
"27167950200",2789,354,0,11,95,11,64,0,3324
"27169670100",6398,510,15,3,444,51,224,0,7645
"27169670200",2955,304,0,0,33,0,133,0,3425
"27169670300",4054,518,93,26,73,23,0,3,4790
"27169670400",3538,762,0,143,22,5,19,0,4489
"27169670500",1882,1803,0,30,23,37,0,0,3775
"27169670600",2662,647,35,45,415,61,12,0,3877
"27169670700",3189,412,0,80,51,23,16,28,3799
"27169670800",6611,323,50,0,145,0,71,0,7200
"27169670900",3091,306,13,66,61,1,137,26,3701
"27169671000",3738,860,10,0,450,70,371,211,5710
"27171100100",12259,399,239,0,667,5,102,0,13671
"27171100202",1197,64,0,0,36,0,0,0,1297
"27171100203",4725,444,49,0,261,0,137,4,5620
"27171100204",7834,556,57,0,782,0,753,62,10044
"27171100300",5000,371,47,0,48,5,236,6,5713
"27171100400",4216,302,70,45,42,13,39,9,4736
"27171100500",4082,517,1,3,9,0,38,8,4658
"27171100701",5112,694,0,0,176,38,67,120,6207
"27171100702",6556,794,7,68,227,38,108,46,7844
"27171100703",8364,414,3,0,47,1,92,4,8925
"27171100801",10677,214,351,162,1371,0,340,0,13115
"27171100802",13389,266,38,0,585,0,147,0,14425
"27171100900",6379,657,56,42,182,3,235,3,7557
"27171101000",7823,332,0,0,193,6,61,0,8415
"27171101100",6753,519,8,2,265,5,256,10,7818
"27171101200",3510,412,0,0,268,7,273,0,4470
"27171101300",4396,345,20,8,46,199,13,159,5186
"27173970100",2395,258,5,6,316,176,59,91,3306
"27173970200",1987,427,0,0,27,8,18,91,2558
"27173970300",2133,183,0,0,24,46,10,39,2435
"27173970400",1741,199,4,3,56,12,78,6,2099
"28001000100",3251,324,921,1143,19,0,0,0,5658
"28001000200",519,71,2392,1136,0,0,18,37,4173
"28001000300",18,0,1507,813,0,0,0,0,2338
"28001000400",23,218,1269,1793,11,0,11,0,3325
"28001000500",1078,109,1544,727,22,65,22,0,3567
"28001000600",1064,158,628,295,0,0,0,0,2145
"28001000700",870,76,347,393,52,0,3,35,1776
"28001000800",1076,183,1364,1032,0,45,0,0,3700
"28001000900",2814,287,275,198,104,0,86,0,3764
"28003950100",4769,916,56,0,85,11,16,80,5933
"28003950200",4310,955,1135,565,323,83,344,0,7715
"28003950300",1764,1050,135,23,226,61,290,29,3578
"28003950400",4800,769,0,0,79,0,19,0,5667
"28003950500",2910,1241,904,674,40,383,51,227,6430
"28003950600",3109,748,0,47,105,97,0,2,4108
"28003950700",3311,503,286,92,0,0,26,0,4218
"28005950100",2448,305,949,651,4,3,42,3,4405
"28005950200",2145,479,609,636,8,0,0,0,3877
"28005950300",1643,387,1682,896,11,3,0,0,4622
"28007060100",2072,264,584,271,11,0,11,0,3213
"28007060200",1552,201,488,325,0,0,10,0,2576
"28007060300",880,139,1036,793,19,0,19,35,2921
"28007060400",1891,279,779,217,37,0,131,0,3334
"28007060500",1469,333,1095,704,132,25,32,44,3834
"28007060600",1022,376,769,1130,19,81,71,0,3468
"28009950100",2485,284,1841,845,197,22,133,0,5807
"28009950200",1904,481,231,198,2,4,39,0,2859
"28011950100",572,70,1419,1643,1,45,0,71,3821
"28011950200",302,30,1365,1013,21,2,5,0,2738
"28011950300",327,40,1804,1046,0,76,28,23,3344
"28011950400",715,182,1524,1467,4,45,0,45,3982
"28011950500",2352,205,1293,1232,59,352,38,332,5863
"28011950600",4462,550,162,104,146,47,91,0,5562
"28011950701",228,50,2289,1659,39,44,44,0,4353
"28011950702",177,90,1727,1201,0,0,0,0,3195
"28013950100",2868,606,344,253,84,0,41,89,4285
"28013950200",653,197,433,230,19,26,19,26,1603
"28013950300",1752,319,666,189,1,18,5,1,2951
"28013950400",1902,610,298,150,140,60,215,226,3601
"28013950500",984,345,723,689,29,0,112,70,2952
"28015950100",3284,537,504,374,78,12,0,32,4821
"28015950200",2591,284,1437,1008,10,29,10,0,5369
"28017950100",904,398,1830,819,31,7,77,15,4081
"28017950200",1901,475,937,263,3,1,22,0,3602
"28017950300",1815,495,1243,446,120,70,381,83,4653
"28017950400",3190,253,715,1100,28,4,63,0,5353
"28019950100",1939,489,165,102,0,0,0,0,2695
"28019950200",2028,243,807,701,45,13,31,0,3868
"28019950300",778,136,394,394,8,0,6,0,1716
"28021950100",642,16,1725,586,104,0,8,0,3081
"28021950200",118,21,693,688,3,23,0,16,1562
"28021950300",305,30,2060,1865,0,0,27,29,4316
"28023950100",3036,272,572,310,17,0,8,0,4215
"28023950200",3298,1031,1160,363,0,0,11,71,5934
"28023950300",922,138,1372,1270,3,0,0,0,3705
"28023950400",1493,336,551,241,23,0,6,0,2650
"28025950100",2445,127,1871,810,0,0,105,0,5358
"28025950200",928,104,795,441,8,7,0,0,2283
"28025950300",852,71,1337,1564,11,0,11,0,3846
"28025950400",1634,241,1567,1460,12,45,46,14,5019
"28025950500",1687,43,1290,595,151,14,19,16,3815
"28027950100",535,79,1537,1557,3,31,8,0,3750
"28027950200",1062,219,619,264,83,2,24,0,2273
"28027950300",945,104,1169,1153,35,8,35,3,3452
"28027950400",1499,104,1562,773,86,0,0,0,4024
"28027950500",855,170,2099,2027,45,21,0,0,5217
"28027950600",22,0,748,567,0,0,0,0,1337
"28027950700",15,0,2728,2254,0,0,0,0,4997
"28029950100",1716,307,2432,1564,149,168,126,195,6657
"28029950200",2382,522,1122,601,8,15,16,140,4806
"28029950300",1524,225,1469,717,30,0,0,0,3965
"28029950400",690,191,2107,1451,140,8,86,95,4768
"28029950500",3657,434,857,629,158,0,68,79,5882
"28029950600",1212,168,1004,538,0,0,0,0,2922
"28031950100",1845,107,1487,1490,0,37,74,0,5040
"28031950200",655,40,640,422,82,12,0,0,1851
"28031950300",2486,337,1132,1116,74,32,153,53,5383
"28031950400",5012,1585,338,270,0,0,118,0,7323
"28033070101",1334,97,758,376,94,170,109,170,3108
"28033070102",2758,75,1012,47,200,0,36,16,4144
"28033070210",2975,551,2270,95,444,42,214,249,6840
"28033070221",2747,272,670,233,63,37,9,90,4121
"28033070222",2490,250,1081,172,76,13,339,21,4442
"28033070310",2081,439,884,7,107,47,146,219,3930
"28033070322",2293,339,1055,169,86,10,77,0,4029
"28033070323",2584,353,2406,461,198,33,451,12,6498
"28033070324",2146,586,1792,200,98,29,169,11,5031
"28033070325",1766,630,445,21,53,151,160,434,3660
"28033070411",1314,186,115,100,56,2,2,2,1777
"28033070412",2258,179,1163,440,331,100,389,22,4882
"28033070421",2014,110,354,0,161,117,36,124,2916
"28033070422",1799,219,265,113,108,0,40,0,2544
"28033070520",6245,282,2964,108,412,77,467,0,10555
"28033070521",2441,444,298,126,282,106,354,62,4113
"28033070522",2990,110,801,0,148,6,63,0,4118
"28033070610",1373,252,1017,399,225,0,18,6,3290
"28033070620",5201,129,893,496,278,0,77,0,7074
"28033070630",7948,283,1109,266,493,24,153,0,10276
"28033070710",4311,121,1374,328,37,7,83,0,6261
"28033070721",2659,229,1279,196,68,0,122,0,4553
"28033070722",4258,182,267,0,128,0,108,0,4943
"28033070811",2821,247,1485,291,497,8,217,18,5584
"28033070812",4004,225,1404,159,148,56,574,56,6626
"28033070821",4200,296,542,11,140,19,71,28,5307
"28033070822",2900,296,976,81,375,7,496,0,5131
"28033070830",4151,124,1028,49,417,23,705,15,6512
"28033070900",2972,112,909,97,114,23,74,12,4313
"28033071000",8038,297,407,145,270,0,93,0,9250
"28033071110",5918,339,190,0,61,77,143,90,6818
"28033071120",4642,529,654,517,38,0,207,306,6893
"28033071200",2571,496,287,71,86,19,44,19,3593
"28035000200",1295,234,632,306,117,4,4,0,2592
"28035000300",817,191,1678,723,161,34,130,40,3774
"28035000500",398,184,429,450,16,43,85,206,1811
"28035000600",50,50,3956,2858,10,8,0,18,6950
"28035000700",1779,409,563,142,57,11,23,113,3097
"28035000800",3191,896,606,528,0,9,15,17,5262
"28035000900",305,350,235,608,31,139,32,17,1717
"28035001000",945,1397,716,1075,178,234,169,45,4759
"28035001100",692,247,1359,1041,228,53,31,90,3741
"28035010101",4451,455,677,83,100,0,155,34,5955
"28035010102",5708,461,222,2,62,0,15,0,6470
"28035010200",2765,772,2155,673,120,37,87,13,6622
"28035010300",2391,319,378,79,440,48,249,63,3967
"28035010400",2166,710,244,230,269,120,267,172,4178
"28035010500",953,360,1056,887,51,0,24,87,3418
"28035010600",6117,2037,47,104,33,21,37,171,8567
"28035010700",60,150,703,808,73,0,54,0,1848
"28037950100",3157,596,884,398,2,8,2,8,5055
"28037950200",1057,206,1249,232,53,0,0,0,2797
"28039950101",5235,521,124,14,85,244,23,261,6507
"28039950102",3127,806,133,19,163,34,114,8,4404
"28039950200",1517,209,187,279,35,94,11,46,2378
"28039950301",4785,1340,495,124,0,27,3,0,6774
"28039950302",2219,302,207,38,14,0,0,0,2780
"28041950100",3450,874,277,67,40,0,16,0,4724
"28041950200",4161,839,1011,96,263,2,44,0,6416
"28043950100",3230,455,1958,567,53,0,5,0,6268
"28043950200",3247,385,1001,333,25,0,0,0,4991
"28043950300",630,119,990,1054,21,0,0,16,2830
"28043950400",256,167,1259,705,0,5,13,0,2405
"28043950500",3024,437,681,547,86,52,0,0,4827
"28045030100",3260,921,375,224,172,69,42,2,5065
"28045030200",3557,1125,726,249,147,28,197,2,6031
"28045030300",5523,2303,1174,153,240,140,106,39,9678
"28045030400",1658,156,467,215,9,20,81,20,2626
"28045030500",7384,644,72,3,187,0,244,180,8714
"28045030601",5459,1793,0,3,253,23,143,23,7697
"28045030602",4634,738,151,20,441,59,476,0,6519
"28045990000",0,0,0,0,0,0,0,0,0
"28047000100",147,53,0,26,70,80,0,0,376
"28047000300",174,178,589,660,205,106,41,107,2060
"28047000600",977,154,56,18,15,49,15,13,1297
"28047000900",315,36,68,73,63,14,5,0,574
"28047001201",2742,528,408,130,458,155,161,132,4714
"28047001202",3539,553,990,703,704,49,311,219,7068
"28047001300",1556,257,495,241,494,17,445,6,3511
"28047001400",1182,252,118,197,5,23,65,0,1842
"28047001501",2542,189,575,175,69,0,185,0,3735
"28047001502",2743,640,425,283,417,229,362,165,5264
"28047001600",2836,176,19,0,225,8,90,0,3354
"28047001700",2788,728,1153,564,215,97,154,62,5761
"28047001800",224,94,1115,1150,13,0,68,14,2678
"28047001900",1375,639,671,230,0,0,89,234,3238
"28047002000",1087,495,873,570,18,27,161,78,3309
"28047002300",394,364,865,482,9,42,20,0,2176
"28047002400",546,335,1365,1598,6,125,130,21,4126
"28047002500",1194,84,87,0,59,0,231,45,1700
"28047002600",540,63,1341,1063,76,35,12,0,3130
"28047002700",4266,428,326,342,174,166,115,43,5860
"28047002800",2084,269,61,0,37,22,112,67,2652
"28047002900",1149,12,149,9,18,15,47,9,1408
"28047003000",1671,308,996,301,198,22,0,0,3496
"28047003101",5173,670,464,616,363,12,245,117,7660
"28047003102",5450,827,639,131,286,48,271,0,7652
"28047003204",1802,539,1018,299,56,0,393,116,4223
"28047003205",3783,517,1877,83,47,0,66,0,6373
"28047003206",5180,620,1372,1024,686,47,134,142,9205
"28047003207",2382,770,1279,1104,177,89,76,128,6005
"28047003208",1404,291,968,695,162,192,97,216,4025
"28047003301",5260,790,1257,151,1116,50,625,52,9301
"28047003303",3620,388,793,77,406,337,400,16,6037
"28047003304",3013,107,863,40,308,67,207,0,4605
"28047003402",8028,1182,896,386,1265,539,199,0,12495
"28047003403",1838,126,0,0,45,0,41,28,2078
"28047003404",4619,315,126,28,190,32,22,0,5332
"28047003501",6890,1291,241,134,288,195,151,0,9190
"28047003502",4606,839,79,21,224,13,68,0,5850
"28047003504",4781,732,747,242,360,0,105,0,6967
"28047003505",4195,789,1233,202,234,35,645,65,7398
"28047003600",283,90,217,128,141,142,77,62,1140
"28047003700",1602,425,322,670,173,78,146,133,3549
"28047003800",824,204,110,55,76,0,148,90,1507
"28047003900",1420,417,488,527,196,221,59,117,3445
"28047980000",0,0,0,0,0,0,0,0,0
"28047990000",0,0,0,0,0,0,0,0,0
"28049000100",2875,180,1261,222,278,17,36,17,4886
"28049000200",3862,304,816,478,0,0,63,0,5523
"28049000301",51,40,1313,1188,0,0,0,0,2592
"28049000302",196,234,2548,889,49,0,0,170,4086
"28049000400",974,130,1396,571,66,0,13,8,3158
"28049000500",0,50,4253,2119,9,83,0,0,6514
"28049000600",0,0,2190,1392,0,0,0,0,3582
"28049000700",400,39,3517,1507,0,31,0,0,5494
"28049000800",0,27,1764,2130,7,0,4,0,3932
"28049000900",0,1,995,774,2,0,0,0,1772
"28049001000",0,0,908,786,19,0,38,0,1751
"28049001100",31,0,1012,673,0,0,0,0,1716
"28049001200",1,18,1147,647,0,0,0,8,1821
"28049001300",2052,420,581,189,12,10,11,0,3275
"28049001400",2310,126,38,0,26,0,34,0,2534
"28049001500",2399,331,164,21,124,20,35,0,3094
"28049001600",665,192,1626,421,82,109,12,14,3121
"28049001900",31,0,862,920,15,0,0,0,1828
"28049002000",4,0,503,482,0,0,0,0,989
"28049002100",77,4,1480,1313,0,0,0,0,2874
"28049002200",73,67,957,871,0,12,5,0,1985
"28049002300",112,22,1169,1277,0,0,0,5,2585
"28049002400",31,0,2759,1215,18,21,0,0,4044
"28049002500",37,15,1280,976,65,6,0,3,2382
"28049002700",209,84,298,279,5,24,0,24,923
"28049003000",181,96,734,809,3,20,37,9,1889
"28049003200",11,2,731,441,0,0,0,0,1185
"28049003300",624,13,3428,2371,39,115,22,32,6644
"28049003400",156,209,1623,1487,38,9,0,96,3618
"28049003500",254,66,1924,1664,6,6,0,0,3920
"28049003600",373,0,2257,1555,93,0,18,0,4296
"28049003700",468,133,1761,974,15,0,59,0,3410
"28049003800",714,172,1389,1153,32,20,255,0,3735
"28049010101",2197,110,3713,631,272,75,335,57,7390
"28049010102",1176,184,3131,748,13,341,0,527,6120
"28049010201",21,0,2180,703,79,0,73,0,3056
"28049010202",106,2,4848,1047,26,0,111,0,6140
"28049010203",48,36,1726,1100,12,0,0,0,2922
"28049010301",26,4,2370,884,0,0,0,0,3284
"28049010304",2672,130,2711,226,342,0,159,0,6240
"28049010305",1455,134,1462,376,135,39,121,0,3722
"28049010400",2161,349,747,230,22,123,0,65,3697
"28049010500",3174,446,3027,1218,94,29,171,0,8159
"28049010600",946,221,2960,1074,64,26,78,0,5369
"28049010700",3592,367,1287,191,46,0,0,0,5483
"28049010801",62,43,743,676,111,35,122,50,1842
"28049010804",531,107,579,61,208,22,109,8,1625
"28049010805",2131,48,997,277,162,131,48,17,3811
"28049010806",2195,156,648,44,252,91,54,17,3457
"28049010807",2556,69,1141,16,72,0,4,8,3866
"28049010808",383,0,3545,603,91,11,0,0,4633
"28049010809",265,43,2196,263,0,0,0,0,2767
"28049010901",202,32,1461,800,10,0,0,0,2505
"28049010902",97,31,1265,327,43,28,50,28,1869
"28049011001",616,258,3254,2210,0,0,36,0,6374
"28049011002",440,48,2871,1227,35,0,0,0,4621
"28049011101",261,103,1955,396,67,0,67,0,2849
"28049011102",2837,59,6630,591,217,0,37,0,10371
"28049011103",2028,222,3406,456,10,0,0,0,6122
"28049011201",1668,18,749,344,23,0,20,0,2822
"28049011202",4013,627,3608,195,61,7,17,13,8541
"28049011300",1682,107,1815,619,41,28,96,28,4416
"28049011400",0,75,596,454,0,1,0,52,1178
"28049011500",37,60,557,781,0,0,0,0,1435
"28051950100",769,215,1910,1303,8,8,0,0,4213
"28051950200",480,106,1520,1610,119,4,0,0,3839
"28051950300",150,51,960,1609,0,5,0,0,2775
"28051950400",442,144,1064,860,0,0,0,0,2510
"28051950500",404,80,2438,2049,0,0,20,9,5000
"28053950100",499,57,989,1104,107,0,107,0,2863
"28053950200",726,132,535,378,16,0,4,4,1795
"28053950300",483,98,1925,1840,21,0,50,49,4466
"28055950100",349,32,332,281,0,1,0,1,996
"28057950100",3235,866,188,52,58,34,52,0,4485
"28057950200",5605,708,154,11,49,0,194,0,6721
"28057950300",1538,448,183,113,10,18,26,0,2336
"28057950400",4209,716,11,12,37,47,8,39,5079
"28057950500",2980,596,331,167,16,0,0,0,4090
"28059040101",6150,464,600,12,4,0,0,0,7230
"28059040102",6081,794,15,1,245,0,0,0,7136
"28059040201",8028,492,165,85,182,21,22,0,8995
"28059040203",3411,470,227,92,262,58,18,8,4546
"28059040204",5881,560,701,0,345,0,59,0,7546
"28059040300",4484,912,660,273,1115,145,52,90,7731
"28059040400",5725,1012,993,114,403,123,169,159,8698
"28059040500",2897,359,149,40,72,20,81,8,3626
"28059040600",4481,243,502,32,212,0,253,48,5771
"28059040700",6202,953,1033,86,400,23,603,0,9300
"28059040800",3917,574,1073,798,353,49,368,78,7210
"28059040900",8158,627,675,631,768,95,750,238,11942
"28059041000",2931,227,952,307,589,0,703,22,5731
"28059041100",3010,529,1513,990,260,19,345,437,7103
"28059041300",3866,754,933,279,91,198,51,166,6338
"28059041400",1402,107,1370,315,0,0,34,54,3282
"28059041500",351,28,654,127,15,0,26,0,1201
"28059041600",332,76,1668,767,26,0,37,0,2906
"28059041700",27,32,1783,323,2,15,0,9,2191
"28059041800",67,94,2020,475,0,0,0,0,2656
"28059041900",1203,194,478,204,99,16,69,20,2283
"28059042000",1795,466,1473,791,422,11,516,138,5612
"28059042100",1012,614,541,592,64,0,254,117,3194
"28059042200",1733,809,522,795,253,180,162,252,4706
"28059042500",1472,103,154,191,51,24,228,10,2233
"28059042600",2609,8,236,125,39,37,106,37,3197
"28059042700",709,142,15,65,0,0,4,0,935
"28059042900",1334,209,408,184,59,1,153,33,2381
"28059990000",0,0,0,0,0,0,0,0,0
"28061950100",1983,337,1814,545,6,0,28,11,4724
"28061950200",653,89,743,588,0,0,0,0,2073
"28061950300",3009,533,1250,209,0,2,0,1,5004
"28061950400",957,173,2483,1101,14,117,5,98,4948
"28063950100",874,13,2070,2824,0,20,0,0,5801
"28063950200",0,0,772,569,8,0,0,0,1349
"28065950100",1341,329,2157,1338,23,0,19,0,5207
"28065950201",993,188,1366,552,10,0,12,0,3121
"28065950202",1444,278,1136,731,0,15,0,0,3604
"28067950100",3924,693,1242,710,164,215,91,0,7039
"28067950200",4190,188,718,421,42,0,64,0,5623
"28067950301",3333,704,268,461,47,0,0,0,4813
"28067950302",2756,410,0,0,62,0,52,0,3280
"28067950401",2315,119,488,146,0,2,0,0,3070
"28067950402",1758,535,1619,612,128,0,42,151,4845
"28067950500",1708,374,726,1213,386,125,700,170,5402
"28067950600",1661,642,2690,1982,150,37,316,75,7553
"28067950700",872,175,1321,994,0,52,0,0,3414
"28067950800",4103,484,205,428,29,57,92,82,5480
"28067950900",5650,1701,326,121,33,32,191,487,8541
"28067951000",1485,361,733,498,21,15,0,0,3113
"28067951100",5483,678,523,290,0,2,430,0,7406
"28067980000",0,0,0,0,0,0,0,0,0
"28069030100",1173,357,1839,1742,6,0,18,0,5135
"28069030200",1818,116,1554,401,168,275,257,0,4589
"28071950100",2449,296,1458,548,139,0,64,172,5126
"28071950201",2050,562,446,468,20,0,0,0,3546
"28071950202",1744,2035,544,185,0,27,59,181,4775
"28071950301",239,660,159,536,114,156,104,95,2063
"28071950302",1711,619,516,221,376,107,207,0,3757
"28071950401",4399,509,1942,620,99,57,55,26,7707
"28071950402",1557,860,1002,371,23,5,1,18,3837
"28071950501",5502,262,338,14,215,0,27,0,6358
"28071950502",1838,305,302,14,14,5,0,0,2478
"28071950503",2641,1514,1336,387,141,429,12,20,6480
"28073020100",5997,786,595,72,42,101,19,101,7713
"28073020201",5447,441,446,300,124,266,42,190,7256
"28073020202",7328,297,542,39,236,90,73,0,8605
"28073020301",4597,583,2371,233,560,49,534,10,8937
"28073020302",3920,1560,2616,1690,347,31,24,103,10291
"28073020400",4833,450,477,129,101,62,116,35,6203
"28073020500",4793,954,447,22,0,26,52,0,6294
"28073020600",1629,269,806,758,28,33,37,0,3560
"28075000200",188,117,1390,874,83,132,162,34,2980
"28075000300",638,84,948,1011,12,0,5,0,2698
"28075000400",103,251,1547,2997,66,273,0,2,5239
"28075000600",70,16,760,935,31,12,0,1,1825
"28075000700",571,266,1790,1268,43,11,33,11,3993
"28075000800",200,181,759,536,0,0,0,1,1677
"28075000900",990,338,2633,1258,280,117,236,35,5887
"28075001000",2093,333,1094,560,28,12,165,4,4289
"28075001101",2301,118,464,370,17,1,39,1,3311
"28075001102",2419,299,1258,159,110,9,34,0,4288
"28075010201",2880,300,1830,1213,224,0,55,0,6502
"28075010202",4172,435,1091,467,159,0,305,0,6629
"28075010301",4338,402,1300,0,27,0,10,9,6086
"28075010302",4683,345,695,3,286,0,130,0,6142
"28075010400",1129,287,161,73,87,7,53,0,1797
"28075010500",4516,657,326,60,53,0,22,0,5634
"28075010600",5485,271,1190,261,256,23,13,0,7499
"28075010700",252,96,417,307,0,0,0,0,1072
"28075980000",24,9,0,5,0,0,0,0,38
"28077960100",2085,525,1236,504,24,0,68,0,4442
"28077960200",2588,238,1123,916,63,0,5,12,4945
"28077960300",2755,215,250,44,32,28,0,0,3324
"28079040100",2218,223,595,220,207,0,211,24,3698
"28079040400",3304,476,1089,755,558,171,0,16,6369
"28079040500",1994,174,684,208,1,0,108,0,3169
"28079040600",1928,582,960,1563,409,164,330,291,6227
"28079040700",829,112,1413,1431,0,0,15,0,3800
"28081950101",3488,454,462,58,127,90,2,60,4741
"28081950102",2545,379,701,228,21,0,0,58,3932
"28081950201",6253,812,615,35,96,0,63,38,7912
"28081950202",5439,310,49,24,116,43,84,0,6065
"28081950301",4408,520,20,94,24,36,244,0,5346
"28081950302",2088,401,428,203,50,0,32,0,3202
"28081950401",1791,270,1070,1053,319,68,69,0,4640
"28081950402",5691,174,647,96,133,100,7,0,6848
"28081950500",2730,510,969,875,41,63,5,9,5202
"28081950601",2506,301,771,344,43,88,9,62,4124
"28081950602",1882,248,1178,434,27,0,65,0,3834
"28081950700",1198,352,1174,938,24,74,24,222,4006
"28081950800",1349,115,674,860,173,0,149,114,3434
"28081950901",1633,89,583,620,44,69,70,0,3108
"28081950902",1718,537,1213,975,358,10,161,364,5336
"28081951001",2075,388,988,281,0,9,69,0,3810
"28081951002",742,210,1756,1042,51,87,18,50,3956
"28081951100",3603,632,1070,360,157,14,17,11,5864
"28081980000",0,0,0,0,0,0,0,0,0
"28083950100",382,50,358,284,0,0,0,0,1074
"28083950200",605,175,991,1138,9,6,0,0,2924
"28083950300",678,40,2074,1951,186,0,31,0,4960
"28083950400",832,42,2251,1833,55,0,40,150,5203
"28083950600",3703,457,181,549,71,102,176,37,5276
"28083950700",190,247,1114,634,0,90,0,165,2440
"28083950800",30,9,2115,1964,130,96,0,9,4353
"28083950900",83,37,1721,2572,10,110,0,102,4635
"28085950100",1923,497,1034,325,0,0,32,0,3811
"28085950200",3839,375,492,507,0,0,0,0,5213
"28085950300",5203,1207,540,335,186,0,47,26,7544
"28085950400",4729,1174,1334,119,75,0,21,169,7621
"28085950500",939,528,1170,2027,14,0,45,0,4723
"28085950600",2828,195,1194,1382,48,0,30,0,5677
"28087000101",5056,687,553,167,40,1,79,1,6584
"28087000102",1197,389,668,235,87,102,0,119,2797
"28087000200",1081,10,153,0,176,2,110,0,1532
"28087000300",5200,450,1708,432,149,16,150,55,8160
"28087000401",4209,577,1323,937,25,0,71,0,7142
"28087000403",1912,194,1518,803,15,0,15,0,4457
"28087000404",3251,278,415,204,0,0,167,0,4315
"28087000500",1191,287,1709,736,27,104,55,104,4213
"28087000600",599,110,1464,1484,16,0,0,0,3673
"28087000700",1040,227,1174,1821,45,4,0,0,4311
"28087000800",64,45,1134,1831,6,0,27,7,3114
"28087000900",1555,350,1666,1061,213,23,15,7,4890
"28087001000",1173,43,659,245,28,1,10,6,2165
"28087001100",237,12,936,711,21,7,0,0,1924
"28089030101",6081,253,720,108,197,29,39,0,7427
"28089030104",1913,91,466,13,224,15,0,0,2722
"28089030105",1201,407,620,259,326,42,287,23,3165
"28089030106",1715,348,2185,281,153,187,81,178,5128
"28089030107",1882,143,444,23,27,37,9,0,2565
"28089030108",1362,47,3245,225,431,39,338,0,5687
"28089030201",6242,346,1121,305,68,0,70,0,8152
"28089030202",3771,58,454,30,287,18,23,18,4659
"28089030203",2373,136,325,0,151,0,0,0,2985
"28089030204",2977,105,438,156,248,38,52,0,4014
"28089030205",1664,90,452,7,319,9,0,0,2541
"28089030206",1450,44,196,38,72,5,35,0,1840
"28089030301",4391,37,615,0,269,9,0,0,5321
"28089030302",2937,182,2086,1215,59,0,42,0,6521
"28089030400",9388,143,3097,347,414,0,266,0,13655
"28089030500",3,140,3510,2907,203,562,201,617,8143
"28089030600",272,68,1702,1319,108,21,108,28,3626
"28089030700",201,21,415,202,192,28,179,37,1275
"28089030800",675,47,1003,183,42,50,36,50,2086
"28089030900",1706,153,3599,769,59,0,43,0,6329
"28089031000",242,81,1324,318,0,0,9,0,1974
"28091950100",3389,1146,513,575,60,36,0,0,5719
"28091950200",1707,472,633,407,79,0,11,14,3323
"28091950300",784,604,808,1095,7,0,57,0,3355
"28091950400",2080,387,338,474,29,0,47,0,3355
"28091950500",1788,553,1669,931,0,129,0,220,5290
"28091950600",3524,571,404,281,21,24,0,0,4825
"28093950100",3572,554,2096,233,96,25,0,43,6619
"28093950200",4487,797,2066,911,356,63,495,16,9191
"28093950300",3041,267,2503,381,141,252,141,252,6978
"28093950401",349,50,1479,1057,46,40,0,40,3061
"28093950402",505,36,1926,562,20,10,20,4,3083
"28093950500",2907,877,2212,546,127,59,33,119,6880
"28095950100",5079,312,216,13,27,2,22,0,5671
"28095950200",4082,508,1462,852,62,15,138,0,7119
"28095950300",2711,423,248,167,11,0,14,0,3574
"28095950400",1273,155,806,960,6,78,0,7,3285
"28095950501",2850,450,160,146,10,15,0,15,3646
"28095950502",3206,442,171,56,19,0,28,19,3941
"28095950600",1578,78,1008,486,0,71,78,0,3299
"28095950700",713,114,879,727,4,11,0,37,2485
"28095950800",424,59,1221,1488,24,31,11,0,3258
"28097950100",1406,177,594,579,0,0,0,0,2756
"28097950200",1261,222,872,347,0,0,0,0,2702
"28097950300",2072,383,1388,1170,37,0,0,0,5050
"28099010100",4010,646,634,123,317,102,33,0,5865
"28099010200",1954,298,312,162,141,0,48,0,2915
"28099010400",1097,61,1511,914,105,51,47,35,3821
"28099010500",1452,157,477,728,63,3,0,0,2880
"28099010600",2714,690,120,147,823,341,9,235,5079
"28099010700",2983,700,576,350,124,180,33,0,4946
"28099940100",365,181,141,0,2520,744,64,28,4043
"28101050100",2450,298,208,0,14,0,0,0,2970
"28101050200",2521,284,282,573,45,42,34,0,3781
"28101050300",2502,451,744,520,547,568,77,0,5409
"28101050400",2986,638,1260,454,10,0,77,64,5489
"28101050500",948,292,1859,458,57,0,75,0,3689
"28103950100",1378,249,2523,1293,17,0,0,49,5509
"28103950200",948,43,1089,1254,7,0,5,0,3346
"28103950300",290,62,857,949,13,0,31,0,2202
"28105950100",2346,1731,1763,1221,35,474,14,67,7651
"28105950200",3502,1313,1238,899,243,0,37,0,7232
"28105950300",826,243,1385,1000,187,0,42,0,3683
"28105950400",1852,1507,639,507,376,32,28,28,4969
"28105950500",1720,875,870,447,94,76,55,45,4182
"28105950601",2135,595,300,302,171,127,30,94,3754
"28105950602",1994,440,1313,1148,230,0,172,0,5297
"28105950700",3380,714,2565,1015,23,0,80,15,7792
"28107950100",1647,179,4256,1158,74,33,53,0,7400
"28107950200",659,75,1011,895,4,7,0,0,2651
"28107950300",2519,374,1006,1470,22,111,107,156,5765
"28107950400",3155,736,923,706,170,0,207,0,5897
"28107950500",2878,422,2042,759,25,13,7,17,6163
"28107950600",3706,304,1761,1207,0,0,0,0,6978
"28109950100",3961,1442,0,0,71,30,180,19,5703
"28109950200",3643,813,579,523,105,33,102,31,5829
"28109950300",1591,265,207,217,287,10,67,10,2654
"28109950401",4825,1673,120,262,117,0,174,129,7300
"28109950402",4324,1176,233,550,0,0,43,0,6326
"28109950501",6120,1175,198,2,101,0,318,0,7914
"28109950502",6290,754,480,32,182,95,267,0,8100
"28109950600",3024,390,444,234,73,0,104,0,4269
"28109950700",3135,1160,1880,982,138,0,207,0,7502
"28111950101",3285,352,439,190,11,6,0,0,4283
"28111950102",2369,715,478,217,74,18,0,0,3871
"28111950200",2224,375,660,643,30,0,6,0,3938
"28113950101",3370,296,1117,410,63,11,9,0,5276
"28113950102",3047,332,333,230,0,8,0,0,3950
"28113950200",2124,520,1499,1040,83,49,74,24,5413
"28113950300",111,76,2595,2211,122,61,90,89,5355
"28113950400",1696,204,591,528,114,0,0,0,3133
"28113950500",1800,348,3669,745,102,1,29,169,6863
"28113950600",1612,580,2085,1861,21,5,0,0,6164
"28113950700",1328,585,895,695,47,2,33,1,3586
"28115950101",2411,506,1342,284,33,0,20,0,4596
"28115950102",3995,737,487,30,93,83,75,80,5580
"28115950200",4178,691,275,27,400,144,552,168,6435
"28115950300",3036,442,501,294,842,155,739,136,6145
"28115950400",2858,711,619,70,23,0,0,50,4331
"28115950500",3795,570,305,115,20,0,20,13,4838
"28117950100",5287,831,72,80,6,46,0,24,6346
"28117950200",4345,934,316,47,86,0,83,48,5859
"28117950300",2986,1342,719,599,0,99,0,23,5768
"28117950400",3605,616,30,250,57,0,141,0,4699
"28117950500",635,93,340,732,82,14,0,6,1902
"28119950100",325,25,989,942,23,12,63,18,2397
"28119950200",286,39,693,588,8,0,0,0,1614
"28119950300",1252,312,1096,999,0,22,0,0,3681
"28121020101",2542,272,739,499,162,122,66,122,4524
"28121020102",8411,248,1507,768,268,3,39,3,11247
"28121020206",6971,646,1295,102,316,0,161,108,9599
"28121020207",3848,309,1263,239,80,37,140,21,5937
"28121020208",5225,362,483,0,169,20,89,0,6348
"28121020209",3766,119,509,6,62,9,26,0,4497
"28121020210",3805,135,410,214,205,0,72,0,4841
"28121020211",6902,431,858,0,532,0,298,0,9021
"28121020212",2248,46,403,0,51,0,62,0,2810
"28121020213",1083,0,260,51,55,0,0,0,1449
"28121020301",2550,391,23,92,0,0,0,0,3056
"28121020302",5532,553,898,69,480,43,272,79,7926
"28121020401",2758,466,533,263,110,14,76,2,4222
"28121020402",4133,454,1335,194,136,0,19,17,6288
"28121020500",26,147,8,110,0,0,0,0,291
"28121020600",4386,500,2978,441,301,339,391,198,9534
"28121020701",746,16,223,25,5,0,81,5,1101
"28121020703",1120,349,185,26,42,26,70,23,1841
"28121020704",4416,634,624,149,113,16,576,43,6571
"28121020801",1611,221,199,12,4,0,23,0,2070
"28121020802",7363,973,2628,890,413,0,9,394,12670
"28121020803",1385,526,115,0,6,31,21,40,2124
"28121020900",4913,920,1359,163,0,0,35,0,7390
"28121021001",4469,644,533,108,65,77,26,49,5971
"28121021002",5130,498,948,193,94,0,70,0,6933
"28121021003",3807,472,551,127,32,43,0,0,5032
"28121980000",93,9,28,6,0,6,0,0,142
"28123020100",2988,799,1627,1011,208,42,322,163,7160
"28123020200",1532,478,1835,803,46,6,57,36,4793
"28123020300",3862,477,574,219,16,0,244,0,5392
"28123020400",1111,500,792,459,86,11,623,213,3795
"28123020500",2075,560,1193,737,262,105,656,538,6126
"28123020600",1877,279,770,452,22,104,61,74,3639
"28125950100",757,60,882,843,17,7,7,0,2573
"28125950200",419,63,1159,569,7,0,41,0,2258
"28127950100",2102,832,1608,365,14,16,23,0,4960
"28127950200",2011,438,653,459,1,46,0,40,3648
"28127950300",3899,603,1196,844,55,14,0,0,6611
"28127950400",4098,524,1237,1186,248,120,50,0,7463
"28127950500",1909,488,1193,528,86,0,269,44,4517
"28129950100",3120,730,857,266,9,0,2,17,5001
"28129950200",4150,767,497,659,45,7,9,0,6134
"28129950300",3108,253,750,990,7,15,7,0,5130
"28131020100",2269,397,411,523,0,0,78,32,3710
"28131020201",5268,796,585,233,143,100,16,14,7155
"28131020202",4247,690,860,427,216,2,112,2,6556
"28133950100",927,226,991,1211,12,0,13,0,3380
"28133950200",954,282,2107,1035,10,0,42,8,4438
"28133950300",883,39,642,752,78,109,48,116,2667
"28133950401",1407,110,1345,445,33,32,84,14,3470
"28133950402",31,0,3227,2414,10,77,0,24,5783
"28133950500",263,11,909,1068,32,0,0,0,2283
"28133950600",626,133,942,653,19,0,16,9,2398
"28135950100",2180,387,752,384,11,2,0,16,3732
"28135950200",417,41,806,1084,26,5,0,0,2379
"28135950300",857,205,1139,706,2,2,0,5,2916
"28135950400",943,50,850,318,0,0,0,0,2161
"28137950100",3026,529,1551,527,25,37,101,0,5796
"28137950200",5049,364,904,220,0,11,31,0,6579
"28137950301",1754,132,1033,883,129,38,42,38,4049
"28137950302",4124,632,868,139,28,217,0,217,6225
"28137950400",2401,240,1201,619,130,15,221,24,4851
"28139950100",2968,1193,275,188,90,60,50,60,4884
"28139950200",3953,1644,527,250,294,51,257,155,7131
"28139950300",1374,204,455,410,209,76,18,0,2746
"28139950400",5384,765,657,509,111,66,354,154,8000
"28141950100",2517,331,0,0,7,0,12,0,2867
"28141950200",1649,507,44,19,75,19,0,8,2321
"28141950300",5022,823,0,7,112,29,0,0,5993
"28141950400",6066,1252,220,133,312,70,375,125,8553
"28143950100",961,359,3087,1087,146,48,0,44,5732
"28143950200",858,74,2254,1407,15,97,0,93,4798
"28143980000",0,0,0,0,0,0,0,0,0
"28145950100",3293,1060,168,1,43,61,30,108,4764
"28145950200",3368,1213,329,43,30,72,46,50,5151
"28145950300",2555,401,685,331,229,84,208,25,4518
"28145950400",1846,700,734,382,177,262,57,430,4588
"28145950500",3960,1151,296,107,31,0,3,239,5787
"28145950600",2557,279,290,347,32,7,0,43,3555
"28147950100",2267,661,2314,1276,80,11,80,0,6689
"28147950200",740,155,339,265,83,0,29,0,1611
"28147950300",3627,364,1628,896,85,0,0,142,6742
"28149950100",2945,29,673,619,0,103,91,19,4479
"28149950200",501,105,1980,1448,147,6,0,0,4187
"28149950300",297,53,1409,1616,0,0,16,0,3391
"28149950400",843,17,1095,1087,4,0,36,0,3082
"28149950500",870,141,841,309,50,90,38,134,2473
"28149950600",2827,270,1521,896,254,23,202,16,6009
"28149950700",564,111,1104,242,19,4,0,0,2044
"28149950800",1354,246,1614,542,100,0,43,47,3946
"28149950901",3395,423,1069,193,15,0,66,0,5161
"28149950902",2500,392,674,377,56,7,9,0,4015
"28149951101",2958,369,1336,481,10,0,10,0,5164
"28149951102",2287,358,1200,483,191,22,210,0,4751
"28151000100",969,124,307,250,8,0,18,6,1682
"28151000200",380,95,842,670,0,0,5,0,1992
"28151000300",67,44,1501,1395,39,10,0,0,3056
"28151000400",7,0,1300,1537,6,0,0,0,2850
"28151000600",9,48,1174,1460,0,11,11,11,2724
"28151000701",941,454,1489,691,55,0,0,0,3630
"28151000702",1868,106,1168,43,407,99,202,123,4016
"28151000800",1329,250,1399,525,20,10,6,8,3547
"28151000900",733,134,1020,1063,7,42,0,0,2999
"28151001000",9,8,567,474,4,33,8,0,1103
"28151001100",0,0,651,962,0,4,0,0,1617
"28151001200",0,0,1341,982,21,0,0,0,2344
"28151001300",119,7,1273,1081,41,0,23,0,2544
"28151001400",621,212,2206,1107,0,5,0,11,4162
"28151001500",2191,858,469,607,65,0,120,0,4310
"28151001600",480,162,544,656,89,17,50,0,1998
"28151001700",686,34,1011,1002,4,7,4,0,2748
"28151002000",223,38,674,505,0,0,0,0,1440
"28151002100",66,0,446,696,0,2,0,0,1210
"28153950100",2206,202,1416,1212,123,14,0,0,5173
"28153950200",1124,601,1105,1417,55,53,55,53,4463
"28153950300",3428,712,783,443,45,0,60,24,5495
"28153950400",3243,582,715,732,39,13,71,13,5408
"28155950100",3538,572,175,256,28,58,85,4,4716
"28155950200",2468,426,546,291,35,0,26,0,3792
"28155950300",625,250,200,388,75,11,6,0,1555
"28157950100",1417,76,1223,1207,0,0,0,0,3923
"28157950200",799,237,2633,885,0,0,0,0,4554
"28159950100",1559,391,645,227,26,0,0,6,2854
"28159950200",1658,223,1463,825,0,7,31,0,4207
"28159950300",1070,271,1069,1208,131,0,58,0,3807
"28159950400",1343,358,845,1285,9,0,9,34,3883
"28159950500",2283,401,728,372,0,0,52,0,3836
"28161950100",1874,334,721,314,17,5,18,15,3298
"28161950200",1741,492,807,655,40,2,15,47,3799
"28161950300",2459,404,1826,498,38,18,80,0,5323
"28163950100",1450,349,973,754,81,0,0,0,3607
"28163950200",885,46,1235,1069,0,0,0,4,3239
"28163950300",336,17,1919,2741,0,0,0,9,5022
"28163950400",1573,158,169,49,2,0,65,0,2016
"28163950500",331,71,1812,2118,16,74,0,0,4422
"28163950600",3374,1091,1410,322,55,0,0,0,6252
"29001950100",3205,547,4,0,45,17,3,0,3821
"29001950200",2451,476,0,0,67,0,13,0,3007
"29001950300",1622,1161,43,6,0,140,142,61,3175
"29001950400",3078,382,35,0,173,43,16,0,3727
"29001950500",4765,1502,99,77,30,281,110,120,6984
"29001950900",1000,1160,15,18,24,37,0,91,2345
"29001951000",15,27,20,18,0,10,0,0,90
"29003010100",5180,441,127,11,136,0,175,34,6104
"29003010200",5730,595,36,4,32,23,117,0,6537
"29003010300",1593,224,22,0,44,0,1,3,1887
"29003010400",2452,292,0,0,75,0,17,0,2836
"29005950100",2496,464,4,1,46,5,23,1,3040
"29005950200",2184,156,0,0,21,6,31,5,2403
"29007950100",1964,480,260,50,83,67,36,12,2952
"29007950200",3813,559,18,7,23,8,17,3,4448
"29007950300",2782,762,61,0,52,0,0,0,3657
"29007950400",2198,367,12,89,70,121,146,0,3003
"29007950500",2711,332,32,60,102,50,203,0,3490
"29007950600",2162,312,285,10,60,0,0,0,2829
"29007950700",2524,698,317,22,179,166,70,154,4130
"29009960100",4635,970,0,0,49,0,0,0,5654
"29009960200",5082,971,6,0,361,216,479,286,7401
"29009960300",3580,1171,0,1,670,513,810,688,7433
"29009960401",3254,719,0,0,184,93,41,38,4329
"29009960402",2321,591,0,0,158,116,221,26,3433
"29009960500",5199,974,0,0,85,123,147,132,6660
"29009960600",2417,556,5,0,77,7,23,10,3095
"29011960100",2554,415,0,2,82,118,56,126,3353
"29011960200",3003,673,0,0,76,50,13,31,3846
"29011960300",3620,1237,1,0,122,207,13,31,5231
"29013070100",4498,634,0,2,271,17,106,0,5528
"29013070200",3045,609,0,0,148,49,105,36,3992
"29013070300",2767,1388,11,35,20,56,12,63,4352
"29013070400",2227,514,4,2,20,21,2,0,2790
"29015460100",2873,723,0,0,14,0,103,12,3725
"29015460200",1782,579,7,0,30,4,26,0,2428
"29015460300",3440,711,7,4,51,28,76,0,4317
"29015460400",1529,269,0,0,78,0,0,0,1876
"29015460700",2055,421,6,7,53,56,0,0,2598
"29015460800",2993,748,9,0,67,122,101,0,4040
"29017950100",3567,1031,0,10,10,12,14,3,4647
"29017950200",3366,982,0,0,163,0,19,74,4604
"29017950300",2453,656,0,0,22,9,0,0,3140
"29019000200",872,357,23,0,79,50,60,6,1447
"29019000300",781,1585,0,82,110,125,4,62,2749
"29019000500",324,1027,46,0,184,300,28,48,1957
"29019000600",4194,303,0,0,294,47,128,0,4966
"29019000700",2148,683,536,104,58,341,80,261,4211
"29019000900",847,313,210,140,91,17,55,41,1714
"29019001001",2419,1471,44,154,229,185,66,28,4596
"29019001002",4022,729,111,174,827,91,333,0,6287
"29019001101",2710,3568,621,566,487,772,197,135,9056
"29019001103",5086,1053,425,27,324,74,112,0,7101
"29019001104",7473,1720,735,108,565,58,152,0,10811
"29019001201",4360,228,616,65,690,210,185,87,6441
"29019001202",4615,416,7,10,494,32,93,0,5667
"29019001300",1992,556,144,346,464,101,100,11,3714
"29019001400",8436,665,673,498,805,200,361,2,11640
"29019001502",3387,939,695,353,452,253,89,85,6253
"29019001503",1930,691,513,210,173,129,130,21,3797
"29019001504",5501,1300,982,710,468,165,416,29,9571
"29019001601",5364,807,892,202,389,405,224,22,8305
"29019001602",2900,125,56,119,72,0,85,0,3357
"29019001701",6504,719,12,16,198,0,14,0,7463
"29019001702",4040,311,50,19,162,2,60,0,4644
"29019001803",3676,341,140,68,425,8,232,46,4936
"29019001805",7556,240,876,186,672,12,268,0,9810
"29019001901",4474,270,28,0,71,8,46,0,4897
"29019001902",7267,646,45,0,368,0,192,17,8535
"29019002000",4226,658,84,1,58,13,7,0,5047
"29019002100",924,696,644,588,128,373,66,34,3453
"29019002200",170,531,6,70,132,223,19,11,1162
"29021000100",4900,487,30,56,338,0,516,0,6327
"29021000200",3938,265,6,0,50,46,76,46,4427
"29021000300",2444,604,0,0,103,69,117,23,3360
"29021000400",1216,466,60,17,129,0,27,0,1915
"29021000500",1993,356,64,19,299,11,234,53,3029
"29021000600",2827,259,37,3,118,110,170,109,3633
"29021000701",3057,80,0,185,42,0,70,0,3434
"29021000702",3106,843,185,207,160,142,93,140,4876
"29021000900",4045,460,60,23,82,0,171,23,4864
"29021001000",808,994,573,103,229,232,179,88,3206
"29021001100",1455,685,226,24,81,30,95,206,2802
"29021001200",949,359,74,64,31,195,16,114,1802
"29021001500",4054,780,156,0,179,186,102,0,5457
"29021001600",1715,181,441,49,118,0,129,0,2633
"29021001700",3385,674,47,9,51,49,343,0,4558
"29021001800",2069,847,15,67,112,45,88,41,3284
"29021002100",1753,285,242,39,272,61,159,0,2811
"29021002200",1784,109,34,0,9,8,60,8,2012
"29021002300",2217,343,4,0,21,0,198,0,2783
"29021002400",1403,319,146,8,63,120,127,26,2212
"29021002500",1431,528,43,16,118,5,131,157,2429
"29021002700",2810,214,14,78,90,195,117,0,3518
"29021002800",4671,427,31,0,105,47,202,0,5483
"29021002900",2593,294,0,0,19,0,32,0,2938
"29021003000",3900,1350,193,184,378,222,380,98,6705
"29023950100",4525,662,16,0,151,0,134,32,5520
"29023950201",3905,411,65,0,151,0,69,0,4601
"29023950202",5076,453,1,0,178,0,0,0,5708
"29023950300",5311,903,69,5,73,116,82,116,6675
"29023950400",1443,851,624,64,56,441,15,68,3562
"29023950500",1350,945,99,43,125,22,40,0,2624
"29023950600",3453,656,20,0,77,21,5,16,4248
"29023950700",1671,790,337,147,25,17,6,7,3000
"29023950800",1787,569,261,110,20,39,63,39,2888
"29023950900",2630,649,176,104,73,45,11,0,3688
"29025950100",2142,466,18,0,38,25,9,11,2709
"29025950200",5252,801,24,9,153,22,126,18,6405
"29027070100",4171,481,59,11,94,71,175,0,5062
"29027070200",2971,499,0,1,102,21,37,0,3631
"29027070300",3766,944,220,76,90,217,57,90,5460
"29027070400",2958,715,366,35,173,27,122,0,4396
"29027070500",4248,504,120,20,200,0,42,0,5134
"29027070600",5070,1218,56,14,149,6,92,22,6627
"29027070700",5618,402,86,21,249,16,58,0,6450
"29027070800",3811,645,12,20,203,13,22,0,4726
"29029950100",3395,595,0,0,66,0,10,47,4113
"29029950200",4552,1149,1,0,205,232,81,417,6637
"29029950300",1878,257,0,0,4,0,0,0,2139
"29029950400",3395,297,0,9,47,45,75,61,3929
"29029950500",2518,693,3,4,47,137,50,97,3549
"29029950600",3606,505,0,0,110,17,25,15,4278
"29029950700",2869,555,16,2,19,21,5,37,3524
"29029950800",6022,1407,0,6,101,95,9,44,7684
"29029950900",3069,711,0,0,0,0,2,44,3826
"29029951100",2366,191,0,0,10,10,20,10,2607
"29029951200",1728,303,44,17,49,0,10,0,2151
"29031880100",4883,501,0,0,52,0,79,0,5515
"29031880200",3960,60,0,0,8,0,51,0,4079
"29031880300",3790,278,31,0,42,10,3,0,4154
"29031880400",5853,594,95,224,144,0,216,22,7148
"29031880500",8465,1166,50,63,150,114,96,12,10116
"29031880600",4699,873,46,103,132,54,0,58,5965
"29031880700",3910,604,99,73,202,0,96,0,4984
"29031880800",898,553,97,191,85,151,66,45,2086
"29031880900",1301,187,205,229,152,149,66,26,2315
"29031881000",892,577,215,333,40,68,16,12,2153
"29031881100",2710,556,124,3,54,102,66,58,3673
"29031881200",5170,423,148,253,36,0,99,0,6129
"29031881300",4013,546,684,259,256,42,172,0,5972
"29031881400",1095,486,368,622,48,28,6,19,2672
"29031881500",3620,496,10,2,121,93,23,181,4546
"29031881600",1614,825,196,603,56,256,43,66,3659
"29033960100",1989,359,6,0,73,5,37,5,2474
"29033960200",2396,215,15,0,135,14,25,6,2806
"29033960300",3065,555,10,35,69,30,41,6,3811
"29035960100",2485,897,0,0,60,32,9,27,3510
"29035960200",2166,410,0,33,64,55,38,1,2767
"29037060001",3274,593,89,0,81,61,294,252,4644
"29037060003",2704,293,202,0,353,0,317,30,3899
"29037060004",4296,791,109,47,322,0,315,279,6159
"29037060100",1090,198,56,30,65,0,40,0,1479
"29037060202",4154,227,36,74,432,71,254,88,5336
"29037060301",7442,211,1191,111,199,45,175,43,9417
"29037060302",6210,709,82,0,207,47,162,0,7417
"29037060305",3996,46,444,0,204,0,153,0,4843
"29037060400",4391,99,88,0,101,0,180,8,4867
"29037060500",2616,141,10,2,61,17,67,0,2914
"29037060600",6382,988,0,16,375,0,125,179,8065
"29037060700",3004,349,17,0,95,41,50,8,3564
"29037060800",5346,350,0,0,56,0,135,0,5887
"29037060904",2461,317,0,77,51,6,0,2,2914
"29037061001",3990,248,111,0,240,27,60,0,4676
"29037061002",6172,644,3,1,113,206,214,10,7363
"29037061100",3702,205,0,0,76,51,80,3,4117
"29037061200",3408,423,9,0,88,14,72,22,4036
"29037061300",3806,788,860,0,174,0,132,0,5760
"29037061400",4432,855,1,23,12,35,273,43,5674
"29039870100",4666,764,0,1,66,4,48,1,5550
"29039870200",2922,1568,1,0,182,63,0,0,4736
"29039870300",2470,718,3,0,51,52,22,14,3330
"29041470100",1789,381,0,2,10,1,5,1,2189
"29041470200",1964,375,37,46,19,20,28,11,2500
"29041470300",2319,372,24,58,51,5,16,0,2845
"29043020101",2624,220,80,0,94,0,19,0,3037
"29043020102",4511,480,40,0,166,46,44,12,5299
"29043020201",4103,136,0,0,0,0,0,0,4239
"29043020202",5331,762,0,0,191,0,372,0,6656
"29043020203",5118,740,0,0,368,196,79,134,6635
"29043020204",3269,728,33,2,172,0,53,50,4307
"29043020205",5618,868,46,0,190,61,371,0,7154
"29043020302",5043,441,0,1,136,72,146,0,5839
"29043020303",4607,710,49,0,0,0,194,0,5560
"29043020304",2323,530,28,2,31,94,42,75,3125
"29043020305",5546,405,25,103,102,126,19,31,6357
"29043020306",7084,314,39,28,68,51,368,42,7994
"29043020400",6714,617,9,0,122,6,30,0,7498
"29043020500",6357,647,0,0,217,40,56,3,7320
"29045950100",1751,262,0,0,42,20,0,13,2088
"29045950200",1877,356,0,12,10,3,0,0,2258
"29045950300",2097,428,0,0,19,32,0,20,2596
"29047020201",2950,435,293,375,680,210,243,29,5215
"29047020202",3156,243,21,9,266,48,337,0,4080
"29047020300",4173,588,228,178,555,337,480,154,6693
"29047020400",1700,101,216,28,486,7,369,30,2937
"29047020500",3662,957,53,284,197,104,272,101,5630
"29047020602",2638,565,425,619,216,107,234,136,4940
"29047020603",2891,468,211,0,88,41,286,120,4105
"29047020604",3340,325,284,24,704,59,447,60,5243
"29047020801",5157,816,49,0,467,99,173,107,6868
"29047020901",4696,120,115,2,310,0,322,0,5565
"29047020902",1955,80,232,8,156,25,267,8,2731
"29047021001",2672,363,26,154,143,237,112,234,3941
"29047021003",3276,377,70,0,149,34,185,22,4113
"29047021004",2430,337,195,9,114,7,57,39,3188
"29047021101",3462,650,169,0,151,135,154,269,4990
"29047021102",5696,452,312,42,182,0,417,34,7135
"29047021103",3060,204,127,33,202,29,193,10,3858
"29047021204",3007,668,544,41,350,295,251,290,5446
"29047021205",5241,208,561,116,749,17,473,0,7365
"29047021206",5939,80,200,22,731,0,504,0,7476
"29047021207",2167,225,304,75,223,133,261,46,3434
"29047021208",3909,692,676,236,593,0,689,253,7048
"29047021303",2740,273,140,13,128,57,69,0,3420
"29047021305",5791,390,433,71,695,0,468,0,7848
"29047021306",6455,107,422,0,316,0,603,0,7903
"29047021307",4329,140,533,204,504,187,356,116,6369
"29047021309",3984,42,154,0,263,34,105,0,4582
"29047021310",6594,293,216,0,527,0,504,0,8134
"29047021401",2951,397,305,12,96,0,17,82,3860
"29047021403",2283,184,83,0,92,0,119,9,2770
"29047021404",3921,343,253,63,45,73,60,53,4811
"29047021600",7145,497,66,130,315,32,194,37,8416
"29047021701",4966,203,91,0,268,29,184,0,5741
"29047021702",4618,1276,249,109,113,34,79,3,6481
"29047021803",6780,31,215,0,619,0,272,0,7917
"29047021804",6359,46,0,0,102,0,11,4,6522
"29047021805",7881,223,19,0,468,59,300,17,8967
"29047021806",3486,344,0,0,66,7,16,0,3919
"29047021900",5676,187,39,0,183,0,162,0,6247
"29047022000",4146,447,0,0,280,17,234,2,5126
"29047022100",3079,300,187,0,777,58,493,125,5019
"29047022200",3104,187,154,133,241,16,274,0,4109
"29047022301",2423,271,66,0,113,9,55,63,3000
"29047022302",5168,320,102,0,173,0,397,11,6171
"29049960100",4082,656,44,12,57,63,10,4,4928
"29049960200",6023,317,24,44,132,48,158,8,6754
"29049960300",3602,296,161,17,185,5,153,0,4419
"29049960400",3660,506,12,0,30,10,27,9,4254
"29051010300",3965,298,126,576,197,4,0,43,5209
"29051010400",4927,659,122,561,198,0,58,0,6525
"29051010500",1915,612,759,509,254,97,39,103,4288
"29051010600",1756,693,275,205,347,217,148,0,3641
"29051010701",4192,318,371,39,454,0,253,0,5627
"29051010702",4456,285,413,156,149,223,14,0,5696
"29051010800",7093,672,652,1,181,216,260,234,9309
"29051010900",5431,265,379,57,125,56,38,0,6351
"29051020198",3859,85,0,2,36,0,15,0,3997
"29051020200",3727,169,0,0,51,36,5,0,3988
"29051020300",3320,329,0,0,58,5,0,0,3712
"29051020400",4280,314,537,127,446,35,255,110,6104
"29051020500",2136,398,0,0,69,3,18,0,2624
"29051020600",3414,446,27,157,204,0,157,20,4425
"29051020700",607,470,435,381,108,108,33,23,2165
"29053950100",2594,509,5,2,55,4,1,1,3171
"29053950200",1276,291,96,84,45,23,70,7,1892
"29053950300",2913,562,60,58,280,0,86,0,3959
"29053950400",1682,232,72,43,58,107,14,12,2220
"29053950500",3988,712,17,0,175,5,5,1,4903
"29055450101",1831,478,0,1,40,1,19,45,2415
"29055450102",4325,1420,9,14,58,0,93,0,5919
"29055450200",3164,755,13,2,208,2,15,63,4222
"29055450301",2222,548,0,0,0,31,69,0,2870
"29055450302",3208,909,0,0,0,36,0,66,4219
"29055450400",3594,1264,7,0,91,22,26,0,5004
"29057480100",3306,923,1,0,109,45,41,80,4505
"29057480200",2362,639,10,12,85,44,0,7,3159
"29059480100",3475,950,2,4,116,213,30,21,4811
"29059480200",3920,884,0,0,162,46,104,11,5127
"29059480300",4935,1548,0,0,95,85,113,9,6785
"29061470100",2691,464,2,0,41,2,26,9,3235
"29061470200",4003,801,4,0,82,30,48,18,4986
"29063080100",4409,710,19,16,180,12,6,76,5428
"29063080200",3587,270,8,10,46,4,16,5,3946
"29065960100",3841,611,0,0,122,8,10,0,4592
"29065960200",4156,877,0,0,255,69,80,51,5488
"29065960300",1239,883,58,0,4,7,0,13,2204
"29065960400",2581,579,0,0,15,61,33,0,3269
"29067950100",2821,786,0,0,31,0,0,27,3665
"29067950200",4243,1134,0,0,65,0,23,9,5474
"29067950500",3186,925,0,0,105,16,68,9,4309
"29069360100",1021,381,749,314,28,126,0,0,2619
"29069360200",1868,395,194,147,31,58,108,21,2822
"29069360300",2910,1083,0,27,12,20,33,33,4118
"29069360400",3168,756,65,168,27,104,199,91,4578
"29069360500",1713,423,397,161,0,13,15,67,2789
"29069360600",2398,1486,230,188,126,21,146,243,4838
"29069360700",2478,573,355,119,116,0,89,0,3730
"29069360800",1467,540,7,0,20,231,292,366,2923
"29069360900",1768,317,82,11,34,5,36,24,2277
"29069361000",1421,592,0,0,11,12,18,83,2137
"29071800100",7890,971,63,0,154,0,89,0,9167
"29071800201",4150,524,45,153,127,245,0,245,5489
"29071800202",5641,173,0,0,217,0,88,0,6119
"29071800300",6492,503,63,52,127,0,132,66,7435
"29071800401",4708,366,14,0,151,18,394,7,5658
"29071800402",5676,678,0,21,0,0,97,0,6472
"29071800500",6347,693,0,0,56,0,75,0,7171
"29071800601",6121,1174,0,0,104,0,80,0,7479
"29071800602",7420,516,0,0,192,0,49,18,8195
"29071800701",5235,1006,447,48,109,0,82,0,6927
"29071800702",2853,109,19,9,101,0,17,0,3108
"29071800800",6042,1015,64,0,111,3,0,0,7235
"29071800901",2487,513,0,0,159,0,50,0,3209
"29071800902",4970,1275,93,5,149,74,0,0,6566
"29071801000",2990,640,0,0,78,0,23,0,3731
"29071801101",3075,1114,26,0,9,8,9,0,4241
"29071801102",3140,698,0,0,13,0,0,12,3863
"29073960100",2154,345,36,0,11,0,0,10,2556
"29073960200",1697,139,0,0,17,5,6,0,1864
"29073960300",2636,314,0,0,34,67,24,0,3075
"29073960400",2264,668,0,13,48,0,18,0,3011
"29073960500",3481,669,12,0,23,20,22,100,4327
"29075960100",2617,399,13,28,41,11,8,0,3117
"29075960200",2812,611,0,1,28,16,23,0,3491
"29077000100",509,520,55,112,11,50,11,55,1323
"29077000200",151,650,20,30,48,198,20,48,1165
"29077000300",2165,682,0,0,130,86,128,52,3243
"29077000400",1803,1609,53,196,222,100,146,169,4298
"29077000501",1179,806,65,94,143,67,37,32,2423
"29077000502",1369,1192,118,205,121,236,21,18,3280
"29077000600",1408,735,26,105,66,13,30,28,2411
"29077000700",1481,974,189,203,108,19,53,38,3065
"29077000800",1288,530,58,70,29,41,33,27,2076
"29077000900",2811,1188,71,126,160,384,64,55,4859
"29077001000",1870,170,10,0,46,11,36,0,2143
"29077001100",2227,497,82,22,275,71,152,6,3332
"29077001200",2925,646,87,21,137,70,81,253,4220
"29077001301",1749,385,13,0,15,3,110,43,2318
"29077001302",1341,538,6,65,185,22,289,37,2483
"29077001400",2834,1090,132,21,239,173,161,72,4722
"29077001500",3163,1027,310,0,422,229,225,75,5451
"29077001700",1714,719,132,41,95,95,38,15,2849
"29077001800",1976,788,48,27,61,69,19,36,3024
"29077001900",1709,1090,55,70,142,60,30,103,3259
"29077002200",2966,643,116,11,273,338,128,338,4813
"29077002300",3508,1680,10,42,147,227,32,66,5712
"29077002402",3017,555,83,43,273,35,78,35,4119
"29077002502",3736,1033,233,60,249,88,22,40,5461
"29077002600",4393,155,41,0,75,0,73,0,4737
"29077002700",1754,319,44,0,271,21,56,0,2465
"29077002800",1505,217,14,4,83,0,125,88,2036
"29077002900",3580,299,77,15,208,0,74,15,4268
"29077003002",3330,1017,424,39,344,89,58,75,5376
"29077003100",1509,834,189,0,33,27,15,53,2660
"29077003200",2744,894,90,134,184,138,211,30,4425
"29077003300",2026,1478,0,256,192,84,12,58,4106
"29077003600",1496,1269,25,80,80,172,41,362,3525
"29077003700",6359,512,25,0,350,0,216,18,7480
"29077003800",6519,194,0,0,409,0,58,0,7180
"29077003900",2255,362,51,68,48,0,36,7,2827
"29077004001",3892,704,87,0,224,33,56,21,5017
"29077004002",2968,205,53,2,235,0,64,0,3527
"29077004003",4363,384,60,0,177,36,87,0,5107
"29077004101",7355,456,196,0,302,70,191,0,8570
"29077004102",6456,385,173,0,319,0,127,0,7460
"29077004103",5660,773,90,0,722,0,25,0,7270
"29077004201",4367,486,36,0,153,0,51,23,5116
"29077004202",4554,893,71,0,509,194,164,115,6500
"29077004301",6094,433,85,101,224,194,341,0,7472
"29077004302",2816,518,86,0,171,59,72,0,3722
"29077004400",4768,1523,284,35,118,32,235,0,6995
"29077004500",2314,143,43,0,71,28,79,0,2678
"29077004600",6359,668,61,7,126,1,151,8,7381
"29077004700",4417,520,0,0,171,0,0,0,5108
"29077004801",5560,955,0,0,245,0,139,16,6915
"29077004802",6553,578,0,0,230,32,234,0,7627
"29077004803",3388,902,11,0,91,0,7,0,4399
"29077004900",5555,373,0,0,119,0,0,0,6047
"29077005001",3078,500,13,0,100,23,106,26,3846
"29077005002",5575,508,138,2,176,14,261,19,6693
"29077005100",2818,396,0,0,70,0,64,0,3348
"29077005200",5373,804,22,0,125,53,29,47,6453
"29077005500",2361,754,362,127,112,7,31,5,3759
"29077005600",2639,712,46,33,120,61,160,0,3771
"29077005700",2559,1039,22,12,191,88,67,118,4096
"29077005800",2848,1603,74,113,105,89,172,18,5022
"29079960100",1781,203,1,0,17,12,3,0,2017
"29079960200",1771,372,2,0,45,6,45,0,2241
"29079960300",1823,356,17,39,148,17,0,39,2439
"29079960400",2579,718,4,6,21,15,3,28,3374
"29081950100",2977,673,0,1,17,13,9,9,3699
"29081950200",1669,239,17,2,8,0,8,0,1943
"29081950300",2482,372,0,22,81,3,136,0,3096
"29083950100",2336,405,103,0,7,28,0,0,2879
"29083950200",2767,815,0,0,89,16,58,0,3745
"29083950300",2992,407,0,0,15,55,58,37,3564
"29083950400",2307,419,5,4,51,0,119,0,2905
"29083950500",2625,813,53,6,89,33,117,30,3766
"29083950600",3923,902,76,33,41,51,0,0,5026
"29085470100",2080,658,0,2,31,2,19,3,2795
"29085470300",2128,309,0,0,40,2,58,0,2537
"29085470500",2728,1106,0,0,45,148,33,2,4062
"29087960100",1002,210,0,1,4,7,2,1,1227
"29087960200",1424,195,0,0,57,2,5,2,1685
"29087960300",1481,133,6,0,30,8,3,0,1661
"29089960100",2367,352,65,30,73,14,23,24,2948
"29089960200",2859,459,46,3,26,74,35,15,3517
"29089960300",2028,684,279,10,119,5,37,0,3162
"29091090100",4248,1347,0,15,173,9,79,0,5871
"29091090200",3003,996,0,0,47,39,54,20,4159
"29091090300",3382,949,5,0,88,27,7,27,4485
"29091090400",3422,744,0,0,204,23,57,0,4450
"29091090500",4143,631,14,7,86,34,50,0,4965
"29091090600",3884,900,0,0,34,55,67,0,4940
"29091090700",2775,2027,0,0,108,193,0,217,5320
"29091090800",4719,1003,59,0,263,63,0,157,6264
"29093950100",2349,344,0,0,45,2,69,22,2831
"29093950200",1673,463,28,1,71,30,28,0,2294
"29093950300",1944,775,31,14,15,37,17,8,2841
"29093950400",1549,418,8,81,6,20,0,0,2082
"29095000300",554,124,145,398,206,339,60,87,1913
"29095000600",1163,1139,14,102,831,754,1274,1268,6545
"29095000700",1128,654,296,216,694,527,713,835,5063
"29095000800",1286,341,297,92,1176,255,1132,278,4857
"29095000900",945,183,131,215,906,384,645,393,3802
"29095001000",861,99,485,644,681,154,668,115,3707
"29095001100",909,217,294,87,96,36,144,46,1829
"29095001800",366,396,407,386,541,236,360,404,3096
"29095001900",865,295,532,274,472,340,809,215,3802
"29095002000",517,187,12,95,894,671,652,696,3724
"29095002100",554,761,367,796,790,336,920,755,5279
"29095002200",411,410,421,358,692,264,544,551,3651
"29095002300",472,144,502,261,56,227,306,212,2180
"29095003400",288,252,504,783,413,61,544,101,2946
"29095003700",43,32,431,523,2,0,43,23,1097
"29095003800",15,29,1079,613,9,53,34,46,1878
"29095004300",1063,297,255,375,147,30,134,7,2308
"29095004400",674,87,62,24,62,74,34,0,1017
"29095004600",1813,323,78,53,301,57,548,25,3198
"29095005100",895,127,119,96,95,226,162,277,1997
"29095005200",137,103,314,463,28,57,114,97,1313
"29095005300",190,35,550,211,64,28,26,5,1109
"29095005400",15,6,303,409,0,0,0,0,733
"29095005500",0,35,459,284,0,17,15,11,821
"29095005601",91,0,1046,575,44,166,6,110,2038
"29095005602",6,4,849,814,27,35,27,34,1796
"29095005700",98,0,1430,554,92,49,0,0,2223
"29095005801",36,95,940,439,94,75,82,111,1872
"29095006000",58,71,731,293,90,113,13,91,1460
"29095006100",132,75,900,1064,249,7,31,21,2479
"29095006300",19,58,1035,664,45,0,51,26,1898
"29095006500",1006,183,270,221,107,16,119,0,1922
"29095006600",984,170,74,6,219,43,136,8,1640
"29095006700",838,285,206,98,274,71,235,80,2087
"29095006900",894,76,37,0,80,20,45,0,1152
"29095007100",1915,471,43,10,293,28,295,9,3064
"29095007200",1705,181,58,0,175,0,35,0,2154
"29095007300",2473,363,181,0,171,110,20,33,3351
"29095007400",2197,453,68,36,167,124,59,10,3114
"29095007500",451,472,762,363,127,49,9,57,2290
"29095007600",95,133,1190,563,25,37,0,0,2043
"29095007700",7,17,943,679,10,41,0,0,1697
"29095007802",94,19,1501,452,234,26,234,0,2560
"29095007900",99,31,2326,840,282,0,91,0,3669
"29095008000",60,138,1766,679,132,187,160,74,3196
"29095008100",175,46,1236,374,44,19,27,0,1921
"29095008200",2403,205,212,10,208,52,63,8,3161
"29095008300",2156,32,52,0,108,7,30,7,2392
"29095008400",2728,0,0,0,94,0,35,0,2857
"29095008500",3123,137,54,0,138,0,69,0,3521
"29095008600",4627,214,176,0,160,0,147,10,5334
"29095008700",258,60,1199,550,122,0,49,14,2252
"29095008800",134,53,2062,947,95,0,96,17,3404
"29095008900",33,4,1222,864,16,5,14,0,2158
"29095009000",739,74,2620,786,321,0,160,9,4709
"29095009100",3121,241,349,58,208,0,185,0,4162
"29095009200",2296,157,193,46,85,8,141,8,2934
"29095009300",2012,192,77,2,145,0,94,8,2530
"29095009400",2469,572,665,356,419,83,102,92,4758
"29095009500",669,331,1215,678,102,8,9,13,3025
"29095009600",249,114,546,1102,89,116,25,102,2343
"29095009700",302,56,483,299,105,33,76,33,1387
"29095009800",2183,301,708,143,197,0,108,0,3640
"29095009900",1557,158,169,45,51,138,32,104,2254
"29095010001",1380,39,249,65,65,0,27,0,1825
"29095010002",1382,119,1379,100,185,95,54,23,3337
"29095010103",909,68,1009,134,189,0,91,0,2400
"29095010105",2837,73,275,0,161,118,129,0,3593
"29095010201",649,233,604,726,70,55,22,12,2371
"29095010203",2555,205,1407,139,231,7,208,0,4752
"29095010204",2298,588,548,611,1084,329,793,185,6436
"29095010500",1610,326,1368,804,412,197,447,253,5417
"29095010600",2084,332,617,0,145,65,329,0,3572
"29095010702",1285,132,919,888,122,24,165,27,3562
"29095011000",2741,1379,203,13,85,107,170,46,4744
"29095011100",2329,594,26,0,222,13,132,49,3365
"29095011200",2385,596,113,4,40,86,196,41,3461
"29095011300",3084,990,164,276,314,54,163,3,5048
"29095011401",6106,1363,351,299,496,115,647,620,9997
"29095011405",1209,1209,333,196,228,249,269,215,3908
"29095011406",4434,490,116,75,592,68,579,82,6436
"29095011500",3119,1069,207,541,394,152,354,186,6022
"29095011600",3086,875,186,62,232,21,185,0,4647
"29095011700",2857,440,400,167,30,93,170,139,4296
"29095011800",3128,987,229,304,270,332,365,245,5860
"29095011900",2442,419,53,45,260,214,249,148,3830
"29095012000",2273,412,138,31,302,24,332,12,3524
"29095012100",3371,1074,482,59,645,226,576,355,6788
"29095012200",4735,340,386,0,354,104,216,43,6178
"29095012300",2767,268,103,4,62,9,8,9,3230
"29095012400",3124,236,214,83,626,151,370,142,4946
"29095012501",1867,548,845,56,74,126,164,118,3798
"29095012502",1832,130,533,18,115,11,162,6,2807
"29095012600",2941,290,1113,118,393,0,299,0,5154
"29095012701",4355,360,1319,294,258,7,468,7,7068
"29095012802",2205,87,1148,26,100,6,283,0,3855
"29095012803",1220,68,383,100,7,14,97,0,1889
"29095012804",2970,186,1813,685,279,268,158,64,6423
"29095012903",1027,228,1752,382,314,28,286,8,4025
"29095012904",962,209,1164,77,179,0,10,0,2601
"29095012906",1401,143,2095,449,422,41,121,11,4683
"29095013003",1101,209,3174,837,152,217,490,58,6238
"29095013100",695,219,1336,268,254,277,105,200,3354
"29095013203",921,280,1554,986,198,249,305,128,4621
"29095013208",459,44,1310,855,131,26,242,25,3092
"29095013210",463,47,1497,298,141,77,148,61,2732
"29095013301",2513,250,470,55,392,188,235,188,4291
"29095013307",407,140,1579,186,515,10,416,22,3275
"29095013309",1451,186,2136,293,195,64,197,0,4522
"29095013313",2778,248,1049,356,595,100,517,132,5775
"29095013401",1048,501,683,142,285,248,575,467,3949
"29095013405",965,436,180,579,81,10,171,158,2580
"29095013407",2172,84,106,15,78,0,0,0,2455
"29095013408",3489,244,1014,116,539,0,265,0,5667
"29095013410",1806,538,435,231,139,35,145,22,3351
"29095013416",1034,54,1028,142,138,0,83,0,2479
"29095013502",4617,376,102,17,401,39,157,0,5709
"29095013504",2764,195,291,8,162,0,342,94,3856
"29095013606",1301,20,60,0,29,0,18,0,1428
"29095013608",4781,270,171,256,101,0,67,13,5659
"29095013612",4668,139,650,70,1075,0,355,0,6957
"29095013703",3262,770,225,484,165,85,31,19,5041
"29095013704",5288,321,297,48,277,0,224,22,6477
"29095013801",3573,571,618,0,369,33,120,0,5284
"29095013802",7621,190,600,76,479,43,537,0,9546
"29095013901",6154,190,0,0,136,0,135,0,6615
"29095013902",949,124,21,2,57,1,33,0,1187
"29095013904",5664,175,508,0,414,94,252,0,7107
"29095013916",4738,103,465,0,356,18,90,0,5770
"29095014002",1593,107,0,0,22,0,6,0,1728
"29095014004",2209,460,13,1,61,4,164,13,2925
"29095014005",4944,249,49,0,60,0,585,0,5887
"29095014006",5065,304,316,2,553,44,453,57,6794
"29095014007",4454,934,54,53,120,12,203,0,5830
"29095014101",5119,793,584,14,262,178,167,69,7186
"29095014105",6405,356,395,0,462,0,350,0,7968
"29095014108",4350,506,520,294,480,0,430,0,6580
"29095014111",2546,57,119,11,230,109,103,0,3175
"29095014112",701,2,15,25,10,0,26,0,779
"29095014114",5612,749,564,81,360,142,23,18,7549
"29095014120",2341,419,64,0,270,44,135,335,3608
"29095014203",3496,54,223,0,208,20,138,0,4139
"29095014204",6113,307,704,322,398,11,219,34,8108
"29095014300",3516,320,1189,164,311,17,0,60,5577
"29095014400",1472,158,751,64,85,8,17,8,2563
"29095014501",3174,182,419,39,273,0,187,11,4285
"29095014502",3991,92,101,0,153,0,56,17,4410
"29095014601",4106,219,225,71,311,16,316,24,5288
"29095014603",2910,388,60,0,142,30,74,63,3667
"29095014604",2875,555,221,48,752,111,821,0,5383
"29095014701",2590,279,283,194,125,0,117,9,3597
"29095014702",4248,205,88,33,512,0,409,0,5495
"29095014804",2458,139,26,0,143,0,132,0,2898
"29095014806",3624,129,160,0,274,10,157,23,4377
"29095014902",1458,348,7,0,81,12,51,30,1987
"29095014903",4658,59,2,0,63,12,235,0,5029
"29095014904",5100,318,252,83,277,53,216,80,6379
"29095014905",4277,91,156,0,106,0,80,0,4710
"29095015000",3216,356,36,6,131,7,94,48,3894
"29095015100",4818,666,267,7,291,21,223,158,6451
"29095015200",1121,199,176,103,146,29,92,0,1866
"29095015300",1103,318,95,337,701,706,1173,920,5353
"29095015400",171,322,776,1729,27,453,32,262,3772
"29095015500",564,274,0,16,107,249,125,324,1659
"29095015600",991,456,0,183,209,73,272,73,2257
"29095015700",1537,178,175,41,144,29,65,12,2181
"29095015800",1070,88,40,44,31,8,103,16,1400
"29095015900",460,128,47,144,134,69,57,17,1056
"29095016000",108,156,508,211,494,206,380,256,2319
"29095016100",27,14,1326,406,36,36,17,18,1880
"29095016200",101,89,621,276,76,24,49,18,1254
"29095016300",371,629,550,387,313,240,306,229,3025
"29095016400",101,298,930,329,150,347,134,329,2618
"29095016500",79,35,1021,355,11,48,64,60,1673
"29095016600",104,118,661,442,87,41,102,33,1588
"29095016700",1692,230,434,105,310,51,285,19,3126
"29095016800",2419,512,184,179,323,46,372,43,4078
"29095016900",25,4,1264,705,65,29,26,61,2179
"29095017000",813,464,519,172,121,188,33,325,2635
"29095017100",113,12,3033,499,31,38,0,0,3726
"29095017200",1478,142,2123,361,187,175,228,158,4852
"29095017300",2797,119,402,16,147,47,52,11,3591
"29095017400",409,239,1221,221,214,125,143,12,2584
"29095017500",841,111,457,147,90,31,70,0,1747
"29095017600",3153,125,1389,160,185,0,150,0,5162
"29095017700",4692,264,129,0,340,12,471,70,5978
"29095017800",1008,310,227,574,232,227,249,145,2972
"29095017900",3511,222,470,32,233,97,114,0,4679
"29095018000",2515,437,219,9,224,11,272,17,3704
"29095018100",5194,235,484,40,619,0,73,30,6675
"29095018200",2479,53,344,7,251,28,196,6,3364
"29095018500",2572,134,243,9,511,0,228,0,3697
"29095018600",2809,34,0,0,187,0,33,0,3063
"29095019300",4219,345,543,98,254,113,130,16,5718
"29095980101",0,0,0,0,0,0,0,0,0
"29095980802",0,0,0,0,0,0,0,0,0
"29095988300",37,0,0,0,0,0,0,0,37
"29095989100",7,0,5,0,0,0,0,0,12
"29095989200",0,0,0,0,0,0,0,0,0
"29097010100",2039,709,158,108,385,58,11,37,3505
"29097010200",3715,692,51,0,255,15,75,34,4837
"29097010300",4665,881,112,96,440,131,539,51,6915
"29097010400",3617,510,13,58,354,2,81,5,4640
"29097010500",4455,688,78,50,319,83,377,0,6050
"29097010600",3408,548,72,164,130,154,251,123,4850
"29097010700",2061,371,0,46,113,362,102,123,3178
"29097010800",2404,486,62,64,549,160,213,142,4080
"29097010900",5322,651,93,0,357,78,26,0,6527
"29097011000",2124,1356,168,353,161,65,65,39,4331
"29097011100",1589,222,23,0,66,29,87,4,2020
"29097011200",5543,670,0,2,414,0,63,0,6692
"29097011300",6998,1192,47,0,404,90,135,0,8866
"29097011400",4292,682,0,59,188,20,35,14,5290
"29097011500",8075,1269,31,6,150,55,373,161,10120
"29097011600",2518,1528,35,55,411,363,685,1504,7099
"29097011700",4907,1618,77,32,53,135,647,1090,8559
"29097011800",3162,757,34,25,201,0,514,281,4974
"29097011900",3102,511,0,63,186,34,56,2,3954
"29097012000",3697,626,0,0,78,47,13,21,4482
"29097012100",2869,299,10,0,260,58,157,19,3672
"29097012200",6188,882,53,2,212,39,149,21,7546
"29099700107",2522,122,154,0,106,0,66,0,2970
"29099700109",11623,741,0,14,352,13,39,14,12796
"29099700110",7019,476,0,0,186,0,218,0,7899
"29099700111",3669,665,0,11,85,34,74,0,4538
"29099700113",3031,262,0,0,49,18,20,8,3388
"29099700114",3911,596,18,0,67,3,57,104,4756
"29099700115",4169,266,0,0,132,0,243,0,4810
"29099700116",2755,174,13,0,123,12,50,0,3127
"29099700117",6360,285,0,0,214,4,107,71,7041
"29099700118",5288,431,11,0,205,80,108,0,6123
"29099700119",2044,175,94,0,37,0,15,11,2376
"29099700203",4647,617,32,108,263,79,117,0,5863
"29099700206",4200,1006,0,46,34,34,83,30,5433
"29099700207",3138,537,47,0,80,0,62,0,3864
"29099700208",4904,981,77,39,234,15,102,0,6352
"29099700209",3402,52,0,6,83,0,153,0,3696
"29099700210",3161,399,15,0,223,14,127,14,3953
"29099700211",4328,493,0,0,95,0,14,30,4960
"29099700302",4912,543,0,0,145,4,47,0,5651
"29099700303",4190,298,50,0,103,58,246,12,4957
"29099700304",6422,713,0,0,106,77,67,0,7385
"29099700401",3670,477,0,0,23,0,0,0,4170
"29099700402",5607,401,0,3,221,0,218,1,6451
"29099700502",4785,586,0,0,158,10,202,1,5742
"29099700503",3098,482,0,0,22,0,0,26,3628
"29099700504",4099,655,0,0,52,9,41,0,4856
"29099700601",4945,1044,114,0,201,30,86,0,6420
"29099700603",5249,736,29,54,30,0,52,46,6196
"29099700604",5361,498,0,25,61,16,21,20,6002
"29099700605",5640,542,0,2,42,0,53,32,6311
"29099700700",3646,535,67,38,162,162,65,0,4675
"29099700801",4585,398,74,92,151,16,83,0,5399
"29099700802",3164,523,28,237,165,162,0,0,4279
"29099700900",4231,627,158,3,69,0,0,0,5088
"29099701000",7417,667,0,0,182,16,248,8,8538
"29099701101",3583,346,34,0,27,0,33,0,4023
"29099701102",4565,904,2,0,31,28,42,0,5572
"29099701200",4232,1186,74,0,48,104,8,92,5744
"29099701300",2606,652,80,0,36,38,13,0,3425
"29099701401",3279,253,16,0,21,0,0,0,3569
"29099701403",3593,549,0,0,40,0,4,16,4202
"29099701404",5001,687,0,0,105,50,0,0,5843
"29101960100",7614,791,179,67,186,5,95,0,8937
"29101960200",4050,721,64,6,145,38,53,92,5169
"29101960300",7301,777,255,22,413,16,455,26,9265
"29101960400",1627,1421,135,171,184,185,85,52,3860
"29101960500",5278,1003,240,46,632,148,120,0,7467
"29101960600",1943,1188,105,155,25,84,66,44,3610
"29101960700",4124,767,358,19,504,82,308,56,6218
"29101960900",3804,790,15,1,94,16,52,7,4779
"29101980000",1153,90,181,0,244,10,143,0,1821
"29103960100",1504,292,0,32,7,10,4,0,1849
"29103960200",1487,585,9,6,37,23,12,0,2159
"29105960100",6808,1453,49,0,242,58,332,39,8981
"29105960298",4862,456,0,0,81,12,53,0,5464
"29105960300",5905,1029,0,0,107,39,65,0,7145
"29105960400",2521,824,0,0,140,28,31,22,3566
"29105960500",4040,1090,0,54,241,46,59,118,5648
"29105960600",3034,1582,0,0,162,94,37,0,4909
"29107090100",4322,611,41,24,138,67,44,98,5345
"29107090200",4530,548,326,35,103,118,0,161,5821
"29107090300",1088,183,64,1,51,0,31,31,1449
"29107090400",5675,733,109,2,57,98,107,82,6863
"29107090500",3362,235,0,1,184,1,33,14,3830
"29107090601",5074,452,0,0,160,1,147,25,5859
"29107090602",3462,310,25,2,85,25,21,0,3930
"29109470100",3297,470,0,0,54,13,88,0,3922
"29109470200",6160,985,23,1,107,0,324,216,7816
"29109470300",4292,856,0,1,76,53,257,120,5655
"29109470400",5407,1222,8,0,285,377,435,364,8098
"29109470500",4552,1455,0,8,126,106,59,60,6366
"29109470601",3981,577,0,0,152,113,314,0,5137
"29109470602",1966,603,0,1,143,74,273,15,3075
"29111970100",2522,317,15,4,29,47,4,0,2938
"29111970200",1833,320,9,28,5,0,11,0,2206
"29111970300",2273,114,0,1,68,2,146,0,2604
"29111970400",1398,167,103,42,107,46,4,0,1867
"29113810100",3095,452,7,103,26,8,52,24,3767
"29113810201",5169,1370,5,8,196,46,105,90,6989
"29113810202",5627,459,17,0,76,0,15,0,6194
"29113810301",6498,1440,378,0,243,111,197,143,9010
"29113810303",7498,728,303,25,182,94,107,0,8937
"29113810304",7592,1945,204,61,81,151,8,0,10042
"29113810400",7103,776,9,0,396,149,201,155,8789
"29115490100",1402,355,5,0,6,5,16,9,1798
"29115490200",1843,430,0,0,37,15,36,12,2373
"29115490300",2429,137,20,0,162,4,41,4,2797
"29115490400",1808,909,32,7,87,38,25,14,2920
"29115490500",2249,305,1,0,5,36,14,36,2646
"29117480100",2413,463,3,27,41,74,40,2,3063
"29117480200",2812,403,0,14,86,10,6,0,3331
"29117480300",2632,348,0,16,7,0,30,17,3050
"29117480400",2235,337,0,0,59,0,67,0,2698
"29117480500",1154,436,41,0,53,29,0,0,1713
"29119070100",4921,820,0,0,328,84,172,0,6325
"29119070200",3428,853,0,6,184,253,91,50,4865
"29119070300",3252,1437,128,130,434,116,958,755,7210
"29119070400",4408,1070,15,2,575,130,403,153,6756
"29121960100",1862,411,0,2,14,7,7,1,2304
"29121960200",2006,539,3,0,14,8,1,0,2571
"29121960300",3023,666,26,12,42,57,31,9,3866
"29121960400",3095,512,17,28,64,25,21,13,3775
"29121960500",1789,448,271,138,34,52,70,21,2823
"29123960100",2678,640,45,0,131,23,0,12,3529
"29123960200",3685,1400,0,0,92,25,227,0,5429
"29123960300",3093,326,0,0,0,0,5,0,3424
"29125880100",1978,805,0,32,0,12,5,27,2859
"29125880298",2461,236,0,0,72,0,0,0,2769
"29125880300",2813,442,0,15,88,21,63,0,3442
"29127960100",3872,251,45,0,70,0,0,0,4238
"29127960200",2820,288,7,1,64,19,11,6,3216
"29127960300",2901,490,23,14,47,56,0,0,3531
"29127960400",2761,669,123,246,40,116,62,64,4081
"29127960500",1859,729,277,83,107,0,18,0,3073
"29127960600",2621,319,162,1,112,0,10,1,3226
"29127960800",2137,464,179,83,124,19,166,39,3211
"29127960900",2061,769,254,33,46,0,29,0,3192
"29129470100",1261,280,3,4,21,0,0,0,1569
"29129470200",1671,373,3,1,37,0,18,29,2132
"29131962500",5551,772,0,0,107,57,6,2,6495
"29131962600",2917,463,0,0,42,0,29,9,3460
"29131962700",3286,750,82,0,61,27,15,23,4244
"29131962800",4177,1029,3,3,213,202,36,195,5858
"29131962900",2810,1845,0,0,20,132,30,65,4902
"29133950100",1652,422,46,50,3,67,0,0,2240
"29133950200",1713,459,1370,1040,43,0,6,7,4638
"29133950300",1467,403,37,71,7,0,3,0,1988
"29133950400",2517,1183,110,92,14,15,86,86,4103
"29135385100",3561,294,0,0,171,2,41,22,4091
"29135385200",3478,409,67,0,184,58,410,50,4656
"29135385300",2786,475,10,0,48,0,77,1,3397
"29135385400",2220,451,28,15,55,5,57,1,2832
"29137960100",2832,339,71,156,92,9,11,4,3514
"29137960200",1967,378,30,6,21,4,19,35,2460
"29137960300",2215,427,0,0,45,3,12,10,2712
"29139970100",1867,351,3,8,35,21,30,0,2315
"29139970200",2825,794,25,8,27,23,13,33,3748
"29139970300",2670,385,36,0,76,29,0,0,3196
"29139970400",1945,322,0,5,13,122,83,5,2495
"29141470100",5142,1055,66,0,187,1,62,3,6516
"29141470200",2950,742,0,0,127,2,69,13,3903
"29141470300",1742,618,88,26,0,83,57,0,2614
"29141470400",1863,705,0,0,7,0,72,12,2659
"29141470500",3456,986,0,21,55,30,65,21,4634
"29143960100",3548,577,387,92,125,19,124,13,4885
"29143960200",1251,372,279,238,24,15,33,13,2225
"29143960300",1905,412,541,305,32,96,0,4,3295
"29143960400",1475,429,220,154,41,14,9,0,2342
"29143960500",1802,559,0,1,13,1,14,17,2407
"29143960600",1970,445,295,446,40,0,28,0,3224
"29145020100",3088,672,6,146,417,70,316,298,5013
"29145020200",3283,646,54,10,519,22,329,141,5004
"29145020300",2848,484,39,3,157,28,338,59,3956
"29145020400",5850,939,0,0,255,11,202,6,7263
"29145020501",3368,350,13,6,129,0,48,0,3914
"29145020502",4082,987,43,0,227,53,247,0,5639
"29145020601",4415,487,10,9,430,41,103,69,5564
"29145020602",3553,400,82,0,405,0,29,17,4486
"29145020700",3094,630,25,0,868,154,20,4,4795
"29145020800",4668,1066,8,0,293,150,143,26,6354
"29145020900",3520,489,21,0,126,70,24,0,4250
"29145021000",2860,604,12,0,342,14,245,95,4172
"29147470100",1783,329,4,0,59,27,19,4,2225
"29147470200",2329,350,0,9,87,3,12,2,2792
"29147470300",3676,1776,18,16,40,112,38,11,5687
"29147470400",2417,1915,6,132,115,34,13,47,4679
"29147470500",3997,751,3,13,42,8,19,15,4848
"29149480100",2506,1188,0,0,97,79,40,0,3910
"29149480200",3345,809,0,0,186,23,82,0,4445
"29149480300",1769,642,0,0,19,41,32,0,2503
"29151490100",3465,160,0,0,4,0,3,0,3632
"29151490200",3667,525,38,1,46,54,7,0,4338
"29151490300",3197,187,0,23,14,0,43,38,3502
"29151490400",1950,218,23,0,4,0,0,4,2199
"29153470100",3770,780,0,0,65,105,33,76,4829
"29153470200",3582,1073,0,0,122,11,36,0,4824
"29155470100",1430,498,112,57,30,19,9,2,2157
"29155470200",1148,181,1057,922,39,13,51,1,3412
"29155470300",1609,291,569,467,47,38,23,10,3054
"29155470400",1527,478,416,623,12,13,15,121,3205
"29155470500",2277,482,126,30,53,11,58,0,3037
"29155470600",2027,657,98,268,51,62,79,23,3265
"29157470100",2164,295,0,0,13,109,0,74,2655
"29157470200",4233,710,0,0,94,0,0,0,5037
"29157470300",3103,483,0,0,123,7,117,0,3833
"29157470400",3056,410,0,0,85,18,164,10,3743
"29157470500",3613,165,40,0,0,0,9,0,3827
"29159480100",3183,434,2,0,55,119,21,5,3819
"29159480200",4857,450,49,0,570,120,614,171,6831
"29159480300",3383,583,9,10,128,29,59,2,4203
"29159480400",3506,495,51,0,70,13,42,42,4219
"29159480500",2452,552,0,0,37,15,0,12,3068
"29159480600",789,611,192,140,226,234,86,317,2595
"29159480700",2302,776,41,26,169,51,194,26,3585
"29159480800",1920,606,154,60,86,31,145,84,3086
"29159480900",1579,762,59,19,151,45,167,3,2785
"29159481000",3365,716,41,20,423,84,375,52,5076
"29159481100",3332,744,159,14,286,33,628,256,5452
"29161890100",3848,539,0,0,26,62,22,14,4511
"29161890200",3809,493,7,0,143,104,22,0,4578
"29161890300",4409,1349,55,227,665,137,147,96,7085
"29161890400",1437,1320,74,129,472,442,125,60,4059
"29161890500",2932,752,27,0,75,6,7,26,3825
"29161890600",2546,377,0,0,84,0,0,0,3007
"29161890700",2682,595,0,3,139,0,1,0,3420
"29161890800",1899,425,91,0,65,2,0,0,2482
"29161890900",3437,460,149,57,275,0,415,0,4793
"29161891000",4556,497,0,129,17,0,90,0,5289
"29163460100",2494,398,81,7,204,100,105,53,3442
"29163460200",2402,446,16,1,116,0,39,0,3020
"29163460300",3121,328,4,2,65,8,0,0,3528
"29163460400",3494,831,156,29,112,21,41,20,4704
"29163460500",1395,360,60,17,27,6,11,2,1878
"29165030001",5543,408,974,276,547,139,433,14,8334
"29165030002",1666,249,349,49,135,228,20,111,2807
"29165030101",2967,156,85,9,268,0,207,2,3694
"29165030102",2014,153,311,2,378,208,207,49,3322
"29165030103",4865,236,192,17,226,96,445,108,6185
"29165030201",1713,85,113,25,37,0,68,0,2041
"29165030205",5226,231,572,160,467,3,458,0,7117
"29165030207",4585,466,83,0,215,0,446,16,5811
"29165030208",2680,78,0,2,93,0,66,4,2923
"29165030209",6503,349,456,0,520,82,544,38,8492
"29165030210",1638,35,128,206,194,3,25,6,2235
"29165030211",1825,87,177,261,249,118,265,0,2982
"29165030305",7141,578,299,0,520,138,213,21,8910
"29165030306",3425,18,52,0,94,12,15,12,3628
"29165030307",0,0,0,0,0,0,0,0,0
"29165030308",3650,262,220,54,515,25,535,25,5286
"29165030401",5218,88,54,0,106,0,152,9,5627
"29165030500",4747,525,483,65,290,0,216,37,6363
"29165030600",6210,332,49,24,235,25,118,15,7008
"29165030700",3130,196,0,3,74,6,18,7,3434
"29167960100",4260,1366,9,23,230,63,76,21,6048
"29167960200",5423,1371,22,6,52,0,99,0,6973
"29167960300",6512,1743,0,58,146,103,114,2,8678
"29167960400",6722,1284,4,49,320,47,79,218,8723
"29169470101",3501,390,2,0,226,19,154,4,4296
"29169470102",1944,845,41,0,114,21,83,18,3066
"29169470286",2507,397,290,109,389,108,139,33,3972
"29169470287",4943,442,784,442,1421,411,932,148,9523
"29169470389",1081,134,258,4,313,0,358,2,2150
"29169470390",962,72,406,68,527,27,487,0,2549
"29169470400",8252,641,1020,306,740,123,477,50,11609
"29169470500",4264,677,200,37,149,102,145,47,5621
"29169470600",2234,213,1082,27,443,4,514,7,4524
"29171960100",2361,291,10,0,18,0,5,0,2685
"29171960200",1474,618,8,1,24,27,41,3,2196
"29173470100",2907,507,39,0,9,4,0,0,3466
"29173470200",3100,221,28,0,88,38,72,0,3547
"29173470300",2841,231,1,1,55,12,27,19,3187
"29175490100",3235,458,5,26,146,14,74,23,3981
"29175490200",2762,332,16,49,103,36,173,0,3471
"29175490300",2361,1338,321,68,94,64,27,0,4273
"29175490400",2642,276,226,0,69,9,84,0,3306
"29175490500",3070,718,77,90,127,155,0,35,4272
"29175490600",3234,605,24,3,36,22,5,0,3929
"29177080000",6398,574,0,0,190,23,145,18,7348
"29177080100",3039,583,5,4,34,64,66,29,3824
"29177080200",4291,1168,102,156,13,151,11,76,5968
"29177080300",4954,777,11,2,176,36,43,16,6015
"29179380100",2061,743,23,4,36,17,17,67,2968
"29179380200",2794,697,5,4,35,34,25,3,3597
"29181870100",3572,645,0,0,202,0,25,4,4448
"29181870200",1891,663,0,0,61,38,43,14,2710
"29181870300",3058,1472,0,4,42,26,26,15,4643
"29181870400",1688,499,8,0,11,71,34,0,2311
"29183310100",1830,358,12,0,30,3,9,0,2242
"29183310201",3266,44,168,0,52,0,24,0,3554
"29183310202",3121,371,37,19,34,0,51,0,3633
"29183310301",3861,122,127,117,44,0,65,0,4336
"29183310302",2392,299,165,241,166,2,55,0,3320
"29183310400",1777,370,122,34,110,15,63,11,2502
"29183310501",2024,1072,137,91,472,301,451,765,5313
"29183310502",1909,220,37,8,25,43,27,9,2278
"29183310601",1353,285,14,0,62,57,82,38,1891
"29183310602",4751,93,359,51,146,75,90,48,5613
"29183310700",3384,693,117,289,194,0,11,30,4718
"29183310801",1941,85,128,0,120,18,84,7,2383
"29183310802",4812,341,199,41,273,63,321,0,6050
"29183310901",1505,60,548,52,31,0,8,0,2204
"29183310902",4003,778,167,183,128,0,129,0,5388
"29183310903",3453,334,192,6,82,78,19,44,4208
"29183311001",3163,162,283,0,521,0,101,0,4230
"29183311003",1898,239,429,20,464,75,314,113,3552
"29183311004",4313,262,88,51,407,0,28,0,5149
"29183311103",5989,173,75,0,181,13,47,0,6478
"29183311114",4262,67,134,0,168,0,51,0,4682
"29183311122",4941,358,501,234,655,8,306,8,7011
"29183311124",5443,152,108,0,374,60,163,0,6300
"29183311132",3169,20,170,0,77,0,23,0,3459
"29183311145",4273,66,156,0,293,0,28,0,4816
"29183311146",3747,25,215,10,484,9,141,0,4631
"29183311147",3815,231,129,0,62,0,6,215,4458
"29183311148",3853,92,31,10,221,0,143,0,4350
"29183311149",3182,171,163,0,417,48,191,0,4172
"29183311150",4149,96,128,0,317,56,62,25,4833
"29183311151",4714,88,245,84,641,0,0,0,5772
"29183311152",4398,160,150,0,209,0,78,9,5004
"29183311153",5420,99,424,0,584,34,54,0,6615
"29183311154",4167,143,13,0,296,0,204,14,4837
"29183311203",5103,136,315,19,266,26,120,0,5985
"29183311211",3417,171,453,4,230,0,90,0,4365
"29183311212",3373,152,67,0,234,0,9,21,3856
"29183311221",3026,198,83,0,76,25,83,0,3491
"29183311294",3489,193,189,1,175,0,228,168,4443
"29183311296",3998,121,0,0,200,12,48,0,4379
"29183311311",5289,102,283,0,164,43,309,0,6190
"29183311312",5780,167,176,0,125,9,109,0,6366
"29183311322",4979,145,270,0,196,0,64,0,5654
"29183311331",3729,211,357,0,235,20,194,20,4766
"29183311391",4435,44,266,9,192,0,234,0,5180
"29183311422",4933,327,288,0,98,42,203,6,5897
"29183311500",1449,342,30,35,35,30,13,45,1979
"29183311601",5013,418,186,0,245,0,9,69,5940
"29183311602",4962,161,170,0,264,21,268,21,5867
"29183311712",3861,148,361,0,174,0,68,24,4636
"29183311721",3204,142,140,30,220,0,72,0,3808
"29183311722",6263,668,74,52,161,0,18,195,7431
"29183311732",6393,461,292,1,280,0,291,0,7718
"29183311733",2240,122,70,0,119,0,97,0,2648
"29183311734",3182,191,89,41,126,58,71,87,3845
"29183311735",5673,58,241,0,272,28,96,0,6368
"29183311736",5478,115,364,0,756,0,132,0,6845
"29183311801",4938,205,363,0,102,0,149,0,5757
"29183311802",4865,640,202,59,98,0,0,7,5871
"29183311903",5107,305,87,17,186,0,54,0,5756
"29183311904",5192,456,243,58,459,0,385,12,6805
"29183311907",5290,605,86,0,219,0,0,0,6200
"29183311908",2583,172,257,0,96,0,181,0,3289
"29183311909",4402,212,177,0,156,0,107,39,5093
"29183312001",2408,45,0,0,25,0,16,0,2494
"29183312094",3565,107,238,137,72,49,109,22,4299
"29183312095",3877,163,41,41,365,0,74,0,4561
"29183312096",6047,78,154,0,162,0,148,0,6589
"29183312097",6845,258,155,0,238,5,273,0,7774
"29183312192",3397,138,6,10,136,0,59,0,3746
"29183312193",6635,24,131,17,91,0,60,0,6958
"29183312194",2663,106,165,3,49,17,109,0,3112
"29183312195",2314,315,88,320,109,0,0,0,3146
"29183312204",4832,125,0,0,32,0,15,0,5004
"29183312205",6152,789,368,38,124,86,306,86,7949
"29183312206",3842,162,49,1,59,0,39,0,4152
"29183312300",2992,52,13,7,0,0,13,0,3077
"29183312400",3813,509,167,29,126,31,56,0,4731
"29183980000",0,0,0,0,0,0,0,0,0
"29185480100",2606,775,0,24,86,35,70,20,3616
"29185480200",2276,480,0,0,42,21,63,0,2882
"29185480300",2225,686,0,1,95,8,34,0,3049
"29186960100",5254,765,9,0,26,19,72,0,6145
"29186960200",3562,1059,0,8,344,34,25,0,5032
"29186960300",3768,278,21,0,22,0,0,0,4089
"29186960400",2139,432,15,4,0,0,3,64,2657
"29187950101",3517,732,0,0,47,0,51,0,4347
"29187950102",3750,834,0,0,92,30,24,36,4766
"29187950300",3317,769,9,33,8,37,22,10,4205
"29187950400",4978,1440,0,21,67,146,60,140,6852
"29187950600",2283,764,0,0,20,12,11,5,3095
"29187950700",6561,1312,0,0,3,5,63,0,7944
"29187950800",4937,837,13,36,216,54,75,12,6180
"29187950901",1886,369,0,0,32,0,0,0,2287
"29187950902",3658,561,36,5,68,5,55,5,4393
"29187951000",4880,1729,28,21,58,0,68,9,6793
"29187951100",5691,1628,29,28,23,67,19,0,7485
"29189210100",1779,147,2735,1405,50,278,64,114,6572
"29189210200",734,81,3902,1341,0,162,14,0,6234
"29189210300",728,225,1508,1006,80,48,31,100,3726
"29189210400",421,7,3064,759,40,32,22,0,4345
"29189210501",306,0,2014,1075,104,112,0,0,3611
"29189210502",112,16,2331,865,47,71,0,0,3442
"29189210600",1179,237,3384,982,70,86,0,0,5938
"29189210702",1050,114,3871,834,318,94,50,0,6331
"29189210703",643,96,2259,604,151,18,0,0,3771
"29189210704",433,78,1736,1132,166,11,28,31,3615
"29189210803",1515,42,2748,64,184,15,0,0,4568
"29189210804",1210,101,6529,829,411,49,50,0,9179
"29189210805",763,152,4102,530,13,35,16,2,5613
"29189210806",512,106,3938,970,98,11,21,0,5656
"29189210912",3277,138,2986,66,317,0,40,0,6824
"29189210921",1862,71,1596,347,169,0,21,0,4066
"29189210923",3056,99,1831,340,279,33,0,25,5663
"29189210924",1489,68,2285,189,493,77,135,10,4746
"29189210925",2356,223,2473,98,145,0,41,0,5336
"29189210926",1629,158,768,77,76,5,10,0,2723
"29189210927",2513,24,1810,165,37,0,253,16,4818
"29189210928",1319,9,2336,185,484,85,190,0,4608
"29189211000",3055,687,2748,117,700,0,17,0,7324
"29189211101",4011,346,1981,161,242,48,60,18,6867
"29189211102",1233,151,2368,356,195,0,50,0,4353
"29189211201",2868,441,1877,359,96,125,45,53,5864
"29189211202",2822,208,237,0,22,8,0,27,3324
"29189211301",5092,114,395,285,496,11,137,38,6568
"29189211331",4584,333,1069,202,160,74,59,0,6481
"29189211332",4697,320,540,223,245,294,62,236,6617
"29189211333",2826,56,1406,275,142,67,52,11,4835
"29189211334",3138,164,419,44,125,52,169,0,4111
"29189211401",3343,359,930,143,454,0,76,216,5521
"29189211402",676,95,885,104,140,5,2,16,1923
"29189211500",87,13,2397,581,6,132,14,132,3362
"29189211600",2057,145,2811,730,166,401,43,2,6355
"29189211700",1856,158,1920,360,106,16,65,0,4481
"29189211801",542,32,2582,970,66,170,24,0,4386
"29189211802",387,39,2175,542,27,107,30,0,3307
"29189211900",386,12,2646,1944,145,9,26,0,5168
"29189212001",518,31,4985,2130,0,0,15,0,7679
"29189212002",132,27,1997,616,33,56,0,12,2873
"29189212101",215,28,2458,1544,79,2,41,28,4395
"29189212102",94,30,1951,982,62,5,0,0,3124
"29189212200",117,14,4426,1716,49,0,8,19,6349
"29189212300",746,94,2859,1003,231,19,4,12,4968
"29189212400",165,53,1680,841,41,105,0,40,2925
"29189212500",1241,32,2365,1423,0,49,109,0,5219
"29189212600",2108,250,1346,858,148,164,43,29,4946
"29189212700",1267,162,3353,637,53,20,39,0,5531
"29189213101",2826,587,568,169,157,0,168,161,4636
"29189213102",226,45,9,9,13,0,8,0,310
"29189213202",3999,323,574,18,1400,10,238,0,6562
"29189213203",3530,258,316,231,214,19,35,0,4603
"29189213204",1677,338,366,241,571,267,450,189,4099
"29189213300",3877,398,2071,600,853,162,504,0,8465
"29189213400",2941,770,1821,683,600,76,409,171,7471
"29189213500",3220,224,1295,184,156,0,183,46,5308
"29189213600",512,138,2038,1368,134,76,10,7,4283
"29189213700",1075,189,2711,664,174,84,10,42,4949
"29189213800",181,13,3636,1481,71,74,44,1,5501
"29189213900",10,11,733,1100,7,4,7,0,1872
"29189214100",29,0,990,314,111,0,0,0,1444
"29189214200",150,45,2122,996,26,0,0,0,3339
"29189214300",924,219,1466,674,147,143,55,118,3746
"29189214400",3006,475,1104,116,167,23,525,41,5457
"29189214500",2159,289,392,202,64,55,79,0,3240
"29189214601",2784,423,498,40,250,66,65,2,4128
"29189214602",2520,500,819,207,73,10,117,173,4419
"29189214700",3578,759,966,442,429,76,268,45,6563
"29189214800",4015,425,595,125,265,102,84,177,5788
"29189214900",3393,525,1330,298,676,88,587,176,7073
"29189215001",1373,78,130,231,705,248,61,0,2826
"29189215003",3588,220,192,101,227,0,70,0,4398
"29189215004",1835,364,607,30,149,48,52,23,3108
"29189215005",3563,406,635,49,855,132,42,0,5682
"29189215102",3533,321,500,0,653,31,516,31,5585
"29189215103",1758,48,280,0,407,0,109,0,2602
"29189215105",1776,90,71,28,466,75,256,0,2762
"29189215141",3402,46,337,10,532,0,51,8,4386
"29189215142",4155,467,1107,169,940,153,566,38,7595
"29189215143",2761,148,74,34,12,0,0,0,3029
"29189215144",4338,363,485,15,710,45,252,65,6273
"29189215201",3816,417,583,44,930,138,192,55,6175
"29189215202",4784,328,470,0,872,16,123,0,6593
"29189215231",3776,292,148,0,408,11,182,0,4817
"29189215232",5789,275,291,41,1286,49,73,12,7816
"29189215301",3312,268,185,29,594,0,34,0,4422
"29189215302",2800,42,142,1,187,9,55,0,3236
"29189215400",4601,54,45,15,284,0,66,0,5065
"29189215500",3768,69,392,0,507,38,57,38,4869
"29189215600",1821,208,1776,353,765,111,255,171,5460
"29189215700",1011,160,3373,582,172,834,304,364,6800
"29189215800",5255,482,1472,175,208,153,200,74,8019
"29189215900",1813,166,3678,677,154,0,100,0,6588
"29189216000",147,35,1005,191,80,0,4,0,1462
"29189216100",2319,793,586,532,316,434,98,122,5200
"29189216200",6144,595,657,41,384,286,230,16,8353
"29189216300",2341,213,33,0,239,134,111,0,3071
"29189216400",4551,198,261,31,602,81,70,0,5794
"29189216500",3100,156,22,17,506,25,185,0,4011
"29189216600",1534,114,128,0,100,0,17,0,1893
"29189216700",2281,118,620,117,230,34,42,1,3443
"29189216800",2495,249,161,6,167,107,167,14,3366
"29189216900",1366,217,422,55,39,59,64,0,2222
"29189217000",2560,561,293,343,142,34,29,0,3962
"29189217200",1155,207,139,88,206,98,52,14,1959
"29189217300",2675,125,157,4,296,106,71,0,3434
"29189217400",3824,158,81,21,210,11,88,0,4393
"29189217500",5017,78,86,2,288,0,133,0,5604
"29189217600",6685,303,41,25,288,0,105,4,7451
"29189217701",4486,163,113,0,615,0,111,0,5488
"29189217702",5935,150,117,50,563,81,71,0,6967
"29189217802",6164,30,98,2,696,0,201,0,7191
"29189217806",4729,597,204,1,24,99,156,0,5810
"29189217807",5475,122,251,10,261,23,45,0,6187
"29189217841",4476,92,147,0,628,177,453,0,5973
"29189217842",5539,91,250,14,617,124,137,21,6793
"29189217851",2903,27,98,0,115,0,11,0,3154
"29189217852",5439,114,56,0,413,14,88,0,6124
"29189217921",4392,84,9,12,253,0,91,0,4841
"29189217923",6116,381,257,1,768,14,243,17,7797
"29189217931",5545,193,122,14,473,0,319,7,6673
"29189217932",3662,109,58,0,704,17,38,0,4588
"29189217941",4317,205,221,258,659,0,97,17,5774
"29189217942",4516,166,159,0,461,29,13,0,5344
"29189217943",3092,52,39,7,463,0,88,0,3741
"29189217944",5034,113,65,0,548,0,65,0,5825
"29189218003",6400,253,57,0,495,0,179,0,7384
"29189218011",5036,441,356,138,1088,126,479,127,7791
"29189218012",3896,101,41,25,180,0,29,0,4272
"29189218102",2591,131,17,298,293,0,0,0,3330
"29189218103",4094,480,74,0,492,155,85,18,5398
"29189218201",2830,87,39,0,75,0,41,0,3072
"29189218300",3395,150,285,72,113,21,92,1,4129
"29189218401",3663,66,24,10,13,0,0,0,3776
"29189218402",4188,200,158,0,212,0,138,0,4896
"29189218500",4207,173,59,6,133,40,151,0,4769
"29189218600",1852,127,340,127,50,0,26,0,2522
"29189218800",5642,60,20,0,204,0,48,0,5974
"29189218900",3958,316,1482,227,514,0,114,0,6611
"29189219100",3711,160,60,9,105,0,79,6,4130
"29189219200",1972,148,112,21,127,0,26,10,2416
"29189219300",1585,85,154,47,62,30,44,0,2007
"29189219400",5852,142,64,0,178,0,173,0,6409
"29189219500",5746,161,0,90,64,0,236,0,6297
"29189219600",5064,452,178,15,610,15,138,95,6567
"29189219700",5198,382,192,20,185,142,147,31,6297
"29189219800",6029,666,226,88,531,65,129,162,7896
"29189219900",4879,572,7,0,811,1,84,0,6354
"29189220001",4302,168,51,0,78,0,151,0,4750
"29189220002",2916,151,39,8,131,0,76,0,3321
"29189220100",5730,1105,142,12,283,230,97,0,7599
"29189220200",4579,331,113,5,80,0,174,0,5282
"29189220300",1205,402,118,36,45,47,34,3,1890
"29189220431",6967,555,65,19,419,100,514,28,8667
"29189220432",7417,250,160,50,273,0,90,0,8240
"29189220441",6037,167,82,0,142,0,147,0,6575
"29189220442",3936,250,19,0,100,12,80,0,4397
"29189220443",3269,306,40,93,186,0,75,0,3969
"29189220444",7398,203,64,0,117,202,15,0,7999
"29189220445",4642,130,0,3,96,0,51,7,4929
"29189220446",4394,139,108,0,27,8,199,0,4875
"29189220501",5181,849,120,68,244,36,130,0,6628
"29189220502",5171,653,362,120,306,176,165,0,6953
"29189220601",5551,310,43,91,285,12,81,9,6382
"29189220602",4924,589,88,0,261,0,81,0,5943
"29189220701",2353,350,57,1,39,10,123,61,2994
"29189220702",3262,107,0,0,116,0,13,0,3498
"29189220703",2352,51,0,0,45,0,48,0,2496
"29189220801",4315,506,71,0,57,6,75,1,5031
"29189220802",4322,141,30,127,234,20,240,0,5114
"29189220803",4106,89,118,32,264,0,118,0,4727
"29189221000",2201,74,519,138,98,0,308,0,3338
"29189221100",1757,55,2,7,57,14,25,10,1927
"29189221201",2919,271,29,0,139,0,2,0,3360
"29189221202",5418,239,135,1,138,0,0,0,5931
"29189221301",7196,495,0,1,27,0,37,0,7756
"29189221302",5924,360,146,0,235,18,139,0,6822
"29189221332",4112,141,9,0,238,0,58,0,4558
"29189221335",5400,150,150,0,173,0,115,0,5988
"29189221421",6301,113,42,0,216,0,97,0,6769
"29189221422",7464,768,12,1,52,146,158,0,8601
"29189221423",3542,283,90,0,74,0,29,0,4018
"29189221424",4517,196,8,0,171,7,34,0,4933
"29189221502",5266,98,20,1,298,1,73,0,5757
"29189221503",4978,313,60,1,415,44,121,0,5932
"29189221506",4407,9,15,0,376,0,139,0,4946
"29189221621",3764,179,30,0,44,133,18,0,4168
"29189221624",3000,66,89,0,300,0,50,0,3505
"29189221625",5796,603,106,43,268,25,238,0,7079
"29189221626",6044,232,121,9,369,0,287,0,7062
"29189221627",5677,109,189,0,286,0,199,11,6471
"29189221628",4856,448,158,1,763,53,259,0,6538
"29189221629",4761,149,19,6,518,0,131,52,5636
"29189221800",188,34,2161,754,7,61,8,0,3213
"29189221900",2879,146,110,1,235,0,100,11,3482
"29189222000",3183,67,39,3,10,6,69,1,3378
"29189222100",4600,64,127,0,151,0,83,0,5025
"29195090100",1811,485,136,49,124,0,107,17,2729
"29195090200",2067,187,21,3,57,27,58,11,2431
"29195090300",1744,569,109,0,395,234,348,234,3633
"29195090400",1585,446,256,89,365,0,322,0,3063
"29195090500",2417,474,40,23,104,105,130,0,3293
"29195090600",1638,413,155,23,352,228,361,245,3415
"29195090700",1961,405,74,23,80,5,8,3,2559
"29195090800",2171,371,42,7,56,29,36,139,2851
"29197470100",1428,534,17,10,25,0,11,1,2026
"29197470200",1761,505,2,2,19,3,0,0,2292
"29199480100",2439,264,22,0,10,1,34,2,2772
"29199480200",1549,388,0,15,3,0,8,0,1963
"29201780100",2405,672,35,1,134,54,113,0,3414
"29201780200",2958,741,0,0,115,22,58,22,3916
"29201780300",2206,404,0,15,26,34,55,11,2751
"29201780400",4274,997,96,72,119,44,28,14,5644
"29201780600",3305,435,359,31,53,15,6,5,4209
"29201780700",962,225,1166,501,78,0,0,50,2982
"29201781000",3115,539,2,6,12,0,16,115,3805
"29201781100",2760,561,0,0,16,41,17,0,3395
"29201781200",3244,843,971,568,107,162,184,66,6145
"29201781300",2237,286,206,180,43,7,22,7,2988
"29203470100",2661,544,7,0,15,116,0,0,3343
"29203470200",3493,1194,0,12,155,33,127,23,5037
"29205450100",1743,240,0,25,10,3,6,3,2030
"29205450200",1969,313,0,8,2,6,0,22,2320
"29205450300",1301,390,0,0,7,3,25,19,1745
"29207470100",3100,640,7,3,12,15,14,0,3791
"29207470200",3640,688,0,31,2,2,87,6,4456
"29207470300",3452,555,0,18,5,1,24,0,4055
"29207470400",2778,290,60,27,28,25,52,24,3284
"29207470500",2418,752,0,0,121,0,69,0,3360
"29207470600",4269,534,43,0,25,25,23,0,4919
"29207470700",1891,517,51,127,109,0,42,9,2746
"29207470800",2877,100,12,0,6,0,77,0,3072
"29209090100",6169,1189,0,0,100,56,50,78,7642
"29209090200",3898,811,0,0,144,70,88,49,5060
"29209090400",4469,654,0,0,87,36,15,11,5272
"29209090500",4604,704,2,2,98,0,66,6,5482
"29209090601",2923,182,3,0,99,5,30,0,3242
"29209090602",3405,1303,0,0,180,101,183,15,5187
"29211480100",1955,185,0,0,16,6,34,7,2203
"29211480200",1035,229,5,3,32,1,23,4,1332
"29211480300",2170,571,32,10,164,41,813,294,4095
"29213480105",4737,706,37,0,327,100,219,26,6152
"29213480106",1623,672,14,0,98,141,253,142,2943
"29213480201",7430,1434,102,36,462,179,45,486,10174
"29213480202",4940,2022,4,6,327,273,197,275,8044
"29213480301",4355,430,42,9,280,12,220,27,5375
"29213480302",3582,434,0,0,137,0,140,8,4301
"29213480401",3439,1201,30,0,108,73,103,0,4954
"29213480402",2070,600,4,19,62,46,0,6,2807
"29213480501",1578,193,0,0,0,75,0,0,1846
"29213480502",5024,1506,0,0,148,199,410,92,7379
"29215480100",4820,797,56,0,235,208,159,33,6308
"29215480200",3971,1110,0,0,186,13,16,0,5296
"29215480300",5226,1262,7,1,129,90,12,109,6836
"29215480400",4279,1667,43,0,67,60,112,8,6236
"29217950100",2227,754,1,0,43,31,2,14,3072
"29217950200",1821,480,0,0,58,0,0,0,2359
"29217950300",4190,1189,13,12,163,36,0,292,5895
"29217950400",2178,901,23,0,100,22,0,9,3233
"29217950500",2715,104,4,0,104,2,13,0,2942
"29217950600",2552,382,12,0,4,0,3,3,2956
"29219820101",5478,1056,45,46,115,31,78,359,7208
"29219820102",6446,1203,121,47,211,172,63,93,8356
"29219820103",6303,952,207,129,299,26,115,0,8031
"29219820201",1935,252,0,0,77,165,43,165,2637
"29219820202",6628,484,0,4,98,4,85,7,7310
"29221460100",4141,2118,11,1,149,68,3,10,6501
"29221460200",3659,1016,0,0,164,12,36,7,4894
"29221460300",2651,847,14,44,56,13,32,0,3657
"29221460400",3478,1015,0,0,82,0,0,0,4575
"29221460500",3618,496,0,0,135,33,0,0,4282
"29223690100",2709,541,0,0,10,37,0,18,3315
"29223690200",2539,694,0,4,131,3,0,1,3372
"29223690300",3067,1112,15,0,141,30,10,34,4409
"29223690400",1689,470,20,0,10,38,17,0,2244
"29225470101",3872,376,0,0,31,109,97,67,4552
"29225470102",4807,203,88,0,151,18,88,0,5355
"29225470201",4520,464,50,0,85,125,87,86,5417
"29225470202",2770,871,0,15,213,35,105,9,4018
"29225470301",4437,733,2,10,129,9,32,0,5352
"29225470302",3869,1425,12,1,52,18,0,0,5377
"29225470401",2659,856,0,0,54,55,43,16,3683
"29225470402",1813,517,2,3,41,5,3,3,2387
"29227960100",1749,272,0,0,13,9,12,3,2058
"29229490100",2668,928,0,0,34,46,21,5,3702
"29229490200",3031,987,37,0,64,18,34,13,4184
"29229490300",3660,1088,6,6,139,16,61,10,4986
"29229490400",4285,943,3,1,137,131,137,0,5637
"29510101100",2008,159,164,0,176,89,138,89,2823
"29510101200",2515,443,163,0,124,8,63,8,3324
"29510101300",3356,188,203,89,260,1,76,0,4173
"29510101400",1461,244,394,175,221,52,67,14,2628
"29510101500",1702,390,505,835,192,76,313,2,4015
"29510101800",1698,588,376,247,188,118,395,90,3700
"29510102100",1991,317,360,74,185,0,139,0,3066
"29510102200",5901,247,76,14,99,86,459,28,6910
"29510102300",1619,233,17,0,16,0,13,0,1898
"29510102400",1863,423,109,60,101,13,111,25,2705
"29510102500",1686,128,76,10,105,13,78,13,2109
"29510103100",2508,122,313,38,81,0,49,0,3111
"29510103400",1646,192,14,19,20,1,44,0,1936
"29510103600",941,132,27,18,193,0,28,0,1339
"29510103700",1905,252,128,0,59,5,75,0,2424
"29510103800",3256,140,276,10,181,0,98,0,3961
"29510104200",2656,325,135,106,179,213,152,122,3888
"29510104500",939,99,159,10,118,29,39,0,1393
"29510105198",1966,650,389,63,270,93,102,22,3555
"29510105200",1048,152,1447,215,120,64,21,35,3102
"29510105300",108,0,1294,886,55,0,52,0,2395
"29510105400",188,169,1276,792,76,62,140,133,2836
"29510105500",285,0,1797,750,65,0,0,0,2897
"29510106100",0,1,991,710,6,24,0,1,1733
"29510106200",0,0,798,1066,0,9,0,0,1873
"29510106300",5,0,704,559,14,5,4,5,1296
"29510106400",13,0,1737,929,13,0,13,0,2705
"29510106500",0,13,1812,706,0,0,0,0,2531
"29510106600",0,0,831,1124,6,5,0,0,1966
"29510106700",32,1,1805,1155,8,79,0,0,3080
"29510107200",5,0,634,393,21,0,0,0,1053
"29510107300",65,0,3078,1678,18,9,19,6,4873
"29510107400",36,9,1625,1161,0,19,0,0,2850
"29510107500",0,0,1770,566,13,11,0,0,2360
"29510107600",28,4,1185,1041,0,0,0,0,2258
"29510108100",120,1,2262,585,1,0,36,0,3005
"29510108200",40,10,1621,517,24,31,19,0,2262
"29510108300",100,21,1241,560,17,0,0,3,1942
"29510109600",26,0,2573,1045,24,0,14,0,3682
"29510109700",62,169,1001,1054,0,15,0,36,2337
"29510110100",40,1,1916,922,28,26,15,26,2974
"29510110200",7,0,1400,997,16,0,0,0,2420
"29510110300",7,60,1510,516,0,0,0,28,2121
"29510110400",0,2,1950,377,23,0,0,0,2352
"29510110500",0,2,958,540,14,0,0,0,1514
"29510111100",6,30,969,734,0,0,0,0,1739
"29510111200",5,17,467,543,3,15,0,0,1050
"29510111300",0,0,818,422,0,0,0,0,1240
"29510111400",0,6,708,626,0,12,0,0,1352
"29510111500",0,1,305,381,19,0,0,0,706
"29510112100",2168,285,882,282,276,30,43,0,3966
"29510112200",101,5,915,548,0,0,39,0,1608
"29510112300",31,0,1309,1124,25,0,0,0,2489
"29510112400",2071,513,674,189,247,101,121,27,3943
"29510113500",1941,249,0,4,14,0,0,0,2208
"29510114101",2481,466,756,218,340,88,77,0,4426
"29510114102",3720,288,50,63,0,0,0,0,4121
"29510114200",3274,270,416,131,175,272,162,0,4700
"29510114300",4432,223,129,72,380,44,311,1,5592
"29510115100",2603,612,259,126,240,103,252,88,4283
"29510115200",1121,407,493,630,261,224,92,173,3401
"29510115300",2295,744,1066,495,570,76,211,248,5705
"29510115400",1804,503,333,244,225,116,126,45,3396
"29510115500",1886,1002,2096,960,256,33,373,59,6665
"29510115600",1842,644,820,986,311,134,147,133,5017
"29510115700",947,536,875,1151,149,158,165,247,4228
"29510116100",1565,275,794,620,496,118,287,156,4311
"29510116200",2600,175,693,450,462,17,208,0,4605
"29510116301",2118,172,386,150,266,163,274,38,3567
"29510116302",494,157,688,338,315,224,195,128,2539
"29510116400",645,455,1945,1317,492,162,433,61,5510
"29510116500",1614,432,1212,492,686,193,182,182,4993
"29510117100",970,72,266,5,122,66,52,0,1553
"29510117200",2692,449,1185,740,154,217,44,10,5491
"29510117400",1866,372,929,185,672,55,52,0,4131
"29510118100",313,80,439,272,13,0,82,0,1199
"29510118400",72,105,126,141,0,29,7,7,487
"29510118600",889,322,938,383,115,176,109,22,2954
"29510119101",996,315,500,414,217,169,38,31,2680
"29510119102",1475,499,102,178,252,295,23,32,2856
"29510119200",710,86,590,185,93,18,28,0,1710
"29510119300",302,767,676,274,140,322,30,50,2561
"29510120200",147,5,391,911,5,55,0,0,1514
"29510121100",88,120,826,544,8,35,0,0,1621
"29510121200",6,6,773,1873,4,5,31,0,2698
"29510123100",847,104,2001,450,142,25,104,11,3684
"29510123200",1262,109,324,380,101,13,5,0,2194
"29510123300",1883,119,470,289,29,0,32,23,2845
"29510124100",1061,402,1595,2032,259,253,146,216,5964
"29510124200",811,187,976,844,223,151,170,119,3481
"29510124300",1921,317,458,195,76,8,156,0,3131
"29510124600",477,162,309,767,27,147,6,104,1999
"29510125500",1504,305,538,155,154,42,59,0,2757
"29510125600",1729,171,875,266,273,31,44,54,3443
"29510125700",14,14,1296,2282,12,0,0,0,3618
"29510126600",450,241,922,1372,0,0,81,0,3066
"29510126700",194,166,384,599,10,0,0,0,1353
"29510126800",2679,301,291,14,236,46,81,39,3687
"29510126900",57,92,2664,1601,58,15,25,10,4522
"29510127000",190,57,602,372,0,10,0,8,1239
"29510127100",31,9,1130,967,0,0,4,5,2146
"29510127200",2590,445,694,141,303,40,83,0,4296
"29510127300",1015,278,1244,661,68,32,57,119,3474
"29510127400",1265,225,1501,2217,47,20,71,0,5346
"29510127500",353,20,1057,762,234,0,41,0,2467
"29510127600",2310,250,495,87,84,8,33,0,3267
"30001000100",1141,179,2,2,24,0,45,13,1406
"30001000200",2927,325,0,0,124,6,69,0,3451
"30001000300",3056,833,0,0,184,0,197,0,4270
"30003000100",2597,324,0,0,1291,599,321,133,5265
"30003940400",135,8,0,0,747,768,44,6,1708
"30003940500",338,116,0,0,540,200,28,2,1224
"30003940600",465,12,0,0,1800,1152,71,13,3513
"30003940700",219,31,0,0,1057,509,13,1,1830
"30005000100",722,156,0,0,235,222,6,7,1348
"30005000200",1806,330,8,0,99,45,72,13,2373
"30005940100",27,0,0,0,868,498,24,9,1426
"30005940200",28,5,0,0,865,558,1,0,1457
"30007000100",1703,311,0,0,92,52,50,10,2218
"30007000200",3218,164,0,35,72,0,0,0,3489
"30009000100",2175,184,0,0,87,0,40,0,2486
"30009000200",1798,214,0,0,115,14,85,23,2249
"30009000300",1859,419,0,0,53,15,0,59,2405
"30009000400",1706,131,0,0,23,9,5,0,1874
"30009000500",1129,173,0,0,16,2,17,0,1337
"30011000300",1040,128,0,0,4,0,7,1,1180
"30013000100",1836,455,0,73,116,31,54,95,2660
"30013000200",3177,172,91,0,613,20,152,0,4225
"30013000300",2484,394,0,0,266,254,156,71,3625
"30013000400",1404,331,6,0,111,198,63,9,2122
"30013000700",1224,359,68,28,190,169,91,23,2152
"30013000800",1344,187,19,0,130,19,69,19,1787
"30013000900",1946,589,18,0,166,295,97,88,3199
"30013001000",2572,275,55,4,170,19,9,0,3104
"30013001100",3278,753,43,4,134,113,92,27,4444
"30013001200",2442,56,272,0,233,4,342,8,3357
"30013001600",2997,1482,3,0,360,158,110,173,5283
"30013001700",1942,137,0,0,183,1,86,0,2349
"30013001800",3004,115,62,1,294,110,86,37,3709
"30013001900",5409,128,0,0,433,0,59,0,6029
"30013002100",3037,688,0,0,259,91,134,0,4209
"30013002200",5283,400,49,0,522,68,312,20,6654
"30013002300",6547,299,52,0,170,68,88,0,7224
"30013010100",2832,605,0,0,238,28,80,0,3783
"30013010400",1557,161,0,0,34,18,0,0,1770
"30013010600",3070,351,10,0,152,73,24,0,3680
"30013010700",3462,523,17,0,170,37,62,0,4271
"30013010800",1550,732,121,0,104,435,98,115,3155
"30015010200",1689,176,0,0,67,0,19,0,1951
"30015010300",2189,301,0,0,567,768,33,59,3917
"30017961300",1773,170,14,0,26,14,27,16,2040
"30017961500",1319,305,0,0,76,11,41,11,1763
"30017961600",1777,175,0,0,62,0,85,0,2099
"30017961800",1394,75,0,0,49,9,23,0,1550
"30017961900",1770,186,0,0,86,16,62,0,2120
"30017962000",1589,442,0,23,0,48,43,0,2145
"30019020300",1620,119,0,0,38,1,41,0,1819
"30021000100",1209,201,0,0,21,2,7,0,1440
"30021000200",2348,378,0,0,17,5,10,12,2770
"30021000300",3661,660,22,30,164,0,168,0,4705
"30023000300",2044,551,72,8,55,54,5,34,2823
"30023000400",2502,326,20,0,21,41,42,39,2991
"30023000500",2244,632,0,2,174,65,41,64,3222
"30025000100",2697,183,33,0,51,0,21,0,2985
"30027030100",3345,770,12,0,113,21,47,19,4327
"30027030200",6298,384,0,0,277,0,89,60,7108
"30029000100",2216,814,0,22,300,0,66,31,3449
"30029000201",3414,1066,0,0,32,84,109,0,4705
"30029000202",2371,219,0,0,363,0,216,0,3169
"30029000203",3606,495,0,0,225,33,52,5,4416
"30029000300",4043,408,0,0,89,0,108,0,4648
"30029000401",4145,832,0,0,76,75,71,11,5210
"30029000402",2256,377,0,0,13,9,61,0,2716
"30029000601",3311,263,0,0,222,9,58,20,3883
"30029000602",3403,327,17,0,83,9,45,44,3928
"30029000700",4746,704,0,0,178,38,227,0,5893
"30029000800",6213,547,0,0,87,88,49,0,6984
"30029000900",5885,1033,16,0,330,290,265,228,8047
"30029001000",1352,352,0,0,92,20,20,0,1836
"30029001100",4633,943,0,0,113,48,0,57,5794
"30029001200",5803,707,32,0,385,14,80,14,7035
"30029001301",3030,199,0,0,59,0,109,0,3397
"30029001302",4197,557,0,0,71,10,92,6,4933
"30029001400",4264,796,101,0,133,37,33,19,5383
"30029001700",6607,1034,3,0,220,31,142,47,8084
"30031000101",4589,361,0,0,141,7,87,0,5185
"30031000102",1719,205,4,0,46,0,52,0,2026
"30031000103",6389,651,0,0,135,76,243,65,7559
"30031000200",8135,1179,19,0,256,0,218,166,9973
"30031000300",2699,284,0,0,105,20,54,5,3167
"30031000400",4183,262,15,0,76,7,31,49,4623
"30031000501",1830,71,0,0,43,2,44,1,1991
"30031000502",4562,318,13,0,211,0,83,0,5187
"30031000503",8484,1237,0,0,417,151,180,121,10590
"30031000504",1918,98,0,0,14,0,32,16,2078
"30031000600",1808,441,0,0,165,117,194,52,2777
"30031000701",2606,453,0,2,123,57,34,25,3300
"30031000702",4267,968,43,0,167,140,201,50,5836
"30031000800",1593,444,0,7,19,93,16,35,2207
"30031000900",1963,1285,22,11,211,154,61,80,3787
"30031001001",2965,384,31,0,69,13,13,3,3478
"30031001002",3661,516,7,0,112,0,88,13,4397
"30031001101",432,935,11,41,264,224,0,0,1907
"30031001102",1621,381,0,0,125,31,21,9,2188
"30031001200",4389,333,7,0,92,39,41,1,4902
"30031001500",1728,212,35,12,33,24,40,53,2137
"30031001600",2403,191,5,0,13,0,137,12,2761
"30033000100",992,84,0,0,5,14,4,1,1100
"30035940200",126,69,11,0,2752,2553,16,0,5527
"30035940400",1196,427,29,0,2115,797,114,74,4752
"30035976000",2332,224,0,0,418,282,0,36,3292
"30035980000",24,22,0,0,2,7,0,13,68
"30037000100",558,150,0,0,24,6,3,5,746
"30039961700",2616,386,0,2,69,7,25,30,3135
"30041040100",957,192,0,0,26,0,0,0,1175
"30041040200",1536,135,0,0,135,1,52,1,1860
"30041040300",1862,789,0,0,224,436,30,87,3428
"30041040400",3242,444,34,0,605,72,91,32,4520
"30041040500",2208,118,0,0,224,10,75,0,2635
"30041940300",103,25,0,0,1819,817,49,20,2833
"30043962201",3527,21,2,0,116,0,49,0,3715
"30043962202",3492,530,36,0,184,23,97,45,4407
"30043962300",2748,410,0,0,109,26,41,8,3342
"30045000100",1741,256,0,0,23,3,20,0,2043
"30047000100",1144,250,9,0,5,6,33,46,1493
"30047000200",1277,187,0,0,62,13,27,20,1586
"30047940301",3341,617,0,0,835,381,103,55,5332
"30047940303",3838,876,0,0,883,260,171,56,6084
"30047940400",1455,477,0,0,1078,1023,135,121,4289
"30047940500",2397,587,0,0,1100,574,198,65,4921
"30047940600",1957,412,0,0,1386,306,35,6,4102
"30047940700",804,228,0,13,575,239,16,33,1908
"30049000100",1437,302,0,0,103,17,85,29,1973
"30049000200",4675,250,0,0,164,30,100,70,5289
"30049000300",2106,180,0,3,79,18,60,3,2449
"30049000400",4180,1119,0,0,181,113,130,36,5759
"30049000501",3306,359,41,0,333,0,0,0,4039
"30049000502",5149,868,127,14,254,109,84,0,6605
"30049000600",2199,83,0,0,89,6,16,0,2393
"30049000700",5902,730,0,0,548,15,86,51,7332
"30049000800",2621,564,0,22,115,83,45,29,3479
"30049000900",2869,549,40,13,183,232,88,85,4059
"30049001000",3687,301,0,0,253,0,74,0,4315
"30049001100",4331,458,0,0,64,0,0,66,4919
"30049001201",5822,461,3,0,547,14,378,44,7269
"30049001202",4527,153,25,0,251,0,152,6,5114
"30051050100",1789,312,0,6,39,44,3,13,2206
"30053000100",2879,547,0,0,92,53,66,0,3637
"30053000200",1757,471,0,0,51,25,15,14,2333
"30053000300",2868,508,15,0,233,26,245,9,3904
"30053000400",5034,1073,0,11,178,12,55,25,6388
"30053000500",2745,556,0,0,82,0,28,18,3429
"30055954000",1510,156,0,0,57,0,23,0,1746
"30057000100",2849,246,0,35,53,0,142,0,3325
"30057000200",2204,258,3,9,51,10,44,11,2590
"30057000300",1663,215,0,0,50,0,13,4,1945
"30059000100",1690,274,0,0,12,5,10,19,2010
"30061964500",1657,253,0,35,17,5,11,5,1983
"30061964600",1611,535,0,0,10,6,23,0,2185
"30063000100",5120,687,0,0,346,163,179,0,6495
"30063000201",5302,1804,0,84,378,250,312,75,8205
"30063000202",9349,903,0,0,643,88,300,16,11299
"30063000300",1072,858,33,2,164,92,7,0,2228
"30063000400",2371,566,12,0,94,14,63,0,3120
"30063000500",3033,1176,0,28,717,214,23,56,5247
"30063000700",1619,708,19,14,113,31,30,0,2534
"30063000800",4200,1588,0,0,429,29,199,260,6705
"30063000901",5002,379,28,0,134,200,125,17,5885
"30063000902",2106,112,0,0,36,6,29,0,2289
"30063001000",3714,1106,0,0,150,46,61,0,5077
"30063001100",2341,630,0,0,268,94,83,0,3416
"30063001200",3836,915,41,0,235,44,122,102,5295
"30063001302",5008,572,0,164,141,110,78,11,6084
"30063001303",4001,789,0,0,206,21,9,44,5070
"30063001304",5946,345,0,0,572,11,469,0,7343
"30063001400",5735,715,18,0,208,144,112,21,6953
"30063001500",5482,510,0,0,243,0,83,0,6318
"30063001600",6693,409,0,0,141,131,76,16,7466
"30063001800",3086,519,0,0,557,28,102,33,4325
"30065000100",2197,416,38,0,135,9,20,5,2820
"30065000200",1509,356,8,0,51,3,34,3,1964
"30067000100",1605,119,0,0,43,7,4,4,1782
"30067000200",3405,493,0,0,143,23,35,0,4099
"30067000300",2189,484,0,6,112,126,48,89,3054
"30067000400",4490,398,0,24,27,0,84,0,5023
"30067000500",1466,257,0,0,55,2,67,51,1898
"30067980600",0,32,0,0,0,0,0,0,32
"30069000100",427,36,6,17,0,0,7,0,493
"30071060200",3187,452,0,0,375,120,76,0,4210
"30073977000",3230,500,25,0,126,62,36,38,4017
"30073977200",1006,333,0,0,575,281,18,5,2218
"30075000100",1419,177,0,0,74,8,26,0,1704
"30077000100",1309,218,6,0,63,3,12,0,1611
"30077000200",3198,584,0,0,70,31,35,0,3918
"30079000100",988,225,0,0,29,16,7,0,1265
"30081000100",3411,337,0,0,136,21,26,0,3931
"30081000201",2876,879,0,4,58,117,27,62,4023
"30081000202",5858,588,64,0,274,18,71,0,6873
"30081000300",2552,622,0,0,29,11,53,73,3340
"30081000401",2122,587,0,0,46,4,41,110,2910
"30081000402",3806,1034,0,0,51,53,47,126,5117
"30081000500",3747,1388,44,0,360,0,0,50,5589
"30081000600",4809,1181,0,0,162,131,150,277,6710
"30081000700",1433,310,0,0,51,23,9,10,1836
"30081000800",860,291,0,0,25,4,44,104,1328
"30083070100",1041,254,14,33,72,14,48,11,1487
"30083070200",1414,272,0,0,244,5,108,6,2049
"30083070300",3526,723,0,0,107,9,101,52,4518
"30083070400",2712,113,0,0,103,0,101,0,3029
"30085080100",1340,84,0,0,195,36,48,0,1703
"30085940001",1536,137,6,5,1897,921,17,16,4535
"30085940002",691,60,0,0,2246,1489,15,6,4507
"30087000100",2152,121,0,0,95,0,12,33,2413
"30087000200",1109,149,0,0,151,17,79,41,1546
"30087000300",1738,42,12,0,310,127,91,0,2320
"30087940400",250,28,17,0,1561,1305,47,67,3275
"30089000100",2428,681,0,0,66,30,82,22,3309
"30089000200",4552,1257,7,0,146,0,50,11,6023
"30089940300",974,360,5,1,441,233,22,61,2097
"30091090200",1997,195,0,0,68,84,44,0,2388
"30091090400",905,99,0,4,68,10,11,0,1097
"30093000100",2457,1703,32,0,218,256,103,41,4810
"30093000200",3089,1298,51,30,135,60,194,316,5173
"30093000300",2004,566,0,0,17,19,66,4,2676
"30093000400",3290,497,8,0,139,2,254,13,4203
"30093000500",3496,493,0,0,100,30,16,60,4195
"30093000600",3659,807,0,19,48,55,56,8,4652
"30093000700",3121,240,0,0,57,29,75,45,3567
"30093000800",4476,715,0,0,169,147,44,42,5593
"30095966400",3607,242,23,8,37,16,79,8,4020
"30095966500",1765,185,1,0,67,0,123,4,2145
"30095966600",2796,207,0,0,184,6,39,6,3238
"30097967000",2965,476,7,0,142,0,26,59,3675
"30099000100",1625,217,0,0,59,19,12,0,1932
"30099000200",1576,180,0,0,47,24,31,34,1892
"30099000300",1839,286,0,0,81,25,9,0,2240
"30101000100",946,148,0,0,24,0,19,0,1137
"30101000200",2506,591,0,0,218,43,32,63,3453
"30101980000",0,0,0,0,0,0,0,0,0
"30103963500",570,112,0,0,53,26,27,22,810
"30105100100",1259,143,0,0,21,0,4,27,1454
"30105100500",2177,295,0,0,123,130,9,18,2752
"30105940600",2344,207,7,0,452,142,51,9,3212
"30107000100",1763,275,0,0,34,19,18,1,2110
"30109000100",820,136,0,0,0,0,21,0,977
"30111000200",2042,682,27,13,171,263,181,47,3426
"30111000300",2179,871,12,45,650,302,519,134,4712
"30111000401",2523,469,64,11,64,53,83,123,3390
"30111000402",2134,489,0,3,346,162,171,64,3369
"30111000500",3108,834,0,0,67,1,57,0,4067
"30111000600",2014,203,31,0,59,3,9,0,2319
"30111000701",3927,384,0,0,280,196,156,0,4943
"30111000702",6180,577,0,0,555,246,331,0,7889
"30111000704",3259,337,77,0,513,131,238,93,4648
"30111000705",3390,296,17,0,364,71,215,26,4379
"30111000706",2693,1014,0,0,81,59,136,69,4052
"30111000800",3771,384,0,0,252,51,153,14,4625
"30111000901",2618,211,0,0,129,188,90,118,3354
"30111000902",2906,701,46,0,591,493,300,46,5083
"30111001000",3559,506,13,0,536,277,360,74,5325
"30111001100",4812,231,73,0,354,35,237,0,5742
"30111001200",1968,424,51,12,136,238,61,177,3067
"30111001300",5653,367,0,0,52,151,125,204,6552
"30111001401",9135,583,124,0,603,109,348,66,10968
"30111001402",5221,358,11,0,246,113,283,62,6294
"30111001501",4117,629,0,11,169,13,190,13,5142
"30111001502",3179,397,3,0,125,22,66,57,3849
"30111001702",3744,241,167,20,163,79,99,12,4525
"30111001703",4347,826,0,0,255,18,82,11,5539
"30111001704",3402,574,100,0,222,89,74,0,4461
"30111001801",4894,103,0,0,652,11,132,0,5792
"30111001802",4950,630,0,0,242,17,355,0,6194
"30111001803",1779,128,20,0,127,0,120,0,2174
"30111001804",2491,185,0,37,0,9,78,49,2849
"30111001901",4367,138,0,0,90,8,179,0,4782
"30111001902",3277,261,0,0,57,154,4,109,3862
"30111940000",6212,624,11,0,823,125,280,19,8094
"31001965400",3751,232,0,37,50,5,58,13,4146
"31001965500",3674,439,21,11,73,20,182,50,4470
"31001965600",4078,400,18,0,251,23,125,22,4917
"31001965700",877,248,0,0,21,130,155,160,1591
"31001965800",1642,231,0,0,410,63,480,19,2845
"31001965900",3799,232,30,0,62,14,242,26,4405
"31001966000",3285,775,43,26,307,92,360,73,4961
"31001966100",1531,417,0,0,7,0,532,28,2515
"31001966200",2248,94,27,0,26,4,37,5,2441
"31003979600",1803,251,0,0,14,11,32,35,2146
"31003979700",1395,219,0,0,27,10,44,20,1715
"31003979800",2362,319,0,0,20,3,44,17,2765
"31005958300",438,34,0,0,4,0,0,0,476
"31007954000",640,118,14,0,15,0,23,16,826
"31009972400",493,94,0,0,4,3,0,0,594
"31011960100",3101,355,4,0,13,1,38,18,3530
"31011960200",1600,203,0,0,7,6,10,8,1834
"31013951100",1711,225,0,0,4,20,16,0,1976
"31013951200",4141,541,0,2,173,19,503,0,5379
"31013951300",2642,1023,8,0,157,416,272,472,4990
"31015975800",1704,237,14,2,40,4,7,5,2013
"31017975000",2513,446,0,0,35,27,26,2,3049
"31019968900",2989,283,0,0,85,0,74,20,3451
"31019969000",4008,165,0,0,48,0,88,0,4309
"31019969100",3752,414,29,0,415,22,691,144,5467
"31019969202",2865,610,8,30,178,13,177,76,3957
"31019969203",4938,540,0,8,62,0,107,47,5702
"31019969204",4757,154,71,0,103,34,105,42,5266
"31019969300",1516,226,0,9,377,56,373,39,2596
"31019969400",3338,350,12,6,237,74,346,17,4380
"31019969500",1613,323,44,15,31,5,240,19,2290
"31019969600",2454,1217,1,49,88,138,172,64,4183
"31019969700",4721,673,44,7,553,105,561,76,6740
"31021963200",1956,144,28,3,94,7,5,0,2237
"31021963300",2113,200,0,17,85,6,101,0,2522
"31021963400",1650,224,0,0,52,10,45,12,1993
"31023967600",3002,236,2,0,48,17,63,8,3376
"31023967700",2424,335,36,0,80,2,133,0,3010
"31023967800",1803,137,16,0,13,1,9,5,1984
"31025965600",3408,259,115,0,7,0,119,0,3908
"31025965700",4474,160,0,0,71,7,87,0,4799
"31025965800",3020,144,0,11,79,25,2,17,3298
"31025965900",4387,425,9,0,69,0,43,0,4933
"31025966000",3684,99,63,0,168,9,182,0,4205
"31025966100",3795,319,19,0,142,0,209,12,4496
"31027977100",3828,607,0,3,24,9,90,18,4579
"31027977200",3771,290,0,0,28,22,10,7,4128
"31029961900",3367,461,0,0,58,9,367,111,4373
"31031955800",3302,358,0,0,410,90,0,47,4207
"31031955900",1267,193,0,0,16,0,87,0,1563
"31033954800",2356,255,19,0,192,5,99,31,2957
"31033954900",3641,658,0,2,78,24,158,236,4797
"31033955000",2229,378,0,0,38,18,33,64,2760
"31035962100",3184,280,32,2,28,65,312,118,4021
"31035962200",2354,279,0,0,65,10,85,23,2816
"31037964600",2090,205,18,0,45,11,29,6,2404
"31037964700",1488,145,2,0,43,22,83,6,1789
"31037964800",4571,918,150,63,544,43,3537,754,10580
"31039972700",2367,203,0,0,45,0,59,6,2680
"31039972800",3431,627,49,0,162,74,446,246,5035
"31039972900",1701,130,5,0,104,17,33,19,2009
"31041971700",2272,356,15,0,69,4,21,5,2742
"31041971800",2443,208,0,0,41,13,20,5,2730
"31041971900",3285,506,26,0,0,25,123,25,3990
"31041972000",1202,113,3,0,49,0,23,0,1390
"31043010100",2733,666,214,495,1277,899,2219,825,9328
"31043010200",3881,541,107,60,2049,180,2668,546,10032
"31043010300",3138,291,11,0,626,26,928,141,5161
"31043010400",2879,248,5,0,253,32,236,20,3673
"31045950600",1978,439,4,4,61,20,27,9,2542
"31045950700",4064,706,0,8,526,168,206,23,5701
"31047968000",2284,193,18,0,137,35,316,8,2991
"31047968100",1363,103,0,0,40,0,68,24,1598
"31047968200",3291,322,10,0,8,53,88,34,3806
"31047968300",3150,471,110,23,80,20,437,47,4338
"31047968400",3312,733,65,248,1017,55,3178,693,9301
"31047968500",3118,787,507,24,555,150,2238,683,8062
"31047968600",1356,77,0,0,32,10,10,16,1501
"31049955400",1610,261,0,0,24,11,63,84,2053
"31051977600",2284,199,0,0,44,3,51,8,2589
"31051977800",2642,387,5,13,171,34,418,189,3859
"31053963600",4134,414,29,8,166,43,127,14,4935
"31053963700",2599,136,0,0,22,0,12,0,2769
"31053963800",4077,532,0,0,100,0,217,29,4955
"31053963900",3409,877,44,0,5,74,452,360,5221
"31053964000",2559,399,0,0,200,21,313,78,3570
"31053964100",3995,241,0,0,74,0,266,135,4711
"31053964200",2935,271,40,8,263,53,411,156,4137
"31053964300",4248,391,0,0,139,55,294,55,5182
"31053964400",2222,706,0,20,134,22,714,270,4088
"31055000200",1773,262,983,97,353,18,153,10,3649
"31055000300",635,301,738,332,136,101,265,74,2582
"31055000400",929,523,98,63,310,287,353,399,2962
"31055000500",547,248,126,97,49,178,23,153,1421
"31055000600",308,31,408,219,123,74,88,5,1256
"31055000700",100,68,514,524,101,31,52,21,1411
"31055000800",190,122,591,757,207,225,200,80,2372
"31055001100",234,308,931,1098,140,131,96,140,3078
"31055001200",205,254,1296,766,144,94,203,95,3057
"31055001600",54,39,0,0,26,55,0,0,174
"31055001800",1853,429,74,68,106,29,53,65,2677
"31055001900",467,264,215,83,89,139,72,23,1352
"31055002000",2066,923,0,87,521,258,1505,957,6317
"31055002100",1178,904,65,59,303,101,618,588,3816
"31055002200",674,159,0,0,209,29,179,23,1273
"31055002300",1748,697,0,2,77,17,376,309,3226
"31055002400",2426,876,19,2,293,273,1578,841,6308
"31055002500",1671,472,103,0,246,141,839,366,3838
"31055002600",1541,199,6,28,530,205,1605,331,4445
"31055002700",1357,513,50,3,525,207,1312,558,4525
"31055002800",2080,604,27,27,631,192,2003,553,6117
"31055002900",2368,765,492,1240,573,189,2136,636,8399
"31055003000",4041,1142,225,23,1415,706,1900,1658,11110
"31055003100",2445,579,71,117,537,119,1381,327,5576
"31055003200",1283,552,6,115,654,172,1586,545,4913
"31055003300",1148,570,20,12,219,447,596,721,3733
"31055003401",2435,694,75,23,756,76,873,179,5111
"31055003402",2221,244,27,0,94,0,377,103,3066
"31055003500",3637,273,171,0,265,215,632,225,5418
"31055003600",3594,236,89,0,176,61,83,0,4239
"31055003700",2121,141,7,10,125,0,60,0,2464
"31055003800",2074,608,154,430,248,364,885,251,5014
"31055003900",1000,894,70,55,505,278,622,856,4280
"31055004000",1309,900,67,230,162,195,385,670,3918
"31055004200",748,420,70,41,218,61,222,257,2037
"31055004300",1509,624,92,55,256,59,105,130,2830
"31055004400",1007,82,1,2,106,4,21,6,1229
"31055004500",2749,208,60,0,59,0,61,0,3137
"31055004600",2008,275,0,0,202,48,65,0,2598
"31055004700",1988,56,19,0,55,0,57,0,2175
"31055004800",3523,566,252,52,418,11,436,0,5258
"31055004900",2581,435,544,422,508,535,425,256,5706
"31055005000",2288,825,337,111,519,289,712,313,5394
"31055005100",863,535,489,361,163,79,150,216,2856
"31055005200",154,159,364,491,215,219,30,156,1788
"31055005300",393,152,1010,480,196,132,119,137,2619
"31055005400",783,517,913,291,256,319,236,363,3678
"31055005500",3997,480,233,59,293,0,151,115,5328
"31055005600",2874,381,525,36,421,20,164,52,4473
"31055005700",2183,358,741,236,215,202,100,206,4241
"31055005800",2141,226,1012,202,214,381,163,70,4409
"31055005901",385,201,875,453,136,10,7,22,2089
"31055005902",127,148,826,774,113,63,90,0,2141
"31055006000",1053,298,1146,939,201,176,350,294,4457
"31055006101",338,85,1221,319,143,354,79,100,2639
"31055006102",829,504,1213,769,237,133,133,303,4121
"31055006202",2344,255,941,541,255,77,164,33,4610
"31055006301",949,90,1103,156,118,127,111,43,2697
"31055006302",892,273,1979,346,441,346,164,236,4677
"31055006303",1373,97,550,351,146,309,180,38,3044
"31055006400",3299,1069,80,158,251,104,313,69,5343
"31055006503",2241,90,134,40,158,13,104,0,2780
"31055006504",2520,240,288,77,216,22,105,5,3473
"31055006505",1014,100,419,116,108,0,43,0,1800
"31055006506",1249,253,1330,218,353,216,193,0,3812
"31055006602",4104,872,473,33,318,63,244,0,6107
"31055006603",1661,337,346,564,92,27,168,29,3224
"31055006604",3042,247,178,135,349,42,274,0,4267
"31055006701",2984,265,118,14,229,97,81,47,3835
"31055006703",2408,185,207,47,170,120,66,0,3203
"31055006704",1384,144,0,0,36,6,0,0,1570
"31055006803",1727,82,73,36,87,0,7,0,2012
"31055006804",1335,54,0,0,100,0,30,0,1519
"31055006805",3371,83,0,2,100,10,55,10,3631
"31055006806",1347,409,195,251,152,218,0,45,2617
"31055006903",2308,87,75,72,121,0,212,7,2882
"31055006904",3754,173,0,0,99,27,135,0,4188
"31055006905",1482,121,53,5,285,0,31,25,2002
"31055006906",2751,247,15,77,58,0,121,18,3287
"31055007001",1784,650,248,69,201,130,148,146,3376
"31055007002",2507,256,218,150,151,36,205,0,3523
"31055007003",2099,233,4,18,112,19,722,76,3283
"31055007101",2210,348,93,1,282,149,597,182,3862
"31055007102",3124,233,0,104,232,0,820,0,4513
"31055007303",2291,209,74,23,84,0,7,0,2688
"31055007304",1163,43,116,14,104,0,70,0,1510
"31055007309",2794,306,383,62,211,54,49,13,3872
"31055007310",2071,161,325,0,197,0,135,21,2910
"31055007311",2188,130,361,600,129,42,142,0,3592
"31055007312",1277,123,209,154,179,20,48,18,2028
"31055007313",5010,329,1613,323,449,0,323,46,8093
"31055007314",2770,21,114,0,145,0,75,0,3125
"31055007315",2820,174,169,0,130,0,22,0,3315
"31055007316",2396,0,47,55,251,0,128,0,2877
"31055007317",3052,295,300,6,112,5,53,0,3823
"31055007318",3598,92,159,0,233,30,14,30,4156
"31055007405",1282,260,21,2,130,7,59,4,1765
"31055007406",4131,505,47,0,261,0,136,0,5080
"31055007407",2649,406,68,0,338,21,315,240,4037
"31055007408",3712,276,92,14,306,161,334,138,5033
"31055007409",2000,152,22,0,108,0,50,20,2352
"31055007424",2317,248,106,27,68,0,165,89,3020
"31055007429",3579,41,9,0,105,0,190,0,3924
"31055007431",3749,281,162,25,252,0,44,0,4513
"31055007432",2640,171,58,100,232,0,185,61,3447
"31055007433",3546,170,317,73,199,22,201,31,4559
"31055007434",2136,427,596,67,243,61,257,57,3844
"31055007435",2774,362,52,44,339,135,184,33,3923
"31055007436",2991,178,450,326,182,32,99,0,4258
"31055007438",1736,124,14,0,34,0,108,14,2030
"31055007439",4131,145,273,0,140,0,165,19,4873
"31055007440",930,210,363,197,152,15,74,44,1985
"31055007441",2271,53,70,28,221,0,75,0,2718
"31055007442",4371,207,9,9,95,14,186,9,4900
"31055007443",2819,114,204,70,281,0,177,0,3665
"31055007444",2866,275,310,75,893,0,151,0,4570
"31055007445",1679,163,258,66,180,122,48,0,2516
"31055007446",3584,79,11,0,154,14,169,13,4024
"31055007447",2615,150,0,0,19,0,147,10,2941
"31055007448",2422,89,28,0,82,0,38,27,2686
"31055007449",3072,163,0,0,184,0,55,0,3474
"31055007450",2959,185,119,0,127,0,56,0,3446
"31055007451",4460,489,0,29,456,0,164,0,5598
"31055007452",4456,113,26,0,242,12,216,0,5065
"31055007453",3119,51,31,0,125,138,15,9,3488
"31055007454",3909,202,26,0,119,26,172,0,4454
"31055007455",1293,238,0,0,10,37,76,91,1745
"31055007456",2159,102,100,15,115,60,163,60,2774
"31055007457",2401,147,86,9,189,39,291,33,3195
"31055007458",2184,341,103,15,232,10,160,25,3070
"31055007459",2896,192,0,0,44,48,440,0,3620
"31055007460",3784,9,0,0,255,0,96,0,4144
"31055007461",4912,148,15,0,605,48,171,48,5947
"31055007462",4041,404,47,0,180,63,242,150,5127
"31055007463",3879,246,181,0,232,10,184,0,4732
"31055007464",2321,114,55,202,90,0,80,0,2862
"31055007465",3286,117,56,0,531,51,183,0,4224
"31055007466",4135,765,130,15,392,111,372,527,6447
"31055007467",4088,311,243,0,449,76,489,126,5782
"31055007468",2505,118,29,0,138,37,560,63,3450
"31055007469",3348,62,8,31,398,0,185,11,4043
"31055007470",4371,115,447,102,656,70,469,0,6230
"31055007471",2803,67,167,72,464,36,34,8,3651
"31055007472",3969,44,95,0,301,32,163,32,4636
"31055007504",2428,296,24,17,42,0,24,32,2863
"31055007505",2688,53,0,0,105,6,62,0,2914
"31055007506",2135,119,41,0,62,0,102,0,2459
"31055007508",2329,146,0,1,14,4,29,2,2525
"31055007509",3704,29,0,0,50,0,18,0,3801
"31055007511",4286,307,138,0,422,58,136,0,5347
"31055007512",5325,463,0,7,232,83,86,0,6196
"31055007513",4458,42,28,0,219,0,14,0,4761
"31055007514",3439,39,13,0,96,0,53,0,3640
"31055007515",3282,0,198,0,346,0,109,0,3935
"31055007516",3124,32,44,0,162,0,16,0,3378
"31055007517",3984,314,83,0,171,13,32,0,4597
"31057962300",1724,180,0,0,23,0,119,4,2050
"31059091600",1972,217,0,0,27,0,84,9,2309
"31059091700",2996,218,19,0,45,27,40,47,3392
"31061964600",1152,125,0,1,1,11,18,2,1310
"31061964700",1457,293,0,6,21,9,15,8,1809
"31063961100",2053,296,0,0,17,15,17,4,2402
"31065963900",3918,778,5,0,76,37,48,98,4960
"31067964600",2381,152,0,0,32,0,15,0,2580
"31067964700",3605,172,3,0,20,5,70,29,3904
"31067964800",3085,534,0,0,121,35,44,22,3841
"31067964900",3209,490,10,0,59,0,20,0,3788
"31067965000",2851,262,5,0,41,0,16,6,3181
"31067965100",1290,346,0,0,148,44,120,32,1980
"31067965200",2100,368,11,3,84,38,12,0,2616
"31069952100",1610,214,0,0,55,7,19,13,1918
"31071973200",1668,220,0,9,17,0,15,2,1931
"31073967600",1776,146,0,0,32,2,31,4,1991
"31075956300",542,84,0,0,0,0,4,9,639
"31077970900",2148,276,5,6,19,7,31,19,2511
"31079000100",2274,198,21,0,34,7,91,55,2680
"31079000200",3448,1151,0,19,414,118,2165,1024,8339
"31079000300",4815,1220,63,77,179,36,1828,731,8949
"31079000400",4248,788,0,0,127,10,706,252,6131
"31079000500",4312,128,49,0,143,0,179,36,4847
"31079000600",4207,324,81,12,257,20,613,127,5641
"31079000700",3325,570,42,0,148,8,904,19,5016
"31079000800",2649,298,31,0,12,0,357,0,3347
"31079000900",3704,1192,80,206,158,49,1028,707,7124
"31079001000",2737,686,320,140,344,272,633,705,5837
"31079001100",3046,890,0,90,366,56,1189,712,6349
"31079001200",3381,222,35,6,58,15,241,3,3961
"31079001300",2631,233,8,2,55,11,81,66,3087
"31079001400",1873,173,32,0,15,2,265,54,2414
"31081969100",1785,122,27,0,43,0,44,0,2021
"31081969200",2197,217,0,0,37,3,40,13,2507
"31081969300",3930,476,11,0,95,0,108,8,4628
"31083964200",2944,377,3,0,53,25,50,40,3492
"31085961500",1055,80,2,0,8,0,49,12,1206
"31087962700",2362,404,4,0,35,8,51,2,2866
"31089974000",1382,180,0,0,4,0,21,0,1587
"31089974100",2251,440,0,0,19,5,20,8,2743
"31089974200",1720,150,2,0,17,0,30,0,1919
"31089974300",3402,327,0,0,265,91,223,61,4369
"31091956700",544,108,0,0,8,0,20,0,680
"31093970500",1591,127,0,0,18,0,81,0,1817
"31093970600",3971,476,0,7,75,16,40,16,4601
"31095963600",2929,226,0,0,71,31,35,26,3318
"31095963700",2322,522,0,0,8,11,85,70,3018
"31095963800",936,242,0,0,52,0,0,19,1249
"31097967500",1642,109,2,0,36,5,29,0,1823
"31097967600",1759,339,14,0,183,28,167,94,2584
"31099966600",3173,174,0,0,35,7,162,0,3551
"31099966700",2783,198,0,0,53,0,137,0,3171
"31101000100",1045,230,0,0,59,19,46,38,1437
"31101000200",2775,397,0,0,55,0,145,12,3384
"31101000300",3124,255,3,1,56,58,163,73,3733
"31103975400",625,105,0,1,1,7,0,0,739
"31105954500",3080,463,15,0,132,2,167,90,3949
"31107976200",2438,277,0,0,34,24,25,0,2798
"31107976300",1973,297,0,1,41,31,15,20,2378
"31107976400",2161,165,0,0,518,353,111,24,3332
"31109000100",2770,703,73,33,121,118,171,44,4033
"31109000201",3954,393,22,0,103,39,83,0,4594
"31109000202",1829,1152,103,31,218,64,238,56,3691
"31109000300",2162,900,83,45,222,108,234,223,3977
"31109000400",2047,1477,217,500,960,302,346,293,6142
"31109000500",818,665,19,30,29,65,39,92,1757
"31109000600",1,58,0,0,0,0,0,7,66
"31109000700",808,509,144,200,559,393,73,0,2686
"31109000800",1840,584,282,87,376,408,288,564,4429
"31109000900",2156,748,24,57,297,217,102,69,3670
"31109001001",1788,525,87,0,208,100,104,75,2887
"31109001002",972,416,44,24,32,18,11,0,1517
"31109001003",2649,363,154,70,366,40,202,40,3884
"31109001101",4126,135,8,0,180,0,76,10,4535
"31109001102",2999,370,34,0,114,0,39,0,3556
"31109001200",5276,546,54,0,265,1,55,15,6212
"31109001301",3225,166,50,0,101,0,52,25,3619
"31109001302",2705,82,21,0,141,13,84,7,3053
"31109001400",3276,699,67,89,375,0,168,0,4674
"31109001500",3732,316,115,10,65,49,162,25,4474
"31109001600",4810,549,46,53,195,52,166,120,5991
"31109001700",2484,1376,252,243,789,562,528,581,6815
"31109001800",710,366,69,153,147,206,63,163,1877
"31109001900",295,229,66,3,30,4,0,1,628
"31109002001",934,834,235,83,308,46,129,245,2814
"31109002002",1337,701,210,263,71,199,324,169,3274
"31109002100",1258,577,7,14,195,80,365,160,2656
"31109002200",2941,1028,375,29,307,268,252,349,5549
"31109002300",4453,860,78,174,447,144,232,57,6445
"31109002400",2721,177,0,0,35,0,26,0,2959
"31109002500",5111,291,13,9,215,61,220,43,5963
"31109002701",2116,323,45,0,366,36,196,0,3082
"31109002702",4450,357,30,0,285,97,279,34,5532
"31109002800",4607,319,149,68,219,0,107,42,5511
"31109002900",3419,815,398,151,514,24,184,39,5544
"31109003001",4831,609,67,183,848,261,251,92,7142
"31109003002",2217,618,176,109,148,48,185,24,3525
"31109003003",2799,1083,90,72,287,252,154,385,5122
"31109003102",4944,379,294,34,337,70,260,50,6368
"31109003103",1238,729,21,25,513,145,589,267,3527
"31109003104",3496,884,129,120,853,276,589,212,6559
"31109003202",1894,582,251,26,116,17,245,187,3318
"31109003301",2484,1693,21,346,240,121,104,115,5124
"31109003302",3317,302,147,0,298,5,526,58,4653
"31109003401",4174,534,0,0,415,0,288,122,5533
"31109003402",4260,274,436,504,506,154,317,286,6737
"31109003500",6,16,0,2,0,0,0,0,24
"31109003601",0,0,0,0,0,0,0,0,0
"31109003604",2625,105,29,0,124,2,0,15,2900
"31109003605",2926,187,44,0,164,160,184,0,3665
"31109003607",3279,207,52,0,394,48,29,0,4009
"31109003608",1015,28,0,0,80,0,31,0,1154
"31109003609",2155,12,0,5,69,0,40,0,2281
"31109003704",3994,687,230,0,276,19,308,0,5514
"31109003706",5476,157,64,0,263,25,164,0,6149
"31109003707",6492,207,39,17,217,0,71,1,7044
"31109003708",3936,145,0,0,251,0,149,0,4481
"31109003709",4376,230,44,0,144,95,78,94,5061
"31109003713",2123,5,57,0,119,0,35,0,2339
"31109003714",2113,58,0,0,53,0,149,0,2373
"31109003715",2360,11,17,0,126,0,17,0,2531
"31109003716",4363,141,51,0,308,0,166,0,5029
"31109003717",2629,459,39,32,36,0,96,0,3291
"31109003718",1968,44,22,0,155,0,29,2,2220
"31109003719",3573,109,107,0,92,63,52,0,3996
"31109003720",1486,0,0,0,100,0,0,0,1586
"31109003801",4377,171,112,31,153,87,21,16,4968
"31109003802",2543,223,7,0,49,0,168,0,2990
"31109010100",5879,191,0,0,170,5,64,0,6309
"31109010201",2963,847,139,17,337,37,333,0,4673
"31109010202",4216,114,22,0,33,20,21,11,4437
"31109010300",3629,145,19,12,57,0,11,0,3873
"31109010400",7912,319,19,6,187,8,308,32,8791
"31109983200",0,0,0,0,0,0,0,0,0
"31111959700",3243,240,0,0,15,13,44,4,3559
"31111959800",2710,207,0,6,151,32,175,54,3335
"31111959900",3720,971,12,60,279,32,386,117,5577
"31111960200",3759,774,23,24,125,39,183,321,5248
"31111960300",3737,630,47,8,238,34,378,250,5322
"31111960400",5030,444,0,0,181,30,361,0,6046
"31111960500",3751,606,38,23,124,0,212,16,4770
"31111960600",3477,244,4,0,170,25,155,37,4112
"31113957500",621,76,2,0,8,10,7,12,736
"31115972800",429,94,0,0,17,19,0,11,570
"31117957900",373,49,0,0,4,0,4,0,430
"31119960600",3917,415,0,112,306,0,262,84,5096
"31119960700",2075,764,73,24,172,66,265,121,3560
"31119960801",3891,270,0,0,23,63,165,104,4516
"31119960802",2725,352,18,0,39,49,24,123,3330
"31119960900",3231,798,25,29,231,322,379,524,5539
"31119961000",2419,661,76,0,173,8,472,131,3940
"31119961100",1741,217,46,0,142,110,503,213,2972
"31119961200",3259,231,4,0,17,2,67,22,3602
"31119961300",3939,594,85,0,262,0,1131,176,6187
"31121966600",1796,165,21,0,24,3,28,23,2060
"31121966700",2224,227,0,12,28,1,110,7,2609
"31121966800",2443,432,0,0,170,0,70,12,3127
"31123952500",3980,636,8,3,119,28,588,107,5469
"31125966100",3153,404,0,0,14,5,85,0,3661
"31127968100",2924,237,9,7,38,32,30,29,3306
"31127968200",3060,327,21,8,37,16,37,0,3506
"31129960000",2041,198,0,0,16,9,30,49,2343
"31129960100",1800,212,0,0,8,47,8,14,2089
"31131966600",1925,123,0,0,7,6,28,0,2089
"31131966700",2777,233,0,0,23,27,12,0,3072
"31131966800",2687,145,14,0,33,0,15,0,2894
"31131966900",3589,495,0,0,246,74,315,109,4828
"31131967000",2373,499,13,1,119,0,363,156,3524
"31133967800",2194,487,0,0,24,2,48,0,2755
"31135959300",2622,230,4,0,25,4,61,35,2981
"31137967000",2185,266,0,0,73,11,91,5,2631
"31137967100",3007,120,0,0,65,0,177,0,3369
"31137967200",2991,162,4,0,29,6,148,8,3348
"31139979100",3701,109,0,0,57,3,35,0,3905
"31139979200",2840,256,10,0,39,3,40,3,3191
"31141965100",3755,189,0,0,2,5,8,12,3971
"31141965298",2913,250,0,0,37,33,34,10,3277
"31141965300",6347,570,7,0,101,58,755,179,8017
"31141965400",3779,463,0,36,138,106,675,525,5722
"31141965500",4976,350,0,0,201,0,819,44,6390
"31141965600",3472,546,0,9,302,38,900,315,5582
"31141965700",2663,290,7,0,279,20,466,151,3876
"31143960000",1772,140,0,0,45,4,3,9,1973
"31143960100",2827,279,3,0,91,11,118,50,3379
"31145963100",2250,293,0,30,34,0,25,2,2634
"31145963200",4381,264,10,0,20,0,310,5,4990
"31145963300",2654,570,8,0,64,46,88,29,3459
"31147964500",1496,128,2,0,105,14,13,5,1763
"31147968500",1436,316,4,0,25,9,18,5,1813
"31147968600",3347,837,0,0,188,158,21,70,4621
"31149974600",1239,103,0,0,33,8,4,0,1387
"31151960600",4960,1138,0,64,672,111,1990,755,9690
"31151960700",2067,71,0,0,8,0,83,0,2229
"31151960800",1346,109,3,0,30,3,49,0,1540
"31151960900",2398,211,0,0,41,16,129,44,2839
"31153010103",3890,262,251,0,228,0,239,0,4870
"31153010104",1357,185,102,0,247,35,208,111,2245
"31153010105",2200,252,54,0,125,54,89,42,2816
"31153010106",3053,825,87,8,107,139,143,128,4490
"31153010107",2407,342,267,0,378,186,714,421,4715
"31153010108",2799,193,202,405,384,7,655,30,4675
"31153010203",4141,81,170,35,253,0,251,0,4931
"31153010204",2953,379,239,0,106,11,116,54,3858
"31153010205",4765,11,236,0,447,0,295,0,5754
"31153010206",3385,20,262,0,539,30,686,10,4932
"31153010207",1920,72,108,3,356,0,199,0,2658
"31153010208",2197,177,340,12,138,10,182,8,3064
"31153010302",277,29,78,0,103,0,16,0,503
"31153010305",1243,93,153,8,85,0,301,13,1896
"31153010306",1738,99,93,0,306,0,126,12,2374
"31153010401",2319,346,106,29,247,83,735,101,3966
"31153010402",3437,672,300,130,189,21,279,0,5028
"31153010501",5341,545,463,52,672,81,874,154,8182
"31153010502",3214,562,76,5,346,72,458,138,4871
"31153010503",2934,175,192,0,76,52,472,121,4022
"31153010614",3991,412,245,245,588,134,509,27,6151
"31153010615",1659,142,25,0,211,0,199,32,2268
"31153010616",3523,94,114,0,160,0,337,0,4228
"31153010617",5384,65,161,2,299,0,304,28,6243
"31153010618",4921,71,97,32,613,0,339,0,6073
"31153010619",3659,567,257,6,273,8,185,0,4955
"31153010620",3381,166,61,0,235,0,149,0,3992
"31153010621",5428,118,96,304,131,0,207,307,6591
"31153010622",2537,62,63,0,274,0,50,9,2995
"31153010623",4264,116,27,0,127,0,35,0,4569
"31153010624",4961,274,31,2,222,0,147,0,5637
"31153010625",4515,247,292,60,194,50,484,60,5902
"31153010626",4486,260,0,0,413,0,27,0,5186
"31153010627",2525,9,0,0,78,5,236,0,2853
"31153010628",4434,36,124,0,88,9,154,0,4845
"31153010629",1529,97,36,0,154,0,60,0,1876
"31153010630",2357,30,9,0,129,0,82,0,2607
"31153010631",4189,228,36,66,31,0,126,0,4676
"31153010632",4054,105,0,0,219,0,211,0,4589
"31153010633",2636,66,36,0,110,6,93,0,2947
"31153010634",2272,55,12,0,242,13,72,13,2679
"31153010701",2108,61,0,0,88,0,14,14,2285
"31153010702",2932,144,7,0,103,1,19,0,3206
"31155968100",3109,133,0,0,18,3,31,3,3297
"31155968200",4825,530,3,54,84,8,80,0,5584
"31155968300",3986,472,0,0,61,6,137,0,4662
"31155968400",3975,248,51,0,64,20,89,0,4447
"31155968500",2518,265,0,0,143,0,53,24,3003
"31157952900",2686,131,0,0,62,3,219,18,3119
"31157953000",2504,442,0,0,191,110,442,192,3881
"31157953100",1798,362,2,4,81,52,288,207,2794
"31157953200",1340,118,0,0,11,10,101,15,1595
"31157953300",3082,167,60,6,214,49,476,15,4069
"31157953400",2373,78,16,0,89,0,241,5,2802
"31157953500",1937,898,36,37,74,21,397,385,3785
"31157953600",2555,133,0,7,142,0,422,15,3274
"31157953700",2593,1073,7,2,341,371,1797,813,6997
"31157953800",3552,459,6,22,249,14,900,59,5261
"31157953900",4725,329,4,1,120,58,793,176,6206
"31159960100",3864,388,31,0,63,11,10,8,4375
"31159960200",1999,249,13,0,37,0,36,0,2334
"31159960300",3623,312,9,0,77,60,92,0,4173
"31159960400",4289,305,9,4,101,59,59,80,4906
"31161951600",1400,318,0,6,174,194,80,74,2246
"31161951700",2499,276,17,0,242,109,37,12,3192
"31163970100",2679,333,0,32,17,0,48,0,3109
"31165950100",1101,137,0,0,38,3,57,9,1345
"31167962100",1457,138,0,0,7,0,6,0,1608
"31167962200",3878,459,22,7,88,25,264,30,4773
"31169963100",2283,211,0,0,14,23,16,0,2547
"31169963200",2029,373,0,0,30,85,19,4,2540
"31171957100",665,56,0,0,22,3,0,4,750
"31173940100",1836,282,0,2,1016,1045,75,117,4373
"31173940200",631,42,0,2,1240,708,69,11,2703
"31175971300",1562,181,0,0,15,7,17,4,1786
"31175971400",2060,307,0,0,0,65,0,38,2470
"31177050101",2740,107,0,0,25,0,63,0,2935
"31177050102",4031,953,25,45,175,60,56,0,5345
"31177050201",3914,143,0,0,8,1,58,1,4125
"31177050202",3041,45,16,0,11,0,134,0,3247
"31177050300",3963,433,0,0,66,1,106,0,4569
"31179978600",3059,145,85,0,155,25,99,19,3587
"31179978700",3592,1053,114,0,0,0,284,57,5100
"31181965000",1681,129,0,0,17,43,27,8,1905
"31181965100",1389,270,0,0,51,10,111,5,1836
"31183973600",725,110,0,0,12,1,12,0,860
"31185969600",2542,108,0,0,51,4,43,3,2751
"31185969700",3337,289,0,0,231,94,97,161,4209
"31185969800",3329,559,0,2,107,0,132,0,4129
"31185969900",2087,178,9,11,37,0,64,0,2386
"32001950100",2104,246,21,55,267,13,227,55,2988
"32001950301",1718,1181,36,0,440,394,149,280,4198
"32001950302",3325,542,255,143,647,39,549,35,5535
"32001950400",520,19,12,0,188,9,176,0,924
"32001950500",726,141,0,0,365,253,22,79,1586
"32001950600",3871,186,17,0,375,141,505,284,5379
"32001950700",4508,646,28,0,511,35,682,51,6461
"32003000101",2791,477,472,427,1964,409,3057,675,10272
"32003000103",1981,598,489,80,1442,487,2487,716,8280
"32003000105",1908,925,29,57,904,21,1462,452,5758
"32003000106",2063,771,394,35,607,354,912,476,5612
"32003000107",1574,515,419,27,778,15,829,51,4208
"32003000108",1811,361,73,0,1099,742,2101,953,7140
"32003000109",1922,327,105,200,1179,57,1775,115,5680
"32003000201",1048,302,1095,517,931,381,1322,532,6128
"32003000203",1524,698,408,298,585,273,783,603,5172
"32003000204",610,149,0,13,211,29,258,80,1350
"32003000301",299,317,754,412,339,133,484,212,2950
"32003000302",395,510,1266,1606,357,414,624,630,5802
"32003000401",395,548,93,362,308,290,203,293,2492
"32003000402",631,733,150,313,1152,455,1321,978,5733
"32003000403",622,263,244,277,523,253,691,294,3167
"32003000510",2080,403,347,49,1519,495,3211,840,8944
"32003000513",2041,709,66,239,832,350,1965,952,7154
"32003000514",2073,474,364,170,1633,1122,2367,1405,9608
"32003000515",1996,808,190,106,1502,244,2626,913,8385
"32003000516",2316,653,45,268,1036,802,2472,1158,8750
"32003000517",2674,509,160,231,1327,564,3157,743,9365
"32003000518",2278,809,249,397,1261,322,2500,882,8698
"32003000519",1770,918,89,18,1544,414,2861,1103,8717
"32003000520",999,335,18,33,469,211,1242,495,3802
"32003000521",1002,858,286,92,895,511,1681,1084,6409
"32003000522",979,459,24,188,664,498,1371,861,5044
"32003000523",312,710,333,446,343,130,407,697,3378
"32003000524",542,644,26,63,367,234,648,733,3257
"32003000525",1085,163,237,79,873,300,1683,397,4817
"32003000526",1343,570,64,103,1017,155,1905,718,5875
"32003000527",1617,857,149,67,1049,263,1994,1125,7121
"32003000528",1173,444,136,212,506,282,1390,656,4799
"32003000600",765,456,253,249,495,376,630,445,3669
"32003000700",585,265,83,99,226,7,195,67,1527
"32003000800",747,421,88,167,303,237,442,229,2634
"32003000900",562,187,155,63,208,19,61,0,1255
"32003001003",2275,265,314,36,701,158,1506,153,5408
"32003001004",3609,693,411,54,1043,341,1778,715,8644
"32003001005",1197,155,88,9,127,39,118,56,1789
"32003001006",3140,190,261,77,457,56,715,27,4923
"32003001100",936,513,146,238,504,304,816,548,4005
"32003001200",1986,457,231,107,736,357,1021,553,5448
"32003001300",2823,684,32,74,1145,323,2759,741,8581
"32003001401",1139,1168,58,21,664,83,755,728,4616
"32003001402",2469,632,8,5,752,123,2443,541,6973
"32003001501",1397,461,179,302,597,190,1202,287,4615
"32003001502",2511,360,115,135,513,60,1191,188,5073
"32003001607",2272,1046,209,224,675,285,997,329,6037
"32003001608",1000,246,37,0,246,59,446,192,2226
"32003001609",1925,1174,180,94,1091,214,1936,1065,7679
"32003001610",1368,773,60,38,524,79,1140,505,4487
"32003001611",2405,751,19,141,966,81,2261,638,7262
"32003001612",3406,418,708,620,914,1052,2251,913,10282
"32003001613",1590,826,241,149,891,117,1230,586,5630
"32003001706",1782,325,77,75,576,74,383,42,3334
"32003001707",1068,73,76,9,77,15,110,39,1467
"32003001708",1659,98,176,255,429,172,568,114,3471
"32003001709",997,252,86,15,251,6,492,95,2194
"32003001710",2399,407,252,95,938,92,1519,183,5885
"32003001711",2071,401,275,36,760,91,1011,244,4889
"32003001712",2233,484,542,89,517,146,708,324,5043
"32003001713",1941,144,85,62,704,20,1033,65,4054
"32003001714",2163,281,114,0,637,35,1277,202,4709
"32003001715",1136,226,66,37,818,432,1147,431,4293
"32003001716",979,262,24,56,468,0,772,167,2728
"32003001717",1106,79,4,0,130,12,204,10,1545
"32003001718",1367,402,113,228,384,138,1001,365,3998
"32003001801",3978,959,187,308,1122,254,2467,878,10153
"32003001803",1725,189,180,23,659,46,1396,62,4280
"32003001804",1339,677,300,155,720,387,1316,750,5644
"32003001901",2535,1025,222,103,1360,415,2632,1277,9569
"32003001902",2065,653,71,196,609,106,1281,412,5393
"32003002000",2092,552,306,108,509,268,517,193,4545
"32003002201",2131,695,224,214,417,450,874,639,5644
"32003002203",2058,859,184,109,1882,374,2722,1037,9225
"32003002204",1793,1126,155,166,556,519,1815,1444,7574
"32003002206",1722,470,178,35,792,384,1665,619,5865
"32003002207",1020,614,168,105,888,1512,1670,1814,7791
"32003002302",692,72,16,5,218,0,69,5,1077
"32003002303",424,15,10,0,62,6,17,0,534
"32003002403",1291,559,704,445,536,252,674,544,5005
"32003002404",903,1158,663,587,588,368,975,1092,6334
"32003002405",2396,1071,213,216,623,212,1853,872,7456
"32003002406",1071,714,267,241,281,141,332,362,3409
"32003002501",3236,1230,298,0,1447,554,2300,694,9759
"32003002504",1994,255,434,151,483,148,960,38,4463
"32003002505",816,157,143,28,284,201,466,150,2245
"32003002506",1599,540,341,115,504,211,943,522,4775
"32003002603",1222,706,238,55,332,222,398,389,3562
"32003002604",1206,368,229,47,143,63,494,228,2778
"32003002605",314,215,76,12,74,13,65,21,790
"32003002706",1975,410,277,146,439,222,1312,425,5206
"32003002707",2079,334,196,53,794,36,1296,258,5046
"32003002708",958,231,507,464,419,36,776,136,3527
"32003002808",1460,78,82,0,319,9,225,13,2186
"32003002810",1972,418,263,79,557,120,920,0,4329
"32003002811",2654,310,217,2,671,45,464,51,4414
"32003002814",3066,179,320,62,1285,377,693,338,6320
"32003002821",2736,613,229,219,859,73,1053,190,5972
"32003002822",2343,371,229,104,801,172,1839,401,6260
"32003002823",1781,238,369,79,713,91,589,103,3963
"32003002824",1420,64,6,5,313,83,207,42,2140
"32003002825",1863,420,124,38,681,45,1077,97,4345
"32003002826",1947,243,287,0,443,34,722,42,3718
"32003002827",1470,325,59,33,601,12,858,0,3358
"32003002828",2063,297,119,79,549,142,333,109,3691
"32003002829",3090,160,151,21,749,49,1014,133,5367
"32003002830",3933,535,317,2,1658,13,1315,58,7831
"32003002831",2376,216,269,61,911,423,1342,138,5736
"32003002832",3248,320,387,34,1176,363,969,231,6728
"32003002833",3473,533,133,26,1370,47,892,227,6701
"32003002834",4427,420,757,0,1262,0,1464,0,8330
"32003002835",1483,225,59,25,854,22,498,91,3257
"32003002836",2325,121,187,0,1110,61,1421,45,5270
"32003002837",4179,308,205,7,955,36,1603,101,7394
"32003002838",3461,294,297,2,771,103,822,58,5808
"32003002841",2011,42,109,13,575,43,248,21,3062
"32003002842",2817,145,131,21,2557,51,1602,70,7394
"32003002843",4170,415,731,1,2454,295,1589,51,9706
"32003002844",4420,200,576,25,1412,95,683,0,7411
"32003002845",3027,560,385,61,711,160,1289,412,6605
"32003002846",4124,186,620,16,2074,196,1468,28,8712
"32003002847",2382,259,219,220,859,55,1381,13,5388
"32003002848",2151,285,226,18,635,59,882,229,4485
"32003002905",1986,484,100,171,884,464,633,66,4788
"32003002915",3516,158,427,120,747,256,852,24,6100
"32003002916",1684,132,309,50,252,39,365,63,2894
"32003002919",2149,419,233,103,748,333,646,293,4924
"32003002935",977,27,85,43,375,92,237,94,1930
"32003002936",1348,96,478,219,894,148,584,20,3787
"32003002937",2673,353,388,85,1078,584,1496,548,7205
"32003002938",784,240,130,33,315,41,147,33,1723
"32003002939",1362,78,99,4,251,22,177,12,2005
"32003002940",1439,198,363,131,1282,234,474,0,4121
"32003002941",2716,717,142,233,1208,105,1274,687,7082
"32003002942",2475,389,310,26,801,302,443,278,5024
"32003002944",1852,292,146,31,841,48,259,178,3647
"32003002946",1314,268,121,16,525,77,339,137,2797
"32003002947",2030,260,25,0,676,19,414,136,3560
"32003002948",1838,142,59,66,1267,92,1837,74,5375
"32003002949",2113,325,169,0,763,84,699,101,4254
"32003002950",2057,328,487,176,1539,152,830,161,5730
"32003002951",3603,307,224,2,2436,572,909,74,8127
"32003002952",1549,223,300,10,396,51,218,74,2821
"32003002953",2860,278,150,12,1130,96,876,109,5511
"32003002954",1864,460,261,55,826,54,764,268,4552
"32003002956",1116,129,412,83,587,132,578,78,3115
"32003002957",1728,10,56,0,225,0,234,0,2253
"32003002958",2497,436,610,21,1766,201,920,280,6731
"32003002961",1475,161,102,0,376,46,140,80,2380
"32003002962",730,145,37,68,117,40,96,61,1294
"32003002964",2121,698,665,153,905,63,1175,299,6079
"32003002965",2838,636,111,29,323,252,1049,563,5801
"32003002966",1735,500,1085,302,692,510,813,498,6135
"32003002967",1442,503,701,105,784,276,527,137,4475
"32003002968",1493,284,240,5,772,70,487,115,3466
"32003002969",814,7,143,103,383,31,411,23,1915
"32003002970",1310,206,489,20,1216,350,725,365,4681
"32003002974",2575,706,296,126,1003,105,736,205,5752
"32003002975",2576,331,539,122,2053,229,1338,237,7425
"32003002976",2702,113,270,144,1127,152,748,31,5287
"32003002977",1999,229,184,1,963,107,686,4,4173
"32003002978",1665,171,247,93,1053,77,587,46,3939
"32003002979",1267,242,186,0,446,35,358,159,2693
"32003002980",2491,55,726,37,3539,217,603,26,7694
"32003002981",1928,97,187,16,2026,69,1065,35,5423
"32003002982",2639,202,479,12,3485,420,788,31,8056
"32003002983",1122,123,575,91,736,171,293,31,3142
"32003002984",1786,55,308,0,1947,138,766,0,5000
"32003002985",1763,226,453,0,1744,85,579,236,5086
"32003002995",1054,240,215,78,767,442,966,287,4049
"32003002996",1706,622,305,46,1710,413,1776,735,7313
"32003003001",2467,189,55,29,944,119,1541,137,5481
"32003003003",3638,176,330,0,946,405,1135,307,6937
"32003003004",1586,298,133,94,214,43,749,107,3224
"32003003005",2777,111,173,173,363,54,1052,10,4713
"32003003006",2329,547,136,46,487,84,1067,380,5076
"32003003102",2456,840,393,110,1138,633,1813,856,8239
"32003003103",2155,315,89,191,608,113,1240,218,4929
"32003003104",1514,886,368,149,648,74,953,453,5045
"32003003204",4889,88,341,50,734,45,472,29,6648
"32003003208",2061,83,124,1,726,0,285,23,3303
"32003003210",2099,219,41,0,150,0,71,10,2590
"32003003211",2940,84,38,0,143,0,127,0,3332
"32003003213",1742,47,68,0,164,71,72,23,2187
"32003003214",1398,19,92,6,56,0,18,0,1589
"32003003215",2634,587,518,33,490,147,639,206,5254
"32003003218",4208,53,227,0,991,0,685,0,6164
"32003003219",3641,336,862,43,1406,132,1359,112,7891
"32003003220",3022,782,415,288,1843,70,1971,567,8958
"32003003222",2927,269,498,0,837,53,525,16,5125
"32003003223",2158,133,172,0,515,34,109,82,3203
"32003003226",1973,18,45,0,398,52,164,0,2650
"32003003227",2373,225,221,58,740,50,298,0,3965
"32003003228",2567,957,566,56,736,39,456,379,5756
"32003003229",1561,214,352,36,572,104,490,43,3372
"32003003230",4725,325,442,129,1168,108,1331,65,8293
"32003003231",3795,482,678,0,1489,168,905,0,7517
"32003003232",4896,271,326,0,608,65,768,47,6981
"32003003233",2288,90,482,15,968,0,488,45,4376
"32003003234",2721,265,744,11,595,66,829,62,5293
"32003003235",1769,108,854,55,515,122,432,30,3885
"32003003236",1605,23,124,0,360,0,215,13,2340
"32003003237",2624,219,69,241,876,123,805,23,4980
"32003003238",4012,497,934,112,672,295,1187,149,7858
"32003003239",2387,147,144,0,611,16,288,70,3663
"32003003240",2554,378,74,5,712,175,549,0,4447
"32003003241",2645,154,496,7,427,64,629,77,4499
"32003003242",1365,62,126,1,185,2,119,12,1872
"32003003243",2682,223,159,57,1100,24,541,19,4805
"32003003244",2513,147,288,0,610,42,712,33,4345
"32003003245",2895,240,237,30,1092,98,919,142,5653
"32003003246",2961,112,188,26,640,21,804,6,4758
"32003003247",3031,86,190,58,459,28,309,8,4169
"32003003248",1996,168,343,214,867,122,586,38,4334
"32003003249",2568,152,174,100,567,203,788,14,4566
"32003003250",3532,175,240,9,944,840,546,18,6304
"32003003251",2159,23,59,0,144,231,310,0,2926
"32003003252",3626,210,241,0,667,72,569,89,5474
"32003003253",2257,174,35,1,994,367,905,104,4837
"32003003254",2343,350,457,3,520,5,716,54,4448
"32003003260",2311,210,302,24,590,82,538,66,4123
"32003003261",2224,175,21,48,131,83,507,218,3407
"32003003262",2414,136,43,0,220,0,23,9,2845
"32003003303",3010,228,641,206,942,232,1058,105,6422
"32003003305",3059,522,579,1,1008,16,815,25,6025
"32003003306",2823,319,302,145,315,13,572,14,4503
"32003003307",3423,226,823,170,1703,49,1006,210,7610
"32003003308",1876,107,392,6,355,43,491,11,3281
"32003003309",3201,149,247,135,444,13,393,21,4603
"32003003310",3315,226,291,0,743,96,772,0,5443
"32003003311",2492,302,185,191,433,78,483,49,4213
"32003003312",2952,111,300,0,383,58,567,61,4432
"32003003313",2503,88,130,0,256,107,673,33,3790
"32003003314",5478,285,149,0,965,0,1818,19,8714
"32003003315",2566,244,304,16,598,211,405,318,4662
"32003003316",4093,242,268,252,683,63,902,63,6566
"32003003317",1981,40,120,0,164,20,354,0,2679
"32003003318",3054,303,574,183,444,28,454,36,5076
"32003003319",4278,328,421,204,873,5,1035,0,7144
"32003003320",3629,229,332,0,418,0,1020,26,5654
"32003003321",1633,98,113,0,355,0,115,7,2321
"32003003408",3237,392,534,26,794,133,898,119,6133
"32003003409",3460,723,456,327,718,233,943,102,6962
"32003003410",3492,145,342,212,405,58,837,36,5527
"32003003411",1877,597,412,74,968,39,659,84,4710
"32003003412",2331,406,491,49,824,216,1236,125,5678
"32003003413",2833,277,728,198,1042,190,1485,194,6947
"32003003414",1508,152,203,3,241,54,315,94,2570
"32003003415",2613,941,646,444,1602,565,1541,1080,9432
"32003003416",2158,75,253,0,464,59,947,37,3993
"32003003418",1582,811,673,388,732,144,1094,543,5967
"32003003419",2434,882,1786,147,1016,388,1089,745,8487
"32003003420",2063,723,325,153,599,750,1355,1169,7137
"32003003421",1617,285,410,94,587,532,367,706,4598
"32003003422",2647,841,296,100,801,221,1395,604,6905
"32003003423",2307,1011,982,383,1795,56,2246,490,9270
"32003003426",1496,483,879,136,564,90,669,277,4594
"32003003427",2060,200,369,184,434,191,1257,207,4902
"32003003428",784,226,292,55,135,335,412,444,2683
"32003003429",1860,1031,630,324,914,247,1403,867,7276
"32003003430",852,328,797,364,503,88,886,238,4056
"32003003431",1027,718,334,257,756,453,1270,1062,5877
"32003003500",424,264,1094,556,221,503,401,715,4178
"32003003607",3924,350,922,96,1878,187,2144,231,9732
"32003003609",2488,176,684,212,873,136,1137,112,5818
"32003003610",2935,158,857,50,1784,166,2368,133,8451
"32003003612",3145,107,1580,420,2131,112,2510,201,10206
"32003003613",2211,439,1296,330,2545,252,2583,470,10126
"32003003615",1459,157,454,71,620,99,810,157,3827
"32003003616",1181,172,1132,743,1257,239,1937,374,7035
"32003003617",360,16,512,100,398,66,430,54,1936
"32003003618",5050,327,999,281,1461,120,1171,192,9601
"32003003619",1578,59,210,0,1208,0,580,18,3653
"32003003620",2676,89,572,330,1207,0,740,28,5642
"32003003621",2472,82,207,14,205,37,33,24,3074
"32003003622",3085,137,1067,25,1553,77,725,111,6780
"32003003623",2476,377,1148,105,767,283,1073,509,6738
"32003003624",2909,219,1727,416,1436,244,1622,17,8590
"32003003625",4353,1055,1161,233,1196,61,1907,689,10655
"32003003626",2502,457,775,36,446,151,1004,92,5463
"32003003627",1873,114,1119,33,1251,97,1191,167,5845
"32003003628",3056,110,1483,1194,2492,198,1369,277,10179
"32003003629",3440,266,1108,12,1457,57,2054,29,8423
"32003003630",3698,446,938,76,954,229,1248,187,7776
"32003003631",1600,426,738,62,765,189,1035,320,5135
"32003003632",1895,268,534,16,608,0,1131,263,4715
"32003003633",2411,437,217,266,441,45,920,432,5169
"32003003634",2216,57,1106,103,844,94,1545,78,6043
"32003003635",2763,129,743,43,1909,62,1938,47,7634
"32003003636",1748,129,361,10,304,246,345,110,3253
"32003003637",2454,523,481,15,1148,83,1140,412,6256
"32003003638",907,276,570,252,1020,133,611,259,4028
"32003003639",1653,112,498,221,841,106,1184,100,4715
"32003003640",2441,151,620,305,825,0,1388,79,5809
"32003003641",2101,142,1960,342,1035,97,1072,191,6940
"32003003642",1746,224,947,142,1520,238,1687,330,6834
"32003003643",1827,253,959,260,1365,356,1929,439,7388
"32003003644",1128,74,1062,480,1442,35,1489,28,5738
"32003003700",309,89,1568,308,593,363,765,432,4427
"32003003800",1445,729,213,380,418,610,1445,1089,6329
"32003004000",1405,605,61,17,759,499,1868,1053,6267
"32003004100",2030,1065,78,0,1691,821,3223,1751,10659
"32003004200",1873,1246,99,32,1200,261,2497,1352,8560
"32003004301",235,457,10,56,273,340,500,755,2626
"32003004302",876,1019,246,113,806,619,1634,1522,6835
"32003004401",943,689,39,58,604,435,1304,1065,5137
"32003004402",1057,1079,434,161,587,670,1557,1628,7173
"32003004500",1480,789,189,257,1077,552,2067,908,7319
"32003004601",1019,693,341,486,1054,277,1792,939,6601
"32003004602",822,670,377,75,513,202,1168,801,4628
"32003004703",1867,1432,767,552,678,128,1384,1402,8210
"32003004707",1175,573,63,119,725,334,1442,796,5227
"32003004709",2027,882,536,476,1773,1153,3259,1748,11854
"32003004710",2426,1615,289,383,1427,714,3024,2087,11965
"32003004712",1797,1409,610,768,883,321,1066,998,7852
"32003004713",1417,857,458,615,595,200,1316,774,6232
"32003004714",1918,965,840,317,939,427,1896,1183,8485
"32003004715",2777,419,832,473,675,727,1346,912,8161
"32003004716",1092,556,367,144,639,210,1216,631,4855
"32003004717",1033,445,132,19,1200,192,1728,551,5300
"32003004907",2219,132,258,41,1004,28,1139,81,4902
"32003004910",881,170,189,23,1465,225,1664,188,4805
"32003004911",1601,497,178,92,1077,351,1288,585,5669
"32003004912",2115,707,329,146,1726,321,2378,775,8497
"32003004914",1429,221,65,48,641,171,1072,271,3918
"32003004915",1645,397,74,9,1007,290,1324,408,5154
"32003004916",1377,391,263,5,423,244,1042,437,4182
"32003004917",1354,107,337,30,1048,161,1363,177,4577
"32003004918",2244,343,510,35,882,27,1431,183,5655
"32003004919",3192,220,201,22,748,152,1741,113,6389
"32003004920",2013,956,322,410,1276,311,2104,717,8109
"32003004921",2792,1071,311,195,1147,199,2303,1166,9184
"32003004923",1644,40,369,298,1300,62,1234,20,4967
"32003004924",1444,357,161,303,1212,209,1563,390,5639
"32003004925",2672,156,553,27,1926,333,2475,162,8304
"32003004926",1653,117,120,45,1432,51,1424,110,4952
"32003005005",2329,629,156,373,287,80,410,238,4502
"32003005006",2028,260,948,22,816,164,1252,172,5662
"32003005007",1399,228,139,0,679,21,289,52,2807
"32003005010",2395,621,191,326,1167,156,1625,596,7077
"32003005011",2294,322,155,121,236,288,1519,526,5461
"32003005012",1717,322,175,43,637,43,837,238,4012
"32003005013",1648,67,193,181,1413,176,1591,30,5299
"32003005014",1988,325,953,118,1951,488,1574,311,7708
"32003005015",2305,47,319,0,1604,60,1120,33,5488
"32003005016",3398,147,536,0,1497,49,2238,63,7928
"32003005017",2140,505,496,190,1529,111,1173,461,6605
"32003005101",5592,196,132,103,1096,302,1596,140,9157
"32003005102",3288,371,163,100,699,105,953,8,5687
"32003005103",3372,357,276,92,839,249,1027,130,6342
"32003005104",2112,332,103,0,614,120,372,28,3681
"32003005105",4838,987,468,444,845,233,1761,421,9997
"32003005106",1931,74,298,27,700,49,759,0,3838
"32003005107",2889,232,135,54,705,84,756,131,4986
"32003005108",2390,138,445,0,461,110,418,75,4037
"32003005109",4630,478,374,113,1456,134,823,74,8082
"32003005200",1984,757,31,10,87,48,413,214,3544
"32003005311",1832,282,117,21,522,28,569,21,3392
"32003005312",1625,359,169,0,397,18,189,217,2974
"32003005313",4677,98,251,76,964,28,992,45,7131
"32003005314",2001,41,174,0,330,0,273,9,2828
"32003005315",4006,179,241,18,680,23,638,0,5785
"32003005316",3157,294,422,190,918,0,976,272,6229
"32003005317",4098,191,214,89,978,82,633,2,6287
"32003005318",2204,235,102,0,510,135,350,0,3536
"32003005319",1777,183,101,2,534,64,536,116,3313
"32003005320",2091,213,169,0,227,16,376,13,3105
"32003005321",2973,249,197,24,543,59,805,108,4958
"32003005322",979,43,0,22,260,25,148,28,1505
"32003005333",1908,127,36,0,319,68,94,37,2589
"32003005335",3959,199,35,32,357,41,457,17,5097
"32003005336",2788,451,173,34,477,21,422,62,4428
"32003005337",2326,183,27,0,467,72,217,72,3364
"32003005338",1761,77,61,14,60,17,237,9,2236
"32003005341",1771,150,58,0,168,67,255,19,2488
"32003005342",2949,104,45,0,287,43,469,50,3947
"32003005343",3437,453,43,0,549,8,591,0,5081
"32003005346",3411,317,251,62,1099,187,712,60,6099
"32003005347",3650,344,80,0,1132,212,294,0,5712
"32003005348",3783,275,38,0,1012,107,557,24,5796
"32003005349",2993,360,91,25,689,126,754,72,5110
"32003005350",2728,149,19,0,623,0,232,7,3758
"32003005351",2702,452,136,81,1023,156,407,303,5260
"32003005352",2286,318,104,11,392,81,308,137,3637
"32003005353",2583,102,185,10,536,27,472,0,3915
"32003005354",3606,423,306,0,535,80,667,230,5847
"32003005355",3821,374,70,32,616,4,270,75,5262
"32003005356",2028,43,87,16,238,12,371,17,2812
"32003005357",4419,352,485,98,758,230,599,69,7010
"32003005358",2263,161,0,0,493,4,471,22,3414
"32003005359",5542,312,725,128,858,91,1138,0,8794
"32003005360",3605,490,76,0,482,0,656,11,5320
"32003005421",1591,608,277,578,106,114,253,235,3762
"32003005422",2399,701,181,98,324,240,667,428,5038
"32003005423",2449,446,213,535,498,76,833,60,5110
"32003005432",4398,105,490,0,877,0,784,0,6654
"32003005433",3821,297,94,0,313,157,453,147,5282
"32003005434",3645,445,69,15,554,34,608,198,5568
"32003005435",2734,511,50,18,106,141,337,121,4018
"32003005436",5946,224,428,464,921,48,1234,14,9279
"32003005437",2338,202,113,0,83,0,59,0,2795
"32003005438",1218,132,116,194,191,92,189,55,2187
"32003005439",1840,482,207,217,645,22,812,212,4437
"32003005501",3553,350,0,0,236,16,147,16,4318
"32003005502",3620,364,0,2,121,2,353,32,4494
"32003005503",2582,243,0,0,90,135,63,95,3208
"32003005504",2784,430,0,14,268,46,433,189,4164
"32003005607",2371,384,63,8,566,214,1129,347,5082
"32003005612",1161,138,0,19,133,8,138,0,1597
"32003005613",3857,200,202,0,180,10,367,30,4846
"32003005614",1150,501,0,6,273,244,498,482,3154
"32003005615",1463,137,0,0,118,93,373,98,2282
"32003005702",1937,800,43,37,103,211,151,162,3444
"32003005703",573,228,51,11,169,16,135,12,1195
"32003005704",1420,536,116,0,80,14,372,73,2611
"32003005705",1932,266,73,0,236,15,78,39,2639
"32003005711",3778,110,106,0,560,169,361,11,5095
"32003005712",6870,279,244,99,1058,63,1168,0,9781
"32003005713",4432,123,143,26,1124,134,691,12,6685
"32003005714",4801,145,175,22,460,34,318,0,5955
"32003005715",3420,143,269,0,678,23,196,9,4738
"32003005716",2573,105,227,11,705,70,59,0,3750
"32003005803",2594,480,176,60,688,185,580,19,4782
"32003005804",3059,27,223,0,678,146,275,0,4408
"32003005805",2462,151,108,62,470,60,466,29,3808
"32003005806",2771,339,197,39,366,209,584,209,4714
"32003005807",3021,208,320,173,562,84,463,15,4846
"32003005808",2140,84,216,19,566,58,340,0,3423
"32003005809",2501,520,349,0,549,138,920,309,5286
"32003005811",4313,181,936,24,2461,311,1351,206,9783
"32003005813",1934,120,620,202,1347,28,797,54,5102
"32003005818",597,132,0,0,66,0,107,0,902
"32003005822",3948,172,80,0,1305,430,328,30,6293
"32003005823",2820,42,332,0,905,37,443,7,4586
"32003005824",2273,198,56,0,510,96,190,202,3525
"32003005825",2888,491,409,94,1095,410,1010,406,6803
"32003005826",1331,286,608,33,1498,122,434,141,4453
"32003005827",4242,290,56,39,1830,223,654,0,7334
"32003005828",4259,124,588,95,2339,131,656,64,8256
"32003005829",3660,345,494,29,1827,220,1035,226,7836
"32003005830",1478,72,712,0,1310,80,506,0,4158
"32003005831",2443,60,270,222,1073,47,541,8,4664
"32003005832",2180,229,93,120,879,96,626,31,4254
"32003005833",3326,316,511,348,2485,170,1032,102,8290
"32003005834",2247,166,180,0,407,38,837,24,3899
"32003005835",3057,71,1075,23,1005,0,1030,0,6261
"32003005836",2980,129,45,0,950,86,564,0,4754
"32003005837",2783,336,280,0,847,24,854,70,5194
"32003005838",3941,53,372,0,1847,175,851,11,7250
"32003005839",2980,35,159,19,629,275,707,255,5059
"32003005840",5387,297,563,235,2969,43,2243,52,11789
"32003005841",3332,207,235,0,638,0,340,134,4886
"32003005842",1678,44,41,13,82,79,27,5,1969
"32003005843",1909,243,21,0,464,28,158,16,2839
"32003005844",5187,165,206,0,924,18,1028,0,7528
"32003005845",2537,385,303,0,775,124,504,102,4730
"32003005846",4165,112,27,0,971,98,915,18,6306
"32003005847",983,83,137,17,530,35,174,0,1959
"32003005848",2217,252,380,204,962,704,511,322,5552
"32003005849",2150,207,519,5,822,10,922,11,4646
"32003005850",1846,41,381,56,1566,117,400,40,4447
"32003005851",3370,637,163,63,2187,150,1250,264,8084
"32003005852",2787,106,205,0,1073,6,578,0,4755
"32003005853",4487,885,394,3,2044,276,1540,406,10035
"32003005854",4811,487,796,353,2226,330,1343,0,10346
"32003005855",2819,288,281,35,2177,15,593,41,6249
"32003005856",2264,61,63,14,1570,163,317,22,4474
"32003005902",939,32,0,1,325,136,224,70,1727
"32003005903",2210,82,5,0,70,0,294,4,2665
"32003005904",1879,84,5,0,92,0,185,5,2250
"32003005905",1803,291,0,0,298,4,226,3,2625
"32003006001",2024,459,1153,389,718,458,751,601,6553
"32003006103",1608,171,307,226,508,222,842,392,4276
"32003006104",1874,217,170,80,1037,78,712,143,4311
"32003006201",1131,1217,367,83,784,227,1020,909,5738
"32003006202",1668,779,249,0,918,58,1594,609,5875
"32003006203",1545,549,108,94,401,188,770,372,4027
"32003006204",2012,622,166,203,1268,87,1679,258,6295
"32003006700",517,70,32,0,121,43,38,7,828
"32003006800",2185,501,303,232,496,274,1268,431,5690
"32003006900",1287,84,61,19,332,6,305,0,2094
"32003007100",1157,867,70,58,573,377,1295,871,5268
"32003007200",1644,441,372,335,1005,326,1452,373,5948
"32003007500",854,80,0,0,58,88,105,5,1190
"32003007600",2927,272,0,0,670,25,746,89,4729
"32003007800",631,638,76,120,199,53,205,93,2015
"32005001000",2381,220,21,0,250,0,201,33,3106
"32005001100",3363,850,40,0,571,285,487,237,5833
"32005001200",2380,438,0,0,37,21,170,79,3125
"32005001300",1482,65,0,0,11,7,46,36,1647
"32005001400",2595,235,0,4,324,53,252,53,3516
"32005001500",4110,498,69,16,718,209,935,154,6709
"32005001600",1034,90,5,0,26,0,16,6,1177
"32005001700",1285,158,0,0,265,54,393,66,2221
"32005001800",1760,106,0,0,128,25,271,0,2290
"32005001900",1295,42,0,0,141,0,101,5,1584
"32005002000",2814,482,0,0,426,11,752,14,4499
"32005002100",1606,150,6,0,122,0,169,37,2090
"32005002200",6214,166,0,0,172,0,412,0,6964
"32005002300",3135,196,0,0,145,4,106,0,3586
"32005002400",806,92,10,2,352,223,181,45,1711
"32005002500",1668,171,6,0,119,37,135,30,2166
"32005990000",0,0,0,0,0,0,0,0,0
"32007950200",1677,107,0,0,46,59,400,52,2341
"32007950701",4764,506,79,44,478,76,1070,302,7319
"32007950702",4091,123,83,0,681,256,686,61,5981
"32007950800",1462,30,10,0,149,18,164,3,1836
"32007950900",1747,143,149,0,152,49,297,45,2582
"32007951000",1223,54,45,0,124,0,477,17,1940
"32007951201",4225,28,0,0,435,4,176,0,4868
"32007951202",2444,232,13,0,228,68,980,167,4132
"32007951300",1970,281,21,0,269,63,1314,90,4008
"32007951401",4228,112,25,22,518,0,1211,22,6138
"32007951402",5954,413,0,0,285,0,379,86,7117
"32007951500",3245,1013,25,0,44,245,1945,720,7237
"32007951600",2157,139,0,3,0,0,183,1,2483
"32007951700",1341,628,0,0,896,250,725,314,4154
"32009950100",743,148,0,0,44,87,100,57,1179
"32011000100",1397,275,0,0,63,10,38,12,1795
"32013010500",4504,392,19,1,764,280,1193,9,7162
"32013010600",2137,220,0,0,98,4,423,11,2893
"32013010701",3735,459,0,1,282,59,1452,167,6155
"32013010702",3146,158,8,0,271,97,849,11,4540
"32015000300",4689,604,0,4,469,99,1277,102,7244
"32017950100",2063,358,0,0,88,127,0,30,2666
"32017950200",1934,312,0,0,46,0,200,125,2617
"32019960101",7825,820,117,29,1198,0,1004,145,11138
"32019960102",6098,811,76,42,752,85,1252,216,9332
"32019960103",951,246,0,6,55,4,276,71,1609
"32019960201",3092,632,6,0,533,28,380,55,4726
"32019960202",2042,822,56,0,196,89,135,159,3499
"32019960301",1240,605,0,0,40,139,283,170,2477
"32019960302",6604,1417,52,0,749,59,964,390,10235
"32019960303",3642,421,4,0,313,37,515,10,4942
"32019960800",3420,306,24,3,153,5,639,15,4565
"32019960900",3131,762,6,6,1055,251,863,223,6297
"32021970700",1968,419,43,28,666,73,314,117,3628
"32021970800",465,154,0,0,444,245,120,25,1453
"32023960100",2130,228,0,2,482,124,303,3,3272
"32023960200",2080,323,0,0,124,27,292,10,2856
"32023960300",1276,584,0,0,296,0,538,99,2793
"32023960401",4219,495,218,92,302,247,453,189,6215
"32023960402",3555,1122,86,14,348,132,693,309,6259
"32023960403",3567,1027,31,180,64,122,318,333,5642
"32023960404",5919,1122,148,0,507,289,542,533,9060
"32023960405",2191,1003,89,3,74,6,360,194,3920
"32023960406",5739,648,83,99,1001,2,689,138,8399
"32023980500",0,0,0,0,0,0,0,0,0
"32027960100",3439,757,6,6,466,168,639,240,5721
"32029970200",3346,384,2,12,156,17,89,70,4076
"32031000101",1490,648,109,28,238,327,92,200,3132
"32031000102",991,932,26,249,271,243,231,276,3219
"32031000201",2134,434,5,48,313,139,1593,197,4863
"32031000202",1464,765,10,0,224,76,530,293,3362
"32031000300",2770,486,16,0,305,112,419,48,4156
"32031000400",4088,887,81,5,307,91,108,58,5625
"32031000700",2412,1387,148,0,1100,140,1062,326,6575
"32031000900",2035,1364,51,295,252,319,1465,1231,7012
"32031001005",2261,310,0,35,337,98,372,96,3509
"32031001008",2049,1172,60,9,558,542,1387,809,6586
"32031001009",1365,336,0,14,380,26,472,168,2761
"32031001010",2445,186,17,0,228,17,83,18,2994
"32031001011",3496,34,16,19,156,20,94,0,3835
"32031001012",2445,189,113,31,296,68,110,34,3286
"32031001013",6236,194,0,35,604,73,102,51,7295
"32031001014",1916,109,0,0,487,33,246,0,2791
"32031001015",3281,154,19,58,375,10,178,2,4077
"32031001101",2662,167,0,0,25,34,126,18,3032
"32031001103",4082,309,142,0,350,0,27,33,4943
"32031001104",3774,105,0,0,675,2,87,0,4643
"32031001105",3471,147,0,5,193,7,221,22,4066
"32031001201",1628,381,8,23,193,24,90,158,2505
"32031001202",2690,746,252,49,592,221,346,61,4957
"32031001300",2363,489,30,37,360,234,269,207,3989
"32031001400",1413,949,67,0,493,193,335,197,3647
"32031001501",2872,617,81,9,973,47,1273,210,6082
"32031001502",1686,1335,327,162,423,344,538,447,5262
"32031001701",992,970,66,398,594,576,872,894,5362
"32031001702",2976,832,83,59,764,390,1385,769,7258
"32031001801",1350,923,89,18,975,281,1398,628,5662
"32031001802",1175,453,97,47,1248,245,1476,480,5221
"32031001901",2361,1373,156,110,589,378,1653,1240,7860
"32031001902",2413,1038,17,32,696,220,1103,492,6011
"32031002103",2513,66,20,0,429,0,623,14,3665
"32031002104",2581,154,24,7,223,42,228,25,3284
"32031002105",3332,565,89,18,634,43,1340,133,6154
"32031002106",2487,295,54,0,422,40,1070,0,4368
"32031002107",675,437,11,12,419,236,412,343,2545
"32031002204",2660,796,253,0,681,517,1653,906,7466
"32031002205",3561,417,43,35,664,108,1090,366,6284
"32031002206",4562,411,27,0,1108,141,737,86,7072
"32031002207",3181,25,136,0,990,32,312,9,4685
"32031002208",2513,107,38,0,412,70,344,21,3505
"32031002209",3991,226,26,0,1481,35,500,35,6294
"32031002210",2047,83,0,0,111,54,208,0,2503
"32031002211",1799,1093,0,0,620,142,1458,915,6027
"32031002212",2090,1743,54,315,102,488,1332,2072,8196
"32031002301",4330,88,53,0,512,11,360,0,5354
"32031002302",2093,86,0,0,261,0,145,19,2604
"32031002401",2493,315,1,2,749,12,321,32,3925
"32031002406",3343,980,65,0,665,176,518,321,6068
"32031002407",2661,462,61,1,523,60,419,167,4354
"32031002408",2382,240,10,91,340,120,215,24,3422
"32031002409",3763,312,47,0,205,0,523,0,4850
"32031002410",3153,452,28,0,479,13,787,154,5066
"32031002411",2815,439,174,0,532,28,516,87,4591
"32031002412",2027,29,0,0,459,100,361,0,2976
"32031002500",3424,647,115,83,517,179,646,151,5762
"32031002603",1206,99,0,0,72,21,105,15,1518
"32031002610",4485,209,12,200,661,96,1612,34,7309
"32031002611",3576,1750,112,255,586,573,1154,711,8717
"32031002612",2405,801,114,0,190,8,346,29,3893
"32031002613",4204,186,147,0,883,0,548,0,5968
"32031002614",2528,365,56,0,827,299,1353,445,5873
"32031002615",2008,387,80,37,919,61,594,320,4406
"32031002616",2504,388,85,0,741,84,1216,94,5112
"32031002617",3949,494,53,22,1244,137,2116,208,8223
"32031002618",5498,286,0,1,570,1,893,23,7272
"32031002619",4007,1325,200,35,372,134,879,790,7742
"32031002703",1522,379,102,111,324,12,756,105,3311
"32031002704",2929,821,126,23,273,274,1114,613,6173
"32031002705",2568,1120,53,51,402,28,655,425,5302
"32031002706",3040,614,42,77,672,295,976,451,6167
"32031002707",3209,868,29,0,573,20,1346,611,6656
"32031002801",2398,802,196,38,1072,185,1566,530,6787
"32031002802",3099,726,68,11,1371,99,2312,556,8242
"32031002901",2953,280,0,25,77,86,810,38,4269
"32031002902",2290,834,40,39,1011,308,1135,757,6414
"32031003000",4321,522,42,0,1661,164,2419,307,9436
"32031003101",2587,604,79,135,468,88,593,205,4759
"32031003105",1761,174,33,0,315,62,477,18,2840
"32031003106",4796,849,82,0,1271,258,1770,458,9484
"32031003108",2769,107,52,0,296,30,593,9,3856
"32031003109",2357,152,0,0,450,53,103,9,3124
"32031003110",3457,475,34,0,820,156,360,156,5458
"32031003202",5580,313,0,0,248,0,276,25,6442
"32031003203",4523,164,30,7,228,10,144,1,5107
"32031003204",2336,27,40,0,83,0,54,0,2540
"32031003305",1025,132,0,0,192,0,418,0,1767
"32031003306",1133,181,0,0,105,94,354,206,2073
"32031003307",850,221,0,0,0,0,175,12,1258
"32031003308",1754,124,0,0,170,11,72,0,2131
"32031003309",2054,206,0,0,143,0,130,0,2533
"32031003501",2757,200,66,9,503,239,365,3,4142
"32031003503",4180,113,57,1,332,26,1219,1,5929
"32031003504",6658,260,81,0,575,27,558,0,8159
"32031003507",3413,32,73,0,496,8,322,0,4344
"32031003508",2348,114,6,0,383,3,493,10,3357
"32031003509",3780,69,220,10,1221,23,1251,22,6596
"32031003510",1858,294,42,0,585,320,493,450,4042
"32031003511",4455,254,180,0,417,0,638,29,5973
"32031003512",3827,251,163,19,470,14,494,75,5313
"32031003513",1944,66,48,0,233,68,408,10,2777
"32031003514",1974,156,98,0,242,40,317,0,2827
"32031003515",5198,142,64,43,871,14,1305,84,7721
"32031940200",270,82,0,3,823,451,70,64,1763
"32031980000",0,42,0,14,0,0,0,13,69
"32031980100",0,0,0,0,0,0,0,0,0
"32031980200",0,0,0,0,0,0,0,0,0
"32031980300",0,0,0,0,0,0,0,0,0
"32031990000",0,0,0,0,0,0,0,0,0
"32031990100",0,0,0,0,0,0,0,0,0
"32033970100",1644,158,0,0,51,10,62,11,1936
"32033970200",3744,478,52,0,358,133,595,97,5457
"32033970300",1831,175,0,1,231,25,316,42,2621
"32510000100",2517,112,173,3,313,24,198,34,3374
"32510000200",3002,795,19,0,237,5,294,325,4677
"32510000300",3153,75,0,0,361,53,97,3,3742
"32510000400",2869,317,0,0,374,208,586,152,4506
"32510000501",3657,1097,94,0,704,402,1362,857,8173
"32510000502",2116,840,0,0,114,210,331,255,3866
"32510000600",3438,730,159,0,849,121,1066,187,6550
"32510000701",3292,426,0,0,167,13,467,94,4459
"32510000702",2416,558,34,0,217,124,325,532,4206
"32510000800",2317,228,0,0,225,47,254,2,3073
"32510000900",3174,634,0,0,1046,16,1028,113,6011
"32510001001",2164,888,19,0,739,718,1438,1035,7001
"32510001002",2914,333,71,0,639,38,756,0,4751
"32510990000",0,0,0,0,0,0,0,0,0
"33001965100",2799,315,12,0,112,24,4,0,3266
"33001965200",2662,329,0,0,38,0,18,0,3047
"33001965300",2960,186,36,0,51,0,19,0,3252
"33001965400",2891,76,2,0,8,0,101,0,3078
"33001965598",3010,249,0,0,18,65,0,65,3407
"33001965600",3059,477,0,0,172,19,32,0,3759
"33001965700",4376,223,0,0,6,0,0,0,4605
"33001965800",6018,635,271,40,292,0,338,67,7661
"33001965900",3077,588,0,0,72,0,95,0,3832
"33001966000",3775,996,0,0,96,80,0,0,4947
"33001966100",3655,221,0,0,127,29,45,7,4084
"33001966200",2189,510,0,0,36,35,0,0,2770
"33001966401",1064,127,0,0,26,0,38,0,1255
"33001966402",5337,420,0,0,159,9,16,0,5941
"33001966500",4508,416,110,0,230,0,16,0,5280
"33003955100",3500,364,3,2,108,0,0,19,3996
"33003955300",5212,694,64,0,187,80,15,85,6337
"33003955400",3459,367,0,0,253,1,0,19,4099
"33003955500",2632,178,16,0,16,0,1,0,2843
"33003955600",4481,510,27,9,85,9,11,0,5132
"33003955800",2116,396,8,0,18,9,4,0,2551
"33003955900",3106,900,0,0,85,0,38,0,4129
"33003956000",5328,306,3,0,151,3,142,0,5933
"33003956100",5625,425,0,0,85,0,230,0,6365
"33003956300",3914,117,0,1,0,0,17,1,4050
"33003956400",2089,162,0,0,5,0,0,0,2256
"33005970100",3719,294,5,0,82,0,61,0,4161
"33005970200",3293,199,0,0,170,35,100,10,3807
"33005970400",4836,253,37,0,49,3,56,6,5240
"33005970500",4427,730,0,0,125,30,15,0,5327
"33005970600",4023,589,54,0,117,98,15,25,4921
"33005970700",3115,217,12,0,191,0,22,0,3557
"33005970800",3558,257,178,0,90,13,31,0,4127
"33005970900",6057,844,0,0,172,139,278,63,7553
"33005971000",4748,461,71,0,190,50,106,0,5626
"33005971100",4037,946,0,4,127,19,69,4,5206
"33005971300",2081,660,0,0,243,0,122,0,3106
"33005971401",1589,796,67,0,139,45,0,14,2650
"33005971402",3179,315,0,0,240,7,84,0,3825
"33005971500",5124,293,6,0,97,0,3,23,5546
"33005971600",3576,369,21,0,21,0,15,0,4002
"33005971700",3378,711,0,0,93,50,22,0,4254
"33007950100",1588,270,0,3,29,12,25,9,1936
"33007950200",2509,456,6,0,81,0,34,9,3095
"33007950300",1889,132,2,0,31,4,41,10,2109
"33007950400",2784,543,10,7,21,0,10,0,3375
"33007950500",2921,284,11,9,67,0,6,1,3299
"33007950600",2379,724,0,0,58,65,22,25,3273
"33007950700",2627,342,0,0,40,13,30,37,3089
"33007950800",1986,365,10,0,62,0,7,14,2444
"33007950900",2870,229,0,0,40,0,31,0,3170
"33007951000",1972,283,5,0,64,2,5,2,2333
"33007951100",2585,318,4,0,82,5,32,13,3039
"33009960100",5067,635,27,15,184,0,102,40,6070
"33009960200",3560,450,10,0,67,160,23,0,4270
"33009960300",3980,436,20,0,144,12,65,10,4667
"33009960400",3562,372,12,0,76,0,2,0,4024
"33009960500",1942,241,0,0,41,13,2,8,2247
"33009960600",3645,634,9,0,111,0,22,0,4421
"33009960700",2821,287,7,0,72,5,20,5,3217
"33009960800",4459,363,12,0,184,9,0,0,5027
"33009960900",2836,307,7,0,107,0,54,7,3318
"33009961000",3929,1083,59,0,198,90,242,1,5602
"33009961100",3590,428,40,0,64,0,13,10,4145
"33009961200",3695,363,0,0,61,0,13,0,4132
"33009961300",2907,379,73,0,46,4,31,2,3442
"33009961400",3293,472,0,0,90,11,14,0,3880
"33009961500",4350,74,11,56,55,0,57,0,4603
"33009961601",2697,73,0,0,130,0,50,0,2950
"33009961602",3206,522,0,59,289,207,36,0,4319
"33009961700",5133,947,11,33,929,247,184,140,7624
"33009961800",5045,173,0,41,636,86,346,0,6327
"33011000101",2454,108,31,53,81,67,10,88,2892
"33011000102",3357,177,146,0,191,328,40,0,4239
"33011000202",1861,275,50,0,37,28,14,23,2288
"33011000203",2242,247,167,0,193,32,19,0,2900
"33011000204",3087,570,338,69,792,56,185,85,5182
"33011000300",2239,389,0,0,121,0,104,65,2918
"33011000600",1352,262,41,0,56,71,94,49,1925
"33011000700",2754,100,16,29,98,0,67,0,3064
"33011000800",1833,283,87,62,122,56,365,76,2884
"33011000901",3149,247,126,0,11,0,203,90,3826
"33011000902",4307,298,369,97,642,33,64,137,5947
"33011001000",4948,195,0,0,340,0,116,0,5599
"33011001100",4980,99,48,0,149,26,171,0,5473
"33011001200",1497,198,7,0,59,0,117,109,1987
"33011001300",1739,664,209,92,170,152,481,78,3585
"33011001400",1114,508,121,85,232,126,252,205,2643
"33011001500",934,747,134,271,563,257,416,260,3582
"33011001600",2399,1138,223,90,800,298,686,296,5930
"33011001700",1734,273,64,0,55,45,112,158,2441
"33011001800",3907,651,157,27,639,71,360,154,5966
"33011001900",1410,414,75,61,634,26,474,131,3225
"33011002000",982,615,137,88,293,131,158,213,2617
"33011002100",3054,957,174,74,494,106,339,109,5307
"33011002200",3053,337,24,0,31,32,189,32,3698
"33011002300",3321,165,34,0,193,0,119,2,3834
"33011002400",5103,938,576,193,371,123,452,37,7793
"33011002500",4531,334,67,0,220,43,185,20,5400
"33011002600",5202,170,0,0,547,0,272,0,6191
"33011002701",3454,201,0,0,88,0,23,0,3766
"33011002702",5617,280,13,0,56,0,0,51,6017
"33011002800",5137,291,152,0,59,17,171,17,5844
"33011002901",6253,339,94,25,383,0,109,0,7203
"33011002902",5324,157,167,0,122,0,43,35,5848
"33011002903",7953,54,8,0,73,0,127,0,8215
"33011010100",4598,75,224,0,276,20,233,15,5441
"33011010200",5231,478,163,20,1036,21,448,51,7448
"33011010301",3763,26,0,0,509,0,147,0,4445
"33011010302",3809,177,22,0,370,0,405,8,4791
"33011010400",3898,533,147,0,393,0,158,177,5306
"33011010500",2346,1111,94,12,320,185,597,799,5464
"33011010600",3394,586,545,178,337,380,690,404,6514
"33011010700",739,292,48,0,168,58,217,104,1626
"33011010800",4264,2083,172,117,745,229,1690,845,10145
"33011010900",5033,887,142,0,554,34,503,89,7242
"33011011000",4002,259,67,0,287,14,246,0,4875
"33011011101",2669,213,34,22,552,9,114,14,3627
"33011011102",1953,184,95,23,806,50,323,5,3439
"33011011200",4860,86,119,0,1101,0,259,0,6425
"33011011300",3700,124,50,0,345,26,92,0,4337
"33011011401",4244,198,16,0,893,23,461,0,5835
"33011011402",3821,305,145,0,775,0,339,31,5416
"33011011500",2049,71,0,0,155,10,122,10,2417
"33011012100",7396,218,112,0,368,0,86,0,8180
"33011012200",6757,424,183,0,237,57,476,43,8177
"33011012300",7690,378,38,0,556,0,79,0,8741
"33011013100",7763,395,42,0,129,0,209,0,8538
"33011014100",4457,302,0,0,160,8,48,0,4975
"33011014201",5640,94,0,21,283,57,310,0,6405
"33011014202",5754,139,0,0,150,0,40,0,6083
"33011014300",7530,352,0,0,399,0,263,1,8545
"33011015100",4868,145,40,0,257,0,102,0,5412
"33011015200",5514,67,0,0,248,86,121,86,6122
"33011016100",2594,76,25,0,290,0,117,0,3102
"33011016201",5548,565,42,0,474,86,69,88,6872
"33011016202",5014,171,0,0,105,0,190,0,5480
"33011017100",7311,124,18,0,248,8,162,0,7871
"33011018000",4833,41,3,0,174,0,16,0,5067
"33011018501",1989,305,0,0,80,0,2,0,2376
"33011018502",1086,207,0,0,5,27,7,0,1332
"33011019000",3426,166,15,2,70,0,45,2,3726
"33011019501",1492,84,3,0,49,5,19,0,1652
"33011019502",2292,194,0,0,10,12,22,0,2530
"33011020000",5136,89,24,0,132,0,51,0,5432
"33011021000",8508,149,14,0,178,0,111,0,8960
"33011021500",4238,278,12,0,101,41,79,0,4749
"33011022000",1229,95,1,0,81,5,27,0,1438
"33011022500",6684,309,0,0,40,0,98,16,7147
"33011023000",5686,378,26,5,106,15,40,1,6257
"33011024000",1665,82,4,0,33,0,28,0,1812
"33011025000",2302,254,13,0,32,24,18,0,2643
"33011025500",5298,710,3,0,178,3,67,3,6262
"33011200100",4335,299,21,0,101,3,0,76,4835
"33011200200",3965,121,0,0,101,19,125,0,4331
"33011200300",3497,306,26,12,137,42,56,0,4076
"33011200400",1679,484,249,11,108,148,165,168,3012
"33011980101",0,0,0,0,0,0,0,0,0
"33013003001",3403,100,54,0,73,4,165,0,3799
"33013003006",3171,187,6,0,0,0,157,0,3521
"33013003100",3791,375,36,0,46,0,72,0,4320
"33013003200",6366,504,0,0,147,104,173,0,7294
"33013030000",2487,164,10,0,108,0,19,0,2788
"33013031001",3708,69,0,0,63,64,60,64,4028
"33013031002",3394,153,0,0,160,0,0,0,3707
"33013032100",3345,188,26,0,104,0,0,2,3665
"33013032200",2594,365,57,45,65,0,112,0,3238
"33013032300",1269,209,13,2,109,59,20,18,1699
"33013032400",2551,443,61,0,78,13,42,13,3201
"33013032500",2884,392,0,48,121,0,8,0,3453
"33013032600",2028,120,59,16,42,4,0,0,2269
"33013032701",1283,120,19,0,195,0,137,0,1754
"33013032706",3509,375,48,60,32,14,169,0,4207
"33013032800",4487,98,0,0,255,0,65,0,4905
"33013032900",2222,604,148,33,263,401,4,25,3700
"33013033000",2272,170,6,0,59,0,12,0,2519
"33013034000",4298,140,0,0,32,11,2,0,4483
"33013035000",3150,699,29,30,146,15,62,0,4131
"33013036000",4735,407,0,0,155,46,11,9,5363
"33013037000",2182,93,12,0,4,0,35,0,2326
"33013038000",2877,535,0,0,19,9,23,14,3477
"33013038500",4186,353,0,0,94,0,50,0,4683
"33013039000",5190,203,29,0,162,0,11,8,5603
"33013040000",3755,389,11,0,31,0,49,31,4266
"33013040500",4934,341,15,0,153,1,28,0,5472
"33013041000",3112,329,0,0,73,41,68,0,3623
"33013041500",3468,216,11,0,54,8,0,0,3757
"33013042500",3341,289,14,0,121,21,24,0,3810
"33013043001",2756,1250,9,0,18,44,61,24,4162
"33013043002",3261,593,80,78,173,20,67,41,4313
"33013044000",4073,454,30,0,71,132,60,0,4820
"33013044100",2625,671,65,30,298,64,36,0,3789
"33013044200",5399,91,25,0,367,0,265,0,6147
"33013044300",3814,262,177,0,181,23,57,0,4514
"33015003301",4195,229,0,0,144,1,138,0,4707
"33015003302",4338,240,16,0,72,0,122,0,4788
"33015003400",4575,575,99,0,168,21,102,33,5573
"33015003500",4769,753,40,105,175,16,164,0,6022
"33015003601",6004,574,181,0,363,0,121,50,7293
"33015003602",5080,164,1,0,37,0,18,0,5300
"33015003701",2870,198,62,0,73,0,133,10,3346
"33015003703",5160,116,99,0,148,0,34,0,5557
"33015003801",3747,70,0,0,108,0,124,0,4049
"33015003802",3924,73,37,0,117,11,222,0,4384
"33015003901",3601,173,0,0,133,8,89,13,4017
"33015003902",3377,74,6,0,0,0,6,0,3463
"33015004000",4769,131,16,0,161,0,46,0,5123
"33015050000",3640,150,0,0,124,0,48,0,3962
"33015051000",4353,200,20,11,105,0,90,24,4803
"33015052000",5577,438,15,0,96,7,35,7,6175
"33015053000",4181,118,0,0,106,0,44,0,4449
"33015054000",4047,102,83,0,78,14,95,14,4433
"33015055001",5290,493,123,0,100,0,203,0,6209
"33015055002",3530,397,33,0,194,0,70,110,4334
"33015056000",4143,163,3,0,21,0,26,0,4356
"33015057000",3731,349,33,0,148,8,109,10,4388
"33015058000",4542,147,59,0,77,0,23,0,4848
"33015059000",6052,307,0,0,108,108,10,0,6585
"33015060000",3792,285,0,12,82,11,61,11,4254
"33015061001",5664,369,0,0,169,0,14,0,6216
"33015062000",2352,70,0,0,31,0,23,0,2476
"33015062500",2689,87,12,0,43,16,47,6,2900
"33015063001",2943,282,8,0,180,100,61,100,3674
"33015063002",4405,695,0,0,126,8,0,0,5234
"33015064000",2063,79,6,0,152,7,0,0,2307
"33015065001",7028,455,81,0,511,0,25,0,8100
"33015065005",2373,51,0,0,23,0,65,0,2512
"33015065006",1420,76,0,0,38,0,0,0,1534
"33015065007",1289,44,16,0,0,0,54,0,1403
"33015065008",913,420,0,0,27,0,26,16,1402
"33015066000",4068,119,56,0,61,40,32,13,4389
"33015067000",7096,24,0,1,170,0,67,1,7359
"33015067501",5856,458,4,0,600,106,291,91,7406
"33015067502",2855,246,76,33,193,45,42,24,3514
"33015069100",3517,128,19,0,31,17,39,0,3751
"33015069200",2704,172,0,0,185,0,0,0,3061
"33015069300",1855,128,15,11,36,26,26,0,2097
"33015069700",2693,67,21,0,271,7,84,10,3153
"33015071000",4970,251,16,0,38,0,37,14,5326
"33015100100",6358,189,21,0,197,0,143,0,6908
"33015100200",4996,247,0,0,179,0,30,0,5452
"33015100301",4085,171,91,18,220,31,372,18,5006
"33015100302",3514,164,47,0,535,0,510,60,4830
"33015100400",6586,286,88,15,609,34,478,0,8096
"33015101100",7235,247,3,0,114,0,75,0,7674
"33015102100",4219,405,48,6,22,17,111,132,4960
"33015103100",6430,211,0,0,147,0,216,0,7004
"33015104101",4448,320,24,0,104,0,137,0,5033
"33015104102",3230,203,0,0,177,6,6,0,3622
"33015105100",5549,332,0,0,133,0,110,0,6124
"33015106101",6797,202,0,0,436,90,42,0,7567
"33015106102",5823,187,68,0,305,0,0,0,6383
"33015106200",3277,439,15,59,71,33,0,59,3953
"33015106400",3971,121,0,0,26,35,70,0,4223
"33015107100",1994,260,88,10,240,117,148,11,2868
"33015107200",4445,582,301,0,519,11,290,56,6204
"33015107400",1070,80,10,0,167,0,63,0,1390
"33015107500",4196,180,1,0,58,9,66,0,4510
"33015980011",0,0,0,0,0,0,0,0,0
"33015990000",0,0,0,0,0,0,0,0,0
"33017080100",2935,18,0,0,229,0,88,0,3270
"33017080202",1579,845,0,0,236,12,64,1,2737
"33017080203",738,337,0,0,134,68,5,0,1282
"33017080204",522,528,0,0,41,0,10,0,1101
"33017080500",5600,271,7,0,407,0,117,0,6402
"33017081100",5532,461,139,0,485,152,0,0,6769
"33017081200",4082,60,0,0,176,0,62,0,4380
"33017081300",3641,745,0,0,123,30,50,0,4589
"33017081400",1418,211,32,0,251,39,63,0,2014
"33017081500",4284,608,32,24,581,35,184,0,5748
"33017081600",5439,340,75,0,457,24,102,0,6437
"33017082000",2288,134,20,0,86,0,83,8,2619
"33017083001",4972,726,134,0,506,317,287,149,7091
"33017083002",3630,676,249,0,456,56,123,0,5190
"33017084100",4554,175,0,0,222,33,16,0,5000
"33017084200",6878,673,29,0,235,6,14,0,7835
"33017084300",4415,1220,0,0,175,12,236,0,6058
"33017084400",3163,860,48,47,80,126,138,0,4462
"33017084500",3249,663,20,0,189,35,84,0,4240
"33017084600",2344,156,0,0,4,0,22,0,2526
"33017085000",7986,546,0,0,137,0,62,0,8731
"33017086000",3780,74,35,0,108,1,274,0,4272
"33017087000",5811,861,0,0,80,53,0,46,6851
"33017088000",4149,372,15,0,36,0,9,0,4581
"33017088500",3834,320,8,0,17,32,27,0,4238
"33019975100",3718,81,17,0,180,4,57,0,4057
"33019975200",4707,113,13,0,92,9,36,0,4970
"33019975300",3050,178,0,0,135,0,94,0,3457
"33019975400",5130,711,0,0,431,39,57,3,6371
"33019975500",2629,227,13,0,38,13,55,0,2975
"33019975600",2738,193,0,0,51,11,25,0,3018
"33019975700",4290,543,61,0,146,7,10,0,5057
"33019975800",4675,514,31,14,211,8,139,0,5592
"33019975901",3579,769,0,0,0,0,0,11,4359
"33019975902",2764,440,0,0,23,0,63,0,3290
"34001000100",902,118,137,512,444,177,494,128,2912
"34001000200",1711,143,366,0,661,342,541,12,3776
"34001000300",1314,589,342,114,1280,645,1094,670,6048
"34001000400",1147,567,187,112,477,279,523,441,3733
"34001000500",802,613,91,107,1106,327,491,640,4177
"34001001100",51,149,938,483,84,191,36,216,2148
"34001001200",253,128,1699,745,230,172,359,244,3830
"34001001300",83,83,1249,381,187,3,92,113,2191
"34001001400",411,442,1576,1105,9,450,279,807,5079
"34001001500",136,113,611,428,75,158,89,126,1736
"34001001900",506,86,501,191,241,45,451,80,2101
"34001002300",655,560,35,205,786,432,589,323,3585
"34001002400",746,463,293,604,293,158,388,328,3273
"34001002500",518,309,1735,1065,278,240,140,120,4405
"34001010101",3156,200,0,11,67,0,86,22,3542
"34001010102",1593,175,33,0,60,17,63,0,1941
"34001010104",1183,295,0,0,92,0,121,63,1754
"34001010105",1687,181,84,187,324,46,162,235,2906
"34001010200",5049,298,54,25,335,0,537,0,6298
"34001010300",1275,73,324,8,623,190,304,20,2817
"34001010401",4589,146,139,145,273,0,203,31,5526
"34001010403",2675,471,394,71,2449,427,930,289,7706
"34001010501",5844,327,474,1,583,61,714,65,8069
"34001010503",3969,271,1989,515,1401,166,1544,73,9928
"34001010505",2230,108,42,16,143,5,224,0,2768
"34001010506",3464,208,465,0,798,99,441,0,5475
"34001010600",2301,220,730,93,312,554,663,569,5442
"34001010700",4629,449,258,160,574,58,1070,147,7345
"34001010800",2366,281,37,0,296,66,368,117,3531
"34001010900",4419,272,255,25,834,0,876,146,6827
"34001011000",2158,139,41,28,285,16,417,42,3126
"34001011100",2043,322,40,59,524,19,610,229,3846
"34001011201",1393,127,190,6,79,4,143,4,1946
"34001011202",5123,552,514,310,612,457,612,328,8508
"34001011300",3244,286,145,29,846,47,1352,92,6041
"34001011401",3528,210,60,6,302,10,434,18,4568
"34001011403",2644,280,825,18,1641,91,1414,81,6994
"34001011404",6173,601,857,279,944,747,1315,487,11403
"34001011500",3742,374,1212,316,572,29,600,154,6999
"34001011600",4291,371,58,26,176,3,145,53,5123
"34001011701",4180,260,911,354,3180,467,1300,267,10919
"34001011702",1278,282,709,55,894,285,545,191,4239
"34001011802",10738,622,1281,236,2946,204,2280,305,18612
"34001011803",2429,358,431,37,1157,320,1301,266,6299
"34001011804",5431,445,208,0,695,20,318,0,7117
"34001011805",1845,117,62,23,92,147,79,65,2430
"34001011900",1908,1122,2442,665,1242,594,2205,1006,11184
"34001012000",1889,521,1237,91,457,281,1157,585,6218
"34001012100",1120,296,773,281,303,218,847,470,4308
"34001012200",1852,191,2282,495,349,76,1554,401,7200
"34001012302",3002,191,25,0,343,8,352,31,3952
"34001012401",2028,401,12,0,205,86,103,135,2970
"34001012402",1846,194,6,7,102,16,149,26,2346
"34001012501",2393,33,17,0,210,0,257,0,2910
"34001012502",1419,22,0,0,61,0,35,0,1537
"34001012602",1345,40,0,4,37,5,0,0,1431
"34001012701",2289,246,399,44,294,26,277,9,3584
"34001012702",1056,103,102,354,106,19,105,1,1846
"34001012801",2540,284,345,360,341,43,483,102,4498
"34001012802",1623,119,7,5,20,45,140,38,1997
"34001013000",2974,342,24,0,90,15,52,29,3526
"34001013101",1313,9,4,1,7,0,29,1,1364
"34001013102",1238,224,47,0,24,0,46,12,1591
"34001013201",1032,929,65,0,1026,54,395,215,3716
"34001013202",1565,368,32,0,276,95,457,36,2829
"34001013301",2206,180,46,1,244,16,406,16,3115
"34001013302",2049,105,23,0,307,13,570,0,3067
"34001013500",2435,59,56,2,37,0,92,0,2681
"34001983400",20,4,7,0,3,0,0,0,34
"34001990000",0,0,0,0,0,0,0,0,0
"34003001000",5214,250,103,0,916,58,292,0,6833
"34003002100",995,86,56,62,510,1,61,26,1797
"34003002200",3460,154,54,0,1152,114,196,33,5163
"34003002300",3392,89,88,0,1903,58,347,0,5877
"34003003100",2338,127,376,114,1776,61,1456,62,6310
"34003003200",1521,129,139,9,2479,510,1343,326,6456
"34003003300",2582,185,337,14,3150,132,1775,124,8299
"34003003401",1904,94,57,2,808,68,554,42,3529
"34003003402",2204,39,55,1,1555,4,782,2,4642
"34003003500",1408,357,473,118,1576,451,1331,436,6150
"34003004001",2080,130,168,3,888,119,1335,68,4791
"34003004002",2782,505,166,25,1390,8,1530,311,6717
"34003005000",4724,189,0,27,1046,203,1382,44,7615
"34003006100",4681,544,80,21,1341,224,1741,287,8919
"34003006201",3021,722,65,0,757,358,1072,438,6433
"34003006202",2744,297,289,0,1437,83,395,116,5361
"34003006300",5243,891,186,0,1325,223,2506,782,11156
"34003007001",2555,45,243,0,1089,0,483,0,4415
"34003007002",2444,137,125,0,1776,62,53,19,4616
"34003008000",6134,128,23,11,2065,255,861,0,9477
"34003009100",3366,35,11,0,1475,42,169,0,5098
"34003009200",2774,29,55,2,497,57,56,1,3471
"34003010100",4233,55,95,16,1517,49,558,0,6523
"34003010200",2938,99,57,196,1155,53,791,1,5290
"34003010300",5484,102,251,1,1340,65,1280,0,8523
"34003011100",2940,104,239,7,777,138,1261,96,5562
"34003011200",3330,504,199,54,726,95,931,445,6284
"34003011300",3535,215,103,1,763,8,964,102,5691
"34003011400",4305,487,307,3,850,173,1126,198,7449
"34003012001",3399,578,311,0,1439,141,1600,214,7682
"34003012002",2423,86,37,3,869,12,410,1,3841
"34003013001",2339,158,448,12,3176,175,705,47,7060
"34003013002",3527,189,100,375,1114,280,590,240,6415
"34003014000",5664,540,127,4,903,75,845,190,8348
"34003015100",2083,21,185,0,303,0,178,0,2770
"34003015200",2115,184,2039,77,865,541,1217,604,7642
"34003015300",744,16,3795,612,846,119,1179,64,7375
"34003015400",2277,123,913,619,2400,394,1628,427,8781
"34003015500",3656,116,1011,0,1196,0,463,1,6443
"34003016000",2757,222,90,0,2253,24,287,10,5643
"34003017100",5473,295,44,1,1307,0,614,0,7734
"34003017200",4735,264,163,0,939,60,778,33,6972
"34003017300",4762,99,209,22,1121,97,829,117,7256
"34003017400",4178,93,36,6,966,62,376,36,5753
"34003017500",5814,357,123,44,1428,77,1594,54,9491
"34003018100",3609,816,49,0,1276,714,2547,928,9939
"34003018200",4303,528,223,62,2255,275,2979,459,11084
"34003019102",1650,229,54,0,1014,220,124,0,3291
"34003019103",1569,103,98,57,2016,89,387,0,4319
"34003019104",1436,244,118,0,2041,282,494,89,4704
"34003019202",618,71,44,0,692,116,395,22,1958
"34003019203",1870,180,0,0,634,295,161,18,3158
"34003019204",1754,183,45,46,1232,342,481,31,4114
"34003019303",1881,13,32,0,2654,691,696,0,5967
"34003019304",1446,126,0,0,1113,94,654,43,3476
"34003019305",4056,397,30,0,1941,48,645,173,7290
"34003019306",1179,55,179,0,690,81,246,0,2430
"34003020100",3243,80,26,0,592,0,310,0,4251
"34003020200",5656,245,33,0,824,0,486,0,7244
"34003021100",5404,698,137,0,406,86,1254,86,8071
"34003021200",4630,556,170,74,284,107,1249,386,7456
"34003021300",3110,434,117,6,408,105,793,176,5149
"34003021400",3774,396,167,19,379,20,1379,166,6300
"34003021500",3465,586,458,187,274,33,2071,357,7431
"34003021600",2812,731,234,82,371,234,1947,651,7062
"34003022100",3261,42,176,0,558,67,32,0,4136
"34003022200",6619,124,16,3,849,47,501,16,8175
"34003023100",813,499,651,138,649,108,860,472,4190
"34003023200",3828,324,1402,157,1225,227,1432,188,8783
"34003023301",1331,32,721,17,881,69,910,69,4030
"34003023302",2372,234,838,120,1347,180,851,144,6086
"34003023401",1176,184,763,40,1575,235,462,242,4677
"34003023402",1561,433,1160,83,1679,928,639,931,7414
"34003023501",653,261,1110,466,555,96,912,265,4318
"34003023502",1290,291,773,35,1307,528,1331,572,6127
"34003023601",1543,275,394,208,651,52,1015,289,4427
"34003023602",1024,95,329,197,1932,561,2229,587,6954
"34003024100",4225,182,189,0,1168,54,178,0,5996
"34003024200",3719,77,0,48,845,47,180,12,4928
"34003025100",4635,551,185,0,587,146,641,209,6954
"34003025200",5157,195,19,2,512,0,615,0,6500
"34003026100",3952,192,0,1,328,242,241,261,5217
"34003026200",4666,249,108,41,520,81,349,180,6194
"34003027000",3773,24,8,0,320,0,400,0,4525
"34003028001",1961,368,123,2,2619,244,668,297,6282
"34003028002",2023,244,42,0,1293,132,314,126,4174
"34003029100",2134,97,253,85,2180,124,715,15,5603
"34003029200",3624,441,100,2,1593,109,1334,328,7531
"34003030100",3178,586,327,361,458,121,1108,719,6858
"34003030200",5202,749,422,134,1045,20,2787,364,10723
"34003030300",2464,388,294,66,652,36,1544,163,5607
"34003030400",4874,681,402,101,1706,67,2006,659,10496
"34003031100",3577,507,28,15,1117,16,1458,320,7038
"34003031200",4178,253,52,0,320,48,818,52,5721
"34003031300",4300,364,51,36,429,17,750,1,5948
"34003031400",4827,436,34,0,362,240,852,277,7028
"34003032102",4771,196,289,0,649,0,147,0,6052
"34003032103",3971,138,73,0,595,0,224,0,5001
"34003032104",1603,43,109,0,388,58,292,40,2533
"34003032201",4253,37,199,0,834,238,243,16,5820
"34003032202",3963,52,31,1,609,54,215,28,4953
"34003033100",2773,72,84,0,576,62,578,0,4145
"34003033200",2039,207,87,0,284,11,449,81,3158
"34003033300",2241,266,249,18,578,104,568,52,4076
"34003034000",6399,373,36,3,366,52,610,295,8134
"34003035100",6322,201,1,1,1076,399,623,293,8916
"34003035200",5051,100,13,1,533,0,238,0,5936
"34003036100",1626,190,171,6,608,21,770,117,3509
"34003036200",2208,95,0,20,336,66,652,72,3449
"34003037100",3634,421,72,2,1340,178,665,198,6510
"34003037201",2917,166,54,0,940,77,514,46,4714
"34003037202",3840,111,651,18,1852,10,962,30,7474
"34003038100",4447,411,170,0,283,185,990,313,6799
"34003038200",2838,362,53,1,952,27,826,111,5170
"34003038300",4694,264,66,0,698,136,1328,51,7237
"34003039100",3774,74,0,0,382,0,379,7,4616
"34003039200",5302,176,46,0,206,51,414,1,6196
"34003039300",2438,66,29,0,176,5,100,7,2821
"34003040001",2898,1,0,3,424,0,205,1,3532
"34003040002",3795,26,35,0,699,24,100,0,4679
"34003041100",1690,265,161,11,3037,559,1339,411,7473
"34003041200",1402,39,4,0,2832,359,517,58,5211
"34003041301",1588,247,203,122,2953,223,1086,233,6655
"34003041302",1232,230,0,57,2676,176,482,76,4929
"34003042100",5072,33,104,5,1473,93,509,4,7293
"34003042301",2949,124,54,0,1589,29,316,64,5125
"34003042302",3116,120,29,0,1396,0,327,0,4988
"34003042400",3210,71,0,0,1144,33,258,14,4730
"34003042500",2393,188,167,0,1868,100,517,135,5368
"34003043001",3453,28,39,2,403,0,335,0,4260
"34003043002",3665,123,147,24,602,83,560,83,5287
"34003044100",5459,164,0,0,413,0,148,0,6184
"34003044201",3335,66,16,0,301,0,350,0,4068
"34003044202",3923,148,0,0,825,0,393,7,5296
"34003045100",4548,426,68,1,3448,168,1943,221,10823
"34003045200",1433,95,32,0,965,7,442,37,3011
"34003046100",2185,263,152,2,1386,81,1276,185,5530
"34003046200",2631,44,53,25,1515,74,1668,57,6067
"34003046300",2906,292,199,6,956,105,1657,153,6274
"34003047100",4290,59,163,0,1279,68,574,29,6462
"34003047200",3388,37,97,15,471,40,147,0,4195
"34003047300",2458,89,43,0,415,36,73,0,3114
"34003047400",3297,213,133,101,1298,243,600,108,5993
"34003047500",5585,114,14,0,1003,104,230,0,7050
"34003048100",2254,93,128,0,1475,40,307,20,4317
"34003048200",6008,6,0,0,1479,0,776,0,8269
"34003049001",3650,89,0,1,772,28,471,0,5011
"34003049002",4025,137,110,0,960,69,142,0,5443
"34003050000",4261,189,41,0,896,0,1105,19,6511
"34003051100",4668,136,160,0,873,240,721,24,6822
"34003051200",2082,32,100,0,367,15,515,18,3129
"34003051300",3115,173,171,47,865,169,712,25,5277
"34003051400",3854,194,235,0,546,73,709,0,5611
"34003052100",6623,575,47,2,397,165,819,162,8790
"34003052200",4860,331,45,3,764,0,791,2,6796
"34003053100",2776,38,84,0,262,0,495,0,3655
"34003053200",6573,186,156,0,1389,0,308,0,8612
"34003054100",1909,88,4771,934,1032,72,1112,117,10035
"34003054200",1488,295,1347,203,675,18,777,38,4841
"34003054300",5602,66,350,0,329,0,177,1,6525
"34003054400",3323,154,1346,62,2046,206,1831,126,9094
"34003054500",2941,121,506,0,997,0,1035,23,5623
"34003054600",3532,82,1738,0,2808,222,2038,93,10513
"34003055100",4874,215,0,2,1385,102,318,21,6917
"34003055200",4589,265,55,50,2820,234,656,63,8732
"34003056100",4195,59,62,0,348,0,353,0,5017
"34003056200",4191,335,156,0,461,0,301,132,5576
"34003057101",2889,455,253,56,538,19,346,187,4743
"34003057102",3335,228,22,3,258,110,427,26,4409
"34003057200",2642,417,30,0,202,10,425,90,3816
"34003058100",3500,114,30,1,115,0,229,0,3989
"34003058200",4934,89,5,0,423,0,445,0,5896
"34003059100",3910,97,321,49,874,42,817,90,6200
"34003059200",4379,425,396,15,420,68,429,99,6231
"34003060000",6530,431,83,0,1169,106,720,77,9116
"34003061100",4004,53,11,0,453,1,318,0,4840
"34003061200",3299,31,0,0,198,29,62,29,3648
"34003061300",2925,190,3,10,253,0,127,2,3510
"34003061400",4844,55,0,0,257,0,225,0,5381
"34005700102",2323,50,82,0,238,0,146,0,2839
"34005700103",2253,163,200,0,143,20,105,0,2884
"34005700104",914,118,414,118,280,48,241,58,2191
"34005700200",2474,82,43,7,39,27,93,44,2809
"34005700303",2613,21,236,243,166,0,293,5,3577
"34005700304",2078,145,26,0,48,51,158,9,2515
"34005700305",4652,166,134,0,208,0,300,0,5460
"34005700306",2335,103,39,5,107,9,117,0,2715
"34005700307",2477,28,57,0,176,39,13,0,2790
"34005700401",1884,63,0,0,160,0,89,0,2196
"34005700402",2995,104,0,0,222,0,31,7,3359
"34005700403",3650,401,0,0,110,30,165,73,4429
"34005700405",1355,228,36,0,96,0,37,0,1752
"34005700407",2554,235,1106,200,1143,188,722,238,6386
"34005700408",920,130,389,0,545,19,213,11,2227
"34005700501",4825,140,300,111,273,23,103,6,5781
"34005700502",2099,124,13,0,70,18,94,0,2418
"34005700503",2841,96,556,101,283,10,129,13,4029
"34005700504",2463,28,49,0,135,0,68,0,2743
"34005700505",4408,161,52,0,1173,12,11,12,5829
"34005700602",4505,238,469,42,1149,40,16,12,6471
"34005700603",3661,436,530,8,936,0,364,88,6023
"34005700605",4282,32,359,0,168,1,36,1,4879
"34005700701",2893,143,134,10,299,0,130,0,3609
"34005700702",1570,182,362,15,80,165,134,106,2614
"34005700703",1541,251,130,53,112,45,169,24,2325
"34005700800",3507,185,596,33,216,0,188,10,4735
"34005700900",1355,123,627,114,331,23,86,15,2674
"34005701001",2809,304,1073,179,475,100,549,140,5629
"34005701002",2118,98,1038,73,520,67,296,26,4236
"34005701102",3476,212,1110,83,421,12,477,50,5841
"34005701103",3524,64,1585,26,898,42,375,27,6541
"34005701104",2534,188,980,239,443,9,386,0,4779
"34005701105",2656,56,2240,111,727,310,557,132,6789
"34005701201",1729,66,773,40,481,0,231,37,3357
"34005701203",1143,88,601,14,67,17,114,0,2044
"34005701204",480,91,983,406,479,88,77,65,2669
"34005701205",1491,51,451,41,115,116,152,74,2491
"34005701301",3211,41,710,114,188,22,104,37,4427
"34005701302",2442,91,34,0,189,0,10,0,2766
"34005701303",3568,81,683,47,826,17,503,0,5725
"34005701401",4715,184,861,0,769,0,275,0,6804
"34005701402",1555,9,20,0,441,0,35,0,2060
"34005701502",3298,36,331,0,211,9,304,16,4205
"34005701700",2955,172,395,12,357,1,202,9,4103
"34005702101",2235,89,637,0,672,12,369,5,4019
"34005702203",1505,237,952,72,334,21,362,39,3522
"34005702204",997,122,426,34,276,157,248,126,2386
"34005702206",1553,56,107,6,261,67,153,25,2228
"34005702207",2016,391,464,29,252,132,279,45,3608
"34005702208",5135,259,1072,115,343,52,861,13,7850
"34005702209",2027,334,355,89,373,19,424,7,3628
"34005702210",2461,517,965,113,479,172,384,192,5283
"34005702300",986,79,132,29,180,61,271,110,1848
"34005702400",3114,61,64,2,164,7,300,0,3712
"34005702500",4352,61,695,16,922,18,272,0,6336
"34005702601",2654,250,889,0,298,12,140,0,4243
"34005702603",1240,248,562,32,98,26,151,127,2484
"34005702700",5399,43,1889,81,1249,120,993,14,9788
"34005702801",243,0,1473,136,170,0,51,45,2118
"34005702802",457,61,2575,181,183,72,90,65,3684
"34005702803",529,67,2774,83,317,0,223,9,4002
"34005702804",435,21,1760,90,316,0,341,0,2963
"34005702805",637,21,2416,260,525,38,249,0,4146
"34005702806",552,0,2294,208,549,123,346,77,4149
"34005702807",367,97,1953,375,574,34,478,12,3890
"34005702808",539,184,1855,208,391,16,447,176,3816
"34005702809",234,106,1106,102,36,1,99,81,1765
"34005702810",241,7,895,39,121,0,88,3,1394
"34005702811",363,10,1768,107,218,13,148,13,2640
"34005702905",3193,181,138,8,463,0,84,0,4067
"34005702906",1797,4,69,3,156,0,115,0,2144
"34005702907",2666,55,0,0,203,23,75,0,3022
"34005702908",3737,107,142,6,312,0,144,39,4487
"34005702909",4609,44,362,0,935,51,439,0,6440
"34005702910",4208,21,152,4,616,222,346,0,5569
"34005702913",2492,352,886,136,470,48,149,2,4535
"34005702914",3347,273,261,12,498,0,216,0,4607
"34005702915",2737,306,837,51,573,15,227,15,4761
"34005702917",1354,23,184,11,218,0,18,0,1808
"34005702918",1302,14,166,14,408,12,96,0,2012
"34005703000",4587,149,655,31,621,36,261,0,6340
"34005703102",2115,18,302,0,302,9,274,0,3020
"34005703103",2626,210,1078,102,500,200,445,243,5404
"34005703104",3385,144,692,11,517,0,521,58,5328
"34005703201",3336,169,156,16,61,0,139,0,3877
"34005703202",2433,168,31,0,78,0,81,0,2791
"34005703203",3513,248,126,0,69,0,36,0,3992
"34005703600",6364,207,52,21,310,0,575,0,7529
"34005703700",6038,158,19,0,214,0,183,0,6612
"34005703801",6008,292,215,2,396,16,204,0,7133
"34005703802",3499,238,250,11,177,22,377,83,4657
"34005703803",4361,101,25,3,70,0,128,0,4688
"34005703804",6661,9,202,5,489,0,302,4,7672
"34005703900",3983,72,24,0,59,0,23,0,4161
"34005704004",3062,162,52,0,335,43,161,0,3815
"34005704005",3537,101,126,10,252,0,76,0,4102
"34005704006",1476,83,221,34,438,39,14,0,2305
"34005704007",3397,182,23,10,87,12,157,48,3916
"34005704008",4605,215,194,4,243,41,108,0,5410
"34005704009",3584,148,298,0,330,0,177,0,4537
"34005704011",2876,93,16,0,34,0,22,0,3041
"34005704012",4905,182,572,0,358,0,388,14,6419
"34005704013",4627,96,113,9,394,0,165,1,5405
"34005704014",5797,202,416,151,1176,70,188,187,8187
"34005704200",5333,317,724,5,1482,0,436,0,8297
"34005704302",4444,36,198,49,914,0,391,0,6032
"34005704500",3467,272,633,48,287,58,329,106,5200
"34005704600",1407,281,500,38,203,49,261,137,2876
"34005704700",3083,357,9,7,143,0,199,53,3851
"34005704801",1975,141,406,0,332,0,396,54,3304
"34005704802",585,8,59,0,99,0,69,6,826
"34005981802",75,0,0,0,0,0,0,0,75
"34005982111",387,19,35,13,210,24,21,22,731
"34007600200",71,46,669,297,324,464,340,497,2708
"34007600400",62,85,982,878,653,297,725,549,4231
"34007600700",125,28,291,213,308,441,481,460,2347
"34007600800",288,497,767,551,1220,1543,1638,1973,8477
"34007600900",696,233,519,830,1345,1122,1650,1543,7938
"34007601000",836,61,935,563,2466,757,3065,918,9601
"34007601101",450,178,286,200,1411,636,1489,630,5280
"34007601102",533,334,1006,404,2796,862,2355,959,9249
"34007601200",880,252,1944,246,2243,841,2963,1015,10384
"34007601300",375,254,1174,751,785,1634,1204,1631,7808
"34007601400",62,5,2765,967,350,462,453,443,5507
"34007601500",39,97,2505,1417,862,690,1205,820,7635
"34007601600",91,41,1201,567,255,47,301,85,2588
"34007601700",52,52,991,1301,268,462,408,548,4082
"34007601800",88,42,659,405,135,186,71,308,1894
"34007601900",104,83,1272,1104,279,171,342,652,4007
"34007602000",547,510,2848,1415,846,722,1387,1268,9543
"34007602503",388,73,949,91,583,76,752,116,3028
"34007602601",1304,89,513,55,779,22,573,38,3373
"34007602602",1005,104,1003,0,1105,12,1100,104,4433
"34007602901",3018,214,665,51,708,0,743,0,5399
"34007602902",2013,105,377,126,596,240,815,214,4486
"34007603001",2555,101,583,0,592,144,609,144,4728
"34007603002",1751,54,1138,72,1399,183,1642,99,6338
"34007603100",2330,288,464,71,650,0,669,155,4627
"34007603200",4698,131,673,31,895,69,409,69,6975
"34007603301",2995,293,381,2,1285,476,213,289,5934
"34007603302",4086,291,526,16,1440,40,638,34,7071
"34007603303",1616,472,96,53,325,65,63,130,2820
"34007603400",5014,179,463,0,1312,68,477,0,7513
"34007603501",3786,107,487,8,1557,96,118,1,6160
"34007603503",3898,34,78,0,550,23,65,0,4648
"34007603504",1979,74,86,1,666,27,124,0,2957
"34007603505",2368,47,161,17,738,55,142,0,3528
"34007603506",4616,46,330,0,1591,8,253,0,6844
"34007603507",5199,87,346,20,1147,112,170,26,7107
"34007603601",2951,99,70,32,219,16,117,7,3511
"34007603602",2114,89,82,1,241,0,159,0,2686
"34007603603",2063,65,14,0,62,0,7,0,2211
"34007603700",2690,100,255,18,646,38,403,0,4150
"34007603800",4660,223,201,1,108,72,40,40,5345
"34007603901",4512,254,24,0,143,16,58,16,5023
"34007603902",2545,82,232,0,121,56,47,56,3139
"34007604100",638,293,503,337,986,211,1035,422,4425
"34007604200",2640,174,351,1,276,63,418,82,4005
"34007604300",3242,182,101,1,204,0,121,0,3851
"34007604400",2786,32,87,12,128,55,172,0,3272
"34007604600",1474,134,149,20,115,15,163,13,2083
"34007604700",1885,112,36,0,58,21,29,0,2141
"34007605100",1997,196,28,38,54,27,7,32,2379
"34007605200",2427,215,46,0,316,0,238,14,3256
"34007605300",1430,116,131,12,92,98,93,59,2031
"34007605400",2279,124,0,70,0,3,58,14,2548
"34007605602",2494,129,44,0,135,0,94,54,2950
"34007605700",3109,239,0,18,49,20,0,47,3482
"34007605800",2343,90,224,1,53,42,16,42,2811
"34007605900",2470,59,11,4,35,0,39,4,2622
"34007606000",1899,40,14,1,112,6,75,6,2153
"34007606100",1887,109,0,0,119,5,44,0,2164
"34007606200",3706,127,0,0,160,0,110,0,4103
"34007606300",1948,246,55,0,70,0,76,0,2395
"34007606400",2859,11,26,1,170,15,150,0,3232
"34007606500",73,0,2119,437,238,52,128,43,3090
"34007606600",1832,127,96,0,42,11,67,8,2183
"34007606700",4235,242,72,16,67,36,209,13,4890
"34007606800",3205,233,22,48,339,329,142,21,4339
"34007607000",3536,490,28,1,268,78,494,216,5111
"34007607100",3309,72,64,13,256,0,372,13,4099
"34007607200",3149,462,364,141,349,237,216,188,5106
"34007607300",2891,359,486,80,369,123,160,136,4604
"34007607401",1807,295,550,34,199,41,121,31,3078
"34007607402",1430,56,467,31,275,44,132,34,2469
"34007607502",3824,95,489,44,631,11,219,0,5313
"34007607503",3899,212,466,0,1781,26,131,0,6515
"34007607504",2817,56,166,0,505,0,101,34,3679
"34007607505",3421,75,402,0,957,0,199,10,5064
"34007607506",1457,289,355,0,760,83,94,13,3051
"34007607507",2838,378,666,31,1228,315,234,0,5690
"34007607600",2088,61,45,9,66,28,25,34,2356
"34007607701",1321,190,1632,606,1145,614,1420,558,7486
"34007607702",1846,242,774,226,805,193,645,197,4928
"34007607801",2112,395,1644,154,622,724,746,581,6978
"34007607802",1593,36,362,15,233,14,159,14,2426
"34007607900",1622,94,47,10,109,17,124,0,2023
"34007608001",2282,196,620,55,239,143,95,106,3736
"34007608202",2881,112,783,11,349,5,85,0,4226
"34007608205",3746,246,113,15,203,27,118,27,4495
"34007608206",3336,57,240,71,127,0,113,13,3957
"34007608209",1880,340,820,16,311,7,115,190,3679
"34007608210",1940,451,1176,92,279,82,398,54,4472
"34007608211",2575,229,1654,3,1106,280,591,0,6438
"34007608302",3335,293,437,48,236,73,210,9,4641
"34007608303",2339,184,147,51,189,89,181,128,3308
"34007608304",4675,404,411,117,524,20,515,32,6698
"34007608401",3003,85,469,38,82,82,69,0,3828
"34007608402",2585,63,825,6,467,27,307,0,4280
"34007608403",4538,145,1246,36,750,243,388,12,7358
"34007608404",3936,451,1244,99,163,16,50,0,5959
"34007608503",1275,158,1180,105,332,122,193,0,3365
"34007608504",1389,273,897,188,296,122,208,186,3559
"34007608600",3199,645,812,33,228,40,421,139,5517
"34007608700",6272,352,95,290,468,0,304,43,7824
"34007608800",3895,202,544,112,480,119,188,145,5685
"34007608901",4662,476,213,19,443,40,289,133,6275
"34007608903",3020,124,42,12,146,1,60,41,3446
"34007608904",1347,46,32,1,19,0,59,0,1504
"34007609000",528,158,606,47,296,16,293,29,1973
"34007609103",3425,141,682,215,707,22,190,33,5415
"34007609201",2073,312,1396,216,415,19,543,46,5020
"34007609202",1014,93,2334,849,336,31,487,37,5181
"34007609203",4423,20,3483,202,1162,147,443,106,9986
"34007609204",631,34,2143,474,224,191,246,216,4159
"34007609205",4364,339,1018,46,802,21,703,43,7336
"34007610300",455,347,583,408,127,117,262,132,2431
"34007610400",237,449,664,1288,505,457,832,1002,5434
"34007610500",1621,222,2372,164,1811,594,1748,638,9170
"34007610600",558,46,192,33,170,75,106,68,1248
"34007610800",1067,130,851,161,462,104,651,95,3521
"34007610900",3257,217,10,3,64,3,47,12,3613
"34007611000",4193,506,188,90,877,118,753,181,6906
"34007611100",2217,274,110,19,191,123,76,97,3107
"34007611200",3549,213,138,23,267,8,117,1,4316
"34007611300",3398,469,155,40,127,0,105,0,4294
"34007611400",3108,294,312,84,203,30,172,32,4235
"34007611500",3799,270,128,79,150,25,458,27,4936
"34007611600",2372,527,684,79,257,23,336,119,4397
"34007611700",2487,339,135,10,56,53,93,20,3193
"34009020101",2498,243,80,51,221,187,349,0,3629
"34009020102",1923,132,49,0,288,92,289,77,2850
"34009020201",1496,11,0,0,0,0,0,0,1507
"34009020203",2088,59,0,0,0,0,0,0,2147
"34009020205",946,32,0,6,0,0,22,0,1006
"34009020206",879,64,0,0,0,0,32,0,975
"34009020301",4005,81,57,0,114,14,123,0,4394
"34009020302",4207,245,0,0,134,2,85,2,4675
"34009020400",3008,211,83,0,45,25,130,0,3502
"34009020500",986,485,565,222,144,142,432,236,3212
"34009020600",1808,77,13,19,122,0,55,19,2113
"34009020700",3769,427,1,0,39,14,44,0,4294
"34009020800",1689,108,0,1,7,19,16,0,1840
"34009020901",703,59,6,3,4,0,0,0,775
"34009020902",1731,83,0,1,37,0,38,0,1890
"34009021001",1734,57,49,2,71,0,84,2,1999
"34009021002",3208,148,113,3,136,19,104,22,3753
"34009021100",4189,516,529,0,109,0,297,0,5640
"34009021300",3431,503,12,2,15,0,15,0,3978
"34009021400",2527,1242,0,204,10,40,415,692,5130
"34009021500",1005,261,359,8,90,31,303,16,2073
"34009021600",2994,158,0,2,60,11,103,25,3353
"34009021701",2108,233,14,2,142,0,173,0,2672
"34009021702",2118,127,20,2,114,0,63,0,2444
"34009021803",2820,623,7,14,0,19,105,37,3625
"34009021804",4629,764,148,20,141,14,343,43,6102
"34009021805",3788,242,94,0,117,206,307,206,4960
"34009021806",2398,291,86,0,0,88,0,91,2954
"34009021900",1752,167,80,19,70,12,47,62,2209
"34009022000",2426,225,18,40,144,157,136,28,3174
"34009022101",1091,449,0,26,0,18,102,0,1686
"34009022102",3352,283,889,120,733,0,444,0,5821
"34009990100",0,0,0,0,0,0,0,0,0
"34011010101",2964,286,9,0,282,0,122,70,3733
"34011010103",0,0,0,0,0,0,0,0,0
"34011010200",3390,567,316,283,134,443,179,426,5738
"34011010301",2379,242,278,129,125,124,299,148,3724
"34011010302",1164,139,23,26,59,0,62,3,1476
"34011010401",1727,419,2008,325,599,106,382,206,5772
"34011010402",0,0,0,0,0,0,0,0,0
"34011010500",1984,99,72,15,130,21,69,14,2404
"34011010600",3693,352,326,18,468,21,168,87,5133
"34011010700",5316,377,1062,69,704,85,417,140,8170
"34011010800",1962,232,407,12,463,0,560,34,3670
"34011020100",199,307,103,87,197,170,386,440,1889
"34011020200",573,262,371,228,623,532,958,799,4346
"34011020300",1839,952,636,644,1897,1047,3657,1838,12510
"34011020400",898,209,583,115,836,222,887,238,3988
"34011020502",0,0,0,0,0,0,0,0,0
"34011020503",435,175,1488,970,167,483,514,590,4822
"34011020600",1611,259,841,226,431,212,651,269,4500
"34011030100",358,195,239,58,11,65,33,119,1078
"34011030200",2127,743,1046,1004,560,211,871,484,7046
"34011030300",1695,224,847,360,365,74,418,24,4007
"34011030400",5584,292,854,105,367,29,715,103,8049
"34011030501",5654,204,498,1,130,0,636,0,7123
"34011030502",2075,491,407,439,540,286,522,611,5371
"34011040300",2500,212,401,95,465,45,1410,162,5290
"34011040400",3054,202,1145,93,1443,15,2304,174,8430
"34011040500",2923,417,1221,116,1424,556,2792,902,10351
"34011040600",3372,1103,509,287,1175,268,2342,544,9600
"34011040700",5330,1064,590,195,512,200,1151,209,9251
"34011040800",3731,230,542,40,609,36,629,86,5903
"34011040901",1476,94,498,61,388,234,641,266,3658
"34011040902",3636,443,875,0,1107,140,1480,268,7949
"34011041000",5178,874,833,135,461,137,1038,283,8939
"34011041100",1478,861,1005,239,2120,1529,3593,2120,12945
"34011990000",0,0,0,0,0,0,0,0,0
"34013000100",1876,709,1047,118,2076,434,3045,1024,10329
"34013000200",866,181,337,157,1220,437,1664,547,5409
"34013000300",1265,320,351,742,843,131,1752,462,5866
"34013000400",1052,165,67,30,895,127,1470,217,4023
"34013000500",386,196,66,41,926,325,1043,475,3458
"34013000600",1721,276,638,123,1387,534,2886,667,8232
"34013000700",927,180,1964,1182,958,482,1794,610,8097
"34013000800",962,271,694,389,1532,682,2292,1014,7836
"34013000900",560,258,678,672,588,602,941,949,5248
"34013001000",286,135,994,487,417,366,568,449,3702
"34013001100",120,132,912,224,155,170,211,228,2152
"34013001300",133,55,1029,459,14,132,142,157,2121
"34013001400",94,258,842,1155,194,102,312,356,3313
"34013001500",22,15,917,794,59,249,40,323,2419
"34013001600",162,139,873,213,302,77,489,206,2461
"34013001700",30,66,1189,577,258,90,263,163,2636
"34013001800",8,12,1276,494,112,6,141,22,2071
"34013001900",0,9,789,893,21,19,50,65,1846
"34013002000",119,54,3250,615,81,123,164,113,4519
"34013002100",79,10,2647,533,77,78,146,119,3689
"34013002201",371,170,3721,642,1577,1213,885,703,9282
"34013002202",74,86,2526,515,257,31,10,0,3499
"34013002300",172,23,3095,725,219,135,169,177,4715
"34013002400",65,8,1816,920,57,143,58,5,3072
"34013002500",0,0,1751,798,123,32,10,22,2736
"34013002600",71,82,810,754,129,140,170,228,2384
"34013002800",124,6,764,501,166,61,267,78,1967
"34013003100",40,0,1383,390,56,57,113,57,2096
"34013003500",20,23,1513,428,26,135,48,135,2328
"34013003700",43,17,1028,603,52,0,55,9,1807
"34013003800",241,107,1050,327,242,9,385,116,2477
"34013003900",0,0,448,543,18,15,7,67,1098
"34013004100",156,0,1642,490,96,0,248,0,2632
"34013004200",6,6,1783,1193,142,110,126,209,3575
"34013004300",0,0,1573,961,40,84,40,39,2737
"34013004400",12,10,934,552,46,126,46,122,1848
"34013004500",4,26,2789,253,48,23,32,14,3189
"34013004600",0,0,1981,898,39,25,12,0,2955
"34013004700",17,4,4273,646,150,12,83,16,5201
"34013004801",47,5,1367,1000,266,49,271,79,3084
"34013004802",261,65,873,1834,177,203,346,276,4035
"34013004900",89,9,2619,820,150,43,134,0,3864
"34013005000",87,62,1699,829,175,80,135,183,3250
"34013005100",8,66,1603,390,0,0,8,23,2098
"34013005200",0,0,749,306,24,16,24,16,1135
"34013005300",0,139,1284,605,24,47,0,158,2257
"34013005400",113,7,1758,1243,17,30,124,25,3317
"34013005700",585,265,765,384,396,345,643,550,3933
"34013006200",42,17,565,603,31,206,97,223,1784
"34013006400",82,0,704,133,65,79,34,0,1097
"34013006600",14,1,889,238,95,139,59,29,1464
"34013006700",301,245,791,1079,475,323,498,373,4085
"34013006800",1658,306,701,563,1809,570,2157,554,8318
"34013006900",1795,536,35,86,2015,524,2198,499,7688
"34013007000",1890,359,0,1,1183,247,1310,270,5260
"34013007100",2203,384,100,0,650,115,709,236,4397
"34013007200",2129,423,14,0,1031,236,1243,407,5483
"34013007300",2468,471,139,48,2376,398,2153,548,8601
"34013007400",1236,227,15,65,972,254,885,213,3867
"34013007501",1527,313,335,456,1037,401,1276,471,5816
"34013007502",857,369,204,437,968,363,1078,620,4896
"34013007600",1550,179,82,0,841,356,839,330,4177
"34013007700",1179,308,71,0,873,541,1010,687,4669
"34013007800",1635,59,103,68,1337,462,1783,498,5945
"34013007900",1892,262,38,172,1260,541,1656,597,6418
"34013008000",618,165,550,164,482,336,424,350,3089
"34013008100",273,162,1941,838,221,114,215,207,3971
"34013008200",0,31,814,598,162,131,92,72,1900
"34013008700",1280,704,458,192,1102,551,2257,1169,7713
"34013008800",505,246,402,69,542,58,1016,290,3128
"34013008900",456,189,343,128,445,372,904,630,3467
"34013009000",139,132,854,209,355,149,351,228,2417
"34013009100",1010,798,198,127,746,635,1735,1432,6681
"34013009200",354,124,788,674,331,235,565,421,3492
"34013009300",1340,465,657,215,1995,568,2918,921,9079
"34013009400",1767,818,991,389,856,607,2155,1154,8737
"34013009500",2014,367,545,358,2510,67,3837,424,10122
"34013009600",1014,567,671,868,1056,606,2038,1189,8009
"34013009700",2023,711,514,189,1278,522,3215,1086,9538
"34013009900",22,8,1212,373,0,195,0,239,2049
"34013010000",53,57,2005,242,129,0,37,0,2523
"34013010100",161,23,2173,319,139,46,143,69,3073
"34013010200",138,112,3958,431,128,6,204,13,4990
"34013010300",63,24,2706,830,183,139,181,199,4325
"34013010400",193,2,3735,604,112,104,256,105,5111
"34013010500",166,28,2837,890,195,66,263,68,4513
"34013010600",125,68,2109,1200,415,120,530,146,4713
"34013010700",3,28,2698,432,23,159,28,158,3529
"34013010800",29,7,1326,350,187,0,244,6,2149
"34013010900",20,4,1735,729,129,80,83,82,2862
"34013011100",225,139,2038,991,183,261,320,367,4524
"34013011200",36,15,2340,467,92,1,53,89,3093
"34013011300",172,0,2097,563,353,89,390,68,3732
"34013011400",320,35,3829,656,126,143,284,128,5521
"34013011500",196,1,1897,348,37,45,132,16,2672
"34013011600",0,0,1917,768,112,12,108,12,2929
"34013011700",21,11,3289,496,69,62,83,11,4042
"34013011800",0,0,1747,408,76,0,47,30,2308
"34013011900",143,35,961,342,83,98,151,142,1955
"34013012000",626,172,3939,353,280,235,538,381,6524
"34013012100",341,22,2238,619,458,226,443,239,4586
"34013012200",283,78,3989,953,277,168,371,215,6334
"34013012300",161,25,3851,501,278,121,359,121,5417
"34013012400",180,160,3208,1098,115,24,236,134,5155
"34013012500",138,17,2616,684,80,82,116,34,3767
"34013012600",58,13,2461,615,78,27,88,27,3367
"34013012700",188,24,3502,339,244,84,305,0,4686
"34013012800",150,18,2314,592,287,58,221,0,3640
"34013012900",0,138,1861,955,159,165,188,276,3742
"34013013000",97,5,1152,189,110,93,37,33,1716
"34013013100",65,13,986,575,83,38,125,87,1972
"34013013200",187,7,1511,648,87,116,164,90,2810
"34013013300",139,28,1796,1254,130,66,193,96,3702
"34013013400",3339,105,0,11,415,0,268,0,4138
"34013013500",3443,297,186,0,767,49,517,21,5280
"34013013600",4154,200,289,1,1345,0,889,10,6888
"34013013700",3478,520,140,77,383,16,531,0,5145
"34013013800",3623,246,0,0,427,0,415,59,4770
"34013013900",3602,77,138,3,1220,0,695,12,5747
"34013014000",2596,120,88,0,1140,14,845,0,4803
"34013014100",1941,122,294,0,1446,274,1433,319,5829
"34013014200",2452,146,142,0,1401,76,1586,185,5988
"34013014300",3485,174,243,27,1650,103,3145,99,8926
"34013014400",1901,305,627,83,856,21,1351,250,5394
"34013014500",2180,252,305,24,1009,412,1667,509,6358
"34013014600",2251,76,649,56,1231,27,1976,10,6276
"34013014700",2839,547,689,156,1476,154,2281,336,8478
"34013014800",2763,43,59,0,601,16,459,0,3941
"34013014900",3496,265,244,0,527,0,391,114,5037
"34013015000",2335,140,324,9,640,0,526,2,3976
"34013015100",2764,203,821,150,638,54,1143,110,5883
"34013015200",3143,180,499,2,421,11,1023,32,5311
"34013015300",1219,200,664,190,607,72,514,138,3604
"34013015400",3001,172,509,51,534,181,857,94,5399
"34013015500",1930,206,818,178,562,28,1080,46,4848
"34013015600",1768,261,901,11,1113,36,854,184,5128
"34013015700",623,175,667,133,462,46,782,101,2989
"34013015800",2186,72,697,135,871,82,1386,104,5533
"34013015900",1977,182,1318,138,1574,180,2214,212,7795
"34013016000",6455,133,439,35,539,4,791,0,8396
"34013016100",2767,50,62,0,161,18,194,6,3258
"34013016200",3085,26,99,3,341,10,152,0,3716
"34013016300",3124,158,149,12,220,77,132,62,3934
"34013016400",3006,142,396,7,188,0,210,15,3964
"34013016500",2813,140,426,82,421,14,374,33,4303
"34013016600",1454,140,1112,46,226,21,231,23,3253
"34013016700",1138,140,839,101,239,81,296,134,2968
"34013016800",1527,123,695,173,511,8,269,0,3306
"34013016900",1782,42,789,10,468,6,145,0,3242
"34013017000",1577,34,1185,33,158,39,308,1,3335
"34013017100",293,29,1372,392,205,83,294,71,2739
"34013017200",600,43,1241,193,409,0,224,0,2710
"34013017301",3497,150,673,55,862,37,369,53,5696
"34013017302",4229,130,956,45,1084,23,742,5,7214
"34013017400",3354,41,1160,56,910,2,542,4,6069
"34013017500",3698,108,1349,155,452,10,832,55,6659
"34013017600",2213,255,1781,81,586,231,1674,356,7177
"34013017700",1590,382,1650,331,642,73,1678,336,6682
"34013017800",1504,231,963,165,651,42,1381,128,5065
"34013017900",1891,76,1013,37,248,0,111,10,3386
"34013018000",4089,48,1452,1,516,12,518,0,6636
"34013018100",83,14,1266,425,143,147,137,144,2359
"34013018200",460,98,2463,926,864,267,1247,330,6655
"34013018300",237,32,2585,758,936,292,1023,345,6208
"34013018400",73,12,1205,332,231,45,310,39,2247
"34013018600",574,93,1086,510,531,571,1089,641,5095
"34013018700",78,164,3033,1135,141,90,109,129,4879
"34013018800",204,27,3078,851,523,0,231,0,4914
"34013018900",362,73,1823,751,275,135,544,159,4122
"34013019000",3336,112,591,10,396,9,138,0,4592
"34013019100",1785,179,1497,147,230,22,190,37,4087
"34013019200",1484,329,828,142,101,34,106,83,3107
"34013019300",1692,199,781,18,498,20,188,0,3396
"34013019400",2886,42,75,0,337,0,214,7,3561
"34013019500",3161,57,431,7,360,0,207,24,4247
"34013019600",2238,205,2795,222,376,0,144,0,5980
"34013019700",2123,140,2812,246,352,14,1130,151,6968
"34013019800",1614,41,589,26,269,6,168,6,2719
"34013019900",2413,127,80,16,151,0,155,106,3048
"34013020000",4618,124,24,0,1045,7,220,0,6038
"34013020100",3727,106,0,0,710,0,90,0,4633
"34013020200",3912,12,263,2,889,8,549,8,5643
"34013020300",3401,248,83,10,877,104,119,18,4860
"34013020400",3932,56,0,2,902,18,233,1,5144
"34013020500",5865,56,102,2,1825,24,249,2,8125
"34013020600",3277,43,15,0,1234,8,74,1,4652
"34013020700",3053,106,49,6,1037,63,197,75,4586
"34013020800",5533,339,158,1,1637,32,442,0,8142
"34013020901",1956,32,8,0,144,0,53,0,2193
"34013020902",5216,55,39,0,483,42,577,0,6412
"34013021000",4706,76,24,0,401,0,233,0,5440
"34013021100",3917,144,136,5,361,80,402,71,5116
"34013021200",3376,25,33,1,148,13,258,1,3855
"34013021300",4633,186,135,3,527,80,247,0,5811
"34013021400",5173,153,416,2,300,111,320,72,6547
"34013021601",7046,80,135,0,214,0,190,0,7665
"34013021602",5842,181,0,1,383,0,332,76,6815
"34013021701",2927,88,53,1,387,65,94,65,3680
"34013021702",3273,134,133,0,375,0,204,0,4119
"34013021801",2514,54,25,2,117,0,107,14,2833
"34013021802",2644,140,0,1,613,7,233,7,3645
"34013021803",4309,100,0,0,180,0,205,0,4794
"34013022700",96,56,1097,1285,328,320,364,447,3993
"34013022800",27,9,1219,845,165,58,188,60,2571
"34013022900",646,285,1109,984,292,187,467,144,4114
"34013023000",0,19,1306,842,317,164,146,143,2937
"34013023100",230,76,1238,721,94,82,322,141,2904
"34013023200",286,107,1537,1429,115,95,245,150,3964
"34013980100",0,0,0,0,0,0,0,0,0
"34013980200",0,14,0,50,34,161,34,161,454
"34015500100",3426,456,43,16,199,110,145,133,4528
"34015500201",2183,52,0,0,247,0,169,0,2651
"34015500202",3749,369,315,52,57,11,61,37,4651
"34015500203",4115,267,151,26,188,11,68,0,4826
"34015500204",4676,169,733,62,437,122,307,48,6554
"34015500205",2927,181,187,9,33,7,65,0,3409
"34015500300",2638,183,23,16,138,0,67,4,3069
"34015500400",2567,583,1211,1088,224,364,318,300,6655
"34015500500",4337,302,80,3,152,0,107,0,4981
"34015500600",7871,390,356,302,871,0,366,0,10156
"34015500701",6750,425,344,171,308,0,350,26,8374
"34015500702",5183,222,245,2,29,0,11,0,5692
"34015500703",1341,40,17,0,28,17,56,17,1516
"34015500800",1910,65,8,8,124,0,23,1,2139
"34015500900",2759,77,67,4,105,0,111,7,3130
"34015501001",1249,166,311,239,95,121,124,194,2499
"34015501002",1766,252,947,639,304,52,196,198,4354
"34015501003",2782,274,181,64,379,23,310,0,4013
"34015501101",2401,414,725,268,228,102,282,262,4682
"34015501102",4672,206,598,294,820,29,428,16,7063
"34015501103",3920,210,232,44,615,59,368,59,5507
"34015501104",2211,125,267,0,141,0,110,0,2854
"34015501105",2240,172,137,28,146,386,179,23,3311
"34015501106",1828,117,1322,272,409,44,21,32,4045
"34015501107",3970,206,37,0,157,0,101,0,4471
"34015501201",5601,88,195,1,246,18,56,0,6205
"34015501202",4376,154,65,1,296,0,61,0,4953
"34015501203",3121,68,8,0,86,0,0,0,3283
"34015501204",3370,56,216,90,153,10,161,0,4056
"34015501205",2431,113,274,0,185,0,81,10,3094
"34015501206",2678,182,197,22,334,33,221,28,3695
"34015501208",3304,255,26,0,363,107,85,75,4215
"34015501209",5352,300,829,142,705,13,894,91,8326
"34015501210",3483,18,71,9,79,0,48,0,3708
"34015501212",2628,108,443,2,331,26,205,85,3828
"34015501213",4039,66,47,109,369,0,294,0,4924
"34015501301",3274,161,17,24,98,25,0,25,3624
"34015501302",2684,159,8,0,84,0,34,0,2969
"34015501303",2102,49,26,11,167,0,12,0,2367
"34015501402",968,645,991,141,266,0,292,14,3317
"34015501403",2363,228,388,252,225,11,111,11,3589
"34015501404",607,311,40,24,3,64,11,24,1084
"34015501405",3362,114,316,12,150,25,16,8,4003
"34015501406",3065,440,393,369,249,312,238,210,5276
"34015501500",5470,587,1138,29,926,75,367,97,8689
"34015501603",5260,485,357,120,432,0,702,30,7386
"34015501604",5419,601,908,91,335,9,294,1,7658
"34015501605",3381,310,617,22,368,100,260,154,5212
"34015501606",4801,228,1327,31,383,67,114,56,7007
"34015501608",3513,465,492,40,393,51,234,10,5198
"34015501609",4024,96,1113,66,493,0,168,10,5970
"34015501701",4521,177,362,5,371,24,297,24,5781
"34015501702",2279,154,39,11,93,0,92,0,2668
"34015501703",3434,304,221,48,352,95,328,0,4782
"34015501704",3040,289,444,0,440,51,334,35,4633
"34015501800",1446,101,39,12,79,2,100,0,1779
"34015501900",3295,170,561,78,130,0,211,51,4496
"34015502001",4928,80,164,0,197,36,173,36,5614
"34015502002",6137,226,352,20,462,0,221,16,7434
"34015502100",2780,40,274,0,78,19,192,0,3383
"34015502200",8526,285,742,143,1247,18,442,21,11424
"34015502300",1787,82,426,11,251,70,300,65,2992
"34015502400",4581,278,667,13,389,36,433,5,6402
"34017000100",1862,82,377,130,4227,422,3002,416,10518
"34017000200",1516,623,208,59,2254,606,2186,937,8389
"34017000300",1682,332,211,0,1712,492,2300,651,7380
"34017000400",835,103,356,12,1957,480,600,329,4672
"34017000500",1221,264,469,61,1987,413,1317,258,5990
"34017000600",1990,296,378,116,1902,463,2128,494,7767
"34017000700",1498,196,127,2,948,830,996,723,5320
"34017000800",1631,217,210,0,1796,620,2064,575,7113
"34017000902",1772,781,261,85,2918,356,728,418,7319
"34017001000",739,149,103,0,752,277,477,54,2551
"34017001100",2724,297,385,29,1699,299,2473,331,8237
"34017001201",722,113,69,8,1109,123,372,49,2565
"34017001202",309,216,159,70,407,213,167,235,1776
"34017001300",924,54,321,7,931,460,1077,340,4114
"34017001400",1421,234,407,26,1570,96,1344,225,5323
"34017001701",1402,469,288,518,1535,662,771,335,5980
"34017001800",1138,569,212,448,1435,246,603,422,5073
"34017001900",269,20,35,34,749,308,81,3,1499
"34017002000",982,647,490,63,1392,378,518,228,4698
"34017002200",1059,180,68,0,160,27,335,91,1920
"34017002300",1158,41,142,29,420,298,297,301,2686
"34017002400",1931,83,174,10,498,10,382,0,3088
"34017002700",1453,637,762,754,1641,102,1092,316,6757
"34017002800",2730,651,1336,354,1170,176,1508,164,8089
"34017002900",1413,230,371,94,1254,305,543,57,4267
"34017003000",1249,319,309,163,761,200,1011,244,4256
"34017003100",1265,450,591,124,1094,370,763,389,5046
"34017003500",1142,191,169,47,331,16,353,145,2394
"34017004000",847,97,1268,149,2390,295,722,255,6023
"34017004101",1873,536,1895,388,1560,656,1471,870,9249
"34017004102",573,209,829,553,854,245,985,405,4653
"34017004200",663,532,1646,529,1257,58,1340,255,6280
"34017004300",260,261,1192,307,147,105,296,283,2851
"34017004400",106,12,1059,988,67,0,117,30,2379
"34017004500",373,50,2335,972,335,126,455,199,4845
"34017004600",628,79,798,62,497,267,910,358,3599
"34017004700",743,86,820,141,816,193,886,220,3905
"34017004800",901,214,828,122,2039,179,764,86,5133
"34017004900",459,143,1640,389,740,304,604,505,4784
"34017005200",383,186,2100,882,368,267,238,511,4935
"34017005300",329,220,1630,355,99,210,415,326,3584
"34017005400",1203,0,2562,272,2767,47,894,17,7762
"34017005500",234,70,1541,467,106,13,409,133,2973
"34017005600",530,168,1204,302,1188,169,545,196,4302
"34017005801",293,0,2759,1516,255,316,430,425,5994
"34017005802",1209,45,58,0,292,0,113,23,1740
"34017005900",1647,169,1766,326,3082,539,700,182,8411
"34017006000",580,159,2258,764,840,334,916,527,6378
"34017006100",1305,678,1459,608,2179,315,950,1096,8590
"34017006200",589,365,950,524,916,229,760,300,4633
"34017006300",1102,162,1027,323,1415,228,1368,271,5896
"34017006400",1895,63,214,0,810,50,521,54,3607
"34017006500",1162,203,260,90,437,46,540,214,2952
"34017006600",251,36,30,0,1172,194,50,0,1733
"34017006700",440,339,917,720,511,100,783,431,4241
"34017006800",50,117,2081,1229,56,26,142,91,3792
"34017006900",32,0,21,0,0,5,29,0,87
"34017007000",1988,156,312,12,1291,129,1145,169,5202
"34017007100",1366,233,236,128,1446,170,683,124,4386
"34017007200",1024,14,184,0,723,49,191,0,2185
"34017007300",870,11,50,0,590,22,168,0,1711
"34017007400",2651,15,99,0,2027,25,318,13,5148
"34017007500",2124,371,223,32,2222,113,351,230,5666
"34017007600",2470,55,148,53,3397,120,375,34,6652
"34017007700",2149,25,309,161,5939,1125,572,76,10356
"34017007800",486,205,70,78,330,122,299,191,1781
"34017010100",3422,361,963,239,757,109,1027,191,7069
"34017010200",1994,349,175,14,552,86,299,139,3608
"34017010300",1698,207,300,92,385,62,676,97,3517
"34017010400",3168,284,581,8,826,82,757,38,5744
"34017010500",3776,261,235,15,279,83,615,71,5335
"34017010600",3752,760,558,82,1003,366,977,127,7625
"34017010700",2118,756,203,59,452,61,709,253,4611
"34017010800",2397,220,127,83,327,21,831,97,4103
"34017010900",1098,392,64,61,197,76,278,72,2238
"34017011000",1100,226,166,12,706,163,496,191,3060
"34017011100",2563,913,402,6,556,152,819,352,5763
"34017011200",5042,446,427,25,660,223,1163,209,8195
"34017011300",1848,275,336,63,244,127,715,120,3728
"34017011400",2678,112,76,50,479,16,698,23,4132
"34017011500",2242,231,294,113,493,19,553,206,4151
"34017011600",2627,383,495,277,669,169,553,205,5378
"34017012300",1547,144,17,14,727,69,972,103,3593
"34017012400",2644,226,24,0,324,10,564,142,3934
"34017012500",2572,108,211,0,1310,69,1322,126,5718
"34017012600",2343,303,10,2,592,93,1059,142,4544
"34017012700",2877,310,162,45,1832,198,1980,315,7719
"34017012800",2121,197,111,0,1394,59,1679,72,5633
"34017012900",2317,334,12,0,1041,292,1510,545,6051
"34017013000",1576,121,59,1,1617,244,1893,166,5677
"34017013100",1356,150,40,12,412,170,809,259,3208
"34017013200",2041,424,117,0,1676,385,2237,447,7327
"34017013300",1545,142,15,0,1549,247,1849,267,5614
"34017013400",1023,77,83,1,961,360,1265,328,4098
"34017013500",1747,660,45,0,1843,605,1821,718,7439
"34017013600",861,132,36,10,973,178,906,186,3282
"34017013700",1213,106,28,6,1103,208,1512,172,4348
"34017013800",772,48,5,0,981,193,481,133,2613
"34017013900",1346,70,33,0,1002,221,764,41,3477
"34017014000",3245,339,240,1,1039,210,3345,416,8835
"34017014101",1593,82,107,58,816,36,543,40,3275
"34017014102",3456,256,266,0,1278,107,3333,160,8856
"34017014200",3580,1035,57,33,1107,351,3812,1285,11260
"34017014300",3488,774,54,11,1263,329,3791,997,10707
"34017014400",4574,868,173,2,1973,131,4837,827,13385
"34017014501",4242,719,208,1,1612,324,4596,919,12621
"34017014502",2034,731,32,0,181,226,1515,724,5443
"34017014600",2080,417,127,0,1150,152,2632,522,7080
"34017014700",2631,542,157,19,1458,290,3608,720,9425
"34017014800",3178,825,162,3,1590,244,3659,915,10576
"34017014900",1390,289,81,0,1030,320,1590,478,5178
"34017015001",1125,37,84,0,747,38,503,0,2534
"34017015002",2155,819,416,102,1621,215,3248,971,9547
"34017015100",1978,331,74,81,1296,171,2841,288,7060
"34017015201",1838,176,14,0,771,0,551,65,3415
"34017015202",2716,433,336,0,1478,729,2935,781,9408
"34017015300",1920,695,97,76,1250,175,2863,746,7822
"34017015500",2558,586,222,23,1713,324,3777,933,10136
"34017015600",1853,933,104,55,947,309,2505,1191,7897
"34017015700",1858,422,88,31,1002,183,2620,607,6811
"34017015801",1711,42,120,7,967,58,186,0,3091
"34017015802",3217,1120,160,93,1457,108,4103,1235,11493
"34017015900",2194,728,96,91,1970,700,3974,1389,11142
"34017016000",1579,446,10,0,947,317,2198,747,6244
"34017016100",1289,467,195,0,1552,458,2909,896,7766
"34017016200",2743,783,31,12,1061,346,3449,1113,9538
"34017016300",2879,821,145,81,828,290,3493,1168,9705
"34017016400",2003,789,91,1,869,418,2623,1116,7910
"34017016500",2243,576,133,38,909,82,2408,299,6688
"34017016600",1836,941,85,0,658,544,2142,1108,7314
"34017016700",878,167,0,13,378,92,1011,272,2811
"34017016800",1999,547,122,19,429,298,2110,843,6367
"34017016900",1656,1101,32,7,607,349,1999,1404,7155
"34017017000",1985,770,532,36,935,224,2914,998,8394
"34017017100",3026,586,241,46,1054,384,3637,946,9920
"34017017200",1362,496,93,22,678,221,1784,625,5281
"34017017300",1524,336,21,0,510,142,1382,435,4350
"34017017400",1500,424,34,89,768,189,2016,618,5638
"34017017500",1646,607,434,23,1168,81,2682,598,7239
"34017017600",1299,370,164,2,666,306,1901,571,5279
"34017017700",1011,212,75,58,391,211,1210,416,3584
"34017017800",2748,1113,280,36,1346,333,3286,1325,10467
"34017017900",1111,110,40,37,588,10,197,53,2146
"34017018000",2966,254,258,4,636,90,1774,283,6265
"34017018100",1764,226,90,21,407,185,1193,361,4247
"34017018200",2934,180,366,0,684,148,964,280,5556
"34017018301",1645,40,0,7,294,6,128,0,2120
"34017018302",2715,68,22,0,679,25,178,0,3687
"34017018400",4288,649,50,0,270,145,581,269,6252
"34017018500",5207,202,82,0,558,196,733,52,7030
"34017018600",1955,116,0,7,318,44,368,17,2825
"34017018701",1321,21,2,0,59,33,113,1,1550
"34017018702",3357,695,63,0,577,100,884,485,6161
"34017018800",2545,210,0,41,261,41,200,25,3323
"34017018900",3115,254,15,0,346,142,229,202,4303
"34017019000",2707,844,515,379,401,212,1478,901,7437
"34017019100",2468,472,65,11,361,7,283,321,3988
"34017019200",3305,45,11,0,636,0,244,0,4241
"34017019300",2067,305,25,19,302,44,476,101,3339
"34017019400",2053,403,29,0,222,0,336,162,3205
"34017019800",3402,486,77,0,1611,113,696,423,6808
"34017019900",2691,96,181,8,1693,131,510,137,5447
"34017020000",2695,396,320,116,1729,84,922,100,6362
"34017020100",412,168,67,0,686,43,214,75,1665
"34017032400",2627,1274,122,31,2059,1169,4467,2398,14147
"34017980100",0,0,0,0,0,0,0,0,0
"34019010100",5505,82,65,0,290,0,317,0,6259
"34019010200",7123,281,2,15,189,21,290,9,7930
"34019010300",2323,138,32,5,179,0,58,4,2739
"34019010400",4328,171,11,0,118,82,101,126,4937
"34019010500",4952,98,115,0,62,0,153,0,5380
"34019010600",5752,85,1,4,84,8,189,2,6125
"34019010701",4215,120,14,2,182,39,194,47,4813
"34019010702",3095,83,3,1,43,1,101,1,3328
"34019010801",2285,176,11,2,193,19,163,99,2948
"34019010802",1550,101,2,7,98,6,119,1,1884
"34019010900",3429,34,25,1,132,0,164,1,3786
"34019011001",4274,20,51,2,214,0,140,7,4708
"34019011002",5711,168,8,0,592,0,520,44,7043
"34019011100",4826,410,17,0,153,0,237,42,5685
"34019011201",6501,66,17,0,468,18,282,0,7352
"34019011202",3149,106,47,34,244,0,159,0,3739
"34019011301",5828,158,20,26,337,0,234,6,6609
"34019011302",5958,579,48,0,719,12,296,72,7684
"34019011303",4206,155,24,20,289,50,85,0,4829
"34019011304",3023,201,33,0,139,0,33,0,3429
"34019011400",2665,497,90,21,1027,274,705,509,5788
"34019011500",4936,165,17,0,159,0,62,10,5349
"34019011600",4863,57,19,0,107,4,30,0,5080
"34019011700",3583,138,0,8,212,13,237,10,4201
"34019011800",2096,73,12,0,98,18,28,8,2333
"34019011900",3383,184,72,6,220,0,350,0,4215
"34021000100",1428,467,447,144,457,285,1336,621,5185
"34021000200",1368,250,635,264,345,425,887,540,4714
"34021000300",1418,321,813,105,1350,215,1754,388,6364
"34021000400",2020,851,476,291,1117,262,2664,918,8599
"34021000500",1925,439,501,452,749,220,2043,664,6993
"34021000600",1700,589,876,135,911,326,1608,726,6871
"34021000700",997,355,512,45,580,66,1189,353,4097
"34021000800",835,283,325,146,477,109,1059,371,3605
"34021000900",680,581,721,824,487,183,755,681,4912
"34021001000",388,301,863,606,468,82,857,379,3944
"34021001101",77,93,1256,554,136,95,16,49,2276
"34021001102",99,23,2634,1061,12,82,9,59,3979
"34021001200",669,8,2506,447,155,53,241,53,4132
"34021001300",416,95,2052,354,160,23,178,34,3312
"34021001401",77,28,2183,1573,88,89,117,86,4241
"34021001402",14,37,1353,659,1,30,21,136,2251
"34021001500",23,84,1923,703,0,17,0,97,2847
"34021001600",99,122,371,296,121,103,214,31,1357
"34021001700",524,61,2244,1127,45,76,429,3,4509
"34021001800",1686,371,952,102,305,205,573,188,4382
"34021001900",289,456,404,363,92,426,379,851,3260
"34021002000",178,62,390,273,66,1,79,2,1051
"34021002100",484,639,2061,526,1069,512,1526,853,7670
"34021002200",1296,485,2530,608,336,137,1184,558,7134
"34021002400",0,0,0,0,0,0,0,0,0
"34021002500",4431,623,644,0,539,0,1473,34,7744
"34021002601",1891,334,1231,184,559,8,940,171,5318
"34021002602",2439,230,780,133,320,113,701,59,4775
"34021002701",2559,270,803,55,249,51,706,182,4875
"34021002702",4695,824,740,131,529,0,1413,230,8562
"34021002800",2319,695,2554,1100,777,98,1258,725,9526
"34021002902",2512,99,1013,274,514,157,651,168,5388
"34021002903",2341,150,10,25,290,49,275,91,3231
"34021002904",4594,40,318,0,480,0,74,12,5518
"34021003001",5563,205,181,3,264,0,282,0,6498
"34021003002",5003,22,29,0,420,0,218,0,5692
"34021003003",5662,140,108,2,263,0,205,0,6380
"34021003004",4792,19,87,1,359,0,280,0,5538
"34021003006",5025,34,371,0,376,3,236,0,6045
"34021003007",3214,136,41,0,88,0,99,0,3578
"34021003008",4414,38,278,1,281,20,169,13,5214
"34021003009",4234,104,110,0,419,0,130,0,4997
"34021003100",3396,155,488,40,371,141,910,130,5631
"34021003201",3781,180,769,69,499,72,147,0,5517
"34021003202",3744,331,591,83,746,17,468,136,6116
"34021003301",5458,169,454,95,715,0,457,24,7372
"34021003302",3820,138,834,81,3507,53,493,18,8944
"34021003400",825,19,1190,220,66,220,222,224,2986
"34021003500",2519,830,2670,221,724,100,474,10,7548
"34021003601",1229,158,1543,229,257,10,221,154,3801
"34021003602",1687,310,1069,387,161,60,156,0,3830
"34021003703",2323,328,670,8,229,39,144,1,3742
"34021003704",1802,50,122,1,121,48,47,0,2191
"34021003705",3702,374,1241,143,165,9,246,160,6040
"34021003706",2771,133,461,33,315,0,170,38,3921
"34021003800",6305,301,100,1,398,1,106,21,7233
"34021003902",1789,14,29,1,58,0,35,0,1926
"34021003903",2322,78,28,13,95,52,66,42,2696
"34021003904",4568,96,281,0,1312,0,371,21,6649
"34021003905",4375,20,154,0,227,0,140,0,4916
"34021004000",3488,135,316,41,425,104,366,1,4876
"34021004201",4894,101,546,42,787,213,568,0,7151
"34021004203",2526,98,79,18,1221,87,186,25,4240
"34021004204",4018,196,224,0,1288,44,259,82,6111
"34021004301",3169,285,173,3,4945,27,577,58,9237
"34021004304",4334,104,266,0,3032,220,361,26,8343
"34021004306",2576,59,135,0,2647,58,237,0,5712
"34021004307",3205,326,45,61,2126,138,355,64,6320
"34021004309",3887,62,75,1,412,5,87,0,4529
"34021004310",7162,203,314,1,1802,1,344,1,9828
"34021004403",3489,138,290,76,1455,109,2181,129,7867
"34021004404",4764,291,295,226,1394,304,2300,98,9672
"34021004405",4001,90,249,100,2936,570,1175,88,9209
"34021004406",3140,160,256,38,1171,133,1365,150,6413
"34021004407",4372,518,299,142,1650,33,887,137,8038
"34021004501",1201,67,47,8,129,7,11,6,1476
"34021004502",820,117,13,0,104,62,29,22,1167
"34023000100",6748,89,73,5,475,0,572,0,7962
"34023000200",4296,172,694,57,1120,37,1464,0,7840
"34023000300",5255,134,606,133,1122,50,1968,126,9394
"34023000401",1947,82,724,42,814,104,560,0,4273
"34023000403",1824,60,1000,59,2592,19,489,13,6056
"34023000404",2338,244,823,11,1837,220,514,216,6203
"34023000501",1434,141,2237,168,1003,29,1062,137,6211
"34023000502",1553,26,1188,91,4453,337,678,60,8386
"34023000603",1010,47,67,10,1073,48,157,0,2412
"34023000606",1787,292,1488,4,3472,205,417,0,7665
"34023000608",377,85,209,15,790,166,83,28,1753
"34023000701",1576,72,328,174,1169,8,387,0,3714
"34023000702",2755,31,1536,47,1143,33,472,34,6051
"34023000801",2431,217,808,30,474,0,821,98,4879
"34023000802",2123,206,99,0,414,10,528,0,3380
"34023000901",2081,16,65,0,276,5,506,10,2959
"34023000902",3277,155,396,28,907,22,706,27,5518
"34023001001",2036,0,145,0,420,0,148,0,2749
"34023001002",2676,225,1036,0,2643,230,487,60,7357
"34023001100",3046,227,50,74,1132,156,222,28,4935
"34023001200",3149,438,360,360,1007,105,920,114,6453
"34023001300",3048,256,97,17,353,302,246,283,4602
"34023001409",1366,35,39,4,1829,41,62,0,3376
"34023001410",922,110,296,42,2927,64,180,12,4553
"34023001411",1375,0,110,0,1973,63,146,0,3667
"34023001412",1460,51,103,0,1644,89,143,0,3490
"34023001413",1463,53,502,24,3397,99,77,0,5615
"34023001414",1456,44,135,26,3861,157,144,38,5861
"34023001415",2682,156,0,0,2536,11,325,24,5734
"34023001416",768,68,147,106,6473,580,324,21,8487
"34023001417",990,10,19,25,1113,0,19,0,2176
"34023001502",3983,223,246,276,1295,13,295,56,6387
"34023001504",1316,90,374,104,3849,146,333,30,6242
"34023001505",110,2,302,13,1534,0,90,0,2051
"34023001506",393,268,83,154,5090,140,242,73,6443
"34023001600",3010,189,215,19,1399,90,1200,34,6156
"34023001701",3124,166,157,0,1381,59,546,45,5478
"34023001702",2265,26,198,25,1089,20,422,0,4045
"34023001803",1608,98,238,1,844,59,455,44,3347
"34023001804",1842,268,173,0,1768,217,690,157,5115
"34023001805",2020,177,535,15,2438,144,565,35,5929
"34023001901",2009,142,526,16,1428,13,492,88,4714
"34023001902",1481,52,122,1,394,0,384,0,2434
"34023001903",2022,138,7,0,774,0,403,78,3422
"34023002000",2348,134,412,8,1059,0,213,0,4174
"34023002101",1980,93,10,1,321,14,148,0,2567
"34023002102",3115,74,113,0,535,0,280,0,4117
"34023002200",2713,101,137,0,520,0,261,0,3732
"34023002301",3332,63,151,1,365,9,374,31,4326
"34023002302",3000,73,11,25,590,16,382,21,4118
"34023002401",3837,155,377,17,833,0,625,79,5923
"34023002402",1034,54,0,0,308,0,75,0,1471
"34023002500",2223,62,585,43,3929,253,652,34,7781
"34023002603",1712,64,389,18,2711,291,355,0,5540
"34023002604",3197,158,508,60,2267,292,654,0,7136
"34023002605",2083,67,108,0,385,40,323,10,3016
"34023002701",1987,456,351,21,2624,94,828,126,6487
"34023002703",3319,232,884,19,1125,18,910,129,6636
"34023002805",2263,16,170,0,276,11,310,16,3062
"34023002901",1920,153,511,17,692,0,501,86,3880
"34023002902",2030,155,173,114,197,233,849,196,3947
"34023003001",3420,276,91,87,499,70,883,236,5562
"34023003002",1619,40,528,0,4515,0,564,8,7274
"34023003101",1436,66,415,11,945,12,306,45,3236
"34023003102",1953,134,565,217,1789,191,459,122,5430
"34023003201",2332,74,460,0,390,6,561,0,3823
"34023003203",1994,336,103,18,681,58,684,262,4136
"34023003300",3177,293,522,138,981,256,2100,457,7924
"34023003401",2789,31,419,10,275,11,728,5,4268
"34023003500",2212,135,289,1,928,129,1221,26,4941
"34023003600",4134,830,676,276,1730,297,2449,578,10970
"34023003700",1844,44,210,14,1452,69,662,36,4331
"34023003800",3544,485,1078,228,1930,182,1558,559,9564
"34023004000",2052,642,695,10,418,130,1949,725,6621
"34023004100",2211,322,159,29,264,0,1835,311,5131
"34023004200",1763,429,231,63,488,37,1887,490,5388
"34023004300",3165,375,397,24,258,179,3042,531,7971
"34023004400",2836,498,322,0,640,10,3180,485,7971
"34023004500",3286,2099,948,86,683,92,3488,2033,12715
"34023004600",3016,1479,238,97,575,72,3340,1483,10300
"34023004700",2645,328,205,177,604,72,2687,298,7016
"34023004800",3261,1576,282,28,286,220,3294,1701,10648
"34023004900",3094,957,245,143,821,216,3363,1054,9893
"34023005000",2603,922,211,114,483,278,2790,1151,8552
"34023005100",1034,1588,54,88,371,350,184,87,3756
"34023005200",2143,2710,219,95,306,771,1658,1330,9232
"34023005300",1607,1159,158,70,155,19,1722,1130,6020
"34023005500",1596,622,1356,97,195,131,1680,731,6408
"34023005601",1488,684,176,81,220,76,1492,631,4848
"34023005602",3776,1551,447,145,1111,274,4561,1793,13658
"34023005700",2815,894,619,354,786,287,3100,971,9826
"34023005800",2739,1561,304,242,347,239,2820,1569,9821
"34023006001",1252,27,413,0,409,21,487,11,2620
"34023006002",1063,405,382,96,462,164,1152,296,4020
"34023006101",3111,223,411,18,945,64,2341,121,7234
"34023006103",2689,97,465,30,1871,138,1641,144,7075
"34023006104",2035,153,763,148,1213,19,552,30,4913
"34023006203",3372,159,1296,423,4008,209,923,17,10407
"34023006204",730,40,126,0,922,10,40,0,1868
"34023006205",3358,99,906,78,2446,162,723,45,7817
"34023006206",1445,34,82,0,235,0,56,0,1852
"34023006207",2692,224,1759,101,1163,107,810,137,6993
"34023006300",5702,469,201,130,460,12,388,69,7431
"34023006403",1600,76,179,0,827,50,371,6,3109
"34023006500",5013,101,359,0,1908,84,478,0,7943
"34023006601",1806,50,0,0,442,8,109,8,2423
"34023006604",3686,295,286,19,2462,0,224,135,7107
"34023006605",3069,79,168,0,474,0,133,0,3923
"34023006606",2058,179,13,0,758,27,49,0,3084
"34023006607",2204,106,70,0,528,0,184,0,3092
"34023006608",2118,100,133,27,1044,46,86,0,3554
"34023006701",2805,96,148,44,1012,41,459,12,4617
"34023006703",3010,337,356,135,1937,147,556,37,6515
"34023006800",3435,632,30,0,263,74,634,433,5501
"34023006900",1791,390,351,98,505,215,989,569,4908
"34023007000",5611,405,1038,0,1086,204,989,238,9571
"34023007101",2735,112,400,0,517,142,538,39,4483
"34023007102",3520,124,265,39,757,10,447,0,5162
"34023007103",1524,249,1949,128,1021,152,727,225,5975
"34023007202",3230,52,303,87,1405,39,519,7,5642
"34023007203",2720,219,324,77,1488,51,658,117,5654
"34023007301",2556,157,102,10,191,0,285,134,3435
"34023007303",1441,69,124,1,119,0,175,0,1929
"34023007304",3228,214,852,0,2270,146,591,15,7316
"34023007402",3380,64,359,0,466,40,455,10,4774
"34023007500",2873,283,124,0,228,36,474,109,4127
"34023007600",4446,353,161,0,238,0,788,1,5987
"34023007702",3850,85,322,35,1476,0,626,0,6394
"34023007703",2516,80,163,0,363,0,237,20,3379
"34023007704",2434,90,86,0,210,0,505,64,3389
"34023007801",1839,72,329,27,868,0,224,0,3359
"34023007804",4055,126,150,0,794,36,443,22,5626
"34023007805",4173,29,88,0,513,0,340,0,5143
"34023007806",3241,227,235,1,249,11,389,21,4374
"34023007905",1720,37,103,3,424,7,247,0,2541
"34023007906",1009,84,301,84,306,14,324,54,2176
"34023007907",2634,28,94,0,364,0,268,0,3388
"34023007908",1403,79,932,67,1613,228,800,31,5153
"34023007909",3326,90,0,13,718,0,402,13,4562
"34023007910",2355,122,89,0,593,36,352,36,3583
"34023007911",2513,0,184,0,1224,11,551,0,4483
"34023007912",4972,157,86,10,2079,43,396,39,7782
"34023008001",5012,220,605,88,861,59,588,30,7463
"34023008101",4153,123,89,2,161,9,156,9,4702
"34023008102",3356,137,58,10,250,11,329,22,4173
"34023008103",1935,79,35,6,299,17,234,7,2612
"34023008202",8203,422,273,7,2566,0,377,0,11848
"34023008204",3420,111,130,14,83,0,121,0,3879
"34023008205",2763,170,68,0,91,0,42,40,3174
"34023008206",2627,348,293,88,113,0,39,151,3659
"34023008207",2315,82,9,0,17,0,49,0,2472
"34023008208",7721,307,368,41,3945,26,493,31,12932
"34023008209",2966,241,0,2,381,13,44,13,3660
"34023008300",4603,523,443,0,383,0,751,291,6994
"34023008403",3349,79,531,206,3261,25,223,8,7682
"34023008404",2875,105,136,0,863,46,286,73,4384
"34023008405",2490,105,293,2,2174,9,161,31,5265
"34023008406",1336,67,52,0,765,0,144,47,2411
"34023008501",1624,124,669,50,2680,173,181,27,5528
"34023008502",2754,37,111,0,2256,0,290,19,5467
"34023008503",3382,101,974,28,4426,58,463,55,9487
"34023008504",3519,43,260,0,2215,0,131,0,6168
"34023008601",2539,136,108,1,2592,0,532,10,5918
"34023008602",2045,104,242,10,2860,122,137,0,5520
"34023008604",2116,92,370,21,2909,162,270,0,5940
"34023008605",651,52,377,0,1383,70,94,0,2627
"34023008606",1325,87,397,0,2207,134,158,71,4379
"34023008700",2834,44,180,1,551,0,95,0,3705
"34023008800",1331,46,174,18,616,56,166,0,2407
"34023008900",1220,83,578,40,1787,139,756,59,4662
"34023009000",1048,174,866,101,683,63,244,1,3180
"34023009100",2282,221,587,80,554,0,638,172,4534
"34023009200",3098,199,555,0,434,6,620,15,4927
"34023009300",1743,1372,568,366,910,172,1480,1004,7615
"34023009400",2807,346,503,0,1494,148,518,69,5885
"34025800100",3915,749,60,0,209,30,296,158,5417
"34025800200",3792,254,70,2,184,37,170,31,4540
"34025800400",3241,192,0,0,41,15,170,0,3659
"34025800500",3831,129,10,1,182,0,428,0,4581
"34025800601",4905,313,102,2,125,13,426,19,5905
"34025800602",3237,250,24,10,177,23,125,14,3860
"34025800701",4720,149,20,2,204,0,324,6,5425
"34025800702",2880,263,8,0,192,47,113,0,3503
"34025800800",6040,47,16,0,201,0,478,0,6782
"34025800900",5226,259,125,0,89,0,313,48,6060
"34025801000",3454,294,13,0,195,0,354,0,4310
"34025801100",3865,121,16,7,210,51,230,37,4537
"34025801200",3499,50,0,0,231,0,94,0,3874
"34025801300",5760,111,68,0,327,0,268,0,6534
"34025801400",3727,23,0,0,228,105,190,71,4344
"34025801500",5460,221,166,0,555,11,200,11,6624
"34025801600",3874,709,197,50,443,86,836,35,6230
"34025801700",2853,467,306,124,465,206,505,191,5117
"34025801800",5233,152,129,214,203,12,714,1,6658
"34025801900",2386,99,154,138,560,30,498,16,3881
"34025802000",2864,206,97,23,439,184,645,194,4652
"34025802100",5380,161,251,23,250,61,353,0,6479
"34025802200",3572,210,0,0,35,0,304,0,4121
"34025802300",3929,202,21,10,231,59,318,52,4822
"34025802400",4765,161,182,0,550,0,380,0,6038
"34025802500",2385,107,417,21,388,5,735,18,4076
"34025802600",2569,153,1098,138,828,85,608,9,5488
"34025802700",2907,94,242,39,516,16,297,30,4141
"34025802800",3389,211,234,0,367,40,350,30,4621
"34025802900",1684,41,31,61,131,1,57,0,2006
"34025803000",4028,200,271,81,466,66,500,0,5612
"34025803100",2540,196,298,2,416,92,237,99,3880
"34025803201",2379,62,27,0,1239,98,305,36,4146
"34025803202",4656,183,76,0,1215,77,265,0,6472
"34025803300",4536,170,160,0,1388,0,201,0,6455
"34025803400",1531,310,1293,354,1339,542,1888,757,8014
"34025803500",1916,107,108,0,192,103,350,95,2871
"34025803600",3559,181,55,63,383,19,524,48,4832
"34025803700",5666,57,183,1,151,0,164,0,6222
"34025803800",3060,33,0,6,45,0,82,2,3228
"34025803900",3574,219,30,0,78,0,141,0,4042
"34025804100",2791,202,0,0,285,0,212,0,3490
"34025804200",5482,240,19,0,179,0,280,0,6200
"34025804500",4332,201,625,35,309,0,636,11,6149
"34025804600",2389,66,96,0,352,0,96,0,2999
"34025804700",0,0,0,0,0,0,0,0,0
"34025804800",7483,334,570,68,473,416,408,105,9857
"34025805001",2234,508,874,79,1041,105,653,418,5912
"34025805100",3199,195,78,10,435,8,318,41,4284
"34025805300",4811,427,46,0,156,0,98,0,5538
"34025805400",2917,204,283,53,144,74,459,122,4256
"34025805500",1839,374,980,107,401,23,882,44,4650
"34025805600",308,614,598,318,520,123,499,690,3670
"34025805700",2005,202,122,9,1025,219,1489,293,5364
"34025805800",1843,461,396,81,461,227,929,368,4766
"34025805900",3302,800,429,115,956,69,1644,406,7721
"34025806000",2635,767,99,23,724,1,813,253,5315
"34025806100",2964,299,35,66,35,181,127,0,3707
"34025806201",2049,215,0,0,38,24,41,0,2367
"34025806202",4370,119,32,0,231,0,314,0,5066
"34025806300",1964,186,0,0,270,44,218,7,2689
"34025806400",4131,487,20,1,412,3,159,14,5227
"34025806501",2140,469,538,161,639,415,1125,232,5719
"34025806502",2077,224,556,9,535,65,392,100,3958
"34025806503",3237,50,151,0,364,0,96,0,3898
"34025806504",1232,273,674,26,334,121,240,70,2970
"34025806600",4654,256,121,0,361,0,491,36,5919
"34025807003",1933,319,1110,666,534,348,1689,635,7234
"34025807004",1424,336,370,303,413,323,577,484,4230
"34025807100",1067,75,839,351,57,238,197,217,3041
"34025807200",309,82,768,707,112,40,206,181,2405
"34025807300",286,82,1528,1043,76,170,332,275,3792
"34025807400",2672,182,39,12,126,0,201,46,3278
"34025807500",833,125,1140,13,313,100,498,158,3180
"34025807600",177,14,1277,833,376,188,218,142,3225
"34025807700",839,78,2271,687,251,90,234,90,4540
"34025807800",1543,92,2017,245,775,8,450,18,5148
"34025807900",1780,58,1188,90,251,8,173,0,3548
"34025808001",3939,220,51,0,106,0,122,0,4438
"34025808002",1958,34,219,23,129,5,229,1,2598
"34025808100",2884,252,796,327,394,0,216,246,5115
"34025808200",3450,243,93,46,266,192,361,177,4828
"34025808300",1686,79,0,2,42,1,37,12,1859
"34025808401",1913,178,29,3,41,34,291,34,2523
"34025808402",2810,375,120,39,187,21,559,192,4303
"34025808500",5696,483,16,4,175,43,212,0,6629
"34025808600",5214,393,584,0,85,6,202,0,6484
"34025808701",4470,276,18,0,174,0,35,0,4973
"34025808702",3776,58,12,0,80,0,42,0,3968
"34025808800",3949,65,0,24,139,11,52,0,4240
"34025808900",4364,178,15,76,35,23,167,0,4858
"34025809000",996,221,208,20,154,48,167,134,1948
"34025809100",2837,111,17,0,34,0,90,1,3090
"34025809200",1804,31,0,1,7,0,22,0,1865
"34025809301",2952,86,0,45,37,0,43,44,3207
"34025809302",2538,169,0,0,14,0,200,7,2928
"34025809400",4428,94,149,0,101,0,222,0,4994
"34025809501",5418,67,143,10,2583,46,375,5,8647
"34025809502",6550,21,215,0,1770,0,321,0,8877
"34025809600",6365,58,29,0,558,0,402,0,7412
"34025809701",4536,53,93,7,993,3,202,0,5887
"34025809703",4006,61,47,0,389,0,133,0,4636
"34025809704",4577,222,47,0,1319,25,233,0,6423
"34025809901",4443,299,58,0,230,25,167,13,5235
"34025809902",4293,219,31,0,290,0,67,105,5005
"34025809903",112,0,17,0,42,0,53,0,224
"34025810001",4661,249,123,21,555,27,314,0,5950
"34025810002",3148,244,87,0,58,49,130,9,3725
"34025810003",4804,92,34,5,99,6,280,0,5320
"34025810004",3567,129,0,2,226,0,105,0,4029
"34025810101",3821,174,55,0,296,0,123,0,4469
"34025810102",3613,131,41,0,313,0,131,0,4229
"34025810200",9942,287,648,11,1803,48,760,0,13499
"34025810300",1718,72,19,0,199,0,131,41,2180
"34025810401",2633,131,123,5,415,0,123,60,3490
"34025810402",6493,286,303,16,1170,0,446,17,8731
"34025810501",3586,169,470,92,258,32,689,150,5446
"34025810502",6455,157,101,2,893,95,663,88,8454
"34025810503",3341,280,181,16,178,0,210,28,4234
"34025810600",6009,298,99,14,288,60,262,19,7049
"34025810700",1368,86,152,9,277,0,476,46,2414
"34025810800",1676,421,539,337,126,187,868,515,4669
"34025810900",2155,291,144,24,331,19,869,203,4036
"34025811000",2672,340,367,26,383,33,1712,351,5884
"34025811101",4833,320,0,0,567,0,184,0,5904
"34025811102",5700,274,94,1,322,1,386,0,6778
"34025811200",4887,192,163,18,261,104,502,107,6234
"34025811301",3875,731,315,53,735,126,543,317,6695
"34025811303",4085,53,141,10,217,29,229,0,4764
"34025811304",2811,100,66,0,431,13,425,64,3910
"34025811401",5472,52,107,0,220,190,539,20,6600
"34025811402",3231,135,251,19,246,0,505,40,4427
"34025811501",5374,37,0,20,606,55,421,0,6513
"34025811502",3200,333,54,0,158,29,125,62,3961
"34025811600",1097,82,107,13,88,0,45,5,1437
"34025811900",6324,128,76,0,370,0,130,0,7028
"34025812000",1620,51,75,0,82,0,63,0,1891
"34025812100",1149,151,7,4,41,0,156,17,1525
"34025812200",2731,75,112,18,628,69,589,10,4232
"34025812300",4441,181,142,51,130,18,428,87,5478
"34025812400",2106,76,7,10,65,15,70,11,2360
"34025812501",5112,200,257,15,285,0,166,0,6035
"34025812502",4416,157,268,5,517,7,203,27,5600
"34025990000",0,0,0,0,0,0,0,0,0
"34027040101",3730,49,39,1,404,96,251,37,4607
"34027040102",4647,244,207,42,476,0,208,130,5954
"34027040200",6015,359,44,6,582,23,564,23,7616
"34027040300",8124,152,10,0,255,0,348,0,8889
"34027040400",3646,80,0,0,152,0,168,0,4046
"34027040500",3007,235,9,0,415,71,649,231,4617
"34027040600",3679,43,10,0,158,0,286,0,4176
"34027040701",5777,75,0,0,189,0,267,0,6308
"34027040702",3871,84,43,0,310,0,384,0,4692
"34027040801",4105,242,8,0,588,13,174,13,5143
"34027040803",4740,315,13,0,2068,54,640,41,7871
"34027040804",2647,112,80,0,725,0,203,2,3769
"34027040805",4959,91,0,0,801,0,386,0,6237
"34027040900",3648,191,133,0,249,0,74,0,4295
"34027041000",3369,156,262,39,799,41,478,33,5177
"34027041100",3010,144,100,2,341,72,618,123,4410
"34027041200",3615,74,9,0,482,55,55,42,4332
"34027041300",3957,74,0,0,308,0,153,0,4492
"34027041400",5214,200,105,0,631,2,360,57,6569
"34027041500",5343,32,83,1,698,16,423,0,6596
"34027041601",3743,220,191,9,2799,69,301,56,7388
"34027041602",2103,38,35,0,839,70,142,70,3297
"34027041603",2443,39,144,0,1670,304,415,11,5026
"34027041604",3509,59,61,0,787,21,294,0,4731
"34027041701",3671,191,136,0,1710,173,630,38,6549
"34027041702",2393,54,118,0,1117,0,356,9,4047
"34027041704",2503,88,272,46,1927,14,353,45,5248
"34027041705",885,150,0,0,201,77,40,13,1366
"34027041706",2596,357,394,13,1655,14,850,53,5932
"34027041801",1243,50,114,7,1373,73,122,8,2990
"34027041802",3164,95,71,0,2022,35,393,59,5839
"34027041803",2297,70,85,47,1994,96,182,55,4826
"34027041901",5020,291,45,0,485,123,287,151,6402
"34027041902",4091,100,18,0,1068,14,458,28,5777
"34027042000",3505,98,177,0,800,12,94,15,4701
"34027042100",3733,130,7,0,368,0,453,9,4700
"34027042200",4137,191,0,1,898,17,271,17,5532
"34027042301",2221,118,19,32,90,0,198,31,2709
"34027042302",2741,41,92,2,205,0,261,0,3342
"34027042500",3166,16,76,0,155,0,144,0,3557
"34027042600",5064,522,269,0,1019,0,600,65,7539
"34027042700",3617,39,38,3,253,30,207,1,4188
"34027042800",4499,94,25,15,352,0,410,0,5395
"34027042900",2895,206,111,4,359,6,244,63,3888
"34027043000",3986,52,0,0,414,12,289,0,4753
"34027043100",3172,115,53,12,217,0,35,9,3613
"34027043200",2586,137,69,0,174,0,207,28,3201
"34027043301",1858,51,440,39,213,0,342,0,2943
"34027043302",2735,174,33,8,213,0,48,0,3211
"34027043303",3409,8,35,0,253,0,226,0,3931
"34027043401",5659,276,248,18,586,17,295,47,7146
"34027043402",4589,205,43,197,420,6,281,25,5766
"34027043500",1792,836,771,169,495,50,1964,753,6830
"34027043600",3963,223,590,19,800,13,1219,70,6897
"34027043700",2388,231,317,0,216,0,323,130,3605
"34027043800",3582,550,362,89,653,21,1188,364,6809
"34027043900",3959,243,124,15,338,0,113,0,4792
"34027044000",5012,92,125,0,592,0,191,0,6012
"34027044101",2630,36,0,1,308,0,96,0,3071
"34027044102",4796,177,109,2,681,29,589,18,6401
"34027044200",3199,209,10,78,357,9,87,0,3949
"34027044300",5339,135,394,44,568,0,959,0,7439
"34027044401",4116,157,53,0,305,0,192,41,4864
"34027044403",4089,87,108,0,427,0,533,20,5264
"34027044404",2982,27,114,0,900,0,519,6,4548
"34027044501",4843,182,346,15,1127,0,547,56,7116
"34027044502",3208,132,66,7,1007,50,1170,49,5689
"34027044601",4538,122,0,1,172,34,353,0,5220
"34027044602",5285,341,116,12,56,0,336,0,6146
"34027044701",4280,291,0,0,71,50,333,0,5025
"34027044702",4933,162,184,5,718,15,643,53,6713
"34027044800",2421,419,377,22,3425,194,4442,398,11698
"34027044900",3182,292,273,0,2240,193,4032,419,10631
"34027045000",1989,180,108,30,2208,297,2983,389,8184
"34027045100",3367,382,267,1,2353,211,2603,405,9589
"34027045200",2863,227,113,8,351,0,622,74,4258
"34027045300",3216,177,144,0,604,114,457,121,4833
"34027045401",4900,47,43,4,146,0,275,18,5433
"34027045402",4057,342,146,67,890,0,754,17,6273
"34027045501",4754,65,98,0,188,0,303,54,5462
"34027045502",7441,188,179,27,547,62,668,14,9126
"34027045602",567,142,237,62,473,165,651,249,2546
"34027045603",3391,148,399,0,1460,63,1281,82,6824
"34027045701",5049,233,91,40,610,32,180,24,6259
"34027045703",3208,79,194,0,242,0,78,0,3801
"34027045704",4519,141,47,0,524,0,255,38,5524
"34027045804",4961,373,30,0,513,0,221,0,6098
"34027045901",1376,51,0,0,126,0,173,0,1726
"34027045902",6777,548,26,0,514,41,190,35,8131
"34027046000",2561,449,34,4,173,27,595,162,4005
"34027046103",4687,229,345,0,534,0,508,16,6319
"34027046104",6037,438,264,64,742,0,1547,288,9380
"34027046105",5045,337,565,4,1081,80,941,141,8194
"34027046106",6346,356,310,0,903,0,473,110,8498
"34027046201",5539,124,205,26,441,0,371,0,6706
"34027046202",3638,193,0,0,81,0,228,74,4214
"34027046297",3217,54,133,0,85,0,109,0,3598
"34027046298",4076,59,164,0,510,0,153,0,4962
"34027046300",4350,122,144,26,705,60,456,11,5874
"34027046400",4435,107,0,4,197,0,153,0,4896
"34029710100",3847,476,39,0,189,104,251,218,5124
"34029711100",3814,180,44,12,45,75,112,115,4397
"34029711200",3747,390,0,0,46,0,35,0,4218
"34029711300",3660,270,0,0,128,0,184,0,4242
"34029711400",5628,213,0,11,91,0,180,13,6136
"34029712000",1191,91,0,0,54,1,7,0,1344
"34029713000",4073,213,24,3,243,32,71,50,4709
"34029713100",5586,230,47,0,563,3,326,0,6755
"34029713201",2573,82,7,0,0,0,76,6,2744
"34029713202",3847,87,0,0,99,0,348,0,4381
"34029713203",3817,158,616,79,337,0,508,0,5515
"34029713300",3515,314,0,1,161,0,207,0,4198
"34029713401",4143,293,140,111,368,0,742,45,5842
"34029713402",3054,535,134,0,269,55,422,134,4603
"34029713500",2932,129,0,0,6,0,92,0,3159
"34029713600",3517,126,0,1,149,15,211,1,4020
"34029713700",2442,117,0,0,23,0,130,0,2712
"34029713800",3089,177,20,14,52,44,215,13,3624
"34029713900",5079,392,383,1,473,99,566,130,7123
"34029714000",5316,163,0,3,583,86,440,16,6607
"34029714100",2727,178,32,25,73,0,102,0,3137
"34029714200",5866,518,44,134,152,39,343,90,7186
"34029714300",3129,87,0,0,29,0,43,30,3318
"34029714400",539,34,1,0,0,0,6,1,581
"34029715000",5009,1640,341,243,1719,192,2689,1272,13105
"34029715200",7248,4082,237,178,800,297,2067,1304,16213
"34029715301",5676,3154,400,14,148,59,750,551,10752
"34029715302",2111,3727,62,57,97,34,249,622,6959
"34029715401",4180,1107,8,0,163,6,218,0,5682
"34029715402",2638,2874,0,0,0,0,108,38,5658
"34029715500",7440,3693,50,0,8,34,126,76,11427
"34029715600",3023,1795,321,272,383,271,850,508,7423
"34029715700",5396,3067,237,18,129,392,781,731,10751
"34029715800",3810,1569,314,101,291,65,781,190,7121
"34029715901",1419,74,405,91,296,25,297,35,2642
"34029715902",3546,193,88,179,138,12,943,55,5154
"34029716000",3301,281,51,0,56,0,73,0,3762
"34029717001",2479,7,116,0,144,0,295,0,3041
"34029717002",3324,176,362,49,459,0,524,7,4901
"34029717101",6885,272,351,0,825,117,717,213,9380
"34029717102",3957,120,147,168,143,9,339,9,4892
"34029717200",7909,289,216,88,618,18,582,17,9737
"34029717300",5044,221,417,84,204,13,387,0,6370
"34029717400",4170,370,437,23,201,28,373,0,5602
"34029717501",5948,450,722,116,255,95,768,265,8619
"34029717502",6461,174,281,14,341,0,514,0,7785
"34029718000",7259,648,270,0,221,2,357,150,8907
"34029720001",3652,319,63,0,222,3,100,3,4362
"34029720101",4262,1153,448,58,85,0,246,0,6252
"34029720102",2637,368,71,14,48,0,103,0,3241
"34029720103",3964,236,23,9,101,72,135,13,4553
"34029720202",3236,120,522,110,22,33,281,33,4357
"34029720203",3475,263,275,1,75,11,302,20,4422
"34029720204",4749,389,341,0,629,19,510,19,6656
"34029720205",2507,91,21,0,207,0,102,19,2947
"34029720206",5174,247,333,0,306,0,179,7,6246
"34029721000",2056,216,167,20,146,68,494,33,3200
"34029722001",4527,171,20,0,380,42,342,0,5482
"34029722002",6853,489,151,0,609,100,850,0,9052
"34029722100",5250,164,187,0,736,0,567,0,6904
"34029722200",1968,260,30,0,17,0,60,0,2335
"34029722300",3422,58,145,0,233,0,102,9,3969
"34029722401",4747,384,20,0,217,0,339,55,5762
"34029722402",3525,86,2,2,222,0,76,0,3913
"34029722500",922,68,0,0,0,0,17,0,1007
"34029722600",2912,122,64,0,0,16,284,1,3399
"34029722701",3973,227,0,0,345,0,162,16,4723
"34029722702",3790,214,22,0,53,0,172,9,4260
"34029722800",3593,282,489,61,545,129,1023,182,6304
"34029722900",3716,403,177,84,904,26,768,33,6111
"34029723000",4396,424,64,18,332,39,296,100,5669
"34029723100",3388,75,23,16,55,57,208,30,3852
"34029723200",5780,276,17,0,427,0,355,33,6888
"34029723300",6122,699,7,20,166,88,813,262,8177
"34029723400",3062,93,0,0,11,0,70,0,3236
"34029723500",1897,251,91,0,188,33,98,0,2558
"34029723600",2112,268,8,0,18,20,68,20,2514
"34029724000",1840,300,609,173,523,209,644,197,4495
"34029725001",2452,158,13,0,139,186,101,192,3241
"34029725002",5443,293,91,3,239,0,481,15,6565
"34029725100",1912,86,6,0,80,26,103,22,2235
"34029726000",1465,124,21,0,78,22,28,25,1763
"34029727001",1865,160,0,0,4,0,4,0,2033
"34029727002",1076,133,0,0,6,0,13,5,1233
"34029728000",4076,797,17,32,155,179,620,389,6265
"34029729000",1715,273,78,0,0,0,92,0,2158
"34029730000",2067,95,10,2,45,0,48,0,2267
"34029731001",3046,88,21,0,29,0,131,0,3315
"34029731002",3292,172,8,83,64,21,202,21,3863
"34029731101",2610,575,54,12,195,37,165,41,3689
"34029731102",5278,280,206,32,435,1,695,2,6929
"34029731103",4137,135,40,0,77,0,293,11,4693
"34029731201",3566,287,69,70,73,11,249,0,4325
"34029731202",3860,364,15,0,36,0,98,0,4373
"34029731203",1610,139,13,0,5,0,0,0,1767
"34029731204",3362,151,25,0,50,7,275,0,3870
"34029731205",2572,212,398,0,61,0,248,24,3515
"34029731206",1953,176,9,24,38,0,68,0,2268
"34029732001",6272,101,29,4,55,0,102,0,6563
"34029732002",7556,818,50,3,52,0,162,142,8783
"34029732101",5331,723,1,49,64,0,292,210,6670
"34029732103",2337,96,0,1,118,0,214,2,2768
"34029732104",3553,379,20,0,128,0,17,0,4097
"34029733000",7787,319,0,18,289,77,454,0,8944
"34029734001",6324,310,203,0,307,15,173,29,7361
"34029734002",5841,521,105,0,236,155,636,47,7541
"34029734003",5638,599,553,1,518,136,767,71,8283
"34029735001",6053,278,0,0,28,0,534,70,6963
"34029735002",8637,235,81,0,61,0,370,0,9384
"34029735101",1953,69,14,0,82,128,61,0,2307
"34029735103",4107,235,0,0,65,0,99,0,4506
"34029735104",3806,383,24,0,261,1,906,166,5547
"34029736001",3015,68,11,0,48,0,55,0,3197
"34029736002",1421,34,3,0,90,0,36,0,1584
"34029736101",4726,601,27,12,310,88,193,333,6290
"34029736102",6776,758,20,33,265,6,289,15,8162
"34029736105",2941,151,59,10,89,4,189,7,3450
"34029737000",2989,258,31,2,81,7,122,25,3515
"34029738001",1883,202,0,0,11,0,21,0,2117
"34029738002",1228,67,32,0,0,1,5,0,1333
"34029738100",1622,67,2,0,29,2,42,0,1764
"34029739000",2026,90,13,0,34,10,35,12,2220
"34029739100",1314,145,17,0,53,17,0,17,1563
"34029980000",0,0,0,0,0,0,0,0,0
"34029980100",0,0,0,0,35,0,0,0,35
"34029990000",0,0,0,0,0,0,0,0,0
"34031116500",7044,228,0,3,418,0,807,100,8600
"34031124200",4998,124,201,0,1548,141,1225,0,8237
"34031124311",3390,216,0,0,993,19,614,19,5251
"34031124312",3108,37,326,1,545,73,470,13,4573
"34031124321",4054,160,375,7,1105,244,1187,255,7387
"34031124322",3413,22,20,3,912,0,787,3,5160
"34031124323",1582,158,258,261,644,0,456,28,3387
"34031124401",5253,129,297,1,811,51,974,52,7568
"34031124402",3098,385,168,24,1344,100,924,23,6066
"34031124500",4709,859,306,1,659,149,1916,214,8813
"34031124601",3103,564,129,7,700,174,1364,365,6406
"34031124602",3123,382,439,0,821,94,1446,169,6474
"34031124700",4083,429,79,1,1356,236,2794,348,9326
"34031124800",2479,187,237,0,1606,109,2172,161,6951
"34031124900",2957,424,275,0,1842,148,3154,431,9231
"34031125000",3874,838,371,0,1451,213,4156,581,11484
"34031125100",2080,259,320,54,1023,389,2474,569,7168
"34031133701",2834,580,670,16,1300,224,2157,441,8222
"34031133702",2163,159,73,11,272,16,860,137,3691
"34031143200",6032,174,124,1,149,0,604,15,7099
"34031143300",5100,151,0,6,172,0,1091,49,6569
"34031143400",5632,792,107,0,504,0,1088,343,8466
"34031154001",4553,160,271,1,642,35,269,80,6011
"34031154002",5793,503,87,1,1092,188,1127,72,8863
"34031163500",7048,377,351,0,535,0,852,0,9163
"34031175200",1592,778,275,167,1328,1137,2856,1960,10093
"34031175301",856,419,34,39,1332,869,2086,1280,6915
"34031175302",1339,559,231,320,1063,1332,2260,1902,9006
"34031175401",1656,458,514,96,1363,1001,2897,1379,9364
"34031175402",671,379,372,391,1690,1378,2395,1790,9066
"34031175500",1327,561,905,720,2312,1850,3535,2629,13839
"34031175601",2220,16,0,0,230,0,221,0,2687
"34031175602",2530,666,725,159,1206,954,2644,1345,10229
"34031175701",2923,217,364,370,812,244,2268,438,7636
"34031175703",2138,312,270,213,1797,412,1800,608,7550
"34031175704",3770,245,156,0,368,16,738,129,5422
"34031175801",817,638,302,5,1952,621,1974,1103,7412
"34031175802",1852,1871,276,290,1613,1217,3507,3161,13787
"34031175900",828,260,340,149,1514,871,2352,1150,7464
"34031180100",3710,532,1853,22,1497,587,4128,351,12680
"34031180201",1072,187,776,147,798,210,1327,346,4863
"34031180202",2353,568,489,202,1173,1590,2844,1236,10455
"34031180300",1670,593,1470,702,1147,592,2375,900,9449
"34031180600",837,514,1129,633,462,358,1102,714,5749
"34031180700",418,198,728,477,204,85,567,283,2960
"34031180800",782,424,459,497,213,354,1048,734,4511
"34031180900",695,484,468,518,735,425,1321,849,5495
"34031181000",1800,459,642,227,1223,366,3010,777,8504
"34031181100",2025,403,2321,1009,1532,541,3290,819,11940
"34031181200",799,297,1478,888,684,146,1477,462,6231
"34031181300",610,689,1891,913,510,44,1123,635,6415
"34031181400",216,131,1154,893,188,95,392,178,3247
"34031181500",170,119,1028,767,310,145,545,307,3391
"34031181702",562,499,363,279,788,560,1330,1109,5490
"34031181800",505,538,165,242,478,538,753,786,4005
"34031181900",1977,337,448,136,1637,467,2455,484,7941
"34031182000",477,248,84,9,534,146,943,377,2818
"34031182100",1618,975,246,118,693,186,1972,586,6394
"34031182200",1048,482,236,525,757,550,1662,936,6196
"34031182301",348,331,228,69,353,456,688,787,3260
"34031182302",1425,828,958,390,1481,1073,2907,1837,10899
"34031182400",1811,154,1773,405,780,192,2716,346,8177
"34031182500",1962,567,3587,990,1050,266,3285,743,12450
"34031182600",965,340,3226,268,693,17,1615,354,7478
"34031182700",3022,758,1242,211,1616,255,4683,875,12662
"34031182800",901,204,449,101,1166,628,2058,805,6312
"34031182900",814,419,88,52,450,349,1182,756,4110
"34031183000",4901,1236,43,24,1400,368,3258,599,11829
"34031183101",2154,147,270,12,785,228,2314,238,6148
"34031183102",2081,640,522,73,787,209,2728,616,7656
"34031183200",763,201,991,551,125,67,908,255,3861
"34031196401",3819,17,0,0,267,20,330,17,4470
"34031196402",5702,558,4,0,728,0,839,441,8272
"34031203600",3257,315,930,388,919,106,2928,290,9133
"34031216701",6206,145,46,8,289,11,125,13,6843
"34031216702",4895,319,2,6,299,14,368,11,5914
"34031223801",2320,62,45,0,367,19,593,19,3425
"34031223802",5948,184,31,70,914,58,1076,58,8339
"34031223900",203,320,15,97,0,0,4,69,708
"34031236601",3101,143,1,2,541,1,450,29,4268
"34031236602",6202,182,96,62,552,5,766,16,7881
"34031246001",3319,231,0,1,883,79,363,53,4929
"34031246002",2764,47,0,0,182,0,125,0,3118
"34031246003",4490,159,140,1,554,0,279,23,5646
"34031246101",5898,259,182,5,780,1,598,72,7795
"34031246102",1722,92,83,25,690,6,313,8,2939
"34031246103",5526,184,0,1,938,44,534,203,7430
"34031246104",2847,61,0,0,169,116,288,1,3482
"34031246201",5351,18,12,3,463,0,335,2,6184
"34031246202",4974,179,137,6,300,0,363,55,6014
"34031246203",3538,78,10,9,269,20,423,54,4401
"34031246300",3758,445,14,80,350,3,380,226,5256
"34031256801",4738,247,80,0,69,159,338,25,5656
"34031256802",3896,152,8,5,82,0,343,34,4520
"34031256803",4556,110,31,0,63,27,384,12,5183
"34031256804",6504,194,0,0,304,0,457,1,7460
"34031256805",4695,264,17,0,112,21,394,29,5532
"34031264101",4061,397,151,0,416,79,1596,263,6963
"34031264102",5693,214,68,3,967,0,1068,3,8016
"34031264200",410,689,1333,1166,396,315,711,1046,6066
"34033020100",1657,81,62,28,71,18,43,27,1987
"34033020200",650,44,839,148,245,27,553,27,2533
"34033020300",685,706,850,434,297,78,465,460,3975
"34033020400",1498,479,573,74,135,7,321,150,3237
"34033020500",1781,100,401,34,97,30,53,0,2496
"34033020600",1802,178,201,52,246,3,349,40,2871
"34033020700",3162,420,181,30,82,4,70,138,4087
"34033020800",2704,273,415,61,31,5,148,5,3642
"34033020900",3143,68,9,41,86,83,57,80,3567
"34033021000",1102,139,30,13,49,42,14,1,1390
"34033021101",4409,137,39,7,132,0,173,0,4897
"34033021102",3243,270,470,252,191,0,219,0,4645
"34033021201",2917,226,94,0,42,5,48,36,3368
"34033021202",2016,171,230,34,166,7,8,7,2639
"34033021300",1009,116,194,8,45,18,71,57,1518
"34033021400",2684,239,59,22,230,40,100,28,3402
"34033021500",1614,273,0,0,212,0,108,0,2207
"34033021600",5108,660,113,0,76,0,146,0,6103
"34033021700",1616,214,47,0,5,0,36,14,1932
"34033021900",622,112,673,265,20,83,20,47,1842
"34033022000",150,385,690,766,51,49,57,294,2442
"34033022100",476,70,247,229,46,105,52,89,1314
"34033022201",1452,79,25,54,101,4,33,1,1749
"34033022202",948,53,28,25,9,15,26,13,1117
"34033990000",0,0,0,0,0,0,0,0,0
"34035050100",2749,66,48,68,129,21,697,0,3778
"34035050200",1422,85,239,0,567,0,389,24,2726
"34035050300",3022,62,147,8,719,14,460,2,4434
"34035050400",1212,91,466,177,467,131,674,173,3391
"34035050500",2168,275,163,9,612,272,771,396,4666
"34035050600",2909,62,89,0,738,0,267,0,4065
"34035050701",2986,107,2,1,819,13,344,0,4272
"34035050703",2677,90,49,76,2231,55,609,2,5789
"34035050704",3518,317,117,0,2638,78,547,79,7294
"34035050801",3082,29,6,15,409,5,170,7,3723
"34035050802",3142,65,113,0,950,0,243,0,4513
"34035050901",4115,57,146,0,416,6,227,0,4967
"34035050902",2971,53,189,3,360,0,225,0,3801
"34035050903",4196,230,175,2,882,37,242,149,5913
"34035051000",3767,449,439,8,2111,71,1521,73,8439
"34035051100",2677,159,150,3,708,1,1944,121,5763
"34035051200",2587,326,439,45,961,308,2158,571,7395
"34035051300",1994,59,41,6,137,0,326,0,2563
"34035051400",3518,165,212,8,558,0,1145,0,5606
"34035051500",2330,548,7,83,245,0,447,141,3801
"34035051600",2453,117,0,35,130,1,426,1,3163
"34035051700",2234,79,485,95,1875,280,2831,340,8219
"34035051800",1548,16,574,96,2007,456,2430,427,7554
"34035051900",1961,80,579,91,596,187,786,186,4466
"34035052001",1706,193,1134,31,730,70,790,154,4808
"34035052002",1820,530,670,88,1440,285,1797,243,6873
"34035052100",4697,347,110,40,1805,0,326,149,7474
"34035052201",4092,198,79,8,1159,0,518,123,6177
"34035052203",3786,87,39,2,956,0,195,0,5065
"34035052204",4144,70,27,4,931,96,516,96,5884
"34035052300",4515,247,100,0,900,4,407,0,6173
"34035052400",4581,156,35,19,363,64,265,14,5497
"34035052601",6796,89,25,63,2457,166,472,14,10082
"34035052603",3563,183,71,0,424,0,182,0,4423
"34035052700",6851,194,22,0,697,2,835,96,8697
"34035052800",2246,41,49,31,12,53,242,49,2723
"34035052901",891,65,45,0,100,0,83,18,1202
"34035052903",5126,177,114,1,636,30,359,25,6468
"34035052904",1883,46,0,2,131,0,130,3,2195
"34035053000",3059,357,361,5,787,16,1222,241,6048
"34035053102",1369,54,1420,59,1350,26,273,0,4551
"34035053103",2516,63,1708,67,756,144,659,139,6052
"34035053105",3573,275,1432,1,2349,18,507,0,8155
"34035053200",2340,239,3122,253,746,85,1319,189,8293
"34035053300",1539,119,1408,402,704,1,1237,105,5515
"34035053402",3006,35,924,0,3131,66,441,0,7603
"34035053403",1842,17,1149,93,1667,100,307,0,5175
"34035053404",3302,418,2901,262,4042,154,1176,210,12465
"34035053501",2413,109,258,5,405,0,79,0,3269
"34035053602",4906,84,313,203,812,0,245,0,6563
"34035053603",3955,82,156,5,373,41,278,27,4917
"34035053604",2946,43,94,0,534,0,193,10,3820
"34035053703",2920,177,37,1,545,1,131,13,3825
"34035053704",2708,15,51,4,422,0,321,0,3521
"34035053705",4523,632,635,2,1162,31,939,80,8004
"34035053706",3450,190,288,0,1134,12,388,117,5579
"34035053707",2978,20,20,50,572,0,119,0,3759
"34035053801",406,8,0,4,42,0,4,4,468
"34035053803",6710,27,454,8,1061,0,223,0,8483
"34035053804",3148,74,296,15,814,64,523,20,4954
"34035053805",2782,73,226,0,556,27,306,0,3970
"34035053901",508,27,7,0,12,0,21,0,575
"34035053904",2639,11,0,0,784,0,126,0,3560
"34035053905",3561,21,342,0,2967,63,273,0,7227
"34035054100",5707,71,115,53,945,111,321,11,7334
"34035054201",4810,354,69,0,2056,82,153,226,7750
"34035054202",3344,176,10,11,1061,0,261,48,4911
"34035054300",5648,253,764,54,2281,40,488,6,9534
"34037371000",3135,375,52,3,214,22,215,19,4035
"34037371100",3591,91,73,10,207,0,102,0,4074
"34037371200",1547,317,9,11,173,7,162,11,2237
"34037371300",3667,145,52,0,201,9,218,68,4360
"34037371400",2622,49,53,0,132,0,321,8,3185
"34037371502",4560,294,66,4,146,4,444,5,5523
"34037371503",2551,44,45,13,11,0,53,0,2717
"34037371600",2528,400,36,9,90,32,429,158,3682
"34037371700",4768,248,144,7,192,20,470,22,5871
"34037371800",6488,424,66,6,271,17,419,5,7696
"34037371900",1682,131,59,5,102,10,76,0,2065
"34037372000",3040,96,0,1,95,0,255,0,3487
"34037372100",1711,106,0,1,54,2,108,7,1989
"34037372200",1996,92,0,0,7,74,190,74,2433
"34037372300",3745,139,14,32,88,19,47,0,4084
"34037372400",2220,111,0,10,74,0,170,0,2585
"34037372500",2766,218,47,0,82,0,115,15,3243
"34037372600",4806,84,44,4,71,0,30,3,5042
"34037372700",2864,100,102,1,158,0,231,59,3515
"34037372800",1355,142,45,2,49,5,96,16,1710
"34037372900",2974,232,11,59,103,0,323,37,3739
"34037373000",2192,93,4,0,59,0,106,0,2454
"34037373100",5495,91,254,16,278,46,518,0,6698
"34037373200",3366,55,41,0,290,11,187,0,3950
"34037373300",2574,89,45,13,150,5,91,2,2969
"34037373400",6156,236,54,2,223,0,179,17,6867
"34037373500",3173,112,25,1,139,2,149,10,3611
"34037373600",2443,51,70,0,144,0,208,20,2936
"34037373700",2327,439,208,345,266,46,474,94,4199
"34037373800",3149,341,107,32,169,21,377,107,4303
"34037373900",3632,213,0,0,130,10,52,10,4047
"34037374000",3034,148,0,31,124,0,55,2,3394
"34037374100",3328,92,0,1,131,0,253,0,3805
"34037374200",2353,42,0,0,141,0,61,0,2597
"34037374300",3132,120,23,0,59,0,96,0,3430
"34037374400",2253,26,0,0,63,0,87,0,2429
"34037374500",1770,63,0,0,111,6,53,0,2003
"34037374600",2876,279,26,21,295,41,148,103,3789
"34037374700",3724,91,95,13,148,19,272,34,4396
"34037374800",3712,234,44,4,324,0,377,0,4695
"34037374900",3721,341,92,0,151,258,510,309,5382
"34039030200",792,201,570,85,1028,324,1627,487,5114
"34039030400",1519,425,1068,637,1151,940,2393,1281,9414
"34039030500",2074,250,488,214,1714,721,3227,977,9665
"34039030600",1243,443,569,444,573,220,1267,586,5345
"34039030701",1041,328,0,0,482,103,691,379,3024
"34039030702",3685,651,716,143,3231,375,5211,869,14881
"34039030802",1660,80,307,166,563,190,1710,239,4915
"34039030900",3026,468,252,0,2202,419,4365,784,11516
"34039031000",1024,225,353,151,1580,699,2533,900,7465
"34039031100",1995,339,358,202,1572,430,3036,731,8663
"34039031200",1301,402,1666,344,1325,440,2307,734,8519
"34039031300",2451,220,1541,439,1690,564,3530,615,11050
"34039031400",1234,521,1909,371,930,173,2006,623,7767
"34039031500",3073,218,603,9,1232,248,2643,400,8426
"34039031601",1416,171,978,59,844,123,2086,219,5896
"34039031602",2640,658,1020,6,1242,427,3061,892,9946
"34039031700",1388,584,1779,713,1004,302,1580,600,7950
"34039031801",3163,414,577,50,493,587,2806,758,8848
"34039031802",1095,186,659,81,514,117,1236,297,4185
"34039031903",2481,993,514,108,1199,316,2703,1178,9492
"34039031904",855,571,669,285,995,144,1733,615,5867
"34039032001",3633,930,157,81,1504,359,4027,695,11386
"34039032002",2587,139,447,195,735,110,2449,146,6808
"34039032100",5291,203,389,0,789,0,2908,37,9617
"34039032200",300,0,4810,815,162,50,274,20,6431
"34039032300",314,14,1461,239,218,0,254,6,2506
"34039032400",2024,226,2855,778,1406,251,1351,262,9153
"34039032500",2960,233,1433,348,593,36,1190,33,6826
"34039032600",1261,156,2572,167,494,167,407,24,5248
"34039032700",2502,405,2723,90,1452,186,1086,133,8577
"34039032800",805,43,3247,800,188,30,388,158,5659
"34039032901",2134,115,751,0,896,254,700,241,5091
"34039032902",4077,162,336,220,790,97,959,59,6700
"34039033000",2460,127,450,33,910,19,841,19,4859
"34039033100",2582,117,1780,2,1234,56,752,43,6566
"34039033200",2324,62,1146,107,1095,140,878,138,5890
"34039033300",2291,117,420,49,981,53,752,0,4663
"34039033400",2526,23,295,0,500,168,658,172,4342
"34039033500",4336,207,903,8,866,206,1452,21,7999
"34039033600",6506,418,342,1,768,10,956,55,9056
"34039033700",3254,179,327,150,1215,58,1255,143,6581
"34039033800",3467,164,84,0,1506,0,1379,0,6600
"34039033900",1713,90,482,11,570,173,972,173,4184
"34039034000",1493,121,2190,292,1167,968,1509,1032,8772
"34039034100",936,91,1725,120,296,378,1007,407,4960
"34039034200",822,158,1683,194,548,305,772,348,4830
"34039034300",1050,61,2207,174,642,48,694,0,4876
"34039034400",433,79,2261,345,376,82,377,82,4035
"34039034500",2294,296,1174,181,496,53,1470,276,6240
"34039034600",291,40,2601,548,578,114,722,30,4924
"34039034700",1560,134,1367,304,506,20,741,130,4762
"34039034800",3516,97,324,20,509,39,843,27,5375
"34039034900",4364,406,895,0,742,159,1543,389,8498
"34039035000",1852,69,250,0,571,0,800,17,3559
"34039035100",1523,173,1459,260,451,37,708,198,4809
"34039035200",1329,153,304,8,865,96,1452,122,4329
"34039035300",2676,378,1381,171,289,180,999,230,6304
"34039035400",1833,111,235,13,371,77,681,47,3368
"34039035500",3625,523,1392,17,1307,339,1730,282,9215
"34039035600",2534,211,574,45,385,27,682,9,4467
"34039035700",2592,249,644,97,1451,39,1713,23,6808
"34039035800",1209,8,1693,262,255,43,677,43,4190
"34039035900",1397,122,1001,193,456,21,589,54,3833
"34039036000",957,120,2514,342,1140,0,1309,64,6446
"34039036100",1299,83,41,0,37,5,93,0,1558
"34039036200",6008,105,1,0,132,0,500,0,6746
"34039036301",4230,143,35,11,268,54,480,0,5221
"34039036302",3564,186,51,0,96,0,532,9,4438
"34039036400",6748,71,101,0,531,0,526,0,7977
"34039036500",4743,88,70,2,735,0,525,11,6174
"34039036600",2898,104,558,92,503,6,465,44,4670
"34039036700",5199,95,78,0,334,13,227,0,5946
"34039036800",6449,41,39,137,765,12,355,1,7799
"34039036900",3921,109,33,1,259,0,753,18,5094
"34039037000",5865,156,150,0,58,0,482,24,6735
"34039037100",4251,32,0,0,97,0,154,0,4534
"34039037200",2680,122,307,9,262,62,219,93,3754
"34039037300",3895,70,229,0,383,0,193,0,4770
"34039037400",3863,57,89,3,282,1,365,7,4667
"34039037500",4652,82,101,109,656,0,647,112,6359
"34039037601",4116,148,177,0,304,43,251,8,5047
"34039037602",4591,365,697,48,559,71,328,1,6660
"34039037700",4106,120,52,78,478,33,504,2,5373
"34039037800",4290,171,199,0,1003,62,450,57,6232
"34039037900",4921,85,224,0,614,83,45,48,6020
"34039038000",3483,288,235,103,1076,60,1525,137,6907
"34039038101",3491,118,12,12,461,86,171,10,4361
"34039038102",6621,198,100,0,1087,24,376,0,8406
"34039038201",5044,212,7,18,779,0,268,109,6437
"34039038202",6002,126,0,4,659,39,539,2,7371
"34039038300",5508,312,236,1,501,0,324,0,6882
"34039038400",3817,98,1408,15,796,0,411,29,6574
"34039038500",4736,59,572,5,434,0,440,0,6246
"34039038601",6232,87,672,26,920,0,555,11,8503
"34039038602",3143,0,281,0,401,0,141,0,3966
"34039038700",5990,46,406,0,981,0,631,22,8076
"34039038800",392,76,2519,344,790,227,881,182,5411
"34039038900",588,168,1722,930,1852,848,1879,745,8732
"34039039000",397,109,1218,145,1217,672,1171,553,5482
"34039039100",1366,99,1168,55,448,11,341,14,3502
"34039039200",538,82,1846,358,1348,770,1283,465,6690
"34039039300",513,346,771,557,2963,1762,3144,1480,11536
"34039039400",647,66,1394,370,1785,685,1478,592,7017
"34039039500",446,112,2308,372,2508,1075,2282,831,9934
"34039039600",637,151,2085,236,578,304,699,439,5129
"34039039700",753,48,2756,112,661,373,756,285,5744
"34039039800",1621,267,615,322,946,385,1984,540,6680
"34039039900",433,75,211,79,114,52,386,100,1450
"34041030600",2788,406,384,36,217,112,310,96,4349
"34041030700",3232,704,162,148,234,65,576,107,5228
"34041030800",2609,384,22,83,147,14,200,8,3467
"34041030900",1471,257,364,202,351,166,247,147,3205
"34041031101",5469,168,4,15,185,0,396,17,6254
"34041031102",3555,144,38,6,150,5,201,5,4104
"34041031200",6803,416,43,6,439,10,294,40,8051
"34041031301",4992,248,1,5,292,1,102,0,5641
"34041031302",4072,152,12,0,234,0,240,0,4710
"34041031401",3415,131,106,1,602,14,690,42,5001
"34041031402",3582,675,28,27,228,85,507,538,5670
"34041031500",5824,467,247,0,844,54,753,89,8278
"34041031601",4329,198,41,6,47,14,192,10,4837
"34041031602",2303,51,61,23,0,0,120,12,2570
"34041031700",2285,229,23,9,97,4,83,1,2731
"34041031800",2474,88,20,0,31,0,16,0,2629
"34041031900",5476,183,735,10,135,0,255,64,6858
"34041032000",4794,834,207,32,361,211,528,346,7313
"34041032101",2917,77,0,1,147,0,90,1,3233
"34041032102",4764,98,309,5,426,18,148,13,5781
"34041032200",6272,348,338,162,592,43,435,37,8227
"34041032300",2801,287,61,0,121,8,95,5,3378
"34041032400",1984,169,103,28,18,0,78,22,2402
"35001000107",2118,128,0,61,237,7,530,54,3135
"35001000108",2086,318,41,0,281,81,617,120,3544
"35001000109",1758,44,116,0,624,110,817,20,3489
"35001000110",2631,560,37,18,370,343,844,521,5324
"35001000111",2077,353,21,0,412,28,696,63,3650
"35001000112",1494,113,38,14,312,19,309,44,2343
"35001000113",2080,132,322,19,503,236,657,78,4027
"35001000114",2462,152,17,104,469,42,1176,167,4589
"35001000115",1770,524,186,133,489,120,644,152,4018
"35001000116",2348,390,44,0,315,8,635,320,4060
"35001000117",1809,147,64,0,227,56,425,121,2849
"35001000118",2015,247,0,8,278,113,547,65,3273
"35001000119",1599,109,50,0,134,9,540,56,2497
"35001000120",1809,187,100,109,383,118,776,145,3627
"35001000121",3508,1010,282,0,704,328,1494,861,8187
"35001000122",3137,340,140,12,314,173,1293,114,5523
"35001000123",3013,387,35,59,750,482,1281,693,6700
"35001000124",1977,475,55,262,293,251,644,537,4494
"35001000125",3474,76,37,0,491,10,998,26,5112
"35001000126",1911,421,78,24,294,0,655,125,3508
"35001000127",2017,343,66,0,416,20,961,205,4028
"35001000128",2163,355,100,57,266,55,1085,107,4188
"35001000129",2398,657,245,117,651,426,1028,459,5981
"35001000203",1209,136,41,220,248,98,416,166,2534
"35001000204",1642,318,102,25,646,231,910,158,4032
"35001000205",1900,332,123,54,399,89,1356,186,4439
"35001000206",2072,264,118,39,346,168,844,240,4091
"35001000207",2103,224,71,97,513,101,1193,212,4514
"35001000208",1709,289,42,0,438,123,1171,226,3998
"35001000300",3553,585,66,18,877,183,1021,248,6551
"35001000401",3046,353,96,24,904,151,1236,184,5994
"35001000402",2522,212,75,15,380,80,651,175,4110
"35001000501",1285,474,28,24,907,455,1000,190,4363
"35001000502",2778,901,115,61,637,166,586,269,5513
"35001000601",2185,253,230,0,876,74,914,77,4609
"35001000603",1851,1452,101,45,1014,866,2134,1839,9302
"35001000604",1366,882,55,27,857,986,1217,1421,6811
"35001000704",2420,560,39,39,648,8,1115,249,5078
"35001000707",2452,1525,369,126,1533,322,2623,1517,10467
"35001000708",3262,879,91,95,1157,277,1956,584,8301
"35001000710",4949,195,131,0,1016,70,1734,90,8185
"35001000711",3312,443,29,0,573,203,802,276,5638
"35001000712",1778,941,284,23,620,524,907,695,5772
"35001000713",2480,1229,497,169,1842,523,2041,858,9639
"35001000714",3071,595,155,23,992,176,1700,438,7150
"35001000801",2283,343,170,9,428,172,536,130,4071
"35001000901",1980,1625,114,40,1667,1597,2753,2488,12264
"35001000903",2102,1590,243,133,738,894,1186,1267,8153
"35001000904",2344,448,102,29,891,514,1385,626,6339
"35001001101",3065,386,52,0,938,107,717,157,5422
"35001001102",1575,567,99,71,330,426,576,684,4328
"35001001200",2821,1671,374,126,1246,1020,2071,1630,10959
"35001001300",1421,375,32,6,1423,1125,2697,1427,8506
"35001001400",957,493,5,17,417,743,1112,1073,4817
"35001001500",971,705,67,32,509,280,800,666,4030
"35001001600",1262,462,39,21,372,324,258,179,2917
"35001001700",2728,843,0,34,797,324,802,288,5816
"35001001800",242,158,0,0,81,88,116,101,786
"35001001900",696,262,26,0,142,0,258,53,1437
"35001002000",607,736,60,21,405,348,716,582,3475
"35001002100",436,180,33,0,192,178,154,222,1395
"35001002200",1992,422,30,0,590,242,1016,432,4724
"35001002300",3587,890,0,49,2224,1401,5092,2183,15426
"35001002401",2515,484,155,42,1702,229,3530,671,9328
"35001002402",3275,648,139,225,1804,1050,4618,1528,13287
"35001002500",1253,656,6,27,270,334,867,904,4317
"35001002600",609,208,0,0,147,83,330,183,1560
"35001002700",2118,448,53,0,630,312,1443,414,5418
"35001002900",1868,594,20,25,853,514,1557,863,6294
"35001003001",2711,390,106,58,766,662,1921,951,7565
"35001003002",2614,359,94,13,776,172,1914,344,6286
"35001003100",2116,204,36,12,442,11,995,130,3946
"35001003201",1849,404,50,0,444,79,1370,313,4509
"35001003202",3097,397,58,0,1974,933,3723,1174,11356
"35001003400",1206,1331,149,69,1060,576,1400,1408,7199
"35001003501",3440,644,54,0,905,660,2391,901,8995
"35001003502",4130,374,0,0,838,134,1698,122,7296
"35001003600",3934,1018,22,0,1242,56,2732,764,9768
"35001003707",2818,618,30,0,684,98,1248,283,5779
"35001003712",4110,270,267,0,528,99,1361,218,6853
"35001003714",4021,1508,301,75,1460,595,2523,1119,11602
"35001003715",3557,74,0,19,440,17,910,38,5055
"35001003717",3383,451,25,0,1232,91,1244,129,6555
"35001003718",2007,170,37,53,294,82,736,30,3409
"35001003719",4114,491,57,147,1155,98,1751,144,7957
"35001003721",5172,90,69,0,844,16,690,0,6881
"35001003722",5240,243,111,20,1165,0,2479,18,9276
"35001003723",3916,870,493,26,606,108,1344,414,7777
"35001003724",2609,106,226,0,384,11,893,9,4238
"35001003725",3205,463,65,12,340,124,983,281,5473
"35001003726",1879,18,8,0,433,52,418,52,2860
"35001003728",2928,309,102,0,678,214,1293,44,5568
"35001003729",1654,47,0,2,167,2,117,10,1999
"35001003730",3919,145,14,0,620,9,826,63,5596
"35001003731",3148,111,0,0,343,70,706,121,4499
"35001003732",5985,483,43,0,967,72,1117,242,8909
"35001003733",1245,861,143,44,658,462,1052,883,5348
"35001003735",3925,894,111,0,1588,131,2891,465,10005
"35001003736",1187,303,47,21,312,151,805,162,2988
"35001003737",2369,102,0,0,192,69,326,19,3077
"35001003738",4170,382,6,0,617,163,963,316,6617
"35001003803",2686,127,7,0,120,0,379,0,3319
"35001003804",4829,191,40,0,795,2,1148,32,7037
"35001003805",1660,447,0,0,109,19,660,324,3219
"35001003806",2808,193,12,0,416,32,821,18,4300
"35001003807",3317,596,18,0,238,80,1083,438,5770
"35001004001",2328,1123,41,85,932,301,2593,1199,8602
"35001004300",2211,1145,12,14,1341,556,2653,1530,9462
"35001004401",1590,419,0,0,661,411,2006,764,5851
"35001004402",2337,919,11,35,956,172,2516,904,7850
"35001004501",1775,652,27,0,816,464,2202,1059,6995
"35001004502",1153,482,31,26,1456,722,2266,1086,7222
"35001004602",2762,274,17,0,899,349,2663,521,7485
"35001004603",2075,392,29,13,1039,240,2455,549,6792
"35001004604",2760,1074,22,40,1201,603,3099,1426,10225
"35001004712",4284,561,140,0,1662,342,4716,780,12485
"35001004713",3984,806,43,0,1699,245,4760,998,12535
"35001004715",2587,596,135,0,827,1192,2862,1374,9573
"35001004716",1563,99,11,56,397,143,799,71,3139
"35001004717",6497,520,212,52,1276,241,3493,411,12702
"35001004720",2692,218,36,0,308,427,837,429,4947
"35001004722",3120,317,23,49,855,131,1589,75,6159
"35001004723",5503,265,71,0,989,1,2915,123,9867
"35001004724",2602,57,17,0,278,23,1258,31,4266
"35001004725",2497,187,0,0,1010,0,1886,143,5723
"35001004726",1800,136,0,0,362,142,905,176,3521
"35001004727",1422,61,5,4,333,46,863,50,2784
"35001004728",3251,214,236,88,1174,4,2182,49,7198
"35001004729",2646,214,28,63,645,61,1829,193,5679
"35001004733",3585,1080,210,20,1798,1082,4590,2034,14399
"35001004734",3625,612,72,0,1969,988,4688,1468,13422
"35001004735",639,428,68,46,527,292,1040,705,3745
"35001004736",497,380,15,0,629,209,913,580,3223
"35001004737",2982,543,198,9,1652,447,3661,934,10426
"35001004738",2732,637,422,27,1510,501,3288,1089,10206
"35001004739",3007,1158,172,0,1767,707,4068,1647,12526
"35001004740",2761,835,373,61,1969,859,4225,1424,12507
"35001004741",3439,883,109,205,1913,790,4295,1352,12986
"35001004742",4079,859,117,0,1649,488,3150,676,11018
"35001004743",2692,145,57,0,557,17,1597,148,5213
"35001004744",3681,63,194,0,1733,0,3231,54,8956
"35001004745",4989,112,258,0,1373,33,2907,50,9722
"35001004746",5558,491,149,14,1687,127,3533,499,12058
"35001004747",3431,668,75,252,737,26,1677,227,7093
"35001004748",7852,484,215,0,813,248,3343,336,13291
"35001004749",1723,816,55,11,1285,781,1758,1351,7780
"35001004750",3991,501,218,165,1122,313,3239,549,10098
"35001004751",1994,193,7,0,372,76,775,35,3452
"35001004752",2317,214,74,35,533,669,1055,666,5563
"35001004753",2861,113,41,0,868,36,1813,115,5847
"35001940500",2659,114,0,0,215,28,220,26,3262
"35001940600",3946,664,109,32,1883,604,2578,508,10324
"35001940700",115,7,0,0,2031,623,273,91,3140
"35003976400",2635,752,0,22,95,126,462,261,4353
"35005000201",2679,380,53,10,700,95,1870,295,6082
"35005000202",2042,540,154,40,763,190,1525,484,5738
"35005000300",3552,709,0,17,775,545,2049,800,8447
"35005000400",2082,1038,28,20,840,244,1835,987,7074
"35005000500",718,543,13,28,226,302,626,694,3150
"35005000600",2675,1173,24,0,678,372,2655,1315,8892
"35005000700",2781,542,203,0,765,205,2043,497,7036
"35005000800",3097,1457,253,68,764,249,1797,1287,8972
"35005000900",2598,93,0,0,298,152,1337,236,4714
"35005001001",3717,185,0,0,811,69,1289,21,6092
"35005001002",2931,1001,0,0,262,95,561,698,5548
"35005001101",3287,1631,23,37,768,258,2965,1316,10285
"35005001102",3288,421,0,0,199,66,475,182,4631
"35005001200",1036,114,6,0,89,74,463,115,1897
"35005001300",2017,367,0,1,361,150,1710,418,5024
"35005001400",2089,297,0,0,365,228,1452,443,4874
"35006941500",32,29,0,0,2189,945,0,25,3220
"35006945800",118,12,14,0,1023,707,69,42,1985
"35006946100",54,31,0,0,2536,1319,119,33,4092
"35006974201",1450,761,36,23,883,866,1411,882,6312
"35006974202",1738,140,57,0,1071,452,1479,221,5158
"35006974400",1714,642,22,0,805,523,1540,711,5957
"35006974700",3433,717,45,0,846,218,2105,263,7627
"35007950500",2751,519,0,27,288,310,1637,575,6107
"35007950600",2441,344,0,0,582,90,1727,173,5357
"35007950700",3685,1017,8,7,602,106,1400,598,7423
"35009000100",1241,1062,317,288,1132,581,1924,1277,7822
"35009000201",2505,366,287,33,804,285,1079,395,5754
"35009000202",1762,630,199,48,824,637,1372,944,6416
"35009000301",3430,598,370,174,867,388,1836,668,8331
"35009000303",2796,208,179,26,305,106,407,167,4194
"35009000304",5622,433,252,0,787,65,1109,0,8268
"35009000400",2204,929,139,180,759,248,1915,896,7270
"35009000500",1061,560,109,9,624,164,1023,564,4114
"35009000601",949,224,3,0,10,11,20,40,1257
"35009000602",4027,136,129,8,402,4,926,15,5647
"35009000603",2375,715,128,83,818,212,1696,600,6627
"35009000900",1322,230,181,0,279,71,281,93,2457
"35011960100",1305,240,0,0,216,179,555,192,2687
"35013000102",2886,713,15,71,279,44,2105,585,6698
"35013000103",2821,1924,43,0,270,144,1934,1737,8873
"35013000104",3797,767,112,0,360,33,1784,506,7359
"35013000201",3013,1416,47,139,264,88,2175,1383,8525
"35013000202",4352,1220,97,0,276,56,2861,1107,9969
"35013000300",2715,871,41,9,313,104,1793,616,6462
"35013000401",1817,798,0,0,247,80,1667,687,5296
"35013000402",3691,1289,68,35,549,118,3221,1085,10056
"35013000500",1326,655,38,7,382,56,1167,316,3947
"35013000600",1176,946,10,0,266,69,1044,842,4353
"35013000700",3766,1347,42,0,231,217,2783,1137,9523
"35013000800",1842,1154,10,170,158,125,1093,755,5307
"35013000900",2730,3355,27,113,435,327,1397,2312,10696
"35013001000",217,739,22,33,195,376,99,525,2206
"35013001102",2202,732,29,0,148,22,1253,478,4864
"35013001103",3702,467,11,0,288,40,2291,445,7244
"35013001104",3019,2133,0,42,195,191,2251,2011,9842
"35013001201",11410,1166,440,0,1345,783,4749,1341,21234
"35013001203",2880,858,73,75,705,197,1606,645,7039
"35013001204",3244,402,24,0,90,0,687,360,4807
"35013001205",3301,441,7,18,692,71,1300,211,6041
"35013001303",5597,1464,46,0,569,93,2894,1329,11992
"35013001304",4937,881,29,23,988,254,3888,1004,12004
"35013001305",3485,1184,58,37,275,54,2663,765,8521
"35013001306",8378,848,58,156,595,14,4685,302,15036
"35013001307",5036,1556,83,0,190,262,3708,1521,12356
"35013001400",2728,1797,0,0,79,174,2038,1887,8703
"35013001500",3617,782,178,0,632,25,1683,514,7431
"35013001600",1953,891,0,0,471,57,1808,886,6066
"35013001701",4703,1492,114,0,363,261,3683,1714,12330
"35013001702",1330,455,0,0,26,4,1044,410,3269
"35013001703",2235,579,26,0,195,144,1783,685,5647
"35013001705",1735,1399,0,0,150,30,1816,1429,6559
"35013001706",2205,1167,0,0,184,21,2362,1188,7127
"35013001707",3059,2319,0,0,87,230,3104,2549,11348
"35013001801",3391,2319,20,0,118,28,2818,2179,10873
"35013001802",3995,2826,0,21,124,56,3797,2903,13722
"35013001804",4573,1862,5,26,165,93,3410,1691,11825
"35013001805",1776,1094,0,0,198,122,1926,1216,6332
"35013001806",2626,3051,0,0,403,322,2978,3302,12682
"35013001900",885,92,363,0,77,26,181,0,1624
"35015000100",1046,277,37,0,62,44,389,93,1948
"35015000200",4318,248,147,0,232,78,810,39,5872
"35015000300",4217,780,0,0,278,181,1747,295,7498
"35015000401",2925,339,20,0,466,3,966,264,4983
"35015000402",3072,765,54,0,348,29,1929,489,6686
"35015000500",2367,332,169,0,253,111,1560,422,5214
"35015000600",3811,508,212,28,432,16,2312,294,7613
"35015000700",4905,402,0,0,487,163,1922,352,8231
"35015000800",1885,283,0,0,85,82,1304,255,3894
"35015000900",3475,710,45,0,602,0,1938,494,7264
"35015001000",4577,724,0,31,535,346,3391,711,10315
"35015001100",5346,471,0,0,708,93,2132,395,9145
"35017964100",1800,230,0,0,218,41,342,5,2636
"35017964200",1766,185,0,0,47,77,270,106,2451
"35017964300",4683,1039,0,25,619,26,2654,619,9665
"35017964400",2318,938,10,0,603,349,1933,1019,7170
"35017964500",1458,429,0,3,267,242,1153,523,4075
"35017964600",1942,599,21,8,550,213,1907,720,5960
"35017964700",4840,920,0,0,370,35,1591,465,8221
"35017964800",1433,253,0,0,140,9,691,75,2601
"35019961600",3119,427,3,15,236,166,2660,518,7144
"35021000100",518,111,0,0,22,4,183,59,897
"35023970000",1356,474,0,0,193,27,473,196,2719
"35023970200",1852,412,0,0,170,144,1506,490,4574
"35025000100",2001,382,18,0,337,125,1427,385,4675
"35025000200",2435,571,13,22,269,112,1943,475,5840
"35025000300",2552,969,144,168,84,135,2332,1049,7433
"35025000400",2015,538,165,224,242,285,1572,628,5669
"35025000502",4732,767,159,356,354,14,2346,433,9161
"35025000503",2882,435,93,15,135,31,1088,243,4922
"35025000504",2685,334,250,7,261,0,648,43,4228
"35025000600",5267,927,89,0,454,0,2660,840,10237
"35025000701",1376,229,0,0,12,0,333,201,2151
"35025000702",1867,207,0,0,54,2,1016,174,3320
"35025000703",2168,44,132,23,226,2,793,44,3432
"35025000704",2503,57,0,0,249,2,909,35,3755
"35025000800",2692,407,0,0,158,34,1285,259,4835
"35025000900",1861,164,12,0,117,36,963,117,3270
"35025001003",2852,697,0,0,274,154,2057,575,6609
"35025001004",2754,639,45,0,296,75,2312,588,6709
"35025001005",2011,1099,143,0,447,0,1801,965,6466
"35025001100",3861,272,0,0,300,40,1815,86,6374
"35027960200",1003,270,0,0,92,60,251,187,1863
"35027960300",1833,326,40,9,179,23,444,88,2942
"35027960400",5238,992,0,0,727,339,2096,966,10358
"35027960600",5022,527,38,10,763,184,1127,253,7924
"35027960800",1515,410,0,0,302,93,471,266,3057
"35028000100",3175,216,0,0,331,28,482,114,4346
"35028000200",4162,64,10,0,518,222,719,84,5779
"35028000400",2452,208,36,0,466,3,407,153,3725
"35028000500",5146,245,42,0,527,0,774,34,6768
"35029000100",3218,1097,44,0,307,358,1900,1066,7990
"35029000200",2545,1354,8,0,330,128,1976,1181,7522
"35029000300",1768,559,25,8,276,112,1225,555,4528
"35029000400",4047,1148,0,0,148,27,1958,978,8306
"35029000500",2789,1545,52,0,250,82,1653,1189,7560
"35029000600",1293,712,0,128,75,165,1143,702,4218
"35031940300",9,39,0,0,6052,3450,224,52,9826
"35031940500",90,40,6,0,507,826,3,9,1481
"35031943500",124,2,43,18,2018,1306,29,2,3542
"35031943600",118,41,0,3,2631,2572,21,77,5463
"35031943700",39,15,0,0,2082,1691,18,0,3845
"35031943800",118,6,12,4,3382,2918,70,29,6539
"35031943901",513,55,54,0,2815,1759,282,36,5514
"35031943902",70,3,0,0,2039,1238,184,79,3613
"35031944000",31,4,0,0,1092,1015,9,19,2170
"35031945200",1565,260,168,0,1573,1852,1394,309,7121
"35031945300",1091,388,11,0,957,926,1549,525,5447
"35031945400",985,221,0,18,1334,189,774,272,3793
"35031945500",3388,439,73,0,2164,174,1711,363,8312
"35031945600",1022,184,2,0,2886,1527,1050,235,6906
"35031945700",145,3,0,0,1235,1034,83,51,2551
"35031946000",418,28,0,0,2450,2088,354,52,5390
"35031973100",342,52,0,0,279,114,25,2,814
"35033955200",2425,715,3,1,1260,318,3078,903,8703
"35035000100",647,424,68,42,175,322,469,461,2608
"35035000200",817,234,88,16,179,266,411,338,2349
"35035000303",1168,532,62,0,240,54,530,223,2809
"35035000304",2508,276,300,0,305,68,653,239,4349
"35035000305",1761,454,510,29,911,84,1007,328,5084
"35035000306",2532,35,114,0,337,6,734,8,3766
"35035000401",3964,315,117,59,320,192,1115,293,6375
"35035000402",5943,458,184,8,828,235,1434,263,9353
"35035000500",3162,1367,18,206,344,476,1125,1211,7909
"35035000601",2141,340,358,0,365,11,407,47,3669
"35035000602",1949,471,0,0,247,53,359,31,3110
"35035000603",2175,253,0,0,183,0,344,75,3030
"35035000700",4250,528,20,0,732,187,1896,321,7934
"35035000901",2263,253,0,0,187,80,193,26,3002
"35035000902",3675,3201,0,118,632,506,3391,3406,14929
"35035940000",89,145,0,1,2034,1456,180,248,4153
"35037958601",2368,411,34,0,94,90,906,263,4166
"35037958602",1724,825,0,10,176,59,1148,756,4698
"35037958900",2487,343,0,0,113,25,670,70,3708
"35039000100",1953,472,0,0,630,148,2277,389,5869
"35039000200",2123,928,0,19,147,120,1760,832,5929
"35039000300",4652,1130,14,0,711,88,4940,1123,12658
"35039000400",3121,730,1,18,351,262,2512,959,7954
"35039000500",2637,457,11,0,243,71,1913,293,5625
"35039940700",1198,432,57,0,1225,610,2030,970,6522
"35039940800",1733,199,10,6,2175,692,2506,458,7779
"35039941000",247,78,14,1,2182,748,292,12,3574
"35039944100",3309,1037,9,0,2105,727,3976,1221,12384
"35041000100",2591,1097,32,131,524,372,766,770,6283
"35041000200",1250,667,0,132,992,641,1612,985,6279
"35041000300",2362,633,26,81,395,84,684,196,4461
"35041000401",2143,570,0,0,470,108,850,535,4676
"35041000402",2148,580,12,0,688,153,795,350,4726
"35043010503",1103,626,0,0,1271,177,1717,598,5492
"35043010601",3502,360,1,0,454,164,1192,239,5912
"35043010602",3265,144,24,0,467,45,1081,76,5102
"35043010702",5365,362,137,0,781,0,1953,195,8793
"35043010703",6533,744,205,0,1223,277,3240,364,12586
"35043010705",4443,631,0,37,673,140,2165,277,8366
"35043010712",3478,942,159,17,635,310,1760,782,8083
"35043010713",3228,797,29,17,746,73,1681,514,7085
"35043010714",3895,429,211,11,409,119,1502,205,6781
"35043010715",2823,338,120,25,307,9,1018,121,4761
"35043010716",4419,681,189,38,311,54,1168,389,7249
"35043010717",7371,153,108,0,1713,210,3552,46,13153
"35043010718",3378,596,64,9,794,24,1678,374,6917
"35043010719",2928,384,201,6,339,42,1533,162,5595
"35043010720",6209,189,426,0,1240,90,2988,137,11279
"35043010721",2796,515,277,8,501,216,1001,233,5547
"35043010722",3332,497,131,0,1030,328,1826,591,7735
"35043010723",7049,968,955,0,1188,199,4155,653,15167
"35043010900",796,332,16,0,599,217,901,257,3118
"35043011000",691,202,18,0,790,155,455,152,2463
"35043011100",4888,434,38,0,1211,380,935,158,8044
"35043011200",1328,114,0,0,969,265,419,38,3133
"35043940200",170,33,0,0,2157,1175,154,41,3730
"35043940300",0,0,0,0,0,0,0,0,0
"35043940500",1578,442,22,5,1511,765,2484,1001,7808
"35043940600",16,2,3,4,1367,514,4,0,1910
"35043940700",509,103,0,0,2436,1206,429,93,4776
"35043940900",37,5,0,0,996,1348,37,17,2440
"35045000100",1601,846,0,0,1835,592,1155,662,6691
"35045000201",3699,92,14,31,479,173,611,212,5311
"35045000202",3994,135,83,0,722,37,743,45,5759
"35045000204",1602,309,10,0,427,65,488,265,3166
"35045000205",2787,1245,0,0,1475,1187,1549,698,8941
"35045000301",2659,102,195,0,1467,403,511,82,5419
"35045000302",2723,131,0,0,236,134,429,70,3723
"35045000401",3257,776,49,0,757,563,705,510,6617
"35045000402",1000,247,28,19,1060,443,373,134,3304
"35045000503",856,367,31,10,1932,311,650,354,4511
"35045000504",929,196,0,0,633,76,140,65,2039
"35045000505",2358,56,70,0,2824,696,690,0,6694
"35045000607",1649,276,0,0,1090,202,878,76,4171
"35045000608",4063,229,30,0,1250,82,1034,0,6688
"35045000609",939,137,6,0,88,106,166,151,1593
"35045000610",2866,387,0,0,563,98,758,189,4861
"35045000611",2794,555,11,0,380,92,243,108,4183
"35045000612",1566,347,0,0,255,66,499,131,2864
"35045000613",2691,182,0,0,824,239,1054,72,5062
"35045000702",606,77,0,0,163,0,156,73,1075
"35045000705",1501,539,7,0,827,471,657,341,4343
"35045000706",2122,382,0,0,626,31,1487,246,4894
"35045000707",2032,216,52,0,1424,628,1078,154,5584
"35045000708",2006,1089,0,10,1694,121,1088,684,6692
"35045000900",1654,88,6,0,581,0,773,12,3114
"35045942801",29,6,19,5,2025,948,10,0,3042
"35045942802",237,43,0,0,4339,2168,3,131,6921
"35045942803",16,13,14,0,1607,1342,15,0,3007
"35045942900",36,11,0,3,2571,2006,28,25,4680
"35045943000",60,14,0,0,2983,1674,101,47,4879
"35045943100",24,8,0,0,1034,663,22,3,1754
"35045943201",801,33,0,5,2276,1732,243,26,5116
"35045943300",2138,482,0,0,328,10,461,56,3475
"35047957200",1967,568,26,68,1051,647,2707,979,8013
"35047957300",1306,716,14,72,346,461,1048,776,4739
"35047957400",1644,924,0,15,736,494,1984,1119,6916
"35047957500",2285,583,18,0,809,204,1978,593,6470
"35047957600",2690,606,95,0,1872,657,3781,1016,10717
"35047957700",688,321,0,0,847,461,1168,664,4149
"35047957800",2033,734,46,3,940,562,2507,1241,8066
"35049000101",3191,274,85,0,256,63,511,56,4436
"35049000200",3362,359,14,0,239,70,1125,158,5327
"35049000300",1006,141,15,4,92,6,332,55,1651
"35049000400",282,18,3,0,4,0,44,15,366
"35049000500",1722,140,38,0,98,8,385,31,2422
"35049000600",1899,184,0,0,182,54,412,153,2884
"35049000700",1327,158,17,0,100,81,639,35,2357
"35049000800",1746,732,0,0,348,233,1077,829,4965
"35049000900",2319,482,0,0,442,31,1600,326,5200
"35049001001",1636,168,0,7,249,86,609,197,2952
"35049001002",1883,1213,7,0,340,145,1357,1111,6056
"35049001102",2338,455,70,1,257,177,1026,341,4665
"35049001103",1175,231,16,13,236,86,815,186,2758
"35049001105",1900,177,26,0,286,8,1046,67,3510
"35049001106",1651,647,0,0,354,54,1189,567,4462
"35049001107",3304,614,32,0,542,60,2010,504,7066
"35049001202",2988,1469,75,45,685,817,2606,1961,10646
"35049001203",1938,429,0,0,278,62,1613,407,4727
"35049001204",2761,770,36,0,791,586,2625,1206,8775
"35049001205",3326,861,27,14,909,221,3651,968,9977
"35049001301",1081,155,5,0,435,0,978,135,2789
"35049001302",1602,666,14,0,356,203,1622,780,5243
"35049001303",4135,1733,96,29,1025,105,3419,1644,12186
"35049001304",458,89,0,0,218,10,557,94,1426
"35049010102",2349,1175,0,0,787,248,2458,1317,8334
"35049010203",845,131,0,0,168,56,288,67,1555
"35049010204",2029,33,0,0,92,0,450,0,2604
"35049010304",2486,364,15,0,500,8,1356,309,5038
"35049010308",1334,486,30,0,356,72,1215,511,4004
"35049010309",2011,153,0,0,85,19,177,20,2465
"35049010310",1043,43,0,0,35,0,138,8,1267
"35049010311",3539,78,9,0,406,49,836,52,4969
"35049010312",3840,548,0,0,336,21,1051,251,6047
"35049010314",1374,358,30,0,314,0,838,161,3075
"35049010315",2397,167,8,0,415,11,1238,11,4247
"35049010316",1109,37,12,0,173,4,566,11,1912
"35049010400",2343,230,0,0,178,73,350,50,3224
"35049010500",1499,168,0,0,79,9,385,75,2215
"35049010601",4371,143,0,31,543,6,3109,144,8347
"35049010602",2479,202,8,0,88,0,403,0,3180
"35049010603",1827,83,0,0,409,0,1180,26,3525
"35049010700",4904,576,23,16,266,0,541,176,6502
"35049010800",2094,221,0,0,116,52,829,168,3480
"35049010900",1660,362,20,0,324,17,1027,282,3692
"35049940300",940,106,0,8,714,156,930,126,2980
"35049940400",771,110,0,0,241,113,377,162,1774
"35049940500",923,101,6,0,730,140,970,130,3000
"35049940600",2356,443,21,5,844,109,2144,451,6373
"35049940900",1649,573,12,7,575,331,1857,790,5794
"35049980000",78,0,0,0,15,0,77,0,170
"35051962200",2503,702,0,0,231,83,956,258,4733
"35051962300",2197,664,26,0,118,39,584,178,3806
"35051962401",1835,130,0,0,147,38,227,136,2513
"35051962402",2282,212,0,0,110,169,730,236,3739
"35053940000",32,0,0,0,524,350,14,0,920
"35053978100",3047,973,18,9,918,51,1787,674,7477
"35053978200",1038,71,0,0,245,40,490,11,1895
"35053978301",2058,319,45,0,108,170,1325,402,4427
"35053978302",1579,814,0,2,155,283,729,592,4154
"35053978303",2440,1110,19,23,580,82,1811,665,6730
"35055940000",801,189,0,0,603,198,1206,296,3293
"35055940100",4096,979,24,4,2771,654,3138,906,12572
"35055952100",3128,733,0,0,910,926,1784,1167,8648
"35055952300",1386,278,0,32,622,319,1221,428,4286
"35055952600",4514,1184,66,0,1297,686,3495,1090,12332
"35055952700",3292,885,23,0,1432,684,2669,926,9911
"35057963201",2314,1061,101,53,221,200,393,392,4735
"35057963202",2507,409,0,21,215,140,1212,240,4744
"35057963600",3517,1735,14,0,171,88,1253,909,7687
"35057963700",1427,509,9,0,149,175,826,459,3554
"35059950200",2745,449,27,34,567,39,1218,224,5303
"35061940300",9,9,0,0,697,193,42,3,953
"35061970101",1488,868,134,0,1180,1932,1758,2498,9858
"35061970102",3735,994,56,0,1214,714,2567,1010,10290
"35061970200",2770,220,0,0,652,244,1285,281,5452
"35061970301",2649,1510,0,0,1871,1160,3356,2204,12750
"35061970302",1576,276,17,0,916,113,1538,330,4766
"35061970303",4072,645,0,0,1247,347,3106,708,10125
"35061970401",2648,917,58,0,771,214,1963,726,7297
"35061970404",3969,619,87,67,380,154,2628,562,8466
"35061970405",1679,170,76,0,969,13,1324,48,4279
"35061970700",2338,733,15,0,876,578,1730,759,7029
"35061970800",2628,1202,10,0,296,638,1920,1365,8059
"35061970901",2486,990,0,0,627,407,1959,1193,7662
"35061970902",1368,315,21,0,446,124,1063,306,3643
"35061971000",3557,389,17,103,915,203,2027,276,7487
"35061971100",895,220,32,0,293,85,540,178,2243
"35061971300",1109,521,0,0,495,171,709,334,3339
"35061971400",2090,246,0,24,568,136,1468,234,4766
"36001000100",363,358,749,385,200,134,253,406,2848
"36001000200",318,207,2640,1583,8,416,392,231,5795
"36001000300",1820,519,1198,1037,389,350,233,118,5664
"36001000401",1498,64,166,8,80,0,53,0,1869
"36001000403",2937,312,369,332,254,374,195,108,4881
"36001000404",4,0,3,0,0,0,0,0,7
"36001000501",1550,458,650,245,453,290,545,165,4356
"36001000502",1022,298,125,21,131,129,37,23,1786
"36001000600",647,908,999,473,281,371,403,205,4287
"36001000700",194,140,2189,972,118,180,199,282,4274
"36001000800",242,146,666,704,91,252,137,89,2327
"36001001100",284,309,239,227,50,12,27,53,1201
"36001001400",2367,404,167,34,69,387,172,110,3710
"36001001500",2158,939,600,120,472,190,276,95,4850
"36001001600",1951,945,272,160,399,75,204,39,4045
"36001001700",2865,278,852,65,436,144,307,145,5092
"36001001801",5228,376,555,47,423,86,190,0,6905
"36001001802",2949,370,323,69,386,102,66,38,4303
"36001001901",2001,211,87,26,153,54,99,54,2685
"36001001902",2012,113,454,0,116,0,50,0,2745
"36001002000",2794,724,1434,363,754,687,615,214,7585
"36001002100",534,305,589,194,265,346,139,169,2541
"36001002200",1321,254,401,125,233,49,141,70,2594
"36001002300",439,192,498,276,67,261,119,197,2049
"36001002500",176,159,1296,888,172,59,123,55,2928
"36001002600",868,315,2612,636,528,502,200,175,5836
"36001012700",1926,136,34,0,96,0,38,0,2230
"36001012800",2389,767,46,65,247,375,214,356,4459
"36001012900",2242,447,74,97,193,127,112,45,3337
"36001013000",5502,475,235,1,153,37,40,2,6445
"36001013100",2108,194,32,0,102,154,102,0,2692
"36001013200",2496,659,74,9,90,77,35,29,3469
"36001013300",3363,362,756,20,146,101,200,0,4948
"36001013400",1700,216,13,0,25,78,70,0,2102
"36001013503",3375,295,192,55,588,77,188,34,4804
"36001013505",2123,216,47,0,117,46,97,5,2651
"36001013506",4338,300,656,53,687,433,481,95,7043
"36001013507",1743,331,135,0,290,37,130,59,2725
"36001013508",5529,310,189,80,572,86,215,0,6981
"36001013601",5486,559,278,0,1017,91,322,0,7753
"36001013602",2659,171,236,27,1081,64,181,18,4437
"36001013703",1393,155,14,0,201,0,21,0,1784
"36001013705",5936,298,73,0,92,0,35,0,6434
"36001013706",1954,66,0,0,210,11,27,0,2268
"36001013707",5026,219,326,0,408,19,234,0,6232
"36001013801",5867,477,685,8,257,0,244,32,7570
"36001013802",4042,92,29,0,227,0,0,11,4401
"36001013901",2028,83,47,10,254,95,43,103,2663
"36001013902",4473,203,47,0,605,5,252,0,5585
"36001014001",2903,232,398,0,295,132,49,11,4020
"36001014002",3475,311,285,0,228,0,234,35,4568
"36001014100",4655,82,56,0,350,0,202,2,5347
"36001014201",4797,193,145,31,607,92,145,0,6010
"36001014202",5219,121,161,0,333,15,113,0,5962
"36001014203",5357,108,144,19,358,3,131,3,6123
"36001014301",2176,408,66,95,53,0,120,0,2918
"36001014302",7354,167,135,0,687,0,163,0,8506
"36001014401",3559,442,81,2,41,0,74,0,4199
"36001014402",2499,320,351,0,70,0,82,16,3338
"36001014501",2156,166,0,0,22,5,38,29,2416
"36001014502",3256,191,0,0,86,25,42,0,3600
"36001014503",2557,52,0,16,184,0,169,8,2986
"36001014606",3362,133,67,0,126,10,34,0,3732
"36001014607",7257,213,87,0,406,0,207,47,8217
"36001014608",2240,132,115,42,110,24,32,0,2695
"36001014609",3835,166,237,96,371,206,237,24,5172
"36001014611",1685,47,32,1,190,2,20,1,1978
"36001014612",1478,64,2,0,51,10,74,8,1687
"36001014613",2666,167,20,8,45,0,52,0,2958
"36001014614",4269,225,92,163,626,51,183,0,5609
"36001014615",1496,113,56,67,733,57,136,1,2659
"36001014700",2363,170,8,0,57,15,22,33,2668
"36001014801",2569,155,20,0,49,9,8,0,2810
"36001014802",1475,382,0,0,35,3,0,0,1895
"36001014803",2994,300,20,1,63,0,10,0,3388
"36003940200",0,0,0,0,15,0,0,0,15
"36003950100",2253,317,0,0,119,13,44,4,2750
"36003950300",2899,667,14,0,53,20,7,0,3660
"36003950400",3072,462,12,0,32,2,10,37,3627
"36003950500",3032,429,0,11,73,11,38,10,3604
"36003950600",2702,828,4,1,33,19,5,4,3596
"36003950700",2891,602,0,0,63,5,12,22,3595
"36003950800",2116,580,1,4,144,22,9,7,2883
"36003950900",3178,591,6,7,76,0,39,5,3902
"36003951000",2592,698,4,6,15,6,10,32,3363
"36003951100",3045,753,18,0,55,7,48,41,3967
"36003951200",3847,654,4,7,51,24,26,1,4614
"36003951300",3449,629,0,0,60,2,28,0,4168
"36005000100",0,0,0,0,0,0,0,0,0
"36005000200",1376,230,1303,119,1420,625,2596,888,8557
"36005000400",1466,196,1794,202,1654,248,3127,394,9081
"36005001600",1413,367,1327,335,1432,284,2967,644,8769
"36005001900",418,405,450,324,529,394,751,749,4020
"36005002000",860,997,2737,1253,1573,1513,2821,2443,14197
"36005002300",329,419,1080,1289,694,1016,1183,1769,7779
"36005002400",0,0,0,0,0,0,0,0,0
"36005002500",841,540,280,745,1028,1696,1861,2144,9135
"36005002701",465,236,589,755,346,781,854,1289,5315
"36005002702",478,534,755,780,872,1132,1350,1888,7789
"36005002800",170,19,4001,406,1080,66,1332,104,7178
"36005003100",344,94,450,76,464,110,855,192,2585
"36005003300",646,375,607,920,696,582,1618,1072,6516
"36005003500",254,119,519,645,1437,770,1756,956,6456
"36005003700",22,28,29,12,49,59,61,59,319
"36005003800",213,57,380,234,352,67,542,113,1958
"36005003900",1141,563,1076,351,2392,1033,3476,1663,11695
"36005004001",223,155,330,0,621,221,382,75,2007
"36005004100",956,749,889,1160,1286,1341,2584,2336,11301
"36005004200",666,945,2030,2198,1460,300,2180,1463,11242
"36005004300",456,335,929,828,1857,1426,2366,2108,10305
"36005004400",272,256,1433,431,1195,1020,1450,1319,7376
"36005004600",277,157,520,120,483,102,773,246,2678
"36005004800",424,127,549,326,1421,1177,1836,1186,7046
"36005005001",284,209,1575,737,1328,862,1546,1366,7907
"36005005002",488,555,627,518,2205,1360,2494,1807,10054
"36005005100",371,386,1266,958,1697,1131,2285,1671,9765
"36005005200",190,181,191,373,745,448,884,640,3652
"36005005300",105,45,819,1006,519,785,504,891,4674
"36005005400",769,198,1318,399,1985,1590,2694,1782,10735
"36005005600",302,74,318,292,823,582,1047,613,4051
"36005005902",243,193,730,180,1059,418,1243,757,4823
"36005006000",138,4,82,143,646,177,730,256,2176
"36005006100",142,33,3053,324,356,84,402,134,4528
"36005006200",471,198,1509,1480,2762,1261,3580,1847,13108
"36005006300",838,454,928,282,1275,692,1851,1031,7351
"36005006400",409,247,804,436,1028,641,1263,653,5481
"36005006500",553,210,990,1191,1562,1290,1887,1516,9199
"36005006700",862,150,1792,956,1683,2133,2620,2517,12713
"36005006800",246,93,830,252,1043,512,1175,467,4618
"36005006900",441,346,2471,1048,1535,1895,2223,2292,12251
"36005007000",647,286,890,231,1737,798,2039,851,7479
"36005007100",231,60,763,265,643,308,1013,366,3649
"36005007200",718,245,632,422,2747,1193,2329,955,9241
"36005007300",196,130,826,559,1094,918,1430,1031,6184
"36005007400",784,186,963,137,1277,377,2066,546,6336
"36005007500",429,222,1200,877,1568,591,2217,895,7999
"36005007600",717,500,935,382,2515,758,2630,1217,9654
"36005007700",133,86,304,220,760,401,889,474,3267
"36005007800",703,555,1322,294,2862,1132,3002,1361,11231
"36005007900",827,267,927,1023,1868,1149,2808,1744,10613
"36005008300",278,341,864,894,2140,1451,2807,2086,10861
"36005008400",337,27,813,140,1018,112,1409,112,3968
"36005008500",392,348,843,461,2514,1535,3035,1867,10995
"36005008600",815,325,525,697,855,699,1662,1043,6621
"36005008700",592,265,1107,393,2452,1401,3182,1626,11018
"36005008900",469,162,376,479,1000,1044,1691,1147,6368
"36005009000",932,396,722,639,752,383,1664,829,6317
"36005009200",718,160,567,163,2738,970,2504,845,8665
"36005009300",793,630,1013,324,1632,1053,2458,1711,9614
"36005009600",266,87,345,21,1292,335,1205,207,3758
"36005009800",1240,446,1262,186,1365,403,2586,811,8299
"36005011000",0,0,0,0,174,31,174,31,410
"36005011502",625,501,775,782,790,827,1611,1372,7283
"36005011700",298,108,304,210,370,222,688,375,2575
"36005011800",3182,346,17,12,484,108,614,107,4870
"36005011900",335,281,1409,594,1751,1200,2170,1577,9317
"36005012101",284,132,605,237,986,770,1312,892,5218
"36005012102",56,161,198,78,468,524,533,699,2717
"36005012300",126,131,932,375,1089,1463,1243,1544,6903
"36005012500",338,135,944,422,1048,1251,1396,1279,6813
"36005012701",264,146,303,277,566,561,865,741,3723
"36005012901",230,125,1110,647,690,973,1035,1099,5909
"36005013000",1013,0,34,24,220,43,467,47,1848
"36005013100",361,116,1044,427,1960,997,2358,1018,8281
"36005013200",3299,154,768,47,2519,361,3208,397,10753
"36005013300",187,178,2189,590,2877,968,3173,1240,11402
"36005013500",212,139,818,635,1060,1075,1336,1274,6549
"36005013800",2289,145,189,1,528,142,683,131,4108
"36005014100",811,215,1559,230,1102,637,2006,818,7378
"36005014300",90,55,152,271,189,174,241,149,1321
"36005014400",906,462,1186,1188,1375,943,2015,1657,9732
"36005014500",263,213,1339,1461,1578,1513,1763,1729,9859
"36005014701",310,501,1291,2409,1546,1029,1888,1702,10676
"36005014702",117,205,977,1699,864,1179,1049,1388,7478
"36005014900",154,199,1036,736,1137,1102,1347,1247,6958
"36005015100",225,404,1978,531,1742,767,2074,1156,8877
"36005015200",1008,243,334,113,1080,182,1405,223,4588
"36005015300",253,315,1114,892,719,1171,1039,1498,7001
"36005015500",372,125,562,172,769,1010,1147,1157,5314
"36005015700",159,110,1184,244,1120,932,1259,1057,6065
"36005015800",695,49,63,66,219,141,408,90,1731
"36005015900",166,196,50,88,764,581,951,819,3615
"36005016000",3529,143,21,0,681,55,983,55,5467
"36005016100",209,243,806,383,1136,1353,1444,1568,7142
"36005016200",966,139,74,23,385,171,630,153,2541
"36005016300",0,0,8,15,15,16,15,16,85
"36005016400",658,26,25,47,144,0,320,6,1226
"36005016500",35,24,465,268,332,142,472,285,2023
"36005016600",1084,90,166,10,841,101,989,108,3389
"36005016700",120,89,949,536,486,253,626,307,3366
"36005016900",57,56,529,302,262,174,352,233,1965
"36005017100",0,0,1,0,0,0,0,0,1
"36005017300",1192,221,1368,574,2138,1186,3285,1192,11156
"36005017500",491,119,1673,1328,1606,1772,2149,2285,11423
"36005017701",201,92,660,75,1262,1749,1452,1804,7295
"36005017702",163,514,1113,704,1372,1575,1478,2223,9142
"36005017901",339,123,940,667,1559,1062,2310,1223,8223
"36005017902",191,204,690,727,1081,691,1233,827,5644
"36005018101",246,117,938,668,619,350,914,497,4349
"36005018102",535,180,1604,554,1726,1001,1979,1096,8675
"36005018301",326,320,1822,252,915,606,1500,799,6540
"36005018302",306,260,835,240,1672,621,1884,835,6653
"36005018400",2408,245,186,12,937,140,1264,224,5416
"36005018500",202,275,1943,1212,1745,1430,1934,1610,10351
"36005018900",1028,624,1148,1093,2325,1980,3136,2957,14291
"36005019300",35,775,1015,1372,1344,734,1513,1547,8335
"36005019400",500,303,167,78,1005,229,866,504,3652
"36005019500",588,444,1880,690,2995,887,3724,1419,12627
"36005019700",442,412,1365,960,2076,1722,2457,2078,11512
"36005019900",475,453,1913,610,2142,1990,2494,2416,12493
"36005020000",741,311,259,38,2212,1093,1759,825,7238
"36005020100",447,196,910,496,1354,809,1828,1062,7102
"36005020200",326,83,283,12,1238,298,1050,254,3544
"36005020400",582,74,531,9,1569,426,1712,319,5222
"36005020501",299,270,1737,704,2255,1303,2887,1720,11175
"36005020502",107,214,412,434,582,328,684,390,3151
"36005020601",333,178,282,99,1495,371,1074,277,4109
"36005020900",335,151,783,472,2022,756,2236,917,7672
"36005021001",417,205,5006,392,2278,780,2262,924,12264
"36005021002",441,67,3273,600,1357,343,1129,244,7454
"36005021100",478,257,1308,1274,1229,1105,1753,1548,8952
"36005021200",519,26,1818,313,2231,262,1668,30,6867
"36005021301",28,93,190,64,351,375,396,480,1977
"36005021302",400,321,1713,1188,1763,865,2176,1493,9919
"36005021501",326,148,729,312,1788,823,2043,1005,7174
"36005021502",303,243,1016,654,1955,1812,2201,1946,10130
"36005021601",418,517,507,370,1217,913,1438,1194,6574
"36005021602",825,235,2310,328,1651,710,1605,644,8308
"36005021700",265,250,1150,1066,978,1353,1309,1479,7850
"36005021800",824,36,1642,487,2614,1394,3038,1259,11294
"36005021900",143,77,117,89,590,189,785,285,2275
"36005022000",212,62,137,234,549,704,649,730,3277
"36005022101",393,209,520,265,1740,829,2130,1056,7142
"36005022102",396,731,414,616,1278,1524,1494,2418,8871
"36005022200",571,93,520,111,1132,532,1435,442,4836
"36005022300",726,193,1619,462,1218,981,1961,1130,8290
"36005022401",472,239,400,63,1153,271,1201,362,4161
"36005022403",915,157,383,9,952,875,1310,973,5574
"36005022404",1136,607,877,133,812,386,981,392,5324
"36005022500",750,284,1458,1053,2836,1144,3708,1525,12758
"36005022701",454,150,1472,598,2070,1119,2691,1312,9866
"36005022702",189,99,528,99,389,221,539,281,2345
"36005022703",328,19,301,191,790,242,873,257,3001
"36005022800",1267,272,1228,39,2531,779,1987,890,8993
"36005022901",350,274,1363,707,1600,873,1825,1284,8276
"36005022902",243,265,611,429,936,745,1130,1203,5562
"36005023000",860,347,222,48,1482,381,1769,357,5466
"36005023100",148,122,417,291,287,219,493,387,2364
"36005023200",697,207,45,23,1349,443,1412,467,4643
"36005023301",205,198,996,369,1766,826,2119,1016,7495
"36005023302",223,401,491,368,961,785,1223,1262,5714
"36005023501",179,168,352,96,1592,1127,1807,1259,6580
"36005023502",552,191,638,467,1552,1120,2015,1501,8036
"36005023600",341,279,212,63,835,462,891,471,3554
"36005023702",13,61,133,82,743,313,771,355,2471
"36005023703",382,295,670,325,1665,1543,1935,1770,8585
"36005023704",159,263,614,528,902,1233,1076,1627,6402
"36005023800",541,107,377,83,882,638,1042,681,4351
"36005023900",310,243,826,1070,3456,2360,3556,2842,14663
"36005024000",641,88,597,312,1891,701,2377,742,7349
"36005024100",323,183,1048,772,2079,1920,2519,2062,10906
"36005024300",300,249,964,613,1783,1680,2138,1818,9545
"36005024400",1162,54,112,40,960,260,1120,259,3967
"36005024501",365,268,1266,418,1721,1036,2208,1502,8784
"36005024502",234,146,455,802,862,1129,1059,1389,6076
"36005024600",1050,51,160,0,912,21,754,19,2967
"36005024700",138,88,920,116,326,268,480,304,2640
"36005024800",1794,210,99,0,913,172,812,108,4108
"36005024900",0,0,0,0,0,0,0,0,0
"36005025000",1591,161,0,31,828,204,524,267,3606
"36005025100",453,477,1288,291,2659,1078,2780,1434,10460
"36005025200",1195,135,124,41,778,224,727,233,3457
"36005025300",424,132,933,293,2734,1339,2892,1366,10113
"36005025400",1142,213,44,10,400,113,379,108,2409
"36005025500",446,80,816,582,1688,2116,2060,2229,10017
"36005025600",525,129,166,118,635,70,670,70,2383
"36005025700",58,98,348,91,527,539,603,612,2876
"36005026100",172,0,855,43,433,148,529,148,2328
"36005026300",525,133,878,211,2604,1634,3092,1619,10696
"36005026400",2511,372,382,131,1989,526,1976,560,8447
"36005026500",432,353,757,210,3668,1254,3347,1414,11435
"36005026601",1632,163,82,10,917,107,976,107,3994
"36005026602",2603,502,277,66,1683,357,2111,482,8081
"36005026701",479,67,201,122,1857,713,1786,634,5859
"36005026702",694,181,764,330,2717,1429,3365,1546,11026
"36005026900",339,229,341,102,1660,643,1745,742,5801
"36005027300",1009,181,1290,455,3449,1790,4543,1924,14641
"36005027401",4215,239,0,0,269,0,445,32,5200
"36005027402",2789,258,138,0,337,20,669,42,4253
"36005027600",25,0,30,0,0,7,0,7,69
"36005027700",397,276,809,453,2255,1400,2447,1567,9604
"36005027900",1932,223,994,198,2752,413,3242,578,10332
"36005028100",1836,111,631,101,937,52,1259,38,4965
"36005028300",462,73,594,356,1478,418,1925,481,5787
"36005028400",27,17,13,31,118,9,114,16,345
"36005028500",1720,321,101,0,712,223,848,289,4214
"36005028600",753,152,12,0,182,119,155,135,1508
"36005028700",1012,437,433,47,1312,248,1702,265,5456
"36005028800",2551,126,80,1,716,22,385,7,3888
"36005028900",1357,217,67,115,1822,251,2260,277,6366
"36005029301",1474,146,40,0,132,50,195,23,2060
"36005029302",3924,47,365,0,957,0,1104,14,6411
"36005029500",2561,169,543,21,1246,62,1015,43,5660
"36005029600",544,49,289,70,531,104,318,76,1981
"36005029700",2931,144,225,9,492,8,757,0,4566
"36005030000",2477,365,211,19,2214,457,2111,278,8132
"36005030100",555,126,50,1,237,8,263,47,1287
"36005030200",810,147,6182,389,2077,277,1999,299,12180
"36005030701",4116,314,230,0,447,148,536,148,5939
"36005030900",2665,75,241,9,219,20,356,21,3606
"36005031000",1927,42,490,0,1218,232,1064,0,4973
"36005031200",1117,72,294,1,630,10,421,27,2572
"36005031400",1242,65,143,0,594,59,567,27,2697
"36005031600",795,47,212,85,729,128,664,59,2719
"36005031800",1191,127,135,5,589,131,467,144,2789
"36005031900",4,50,0,4,0,0,0,0,58
"36005032300",3038,129,456,8,827,31,854,92,5435
"36005032400",553,111,694,111,965,350,1207,478,4469
"36005032600",1894,69,372,19,905,116,773,115,4263
"36005032800",935,213,872,319,1594,420,1403,638,6394
"36005033000",1874,377,679,430,1605,766,2080,1025,8836
"36005033201",990,184,655,135,1430,467,1844,564,6269
"36005033202",592,116,956,308,1154,363,1282,444,5215
"36005033400",278,55,306,107,443,130,575,178,2072
"36005033500",1208,96,74,17,382,20,285,33,2115
"36005033600",851,305,2232,717,1608,874,2421,1209,10217
"36005033700",1718,92,181,6,311,45,283,10,2646
"36005033800",226,237,1490,339,824,747,879,803,5545
"36005034000",255,325,1766,202,1265,630,1219,602,6264
"36005034200",320,0,849,128,490,150,597,94,2628
"36005034300",799,20,67,16,360,216,448,190,2116
"36005034400",588,13,771,40,665,211,506,202,2996
"36005034500",1628,218,260,21,1133,65,800,24,4149
"36005034800",617,78,3509,818,1344,971,1832,1064,10233
"36005035000",177,12,1053,184,141,124,308,50,2049
"36005035100",998,299,196,0,596,140,558,314,3101
"36005035600",123,12,1673,43,423,133,343,144,2894
"36005035800",248,12,5901,571,1206,116,1240,143,9437
"36005035900",103,83,402,228,485,601,619,667,3188
"36005036000",660,26,1360,123,882,37,900,94,4082
"36005036100",362,129,879,707,2180,2185,2571,2569,11582
"36005036300",665,305,424,749,3253,2386,3872,2697,14351
"36005036400",16,0,1858,262,235,2,223,2,2598
"36005036501",167,192,1039,930,579,796,842,952,5497
"36005036502",42,111,358,107,571,597,555,705,3046
"36005036700",175,157,256,319,641,766,907,914,4135
"36005036800",126,12,1479,322,250,102,409,112,2812
"36005036901",86,87,315,477,654,665,797,977,4058
"36005036902",87,53,842,288,412,609,649,598,3538
"36005037000",132,38,1539,55,632,91,579,97,3163
"36005037100",580,362,1303,645,472,405,1183,695,5645
"36005037200",199,4,1147,185,464,225,459,218,2901
"36005037300",713,192,1245,385,1414,1131,2149,1288,8517
"36005037400",101,196,1520,480,497,731,609,870,5004
"36005037504",364,580,629,621,911,616,1083,1213,6017
"36005037600",171,0,959,130,946,271,835,264,3576
"36005037800",296,107,1619,183,465,391,705,445,4211
"36005037900",390,290,1421,1094,948,972,1457,1206,7778
"36005038000",162,66,2736,1006,57,327,318,395,5067
"36005038100",653,354,1475,420,1671,1494,2594,1990,10651
"36005038200",55,32,1756,222,446,169,442,208,3330
"36005038301",235,278,917,289,1572,1005,1859,1363,7518
"36005038302",117,211,1299,1571,792,1335,1049,1680,8054
"36005038500",351,381,711,782,1053,1750,1524,2109,8661
"36005038600",205,73,5174,595,834,562,684,621,8748
"36005038700",530,356,566,176,663,708,861,895,4755
"36005038800",67,8,1767,430,283,57,365,75,3052
"36005038900",828,797,352,420,1784,1214,1969,1279,8643
"36005039000",124,154,1896,561,284,246,211,400,3876
"36005039100",1248,817,501,440,2060,2135,2522,2531,12254
"36005039200",112,45,924,382,222,30,302,44,2061
"36005039300",327,375,1207,886,2602,2384,2865,2611,13257
"36005039400",308,82,2159,820,676,403,896,518,5862
"36005039500",312,123,1049,609,1030,694,1651,946,6414
"36005039600",93,40,1672,624,423,629,376,618,4475
"36005039700",146,164,119,56,320,406,432,309,1952
"36005039800",160,0,2230,345,142,0,149,0,3026
"36005039901",158,210,686,336,2415,1463,2236,1502,9006
"36005039902",442,245,505,546,1716,1230,1986,1509,8179
"36005040100",376,305,412,245,2723,1337,2899,1700,9997
"36005040302",367,165,410,362,1615,1202,1963,1204,7288
"36005040303",540,307,758,227,1773,861,2134,1138,7738
"36005040304",397,266,307,87,1996,879,2055,1100,7087
"36005040400",45,0,2020,399,365,43,369,43,3284
"36005040501",223,156,857,152,1577,939,1609,1025,6538
"36005040502",276,301,1394,454,1787,1375,2128,1649,9364
"36005040600",61,220,1802,754,380,152,262,362,3993
"36005040701",365,180,581,165,1108,841,1302,946,5488
"36005040702",1052,316,826,392,2758,1462,2947,1687,11440
"36005040800",375,107,1976,710,589,416,801,375,5349
"36005040900",543,86,2233,288,296,54,344,96,3940
"36005041100",392,121,611,81,1052,671,1138,749,4815
"36005041300",1195,395,685,126,3794,1370,3976,1275,12816
"36005041400",453,16,2536,362,1287,137,1013,163,5967
"36005041500",671,150,845,217,2543,1000,2577,1186,9189
"36005041800",93,219,1606,596,745,519,544,788,5110
"36005041900",1549,249,1120,232,2505,1290,2430,1270,10645
"36005042000",208,134,1629,359,558,396,582,496,4362
"36005042100",1378,327,524,345,2149,975,2329,1248,9275
"36005042200",428,45,2403,210,167,34,477,41,3805
"36005042300",876,252,595,191,1286,1001,1473,1021,6695
"36005042400",193,15,1971,245,21,198,167,106,2916
"36005042500",1105,460,750,209,2535,1578,2831,1597,11065
"36005042600",216,5,5276,1006,515,178,527,178,7901
"36005042800",119,8,1433,139,273,71,190,33,2266
"36005042901",852,110,543,44,995,1233,1260,676,5713
"36005042902",685,170,922,406,1126,638,1391,792,6130
"36005043000",314,20,2317,181,562,156,491,143,4184
"36005043100",1063,412,1996,521,4529,1452,3993,1512,15478
"36005043400",222,132,2107,367,800,64,635,133,4460
"36005043500",0,0,55,0,0,0,0,0,55
"36005043600",84,69,1217,298,555,41,415,41,2720
"36005044200",272,17,2567,632,250,352,556,376,5022
"36005044400",230,67,2418,394,359,132,438,148,4186
"36005044800",168,0,1644,145,227,0,280,27,2491
"36005044901",1232,160,5,21,236,15,256,36,1961
"36005044902",1546,155,0,9,293,28,157,45,2233
"36005045101",1257,53,15,0,83,0,115,7,1530
"36005045102",1483,71,50,5,234,4,217,6,2070
"36005045600",862,6,1379,214,491,384,700,316,4352
"36005045800",253,220,1480,1032,1014,1288,1431,1499,8217
"36005046000",43,16,1642,312,170,150,234,230,2797
"36005046201",4762,545,15537,922,5441,672,8554,932,37365
"36005046202",221,152,4855,891,1121,636,1421,714,10011
"36005048400",252,92,2740,216,431,0,579,10,4320
"36005050400",18,0,20,0,16,0,29,0,83
"36005051600",3367,177,54,4,730,3,935,2,5272
"36007000100",1441,565,196,182,184,504,37,186,3295
"36007000200",1521,1016,155,355,133,159,0,137,3476
"36007000300",1500,413,210,76,171,137,205,121,2833
"36007000400",1137,423,242,135,47,107,68,46,2205
"36007000500",712,664,94,118,92,56,76,91,1903
"36007000600",1318,489,223,90,56,66,96,95,2433
"36007000700",2393,278,99,173,241,125,23,131,3463
"36007000900",835,386,183,122,86,10,113,21,1756
"36007001100",394,467,76,404,162,91,164,207,1965
"36007001200",343,299,20,63,22,33,53,7,840
"36007001300",514,1088,169,353,47,241,79,318,2809
"36007001400",2717,1329,150,143,357,204,161,38,5099
"36007001500",3578,480,362,0,356,172,53,24,5025
"36007001600",1714,178,35,35,129,126,61,0,2278
"36007001700",2456,1111,397,89,217,89,0,186,4545
"36007001800",2009,852,296,594,187,295,112,126,4471
"36007010200",4386,833,0,0,89,24,0,5,5337
"36007011901",2476,320,23,0,9,57,22,44,2951
"36007011902",2220,442,0,0,47,0,30,17,2756
"36007011903",2320,285,0,0,12,41,26,0,2684
"36007012000",1370,173,0,6,11,0,9,0,1569
"36007012101",3112,422,17,0,0,125,0,25,3701
"36007012102",3764,256,17,11,15,13,23,11,4110
"36007012103",3032,239,14,14,82,1,95,35,3512
"36007012201",2057,173,9,0,108,0,0,0,2347
"36007012202",3371,604,0,0,134,0,0,0,4109
"36007012300",4359,783,15,25,2,0,41,0,5225
"36007012400",2110,248,12,0,73,35,31,0,2509
"36007012500",5548,520,59,0,78,0,24,14,6243
"36007012600",4967,624,0,20,118,60,79,16,5884
"36007012701",4601,704,41,0,17,5,51,0,5419
"36007012702",4403,279,31,9,91,70,85,0,4968
"36007012800",3513,658,40,80,330,75,108,28,4832
"36007012900",1207,152,0,0,19,0,0,0,1378
"36007013000",3702,182,41,0,315,0,127,0,4367
"36007013100",1992,307,55,26,127,0,51,0,2558
"36007013201",1713,83,11,97,146,0,166,0,2216
"36007013202",2791,319,0,0,227,0,237,0,3574
"36007013301",4016,323,266,52,187,80,15,2,4941
"36007013303",2434,196,0,0,56,0,7,30,2723
"36007013304",5253,373,52,19,316,27,18,0,6058
"36007013400",3076,665,31,0,160,243,138,180,4493
"36007013500",1013,501,74,156,130,100,48,59,2081
"36007013600",2580,695,78,122,60,40,10,22,3607
"36007013700",2408,395,48,28,192,43,187,93,3394
"36007013800",2592,333,122,29,115,166,121,48,3526
"36007013900",1160,637,303,87,168,114,21,110,2600
"36007014000",1565,523,83,123,328,373,30,210,3235
"36007014100",2330,358,20,0,94,0,0,10,2812
"36007014200",2344,70,31,32,301,49,141,0,2968
"36007014301",3524,155,36,25,864,318,0,0,4922
"36007014302",1745,360,45,9,243,248,71,77,2798
"36007014400",4297,122,56,75,239,11,197,0,4997
"36007014500",3036,336,237,0,44,0,68,0,3721
"36007014600",5043,131,19,0,230,0,22,0,5445
"36009940000",11,0,0,0,162,161,0,0,334
"36009940200",0,0,0,0,0,0,0,0,0
"36009940300",2894,1121,70,44,1383,702,199,63,6476
"36009960100",3027,420,19,0,6,29,71,4,3576
"36009960200",3702,515,13,0,47,42,19,11,4349
"36009960300",4077,452,9,3,95,0,36,81,4753
"36009960400",3316,436,13,110,191,35,19,38,4158
"36009960500",4012,1300,6,5,64,49,53,37,5526
"36009960600",2732,480,0,2,105,52,38,9,3418
"36009960702",2427,230,18,0,65,15,65,0,2820
"36009960800",3614,589,28,12,52,62,88,22,4467
"36009961000",3715,540,43,0,42,26,8,4,4378
"36009961100",3226,546,48,0,121,32,0,0,3973
"36009961200",3205,367,5,15,52,7,50,3,3704
"36009961300",3200,556,0,17,13,25,18,28,3857
"36009961400",3782,975,10,0,121,54,81,20,5043
"36009961500",1502,310,22,0,9,0,0,0,1843
"36009961600",2878,626,0,0,237,162,51,0,3954
"36009961700",1944,1304,100,0,119,26,43,56,3592
"36009961800",3649,661,267,80,103,0,0,0,4760
"36009962200",2621,398,7,5,44,0,19,4,3098
"36011040100",3907,691,1,0,45,20,2,16,4682
"36011040200",4191,491,9,0,96,9,62,0,4858
"36011040300",3504,498,13,1,23,42,24,3,4108
"36011040400",3821,415,4,12,129,4,75,3,4463
"36011040500",2792,283,25,0,69,0,63,4,3236
"36011040600",3091,98,0,2,39,1,0,1,3232
"36011040700",3644,86,2,0,29,0,13,0,3774
"36011040800",3592,219,11,0,42,24,18,0,3906
"36011040900",3253,623,16,0,47,14,8,11,3972
"36011041000",4091,426,28,3,47,24,180,65,4864
"36011041100",4123,183,10,0,156,4,79,2,4557
"36011041200",4677,301,30,8,150,61,76,58,5361
"36011041300",2524,911,317,31,48,92,164,0,4087
"36011041400",3313,656,20,249,237,29,39,46,4589
"36011041500",2264,280,27,98,90,68,44,12,2883
"36011041600",2124,98,46,0,57,12,65,0,2402
"36011041700",3009,776,140,0,140,0,65,25,4155
"36011041800",3611,575,426,86,77,97,70,2,4944
"36011042100",1639,683,11,37,259,39,67,3,2738
"36011990200",0,0,0,0,0,0,0,0,0
"36013030100",2035,1117,172,23,71,226,56,303,4003
"36013030200",2524,1045,194,22,230,134,354,201,4704
"36013030300",722,595,206,107,305,167,230,166,2498
"36013030400",3660,492,86,48,69,77,39,192,4663
"36013030500",1222,1442,95,75,36,271,178,298,3617
"36013030600",2401,712,17,159,71,79,82,133,3654
"36013030700",3486,890,35,87,80,95,104,266,5043
"36013030800",3394,720,88,1,131,75,25,97,4531
"36013035100",3615,602,24,0,147,6,41,32,4467
"36013035300",2305,213,11,2,57,32,93,50,2763
"36013035400",1718,803,44,10,134,162,431,481,3783
"36013035500",2310,416,141,105,131,114,716,352,4285
"36013035600",2349,503,79,208,103,39,423,241,3945
"36013035700",2073,404,27,117,196,163,486,340,3806
"36013035800",2938,879,41,12,63,0,13,209,4155
"36013035901",3768,933,11,26,51,18,104,0,4911
"36013035902",126,50,0,0,9,5,0,5,195
"36013036000",3063,592,20,152,167,118,179,285,4576
"36013036100",3997,664,0,3,57,21,22,2,4766
"36013036300",3169,742,10,12,43,15,57,19,4067
"36013036401",2470,238,11,4,26,4,47,2,2802
"36013036402",2428,838,0,0,128,3,31,0,3428
"36013036500",4064,635,10,0,0,8,28,128,4873
"36013036600",2562,460,0,12,9,0,21,55,3119
"36013036700",3339,1032,3,0,35,16,14,5,4444
"36013036800",3631,582,0,0,65,44,30,20,4372
"36013036901",2514,241,0,0,32,21,12,0,2820
"36013036902",3306,239,29,0,0,0,0,0,3574
"36013037000",3085,279,20,0,39,46,58,28,3555
"36013037100",3267,344,24,0,60,97,48,0,3840
"36013037200",2660,350,28,27,79,14,53,5,3216
"36013037300",4450,764,0,13,61,108,74,41,5511
"36013037400",3507,345,5,1,54,32,87,8,4039
"36013037500",4423,420,41,0,44,13,20,31,4992
"36013037600",1867,527,0,0,51,150,47,68,2710
"36013990000",0,0,0,0,0,0,0,0,0
"36015000100",1452,867,237,249,164,60,37,42,3108
"36015000200",1778,377,192,343,61,99,10,0,2860
"36015000300",0,0,0,0,0,0,0,0,0
"36015000400",1570,160,154,12,26,37,14,0,1973
"36015000500",2382,627,176,4,55,22,100,0,3366
"36015000600",1107,749,174,57,22,271,53,199,2632
"36015000700",642,629,174,181,139,207,57,38,2067
"36015000900",2528,587,29,26,275,42,263,60,3810
"36015001000",1322,827,59,184,167,253,8,49,2869
"36015001100",2411,585,41,51,36,72,43,34,3273
"36015010100",3165,396,9,3,29,22,116,0,3740
"36015010200",5087,603,30,37,101,11,18,1,5888
"36015010300",6797,524,132,5,308,0,77,3,7846
"36015010400",3284,88,0,13,93,0,0,13,3491
"36015010500",2287,314,16,0,76,231,88,23,3035
"36015010600",2390,233,38,0,107,33,0,0,2801
"36015010700",6312,429,97,0,448,0,125,23,7434
"36015010800",2570,677,0,23,127,164,13,0,3574
"36015010900",4655,150,140,0,286,34,0,0,5265
"36015011000",3391,395,16,0,33,0,0,11,3846
"36015011100",5679,824,20,19,417,180,304,0,7443
"36015011200",4218,286,9,0,18,23,98,0,4652
"36017970100",4949,730,14,16,48,26,90,1,5874
"36017970200",3268,681,0,0,63,34,45,33,4124
"36017970300",2984,680,8,12,65,49,15,0,3813
"36017970400",1603,1042,51,0,116,137,80,66,3095
"36017970500",4686,768,0,0,117,28,36,0,5635
"36017970601",3437,755,4,1,80,14,49,14,4354
"36017970602",3472,346,18,0,116,20,162,11,4145
"36017970700",2032,299,0,0,81,22,55,4,2493
"36017970801",3557,348,0,0,38,8,36,0,3987
"36017970802",3004,732,49,55,77,72,57,38,4084
"36017970900",4242,689,2,9,124,23,77,40,5206
"36017971000",2677,432,27,0,36,47,18,33,3270
"36019100100",4812,704,51,2,98,18,36,4,5725
"36019100200",3695,431,30,7,31,21,87,0,4302
"36019100300",4498,1259,36,7,99,67,20,18,6004
"36019100400",3330,694,8,12,85,18,42,4,4193
"36019100600",4713,567,26,0,161,24,7,0,5498
"36019100700",3237,277,38,0,140,25,53,5,3775
"36019100800",3641,340,22,11,40,49,0,39,4142
"36019100900",3640,787,24,81,221,107,45,23,4928
"36019101000",3343,280,56,0,166,77,79,9,4010
"36019101100",72,39,0,0,0,0,0,0,111
"36019101300",1432,1046,139,46,28,119,22,205,3037
"36019101400",1356,273,15,0,74,4,0,3,1725
"36019101600",1170,323,25,8,35,23,34,18,1636
"36019101700",4412,634,0,3,112,9,35,20,5225
"36019101800",5058,271,6,8,42,0,32,0,5417
"36019101900",6086,512,118,64,179,22,83,55,7119
"36019102000",2512,501,29,0,16,55,24,0,3137
"36019102100",1512,345,0,0,58,29,17,0,1961
"36019102200",1856,941,47,83,98,45,34,45,3149
"36021000100",1993,151,67,0,136,33,38,0,2418
"36021000200",1254,109,0,0,75,17,37,0,1492
"36021000300",3538,231,15,14,80,71,73,72,4094
"36021000401",2303,47,25,5,14,0,7,7,2408
"36021000402",5228,216,92,0,178,35,200,20,5969
"36021000500",1641,310,22,1,49,29,24,0,2076
"36021000600",2489,205,50,0,0,1,9,8,2762
"36021000700",4662,219,85,49,93,8,58,3,5177
"36021000800",1271,187,32,0,13,0,10,0,1513
"36021000900",1437,128,129,0,27,5,30,0,1756
"36021001000",4913,454,23,23,247,42,178,3,5883
"36021001100",3090,350,110,48,361,40,57,104,4160
"36021001200",1212,555,558,193,745,167,322,134,3886
"36021001300",1752,312,250,16,171,120,64,98,2783
"36021001400",2787,386,56,19,110,13,275,157,3803
"36021001500",1052,189,0,1,7,0,37,3,1289
"36021001600",2974,500,0,16,84,0,106,12,3692
"36021001700",1223,200,96,0,49,24,21,30,1643
"36021001800",1645,83,2,2,53,0,29,0,1814
"36021001900",1490,272,5,0,104,22,93,18,2004
"36021002000",1815,129,5,11,111,0,83,0,2154
"36023970100",3017,297,14,3,93,24,46,16,3510
"36023970200",5261,574,10,28,4,33,13,3,5926
"36023970300",2440,242,62,0,265,36,169,27,3241
"36023970400",2590,281,0,2,52,68,91,0,3084
"36023970500",2779,464,0,0,220,0,196,0,3659
"36023970600",2234,495,299,1,41,0,147,0,3217
"36023970700",3477,1165,14,36,126,36,60,108,5022
"36023970800",86,56,0,0,0,0,0,0,142
"36023970900",2922,980,159,89,271,81,41,23,4566
"36023971000",4686,289,14,0,121,0,33,0,5143
"36023971100",4112,557,25,0,173,5,76,5,4953
"36023971200",3535,331,31,0,265,0,29,0,4191
"36025970100",3720,600,11,0,142,0,64,0,4537
"36025970200",2573,265,3,3,162,18,92,17,3133
"36025970300",2026,136,30,8,10,0,3,3,2216
"36025970400",5123,476,0,0,77,0,137,0,5813
"36025970500",3803,376,31,92,59,13,61,14,4449
"36025970600",4323,1089,0,7,49,16,54,57,5595
"36025970700",1892,396,38,0,31,0,83,0,2440
"36025970800",2838,333,30,38,38,7,22,11,3317
"36025970900",0,0,0,0,7,0,0,0,7
"36025971000",2549,472,40,12,18,66,25,51,3233
"36025971100",1842,356,74,9,57,0,8,43,2389
"36025971200",2810,435,21,10,281,71,328,97,4053
"36025971300",1431,419,4,0,48,0,35,0,1937
"36025971400",2706,298,25,37,51,31,29,31,3208
"36027010000",3498,227,209,32,180,169,330,170,4815
"36027020003",3791,279,218,35,113,0,227,0,4663
"36027020004",2580,75,7,20,96,0,280,0,3058
"36027020005",4866,117,178,2,308,0,424,0,5895
"36027030000",3687,350,20,46,160,15,40,110,4428
"36027040001",4083,361,33,0,334,6,378,0,5195
"36027040003",2635,279,398,51,396,34,507,153,4453
"36027050102",3425,89,76,0,213,1,358,1,4163
"36027050103",4592,234,271,23,484,29,527,12,6172
"36027050104",6047,99,31,0,719,18,406,0,7320
"36027050203",4368,177,102,2,393,29,243,102,5416
"36027050204",2303,42,55,2,277,0,316,0,2995
"36027050205",4806,39,57,2,213,0,329,0,5446
"36027060100",2811,409,541,51,677,23,438,26,4976
"36027060201",2743,59,238,0,124,30,233,30,3457
"36027060202",3083,450,184,23,541,21,452,152,4906
"36027060301",3730,196,338,0,407,2,335,16,5024
"36027060302",1614,24,123,0,631,1,239,1,2633
"36027060400",1352,212,85,0,274,0,197,47,2167
"36027070101",3390,251,207,7,304,0,186,22,4367
"36027070102",2894,263,154,20,80,0,238,20,3669
"36027070201",2566,432,156,19,72,9,82,19,3355
"36027070301",5140,193,344,56,193,7,181,5,6119
"36027070401",2080,357,209,1,320,16,33,10,3026
"36027080103",3887,188,118,75,432,58,362,100,5220
"36027080104",3359,88,23,12,283,48,289,14,4116
"36027080201",3970,18,255,0,156,7,423,0,4829
"36027080202",2249,92,80,2,241,0,102,0,2766
"36027090000",1912,65,68,0,197,0,98,0,2340
"36027100000",2528,138,76,0,244,25,294,51,3356
"36027110003",3737,62,134,4,204,4,96,4,4245
"36027110004",1674,54,14,4,81,54,254,53,2188
"36027110005",1716,136,62,11,281,56,444,89,2795
"36027120000",2201,173,4,2,162,0,196,1,2739
"36027130003",4766,239,204,45,342,2,228,2,5828
"36027130004",1359,96,39,1,38,4,99,2,1638
"36027130005",1935,309,163,0,143,1,239,60,2850
"36027140101",2052,608,537,102,244,74,444,140,4201
"36027140200",4872,382,1061,83,513,124,970,13,8018
"36027140300",3004,814,1250,51,542,128,502,132,6423
"36027140400",4135,50,334,2,542,6,335,6,5410
"36027140500",1589,250,216,83,724,141,165,48,3216
"36027140602",1833,230,182,0,452,40,295,131,3163
"36027140700",5198,135,631,100,775,67,361,67,7334
"36027140801",2070,296,47,22,200,209,227,196,3267
"36027150003",1092,298,1,3,137,8,200,11,1750
"36027150004",3304,182,27,0,265,36,85,44,3943
"36027150005",2381,97,0,7,43,0,15,7,2550
"36027150006",1365,185,11,1,166,32,76,24,1860
"36027160003",2074,40,29,19,16,43,40,39,2300
"36027160004",2216,60,22,4,43,0,62,0,2407
"36027160005",1981,280,66,11,115,12,62,34,2561
"36027170000",3043,197,200,83,194,48,313,42,4120
"36027180001",4575,129,16,10,134,0,215,0,5079
"36027190101",3053,47,293,0,775,34,514,0,4716
"36027190102",1288,29,212,0,213,26,185,0,1953
"36027190203",2008,188,124,14,227,3,207,25,2796
"36027190204",4206,75,255,23,705,8,677,0,5949
"36027190301",2329,167,470,17,334,0,498,0,3815
"36027190401",1771,29,53,0,72,0,147,0,2072
"36027190402",2851,157,119,0,280,25,501,0,3933
"36027200001",2771,226,65,0,23,0,46,0,3131
"36027200002",1277,81,4,3,73,61,16,68,1583
"36027210101",3150,285,363,168,517,128,715,105,5431
"36027210201",2217,347,990,214,499,275,810,343,5695
"36027210301",3017,69,402,121,602,13,700,13,4937
"36027220100",1550,421,657,415,637,63,786,30,4559
"36027220201",932,384,839,486,309,85,481,131,3647
"36027220300",728,280,1631,1076,482,190,577,281,5245
"36027220700",813,109,865,271,239,122,208,71,2698
"36027220801",1912,502,483,356,492,234,479,463,4921
"36027220901",1642,211,1379,254,433,69,442,107,4537
"36027221001",2650,97,552,89,407,11,57,0,3863
"36027221100",1075,320,1008,186,882,740,1281,929,6421
"36027300000",2594,175,558,5,1521,438,1352,75,6718
"36027410000",1185,268,240,19,163,38,163,27,2103
"36027610000",0,0,0,0,0,0,0,0,0
"36027640001",0,0,0,0,0,0,0,0,0
"36027640002",60,24,24,153,23,6,42,44,376
"36029000110",1572,452,126,0,272,409,235,462,3528
"36029000200",2756,753,14,43,164,405,123,361,4619
"36029000500",1256,491,5,16,116,81,271,111,2347
"36029000600",3766,377,255,259,74,51,235,107,5124
"36029000700",3548,15,12,1,96,0,39,0,3711
"36029000800",3644,653,84,104,154,58,174,88,4959
"36029000900",2051,264,80,12,87,0,179,0,2673
"36029001000",3807,575,93,236,121,67,86,37,5022
"36029001100",1942,721,90,58,66,90,96,74,3137
"36029001402",128,21,1817,1204,84,16,40,29,3339
"36029001500",96,58,869,463,38,1,3,38,1566
"36029001600",271,187,534,588,128,319,0,127,2154
"36029001700",674,478,446,84,138,34,14,45,1913
"36029001900",2481,226,339,0,107,69,65,43,3330
"36029002300",1658,1001,158,259,44,103,15,327,3565
"36029002400",2330,804,356,422,84,370,56,196,4618
"36029002502",107,39,1287,390,31,116,0,82,2052
"36029002702",585,75,461,449,473,1031,0,13,3087
"36029002800",429,223,774,585,68,179,110,34,2402
"36029002900",475,200,670,555,113,31,0,20,2064
"36029003000",277,79,941,939,202,35,53,65,2591
"36029003100",65,48,1118,450,5,26,3,11,1726
"36029003301",49,38,2206,1218,136,0,75,0,3722
"36029003302",85,28,1637,1097,39,132,12,78,3108
"36029003400",20,20,1549,563,17,15,0,0,2184
"36029003500",34,66,1558,1023,20,42,70,3,2816
"36029003600",177,182,1267,886,23,41,38,0,2614
"36029003700",295,72,1850,1695,85,65,14,109,4185
"36029003800",299,4,1509,1271,94,53,198,21,3449
"36029003901",16,9,620,266,21,15,0,6,953
"36029004001",319,311,1785,1572,90,140,39,211,4467
"36029004100",321,58,3033,944,70,60,28,5,4519
"36029004200",277,36,1996,1375,36,0,0,0,3720
"36029004300",651,63,2587,2193,308,45,33,25,5905
"36029004401",250,28,2866,1039,7,15,0,0,4205
"36029004402",36,2,1003,1543,33,93,17,98,2825
"36029004500",3593,232,1147,250,184,179,94,0,5679
"36029004601",1424,289,541,54,512,626,63,47,3556
"36029004602",16,2,0,0,0,0,0,0,18
"36029004700",717,314,3403,791,516,364,67,144,6316
"36029004800",3415,199,395,9,213,4,295,4,4534
"36029004900",3871,484,471,176,551,41,345,10,5949
"36029005000",1228,122,384,344,71,96,146,87,2478
"36029005100",3147,485,708,138,172,21,202,167,5040
"36029005201",1941,265,212,101,115,6,62,0,2702
"36029005202",126,480,941,267,100,60,18,39,2031
"36029005300",411,35,155,156,69,40,10,6,882
"36029005400",2872,388,430,77,272,59,116,26,4240
"36029005500",1408,674,246,338,464,790,574,387,4881
"36029005600",1599,520,881,535,350,678,503,642,5708
"36029005700",1024,383,321,204,53,405,140,454,2984
"36029005801",1838,740,178,62,25,677,101,457,4078
"36029005802",2249,821,198,459,404,395,611,330,5467
"36029005900",1742,656,209,347,515,468,458,405,4800
"36029006100",1102,590,577,951,1044,511,497,544,5816
"36029006201",0,0,0,0,0,0,0,0,0
"36029006301",3105,759,245,0,363,348,127,377,5324
"36029006302",2364,224,20,13,27,0,92,0,2740
"36029006501",1694,230,175,180,319,101,267,39,3005
"36029006601",1298,505,113,72,322,483,202,126,3121
"36029006602",1365,141,234,85,65,135,89,135,2249
"36029006701",2192,218,252,68,404,131,267,71,3603
"36029006702",1552,362,461,205,150,187,19,158,3094
"36029006800",2184,656,114,266,170,165,130,164,3849
"36029006901",651,461,190,314,805,955,620,508,4504
"36029006902",1392,408,244,287,486,836,400,741,4794
"36029007000",682,268,197,302,392,696,324,730,3591
"36029007101",863,724,397,659,961,481,1358,1009,6452
"36029007102",597,393,331,583,341,526,388,781,3940
"36029007202",970,105,317,72,360,13,498,71,2406
"36029007302",7077,559,78,14,196,0,235,18,8177
"36029007303",6098,509,151,54,384,50,360,51,7657
"36029007304",4996,97,9,1,174,0,22,0,5299
"36029007600",2717,272,0,2,47,13,12,0,3063
"36029007700",3691,435,12,0,161,20,77,20,4416
"36029007800",4752,506,0,1,70,123,30,0,5482
"36029007901",2629,227,114,0,468,0,100,0,3538
"36029007902",5224,120,334,0,167,22,158,1,6026
"36029007903",3235,64,57,36,44,8,29,0,3473
"36029007904",2730,236,53,0,230,0,162,0,3411
"36029007905",3429,462,0,0,120,79,91,21,4202
"36029008001",4316,351,329,0,570,0,234,37,5837
"36029008002",4794,544,96,43,232,14,25,242,5990
"36029008003",4695,629,121,23,192,106,187,6,5959
"36029008101",4974,293,33,1,274,64,54,30,5723
"36029008102",3758,198,19,3,69,38,70,10,4165
"36029008201",2122,188,25,12,62,0,64,12,2485
"36029008202",3241,192,147,0,0,84,19,9,3692
"36029008300",1314,571,150,94,204,194,9,114,2650
"36029008400",1701,419,0,0,39,214,53,0,2426
"36029008500",2161,89,85,39,109,15,134,6,2638
"36029008600",3896,202,128,0,221,0,18,0,4465
"36029008700",4183,451,205,0,124,0,382,18,5363
"36029008800",2725,312,105,90,142,48,56,17,3495
"36029008900",3796,212,77,36,87,7,102,28,4345
"36029009004",3209,60,112,0,296,0,143,0,3820
"36029009006",6254,252,179,2,642,39,211,4,7583
"36029009007",6290,296,60,0,992,0,263,14,7915
"36029009008",3899,139,88,0,478,0,48,0,4652
"36029009009",3928,134,233,18,651,53,46,0,5063
"36029009010",4093,399,131,103,879,1,75,22,5703
"36029009104",3743,190,68,5,242,0,147,0,4395
"36029009106",2607,147,196,53,171,0,81,25,3280
"36029009107",3112,676,721,92,417,325,246,293,5882
"36029009109",2213,119,34,3,501,318,25,7,3220
"36029009110",0,4,0,0,0,3,0,0,7
"36029009112",1812,361,25,134,223,109,33,0,2697
"36029009113",5713,202,375,2,420,36,239,16,7003
"36029009114",3482,67,120,46,378,96,238,2,4429
"36029009115",1372,814,226,220,230,531,20,24,3437
"36029009116",3809,520,362,1,341,348,187,0,5568
"36029009200",2647,142,282,14,406,454,0,124,4069
"36029009301",2501,689,746,218,552,263,36,29,5034
"36029009302",1947,254,188,6,231,40,44,0,2710
"36029009401",4348,430,300,15,322,9,101,13,5538
"36029009402",3928,155,83,0,114,0,134,15,4429
"36029009501",4441,67,398,80,62,10,29,0,5087
"36029009502",5616,366,90,14,413,20,125,28,6672
"36029009600",5029,351,101,74,471,40,222,0,6288
"36029009701",2752,157,35,0,65,11,46,0,3066
"36029009702",4188,198,12,0,150,12,69,29,4658
"36029009800",1469,248,0,0,0,4,96,4,1821
"36029009900",3075,438,90,0,13,26,33,0,3675
"36029010001",2694,208,0,0,52,10,61,0,3025
"36029010002",3700,135,0,25,41,39,63,28,4031
"36029010003",3251,365,69,41,176,77,77,1,4057
"36029010101",3603,124,624,35,115,0,72,14,4587
"36029010102",1755,468,680,260,271,33,80,181,3728
"36029010103",3423,384,284,11,33,0,12,0,4147
"36029010201",1876,102,520,144,190,0,0,0,2832
"36029010202",1040,122,1231,287,171,48,95,100,3094
"36029010300",561,152,332,197,204,77,106,16,1645
"36029010400",1211,352,373,110,92,137,84,63,2422
"36029010500",1461,321,344,185,114,0,28,0,2453
"36029010600",2098,178,141,0,48,0,56,0,2521
"36029010700",1910,298,172,36,67,0,48,0,2531
"36029010803",1744,125,0,0,17,0,0,0,1886
"36029010804",3710,159,57,0,114,9,75,12,4136
"36029010805",4895,156,0,0,67,0,126,0,5244
"36029010807",4136,404,225,74,294,57,255,35,5480
"36029010808",2677,309,271,40,488,99,172,19,4075
"36029010809",3146,20,0,28,88,0,51,0,3333
"36029010901",1782,131,45,1,252,12,237,12,2472
"36029010902",3439,384,350,115,0,18,129,20,4455
"36029011000",1431,251,0,0,55,102,4,49,1892
"36029011100",2045,181,90,0,0,6,53,6,2381
"36029011200",6154,250,15,0,59,52,51,0,6581
"36029011300",4366,261,109,222,163,0,0,5,5126
"36029011400",1597,452,84,90,158,0,143,10,2534
"36029011500",1391,111,0,12,23,0,78,12,1627
"36029011600",1907,46,0,0,81,13,52,0,2099
"36029011700",3438,383,10,9,18,15,64,15,3952
"36029011800",3447,101,30,40,19,17,14,3,3671
"36029012001",3764,461,15,0,107,0,147,0,4494
"36029012002",3147,81,17,0,82,28,36,0,3391
"36029012003",4715,146,0,7,79,0,94,0,5041
"36029012300",2121,628,136,49,110,72,133,150,3399
"36029012400",1373,439,51,0,37,100,41,88,2129
"36029012501",3920,684,0,23,185,60,188,47,5107
"36029012502",1600,167,6,0,3,133,30,108,2047
"36029012800",2087,331,17,25,72,27,21,32,2612
"36029012901",5456,442,127,0,180,227,193,18,6643
"36029012902",3249,174,29,22,10,0,31,0,3515
"36029013001",2778,185,66,0,13,146,0,0,3188
"36029013002",4561,579,62,0,128,0,51,30,5411
"36029013101",5732,360,203,1,102,0,28,0,6426
"36029013102",7473,361,132,7,141,0,174,0,8288
"36029013201",5156,628,17,34,201,2,253,2,6293
"36029013202",4758,198,30,0,69,8,103,8,5174
"36029013300",3273,93,16,8,221,21,303,21,3956
"36029013400",6111,173,0,0,57,0,122,0,6463
"36029013501",6665,80,13,0,137,0,227,0,7122
"36029013502",6879,157,17,0,44,0,36,0,7133
"36029013600",2922,64,42,38,11,13,47,1,3138
"36029013701",5989,184,77,2,63,0,69,0,6384
"36029013702",5159,151,44,0,205,8,135,28,5730
"36029013800",6997,507,1,0,221,0,220,0,7946
"36029013900",2085,87,0,3,42,0,0,0,2217
"36029014000",3292,128,0,30,80,0,85,0,3615
"36029014101",5725,208,0,1,73,0,73,0,6080
"36029014102",5261,187,0,0,63,0,12,0,5523
"36029014204",3442,227,9,3,45,2,65,2,3795
"36029014206",7010,179,0,2,0,9,310,9,7519
"36029014207",4946,97,53,56,148,111,22,77,5510
"36029014208",4801,117,57,0,83,0,62,0,5120
"36029014209",3862,63,44,0,92,2,35,2,4100
"36029014300",5409,316,1,0,313,0,77,0,6116
"36029014400",3651,450,0,1,47,76,24,9,4258
"36029014501",3152,272,1,1,35,0,8,18,3487
"36029014502",1694,569,0,2,0,150,32,150,2597
"36029014601",4465,201,93,0,246,0,136,0,5141
"36029014603",3485,81,98,1,558,0,47,0,4270
"36029014604",7355,135,39,0,569,0,184,0,8282
"36029014701",4803,216,40,23,239,16,112,2,5451
"36029014702",7246,338,37,43,454,10,99,21,8248
"36029014801",2209,148,0,1,135,0,54,0,2547
"36029014803",5686,220,106,16,103,0,0,0,6131
"36029014901",2238,345,0,3,14,6,38,0,2644
"36029014903",5486,404,0,37,149,0,19,1,6096
"36029014904",0,0,0,0,0,0,0,0,0
"36029015001",5059,235,0,0,47,0,151,0,5492
"36029015002",2669,296,0,0,56,0,81,0,3102
"36029015003",2865,438,1,0,21,6,51,10,3392
"36029015101",3036,194,2,0,36,0,0,0,3268
"36029015102",2603,146,0,0,21,0,21,6,2797
"36029015201",2958,96,0,70,11,0,0,70,3205
"36029015202",4720,158,3,3,0,0,0,18,4902
"36029015301",4451,225,0,3,0,3,55,3,4740
"36029015302",2795,131,0,0,0,0,29,0,2955
"36029015401",2234,255,22,0,11,0,20,0,2542
"36029015402",4683,560,0,0,226,7,108,26,5610
"36029015501",1522,199,0,0,65,27,42,7,1862
"36029015503",2076,234,26,12,59,48,16,0,2471
"36029015504",3571,352,1,0,137,7,46,0,4114
"36029015600",1726,134,3,0,101,88,32,68,2152
"36029015700",3183,230,3,2,47,4,10,0,3479
"36029015800",3802,331,8,0,47,16,0,0,4204
"36029015900",3471,494,38,16,73,30,60,31,4213
"36029016100",20,1,1,1,3,1,3,1,31
"36029016200",1489,96,90,60,189,0,176,6,2106
"36029016300",1661,434,0,257,116,94,111,126,2799
"36029016400",879,336,941,630,324,6,293,84,3493
"36029016500",518,318,103,76,55,37,53,94,1254
"36029016600",13,20,1748,820,65,30,8,1,2705
"36029016700",1889,386,31,5,17,20,71,150,2569
"36029016800",114,18,2168,1060,137,99,181,44,3821
"36029016900",1766,273,522,289,239,78,127,22,3316
"36029017000",65,7,1800,715,97,30,30,10,2754
"36029017100",831,649,421,1340,793,1080,272,816,6202
"36029017200",1642,317,0,0,49,132,1,38,2179
"36029017300",6447,225,0,13,114,0,61,0,6860
"36029017400",1248,919,632,697,175,319,254,405,4649
"36029017501",964,250,0,0,174,3,0,1,1392
"36029017502",2208,252,7,4,30,0,0,0,2501
"36029940000",50,32,4,0,1292,472,121,57,2028
"36029940100",0,0,0,0,17,0,0,0,17
"36029990000",0,0,0,0,0,0,0,0,0
"36031960100",2401,231,2,3,42,28,35,12,2754
"36031960200",2454,222,4,3,40,3,5,2,2733
"36031960300",2777,220,5,2,11,3,24,3,3045
"36031960498",2447,123,56,23,32,25,25,0,2731
"36031960598",3575,319,22,35,74,53,122,49,4249
"36031960700",1652,293,1,0,33,13,11,0,2003
"36031960800",1692,157,0,2,29,10,8,3,1901
"36031960900",2908,406,0,8,102,63,49,57,3593
"36031961000",4010,512,8,12,81,2,18,0,4643
"36031961100",1643,138,3,0,50,9,0,0,1843
"36031961200",3910,880,25,1,81,11,0,3,4911
"36031961300",1111,169,0,3,46,2,14,2,1347
"36031961400",1071,174,1,0,4,1,0,3,1254
"36033940000",121,105,0,0,2001,1005,72,0,3304
"36033950100",3473,752,16,12,79,7,17,23,4379
"36033950200",2940,855,11,33,820,165,34,29,4887
"36033950300",4754,1284,11,23,87,17,101,11,6288
"36033950400",4095,713,26,25,102,41,0,0,5002
"36033950501",2391,832,23,103,38,83,77,52,3599
"36033950502",1407,265,0,0,33,0,7,12,1724
"36033950600",1358,258,0,0,56,9,23,4,1708
"36033950700",1679,467,6,1,12,12,20,3,2200
"36033950800",1575,134,4,0,23,0,12,3,1751
"36033950900",2795,688,28,26,129,4,8,0,3678
"36033951000",1778,160,7,20,0,3,0,0,1968
"36033951100",2772,610,4,105,6,0,0,4,3501
"36033951200",1915,184,7,0,29,0,4,0,2139
"36035970100",2255,359,0,0,39,1,17,0,2671
"36035970200",2286,350,3,0,26,21,52,3,2741
"36035970300",3167,490,0,0,34,27,0,0,3718
"36035970400",1587,218,0,0,34,21,0,8,1868
"36035970500",3278,622,30,0,67,6,14,0,4017
"36035970600",5552,810,33,0,103,0,76,21,6595
"36035970700",2439,935,31,95,17,144,32,176,3869
"36035970800",2056,766,78,20,140,11,33,39,3143
"36035970900",2583,764,90,32,60,60,163,52,3804
"36035971000",1976,432,11,7,3,25,6,34,2494
"36035971100",1588,528,0,0,70,64,0,120,2370
"36035971200",3303,441,59,0,110,48,67,6,4034
"36035971300",3465,620,49,2,150,31,50,2,4369
"36035971400",3006,379,21,0,59,0,17,2,3484
"36035971500",4790,313,0,0,118,10,183,3,5417
"36037940100",16,9,0,0,428,90,0,0,543
"36037950100",4630,535,43,8,106,40,43,47,5452
"36037950200",4875,361,54,19,222,136,304,94,6065
"36037950300",5147,621,70,0,139,50,72,0,6099
"36037950400",6031,559,0,4,192,10,229,40,7065
"36037950500",2433,312,77,7,93,3,0,3,2928
"36037950600",1554,578,49,111,148,27,65,91,2623
"36037950700",1291,325,102,329,37,29,45,44,2202
"36037950800",1591,640,51,83,24,56,11,91,2547
"36037950900",1791,251,52,54,186,31,132,44,2541
"36037951000",1799,237,59,162,137,39,44,9,2486
"36037951100",4556,299,35,76,173,65,13,3,5220
"36037951200",3962,323,186,0,113,10,167,13,4774
"36037951300",3697,442,32,5,25,29,16,0,4246
"36037951400",5210,423,18,8,33,45,24,46,5807
"36039080100",3076,125,9,12,30,1,40,0,3293
"36039080201",3173,478,0,0,32,0,22,19,3724
"36039080202",2353,315,9,0,20,9,0,0,2706
"36039080300",2644,344,10,0,47,3,106,0,3154
"36039080401",1936,500,0,13,194,4,165,0,2812
"36039080402",1725,335,0,0,40,0,50,43,2193
"36039080501",1954,422,95,0,22,0,69,0,2562
"36039080502",3133,816,0,6,124,4,0,21,4104
"36039080600",2788,260,43,0,108,44,244,134,3621
"36039080700",2322,207,143,134,23,0,75,0,2904
"36039080800",0,0,0,0,0,0,0,0,0
"36039080900",3408,327,47,12,134,100,242,51,4321
"36039081000",2695,822,344,211,119,87,89,39,4406
"36039081101",3275,300,29,0,199,0,0,0,3803
"36039081102",1957,366,288,0,439,39,399,25,3513
"36041950100",867,68,0,2,14,1,25,0,977
"36041950300",999,63,1,1,50,0,0,3,1117
"36041950400",1390,227,0,3,1,3,16,2,1642
"36041950500",922,80,1,3,62,0,7,0,1075
"36043010100",5196,643,26,35,212,30,154,47,6343
"36043010201",2616,681,18,24,51,52,18,64,3524
"36043010202",3621,402,28,1,43,13,30,13,4151
"36043010300",4245,555,8,23,116,151,72,88,5258
"36043010400",2199,1208,2,6,54,22,0,0,3491
"36043010501",2126,450,2,0,29,3,0,65,2675
"36043010502",1592,232,0,0,0,0,13,1,1838
"36043010701",1988,628,6,1,76,34,0,10,2743
"36043010702",1607,350,6,34,90,0,28,0,2115
"36043010900",2858,409,14,0,40,51,6,0,3378
"36043011001",1630,369,2,10,0,0,28,6,2045
"36043011002",2752,492,1,0,84,3,8,0,3340
"36043011100",1507,493,6,0,54,0,12,128,2200
"36043011200",4261,1012,16,137,241,8,44,8,5727
"36043011301",1448,163,15,0,58,0,0,0,1684
"36043011302",3063,303,0,0,7,5,75,5,3458
"36043011400",4176,365,44,0,82,0,83,0,4750
"36043011501",2623,400,7,2,136,24,47,24,3263
"36043011502",1928,194,0,2,3,3,74,3,2207
"36045060100",3748,596,28,0,68,11,39,7,4497
"36045060200",5593,497,24,29,70,14,66,0,6293
"36045060300",3429,454,8,5,129,6,27,0,4058
"36045060400",6386,807,16,20,172,2,116,5,7524
"36045060500",4028,203,325,5,459,69,290,14,5393
"36045060600",4463,539,592,13,557,232,742,189,7327
"36045060700",3664,410,33,0,138,11,119,6,4381
"36045060803",3042,716,635,206,1124,122,1131,34,7010
"36045060804",3200,385,490,86,861,301,924,223,6470
"36045060900",4435,1388,105,2,207,23,201,6,6367
"36045061000",2836,337,198,0,288,13,341,24,4037
"36045061100",4567,347,165,15,647,98,314,109,6262
"36045061200",1864,985,195,57,234,35,183,113,3666
"36045061300",1456,714,73,82,386,203,185,9,3108
"36045061400",2525,1221,37,18,75,31,69,82,4058
"36045061500",2828,346,576,31,446,36,241,61,4565
"36045061600",3025,719,29,48,246,4,53,6,4130
"36045061700",1931,258,4,4,79,0,51,6,2333
"36045061800",6017,827,9,13,333,10,151,0,7360
"36045061900",2878,627,65,25,77,76,101,11,3860
"36045062100",2827,793,333,97,124,152,107,134,4567
"36045062200",3508,327,88,3,303,107,157,62,4555
"36045062400",3469,336,167,0,205,39,100,19,4335
"36045062500",2657,712,38,0,15,2,3,2,3429
"36045980000",0,17,0,0,0,0,0,0,17
"36045990001",0,0,0,0,0,0,0,0,0
"36047000100",2733,416,313,97,650,158,474,111,4952
"36047000200",233,91,79,67,592,476,789,532,2859
"36047000301",2813,408,155,62,365,120,356,126,4405
"36047000501",2660,271,205,1,508,50,56,66,3817
"36047000502",1994,110,59,33,295,47,166,10,2714
"36047000700",2976,130,52,0,567,14,264,3,4006
"36047000900",2633,166,96,113,783,5,268,35,4099
"36047001100",418,33,74,0,148,28,69,0,770
"36047001300",1177,469,162,133,394,292,181,251,3059
"36047001500",1854,333,801,387,1246,590,493,575,6279
"36047001800",0,0,0,0,0,0,0,0,0
"36047002000",399,26,115,6,588,187,847,219,2387
"36047002100",2904,88,104,90,505,65,188,70,4014
"36047002200",1506,473,87,27,1785,775,2168,819,7640
"36047002300",172,171,1380,1208,773,666,508,666,5544
"36047002901",34,225,759,968,423,868,395,729,4401
"36047003000",1275,173,21,34,340,27,380,20,2270
"36047003100",510,5,699,25,425,34,159,39,1896
"36047003300",1486,325,218,100,728,141,459,206,3663
"36047003400",2087,587,27,0,415,1,270,15,3402
"36047003500",524,18,763,63,338,17,117,0,1840
"36047003600",2532,306,184,2,1446,19,556,2,5047
"36047003700",554,49,26,3,103,56,69,52,912
"36047003800",1255,21,14,0,311,72,226,0,1899
"36047003900",1338,101,265,115,592,77,364,51,2903
"36047004100",2277,123,313,110,466,43,206,41,3579
"36047004300",1953,86,40,31,671,107,418,95,3401
"36047004400",1958,119,9,0,277,19,97,71,2550
"36047004500",2977,97,39,5,287,33,231,2,3671
"36047004600",1088,145,9,0,149,0,68,45,1504
"36047004700",906,53,202,53,417,68,363,72,2134
"36047004900",1515,105,21,0,293,9,252,9,2204
"36047005000",2188,61,12,2,199,6,250,1,2719
"36047005100",1577,95,105,0,395,9,396,77,2654
"36047005201",1065,316,0,19,101,215,94,16,1826
"36047005202",2020,111,80,11,217,0,138,0,2577
"36047005300",1118,189,164,129,710,196,605,282,3393
"36047005400",2388,540,21,0,540,32,314,70,3905
"36047005601",1916,119,81,129,264,113,314,115,3051
"36047005602",1267,117,0,0,478,0,355,0,2217
"36047005800",2075,518,10,0,520,279,518,41,3961
"36047005900",706,183,114,80,180,11,122,90,1486
"36047006000",2004,280,12,0,416,86,305,63,3166
"36047006200",1705,201,28,137,573,233,561,8,3446
"36047006300",1559,147,18,0,212,7,222,72,2237
"36047006400",2595,271,45,8,547,152,123,60,3801
"36047006500",4457,350,44,48,349,71,328,0,5647
"36047006600",2419,479,52,3,950,30,774,106,4813
"36047006700",3235,95,19,15,243,9,245,21,3882
"36047006800",2228,1160,64,26,1196,527,1132,425,6758
"36047006900",2621,160,119,0,990,11,812,39,4752
"36047007000",1463,315,106,19,644,125,389,36,3097
"36047007100",1212,407,1193,581,720,722,955,1009,6799
"36047007200",388,134,32,15,965,750,404,719,3407
"36047007400",980,504,130,95,2794,1097,2766,1249,9615
"36047007500",3397,155,0,2,1338,17,712,112,5733
"36047007600",978,298,187,0,1562,1407,1406,1373,7211
"36047007700",3059,214,97,7,957,18,612,14,4978
"36047007800",1739,681,331,4,2117,675,3094,1255,9896
"36047008000",1092,393,171,0,2041,535,2609,652,7493
"36047008200",885,448,137,32,1874,928,2183,976,7463
"36047008400",1171,282,26,11,1492,923,1887,1036,6828
"36047008500",695,336,1644,1547,771,1661,1585,1921,10160
"36047008600",0,0,0,0,0,0,0,0,0
"36047008800",1123,213,52,0,1385,353,1757,349,5232
"36047009000",553,162,0,0,1684,931,1168,342,4840
"36047009200",987,279,117,63,2189,1587,1281,886,7389
"36047009400",1119,347,74,4,2697,1724,1050,209,7224
"36047009600",1610,961,68,9,2761,1052,2312,1089,9862
"36047009800",1200,529,117,45,3076,2627,2337,1768,11699
"36047010000",860,374,105,22,2901,2119,1278,1180,8839
"36047010100",1504,384,93,8,1593,538,1868,864,6852
"36047010200",743,277,47,0,3320,870,960,261,6478
"36047010400",358,105,9,0,3770,1837,593,146,6818
"36047010600",400,52,0,70,2824,2573,438,199,6556
"36047010800",562,96,26,9,2334,1634,502,152,5315
"36047011000",668,144,68,0,1022,576,829,332,3639
"36047011200",2145,1257,226,18,1897,960,1787,678,8968
"36047011400",1582,1344,121,23,1023,246,331,206,4876
"36047011600",376,293,72,11,2752,1019,353,81,4957
"36047011700",1752,206,70,0,616,105,685,145,3579
"36047011800",352,8,0,43,1064,583,351,93,2494
"36047011900",1169,48,34,17,572,66,667,66,2639
"36047012000",42,48,0,0,643,467,5,23,1228
"36047012100",1133,61,24,25,549,7,472,0,2271
"36047012200",1130,273,54,9,2311,1398,1633,952,7760
"36047012600",846,310,35,14,941,633,665,306,3750
"36047012700",974,238,1137,385,825,266,840,379,5044
"36047012801",668,118,39,0,892,248,180,96,2241
"36047012901",1199,132,99,20,1056,218,884,158,3766
"36047012902",1144,176,217,12,372,72,425,57,2475
"36047013000",2310,756,102,14,1249,540,795,318,6084
"36047013100",2369,137,428,82,855,236,791,262,5160
"36047013200",945,80,14,0,745,294,231,15,2324
"36047013300",3487,104,106,57,680,89,597,13,5133
"36047013400",2753,217,0,10,881,168,616,64,4709
"36047013500",2598,77,381,8,597,74,409,51,4195
"36047013600",2568,555,24,8,559,102,299,72,4187
"36047013700",2107,291,151,79,574,88,595,170,4055
"36047013800",2468,526,0,8,421,239,481,304,4447
"36047013900",2037,274,328,35,687,99,619,24,4103
"36047014000",1517,145,0,0,194,6,165,43,2070
"36047014100",2326,103,272,26,1164,89,853,68,4901
"36047014200",1695,508,50,0,618,268,487,55,3681
"36047014300",1735,111,88,37,1256,528,1364,537,5656
"36047014500",2317,562,191,23,1374,162,1570,98,6297
"36047014700",1115,264,84,0,638,143,659,296,3199
"36047014800",1163,112,0,0,47,31,11,0,1364
"36047014900",4337,238,185,75,852,17,931,111,6746
"36047015000",1330,65,0,2,221,30,57,18,1723
"36047015100",2821,179,140,12,809,33,670,41,4705
"36047015200",1628,167,6,4,595,41,181,20,2642
"36047015300",2186,119,99,0,328,25,248,25,3030
"36047015400",0,0,0,0,0,0,0,0,0
"36047015500",2856,107,273,0,369,77,122,8,3812
"36047015700",3597,70,152,3,552,23,245,3,4645
"36047015900",3774,189,514,22,638,1,322,19,5479
"36047016000",2406,363,182,29,894,541,913,195,5523
"36047016100",2026,214,403,10,463,35,327,44,3522
"36047016200",1389,225,110,0,775,71,327,19,2916
"36047016300",1677,177,632,73,416,76,156,59,3266
"36047016400",418,84,290,0,67,0,304,0,1163
"36047016500",4163,296,173,3,942,61,427,46,6111
"36047016600",2014,153,0,0,66,6,206,65,2510
"36047016700",3956,114,90,0,581,187,516,114,5558
"36047016800",1196,68,80,0,253,85,43,0,1725
"36047016900",2766,466,213,15,736,424,435,348,5403
"36047017000",1836,141,0,0,1254,527,466,26,4250
"36047017100",3279,164,50,18,454,2,219,50,4236
"36047017200",1649,45,104,0,2277,28,580,2,4685
"36047017400",1139,103,0,0,781,41,224,0,2288
"36047017500",0,0,0,0,0,0,0,0,0
"36047017600",975,128,14,0,922,159,402,60,2660
"36047017700",0,0,0,0,0,0,0,0,0
"36047017800",925,95,29,0,1470,363,552,137,3571
"36047017900",824,108,1979,432,447,98,563,210,4661
"36047018000",1402,582,0,0,765,504,720,8,3981
"36047018100",1955,150,731,36,535,123,457,95,4082
"36047018200",1259,69,39,0,1299,552,463,144,3825
"36047018300",1451,98,527,0,551,83,287,61,3058
"36047018400",1170,48,39,0,862,69,47,12,2247
"36047018501",329,401,1471,1262,426,590,469,780,5728
"36047018600",1331,18,23,0,690,100,146,0,2308
"36047018700",603,41,347,60,443,74,304,102,1974
"36047018800",1653,136,11,6,991,153,217,36,3203
"36047019000",1878,429,28,25,2004,946,1044,545,6899
"36047019100",925,267,609,109,484,378,439,374,3585
"36047019200",1418,599,0,5,1015,219,261,175,3692
"36047019300",946,456,2241,178,576,39,719,20,5175
"36047019400",964,189,35,30,2172,263,479,7,4139
"36047019500",1552,293,1315,126,522,180,660,63,4711
"36047019600",1542,516,102,47,2266,820,700,493,6486
"36047019700",1401,162,1029,240,469,39,210,10,3560
"36047019800",1260,149,23,11,367,93,63,0,1966
"36047019900",1184,152,835,165,478,61,213,64,3152
"36047020000",1122,209,0,0,798,53,395,94,2671
"36047020100",1533,119,1574,123,455,10,382,19,4215
"36047020200",1339,68,0,0,524,43,99,0,2073
"36047020300",749,113,273,151,283,55,89,34,1747
"36047020400",1241,127,0,0,372,109,23,0,1872
"36047020500",1452,96,653,61,314,31,129,4,2740
"36047020600",1620,73,17,2,814,85,186,6,2803
"36047020700",2386,59,1120,53,656,128,571,42,5015
"36047020800",1457,201,9,25,1076,385,108,56,3317
"36047021000",1512,439,12,19,2357,752,489,54,5634
"36047021100",293,22,563,115,215,46,269,67,1590
"36047021200",1023,249,22,0,2854,982,142,30,5302
"36047021300",576,178,2725,763,135,22,136,11,4546
"36047021400",689,547,0,0,972,335,119,44,2706
"36047021500",2244,175,1983,229,473,262,571,93,6030
"36047021600",1740,1730,0,0,461,261,75,171,4438
"36047021700",1096,81,1435,419,514,65,238,38,3886
"36047021800",2144,2002,0,23,313,148,60,256,4946
"36047021900",627,127,1752,750,472,109,325,73,4235
"36047022000",2406,2010,9,5,438,132,319,24,5343
"36047022100",1039,232,1867,635,466,215,609,232,5295
"36047022200",2048,2037,32,11,262,81,389,180,5040
"36047022400",2862,1463,91,9,857,753,817,585,7437
"36047022600",646,62,11,14,1269,421,1082,239,3744
"36047022700",649,74,1891,338,267,222,379,77,3897
"36047022800",1530,450,41,15,968,509,497,302,4312
"36047022900",995,49,1848,335,381,135,159,133,4035
"36047023000",1861,1467,55,0,523,302,474,363,5045
"36047023100",1293,323,986,271,414,145,147,69,3648
"36047023200",2577,2702,0,40,543,280,468,150,6760
"36047023300",787,218,1889,913,682,309,605,213,5616
"36047023400",2674,2753,0,0,26,0,24,0,5477
"36047023500",1304,1557,681,138,293,325,638,303,5239
"36047023600",2977,2373,0,8,97,15,158,0,5628
"36047023800",2969,1184,0,0,0,14,227,0,4394
"36047024000",2386,1747,0,20,132,42,129,29,4485
"36047024100",811,370,705,52,258,90,444,59,2789
"36047024200",1680,885,10,0,290,54,112,26,3057
"36047024300",907,136,2235,439,420,70,484,78,4769
"36047024400",1344,1233,12,1,717,216,457,180,4160
"36047024500",440,59,2127,815,351,93,101,42,4028
"36047024600",1575,619,29,1,987,341,78,126,3756
"36047024700",353,41,1101,305,151,48,155,8,2162
"36047024800",1370,310,41,0,828,327,482,159,3517
"36047024900",440,187,2556,434,97,115,62,54,3945
"36047025000",345,88,24,9,874,235,116,15,1706
"36047025100",178,104,1744,854,234,142,129,187,3572
"36047025200",2896,270,67,0,1579,487,941,42,6282
"36047025300",498,168,1068,196,260,148,359,182,2879
"36047025400",1187,192,0,0,2061,619,462,145,4666
"36047025500",510,512,1615,842,708,1065,1447,1852,8551
"36047025600",1042,198,0,0,1708,295,270,49,3562
"36047025700",322,151,578,173,434,268,555,376,2857
"36047025800",1857,479,1,1,1388,719,368,331,5144
"36047025901",432,150,518,218,146,110,383,238,2195
"36047025902",271,429,1030,1262,88,511,674,849,5114
"36047026000",1144,149,44,0,1679,594,252,70,3932
"36047026100",967,281,2450,990,271,103,588,231,5881
"36047026200",1159,199,16,0,998,255,422,98,3147
"36047026300",169,21,1350,331,120,99,145,153,2388
"36047026400",1487,409,0,18,2212,559,553,194,5432
"36047026500",388,51,1934,978,242,140,152,134,4019
"36047026600",2026,264,0,11,1209,128,392,152,4182
"36047026700",446,94,1970,469,179,122,270,49,3599
"36047026800",1835,464,8,0,1148,409,804,255,4923
"36047026900",417,19,1975,337,40,35,278,137,3238
"36047027000",1300,312,19,0,582,125,101,102,2541
"36047027100",78,93,1633,525,223,90,98,15,2755
"36047027200",1497,541,0,0,1437,164,592,11,4242
"36047027300",162,6,1625,635,124,30,95,32,2709
"36047027400",1135,289,5,1,1208,148,50,55,2891
"36047027500",444,98,2240,808,584,100,488,104,4866
"36047027600",1220,224,0,10,2366,796,1164,243,6023
"36047027700",157,10,2327,1957,76,40,298,53,4918
"36047027800",1233,202,0,22,1214,469,245,6,3391
"36047027900",192,56,3038,367,147,125,271,69,4265
"36047028000",906,59,6,1,577,123,69,19,1760
"36047028100",621,827,1684,1013,387,526,807,1348,7213
"36047028200",1413,183,0,14,1090,414,113,10,3237
"36047028300",341,268,1261,781,512,405,792,714,5074
"36047028400",1948,302,11,40,1020,373,536,62,4292
"36047028501",144,34,0,2,198,0,206,0,584
"36047028502",159,204,974,809,299,107,603,341,3496
"36047028600",2245,321,167,0,1403,624,701,281,5742
"36047028700",589,61,1244,613,113,361,376,209,3566
"36047028800",1218,349,0,7,1003,464,112,179,3332
"36047028900",452,417,1424,544,333,116,550,564,4400
"36047029000",2218,638,0,15,964,380,136,398,4749
"36047029100",320,76,2106,538,83,120,213,147,3603
"36047029200",1007,219,8,19,887,168,368,51,2727
"36047029300",115,52,1968,521,459,89,577,127,3908
"36047029400",1200,239,97,48,456,201,79,147,2467
"36047029500",535,70,2369,590,307,76,549,0,4496
"36047029600",2906,601,88,0,1241,308,209,50,5403
"36047029700",207,68,2086,1116,212,206,174,30,4099
"36047029800",2480,158,0,2,988,199,654,139,4620
"36047029900",54,50,1069,968,334,108,273,130,2986
"36047030000",1438,171,0,0,1376,295,229,110,3619
"36047030100",13,56,1975,413,275,52,59,38,2881
"36047030200",1122,234,41,0,2625,423,221,28,4694
"36047030300",42,2,2159,2425,167,351,251,398,5795
"36047030400",1606,535,20,20,1610,183,258,9,4241
"36047030500",1898,278,1865,345,914,307,610,272,6489
"36047030600",857,168,0,0,743,231,91,76,2166
"36047030700",20,45,2358,1036,377,452,499,547,5334
"36047030800",1483,216,8,0,348,91,384,40,2570
"36047030900",5,72,1349,669,31,75,75,95,2371
"36047031100",93,164,1825,665,82,0,87,146,3062
"36047031300",290,23,2906,824,135,125,86,167,4556
"36047031400",2634,587,89,8,798,85,216,92,4509
"36047031500",828,96,2299,1156,384,93,293,57,5206
"36047031701",431,138,1810,486,210,53,85,38,3251
"36047031702",619,156,2257,546,376,160,536,191,4841
"36047031900",362,207,2364,700,18,0,202,52,3905
"36047032100",764,326,3495,918,162,200,512,321,6698
"36047032300",371,63,2312,528,340,129,309,115,4167
"36047032500",245,394,4621,1160,62,145,329,77,7033
"36047032600",1403,520,1290,1313,1394,1220,1317,884,9341
"36047032700",343,83,1521,330,238,24,289,27,2855
"36047032800",260,80,620,308,780,315,227,76,2666
"36047032900",1268,234,2555,833,526,78,407,69,5970
"36047033000",849,578,1213,845,448,390,767,614,5704
"36047033100",2152,587,1277,141,93,100,195,100,4645
"36047033300",2609,367,1070,194,119,123,44,141,4667
"36047033500",1377,240,749,94,279,0,254,43,3036
"36047033600",3000,440,270,21,443,95,383,41,4693
"36047033700",1314,381,1847,151,29,59,158,167,4106
"36047033900",717,26,2257,999,308,58,248,85,4698
"36047034000",460,564,468,190,248,109,297,277,2613
"36047034100",243,14,1609,212,217,109,177,12,2593
"36047034200",1245,931,1338,801,450,929,489,835,7018
"36047034300",152,83,2392,1068,953,370,938,382,6338
"36047034500",0,28,1409,932,101,105,83,121,2779
"36047034700",23,49,1939,822,111,164,296,182,3586
"36047034800",945,326,103,1,432,273,565,351,2996
"36047034900",149,164,3462,1189,310,463,146,562,6445
"36047035000",2195,537,0,0,62,18,0,0,2812
"36047035100",116,675,2284,639,223,453,260,147,4797
"36047035200",191,277,137,53,40,43,79,36,856
"36047035300",731,161,2519,750,372,140,336,153,5162
"36047035400",4568,474,40,0,0,0,0,0,5082
"36047035500",483,145,3103,796,280,145,304,228,5484
"36047035601",2066,418,19,0,0,0,6,0,2509
"36047035602",3777,748,53,1,1,0,50,15,4645
"36047035700",24,58,1032,1001,160,263,232,239,3009
"36047035900",9,86,2487,2092,127,139,298,389,5627
"36047036001",1906,951,0,24,47,0,67,9,3004
"36047036002",1949,1257,13,0,395,200,92,200,4106
"36047036100",7,15,1431,590,216,138,278,116,2791
"36047036200",1270,949,31,27,592,309,683,602,4463
"36047036300",38,78,2765,637,453,6,498,103,4578
"36047036400",973,332,23,18,731,49,208,100,2434
"36047036501",39,84,2034,298,169,0,201,0,2825
"36047036502",38,14,438,331,172,80,222,76,1371
"36047036600",1714,632,98,160,901,808,598,520,5431
"36047036700",109,27,658,75,350,66,404,84,1773
"36047036900",336,19,2243,1092,445,625,652,653,6065
"36047037000",2425,338,0,8,1201,111,163,65,4311
"36047037100",18,0,3186,829,120,173,341,151,4818
"36047037300",240,127,2048,687,429,387,434,471,4823
"36047037401",3212,495,65,0,279,95,170,33,4349
"36047037402",2568,638,201,0,603,357,458,41,4866
"36047037500",278,84,2054,514,154,128,443,96,3751
"36047037700",291,92,2727,500,270,243,280,248,4651
"36047037900",73,71,2303,799,100,66,167,45,3624
"36047038100",135,87,2835,1521,241,228,323,314,5684
"36047038200",622,333,1314,1172,1165,1235,649,671,7161
"36047038300",287,20,3188,552,258,31,513,63,4912
"36047038500",218,281,1820,733,272,80,482,224,4110
"36047038600",1426,457,1,4,1414,192,397,177,4068
"36047038700",321,420,1798,839,409,102,412,436,4737
"36047038800",2991,498,30,9,235,341,171,122,4397
"36047038900",769,402,133,64,1214,673,1450,803,5508
"36047039000",1772,362,0,0,141,43,22,13,2353
"36047039100",539,405,335,341,1170,372,1500,757,5419
"36047039200",2029,286,49,0,142,208,192,20,2926
"36047039300",1315,319,1236,386,386,76,1494,624,5836
"36047039400",1727,170,0,0,235,20,90,14,2256
"36047039500",926,946,1120,131,344,380,1125,1133,6105
"36047039600",1637,234,0,0,25,96,45,62,2099
"36047039700",671,285,1277,522,170,130,631,343,4029
"36047039800",1171,170,0,0,1012,297,322,184,3156
"36047039900",1022,192,1249,669,399,124,1413,443,5511
"36047040000",1219,326,0,8,1546,498,356,50,4003
"36047040100",515,207,1413,532,479,141,876,247,4410
"36047040200",982,188,0,0,1009,311,206,58,2754
"36047040300",370,262,1591,969,298,490,553,845,5378
"36047040400",1137,111,0,0,885,146,161,105,2545
"36047040500",354,91,452,175,328,45,714,95,2254
"36047040600",1208,151,26,0,1610,35,383,9,3422
"36047040700",0,0,0,0,0,0,0,0,0
"36047040800",982,221,105,0,1433,384,102,111,3338
"36047040900",760,544,905,285,924,526,1896,1010,6850
"36047041000",1283,105,0,0,345,43,222,21,2019
"36047041100",456,38,826,559,947,554,1296,533,5209
"36047041200",1853,226,7,0,576,66,606,60,3394
"36047041300",1132,193,1372,235,599,364,1734,498,6127
"36047041401",1008,128,0,0,105,24,53,11,1329
"36047041402",1351,384,0,0,0,0,9,0,1744
"36047041500",1414,320,1663,310,427,94,1961,502,6691
"36047041600",1836,396,0,44,253,207,103,236,3075
"36047041700",1241,378,701,192,597,280,1738,664,5791
"36047041800",1517,351,5,55,59,10,64,165,2226
"36047041900",1494,501,981,247,415,410,1788,872,6708
"36047042000",1293,430,9,0,247,0,72,36,2087
"36047042100",1481,485,704,193,624,340,1941,824,6592
"36047042200",2048,368,4,45,453,70,224,84,3296
"36047042300",1877,1017,695,68,801,144,2325,1101,8028
"36047042400",1744,338,39,0,889,103,316,29,3458
"36047042500",910,134,281,88,791,450,1309,524,4487
"36047042600",1959,136,78,0,1720,524,336,176,4929
"36047042700",1871,936,383,284,1265,1023,2300,1925,9987
"36047042800",2121,546,30,0,1109,230,368,22,4426
"36047042900",2296,519,481,301,1126,1090,2980,1546,10339
"36047043000",1443,233,0,0,1225,179,387,25,3492
"36047043100",1148,1060,581,112,1830,946,2437,1654,9768
"36047043200",2486,350,25,0,1495,374,632,76,5438
"36047043300",1522,431,1011,135,540,724,2324,1158,7845
"36047043400",1960,384,0,74,761,293,128,0,3600
"36047043500",1767,662,1326,410,791,194,2666,1157,8973
"36047043600",2328,550,0,3,1196,283,110,48,4518
"36047043700",2288,670,954,875,704,572,2558,1233,9854
"36047043800",1532,410,14,11,377,187,158,192,2881
"36047043900",1600,291,451,413,1373,121,2746,439,7434
"36047044000",1954,408,0,2,107,166,135,102,2874
"36047044100",1652,694,695,114,2286,1092,3636,1647,11816
"36047044200",2196,378,0,0,36,65,8,15,2698
"36047044300",2396,696,287,115,1925,779,3276,1212,10686
"36047044400",2161,632,12,0,425,7,256,15,3508
"36047044500",1446,921,338,36,1606,478,1737,1179,7741
"36047044600",1044,140,2,9,595,139,145,55,2129
"36047044700",1119,86,282,173,443,340,1092,391,3926
"36047044800",1349,193,24,0,216,144,102,138,2166
"36047044900",1005,229,754,460,572,230,1021,375,4646
"36047045000",350,157,0,0,0,0,12,6,525
"36047045200",2293,210,0,0,35,134,42,69,2783
"36047045300",700,335,85,260,422,300,630,512,3244
"36047045400",1371,205,20,2,117,203,115,77,2110
"36047045600",1745,497,21,3,212,54,53,3,2588
"36047045800",1365,102,11,0,14,16,14,0,1522
"36047046000",1491,449,433,35,1056,462,180,26,4132
"36047046201",1487,472,0,0,426,275,213,28,2901
"36047046202",1397,427,0,5,164,37,254,42,2326
"36047046400",1833,755,0,6,161,71,48,6,2880
"36047046800",1342,745,1,3,49,3,0,2,2145
"36047047000",1394,1294,32,0,31,12,41,4,2808
"36047047200",2156,671,0,0,0,6,8,0,2841
"36047047400",2411,569,0,0,120,27,20,0,3147
"36047047600",2711,882,0,59,175,102,202,78,4209
"36047047700",2500,317,166,3,454,108,163,225,3936
"36047047800",1803,1675,0,9,823,380,642,360,5692
"36047048000",1794,961,17,38,256,350,157,472,4045
"36047048100",1714,387,88,18,433,139,705,167,3651
"36047048200",2043,1356,288,32,1311,894,376,81,6381
"36047048400",2746,1377,447,5,793,131,485,29,6013
"36047048500",1769,211,177,45,776,263,1176,285,4702
"36047048600",836,364,51,0,1425,797,858,230,4561
"36047048800",1731,556,208,3,721,726,399,160,4504
"36047048900",599,241,900,824,914,443,1800,699,6420
"36047049000",2182,1452,436,0,1627,260,1042,231,7230
"36047049100",1246,310,932,283,2554,523,2124,174,8146
"36047049200",1060,563,497,161,924,319,345,221,4090
"36047049300",3180,796,709,442,2008,493,4085,1149,12862
"36047049400",2762,600,322,122,1297,448,660,0,6211
"36047049500",1896,318,2,4,374,85,578,77,3334
"36047049600",1695,188,115,68,2028,203,859,139,5295
"36047049700",2197,240,28,0,396,53,286,29,3229
"36047049800",1539,314,160,24,1862,681,176,132,4888
"36047049900",1485,72,7,0,200,29,269,11,2073
"36047050000",2262,195,301,0,521,202,509,10,4000
"36047050100",2036,147,89,14,324,122,428,104,3264
"36047050202",1893,167,13,34,204,40,210,12,2573
"36047050300",1965,215,0,0,186,57,516,81,3020
"36047050400",2604,203,582,30,1066,202,790,49,5526
"36047050500",1245,544,480,299,855,756,1309,817,6305
"36047050600",904,492,2244,449,1263,249,1324,666,7591
"36047050700",629,1360,144,27,231,61,295,235,2982
"36047050801",204,71,2210,579,451,289,715,150,4669
"36047050803",378,25,1193,282,66,148,134,104,2330
"36047050804",742,88,2765,570,1321,412,1460,354,7712
"36047050900",1466,2003,32,108,135,77,180,50,4051
"36047051001",281,42,3101,230,383,17,550,15,4619
"36047051002",583,61,2790,545,493,225,744,211,5652
"36047051100",1469,371,264,92,943,568,1080,626,5413
"36047051200",485,86,3382,478,1259,413,1328,351,7782
"36047051300",2943,339,32,75,683,213,1375,317,5977
"36047051400",720,96,3063,683,1925,497,1775,531,9290
"36047051500",1176,71,20,0,282,12,473,28,2062
"36047051601",227,142,3122,1040,542,249,524,179,6025
"36047051602",138,36,2260,616,385,95,456,20,4006
"36047051700",1202,116,122,0,225,0,206,11,1882
"36047051800",761,104,1159,80,888,274,404,341,4011
"36047051900",3101,249,121,8,649,169,547,45,4889
"36047052000",1143,75,927,89,1412,758,305,131,4840
"36047052300",3428,566,129,32,1324,333,2591,783,9186
"36047052500",1299,1600,188,18,301,107,655,226,4394
"36047052600",1833,293,1018,2,1276,231,962,79,5694
"36047052700",2110,1560,491,301,1334,658,2389,2356,11199
"36047052800",1046,50,123,0,746,136,321,0,2422
"36047052900",1861,2011,46,15,213,100,277,118,4641
"36047053000",1869,464,66,58,605,222,143,12,3439
"36047053100",4559,3635,19,8,151,26,615,0,9013
"36047053200",1441,122,188,22,429,265,69,25,2561
"36047053300",2650,3908,11,70,30,12,157,12,6850
"36047053400",1488,992,204,37,567,596,180,24,4088
"36047053500",1489,2330,0,0,154,88,209,88,4358
"36047053700",1390,1894,0,0,49,16,138,0,3487
"36047053800",2056,950,39,4,768,101,550,106,4574
"36047053900",1285,1336,77,0,24,34,391,45,3192
"36047054200",2846,933,49,52,360,368,293,204,5105
"36047054300",176,0,39,39,93,0,92,0,439
"36047054400",1817,631,0,0,493,28,0,0,2969
"36047054500",2489,3273,298,398,175,333,1274,573,8813
"36047054600",3345,667,79,2,209,83,201,57,4643
"36047054700",1948,2209,89,100,557,128,591,393,6015
"36047054800",1880,229,12,1,42,77,168,1,2410
"36047054900",1848,660,60,4,504,98,352,163,3689
"36047055000",2151,823,55,1,521,56,322,129,4058
"36047055100",3476,504,270,93,929,235,2385,486,8378
"36047055200",1903,320,29,1,573,427,57,28,3338
"36047055300",1858,186,12,2,602,130,326,182,3298
"36047055400",2326,556,39,29,580,154,303,158,4145
"36047055500",3128,261,261,9,918,129,741,145,5592
"36047055600",2955,445,19,4,438,9,30,11,3911
"36047055700",1569,269,49,0,216,19,263,38,2423
"36047055800",1586,317,0,0,353,0,222,11,2489
"36047056000",2401,473,46,30,264,250,157,12,3633
"36047056100",2299,281,62,0,201,48,209,37,3137
"36047056200",1250,177,0,0,149,92,0,0,1668
"36047056300",2379,626,63,68,552,395,304,352,4739
"36047056400",2256,55,46,0,260,0,197,0,2814
"36047056500",2843,237,53,0,414,34,348,46,3975
"36047056600",1594,173,94,11,903,176,210,20,3181
"36047056800",996,19,0,0,289,121,73,101,1599
"36047056900",1287,79,16,0,53,17,304,10,1766
"36047057000",2302,151,47,16,881,139,194,11,3741
"36047057100",3425,316,15,0,99,18,148,0,4021
"36047057200",623,351,1677,1271,374,265,637,456,5654
"36047057300",1636,301,195,0,125,42,115,18,2432
"36047057400",1481,45,38,0,1149,229,97,5,3044
"36047057500",2237,456,0,3,862,115,498,74,4245
"36047057600",1593,346,18,0,1081,52,7,0,3097
"36047057800",1542,282,31,15,1100,162,299,2,3433
"36047057900",523,112,9,0,133,36,180,62,1055
"36047058000",1778,276,15,0,1526,223,751,51,4620
"36047058200",1603,148,0,0,659,579,175,142,3306
"36047058400",1944,257,55,35,943,13,104,4,3355
"36047058600",995,211,70,0,1115,200,301,93,2985
"36047058800",2182,568,62,8,741,161,354,107,4183
"36047058900",1317,119,33,0,290,20,26,13,1818
"36047059000",619,173,157,79,737,116,105,34,2020
"36047059100",3093,349,31,0,346,6,413,148,4386
"36047059200",2480,260,97,0,1329,194,71,12,4443
"36047059300",1601,196,14,0,193,37,223,137,2401
"36047059401",4430,952,71,2,1765,418,100,16,7754
"36047059402",3192,254,66,0,945,5,133,30,4625
"36047059600",2025,249,38,0,90,14,29,56,2501
"36047059800",2122,375,340,61,378,89,64,24,3453
"36047060000",4343,636,98,0,197,236,374,93,5977
"36047060600",1494,513,60,39,200,246,185,23,2760
"36047060800",2297,327,113,46,129,119,108,42,3181
"36047061002",3796,541,0,0,107,55,36,0,4535
"36047061003",626,238,0,0,862,98,315,73,2212
"36047061004",3732,2007,80,53,236,122,187,149,6566
"36047061200",793,228,0,0,0,0,0,0,1021
"36047061600",1464,232,23,19,9,10,20,22,1799
"36047062000",1792,276,0,0,24,0,26,10,2128
"36047062200",2396,384,62,46,91,72,244,100,3395
"36047062600",1446,311,112,15,371,330,80,133,2798
"36047062800",4757,494,20,0,185,0,335,118,5909
"36047063200",1195,60,6,1,189,3,203,1,1658
"36047063600",1210,77,0,0,57,0,82,0,1426
"36047063800",1303,13,7,0,413,0,27,0,1763
"36047064000",1429,107,0,0,125,245,146,0,2052
"36047064200",1883,239,7,0,187,39,105,100,2560
"36047064400",1910,286,21,5,547,99,236,68,3172
"36047064600",2027,143,194,14,129,0,312,115,2934
"36047064800",1057,40,445,70,236,0,285,0,2133
"36047065000",552,63,464,42,292,52,93,0,1558
"36047065200",1008,35,63,0,171,0,17,0,1294
"36047065400",1346,112,21,0,314,0,80,0,1873
"36047065600",1360,107,23,0,345,38,253,20,2146
"36047065800",1966,65,4,0,184,7,23,0,2249
"36047066000",1574,36,6,5,336,0,157,0,2114
"36047066200",1095,35,0,1,529,32,132,21,1845
"36047066600",0,0,0,0,0,0,0,0,0
"36047067000",800,103,1565,72,328,33,347,110,3358
"36047067200",98,109,1288,118,20,143,98,146,2020
"36047067400",582,4,1089,40,190,56,230,0,2191
"36047067600",257,33,1470,61,84,0,155,40,2100
"36047067800",276,12,2117,102,42,1,42,1,2593
"36047068000",302,4,1019,419,154,127,164,254,2443
"36047068200",691,7,1914,84,283,15,438,17,3449
"36047068600",552,126,548,0,208,7,61,7,1509
"36047068800",762,27,924,64,6,0,190,12,1985
"36047069000",456,28,1169,6,167,1,234,1,2062
"36047069200",254,95,2010,63,143,17,122,40,2744
"36047069601",1635,632,1671,126,199,16,293,167,4739
"36047069602",3791,166,1527,0,855,0,944,16,7299
"36047069800",1066,115,0,0,192,0,152,0,1525
"36047070000",1670,88,41,0,0,0,21,8,1828
"36047070201",5009,628,0,0,215,0,164,0,6016
"36047070202",16,0,0,0,0,0,0,0,16
"36047070203",0,0,0,0,0,0,0,0,0
"36047070600",2763,19,37,0,5,0,160,0,2984
"36047072000",123,25,1688,254,78,0,23,0,2191
"36047072200",22,4,2590,387,94,14,84,20,3215
"36047072400",59,7,1804,71,47,1,94,1,2084
"36047072600",65,0,2149,89,26,0,25,0,2354
"36047072800",216,52,3007,292,166,0,88,0,3821
"36047073000",160,19,2210,96,192,6,190,0,2873
"36047073200",185,0,2376,358,44,0,129,0,3092
"36047073400",104,0,2088,89,135,0,115,0,2531
"36047073600",425,138,1779,527,443,368,231,224,4135
"36047073800",1228,40,1673,251,227,174,169,204,3966
"36047074000",321,145,2358,521,791,49,264,113,4562
"36047074200",1392,259,1391,78,314,70,257,125,3886
"36047074400",2298,121,50,155,193,11,93,2,2923
"36047074600",1348,170,499,9,113,47,190,5,2381
"36047074800",937,420,270,87,14,59,41,59,1887
"36047075000",1909,522,382,81,47,57,44,7,3049
"36047075200",990,26,19,0,0,0,0,0,1035
"36047075400",1160,320,0,1,0,0,0,0,1481
"36047075600",1432,282,22,87,196,32,55,11,2117
"36047075800",1470,169,0,0,262,0,169,0,2070
"36047076000",2274,270,26,0,92,191,122,22,2997
"36047076200",2093,698,455,39,802,992,554,589,6222
"36047076400",1102,347,1605,112,466,188,278,227,4325
"36047076600",190,24,1692,237,241,25,270,20,2699
"36047076800",2218,495,38,8,624,33,247,48,3711
"36047077000",507,24,1720,354,177,23,229,9,3043
"36047077200",907,592,1354,152,149,69,201,38,3462
"36047077400",523,92,1530,434,239,303,235,53,3409
"36047077600",88,22,3204,193,397,9,251,22,4186
"36047078000",96,1,2181,91,40,0,104,0,2513
"36047078200",17,7,3668,591,139,0,95,0,4517
"36047078400",24,11,2183,165,241,32,170,32,2858
"36047078600",121,99,2784,465,989,282,838,45,5623
"36047078800",88,8,2277,784,271,96,281,78,3883
"36047079000",94,10,3831,650,298,188,175,161,5407
"36047079200",36,39,2251,974,312,191,232,222,4257
"36047079400",3,3,1301,353,31,118,35,118,1962
"36047079601",781,78,2646,306,396,136,365,176,4884
"36047079602",115,29,3139,821,285,446,278,443,5556
"36047079801",628,74,1730,97,332,90,196,81,3228
"36047079802",672,296,3318,1027,389,103,314,0,6119
"36047080000",629,62,2265,827,129,20,147,53,4132
"36047080200",294,91,3248,831,279,372,355,380,5850
"36047080400",203,55,1775,684,206,246,255,0,3424
"36047080600",1311,377,1646,454,41,48,89,48,4014
"36047080800",27,45,67,274,116,237,53,115,934
"36047081000",38,40,1466,383,142,57,70,6,2202
"36047081400",5,3,1763,684,192,41,208,22,2918
"36047081600",13,19,1954,505,203,66,121,44,2925
"36047081800",411,38,2359,1146,336,137,855,232,5514
"36047082000",99,82,3544,727,347,177,249,206,5431
"36047082200",150,314,4900,1104,476,173,472,424,8013
"36047082400",137,0,2644,828,328,67,314,58,4376
"36047082600",8,31,4008,986,138,100,106,265,5642
"36047082800",175,34,2813,411,149,155,207,114,4058
"36047083000",134,0,5100,778,437,35,256,109,6849
"36047083200",163,0,1833,78,164,0,100,6,2344
"36047083400",10,74,1295,36,46,0,68,0,1529
"36047083600",21,5,1712,143,73,36,11,8,2009
"36047083800",118,6,2221,189,10,1,112,1,2658
"36047084000",183,5,1823,70,240,23,214,13,2571
"36047084600",1,21,1288,182,11,52,0,37,1592
"36047084800",1,1,1495,244,20,49,6,7,1823
"36047085000",34,0,1413,148,41,6,88,0,1730
"36047085200",0,0,8,0,0,0,0,0,8
"36047085400",0,0,1591,89,116,0,109,0,1905
"36047085600",16,0,3079,296,130,0,344,10,3875
"36047085800",70,0,1852,332,77,42,14,42,2429
"36047086000",0,26,2626,623,119,0,216,49,3659
"36047086200",0,0,2428,327,150,21,107,21,3054
"36047086400",0,0,2004,209,126,37,81,37,2494
"36047086600",29,18,2508,424,77,28,132,19,3235
"36047086800",76,141,2272,487,61,65,153,0,3255
"36047087000",30,8,2375,540,120,51,231,51,3406
"36047087200",19,0,1928,511,80,0,133,21,2692
"36047087401",66,90,2149,826,41,223,114,230,3739
"36047087600",338,57,1065,53,21,92,107,19,1752
"36047087800",0,12,1736,1378,59,105,169,95,3554
"36047088000",115,0,2592,431,58,0,134,86,3416
"36047088200",72,27,5233,1014,141,67,140,91,6785
"36047088400",116,13,4133,983,236,20,195,35,5731
"36047088600",10,8,3172,868,198,65,304,102,4727
"36047088800",59,14,2878,458,268,252,287,283,4499
"36047089000",148,113,3769,2240,103,215,167,419,7174
"36047089200",1,33,2349,1123,85,14,155,32,3792
"36047089400",150,3,2455,928,69,175,224,167,4171
"36047089600",55,0,2155,749,275,24,99,16,3373
"36047089800",69,41,1142,525,27,18,131,42,1995
"36047090000",78,180,3203,1523,374,261,441,527,6587
"36047090200",76,3,1772,1043,342,233,254,369,4092
"36047090600",132,203,1619,1465,639,328,745,676,5807
"36047090800",76,139,1401,1797,203,546,324,699,5185
"36047091000",158,426,1705,3582,132,434,311,1180,7928
"36047091200",239,225,2803,2193,335,630,823,1087,8335
"36047091600",12,34,2666,1257,112,243,124,279,4727
"36047091800",116,151,1507,698,266,250,612,700,4300
"36047092000",104,24,1934,1025,133,70,344,124,3758
"36047092200",22,155,2494,218,38,0,48,155,3130
"36047092400",31,6,2075,836,97,0,172,70,3287
"36047092800",0,12,2172,242,91,19,68,6,2610
"36047093000",7,1,2097,233,150,5,15,0,2508
"36047093200",19,0,1209,19,21,12,15,0,1295
"36047093400",73,5,2079,222,89,0,146,7,2621
"36047093600",0,0,1745,99,87,0,21,0,1952
"36047093800",18,31,1568,562,0,12,0,12,2203
"36047094401",34,0,3282,471,39,0,126,0,3952
"36047094402",289,144,1439,707,75,36,281,137,3108
"36047094600",148,27,1561,125,83,31,150,0,2125
"36047095000",89,5,2666,270,40,0,93,0,3163
"36047095400",50,18,4016,334,38,82,72,27,4637
"36047095600",297,12,3346,623,271,133,329,55,5066
"36047095800",157,29,2394,404,737,27,608,24,4380
"36047096000",0,0,0,0,0,0,0,0,0
"36047096200",104,10,1153,247,103,1,142,1,1761
"36047096400",99,0,1353,441,619,28,543,55,3138
"36047096600",259,0,1528,276,415,0,272,27,2777
"36047096800",243,13,1020,131,109,42,52,30,1640
"36047097000",309,14,1239,202,99,7,137,56,2063
"36047097400",110,71,2111,286,169,183,109,200,3239
"36047098200",41,179,1991,1224,297,308,425,487,4952
"36047098400",53,0,1607,536,47,0,51,0,2294
"36047098600",80,0,2975,171,149,44,199,12,3630
"36047098800",153,84,2173,461,155,0,129,29,3184
"36047099000",4,0,1177,263,70,53,28,47,1642
"36047099200",90,78,1381,252,94,44,146,1,2086
"36047099400",81,0,1522,124,28,155,0,193,2103
"36047099600",149,0,3291,213,78,10,57,0,3798
"36047099800",143,9,3386,520,149,0,145,0,4352
"36047100400",185,0,2170,282,162,0,79,0,2878
"36047100600",81,9,2029,324,223,0,98,0,2764
"36047100800",163,104,1409,171,65,112,98,14,2136
"36047101000",121,19,1336,223,443,91,222,21,2476
"36047101200",123,43,1694,83,201,26,107,0,2277
"36047101400",58,19,1959,198,91,57,54,49,2485
"36047101600",62,0,1247,47,81,18,0,0,1455
"36047101800",64,0,1452,36,90,0,78,0,1720
"36047102000",108,139,1722,124,46,25,94,0,2258
"36047102200",157,12,1465,53,281,182,31,24,2205
"36047102400",105,0,1585,71,181,43,26,43,2054
"36047102600",67,13,2631,112,5,0,24,44,2896
"36047102800",29,0,1242,138,104,10,18,21,1562
"36047103400",289,344,1191,1114,420,339,288,555,4540
"36047105801",1686,582,2391,1135,337,505,915,505,8056
"36047105804",1019,914,2630,739,643,225,1033,347,7550
"36047107000",91,8,651,108,20,4,147,0,1029
"36047107800",142,2,3235,149,131,40,301,41,4041
"36047109800",129,54,1261,334,102,55,108,46,2089
"36047110400",164,15,3177,718,228,423,556,448,5729
"36047110600",317,66,2342,1281,237,245,766,324,5578
"36047111000",244,113,1558,1362,200,59,562,225,4323
"36047111600",353,194,1453,1106,236,28,594,113,4077
"36047111800",158,128,1392,984,56,0,192,95,3005
"36047112000",307,332,1903,767,6,230,383,704,4632
"36047112200",298,156,1783,948,112,135,340,228,4000
"36047112400",25,60,2063,981,28,98,87,190,3532
"36047112600",482,44,2010,973,186,241,601,455,4992
"36047112800",85,237,2436,611,134,374,188,513,4578
"36047113000",99,181,2015,1495,233,292,422,525,5262
"36047113200",261,48,1502,120,34,46,560,85,2656
"36047113400",80,223,954,852,278,338,465,617,3807
"36047114201",776,185,391,3,247,253,857,421,3133
"36047114202",373,193,894,202,438,112,873,355,3440
"36047114400",131,344,815,900,219,249,340,584,3582
"36047114600",571,358,810,106,723,509,1278,798,5153
"36047115000",235,140,1004,515,512,392,649,472,3919
"36047115200",201,133,1061,995,537,158,709,276,4070
"36047115600",195,184,1162,1743,591,492,778,872,6017
"36047115800",194,279,1774,319,225,57,556,329,3733
"36047116000",108,73,842,384,267,241,390,314,2619
"36047116200",90,0,1425,443,102,26,203,26,2315
"36047116400",123,244,1858,421,193,90,457,334,3720
"36047116600",228,359,1213,677,141,91,403,443,3555
"36047116800",386,164,368,297,220,110,515,196,2256
"36047117000",324,129,626,121,457,160,696,233,2746
"36047117201",558,54,345,113,982,482,1426,499,4459
"36047117202",1304,276,977,129,317,104,1518,388,5013
"36047117400",1601,807,690,204,459,183,1972,841,6757
"36047117601",1297,403,600,190,491,135,1748,551,5415
"36047117602",809,271,536,146,707,436,1512,667,5084
"36047117800",222,366,462,208,331,67,555,374,2585
"36047118000",0,0,0,0,0,0,0,0,0
"36047118201",775,333,509,518,812,134,1490,508,5079
"36047118202",1089,422,430,291,279,131,1257,647,4546
"36047118400",1574,623,1114,266,1096,406,2120,705,7904
"36047118600",975,487,470,311,400,237,1114,653,4647
"36047118800",729,446,1290,1101,498,321,944,462,5791
"36047119000",568,332,651,352,163,429,629,642,3766
"36047119200",503,522,685,842,314,158,718,702,4444
"36047119400",485,296,2024,902,98,0,710,296,4811
"36047119600",445,491,2319,687,670,246,658,504,6020
"36047119800",647,241,974,400,471,184,1167,412,4496
"36047120000",304,376,755,195,77,345,334,442,2828
"36047120200",289,289,714,130,504,178,296,370,2770
"36047120800",597,285,5296,1883,581,49,997,397,10085
"36047121000",430,997,1395,1094,302,145,947,1249,6559
"36047121400",456,644,1532,1210,342,122,845,713,5864
"36047122000",404,28,3080,1265,483,147,830,322,6559
"36047123700",1832,3375,215,8,697,243,832,210,7412
"36047150200",2126,58,57,6,636,17,486,11,3397
"36047152200",1561,167,635,22,884,256,127,78,3730
"36047990100",0,0,0,0,0,0,0,0,0
"36049950100",2220,211,6,0,6,21,18,21,2503
"36049950200",3811,578,17,7,35,4,98,0,4550
"36049950300",6287,948,51,3,175,83,131,63,7741
"36049950400",2509,316,30,0,39,6,24,9,2933
"36049950500",1962,272,35,0,7,0,0,0,2276
"36049950600",1507,397,12,23,30,4,15,0,1988
"36049950700",4394,648,81,11,31,19,25,5,5214
"36051030100",3758,271,104,14,33,39,29,0,4248
"36051030201",3706,1015,40,70,150,201,13,25,5220
"36051030202",5220,413,81,0,109,49,47,81,6000
"36051030300",2912,265,18,0,128,0,29,33,3385
"36051030400",2135,836,15,0,188,89,46,19,3328
"36051030500",0,0,0,0,0,0,0,0,0
"36051030600",3333,377,0,0,279,2,28,10,4029
"36051030700",6709,835,2,0,100,13,29,0,7688
"36051030800",4220,545,24,0,129,187,246,188,5539
"36051030900",1828,593,65,16,48,5,147,166,2868
"36051031000",7,5,1,5,8,0,2,1,29
"36051031100",4044,521,24,0,56,28,8,20,4701
"36051031200",3271,506,0,5,76,15,54,12,3939
"36051031300",3792,707,0,3,32,23,37,0,4594
"36051031400",3605,954,0,37,10,0,72,37,4715
"36053030101",1817,583,33,11,79,21,0,54,2598
"36053030102",3863,812,18,0,107,32,63,63,4958
"36053030103",3205,139,60,0,183,13,156,0,3756
"36053030200",2935,368,0,53,35,153,0,0,3544
"36053030300",4519,714,143,23,66,25,31,0,5521
"36053030401",6656,525,0,0,21,0,68,14,7284
"36053030402",3013,114,0,0,34,0,40,0,3201
"36053030403",4460,327,1,0,61,0,113,0,4962
"36053030501",2191,282,0,0,11,0,38,0,2522
"36053030502",3650,76,0,0,50,13,49,0,3838
"36053030600",6108,669,13,0,249,146,76,4,7265
"36053030700",4607,465,0,97,81,4,25,93,5372
"36053030800",2982,506,42,0,38,16,6,0,3590
"36053030900",1548,253,7,18,232,0,0,0,2058
"36053031000",4533,661,10,0,105,0,102,0,5411
"36053031100",2027,412,0,0,47,0,0,4,2490
"36055000200",151,326,442,1168,90,379,62,344,2962
"36055000700",235,186,639,441,278,183,391,373,2726
"36055001000",2155,332,251,221,67,43,17,160,3246
"36055001300",156,60,362,834,138,309,218,517,2594
"36055001500",96,43,343,282,58,160,175,197,1354
"36055001800",2482,492,635,348,521,451,562,279,5770
"36055001900",1122,186,777,186,137,129,476,74,3087
"36055002000",1440,324,969,687,480,107,416,155,4578
"36055002100",1403,207,930,293,262,67,325,61,3548
"36055002200",356,223,374,453,792,307,291,83,2879
"36055002300",447,497,945,592,525,650,341,386,4383
"36055002400",671,361,680,945,211,271,215,215,3569
"36055002700",3,9,644,637,30,17,0,40,1380
"36055002900",2620,698,178,62,172,73,109,60,3972
"36055003000",1156,309,270,195,162,28,35,73,2228
"36055003100",3317,590,170,27,152,34,146,19,4455
"36055003200",803,318,107,171,63,183,74,87,1806
"36055003300",889,232,73,201,40,53,46,27,1561
"36055003400",1323,350,294,250,133,109,32,36,2527
"36055003500",801,204,54,12,61,23,57,7,1219
"36055003600",1907,191,78,12,163,23,161,57,2592
"36055003700",2112,226,68,242,75,99,72,99,2993
"36055003802",0,0,0,0,0,0,0,0,0
"36055003805",2423,872,448,485,418,217,168,44,5075
"36055003900",175,279,644,392,149,423,230,618,2910
"36055004000",357,251,195,461,122,189,201,230,2006
"36055004100",234,188,126,290,153,96,171,101,1359
"36055004602",547,219,835,705,231,53,418,54,3062
"36055004701",1082,280,869,556,409,72,632,210,4110
"36055004702",458,205,453,530,314,153,337,477,2927
"36055004800",277,187,559,682,317,234,453,306,3015
"36055004900",156,99,601,651,285,220,384,332,2728
"36055005000",190,241,401,313,218,399,231,568,2561
"36055005100",165,78,633,414,177,171,247,214,2099
"36055005200",393,68,292,673,124,110,503,169,2332
"36055005300",250,396,824,420,53,223,249,513,2928
"36055005400",1305,170,1410,448,386,495,549,496,5259
"36055005500",156,414,850,509,290,104,437,413,3173
"36055005600",159,300,693,839,271,255,309,179,3005
"36055005700",121,124,584,812,186,272,136,123,2358
"36055005800",1069,260,1186,1469,448,155,559,228,5374
"36055005900",150,208,500,316,138,210,197,227,1946
"36055006000",1977,271,559,149,159,36,152,75,3378
"36055006100",1961,192,137,0,44,7,29,0,2370
"36055006200",410,153,2005,553,41,0,31,46,3239
"36055006300",439,222,1581,583,171,98,167,243,3504
"36055006400",100,59,1132,1045,51,47,29,66,2529
"36055006500",46,104,918,698,22,127,67,51,2033
"36055006600",15,68,1081,620,17,144,15,57,2017
"36055006700",309,191,2149,660,176,48,110,66,3709
"36055006800",621,123,1572,377,183,19,93,12,3000
"36055006900",201,126,900,772,107,86,43,29,2264
"36055007000",791,260,1164,398,130,119,60,22,2944
"36055007100",852,125,1352,558,82,114,164,50,3297
"36055007500",555,99,979,891,196,261,233,417,3631
"36055007600",1993,170,283,456,167,123,174,87,3453
"36055007700",1756,125,256,120,137,58,21,54,2527
"36055007801",2030,164,111,38,73,59,154,0,2629
"36055007802",1224,60,129,7,30,1,8,1,1460
"36055007900",211,398,426,613,236,230,282,705,3101
"36055008000",257,167,574,709,294,320,377,331,3029
"36055008100",1390,272,1044,408,722,132,1130,236,5334
"36055008200",1029,309,1225,234,628,105,996,182,4708
"36055008301",1334,373,1047,358,700,172,1172,284,5440
"36055008400",471,352,1053,283,571,195,895,374,4194
"36055008500",2317,572,206,55,43,166,172,103,3634
"36055008600",3307,306,434,0,158,0,220,42,4467
"36055008701",1209,570,1028,127,730,96,339,247,4346
"36055008702",331,149,325,497,49,142,106,16,1615
"36055008800",559,524,688,331,204,105,240,426,3077
"36055009200",158,365,306,332,97,182,323,516,2279
"36055009301",362,753,442,707,385,192,601,842,4284
"36055009302",775,221,155,191,161,36,59,51,1649
"36055009400",920,806,361,441,163,167,203,238,3299
"36055009500",1147,196,690,810,59,145,84,80,3211
"36055009601",87,44,619,421,42,5,98,24,1340
"36055009602",275,84,393,743,73,321,152,160,2201
"36055009603",487,336,387,477,121,374,174,223,2579
"36055009604",329,428,268,134,68,77,262,409,1975
"36055010100",3261,226,45,35,43,0,175,8,3793
"36055010200",3652,167,14,0,126,0,23,0,3982
"36055010300",3572,63,21,2,58,30,50,6,3802
"36055010400",3866,404,224,215,340,53,598,61,5761
"36055010500",4089,103,83,0,155,67,217,0,4714
"36055010601",2211,207,157,54,153,65,141,80,3068
"36055010602",3345,250,160,2,147,16,284,16,4220
"36055010700",3019,268,50,92,41,0,275,10,3755
"36055010800",2585,96,137,9,49,0,98,0,2974
"36055010901",2139,316,1156,662,291,186,467,266,5483
"36055010902",2189,384,275,75,145,0,101,32,3201
"36055011000",3952,344,524,32,414,40,460,40,5806
"36055011100",3208,153,310,135,303,8,115,0,4232
"36055011201",3090,117,58,1,65,0,76,9,3416
"36055011203",1841,42,20,7,65,9,43,0,2027
"36055011205",4998,84,77,0,160,9,121,0,5449
"36055011207",4419,263,62,6,146,2,156,35,5089
"36055011208",4138,389,56,0,456,0,20,0,5059
"36055011301",7337,139,122,0,285,26,62,0,7971
"36055011302",5651,97,53,7,97,0,129,3,6037
"36055011400",6023,1428,243,23,771,312,248,203,9251
"36055011501",5657,176,88,4,437,0,440,4,6806
"36055011503",5305,97,92,20,105,25,93,26,5763
"36055011504",5623,121,115,34,601,0,182,0,6676
"36055011505",5538,251,4,9,208,0,99,0,6109
"36055011601",5331,420,66,33,187,83,77,32,6229
"36055011603",768,281,4,0,94,23,74,36,1280
"36055011604",2121,40,30,3,75,0,50,1,2320
"36055011605",1874,46,55,4,101,0,139,0,2219
"36055011703",7893,274,86,29,357,77,110,2,8828
"36055011705",4756,242,26,5,223,0,20,0,5272
"36055011706",4240,199,0,2,238,0,62,0,4741
"36055011707",6461,283,18,1,228,9,36,1,7037
"36055011708",2899,161,127,0,200,0,30,0,3417
"36055011800",4798,179,1,4,263,1,28,51,5325
"36055011901",4535,828,14,148,394,33,262,0,6214
"36055011902",5131,499,171,41,135,0,113,4,6094
"36055012000",2048,519,9,213,63,20,144,11,3027
"36055012100",2911,356,213,105,194,36,143,123,4081
"36055012201",2953,215,216,7,143,26,46,38,3644
"36055012202",3160,219,71,1,76,0,31,0,3558
"36055012301",5061,455,60,23,363,0,107,8,6077
"36055012304",3905,26,29,2,471,0,34,2,4469
"36055012305",3672,50,63,4,484,0,219,6,4498
"36055012306",3992,105,133,26,917,65,72,2,5312
"36055012401",2724,311,12,0,43,0,72,0,3162
"36055012402",5763,81,21,0,255,0,67,0,6187
"36055012500",4000,109,138,37,203,13,34,0,4534
"36055012600",3848,211,77,0,423,30,133,2,4724
"36055012700",3290,201,157,4,178,35,158,0,4023
"36055012800",3581,348,203,139,574,13,315,4,5177
"36055012900",3837,242,240,23,637,43,15,0,5037
"36055013001",2220,603,290,185,1390,914,8,0,5610
"36055013002",3958,338,266,20,898,157,222,0,5859
"36055013101",4901,550,488,0,492,57,238,189,6915
"36055013103",941,751,161,0,165,179,64,200,2461
"36055013104",2966,599,837,34,540,74,97,16,5163
"36055013203",4507,370,537,63,165,6,182,25,5855
"36055013204",6283,382,467,145,864,75,195,31,8442
"36055013205",2940,710,387,45,274,306,0,58,4720
"36055013206",4124,631,462,0,1025,113,281,19,6655
"36055013300",3154,187,11,11,31,0,92,2,3488
"36055013401",3182,281,399,113,218,18,373,39,4623
"36055013402",2763,141,164,0,184,0,28,21,3301
"36055013503",4993,43,139,21,350,12,261,0,5819
"36055013505",3164,278,139,12,157,0,152,0,3902
"36055013506",7826,451,173,0,266,23,469,26,9234
"36055013507",5738,129,81,29,84,0,52,0,6113
"36055013508",3648,102,19,0,162,0,68,0,3999
"36055013601",4156,302,273,52,244,11,209,49,5296
"36055013603",4796,139,91,0,156,0,174,0,5356
"36055013604",3785,293,572,257,137,14,48,140,5246
"36055013701",1909,164,34,0,117,0,40,0,2264
"36055013702",3403,154,8,0,33,13,154,13,3778
"36055013800",4368,1382,252,82,159,524,404,200,7371
"36055013901",3308,167,148,64,411,0,219,0,4317
"36055013902",2281,365,485,413,207,87,184,207,4229
"36055014001",3473,284,353,64,256,25,172,25,4652
"36055014003",3878,359,81,0,155,42,147,63,4725
"36055014004",2906,305,283,0,107,46,285,36,3968
"36055014102",2867,262,401,13,109,96,99,141,3988
"36055014103",3845,203,89,11,127,18,138,29,4460
"36055014104",3048,227,19,306,132,153,218,142,4245
"36055014202",5292,496,495,8,166,22,85,0,6564
"36055014203",4687,692,415,154,796,83,245,500,7572
"36055014204",1834,91,275,8,86,12,48,0,2354
"36055014301",2351,306,89,155,175,10,281,74,3441
"36055014302",3747,348,545,0,374,35,248,41,5338
"36055014400",3577,122,476,90,320,25,183,17,4810
"36055014501",3457,171,435,8,108,20,78,2,4279
"36055014503",2691,165,413,8,110,0,120,47,3554
"36055014504",4425,114,588,1,229,0,15,0,5372
"36055014505",4259,414,126,19,228,96,193,75,5410
"36055014601",4918,129,108,49,94,52,227,34,5611
"36055014602",3236,349,948,149,225,0,242,126,5275
"36055014700",4035,185,313,104,109,22,62,102,4932
"36055014802",4479,438,161,0,106,0,90,69,5343
"36055014803",3140,284,0,0,106,0,60,13,3603
"36055014804",6755,190,2,19,93,10,306,3,7378
"36055014901",4747,383,67,5,221,0,198,76,5697
"36055014903",4651,102,177,0,232,49,74,68,5353
"36055014905",4877,222,145,0,180,25,188,15,5652
"36055014906",2936,451,79,0,94,12,0,0,3572
"36055015000",4935,449,91,3,95,39,213,41,5866
"36055015101",3893,467,251,0,58,68,31,2,4770
"36055015102",4014,260,0,4,20,0,0,0,4298
"36055015200",5674,543,0,19,368,0,367,34,7005
"36055015301",322,161,0,34,30,0,0,0,547
"36055015303",2267,391,53,57,102,0,29,0,2899
"36055015304",2955,914,87,0,374,97,101,74,4602
"36055015400",3414,305,18,0,98,9,61,0,3905
"36055980000",0,0,0,0,0,0,0,0,0
"36055980100",13,0,0,0,3,0,0,0,16
"36055990000",0,0,0,0,0,0,0,0,0
"36057070200",1149,650,1,0,26,357,76,592,2851
"36057070300",870,640,10,37,328,210,392,374,2861
"36057070400",1428,150,50,0,114,8,141,8,1899
"36057070500",2118,217,0,2,495,0,533,98,3463
"36057070600",1359,422,40,73,201,94,668,219,3076
"36057070700",1948,228,191,12,297,17,425,17,3135
"36057070800",1576,447,171,57,228,253,444,410,3586
"36057070900",683,349,86,75,275,150,384,300,2302
"36057072100",4741,719,33,0,73,14,200,97,5877
"36057072200",3155,361,24,27,229,7,133,7,3943
"36057072300",2601,454,11,1,91,2,31,0,3191
"36057072400",1602,796,0,9,27,8,35,8,2485
"36057072500",3007,1099,0,0,67,44,20,9,4246
"36057072600",3010,473,42,24,79,19,45,80,3772
"36057072700",3475,521,24,11,68,0,61,5,4165
"36057072800",3462,321,39,2,146,6,78,28,4082
"36059300100",3975,268,9,51,85,27,67,1,4483
"36059300300",3542,316,18,0,382,45,439,1,4743
"36059300400",4420,295,133,0,888,7,212,0,5955
"36059300500",4602,125,47,3,652,0,150,0,5579
"36059300600",4707,261,13,18,1524,95,267,22,6907
"36059300700",4464,182,47,16,1143,82,577,47,6558
"36059300800",2288,158,250,0,1333,30,215,0,4274
"36059300900",5166,83,20,25,2167,104,84,6,7655
"36059301000",4978,119,86,3,367,31,92,33,5709
"36059301101",4483,253,31,3,1576,292,1395,275,8308
"36059301102",3836,54,189,1,476,32,329,0,4917
"36059301200",5039,193,1,0,452,47,753,47,6532
"36059301300",3164,81,279,99,857,69,955,110,5614
"36059301400",1849,22,0,0,173,0,63,0,2107
"36059301500",2763,83,0,0,361,6,102,4,3319
"36059301600",3707,340,22,4,654,12,235,147,5121
"36059301700",2531,36,0,0,139,6,104,0,2816
"36059301800",2553,414,648,21,1021,9,711,223,5600
"36059301900",2740,6,0,0,217,0,101,0,3064
"36059302000",3901,145,61,0,520,60,134,0,4821
"36059302101",3736,111,8,0,280,47,44,0,4226
"36059302102",2769,146,0,1,427,29,219,0,3591
"36059302200",2585,157,179,104,1481,14,577,0,5097
"36059302300",2348,43,0,9,2088,7,82,0,4577
"36059302400",3620,146,0,1,1375,12,289,56,5499
"36059302501",1896,83,0,0,765,0,56,0,2800
"36059302502",1725,43,53,2,740,36,117,38,2754
"36059302600",1777,64,129,0,623,17,528,0,3138
"36059302700",2397,121,21,0,1772,208,160,0,4679
"36059302800",3556,30,138,0,2280,163,730,0,6897
"36059302900",3128,91,61,5,1203,56,342,23,4909
"36059303000",3423,179,0,1,2030,68,641,0,6342
"36059303101",1729,48,65,0,1771,84,503,0,4200
"36059303102",2262,24,46,0,1948,0,235,0,4515
"36059303201",1627,0,127,13,1976,60,310,0,4113
"36059303202",2408,137,15,1,1373,70,700,70,4774
"36059303301",2331,109,0,1,968,0,360,98,3867
"36059303302",3350,108,1,3,357,91,244,101,4255
"36059303400",2427,29,0,0,113,0,126,0,2695
"36059303500",3843,107,20,0,1045,222,626,262,6125
"36059303600",4987,284,130,29,1482,337,1972,359,9580
"36059303700",5707,80,72,0,561,12,903,38,7373
"36059303800",3855,203,169,88,918,144,532,10,5919
"36059303900",1655,25,1841,69,467,27,664,29,4777
"36059304001",2358,50,21,0,221,0,181,8,2839
"36059304002",2655,104,279,22,1093,104,1194,82,5533
"36059304100",724,87,1118,29,1847,364,1667,383,6219
"36059304202",1461,45,507,0,1338,138,1849,100,5438
"36059304203",658,294,2673,293,1633,88,1673,391,7703
"36059304204",324,90,1219,478,1990,624,2218,623,7566
"36059404300",1755,57,26,0,1206,3,508,7,3562
"36059404400",4394,221,25,1,159,10,227,34,5071
"36059404500",3498,72,238,2,523,0,531,25,4889
"36059404600",3799,88,0,0,465,0,361,0,4713
"36059404700",4147,45,61,1,1724,158,938,136,7210
"36059404800",1708,47,2380,331,2373,184,1781,32,8836
"36059404901",460,25,4158,72,739,43,398,50,5945
"36059404902",435,144,2130,127,1323,652,646,666,6123
"36059405000",1590,38,1809,34,2323,134,1297,131,7356
"36059405100",1353,72,4658,55,1622,163,1050,0,8973
"36059405200",1642,146,2433,301,2614,416,1209,330,9091
"36059405301",2561,199,110,9,753,45,467,24,4168
"36059405302",3053,213,41,0,764,118,541,111,4841
"36059405400",4681,193,571,158,2502,424,1649,149,10327
"36059405500",4684,171,36,0,873,26,720,26,6536
"36059405600",3586,33,133,1,423,0,670,0,4846
"36059405700",3877,195,52,0,575,108,657,42,5506
"36059405800",3236,68,31,9,542,99,399,0,4384
"36059405900",3584,60,454,0,764,26,558,26,5472
"36059406001",3620,222,216,2,713,248,784,18,5823
"36059406002",2283,86,442,10,417,0,488,31,3757
"36059406100",2090,41,343,22,276,68,267,0,3107
"36059406201",1333,114,759,52,444,87,580,142,3511
"36059406202",854,47,4333,204,571,299,1037,320,7665
"36059406300",3313,249,2,5,238,109,172,0,4088
"36059406400",6565,120,0,0,67,18,250,0,7020
"36059406501",6068,256,3,11,218,0,330,0,6886
"36059406600",3711,43,0,0,451,39,182,0,4426
"36059406701",706,244,750,172,805,362,1112,513,4664
"36059406702",845,159,1638,779,673,650,485,631,5860
"36059406801",527,182,1394,399,1410,252,1816,454,6434
"36059406802",337,238,1504,83,1808,516,2060,686,7232
"36059406900",666,296,2679,834,1576,873,1878,882,9684
"36059407000",406,23,3149,884,2444,443,2598,349,10296
"36059407101",498,265,3233,236,963,183,1285,432,7095
"36059407102",896,34,3667,170,1030,272,1797,315,8181
"36059407201",685,276,857,926,1845,463,2214,416,7682
"36059407203",253,250,1552,239,1149,132,1144,75,4794
"36059407204",506,270,967,100,713,301,836,347,4040
"36059407301",1615,135,508,49,161,31,68,28,2595
"36059407302",1436,304,1459,131,1137,278,1652,167,6564
"36059407401",836,214,2833,410,1074,192,1504,347,7410
"36059407402",372,63,1635,93,607,300,636,313,4019
"36059407501",579,175,2576,85,1481,231,1967,380,7474
"36059407502",672,1,2920,215,1545,52,1876,0,7281
"36059407600",3385,207,194,0,1339,143,569,19,5856
"36059407700",3398,121,191,1,1538,60,1201,48,6558
"36059407801",4073,227,31,0,1156,135,1173,149,6944
"36059407802",379,36,0,0,188,98,45,0,746
"36059407900",4264,103,434,0,751,182,174,54,5962
"36059408000",4871,125,61,3,816,0,549,23,6448
"36059408100",5170,131,76,189,763,74,435,0,6838
"36059408200",4969,137,60,0,879,15,616,0,6676
"36059408300",5599,138,77,0,876,77,697,97,7561
"36059408400",3181,46,120,1,383,8,344,17,4100
"36059408500",5708,92,103,3,308,49,179,0,6442
"36059408600",3826,101,43,0,611,0,845,43,5469
"36059408700",4046,79,87,0,542,0,624,0,5378
"36059408800",5989,73,88,0,987,29,783,29,7978
"36059408900",4850,101,12,12,725,71,544,16,6331
"36059409000",4922,145,41,1,851,0,703,9,6672
"36059409100",4506,84,12,0,495,0,662,0,5759
"36059409200",5057,212,1,0,857,0,902,14,7043
"36059409300",3851,62,0,0,219,34,185,22,4373
"36059409400",3566,199,21,2,719,92,678,0,5277
"36059409500",3883,65,0,0,219,0,144,0,4311
"36059409600",4620,94,12,1,340,0,534,0,5601
"36059409700",3747,70,10,0,238,46,195,8,4314
"36059409800",929,176,3311,102,1177,0,638,59,6392
"36059409900",1843,81,4292,72,1694,14,1302,48,9346
"36059410000",1187,93,1319,160,683,11,189,11,3653
"36059410100",5287,31,169,0,427,0,234,0,6148
"36059410200",3249,82,67,0,228,0,327,0,3953
"36059410300",2223,70,1501,188,2034,198,1915,152,8281
"36059410400",995,0,2073,193,2194,148,1746,41,7390
"36059410500",3099,168,1444,21,2193,715,1596,533,9769
"36059410600",3664,233,593,35,2386,233,1916,234,9294
"36059410700",3767,711,270,49,1632,114,1753,426,8722
"36059410800",3023,100,291,12,1125,51,1008,16,5626
"36059410900",2635,190,1784,162,1366,156,804,1,7098
"36059411000",2017,211,614,196,1746,271,1707,252,7014
"36059411100",829,135,1344,233,1420,563,1647,597,6768
"36059411200",4979,170,0,0,1209,267,1330,167,8122
"36059411301",2944,146,309,0,401,8,244,44,4096
"36059411302",6400,119,46,0,92,0,310,0,6967
"36059411400",4798,594,58,77,558,72,181,184,6522
"36059411500",2612,31,24,0,72,10,106,0,2855
"36059411600",6273,114,17,2,103,2,191,0,6702
"36059411700",5715,214,5,4,323,220,216,0,6697
"36059411800",5475,213,274,9,361,0,627,0,6959
"36059411901",2771,169,50,0,409,84,495,58,4036
"36059411902",2858,189,159,0,411,0,402,34,4053
"36059412000",4814,579,187,1,504,0,897,190,7172
"36059412100",5814,197,29,40,216,0,974,98,7368
"36059412200",4982,119,0,0,0,0,205,0,5306
"36059412301",2556,129,23,10,386,1,495,11,3611
"36059412302",2617,128,132,132,598,0,506,39,4152
"36059412400",4106,101,518,129,81,272,260,272,5739
"36059412500",4106,113,7,0,128,9,241,0,4604
"36059412600",3293,223,15,0,199,0,166,1,3897
"36059412700",3815,8,0,0,42,0,321,0,4186
"36059412800",2263,98,448,0,332,0,578,16,3735
"36059412900",1107,78,3623,84,852,87,947,113,6891
"36059413001",3012,275,1,0,424,24,360,36,4132
"36059413002",3234,84,0,0,196,0,136,0,3650
"36059413100",4431,160,42,1,451,9,729,0,5823
"36059413200",5566,255,95,0,104,0,377,17,6414
"36059413300",5974,89,0,2,317,0,588,22,6992
"36059413400",5048,175,40,1,134,68,536,0,6002
"36059413500",3468,366,2402,16,1795,47,2238,133,10465
"36059413600",2963,275,934,195,876,251,1337,283,7114
"36059413700",3741,453,696,8,464,78,876,435,6751
"36059413803",2009,200,1423,88,483,54,597,147,5001
"36059413804",2288,114,752,0,359,7,424,8,3952
"36059413900",1062,436,3465,1014,1032,371,1913,727,10020
"36059414001",233,20,2930,129,859,41,814,41,5067
"36059414002",741,330,2224,506,960,50,1454,388,6653
"36059414100",847,296,3418,168,1368,3,1644,198,7942
"36059414201",1699,285,1259,92,1950,575,2813,673,9346
"36059414202",953,297,1951,214,972,297,1735,517,6936
"36059414301",982,125,375,36,1125,405,1413,353,4814
"36059414303",1698,18,1520,50,756,539,1091,502,6174
"36059414304",938,303,666,37,1095,401,1623,450,5513
"36059414400",820,299,1719,282,1357,1070,1368,1225,8140
"36059414501",3137,127,1132,110,543,120,1302,144,6615
"36059414502",2485,68,601,2,814,140,938,143,5191
"36059414600",2939,165,8,0,497,1,268,1,3879
"36059414700",3999,131,18,0,267,0,265,0,4680
"36059414800",5736,77,5,0,733,69,692,15,7327
"36059414900",5869,360,114,2,839,271,1018,81,8554
"36059415000",5010,206,306,1,668,42,793,1,7027
"36059415101",2240,52,28,0,145,11,78,33,2587
"36059415102",4732,31,40,0,174,0,86,0,5063
"36059415201",3269,51,12,17,228,1,263,34,3875
"36059415202",3786,151,0,0,65,10,330,10,4352
"36059415300",5490,75,38,0,633,0,419,6,6661
"36059415401",4881,75,23,2,282,5,244,0,5512
"36059415402",4380,69,0,2,276,28,225,0,4980
"36059415500",2497,82,11,0,5,0,77,0,2672
"36059415600",5037,265,2,1,441,0,250,0,5996
"36059415700",5699,137,2,14,267,0,340,0,6459
"36059415802",6853,111,44,0,196,5,369,0,7578
"36059416000",3518,123,2,0,248,0,230,2,4123
"36059416100",6290,231,0,0,91,0,221,16,6849
"36059416201",3444,96,61,13,320,26,654,32,4646
"36059416202",2950,512,7,3,781,280,853,392,5778
"36059416300",3620,102,67,0,53,0,198,25,4065
"36059416401",3483,136,20,0,80,0,184,9,3912
"36059416402",2322,40,79,78,129,21,129,21,2819
"36059416500",3100,205,477,705,1609,417,2238,490,9241
"36059416600",4344,296,104,42,408,11,781,7,5993
"36059416701",3179,137,57,1,723,27,1110,19,5253
"36059416702",2975,387,74,0,618,44,483,304,4885
"36059416801",1891,16,0,0,157,12,106,16,2198
"36059416802",3454,298,0,0,259,0,257,24,4292
"36059416900",3687,18,1,2,27,0,267,0,4002
"36059517000",2377,121,103,7,233,14,248,9,3112
"36059517101",2492,237,387,68,1612,392,1704,481,7373
"36059517102",1863,78,3,0,236,0,135,0,2315
"36059517200",3207,768,609,305,2715,1049,2636,1300,12589
"36059517301",1969,388,40,0,382,55,546,247,3627
"36059517302",3137,134,242,0,944,299,610,298,5664
"36059517400",4353,127,212,13,260,0,260,0,5225
"36059517500",3508,84,19,0,304,0,138,39,4092
"36059517600",4280,82,0,4,171,38,522,38,5135
"36059517701",5753,195,300,4,1469,62,316,62,8161
"36059517705",2295,20,96,8,361,0,71,5,2856
"36059517801",3084,111,13,13,202,35,167,6,3631
"36059517802",2810,56,74,0,288,13,454,0,3695
"36059517901",4589,129,0,20,110,12,282,0,5142
"36059517902",2572,153,24,1,81,29,66,18,2944
"36059518000",5221,115,328,0,808,76,952,45,7545
"36059518100",2429,121,0,1,126,0,163,0,2840
"36059518201",3620,81,59,14,369,10,140,3,4296
"36059518203",2769,92,24,3,466,42,53,6,3455
"36059518204",3850,126,62,2,274,0,53,0,4367
"36059518300",4075,249,0,7,1192,112,424,0,6059
"36059518400",3318,38,4,4,1026,0,263,0,4653
"36059518501",4312,232,148,31,1808,0,25,0,6556
"36059518502",1716,69,121,0,1053,127,91,0,3177
"36059518600",2859,1,0,0,1085,2,91,1,4039
"36059518700",3539,158,21,63,1551,31,218,0,5581
"36059518800",2494,6,20,14,783,35,96,14,3462
"36059518900",4210,333,558,2,1865,49,979,318,8314
"36059519000",4559,168,238,2,1204,147,576,78,6972
"36059519100",4299,222,76,3,1318,20,881,0,6819
"36059519200",4280,454,8,32,1237,52,509,159,6731
"36059519300",3483,345,117,56,1817,20,1313,33,7184
"36059519400",3415,124,2,0,994,52,365,17,4969
"36059519500",4289,216,5,0,1483,1,320,46,6360
"36059519601",3395,107,0,5,912,46,227,27,4719
"36059519602",1919,74,0,0,128,0,36,0,2157
"36059519702",4826,177,86,0,428,0,222,0,5739
"36059519703",2950,0,12,0,443,33,155,0,3593
"36059519704",2542,64,8,0,469,12,104,1,3200
"36059519801",1929,30,0,0,537,0,224,0,2720
"36059519802",3995,257,56,0,598,37,181,36,5160
"36059519900",4842,89,20,3,264,15,161,0,5394
"36059520001",5876,209,1,0,694,0,554,0,7334
"36059520002",3558,157,1,2,558,32,383,0,4691
"36059520100",5053,145,0,0,319,0,91,0,5608
"36059520200",2624,50,0,4,650,0,266,0,3594
"36059520300",5483,183,13,0,227,0,478,0,6384
"36059520401",2931,156,76,0,589,6,346,29,4133
"36059520402",3847,177,80,6,256,13,885,69,5333
"36059520501",3400,126,15,0,307,9,574,0,4431
"36059520502",4437,99,179,0,74,41,278,0,5108
"36059520600",5226,65,97,0,470,0,626,0,6484
"36059520700",4582,155,153,0,122,8,328,8,5356
"36059520800",3691,217,0,2,99,1,254,21,4285
"36059520900",4395,145,31,0,202,0,108,0,4881
"36059521000",4533,349,0,0,207,0,185,48,5322
"36059521100",4679,144,0,0,81,9,221,9,5143
"36059521200",2749,76,85,2,157,16,189,0,3274
"36059521301",2142,19,4,6,96,0,194,0,2461
"36059521302",5295,94,0,0,35,11,185,43,5663
"36059521400",6445,16,0,1,145,0,195,0,6802
"36059521500",4492,105,19,0,130,0,326,0,5072
"36059521601",4293,74,6,0,53,1,175,1,4603
"36059521602",3235,11,10,0,30,0,255,0,3541
"36059521700",4316,166,13,0,147,10,353,9,5014
"36059521801",3510,62,168,0,49,0,121,9,3919
"36059521802",3902,149,40,0,76,0,188,0,4355
"36059521902",3916,64,2,1,64,0,164,17,4228
"36059522000",3364,415,2097,38,1495,274,2189,374,10246
"36059522700",4782,49,1,0,28,3,256,0,5119
"36059980100",0,0,0,0,0,0,0,0,0
"36059981100",0,0,0,0,0,0,0,0,0
"36059982100",0,0,0,0,0,0,0,0,0
"36059990100",0,0,0,0,0,0,0,0,0
"36059990200",0,0,0,0,0,0,0,0,0
"36059990301",0,0,0,0,0,0,0,0,0
"36059990302",0,0,0,0,0,0,0,0,0
"36059990400",0,0,0,0,0,0,0,0,0
"36061000100",0,0,0,0,0,0,0,0,0
"36061000201",412,222,36,117,1046,874,633,249,3589
"36061000202",2884,783,681,276,2884,800,2463,705,11476
"36061000500",0,0,0,0,0,0,0,0,0
"36061000600",676,647,368,603,5733,3136,2337,1102,14602
"36061000700",5683,539,279,4,1743,346,507,67,9168
"36061000800",683,163,83,5,5540,2859,221,41,9595
"36061000900",1036,79,32,0,213,35,144,10,1549
"36061001001",1208,84,50,9,318,12,380,9,2070
"36061001002",1188,624,701,538,2291,758,2969,1119,10188
"36061001200",1641,207,134,7,1193,311,819,200,4512
"36061001300",2845,220,103,31,874,94,406,48,4621
"36061001401",2243,120,126,2,584,90,377,33,3575
"36061001402",810,336,127,17,840,536,289,256,3211
"36061001501",3331,215,282,27,1377,321,488,22,6063
"36061001502",4108,388,216,14,1576,184,366,35,6887
"36061001600",1013,108,54,0,4234,2266,288,49,8012
"36061001800",2029,393,107,133,3814,1508,427,344,8755
"36061002000",769,458,690,304,1294,1357,1680,1467,8019
"36061002100",4753,41,170,18,1286,71,168,4,6511
"36061002201",1828,184,931,121,2601,1184,2359,658,9866
"36061002202",1019,168,76,24,517,140,219,114,2277
"36061002400",1010,297,419,299,2110,1523,1653,1008,8319
"36061002500",624,367,357,140,1809,1957,1151,1092,7497
"36061002601",1282,383,173,199,1593,411,1489,442,5972
"36061002602",2455,42,124,57,1396,301,589,174,5138
"36061002700",203,14,9,1,823,188,15,0,1253
"36061002800",2317,741,608,244,2036,1438,2128,1398,10910
"36061002900",197,14,87,1,3242,977,74,13,4605
"36061003001",2271,295,76,6,1259,308,412,318,4945
"36061003002",1536,235,171,84,712,187,555,170,3650
"36061003100",898,43,60,40,404,94,138,46,1723
"36061003200",5550,466,59,64,1208,265,449,139,8200
"36061003300",4010,227,64,63,875,23,370,12,5644
"36061003400",4371,822,95,41,839,505,840,405,7918
"36061003601",1366,127,187,200,810,576,878,278,4422
"36061003602",1426,275,60,284,534,200,185,172,3136
"36061003700",2004,171,40,0,250,58,104,17,2644
"36061003800",5187,589,348,42,1488,364,699,97,8814
"36061003900",3739,258,155,18,925,60,496,102,5753
"36061004000",5688,820,466,42,745,93,382,154,8390
"36061004100",2017,282,77,143,3400,1263,198,128,7508
"36061004200",1985,195,84,79,460,56,75,9,2943
"36061004300",2475,266,2,4,1051,510,334,6,4648
"36061004400",11619,1407,536,0,2563,610,1180,125,18040
"36061004500",742,9,1,2,226,30,23,0,1033
"36061004700",1875,220,0,0,302,0,83,11,2491
"36061004800",4346,455,209,86,1434,63,358,157,7108
"36061004900",3899,90,110,0,435,10,253,12,4809
"36061005000",4017,348,42,0,738,30,264,61,5500
"36061005200",2047,225,0,36,590,89,149,25,3161
"36061005400",3440,229,13,2,620,59,379,45,4787
"36061005501",3623,158,70,0,681,23,18,0,4573
"36061005502",1691,183,40,108,386,28,305,45,2786
"36061005600",1497,374,121,122,595,25,268,107,3109
"36061005700",2295,122,70,0,407,34,126,47,3101
"36061005800",1961,107,19,42,861,0,58,39,3087
"36061005900",4002,244,121,13,497,33,147,27,5084
"36061006000",3607,146,205,0,813,255,357,63,5446
"36061006100",2923,134,0,12,444,56,197,13,3779
"36061006200",1464,485,233,306,669,365,348,180,4050
"36061006300",4843,258,40,19,726,71,198,92,6247
"36061006400",5357,463,243,25,1230,48,415,3,7784
"36061006500",3794,567,127,60,642,43,215,105,5553
"36061006600",6292,918,648,119,2776,486,2299,480,14018
"36061006700",4102,223,175,1,453,52,186,22,5214
"36061006800",4177,352,165,297,778,133,417,111,6430
"36061006900",1799,110,78,10,290,52,137,11,2487
"36061007000",5250,532,109,11,1660,415,147,95,8219
"36061007100",4404,338,28,33,936,72,165,46,6022
"36061007200",4921,474,64,20,1663,86,497,26,7751
"36061007300",4849,231,126,47,518,3,382,86,6242
"36061007400",2125,344,41,52,627,86,375,0,3650
"36061007500",4021,210,0,25,230,53,362,3,4904
"36061007600",963,166,77,13,691,155,45,15,2125
"36061007700",4557,242,86,0,580,50,368,0,5883
"36061007800",5174,542,164,3,1650,107,646,147,8433
"36061007900",3922,416,13,0,227,29,301,48,4956
"36061008000",3637,439,61,38,606,56,306,28,5171
"36061008100",6469,713,165,40,1253,105,807,105,9657
"36061008200",2106,216,444,25,562,74,102,42,3571
"36061008300",2091,374,288,97,709,455,536,226,4776
"36061008400",680,85,64,8,791,257,87,7,1979
"36061008601",1809,190,58,0,556,116,175,7,2911
"36061008602",0,0,0,0,0,0,0,0,0
"36061008603",4029,68,0,0,185,71,190,25,4568
"36061008700",5709,214,37,0,1342,0,995,14,8311
"36061008800",4345,397,142,0,1777,86,364,9,7120
"36061008900",3806,410,202,222,613,49,389,246,5937
"36061009000",4689,320,96,80,1794,215,510,89,7793
"36061009100",4408,457,43,61,1218,372,347,82,6988
"36061009200",1247,41,20,51,315,8,115,38,1835
"36061009300",6846,266,519,1357,1058,537,1863,332,12778
"36061009400",29,0,0,0,4,0,0,0,33
"36061009500",1457,123,73,1,512,162,92,0,2420
"36061009600",98,0,0,0,38,11,7,0,154
"36061009700",2777,590,320,59,1130,229,1117,403,6625
"36061009800",5810,168,66,76,1033,80,431,22,7686
"36061009900",2349,105,128,33,1158,124,281,0,4178
"36061010000",1246,138,20,4,403,14,214,34,2073
"36061010100",677,37,55,32,367,31,99,12,1310
"36061010200",182,27,2,4,10,0,1,2,228
"36061010300",1086,119,171,0,547,76,80,11,2090
"36061010400",679,60,17,3,250,12,140,3,1164
"36061010601",6152,206,100,26,583,120,398,0,7585
"36061010602",3388,190,176,0,650,0,314,0,4718
"36061010800",6690,267,146,0,1134,83,506,1,8827
"36061010900",135,12,13,7,32,21,0,2,222
"36061011000",7046,127,147,75,394,22,635,0,8446
"36061011100",2338,243,265,99,1094,326,524,284,5173
"36061011201",673,16,16,0,129,9,24,0,867
"36061011202",242,5,0,0,19,0,3,0,269
"36061011203",932,130,0,32,186,18,118,8,1424
"36061011300",18,20,2,13,75,0,0,16,144
"36061011401",1135,41,9,4,141,7,5,3,1345
"36061011402",1985,109,11,0,269,11,101,17,2503
"36061011500",1269,278,166,104,708,148,438,159,3270
"36061011600",2141,175,440,1,599,0,130,28,3514
"36061011700",1929,162,295,1,934,214,662,190,4387
"36061011800",7708,695,35,4,914,90,311,0,9757
"36061011900",279,232,225,211,60,64,79,175,1325
"36061012000",2829,202,0,43,197,11,72,101,3455
"36061012100",5892,622,392,110,1169,103,1375,126,9789
"36061012200",3165,107,0,0,14,0,84,15,3385
"36061012400",6552,610,438,56,2088,60,908,83,10795
"36061012500",1297,163,24,45,849,87,115,33,2613
"36061012600",8694,367,129,58,1773,17,544,6,11588
"36061012700",3887,540,267,91,1638,212,1311,216,8162
"36061012800",5239,369,7,0,260,0,264,23,6162
"36061012900",3174,328,168,163,1275,162,619,151,6040
"36061013000",3165,260,0,10,243,11,33,95,3817
"36061013100",1705,265,120,18,394,152,244,174,3072
"36061013200",8271,589,21,0,831,157,572,196,10637
"36061013300",3361,277,69,157,1037,325,1020,187,6433
"36061013400",8244,1581,54,45,995,276,634,149,11978
"36061013500",3372,570,647,177,850,351,1725,635,8327
"36061013600",13132,539,181,0,1703,86,740,1,16382
"36061013700",5084,385,73,24,1239,172,374,0,7351
"36061013800",10230,837,57,39,1140,175,684,169,13331
"36061013900",5769,362,328,2,1207,112,642,51,8473
"36061014000",6314,463,70,0,743,43,281,127,8041
"36061014200",3625,319,7,7,330,0,239,79,4606
"36061014300",0,1,0,1,0,1,0,2,5
"36061014401",4356,148,16,0,379,57,262,25,5243
"36061014402",6075,339,257,56,810,0,198,64,7799
"36061014500",3371,416,79,18,711,31,342,131,5099
"36061014601",3686,183,30,23,465,17,232,28,4664
"36061014602",6240,403,100,57,889,39,563,28,8319
"36061014700",1823,72,44,13,807,33,154,16,2962
"36061014801",2299,89,52,0,466,27,119,27,3079
"36061014802",5773,224,88,1,699,340,341,23,7489
"36061014900",4489,184,28,21,705,97,335,37,5896
"36061015001",1790,94,89,0,148,61,23,0,2205
"36061015002",5043,164,25,3,226,0,450,44,5955
"36061015100",3877,368,623,192,1720,700,1583,769,9832
"36061015200",4236,394,716,351,1061,403,1209,673,9043
"36061015300",7480,384,222,2,700,193,819,34,9834
"36061015400",11055,1027,551,8,2178,144,1514,350,16827
"36061015500",8115,377,169,0,1509,74,488,0,10732
"36061015601",3946,437,342,24,937,14,580,149,6429
"36061015602",617,145,248,122,820,255,608,280,3095
"36061015700",8621,539,27,68,807,61,388,19,10530
"36061015801",4601,205,175,48,292,47,236,107,5711
"36061015802",2223,155,197,9,1027,74,357,76,4118
"36061015900",6897,661,147,5,761,138,361,123,9093
"36061016001",3233,110,1,5,346,0,238,8,3941
"36061016002",1881,198,59,1,473,65,378,57,3112
"36061016100",5468,255,74,19,720,27,220,0,6783
"36061016200",1700,750,2638,1298,1119,1478,2185,2051,13219
"36061016300",5624,426,54,52,1036,60,262,29,7543
"36061016400",1559,492,1622,325,2034,690,2104,1023,9849
"36061016500",5839,283,311,26,545,18,522,105,7649
"36061016600",2621,998,917,216,2048,766,2824,1333,11723
"36061016700",5123,448,129,17,581,11,441,0,6750
"36061016800",1140,353,798,809,721,456,1265,610,6152
"36061016900",6134,403,348,59,542,233,463,119,8301
"36061017000",1583,258,1899,509,2052,1276,2426,1095,11098
"36061017100",7059,568,575,238,829,113,765,195,10342
"36061017200",1562,386,1143,353,1765,451,2788,713,9161
"36061017300",6595,189,380,224,1557,23,1432,109,10509
"36061017401",752,240,987,798,1027,430,986,905,6125
"36061017402",606,174,752,288,480,262,541,167,3270
"36061017500",8887,198,119,82,1167,0,1583,25,12061
"36061017700",4978,488,1376,315,1556,652,1963,768,12096
"36061017800",1266,345,516,316,990,480,1321,558,5792
"36061017900",6314,971,492,197,1229,130,1131,389,10853
"36061018000",1004,801,2020,415,2600,861,2869,1522,12092
"36061018100",5448,518,1833,193,1178,97,1530,58,10855
"36061018200",807,569,965,819,2060,1333,2387,1724,10664
"36061018300",5999,248,432,204,1363,123,1145,288,9802
"36061018400",852,378,2725,1371,1875,1073,2684,1594,12552
"36061018500",3299,239,657,92,947,62,338,3,5637
"36061018600",476,482,2500,1702,1008,908,1038,1385,9499
"36061018700",5756,379,584,603,1175,367,761,793,10418
"36061018800",1183,779,1038,320,1646,601,2233,811,8611
"36061018900",2960,1408,2948,1462,1814,1172,2416,2853,17033
"36061019000",479,81,1368,475,551,56,290,89,3389
"36061019100",6776,321,688,243,1187,84,948,111,10358
"36061019200",267,224,576,1134,959,873,1108,1157,6298
"36061019300",3274,1229,1144,780,1653,1123,2152,2052,13407
"36061019400",636,185,1129,1561,1180,1986,1658,2021,10356
"36061019500",5046,599,580,73,1175,369,1356,301,9499
"36061019600",569,251,675,247,1248,911,1444,979,6324
"36061019701",398,134,64,9,72,196,83,102,1058
"36061019702",674,180,672,180,288,208,329,232,2763
"36061019800",552,38,1481,138,187,47,165,52,2660
"36061019900",4258,969,164,170,1054,619,693,138,8065
"36061020000",759,75,1387,225,561,11,393,32,3443
"36061020101",434,97,24,1,75,31,23,1,686
"36061020102",1124,91,1692,655,558,45,717,205,5087
"36061020300",415,110,189,35,158,112,67,43,1129
"36061020500",2277,67,21,26,278,5,138,34,2846
"36061020600",311,81,1575,622,311,82,285,138,3405
"36061020701",1295,277,53,18,614,377,252,62,2948
"36061020800",1012,212,2066,958,739,432,309,393,6121
"36061020901",305,200,1513,733,747,489,971,711,5669
"36061021000",264,254,3631,1832,795,368,837,887,8868
"36061021100",2948,563,1468,314,2631,1221,1537,715,11397
"36061021200",259,36,2863,145,586,85,673,89,4736
"36061021303",716,213,1899,821,1383,615,1222,756,7625
"36061021400",211,32,1679,588,270,91,178,7,3056
"36061021500",451,271,1472,546,527,268,560,365,4460
"36061021600",1648,335,4118,1387,672,261,918,415,9754
"36061021703",0,0,0,0,0,0,0,0,0
"36061021800",1174,375,2635,1936,881,368,778,346,8493
"36061021900",284,335,1513,1029,1586,1293,1938,1396,9374
"36061022000",909,59,2432,870,977,330,826,258,6661
"36061022102",479,81,1213,245,286,88,84,13,2489
"36061022200",707,87,815,941,311,154,278,167,3460
"36061022301",1663,349,609,445,3388,1500,4195,1657,13806
"36061022302",773,195,762,377,854,465,1281,663,5370
"36061022400",491,119,2389,2512,949,884,1213,922,9479
"36061022500",3034,332,1964,1629,2406,1276,4776,1795,17212
"36061022600",509,47,1657,1174,410,225,450,228,4700
"36061022700",847,411,1922,930,892,424,992,807,7225
"36061022800",570,79,2858,1089,635,483,382,397,6493
"36061022900",1505,715,2544,535,1752,1179,2719,1631,12580
"36061023000",1013,226,4385,1974,1048,462,1707,583,11398
"36061023100",1685,511,1451,686,1657,386,1722,721,8819
"36061023200",320,285,4752,1643,1041,497,1716,776,11030
"36061023300",1373,491,2406,493,1033,932,1524,1465,9717
"36061023400",743,184,1838,1227,892,292,1074,521,6771
"36061023501",878,195,2176,958,1245,928,1287,1088,8755
"36061023502",146,62,983,295,193,29,222,70,2000
"36061023600",351,0,4784,1151,446,248,964,327,8271
"36061023700",1477,448,2032,539,2270,814,3025,990,11595
"36061023801",4606,249,818,126,2698,542,1320,114,10473
"36061023802",927,122,16,89,210,54,52,90,1560
"36061023900",387,236,1272,131,396,104,888,313,3727
"36061024000",98,366,52,620,61,187,97,370,1851
"36061024100",1265,349,2260,290,2160,1196,2636,1435,11591
"36061024200",287,348,1098,763,555,615,752,1097,5515
"36061024301",664,391,1279,654,811,258,1202,778,6037
"36061024302",519,393,2054,1724,950,991,1702,1530,9863
"36061024500",2988,1550,1686,616,6040,2857,8701,3949,28387
"36061024700",2182,889,670,231,3280,504,4393,1368,13517
"36061024900",147,42,228,81,468,219,603,279,2067
"36061025100",383,295,252,182,1212,219,1433,404,4380
"36061025300",2537,1228,889,396,4691,1586,6095,2493,19915
"36061025500",2265,400,395,126,1135,633,1403,569,6926
"36061025700",1271,41,1771,440,713,219,569,217,5241
"36061025900",906,310,1494,628,743,327,714,646,5768
"36061026100",2296,1191,1093,321,6010,2702,8202,3967,25782
"36061026300",1758,781,613,234,3972,2016,5172,2853,17399
"36061026500",2741,454,660,133,2798,740,3689,1077,12292
"36061026700",722,248,54,4,598,87,758,130,2601
"36061026900",1750,452,429,247,4798,1323,6525,1645,17169
"36061027100",3800,1022,378,200,3052,1081,4732,1594,15859
"36061027300",4180,923,444,64,1191,218,1757,280,9057
"36061027500",2439,148,190,86,604,16,651,65,4199
"36061027700",1336,519,237,335,2586,1432,3683,2091,12219
"36061027900",2928,627,877,190,5714,895,7102,1382,19715
"36061028100",2398,90,91,12,234,10,305,19,3159
"36061028300",3251,399,576,97,3017,515,4727,591,13173
"36061028500",1303,389,744,262,3783,1300,4999,1840,14620
"36061028700",1520,466,177,39,1520,535,1837,855,6949
"36061029100",1771,827,725,201,6208,2420,7905,3329,23386
"36061029300",1943,1185,526,141,3698,1608,5281,2889,17271
"36061029500",3137,504,243,40,3747,733,4532,929,13865
"36061029700",0,0,0,0,0,0,0,0,0
"36061029900",723,302,817,97,1198,1155,1969,1440,7701
"36061030300",1697,365,124,188,1116,907,1555,1208,7160
"36061030700",2514,93,151,18,764,44,1128,65,4777
"36061030900",1784,761,1659,854,2878,1315,4488,2165,15904
"36061031100",0,0,0,0,0,0,0,0,0
"36061031703",6145,315,81,0,2050,37,734,39,9401
"36061031704",4206,207,82,0,1806,74,899,0,7274
"36061031900",0,0,0,0,0,0,0,0,0
"36063020100",2729,444,43,23,38,108,72,28,3485
"36063020200",55,202,884,1137,16,119,5,32,2450
"36063020300",1407,196,267,125,109,53,0,0,2157
"36063020400",628,125,596,129,6,22,26,36,1568
"36063020500",603,574,283,452,36,25,24,8,2005
"36063020600",162,181,491,358,37,16,13,0,1258
"36063020700",1538,203,523,457,0,152,0,117,2990
"36063020900",801,453,731,812,18,94,17,110,3036
"36063021000",1375,580,339,206,171,127,9,35,2842
"36063021100",477,188,301,173,180,25,21,0,1365
"36063021200",935,352,536,205,124,94,29,37,2312
"36063021300",694,651,346,322,165,74,84,40,2376
"36063021400",1383,303,258,86,24,55,7,3,2119
"36063021700",1739,798,537,205,102,55,0,0,3436
"36063022000",2723,379,79,39,132,9,141,0,3502
"36063022100",2039,295,56,0,124,34,0,85,2633
"36063022200",2902,406,257,0,109,0,37,5,3716
"36063022300",2467,10,54,12,126,0,9,0,2678
"36063022401",1514,153,46,14,46,0,30,6,1809
"36063022500",2376,158,36,12,77,0,14,0,2673
"36063022601",2015,332,57,46,163,23,75,0,2711
"36063022602",4618,733,188,13,82,2,44,0,5680
"36063022702",6303,148,0,3,19,10,0,0,6483
"36063022711",9059,495,267,0,333,14,257,0,10425
"36063022712",6304,792,240,30,463,17,251,7,8104
"36063022803",3427,55,77,0,70,0,160,0,3789
"36063022804",3192,129,2,0,0,38,32,4,3397
"36063022901",2138,152,0,0,0,0,9,0,2299
"36063022902",2522,170,61,1,74,0,82,0,2910
"36063023001",1757,308,45,16,43,5,43,5,2222
"36063023100",1942,326,7,13,17,47,50,34,2436
"36063023200",2029,572,37,2,3,0,72,29,2744
"36063023300",5445,1012,128,87,330,71,48,16,7137
"36063023401",5697,472,87,99,108,48,156,10,6677
"36063023402",3689,109,100,7,141,27,118,0,4191
"36063023404",4727,219,281,34,15,114,61,172,5623
"36063023405",2770,541,57,9,316,38,51,30,3812
"36063023500",1656,546,98,280,63,0,84,0,2727
"36063023600",2491,655,225,44,313,92,136,0,3956
"36063023700",799,413,113,165,202,64,116,6,1878
"36063023800",2479,360,53,28,42,134,141,44,3281
"36063023901",3249,477,179,208,67,16,37,0,4233
"36063023902",4141,374,56,0,300,0,284,72,5227
"36063024001",4958,584,32,0,367,0,0,0,5941
"36063024002",1465,217,0,0,17,0,6,0,1705
"36063024101",3419,391,0,0,63,27,18,58,3976
"36063024102",2374,260,0,9,33,42,135,42,2895
"36063024201",5823,439,13,3,83,27,0,0,6388
"36063024202",2490,419,0,1,29,14,37,10,3000
"36063024301",1043,144,0,1,8,0,0,0,1196
"36063024302",4302,344,0,29,39,40,59,16,4829
"36063024303",5173,155,113,19,305,0,284,0,6049
"36063024401",2304,246,0,0,44,0,16,3,2613
"36063024404",4469,183,36,20,71,7,0,0,4786
"36063024405",4704,168,0,0,208,0,155,0,5235
"36063024406",1782,69,0,0,89,0,60,6,2006
"36063024501",2686,172,59,0,8,0,65,5,2995
"36063024502",3225,368,1,1,138,6,63,83,3885
"36063024600",4283,271,90,12,105,3,0,1,4765
"36063940001",83,3,0,0,758,215,8,11,1078
"36063940100",0,0,0,0,0,0,0,0,0
"36063990000",0,0,0,0,0,0,0,0,0
"36065020102",446,287,66,78,99,98,111,52,1237
"36065020300",169,312,126,105,197,103,19,56,1087
"36065020705",1499,299,264,0,166,45,79,33,2385
"36065020802",1952,782,538,178,337,258,236,423,4704
"36065020803",621,887,92,114,365,741,180,482,3482
"36065020900",847,640,170,222,54,32,17,111,2093
"36065021000",466,369,161,168,169,187,95,221,1836
"36065021101",409,102,43,56,163,56,141,12,982
"36065021102",807,380,261,296,291,448,123,120,2726
"36065021103",757,297,160,34,111,54,130,111,1654
"36065021201",515,344,146,221,363,185,200,120,2094
"36065021202",804,276,229,228,623,654,114,171,3099
"36065021301",1953,561,70,344,42,17,0,336,3323
"36065021302",2559,701,173,74,239,185,351,292,4574
"36065021303",2355,142,5,0,94,12,62,18,2688
"36065021401",1283,573,336,357,427,75,98,60,3209
"36065021402",882,338,81,363,59,125,77,69,1994
"36065021500",311,312,838,358,341,357,126,244,2887
"36065021601",4220,288,325,197,173,64,277,64,5608
"36065021602",1893,127,42,0,125,8,25,13,2233
"36065021701",2774,206,60,0,128,0,112,0,3280
"36065021702",1947,217,147,89,251,159,94,0,2904
"36065021900",1435,463,70,19,112,149,87,79,2414
"36065022000",1844,1071,104,84,128,96,132,125,3584
"36065022100",2266,232,9,10,70,7,42,23,2659
"36065022200",2410,87,16,0,12,0,0,0,2525
"36065022400",2983,357,148,1,170,20,28,0,3707
"36065022500",1925,856,115,45,205,129,226,56,3557
"36065022701",1862,52,5,2,97,0,50,2,2070
"36065022702",3849,227,37,3,115,0,50,0,4281
"36065022800",2336,272,94,18,65,55,6,14,2860
"36065023000",5175,494,20,0,334,14,78,110,6225
"36065023200",3871,567,17,0,2,0,2,0,4459
"36065023300",2168,427,0,0,62,17,63,28,2765
"36065023400",3145,649,132,73,82,34,0,10,4125
"36065023501",2294,78,12,0,16,0,17,0,2417
"36065023502",4220,251,15,0,6,6,38,0,4536
"36065023702",3443,231,11,0,114,0,7,38,3844
"36065023901",2119,92,1,1,77,0,38,0,2328
"36065023902",1759,212,23,0,3,0,6,0,2003
"36065024000",4046,322,0,2,60,23,6,12,4471
"36065024101",1226,217,0,0,22,1,0,0,1466
"36065024102",2454,402,4,1,20,25,10,28,2944
"36065024200",3730,598,0,0,83,24,22,12,4469
"36065024301",2796,60,100,2,49,0,40,0,3047
"36065024302",3104,258,9,0,31,27,163,27,3619
"36065024303",2170,218,47,0,77,9,55,21,2597
"36065024400",3139,735,3,7,56,20,67,9,4036
"36065024500",4100,629,18,18,80,53,51,21,4970
"36065024700",5212,1006,0,0,49,0,25,0,6292
"36065024800",2764,195,92,2,18,1,111,1,3184
"36065024900",4847,487,1,7,66,8,170,13,5599
"36065025001",2734,170,0,0,23,0,73,0,3000
"36065025002",3305,357,55,1,132,11,77,4,3942
"36065025003",1222,49,19,1,30,14,1,0,1336
"36065025100",1578,149,0,40,0,0,0,55,1822
"36065025200",3903,152,0,5,122,0,0,0,4182
"36065025300",6338,358,49,0,465,128,136,22,7496
"36065025400",5280,168,0,0,234,0,0,29,5711
"36065025500",3950,271,57,29,86,0,71,50,4514
"36065025600",3770,553,11,3,55,26,44,27,4489
"36065025700",2044,354,4,0,9,0,12,2,2425
"36065025800",1146,298,41,0,15,7,3,28,1538
"36065025900",4,58,3,0,0,0,0,0,65
"36065026100",1995,133,0,0,40,0,30,0,2198
"36065026200",4972,214,91,0,402,12,0,6,5697
"36065026300",2197,750,335,23,395,111,360,181,4352
"36065026400",928,573,620,736,810,1071,333,270,5341
"36065026500",79,28,5,6,0,0,5,5,128
"36065026600",96,106,0,41,8,20,0,22,293
"36065026700",4413,954,0,0,77,6,0,0,5450
"36065980002",0,0,0,0,0,0,0,0,0
"36065980003",0,0,0,0,0,0,0,0,0
"36065980100",0,0,0,0,0,0,0,0,0
"36067000100",383,74,76,0,10,55,11,3,612
"36067000200",1180,974,172,26,228,315,63,138,3096
"36067000300",1086,52,254,51,214,60,90,0,1807
"36067000400",2306,466,214,72,223,136,0,160,3577
"36067000501",643,352,226,156,258,400,22,54,2111
"36067000600",1434,538,321,377,528,663,90,93,4044
"36067000700",539,32,359,131,357,116,131,21,1686
"36067000800",1009,231,713,424,185,42,79,14,2697
"36067000900",2378,215,290,63,141,55,61,0,3203
"36067001000",2346,361,591,302,86,344,96,256,4382
"36067001400",788,571,245,368,717,1041,252,68,4050
"36067001500",707,240,335,719,535,665,256,131,3588
"36067001600",874,479,397,292,182,85,39,189,2537
"36067001701",1038,354,25,414,212,541,103,374,3061
"36067001702",1756,232,65,210,153,0,227,13,2656
"36067001800",1939,129,145,271,244,26,72,0,2826
"36067001900",2423,524,251,1,158,25,94,0,3476
"36067002000",1317,412,117,122,104,6,56,33,2167
"36067002101",1027,867,389,423,194,203,245,405,3753
"36067002300",429,304,214,330,350,97,150,20,1894
"36067002400",557,314,223,500,167,201,69,109,2140
"36067002700",1388,264,51,6,15,173,48,5,1950
"36067002901",2082,228,48,1,102,121,56,67,2705
"36067003000",244,508,334,365,82,354,137,710,2734
"36067003200",443,238,93,121,237,324,29,9,1494
"36067003400",241,320,223,99,133,255,22,84,1377
"36067003500",612,418,406,654,110,178,33,242,2653
"36067003601",340,436,792,539,128,70,51,166,2522
"36067003602",659,83,1141,104,116,68,108,17,2296
"36067003800",804,557,488,301,261,127,312,201,3051
"36067003900",609,617,736,764,225,411,254,525,4141
"36067004000",435,119,528,436,176,39,107,39,1879
"36067004200",54,188,579,1234,81,170,77,280,2663
"36067004301",55,196,203,273,74,44,99,40,984
"36067004302",86,542,27,98,23,148,18,63,1005
"36067004400",516,1193,0,38,127,127,0,51,2052
"36067004500",2040,1229,142,42,120,406,37,97,4113
"36067004600",2980,185,603,355,345,29,115,2,4614
"36067004800",1212,83,136,98,21,10,22,0,1582
"36067004900",757,259,98,80,41,118,27,64,1444
"36067005000",1930,87,563,316,27,0,19,101,3043
"36067005100",330,398,790,458,122,149,44,289,2580
"36067005200",128,87,993,706,95,137,6,175,2327
"36067005300",92,47,645,958,2,40,28,28,1840
"36067005400",113,258,1093,1096,292,246,93,372,3563
"36067005500",1151,419,801,357,367,446,55,0,3596
"36067005601",997,85,140,40,113,14,32,3,1424
"36067005602",70,237,26,83,10,190,0,46,662
"36067005700",703,24,549,335,113,47,41,10,1822
"36067005800",167,220,989,862,155,139,168,147,2847
"36067005900",178,40,946,439,35,90,90,52,1870
"36067006000",1728,307,1085,367,140,0,276,0,3903
"36067006101",614,172,1491,655,149,191,80,46,3398
"36067006102",820,262,205,285,272,146,32,27,2049
"36067006103",1751,60,448,73,163,0,107,0,2602
"36067010100",2623,199,0,0,76,0,113,0,3011
"36067010200",4859,604,130,0,275,0,53,0,5921
"36067010301",4983,381,191,0,67,34,61,0,5717
"36067010321",2463,116,73,0,166,0,6,0,2824
"36067010322",3365,121,52,0,331,0,38,0,3907
"36067010400",3816,202,8,1,54,23,243,0,4347
"36067010500",2099,158,49,3,82,7,31,2,2431
"36067010600",1929,132,0,18,67,16,1,0,2163
"36067010700",1534,170,18,0,46,8,6,0,1782
"36067010800",4335,232,58,0,204,1,155,16,5001
"36067010900",1827,197,97,0,55,0,50,0,2226
"36067011011",2683,157,34,0,163,0,94,0,3131
"36067011012",3414,265,37,9,176,0,98,0,3999
"36067011021",2515,167,114,0,104,12,32,0,2944
"36067011022",2722,224,131,0,38,0,0,136,3251
"36067011101",4992,335,427,1,300,0,165,0,6220
"36067011102",2316,613,276,164,171,69,115,42,3766
"36067011201",2789,557,119,15,125,140,75,25,3845
"36067011202",4285,185,144,0,243,36,224,0,5117
"36067011231",4220,205,43,1,233,49,107,10,4868
"36067011232",3307,325,61,34,218,2,27,1,3975
"36067011241",2229,41,8,0,154,12,57,12,2513
"36067011242",5501,420,236,15,268,0,159,33,6632
"36067011300",2649,126,0,0,14,0,28,0,2817
"36067011401",6006,439,63,97,359,72,160,163,7359
"36067011402",3884,442,17,2,125,4,82,3,4559
"36067011500",5053,272,52,0,278,26,65,1,5747
"36067011600",4529,221,17,1,171,40,204,0,5183
"36067011700",2512,318,19,66,115,0,98,0,3128
"36067011800",5429,299,101,0,219,37,27,0,6112
"36067011900",3658,115,0,0,204,67,167,38,4249
"36067012000",5259,440,2,0,155,0,59,0,5915
"36067012100",4042,189,26,0,121,21,168,1,4568
"36067012200",1022,125,14,13,7,3,14,13,1211
"36067012300",2945,106,1,0,178,1,55,1,3287
"36067012400",3825,357,39,0,75,26,71,0,4393
"36067012500",3458,257,50,8,97,18,102,54,4044
"36067012600",4802,101,41,0,108,104,41,60,5257
"36067012700",1699,166,0,0,98,8,42,79,2092
"36067012800",2867,121,0,0,36,2,74,0,3100
"36067012900",1984,510,80,1,29,1,198,50,2853
"36067013000",3252,345,12,17,283,0,210,20,4139
"36067013100",4178,237,0,2,74,0,31,0,4522
"36067013200",2523,60,0,6,40,1,145,0,2775
"36067013300",2000,98,44,8,33,57,75,58,2373
"36067013400",4506,405,197,41,184,88,141,74,5636
"36067013500",4477,213,110,0,335,41,114,0,5290
"36067013600",2601,152,16,0,155,29,79,48,3080
"36067013701",3615,390,200,244,271,128,47,8,4903
"36067013800",1925,122,116,3,68,0,9,0,2243
"36067013900",2235,349,152,12,127,0,28,35,2938
"36067014000",2776,543,129,111,306,16,170,62,4113
"36067014200",3013,354,47,117,264,42,43,108,3988
"36067014300",2261,509,83,1,155,8,124,10,3151
"36067014400",1933,183,86,25,63,0,0,0,2290
"36067014500",3380,158,69,56,214,0,107,0,3984
"36067014600",2669,336,501,66,603,109,158,41,4483
"36067014700",4493,195,528,18,685,9,210,0,6138
"36067014800",2746,88,60,1,106,0,29,0,3030
"36067014900",1500,113,30,7,153,0,32,0,1835
"36067015000",3915,80,55,0,193,0,101,2,4346
"36067015100",5017,223,32,65,340,0,33,0,5710
"36067015201",2621,197,77,0,136,68,147,0,3246
"36067015202",3907,99,414,1,393,21,24,0,4859
"36067015203",2199,75,90,0,238,7,8,0,2617
"36067015400",5112,303,115,4,184,0,50,0,5768
"36067015500",2377,186,90,0,104,9,0,0,2766
"36067015601",2815,345,1,1,52,35,44,0,3293
"36067015700",6334,203,55,0,616,0,229,0,7437
"36067015800",4241,249,18,110,264,40,0,0,4922
"36067016001",3508,65,17,7,88,50,56,7,3798
"36067016002",2840,29,10,6,51,0,58,0,2994
"36067016100",1666,56,84,1,299,55,158,25,2344
"36067016200",1575,136,152,41,322,36,31,41,2334
"36067016300",5909,255,180,62,320,52,184,0,6962
"36067016400",3636,117,9,0,57,21,197,0,4037
"36067016501",1609,117,0,24,27,0,69,0,1846
"36067016502",4022,217,4,0,182,5,0,0,4430
"36067016600",4272,268,0,0,32,0,47,14,4633
"36067016700",2538,38,0,0,49,1,0,2,2628
"36067016801",1642,46,0,0,28,3,21,0,1740
"36067016802",2359,167,0,0,21,4,16,0,2567
"36067016901",2437,160,18,1,113,14,13,41,2797
"36067016902",1886,79,7,16,194,13,140,21,2356
"36067940000",0,0,0,0,184,0,184,0,368
"36069050101",3361,78,33,1,26,0,26,1,3526
"36069050102",10122,279,22,14,433,0,269,0,11139
"36069050201",5192,629,210,0,204,166,123,202,6726
"36069050202",5352,175,15,73,329,69,472,3,6488
"36069050301",3767,307,125,9,153,26,67,27,4481
"36069050302",4089,558,8,22,94,33,70,25,4899
"36069050400",6032,678,114,12,172,12,97,46,7163
"36069050500",5515,547,2,8,63,7,18,9,6169
"36069050601",5208,375,39,49,232,5,62,7,5977
"36069050602",3572,497,24,38,116,17,118,6,4388
"36069050800",2915,275,10,11,26,14,0,1,3252
"36069050900",2060,67,0,2,117,31,70,0,2347
"36069051000",2046,451,28,2,125,6,10,2,2670
"36069051100",1494,474,19,5,75,30,21,50,2168
"36069051200",3053,206,26,4,86,24,65,10,3474
"36069051300",3613,472,12,9,80,72,38,10,4306
"36069051400",2571,145,1,1,19,1,60,0,2798
"36069051500",2897,89,100,7,48,92,279,92,3604
"36069051600",2797,353,271,200,127,15,133,282,4178
"36069051700",836,319,210,160,132,63,221,253,2194
"36069051800",1373,466,158,29,168,213,292,56,2755
"36069051900",1904,761,24,61,155,98,249,102,3354
"36069052000",4447,392,0,0,174,0,27,0,5040
"36069052100",3459,322,0,0,78,10,48,6,3923
"36069052200",2086,366,0,3,13,5,4,2,2479
"36071000100",781,88,489,168,1046,196,1106,91,3965
"36071000200",1280,172,179,266,859,0,1262,6,4024
"36071000300",2355,353,703,881,1660,863,2931,996,10742
"36071000400",830,252,1435,1016,395,715,1110,657,6410
"36071000501",597,311,284,403,768,650,1315,840,5168
"36071000502",374,471,594,1146,1055,549,1134,821,6144
"36071000600",1207,382,823,405,660,240,1420,504,5641
"36071001100",1424,292,1223,122,1141,465,1538,521,6726
"36071001200",688,148,359,92,1127,509,1247,582,4752
"36071001300",2331,38,532,5,461,0,880,16,4263
"36071001500",2095,453,744,241,1213,403,1564,499,7212
"36071001600",3040,263,1089,346,1375,415,1519,446,8493
"36071002100",1925,391,279,12,403,125,234,34,3403
"36071002200",2253,501,221,191,292,23,232,28,3741
"36071002300",1459,183,139,0,281,0,170,25,2257
"36071010101",4054,60,317,3,350,69,854,11,5718
"36071010102",3556,216,329,92,465,132,696,0,5486
"36071010200",3446,134,548,107,324,90,361,158,5168
"36071010300",2107,82,818,47,430,9,457,32,3982
"36071010400",2521,178,370,0,595,3,784,5,4456
"36071010500",5849,371,864,57,1110,339,1932,357,10879
"36071010600",6327,308,218,0,518,0,590,0,7961
"36071010700",4467,736,279,50,1135,226,1272,366,8531
"36071010801",2530,274,413,16,337,39,674,29,4312
"36071010802",4370,179,220,0,137,77,612,26,5621
"36071010901",2535,163,281,15,391,0,393,38,3816
"36071010902",5156,410,31,0,281,0,563,24,6465
"36071011000",3797,401,243,0,427,25,720,113,5726
"36071011101",1392,113,853,0,722,0,561,24,3665
"36071011102",2532,109,511,20,676,25,944,26,4843
"36071011200",2143,109,1191,164,640,95,896,95,5333
"36071011300",3536,354,1497,96,1550,417,1831,400,9681
"36071011400",3250,172,89,0,305,0,411,0,4227
"36071011500",4153,323,261,47,341,106,589,139,5959
"36071011601",3248,561,110,0,226,38,253,88,4524
"36071011602",2773,495,92,0,218,37,266,43,3924
"36071011701",3779,210,279,12,322,1,550,2,5155
"36071011702",3997,226,87,0,132,65,165,11,4683
"36071011801",4107,271,62,0,365,37,683,124,5649
"36071011802",2171,102,63,3,74,8,89,12,2522
"36071011900",3949,325,179,0,667,10,434,10,5574
"36071012100",2568,119,124,10,576,22,690,13,4122
"36071012200",2837,157,152,0,401,14,307,9,3877
"36071012300",4295,183,237,25,551,9,173,0,5473
"36071012601",2564,0,524,0,461,0,670,0,4219
"36071012602",1744,93,549,180,882,29,803,32,4312
"36071012700",2390,200,268,105,984,55,1137,14,5153
"36071012800",3625,67,330,46,591,11,1090,12,5772
"36071012900",2649,90,1,0,195,0,123,0,3058
"36071013000",4027,165,0,0,396,45,722,33,5388
"36071013100",4357,195,159,0,222,28,382,0,5343
"36071013201",3890,187,185,0,804,9,1212,46,6333
"36071013202",1309,198,150,6,353,66,546,67,2695
"36071013300",6641,486,110,58,357,0,750,35,8437
"36071013400",2320,164,160,0,328,65,397,50,3484
"36071013500",5125,423,234,0,452,25,860,0,7119
"36071013600",2407,62,66,0,373,46,423,43,3420
"36071013700",1497,152,596,45,518,26,483,57,3374
"36071013800",2148,115,120,25,172,21,154,28,2783
"36071013900",3724,147,31,0,472,5,634,3,5016
"36071014101",3052,116,202,0,530,304,554,298,5056
"36071014102",3329,112,658,0,1201,22,1163,25,6510
"36071014201",3038,302,192,29,355,27,384,66,4393
"36071014202",5369,266,41,0,789,31,753,31,7280
"36071014301",3371,155,736,116,670,95,926,92,6161
"36071014302",5284,126,366,0,852,17,971,17,7633
"36071014400",3652,194,341,0,380,0,441,0,5008
"36071014501",3868,135,0,22,583,20,548,16,5192
"36071014502",4337,217,509,0,223,0,560,0,5846
"36071014600",6007,355,211,0,166,41,335,120,7235
"36071014700",2618,118,348,0,449,93,272,93,3991
"36071014800",4642,490,133,3,984,0,1269,140,7661
"36071014900",3138,41,60,0,350,13,197,0,3799
"36071015003",1591,2697,0,0,0,12,32,12,4344
"36071015004",2360,4161,0,13,34,16,70,242,6896
"36071015005",2580,1589,0,0,287,24,301,54,4835
"36071015006",2780,3670,0,0,13,22,10,34,6529
"36071015100",1652,900,992,240,768,439,981,813,6785
"36071015200",7790,257,993,0,695,61,1218,100,11114
"36073040200",2960,290,16,0,37,5,50,32,3390
"36073040300",1928,375,14,51,213,96,161,23,2861
"36073040400",2445,406,136,19,117,172,220,16,3531
"36073040500",1670,416,144,158,35,0,7,0,2430
"36073040600",4757,499,11,5,67,7,146,7,5499
"36073040700",3664,1282,585,26,62,245,65,437,6366
"36073040801",3939,659,24,29,58,18,72,8,4807
"36073040802",3168,497,31,32,69,19,51,0,3867
"36073401200",2764,272,60,11,50,7,29,6,3199
"36073401300",4167,500,84,14,164,17,80,68,5094
"36073990000",0,0,0,0,0,0,0,0,0
"36075020100",2857,583,0,13,82,34,17,41,3627
"36075020200",3179,611,1,5,99,8,17,10,3930
"36075020301",1585,575,0,0,34,2,18,0,2214
"36075020302",2711,745,11,0,14,5,17,26,3529
"36075020400",4226,726,3,0,64,164,10,31,5224
"36075020500",4806,966,0,1,132,29,36,7,5977
"36075020600",4249,510,0,0,197,5,114,3,5078
"36075020701",3382,690,0,12,158,0,15,0,4257
"36075020702",3635,524,0,0,67,0,26,7,4259
"36075020703",4130,881,0,0,128,21,11,0,5171
"36075020800",2997,641,0,7,9,0,0,11,3665
"36075020901",1827,536,11,1,79,43,72,39,2608
"36075020902",5344,426,25,0,117,0,21,0,5933
"36075021000",5008,667,0,0,75,0,62,0,5812
"36075021101",2364,1643,22,5,88,216,75,199,4612
"36075021102",1112,849,0,21,72,138,50,218,2460
"36075021103",2341,359,0,2,59,0,56,13,2830
"36075021104",1821,449,1,0,65,7,38,22,2403
"36075021200",5735,913,56,0,16,14,83,0,6817
"36075021300",3511,964,47,24,165,40,38,70,4859
"36075021401",3754,311,13,22,44,23,52,23,4242
"36075021402",1345,189,20,3,37,2,15,0,1611
"36075021501",2494,299,0,3,56,0,0,0,2852
"36075021502",5805,768,44,0,129,19,45,48,6858
"36075021601",1651,1131,40,1,71,28,35,82,3039
"36075021602",1998,1038,51,32,76,59,23,51,3328
"36075021603",3132,457,0,0,49,2,153,7,3800
"36075021604",2525,1119,0,6,204,194,42,187,4277
"36075021605",2249,737,122,28,236,19,97,25,3513
"36075990000",0,0,0,0,0,0,0,0,0
"36077590100",3922,443,5,13,126,32,77,16,4634
"36077590201",1717,216,0,0,19,6,29,0,1987
"36077590202",3079,373,8,6,153,0,16,8,3643
"36077590300",3400,523,26,0,173,7,52,1,4182
"36077590400",4499,605,6,0,42,4,37,16,5209
"36077590500",2629,351,0,2,9,0,4,0,2995
"36077590600",1610,170,6,2,51,10,24,1,1874
"36077590700",3540,641,21,12,44,19,267,4,4548
"36077590800",3877,472,82,294,246,125,169,128,5393
"36077590900",1586,333,65,46,112,49,158,49,2398
"36077591000",1974,1253,0,11,103,67,76,29,3513
"36077591100",1739,882,51,64,78,68,53,16,2951
"36077591200",677,147,0,7,7,99,0,43,980
"36077591300",51,0,0,0,0,0,0,0,51
"36077591400",4675,954,13,0,137,15,86,69,5949
"36077591500",2920,523,2,3,53,32,60,11,3604
"36077591600",3833,383,12,11,89,15,96,2,4441
"36079010100",3395,186,151,0,198,9,445,9,4393
"36079010200",5742,597,56,80,862,218,640,356,8551
"36079010300",3743,347,184,0,434,226,741,285,5960
"36079010400",2649,105,198,1,212,13,394,0,3572
"36079010500",4614,188,236,8,154,0,380,0,5580
"36079010600",3423,104,20,15,164,6,151,6,3889
"36079010700",2286,134,13,2,193,7,191,43,2869
"36079010800",2715,241,51,63,250,7,53,76,3456
"36079010900",6623,301,59,0,455,12,556,0,8006
"36079011000",3769,208,26,1,278,31,657,21,4991
"36079011100",5253,21,176,1,570,19,599,0,6639
"36079011200",5801,276,15,0,909,0,1245,151,8397
"36079011300",3516,223,0,0,129,45,260,148,4321
"36079011400",4498,84,57,4,201,39,457,39,5379
"36079011500",5575,256,46,0,585,96,481,94,7133
"36079011600",5309,12,30,0,324,0,430,4,6109
"36079011700",4510,148,59,19,157,8,490,15,5406
"36079011800",6046,680,110,7,893,214,1407,507,9864
"36079011900",4646,144,151,0,293,70,662,81,6047
"36081000100",3684,388,232,77,1318,229,286,86,6300
"36081000200",1164,105,47,15,1691,266,1670,227,5185
"36081000400",1472,192,404,42,2281,538,2030,363,7322
"36081000600",1187,102,236,138,1932,276,1933,180,5984
"36081000700",3646,153,144,0,1092,175,705,50,5965
"36081000800",1747,268,64,27,1065,465,1714,558,5908
"36081001000",1300,151,146,118,1455,167,1683,272,5292
"36081001200",2439,291,345,7,1518,230,2553,242,7625
"36081001400",2120,82,103,0,1397,158,2563,223,6646
"36081001600",1391,377,153,48,805,419,1599,548,5340
"36081001800",1099,124,300,0,1189,666,1555,419,5352
"36081001900",717,46,30,0,447,103,291,0,1634
"36081002000",456,19,45,35,1045,217,815,128,2760
"36081002200",730,104,114,5,768,197,826,180,2924
"36081002400",795,239,235,17,1004,44,971,228,3533
"36081002500",711,553,1970,1512,1070,522,1569,766,8673
"36081002600",811,126,329,6,1093,53,1156,123,3697
"36081002800",1058,82,60,157,1154,257,1213,270,4251
"36081003000",468,143,205,12,593,213,536,319,2489
"36081003100",601,127,31,1,203,52,389,104,1508
"36081003200",578,17,28,0,766,151,743,105,2388
"36081003300",914,419,65,37,935,304,445,411,3530
"36081003400",610,36,75,33,1186,124,993,92,3149
"36081003600",861,0,160,21,2070,372,1117,140,4741
"36081003700",0,0,0,0,0,0,0,0,0
"36081003800",669,245,99,59,970,524,1099,419,4084
"36081003900",591,299,39,80,393,172,584,307,2465
"36081004001",522,83,54,4,1202,150,937,98,3050
"36081004002",191,76,54,0,909,224,371,66,1891
"36081004200",1111,99,249,15,2711,809,1566,322,6882
"36081004300",504,265,495,390,306,398,565,609,3532
"36081004401",982,58,254,17,1584,796,927,139,4757
"36081004500",2114,135,178,34,722,131,652,62,4028
"36081004700",1370,494,996,360,714,176,1209,464,5783
"36081005000",3,0,0,0,4,0,4,0,11
"36081005100",612,150,12,70,862,400,260,73,2439
"36081005200",567,71,130,23,1618,298,899,256,3862
"36081005300",2483,370,76,0,1237,203,1056,91,5516
"36081005400",1661,274,286,18,2305,1069,1462,645,7720
"36081005500",409,87,26,0,487,116,525,59,1709
"36081005700",2286,353,155,50,1280,442,1749,273,6588
"36081005800",2724,270,233,300,2246,51,2281,384,8489
"36081005900",2511,394,50,9,697,91,1039,148,4939
"36081006100",3870,435,68,77,1256,279,1080,179,7244
"36081006201",4106,334,207,25,900,410,1457,343,7782
"36081006202",4303,492,406,0,1333,423,1966,411,9334
"36081006300",3183,696,276,0,693,364,1236,277,6725
"36081006501",2545,402,80,8,354,29,432,46,3896
"36081006502",2375,490,65,8,899,139,505,88,4569
"36081006900",2324,394,90,0,1528,126,1212,136,5810
"36081007100",2161,336,58,0,901,319,806,100,4681
"36081007300",2940,283,54,0,668,507,1237,14,5703
"36081007500",2560,489,33,0,837,222,917,194,5252
"36081007700",796,82,19,22,373,121,264,19,1696
"36081007900",871,258,104,181,1549,633,1115,339,5050
"36081008100",482,37,18,0,510,111,517,81,1756
"36081008300",1492,121,346,69,1512,332,1412,82,5366
"36081008500",371,176,20,0,489,112,461,51,1680
"36081008600",1164,181,145,0,1022,97,743,207,3559
"36081008700",888,326,1504,924,463,706,1082,1177,7070
"36081008800",2553,147,274,0,568,90,1840,1,5473
"36081009100",1663,213,98,1,665,142,697,71,3550
"36081009400",346,102,415,0,1648,433,503,158,3605
"36081009500",1685,230,65,0,600,33,403,87,3103
"36081009600",863,28,412,65,2370,305,1134,44,5221
"36081009700",2939,173,16,11,250,103,315,114,3921
"36081009800",280,55,307,97,1631,507,337,76,3290
"36081009900",0,0,0,0,0,0,0,0,0
"36081010000",332,192,639,70,2129,393,361,387,4503
"36081010100",1852,161,7,1,338,111,442,42,2954
"36081010200",348,30,482,7,2021,208,810,124,4030
"36081010300",2347,389,71,8,891,127,553,58,4444
"36081010400",242,62,493,93,2121,691,173,49,3924
"36081010500",1694,701,196,29,1445,66,1807,234,6172
"36081010600",307,9,583,70,1933,764,582,64,4312
"36081010701",0,0,0,0,0,0,0,0,0
"36081010800",367,42,200,64,2183,386,486,93,3821
"36081011000",723,44,231,109,1819,389,1001,117,4433
"36081011100",2078,334,0,0,504,117,611,164,3808
"36081011200",412,119,46,45,1373,298,421,115,2829
"36081011300",2723,176,37,10,922,324,936,147,5275
"36081011400",392,74,64,118,268,20,454,68,1458
"36081011500",1405,214,57,11,497,205,408,66,2863
"36081011600",274,37,134,82,1805,87,702,82,3203
"36081011700",2618,226,52,115,670,48,666,71,4466
"36081011800",652,39,189,0,1331,417,681,84,3393
"36081011900",1147,190,10,10,268,87,303,90,2105
"36081012000",197,15,93,94,1425,536,430,201,2991
"36081012100",1544,158,25,0,241,121,293,28,2410
"36081012200",757,125,134,97,1813,410,824,177,4337
"36081012301",1993,253,137,22,228,59,397,63,3152
"36081012400",794,175,132,79,1448,319,927,242,4116
"36081012500",1273,47,12,10,402,87,720,45,2596
"36081012601",436,109,167,14,1533,337,1468,206,4270
"36081012602",430,165,74,20,1540,135,997,182,3543
"36081012800",845,128,183,0,759,155,890,159,3119
"36081013000",715,80,125,13,561,14,387,33,1928
"36081013200",1036,154,261,0,559,75,413,75,2573
"36081013400",3207,242,413,0,1160,520,1167,88,6797
"36081013500",1357,128,0,0,160,0,197,7,1849
"36081013600",1192,128,71,0,512,65,599,48,2615
"36081013700",1302,176,9,0,215,148,181,214,2245
"36081013800",1567,65,164,91,1249,599,839,215,4789
"36081014000",2156,143,43,36,1039,76,816,53,4362
"36081014100",1191,109,90,5,359,71,465,52,2342
"36081014201",889,174,213,22,2481,391,1729,207,6106
"36081014202",514,94,120,53,1200,270,679,193,3123
"36081014300",2450,390,42,0,864,259,1014,222,5241
"36081014400",212,81,95,20,1451,175,596,95,2725
"36081014500",1361,203,140,0,300,107,317,42,2470
"36081014700",2336,166,49,37,442,11,663,11,3715
"36081014800",289,21,139,96,1342,317,531,143,2878
"36081014900",1675,120,28,10,406,44,689,10,2982
"36081015000",177,213,223,13,1726,208,427,59,3046
"36081015100",2038,184,0,0,390,82,225,104,3023
"36081015200",259,99,471,74,1573,377,460,145,3458
"36081015300",1118,129,8,19,599,147,276,75,2371
"36081015400",190,1,115,114,1670,362,625,44,3121
"36081015500",1711,177,53,0,355,132,528,32,2988
"36081015600",285,39,622,130,1941,368,316,6,3707
"36081015700",629,113,20,0,513,311,230,40,1856
"36081015801",302,31,692,234,2137,313,657,102,4468
"36081015802",374,82,491,112,2962,236,641,152,5050
"36081015900",2697,522,78,11,686,248,599,344,5185
"36081016100",1175,289,127,7,662,184,728,276,3448
"36081016300",1672,446,661,457,559,291,1752,510,6348
"36081016400",91,0,1150,310,1908,219,203,53,3934
"36081016600",499,147,591,33,1809,162,939,149,4329
"36081016800",324,36,516,42,2329,179,852,135,4413
"36081016900",3189,229,108,0,1707,163,1030,127,6553
"36081017000",113,28,706,238,1280,101,230,20,2716
"36081017100",0,0,0,0,0,0,0,0,0
"36081017200",218,5,694,174,1058,193,325,5,2672
"36081017400",176,31,912,287,1204,205,344,224,3383
"36081017600",98,11,946,88,1000,215,303,43,2704
"36081017800",66,10,1072,231,714,166,231,97,2587
"36081017900",714,39,5,12,209,60,424,39,1502
"36081018000",198,0,319,167,508,42,193,22,1449
"36081018101",2230,515,0,0,1337,316,1385,398,6181
"36081018102",1949,311,63,10,991,176,351,113,3964
"36081018200",83,7,1265,83,709,105,391,47,2690
"36081018300",3378,449,128,2,1480,557,1377,419,7790
"36081018401",100,0,1534,226,535,16,263,0,2674
"36081018402",68,32,1583,415,203,23,207,37,2568
"36081018501",1924,410,81,0,1197,49,1018,320,4999
"36081018502",2384,171,37,0,652,246,1100,55,4645
"36081018600",178,1,993,120,365,71,238,11,1977
"36081018700",1287,78,49,0,1301,87,780,35,3617
"36081018800",5,6,1000,190,126,1,151,11,1490
"36081018900",1679,265,255,12,947,251,1429,216,5054
"36081019000",132,13,1080,77,934,74,498,89,2897
"36081019200",262,15,1118,43,358,107,444,18,2365
"36081019400",115,0,1380,296,659,57,216,0,2723
"36081019600",103,123,1336,223,961,2,332,123,3203
"36081019800",160,85,841,400,1014,443,563,232,3738
"36081019900",272,34,46,0,367,61,315,70,1165
"36081020200",16,0,887,63,505,102,328,48,1949
"36081020400",106,13,685,272,720,180,367,88,2431
"36081020500",557,118,13,9,308,18,595,104,1722
"36081020600",219,25,406,6,769,124,630,132,2311
"36081020800",570,6,667,59,1069,208,866,128,3573
"36081021200",399,91,95,83,1173,372,947,248,3408
"36081021400",1123,399,421,39,3173,1201,1290,1093,8739
"36081021600",1617,209,642,1,1583,237,1277,144,5710
"36081021900",4,0,0,0,0,0,0,0,4
"36081022001",1988,163,472,158,2554,260,1601,233,7429
"36081022002",2422,457,1180,55,1895,209,1152,176,7546
"36081022900",0,0,0,0,0,0,0,0,0
"36081023000",828,35,53,0,1222,125,946,56,3265
"36081023200",956,284,354,191,3189,342,1205,147,6668
"36081023500",3358,894,142,17,2830,1260,3778,980,13259
"36081023600",464,211,252,35,1349,190,756,185,3442
"36081023800",292,124,453,84,2558,1041,1418,478,6448
"36081024000",614,445,943,134,2984,973,2105,1012,9210
"36081024300",2969,309,27,0,2386,228,1822,308,8049
"36081024500",3705,176,133,2,1846,591,2476,524,9453
"36081024600",0,0,0,0,0,0,0,0,0
"36081024700",435,63,38,0,843,98,512,85,2074
"36081024900",1936,302,33,13,2496,494,1105,284,6663
"36081025100",2351,299,15,0,2612,283,1781,140,7481
"36081025301",2574,253,39,8,1013,162,1490,121,5660
"36081025302",1284,251,44,0,799,311,980,221,3890
"36081025400",51,47,5154,1374,5180,856,4639,540,17841
"36081025500",603,52,0,0,722,66,212,46,1701
"36081025700",558,92,0,0,531,25,301,39,1546
"36081025800",39,32,1447,277,203,0,108,32,2138
"36081025900",1656,44,53,0,1236,385,1459,98,4931
"36081026000",106,16,1123,800,623,108,494,116,3386
"36081026100",2555,834,241,0,2638,893,2458,946,10565
"36081026200",29,0,716,285,179,70,145,37,1461
"36081026300",1641,266,30,0,3705,828,2079,183,8732
"36081026400",170,77,1347,274,276,42,342,119,2647
"36081026500",811,201,24,18,2438,526,610,301,4929
"36081026600",51,13,1157,228,261,194,283,93,2280
"36081026700",2566,339,33,0,2744,705,2842,359,9588
"36081026901",1896,393,9,0,2044,566,2043,546,7497
"36081026902",901,611,85,4,2318,591,998,666,6174
"36081027000",136,6,819,450,308,111,337,123,2290
"36081027100",2772,215,250,0,4104,1365,3285,582,12573
"36081027200",0,0,2184,334,56,15,67,30,2686
"36081027300",4345,1230,291,34,1459,755,5109,1582,14805
"36081027400",87,25,1098,199,307,0,190,25,1931
"36081027500",3402,1006,106,17,1906,449,3697,1306,11889
"36081027600",16,0,814,87,216,118,82,123,1456
"36081027700",4123,469,229,14,1964,995,4009,1235,13038
"36081027800",136,25,1578,407,222,177,407,186,3138
"36081027900",2828,663,188,1,2091,219,3257,755,10002
"36081028000",0,0,1392,33,288,0,211,0,1924
"36081028100",3532,363,47,0,665,107,2729,418,7861
"36081028200",5,0,1319,117,156,5,88,5,1695
"36081028300",3278,845,158,110,1740,486,2753,1046,10416
"36081028400",106,0,2707,739,386,132,246,141,4457
"36081028500",3001,568,78,0,913,384,1315,810,7069
"36081028700",3317,743,148,0,1314,577,2032,456,8587
"36081028800",58,26,3120,369,579,18,307,59,4536
"36081028900",2124,430,154,0,2499,315,1658,357,7537
"36081029100",1637,453,14,5,3020,1256,1305,388,8078
"36081029300",413,11,9,0,660,71,318,4,1486
"36081029400",79,53,5891,455,600,77,626,160,7941
"36081029500",1611,211,172,0,1599,270,805,70,4738
"36081029700",1034,252,71,0,543,127,275,230,2532
"36081029900",0,0,0,0,0,0,0,0,0
"36081030600",189,47,3225,336,325,11,265,63,4461
"36081030902",2527,570,41,2,3540,1641,1902,488,10711
"36081030903",1537,240,38,0,4104,494,2102,223,8738
"36081030904",1275,193,124,4,2059,231,1951,171,6008
"36081031700",4461,397,144,0,1035,228,1056,93,7414
"36081032000",26,68,3197,771,254,175,54,172,4717
"36081032700",1244,251,190,0,1712,503,2179,379,6458
"36081032800",99,2,2092,172,47,11,162,2,2587
"36081032900",1580,193,226,28,2217,523,2373,511,7651
"36081033000",106,2,4990,1049,834,59,779,61,7880
"36081033100",0,0,0,0,0,0,0,0,0
"36081033401",127,0,2783,415,419,0,417,0,4161
"36081033402",188,51,10227,1743,566,0,867,613,14255
"36081033700",686,100,41,0,2274,370,2267,342,6080
"36081033900",963,173,249,0,1885,187,1900,193,5550
"36081034700",953,119,297,6,1477,286,1798,253,5189
"36081035100",1262,327,123,7,2114,321,2171,619,6944
"36081035200",96,0,2395,154,213,5,127,5,2995
"36081035300",586,153,174,149,913,364,1349,343,4031
"36081035700",593,161,959,201,1395,421,1440,302,5472
"36081035800",2,2,4001,252,153,26,173,0,4609
"36081036100",447,225,658,164,1103,343,1394,567,4901
"36081036300",83,0,325,52,1474,279,1554,152,3919
"36081036500",712,235,533,58,2014,535,2607,742,7436
"36081036600",13,1,2364,348,197,6,130,0,3059
"36081036700",200,166,1213,104,896,58,797,166,3600
"36081036800",62,7,2180,166,53,5,171,6,2650
"36081037100",364,79,414,135,739,194,865,136,2926
"36081037300",518,105,555,37,859,379,1161,386,4000
"36081037500",1480,374,99,33,1127,475,2278,715,6581
"36081037600",0,0,5476,200,550,112,287,112,6737
"36081037700",735,393,495,99,1195,572,1963,909,6361
"36081037900",1645,645,307,140,3175,1126,4744,1813,13595
"36081038100",2098,1166,942,182,2420,629,4352,1758,13547
"36081038301",0,0,0,0,0,0,0,0,0
"36081038302",0,0,0,0,0,0,0,0,0
"36081038400",57,0,1910,169,288,0,184,0,2608
"36081039400",69,0,2515,159,130,76,130,50,3129
"36081039800",40,0,1825,78,33,0,40,0,2016
"36081039900",1494,288,97,10,1608,706,2818,572,7593
"36081040000",15,0,908,201,40,0,34,0,1198
"36081040100",2370,740,65,43,3499,967,4892,1552,14128
"36081040200",5,0,1360,98,33,28,24,6,1554
"36081040300",2409,903,193,108,2863,761,4941,1623,13801
"36081040400",24,21,3102,671,261,44,234,42,4399
"36081040500",1288,368,87,12,1279,547,2436,846,6863
"36081040700",2498,761,410,43,2889,549,5030,1230,13410
"36081040900",1192,487,73,181,2466,903,3100,1334,9736
"36081041100",1536,684,100,22,993,621,2379,1037,7372
"36081041300",1504,355,0,0,2022,863,2524,1020,8288
"36081041400",34,82,2645,494,396,222,496,553,4922
"36081041500",1820,224,99,1,941,474,2016,371,5946
"36081042400",13,0,2211,232,84,12,62,0,2614
"36081042600",29,12,9,47,0,10,0,19,126
"36081042700",2116,489,141,0,1506,866,2943,1119,9180
"36081043200",0,60,1281,30,49,5,75,60,1560
"36081043400",106,0,1266,70,366,14,155,0,1977
"36081043701",1490,216,298,103,901,288,1762,517,5575
"36081043702",2071,724,785,188,1709,325,2644,928,9374
"36081043900",1568,782,45,110,1178,759,2348,1362,8152
"36081044000",27,0,2170,649,843,131,423,10,4253
"36081044301",580,1113,256,184,1080,377,1156,1268,6014
"36081044302",1179,181,503,151,2397,362,1742,286,6801
"36081044400",143,172,577,95,1156,645,694,352,3834
"36081044601",839,103,837,145,875,421,1290,281,4791
"36081044602",185,290,973,438,1733,1195,741,716,6271
"36081044800",175,25,266,86,1609,459,546,12,3178
"36081045000",646,7,18,0,880,242,397,7,2197
"36081045200",64,7,102,57,250,76,57,0,613
"36081045400",347,32,430,35,2904,621,263,0,4632
"36081045500",2667,778,6627,1129,1604,128,2634,321,15888
"36081045600",39,0,41,69,1213,116,4,14,1496
"36081045700",542,56,18,0,2105,338,799,40,3898
"36081045800",219,26,219,5,1236,357,251,18,2331
"36081045900",1188,109,2,3,2253,617,1664,249,6085
"36081046000",318,285,781,190,2635,1755,1219,827,8010
"36081046100",669,228,0,17,1974,446,1068,233,4635
"36081046200",919,334,461,166,4532,1539,2713,301,10965
"36081046300",1395,507,29,21,1212,425,1646,593,5828
"36081046400",414,5,254,10,555,85,328,18,1669
"36081046500",2722,329,0,0,624,251,2957,514,7397
"36081046600",435,187,1010,65,1053,727,490,73,4040
"36081046700",2403,1716,128,1,2017,729,2674,1890,11558
"36081046800",462,37,498,65,1995,291,624,217,4189
"36081046900",3007,838,118,100,2997,1415,3655,1067,13197
"36081047000",234,38,330,19,2358,313,578,34,3904
"36081047100",806,35,7,0,2365,1082,728,91,5114
"36081047200",601,284,795,14,1533,120,395,26,3768
"36081047300",992,35,92,0,1836,595,710,86,4346
"36081047500",1367,184,31,0,2752,418,1035,259,6046
"36081047600",573,51,273,5,458,5,128,36,1529
"36081047800",1601,62,1015,305,2512,117,1379,56,7047
"36081047900",1480,103,60,1,3533,861,901,138,7077
"36081048000",245,90,610,45,1773,114,563,65,3505
"36081048100",1855,513,240,108,3503,447,1843,286,8795
"36081048200",119,18,331,53,940,70,434,78,2043
"36081048300",1352,143,27,0,1884,722,1358,484,5970
"36081048400",260,72,1320,180,2787,200,422,57,5298
"36081048500",928,88,86,0,3071,389,879,61,5502
"36081048900",415,31,6,0,1074,70,523,33,2152
"36081049200",690,50,2241,109,976,379,690,8,5143
"36081049301",1174,67,14,21,579,95,443,51,2444
"36081049302",1521,158,27,0,187,175,307,126,2501
"36081049500",918,100,4,0,299,8,525,18,1872
"36081049600",403,50,550,8,1838,197,499,25,3570
"36081049700",1318,87,2,4,1126,132,560,49,3278
"36081049900",1311,73,0,2,3256,599,912,59,6212
"36081050000",73,132,2508,596,589,225,380,186,4689
"36081050201",39,0,1165,116,130,0,99,0,1549
"36081050202",34,2,1215,101,157,18,57,15,1599
"36081050400",87,1,1575,213,152,1,167,0,2196
"36081050500",855,99,18,13,399,76,258,14,1732
"36081050600",13,0,1227,110,380,0,87,0,1817
"36081050700",2336,227,33,1,1084,58,756,12,4507
"36081050800",34,9,1388,155,176,51,69,0,1882
"36081051000",0,38,1298,55,390,4,86,38,1909
"36081051100",1649,105,0,0,176,33,326,76,2365
"36081051200",103,0,1950,259,646,103,256,78,3395
"36081051300",1085,80,13,0,750,28,402,11,2369
"36081051500",1862,306,59,0,198,0,284,131,2840
"36081051600",78,5,1440,141,118,0,228,5,2015
"36081051700",1177,60,0,15,316,126,425,132,2251
"36081051800",0,116,2147,48,118,2,139,116,2686
"36081052000",48,3,1539,54,77,1,79,20,1821
"36081052100",981,136,72,0,169,111,164,78,1711
"36081052200",5,1,1567,163,138,15,204,5,2098
"36081052400",8,0,1378,59,110,94,70,94,1813
"36081052500",1246,172,11,0,230,55,463,29,2206
"36081052600",43,42,1148,344,328,35,188,47,2175
"36081052800",11,0,1115,214,68,0,86,0,1494
"36081053000",0,0,1760,204,156,0,53,10,2183
"36081053100",1892,317,27,0,153,97,571,190,3247
"36081053200",58,0,1357,127,161,0,87,0,1790
"36081053401",53,0,1867,49,135,0,112,0,2216
"36081053500",645,17,0,8,354,251,732,265,2272
"36081053601",4,0,1561,171,266,14,71,10,2097
"36081053800",20,0,1388,135,161,9,66,9,1788
"36081053900",2313,607,97,2,1123,270,1659,546,6617
"36081054000",215,127,2646,603,634,145,308,225,4903
"36081054200",1026,205,1288,92,2756,467,1191,155,7180
"36081054500",2130,509,18,0,896,204,1869,429,6055
"36081054700",2584,741,167,15,911,494,2535,959,8406
"36081054800",282,0,757,43,1272,88,282,44,2768
"36081054900",2972,1006,135,159,753,384,2551,909,8869
"36081055100",3193,860,54,13,799,213,2012,588,7732
"36081055200",430,42,948,97,1312,312,526,65,3732
"36081055300",1150,305,24,17,573,299,1035,488,3891
"36081055400",482,26,475,24,1252,76,567,17,2919
"36081055500",1524,328,113,6,134,114,1276,408,3903
"36081055600",387,12,246,33,1748,126,622,7,3181
"36081055700",2324,700,63,16,496,295,1408,823,6125
"36081055800",381,11,283,0,1117,24,531,0,2347
"36081055900",726,303,30,0,334,117,930,333,2773
"36081056000",386,2,184,86,561,197,245,0,1661
"36081056100",84,0,42,0,30,0,55,0,211
"36081056200",496,22,163,0,726,258,501,270,2436
"36081056400",682,6,267,25,704,60,426,32,2202
"36081056500",873,246,0,14,148,325,844,445,2895
"36081056600",273,68,288,0,1190,64,679,62,2624
"36081056700",3162,340,117,0,369,185,2184,328,6685
"36081056800",669,77,3167,263,624,61,927,91,5879
"36081057700",2965,269,0,0,409,283,1112,331,5369
"36081057900",1036,514,5,0,103,12,318,274,2262
"36081058000",25,0,2868,312,316,0,335,48,3904
"36081058100",2279,450,55,0,39,0,884,334,4041
"36081058200",75,20,3933,586,527,178,284,178,5781
"36081058300",2148,352,205,0,530,51,1371,83,4740
"36081058500",3261,728,52,0,574,15,1620,576,6826
"36081058700",2156,463,90,0,223,117,274,215,3538
"36081058900",2715,625,19,22,477,159,1281,422,5720
"36081059000",30,0,1158,185,116,0,99,0,1588
"36081059100",3461,566,54,0,389,229,1814,397,6910
"36081059200",81,0,951,76,23,0,43,0,1174
"36081059300",2891,499,138,0,396,21,689,310,4944
"36081059400",7,0,1434,39,137,15,22,0,1654
"36081059500",2778,563,233,20,544,123,1137,393,5791
"36081059600",13,1,1448,53,5,0,6,0,1526
"36081059800",81,2,1408,153,143,1,156,2,1946
"36081059900",1194,75,5,1,79,26,288,73,1741
"36081060000",28,0,940,33,9,7,83,0,1100
"36081060100",1374,233,6,0,269,62,551,105,2600
"36081060300",1423,89,14,0,291,22,474,95,2408
"36081060600",32,0,1093,26,100,0,84,0,1335
"36081060701",10,0,0,0,0,0,10,0,20
"36081060800",0,0,1427,69,17,0,16,0,1529
"36081061000",42,0,1518,15,48,18,25,0,1666
"36081061200",52,0,1349,81,11,0,26,7,1526
"36081061301",4094,800,93,0,453,342,845,630,7257
"36081061302",11,0,3,0,0,0,0,0,14
"36081061400",76,0,1172,42,121,0,23,0,1434
"36081061601",10,5,2169,63,77,4,59,0,2387
"36081061602",39,18,1060,105,76,0,107,15,1420
"36081061800",72,8,1639,33,87,9,15,8,1871
"36081061900",2435,311,43,0,349,44,870,179,4231
"36081062000",40,0,1103,35,175,0,98,0,1451
"36081062100",1949,323,7,0,85,162,339,302,3167
"36081062200",18,0,1515,78,46,5,59,0,1721
"36081062300",1654,193,6,0,123,22,412,90,2500
"36081062400",0,0,0,0,0,0,0,0,0
"36081062500",1970,165,37,12,175,18,288,116,2781
"36081062600",123,27,2610,199,112,7,126,44,3248
"36081062700",2114,413,7,0,355,0,1008,191,4088
"36081062900",2236,361,54,2,369,26,598,91,3737
"36081063000",27,0,1607,35,73,2,129,0,1873
"36081063200",19,0,1977,93,109,30,0,30,2258
"36081063301",1168,87,0,0,80,12,326,6,1679
"36081063302",1463,40,0,0,10,0,441,5,1959
"36081063500",2504,84,22,10,23,1,831,26,3501
"36081063700",2529,33,0,13,394,48,918,61,3996
"36081063800",268,7,2872,471,309,2,233,0,4162
"36081063900",1568,184,47,0,715,21,488,41,3064
"36081064101",1551,188,6,5,270,0,396,105,2521
"36081064102",134,0,0,0,0,0,0,0,134
"36081064500",981,178,15,4,798,79,303,25,2383
"36081064600",22,0,2635,184,139,0,103,19,3102
"36081065000",35,0,2659,170,176,0,122,0,3162
"36081065400",373,24,2255,119,200,23,341,31,3366
"36081065501",0,0,0,0,0,0,0,0,0
"36081065600",322,87,3921,408,243,22,241,42,5286
"36081065702",1378,74,71,10,141,0,190,0,1864
"36081065703",2612,160,0,1,53,30,424,41,3321
"36081065900",1669,101,0,0,28,11,193,0,2002
"36081066000",399,141,3017,93,130,0,270,107,4157
"36081066100",1296,48,0,0,147,0,154,0,1645
"36081066300",1911,315,0,0,305,0,129,11,2671
"36081066400",571,66,7675,693,889,67,493,1,10455
"36081066501",2981,255,0,1,46,12,153,1,3449
"36081066701",2177,96,48,0,156,37,384,37,2935
"36081066900",1503,61,0,0,47,0,46,0,1657
"36081067100",1538,120,5,23,370,18,154,0,2228
"36081067700",1537,59,18,0,216,0,71,19,1920
"36081067900",2290,491,93,4,354,39,1043,100,4414
"36081068000",236,2,4317,158,405,42,282,2,5444
"36081068200",0,0,1111,92,56,0,45,0,1304
"36081068300",1767,447,189,0,1802,363,1656,499,6723
"36081068700",1997,165,42,0,2075,313,738,117,5447
"36081069000",0,3,3224,407,74,2,9,22,3741
"36081069300",1385,86,103,0,786,205,704,69,3338
"36081069400",329,0,2307,470,155,0,381,16,3658
"36081069500",934,103,4,0,700,87,376,78,2282
"36081069701",1845,200,246,54,1173,205,730,126,4579
"36081069702",2000,61,32,1,1151,254,176,17,3692
"36081070300",1109,52,44,0,451,18,359,38,2071
"36081070700",1264,104,0,0,816,52,377,38,2651
"36081070900",1337,53,25,0,1121,40,222,0,2798
"36081071100",2946,643,32,0,1578,317,521,105,6142
"36081071303",3991,119,52,0,942,137,1016,0,6257
"36081071304",3509,892,329,0,1134,289,581,73,6807
"36081071305",2442,261,69,0,1826,428,727,241,5994
"36081071306",3117,653,275,0,1963,247,1163,149,7567
"36081071600",0,0,0,0,0,0,0,0,0
"36081071701",3388,413,72,42,1214,107,500,75,5811
"36081071702",1768,193,62,0,1185,122,631,20,3981
"36081071900",1322,321,81,20,575,83,283,97,2782
"36081072100",2707,298,29,0,1419,90,700,172,5415
"36081072300",1145,48,81,0,557,0,144,0,1975
"36081072900",629,49,34,0,357,86,86,6,1247
"36081073100",1022,96,22,0,405,20,133,0,1698
"36081073700",1278,58,0,0,386,30,161,1,1914
"36081073900",3473,263,185,0,1298,33,654,58,5964
"36081074100",2029,127,10,0,812,30,312,12,3332
"36081074300",2743,396,15,0,1505,94,793,20,5566
"36081074500",1888,479,230,66,1083,131,465,120,4462
"36081074700",1124,127,286,42,1510,104,330,23,3546
"36081074900",1200,16,0,0,405,7,97,0,1725
"36081075701",3328,65,0,31,1566,112,586,31,5719
"36081075702",2406,97,213,56,1154,274,422,29,4651
"36081076901",2653,46,117,0,792,274,402,24,4308
"36081076902",872,16,26,0,499,93,146,0,1652
"36081077300",1060,164,205,0,631,44,227,25,2356
"36081077500",1627,71,28,0,223,36,236,62,2283
"36081077902",4256,303,189,11,392,51,169,57,5428
"36081077903",1548,77,130,3,1000,199,471,21,3449
"36081077904",3284,760,214,0,1682,300,755,0,6995
"36081077905",1068,187,90,41,1032,1,249,11,2679
"36081077906",1602,175,144,21,921,260,427,73,3623
"36081077907",1791,520,173,0,470,38,456,0,3448
"36081077908",1119,95,798,18,1137,724,424,194,4509
"36081078800",123,8,1005,134,311,36,74,14,1705
"36081079000",31,32,1108,312,705,171,140,100,2599
"36081079200",93,0,1471,420,294,82,247,7,2614
"36081079300",0,0,0,0,0,0,0,0,0
"36081079701",491,75,230,32,4773,1048,579,70,7298
"36081079702",207,40,8,1,3561,787,513,0,5117
"36081079900",711,96,56,0,2093,641,551,144,4292
"36081080301",856,149,30,0,2948,535,1105,102,5725
"36081080302",1208,16,197,0,1976,123,717,20,4257
"36081080900",4087,368,327,130,2205,100,939,14,8170
"36081081400",377,239,1995,226,899,121,421,239,4517
"36081081800",507,2,1428,216,1618,694,888,153,5506
"36081083700",673,45,88,0,3897,910,368,61,6042
"36081083800",1427,56,660,33,3563,466,1584,81,7870
"36081084000",960,72,824,112,3894,346,1136,72,7416
"36081084500",347,87,482,56,2785,1002,229,132,5120
"36081084601",1086,35,148,5,1323,120,565,66,3348
"36081084602",119,103,30,98,753,36,297,121,1557
"36081084900",371,168,131,69,5128,1883,981,100,8831
"36081085300",278,46,128,2,2917,1234,341,40,4986
"36081085500",1076,164,142,96,4093,954,1086,158,7769
"36081085700",889,174,135,57,2655,1554,992,170,6626
"36081085900",992,93,49,3,2920,1392,543,99,6091
"36081086100",299,38,31,36,1808,278,321,47,2858
"36081086300",637,85,124,28,4336,1692,996,311,8209
"36081086400",864,89,241,32,1295,152,845,96,3614
"36081086500",713,160,3,42,2335,1057,431,32,4773
"36081086900",121,29,14,7,1435,466,213,18,2303
"36081087100",99,114,427,244,927,474,284,290,2859
"36081088400",6537,339,30,52,359,164,797,147,8425
"36081088901",2679,304,138,94,5827,1490,1180,912,12624
"36081089200",7684,305,0,0,266,0,465,0,8720
"36081090700",588,95,0,0,463,81,131,108,1466
"36081091601",3910,121,1,2,43,0,51,1,4129
"36081091602",0,0,0,0,0,0,0,0,0
"36081091800",6,0,0,0,0,0,0,0,6
"36081091900",1554,168,39,0,3326,717,1778,243,7825
"36081092200",2051,50,0,0,0,0,56,0,2157
"36081092500",1164,270,46,62,1759,436,1350,435,5522
"36081092800",3439,40,7,0,11,0,48,0,3545
"36081092900",1888,14,98,2,3688,484,2381,175,8730
"36081093401",3039,224,28,6,195,6,373,6,3877
"36081093402",3216,251,178,42,314,56,485,0,4542
"36081093800",3658,447,462,19,356,116,613,146,5817
"36081093900",1877,249,132,0,2459,257,1261,195,6430
"36081094201",1708,116,1087,357,444,42,1139,45,4938
"36081094202",1188,454,1272,856,752,142,585,612,5861
"36081094203",3023,219,1403,1,715,33,792,33,6219
"36081094500",2268,290,42,1,997,341,993,149,5081
"36081094700",939,129,17,11,1242,164,1008,10,3520
"36081095400",1153,258,2154,602,523,128,790,104,5712
"36081096400",397,159,1854,516,794,76,749,156,4701
"36081097202",560,344,844,572,30,54,405,350,3159
"36081097203",582,888,2593,1689,638,620,1224,1367,9601
"36081097204",299,32,1732,411,395,45,551,15,3480
"36081097300",1929,20,0,1,189,10,297,0,2446
"36081098100",1268,110,4,0,811,103,235,80,2611
"36081098700",2085,36,46,0,383,0,316,0,2866
"36081099100",5071,227,0,0,1049,28,897,55,7327
"36081099200",591,382,1783,536,508,56,858,288,5002
"36081099701",1826,150,13,0,441,91,91,18,2630
"36081099703",2751,35,29,0,1277,79,430,0,4601
"36081099704",4333,507,120,17,1699,260,675,0,7611
"36081099705",1674,43,0,0,873,23,163,0,2776
"36081099801",1363,60,4012,734,590,109,1403,87,8358
"36081099802",1443,571,2510,414,168,113,954,162,6335
"36081099900",0,0,0,0,0,0,0,0,0
"36081100801",943,310,781,116,135,22,351,29,2687
"36081100802",1927,816,3579,522,1084,664,1310,1100,11002
"36081101001",2616,1368,1796,1159,1525,388,2192,1376,12420
"36081101002",2969,772,289,255,135,27,322,148,4917
"36081101700",4399,155,0,1,1046,217,501,2,6321
"36081102900",2365,241,0,2,896,10,721,38,4273
"36081103201",350,884,3553,1015,898,483,1115,1309,9607
"36081103202",3291,399,1843,290,857,186,2022,299,9187
"36081103300",2732,208,8,0,950,150,323,0,4371
"36081103900",4761,201,0,0,1789,114,929,109,7903
"36081104700",3915,35,45,2,2434,309,941,0,7681
"36081105900",2412,44,0,0,1174,81,339,1,4051
"36081107201",1825,218,1,2,5,7,47,57,2162
"36081107202",0,0,0,0,0,0,0,0,0
"36081108500",1220,126,39,3,1208,168,304,10,3078
"36081109300",1954,10,47,0,1261,30,667,0,3969
"36081109700",1142,27,29,1,438,29,227,29,1922
"36081109900",2229,72,128,1,1329,234,1026,13,5032
"36081111300",1190,39,0,5,1291,86,293,8,2912
"36081112300",940,38,25,1,1016,293,373,143,2829
"36081112900",1337,53,113,0,583,69,55,0,2210
"36081113300",1149,47,15,0,439,21,153,33,1857
"36081113900",1773,328,37,1,1288,153,438,69,4087
"36081114100",1411,13,25,3,718,4,158,2,2334
"36081114700",954,145,50,0,679,139,208,6,2181
"36081115100",642,12,22,0,452,22,29,0,1179
"36081115500",686,5,65,0,1562,291,618,19,3246
"36081115700",805,51,28,1,2234,343,51,0,3513
"36081115900",527,187,179,0,2812,673,479,105,4962
"36081116100",736,31,134,0,2360,789,851,44,4945
"36081116300",754,130,306,29,5151,1995,1033,85,9483
"36081116700",296,63,9,1,1134,398,371,214,2486
"36081117100",806,124,34,11,1248,673,427,327,3650
"36081117500",1622,13,59,2,2882,390,276,181,5425
"36081118100",718,119,59,0,792,73,118,0,1879
"36081118500",540,34,34,0,1274,240,314,97,2533
"36081118700",440,106,41,2,1396,340,419,175,2919
"36081118900",409,40,0,0,1845,417,229,31,2971
"36081119100",754,119,13,0,2176,292,784,107,4245
"36081119300",696,121,77,0,1095,188,197,57,2431
"36081119500",528,12,95,0,716,26,348,0,1725
"36081119900",406,8,62,7,815,235,202,1,1736
"36081120100",281,9,2,2,1228,172,133,0,1827
"36081120300",414,78,3,0,991,190,107,28,1811
"36081120500",275,55,17,0,1643,693,182,2,2867
"36081120700",1294,38,5,7,1248,199,518,11,3320
"36081121100",0,0,0,0,0,0,0,0,0
"36081121500",876,8,57,0,2735,758,727,88,5249
"36081122300",1626,45,21,0,1692,400,451,11,4246
"36081122701",3783,344,457,308,5211,912,3311,0,14326
"36081122702",1608,697,843,1164,923,1151,1080,910,8376
"36081124100",1422,77,259,11,1061,566,160,7,3563
"36081124700",2182,179,36,21,729,178,175,4,3504
"36081125700",442,235,368,22,1458,451,143,107,3226
"36081126500",690,55,98,50,590,89,332,34,1938
"36081126700",635,71,100,44,1379,162,539,14,2944
"36081127700",2371,57,203,9,571,170,129,11,3521
"36081128300",54,0,0,0,5,0,0,0,59
"36081129102",2125,110,2,4,1025,101,209,1,3577
"36081129103",2167,272,44,61,1035,67,206,0,3852
"36081129104",2013,95,204,57,1469,177,207,31,4253
"36081130100",1504,139,562,0,1335,309,624,50,4523
"36081133300",2190,89,38,8,1228,114,416,20,4103
"36081133900",589,144,2,0,629,37,87,11,1499
"36081134100",995,3,32,0,2176,237,223,22,3688
"36081134700",2503,256,582,61,4685,1367,1533,77,11064
"36081136700",2066,226,284,3,3351,241,728,58,6957
"36081137700",1917,320,59,14,3687,376,159,120,6652
"36081138501",1445,70,0,0,2584,416,403,0,4918
"36081138502",9,15,0,0,0,0,9,0,33
"36081139900",756,47,0,0,934,35,83,8,1863
"36081140300",871,45,14,0,1493,92,491,0,3006
"36081140901",347,51,9,0,514,24,52,26,1023
"36081140902",921,132,120,8,1850,18,134,109,3292
"36081141700",1584,112,73,0,2824,34,522,13,5162
"36081142900",1756,154,0,0,1409,248,305,0,3872
"36081143500",898,45,0,0,1159,102,258,0,2462
"36081144100",1242,27,0,0,1678,256,331,31,3565
"36081144700",579,158,462,4,1851,284,477,120,3935
"36081145101",1038,21,0,0,434,151,111,1,1756
"36081145102",808,36,47,0,1757,92,439,17,3196
"36081145900",1572,43,12,0,1056,85,416,34,3218
"36081146300",1408,99,9,3,932,161,128,107,2847
"36081146700",2148,190,28,1,796,176,419,68,3826
"36081147100",1489,21,24,0,1428,72,531,15,3580
"36081147900",2609,17,29,0,1926,320,1018,207,6126
"36081148300",1633,61,26,10,1029,45,155,0,2959
"36081150701",2137,54,1,0,699,135,218,0,3244
"36081150702",1683,83,10,0,994,188,281,155,3394
"36081152901",2755,149,0,3,3140,587,668,74,7376
"36081152902",2240,118,366,7,2187,111,77,2,5108
"36081155101",2061,27,18,0,17,0,38,0,2161
"36081155102",3746,280,570,36,2144,183,601,50,7610
"36081156700",99,95,46,112,498,82,13,73,1018
"36081157101",2722,319,370,15,3719,475,1028,14,8662
"36081157102",547,43,36,0,1223,147,333,14,2343
"36081157901",1659,371,75,9,2671,193,125,248,5351
"36081157902",1534,93,137,0,1798,277,395,53,4287
"36081157903",1677,98,0,0,1865,55,195,0,3890
"36081161700",3073,73,7,3,1418,47,1059,27,5707
"36081162100",1902,473,314,1,4047,427,1576,330,9070
"36081990100",0,0,0,0,0,0,0,0,0
"36083040100",2588,574,215,417,436,181,293,317,5021
"36083040200",3208,936,341,272,228,26,276,11,5298
"36083040300",1389,644,271,57,362,93,85,72,2973
"36083040400",597,421,350,405,125,146,221,260,2525
"36083040500",640,720,224,430,136,17,127,95,2389
"36083040600",691,398,207,133,71,60,1,51,1612
"36083040700",1653,901,444,306,429,204,72,122,4131
"36083040800",996,258,290,36,56,94,13,69,1812
"36083040900",1430,482,200,341,140,124,188,225,3130
"36083041000",1721,811,352,332,301,251,220,236,4224
"36083041100",3848,337,350,192,368,277,291,257,5920
"36083041200",2365,212,17,39,179,0,140,9,2961
"36083041300",2147,546,172,80,108,65,13,44,3175
"36083041400",2847,454,97,59,356,233,140,107,4293
"36083051500",1493,582,44,89,282,74,79,13,2656
"36083051600",4980,714,144,42,614,393,334,28,7249
"36083051701",2995,281,0,0,130,0,57,0,3463
"36083051702",2934,342,26,0,68,8,25,0,3403
"36083051800",5118,544,59,0,10,0,22,0,5753
"36083051901",3412,334,55,125,157,0,101,0,4184
"36083051902",3126,178,7,16,85,23,59,0,3494
"36083052002",1502,86,6,0,72,0,26,0,1692
"36083052003",4004,147,73,2,206,24,7,0,4463
"36083052004",5383,56,29,17,479,0,111,4,6079
"36083052101",1842,37,30,0,49,0,2,0,1960
"36083052102",1553,128,0,0,23,0,7,0,1711
"36083052103",1703,123,0,0,19,0,6,0,1851
"36083052201",4256,102,2,1,132,0,45,0,4538
"36083052203",5203,111,110,0,225,0,81,0,5730
"36083052204",2777,101,0,0,3,0,23,21,2925
"36083052301",3474,196,108,1,94,20,169,0,4062
"36083052303",1129,186,3,0,13,0,3,0,1334
"36083052304",5775,222,128,0,217,7,71,0,6420
"36083052402",1735,42,35,1,89,0,38,0,1940
"36083052403",5442,511,76,1,549,0,209,29,6817
"36083052404",6605,284,54,3,605,0,437,0,7988
"36083052501",5863,160,96,18,213,9,43,0,6402
"36083052502",4764,404,0,0,51,0,60,25,5304
"36083052503",1163,37,9,5,29,2,25,2,1272
"36083052601",3101,233,149,4,219,40,117,0,3863
"36083052602",942,46,18,0,91,6,44,0,1147
"36083052603",2557,297,0,0,35,0,42,10,2941
"36085000300",668,157,240,138,426,1,175,128,1933
"36085000600",1537,180,96,14,242,63,275,22,2429
"36085000700",1593,325,1556,975,705,901,1620,671,8346
"36085000800",3997,233,207,0,845,457,1122,335,7196
"36085000900",617,51,772,174,319,29,671,22,2655
"36085001100",785,343,1189,313,129,125,391,366,3641
"36085001700",522,111,213,91,392,144,261,169,1903
"36085001800",538,0,25,0,78,0,157,0,798
"36085002001",1957,92,103,2,336,14,356,15,2875
"36085002002",2342,225,0,2,530,75,145,18,3337
"36085002100",1331,517,748,346,709,256,1021,649,5577
"36085002700",189,284,365,112,567,290,444,453,2704
"36085002900",956,325,1969,1061,1238,280,1512,612,7953
"36085003300",1848,200,705,48,756,63,653,145,4418
"36085003600",1397,193,79,0,842,91,571,190,3363
"36085003900",1385,149,309,27,167,6,677,1,2721
"36085004000",2729,1276,3621,1736,2597,773,2818,1639,17189
"36085004700",1788,34,391,2,181,33,423,0,2852
"36085005000",2541,262,314,0,443,40,376,89,4065
"36085005900",2236,181,121,13,211,0,205,21,2988
"36085006400",1831,230,400,306,327,18,377,163,3652
"36085006700",1918,183,161,11,220,81,129,37,2740
"36085007000",6305,825,365,80,1044,307,663,292,9881
"36085007400",3091,578,23,4,911,118,686,121,5532
"36085007500",2237,197,522,531,501,244,1595,417,6244
"36085007700",338,145,385,152,219,9,397,81,1726
"36085008100",1175,390,902,557,544,159,386,485,4598
"36085009601",2248,553,54,34,474,182,530,138,4213
"36085009602",2798,79,11,0,411,2,372,0,3673
"36085009700",1524,400,1379,351,264,137,540,590,5185
"36085010500",2507,603,730,150,815,165,1325,292,6587
"36085011201",4847,99,0,0,864,0,655,0,6465
"36085011202",4770,344,48,4,599,159,595,39,6558
"36085011401",1548,279,320,271,421,165,323,314,3641
"36085011402",2652,99,135,0,390,71,258,81,3686
"36085012100",2643,293,0,0,237,97,333,142,3745
"36085012200",3289,102,42,0,158,0,237,7,3835
"36085012500",1482,218,533,322,205,58,616,188,3622
"36085012804",3137,247,55,0,394,40,552,57,4482
"36085012805",2412,166,0,0,130,11,220,0,2939
"36085012806",4819,284,577,57,472,84,1478,55,7826
"36085013201",1354,87,0,0,69,0,105,0,1615
"36085013203",4755,297,21,0,402,81,552,1,6109
"36085013204",4094,348,12,9,349,2,304,11,5129
"36085013301",129,255,448,500,142,272,169,382,2297
"36085013302",791,266,1425,304,644,242,741,467,4880
"36085013400",3238,220,0,0,239,29,495,95,4316
"36085013800",6042,134,61,0,2,0,544,0,6783
"36085014100",1215,638,347,46,430,47,982,265,3970
"36085014604",6662,565,0,0,290,149,597,178,8441
"36085014605",3148,111,0,4,188,45,335,19,3850
"36085014606",6514,466,84,0,396,85,594,0,8139
"36085014607",4229,438,0,2,325,13,286,18,5311
"36085014608",3514,93,0,0,147,131,602,0,4487
"36085014700",3117,178,10,0,185,0,302,11,3803
"36085015100",3956,396,57,1,614,63,609,70,5766
"36085015400",0,0,0,0,0,0,0,0,0
"36085015601",5302,323,0,4,472,134,660,142,7037
"36085015602",3222,125,0,0,102,0,140,0,3589
"36085015603",3905,562,13,0,171,20,158,177,5006
"36085016901",2462,127,159,0,293,104,605,97,3847
"36085017005",4236,251,0,3,252,2,255,10,5009
"36085017007",3673,238,297,10,850,171,851,62,6152
"36085017008",6447,280,50,21,358,76,829,15,8076
"36085017009",3874,207,19,0,31,34,320,34,4519
"36085017010",8109,248,13,0,487,66,899,30,9852
"36085017011",3917,547,19,5,166,0,427,26,5107
"36085017012",4021,344,0,30,120,0,350,0,4865
"36085017300",1096,213,349,153,585,52,494,150,3092
"36085017600",4380,309,1,0,196,6,170,0,5062
"36085017700",5438,282,49,2,1026,30,561,29,7417
"36085018100",2398,295,6,14,196,6,324,62,3301
"36085018701",1344,55,65,0,230,3,116,6,1819
"36085018702",3332,341,175,214,2288,117,847,318,7632
"36085018901",3964,361,215,4,854,44,589,95,6126
"36085018902",2926,281,135,30,1554,33,429,39,5427
"36085019700",1533,61,8,0,132,16,34,47,1831
"36085019800",5703,360,30,0,376,40,388,54,6951
"36085020100",2518,191,112,58,612,190,1141,72,4894
"36085020700",1530,1309,1533,99,557,446,1582,1562,8618
"36085020801",6884,1704,155,2,338,67,474,413,10037
"36085020803",5574,464,38,0,235,0,473,108,6892
"36085020804",4603,373,8,2,526,48,172,0,5732
"36085021300",1913,806,683,303,1006,407,1008,707,6833
"36085022300",1019,138,833,17,395,248,908,270,3828
"36085022600",7169,307,314,2,687,81,1526,46,10132
"36085022800",231,0,0,0,0,0,150,0,381
"36085023100",1344,554,1023,115,878,222,1171,394,5701
"36085023900",1320,274,245,30,1043,460,1653,689,5714
"36085024401",5648,305,0,0,221,25,287,61,6547
"36085024402",3701,251,0,0,446,0,445,2,4845
"36085024700",999,353,740,214,430,26,624,212,3598
"36085024800",4270,328,0,12,165,17,453,18,5263
"36085025100",4975,485,0,0,336,0,290,0,6086
"36085027301",2840,234,234,78,415,137,455,0,4393
"36085027302",2426,209,157,1,633,147,253,1,3827
"36085027702",4506,411,172,23,823,162,812,248,7157
"36085027704",3342,238,0,0,625,22,278,0,4505
"36085027705",3961,223,107,0,1392,90,431,58,6262
"36085027706",2147,142,258,0,662,101,428,29,3767
"36085027900",1554,135,1,1,82,13,113,16,1915
"36085029102",2081,92,136,1,362,40,439,28,3179
"36085029103",6246,359,57,50,643,50,631,16,8052
"36085029104",5406,281,481,24,726,81,658,71,7728
"36085030301",3009,308,535,25,1151,28,1255,136,6447
"36085030302",2402,451,1461,113,1134,644,1906,387,8498
"36085031901",259,438,1267,563,303,86,356,532,3804
"36085031902",906,238,1950,1087,229,125,625,295,5455
"36085032300",521,137,237,29,182,0,396,112,1614
"36085990100",0,0,0,0,0,0,0,0,0
"36087010101",4503,282,305,0,309,0,430,8,5837
"36087010102",4212,12,355,17,709,151,1095,151,6702
"36087010200",3490,210,263,0,265,163,637,214,5242
"36087010501",4116,247,573,3,392,0,1002,151,6484
"36087010502",4186,264,950,17,1049,436,1566,497,8965
"36087010503",1395,34,588,0,307,17,167,13,2521
"36087010601",2963,232,271,106,383,83,1593,252,5883
"36087010602",2928,533,1105,0,1708,77,2831,359,9541
"36087010701",2046,116,692,88,1055,59,1922,134,6112
"36087010702",1397,336,640,93,982,620,2241,981,7290
"36087010703",1555,322,560,64,1047,149,1911,420,6028
"36087010801",3613,110,276,2,491,0,252,0,4744
"36087010802",4290,229,123,7,648,34,343,0,5674
"36087010803",3942,198,180,205,869,92,332,15,5833
"36087010804",3102,270,149,0,645,0,523,194,4883
"36087010901",4095,119,100,0,593,0,573,12,5492
"36087010902",2787,156,176,0,829,103,560,103,4714
"36087011000",1686,55,71,11,99,0,98,9,2029
"36087011101",4490,485,209,103,1009,41,874,246,7457
"36087011102",3264,347,1148,2,1477,74,973,215,7500
"36087011200",4867,163,126,13,789,53,481,11,6503
"36087011301",1583,82,2768,424,1839,652,1864,672,9884
"36087011302",3616,193,275,10,1429,77,1021,72,6693
"36087011303",4701,118,121,0,627,20,553,28,6168
"36087011401",3334,105,8,1,711,29,317,18,4523
"36087011403",4501,105,305,21,559,32,457,2,5982
"36087011404",2551,140,463,0,696,34,369,11,4264
"36087011405",1932,66,907,28,843,0,240,4,4020
"36087011501",6760,356,190,3,434,0,347,21,8111
"36087011502",4406,284,1038,50,1793,90,1634,125,9420
"36087011504",1249,104,4307,69,1404,16,1071,26,8246
"36087011505",1304,1714,0,3,89,28,14,40,3192
"36087011506",1183,3177,20,3,49,37,5,25,4499
"36087011601",2626,44,342,2,256,29,117,6,3422
"36087011602",4601,444,199,39,600,0,429,19,6331
"36087011603",4508,154,124,49,394,45,619,45,5938
"36087011700",2574,109,99,38,232,0,334,4,3390
"36087011800",322,75,261,11,203,6,156,8,1042
"36087011901",2738,116,115,0,468,144,666,166,4413
"36087011902",2195,157,329,4,663,130,820,142,4440
"36087012000",2885,81,136,4,400,136,116,144,3902
"36087012101",3393,2788,0,0,12,0,23,0,6216
"36087012102",2898,5064,207,0,0,200,44,172,8585
"36087012103",2975,2549,0,0,0,110,3,82,5719
"36087012105",2546,2099,106,26,210,137,169,71,5364
"36087012106",1322,1457,506,5,463,31,719,30,4533
"36087012202",426,122,3176,620,1072,542,709,433,7100
"36087012203",2270,644,243,0,8,20,37,7,3229
"36087012204",1899,1251,241,0,125,17,122,9,3664
"36087012300",372,510,1421,693,2269,1182,2289,1187,9923
"36087012401",1133,218,2360,266,668,353,523,84,5605
"36087012402",446,72,2113,226,1577,981,1538,951,7904
"36087012501",4048,543,323,6,498,48,324,43,5833
"36087012502",3020,224,954,33,703,176,487,130,5727
"36087012600",5105,458,98,0,680,0,203,0,6544
"36087012700",3509,242,39,23,395,38,270,146,4662
"36087012800",5774,216,100,0,487,2,161,0,6740
"36087013001",1891,103,73,40,313,57,186,50,2713
"36087013002",4072,181,4,5,931,109,410,141,5853
"36087013003",1928,381,244,10,247,11,198,20,3039
"36087013100",4083,585,775,268,368,54,1031,111,7275
"36087013200",1964,144,426,2,272,25,130,0,2963
"36087013300",1911,103,93,0,408,26,133,31,2705
"36087013401",3419,58,268,0,711,1,500,11,4968
"36087013402",2976,321,179,23,629,0,248,118,4494
"36089490100",2410,874,17,9,53,0,0,27,3390
"36089490200",3183,422,15,0,129,0,10,23,3782
"36089490300",3866,1129,4,0,244,114,25,0,5382
"36089490400",2584,254,0,0,155,148,113,0,3254
"36089490500",3007,692,1,32,200,25,27,16,4000
"36089490600",3409,1086,10,3,72,32,26,0,4638
"36089490700",4549,917,39,2,148,53,60,2,5770
"36089490800",2085,606,5,17,179,12,82,12,2998
"36089490900",2516,923,90,6,79,128,23,21,3786
"36089491000",3522,530,0,5,289,80,54,4,4484
"36089491100",18,5,4,0,3,0,0,0,30
"36089491200",34,0,0,0,31,0,29,0,94
"36089491300",3292,667,0,0,109,0,0,1,4069
"36089491400",2576,594,0,35,152,23,44,0,3424
"36089491500",2990,708,0,7,29,54,31,9,3828
"36089491600",1664,459,0,0,56,18,48,0,2245
"36089491700",2920,1131,19,24,69,27,16,3,4209
"36089491800",3242,1057,12,8,53,18,55,8,4453
"36089491900",0,0,0,0,0,0,0,0,0
"36089492000",3600,658,0,0,234,15,97,0,4604
"36089492100",2455,699,22,0,124,65,83,61,3509
"36089492300",5295,755,15,10,102,43,27,37,6284
"36089492400",2365,521,23,2,64,42,0,6,3023
"36089492500",2083,458,2,12,55,32,36,13,2691
"36089492600",4591,796,23,1,104,32,51,1,5599
"36089492700",4409,1553,49,9,64,48,48,0,6180
"36089492800",2471,526,5,5,57,15,2,0,3081
"36089492900",1811,471,11,0,33,8,14,15,2363
"36091060101",4857,452,95,29,86,0,60,0,5579
"36091060102",4879,350,61,0,72,0,88,26,5476
"36091060200",3179,270,78,8,10,30,133,8,3716
"36091060300",3298,434,0,108,49,0,136,0,4025
"36091060400",2050,369,10,0,80,31,45,0,2585
"36091060501",1453,218,0,0,24,7,8,0,1710
"36091060502",2045,249,10,0,10,0,14,0,2328
"36091060503",1943,99,0,5,56,13,53,1,2170
"36091060601",2573,250,70,4,149,0,0,0,3046
"36091060602",4122,528,0,3,81,0,1,0,4735
"36091060701",6367,477,62,1,184,0,163,0,7254
"36091060702",8451,261,194,103,282,59,159,87,9596
"36091060800",4659,324,0,25,82,34,71,0,5195
"36091060901",3402,167,112,9,72,0,300,0,4062
"36091060902",1583,168,91,7,20,23,4,1,1897
"36091061000",2927,653,36,7,337,8,215,13,4196
"36091061100",4868,354,210,82,261,0,166,24,5965
"36091061200",3908,520,29,0,103,11,116,45,4732
"36091061301",3142,43,32,0,166,0,29,0,3412
"36091061302",6426,125,44,21,218,38,261,38,7171
"36091061303",0,0,0,0,0,0,0,0,0
"36091061401",4470,427,0,0,36,10,41,16,5000
"36091061403",5687,222,1,0,38,0,46,0,5994
"36091061404",2691,142,33,1,61,0,47,0,2975
"36091061500",3349,152,0,0,0,46,7,0,3554
"36091061600",3854,109,12,2,153,10,10,0,4150
"36091061701",3948,499,45,5,101,10,89,1,4698
"36091061702",4173,105,24,0,108,0,50,0,4460
"36091061800",4437,529,25,68,296,23,149,19,5546
"36091061901",8089,248,68,2,264,14,116,0,8801
"36091061903",5641,196,42,2,130,22,261,9,6303
"36091062000",5926,279,69,0,6,1,247,1,6529
"36091062100",1531,282,17,0,34,14,43,29,1950
"36091062200",2435,518,10,0,94,23,62,26,3168
"36091062300",1591,417,29,7,48,17,36,0,2145
"36091062403",5618,444,29,30,323,1,120,77,6642
"36091062404",1683,24,19,0,32,0,56,10,1824
"36091062405",4961,645,81,0,965,98,243,283,7276
"36091062406",3103,231,20,0,241,104,96,23,3818
"36091062501",4779,53,85,0,152,40,95,0,5204
"36091062503",5490,28,71,0,405,0,405,0,6399
"36091062505",3103,146,123,0,320,0,56,0,3748
"36091062506",5068,47,158,13,331,0,39,0,5656
"36091062507",2997,226,19,31,201,22,84,18,3598
"36091062508",3644,164,192,8,230,0,134,0,4372
"36091062509",3074,54,70,8,25,0,3,0,3234
"36091062601",2137,70,36,1,207,23,64,0,2538
"36091062602",6001,34,62,1,481,17,173,0,6769
"36091062700",5057,609,73,0,313,22,21,0,6095
"36091062800",1881,165,53,9,153,73,84,14,2432
"36093020101",1863,90,310,12,330,20,9,5,2639
"36093020102",1271,535,514,259,280,42,62,297,3260
"36093020200",1310,503,275,317,326,105,172,198,3206
"36093020300",505,90,66,16,72,11,42,14,816
"36093020500",3367,414,516,75,312,111,278,20,5093
"36093020600",1946,83,232,84,256,78,137,49,2865
"36093020700",1905,399,1125,506,925,627,451,267,6205
"36093020800",1186,525,632,609,595,110,254,177,4088
"36093020900",510,290,536,825,379,448,155,166,3309
"36093021001",122,124,109,96,47,58,0,25,581
"36093021002",522,687,682,492,197,46,172,682,3480
"36093021200",2190,305,104,39,67,53,73,130,2961
"36093021400",886,585,756,502,353,74,193,147,3496
"36093021500",952,554,726,141,709,361,232,555,4230
"36093021600",1847,355,261,200,782,322,375,156,4298
"36093021700",1183,442,1025,323,414,504,366,288,4545
"36093021800",5687,374,661,35,832,0,364,0,7953
"36093031900",6334,270,216,14,683,83,158,5,7763
"36093032000",5226,239,163,4,752,2,40,68,6494
"36093032101",4547,264,1,7,707,1,135,125,5787
"36093032102",1618,33,23,0,146,3,69,1,1893
"36093032200",4266,202,162,3,233,0,248,0,5114
"36093032300",2405,276,91,0,94,0,40,1,2907
"36093032402",2901,73,20,0,172,5,101,0,3272
"36093032403",1918,68,45,13,68,0,37,0,2149
"36093032404",6059,174,21,0,85,36,69,0,6444
"36093032502",2955,212,11,13,195,12,104,12,3514
"36093032503",3630,254,68,0,116,0,33,47,4148
"36093032504",2023,75,6,0,132,0,107,0,2343
"36093032601",1780,104,8,0,26,6,59,0,1983
"36093032602",3724,131,27,0,117,0,81,0,4080
"36093032700",3369,397,205,0,167,0,152,7,4297
"36093032901",3745,105,99,2,157,17,37,0,4162
"36093032902",3655,110,214,1,208,38,130,0,4356
"36093033002",2124,58,10,0,47,0,0,5,2244
"36093033003",3077,96,5,0,191,0,79,0,3448
"36093033004",2161,431,0,0,128,0,67,0,2787
"36093033101",1999,118,0,7,0,0,17,0,2141
"36093033102",5612,297,17,0,291,0,85,0,6302
"36093033200",2134,360,287,143,480,41,125,90,3660
"36093033300",2080,77,14,2,88,13,81,12,2367
"36093033400",1104,155,96,57,104,49,223,24,1812
"36093033500",1380,256,96,44,96,54,104,20,2050
"36095740100",4511,461,30,0,46,1,47,14,5110
"36095740200",4311,733,59,29,101,25,54,26,5338
"36095740300",0,0,0,0,0,0,0,0,0
"36095740400",4294,654,62,3,142,11,84,14,5264
"36095740500",3102,458,32,0,78,14,146,21,3851
"36095740600",2605,363,19,0,58,22,44,2,3113
"36095740700",4551,783,14,8,56,19,167,10,5608
"36095740800",2584,355,11,4,53,7,70,2,3086
"36097950100",4584,242,0,0,108,32,85,1,5052
"36097950200",1450,61,15,4,42,6,55,0,1633
"36097950300",2538,586,0,0,55,21,0,3,3203
"36097950400",3009,567,25,0,26,31,34,19,3711
"36097950500",3580,810,7,7,36,21,11,31,4503
"36099950100",1897,407,0,0,0,20,60,0,2384
"36099950200",1995,332,3,0,90,81,4,4,2509
"36099950300",2911,341,9,0,42,31,110,36,3480
"36099950400",2336,445,82,0,27,85,10,35,3020
"36099950500",3071,461,39,3,22,16,11,0,3623
"36099950600",3012,388,91,32,10,15,44,44,3636
"36099950700",3410,373,0,13,84,37,10,0,3927
"36099950800",3325,332,116,0,102,4,54,31,3964
"36099950900",3049,505,105,8,96,28,32,0,3823
"36099951000",1942,217,0,0,52,1,30,0,2242
"36101960100",1082,198,2,0,16,5,0,0,1303
"36101960200",3011,446,16,14,45,17,102,22,3673
"36101960300",2051,449,5,0,56,6,16,0,2583
"36101960400",3309,619,43,0,57,46,41,0,4115
"36101960500",2250,301,0,9,18,0,44,0,2622
"36101960600",3364,551,3,0,84,29,61,28,4120
"36101960700",2246,671,197,15,133,55,12,78,3407
"36101960800",2217,342,1,1,68,2,33,11,2675
"36101960900",1729,587,0,9,0,25,0,0,2350
"36101961000",2879,700,15,9,30,19,32,17,3701
"36101961100",3180,768,76,86,28,22,36,42,4238
"36101961200",3003,621,34,65,62,35,0,101,3921
"36101961300",2964,647,8,25,75,28,2,30,3779
"36101961400",1900,110,36,9,20,0,0,8,2083
"36101961500",1532,230,3,0,25,0,14,0,1804
"36101961600",1501,130,16,3,24,3,8,0,1685
"36101961700",2951,374,0,19,5,5,24,10,3388
"36101961800",2711,631,2,4,9,6,12,0,3375
"36101961900",2742,497,0,55,51,17,4,51,3417
"36101962000",3433,842,10,0,47,1,5,1,4339
"36101962100",2409,968,3,0,30,74,3,6,3493
"36101962200",2158,393,4,0,26,2,7,0,2590
"36101962300",6468,495,279,13,866,69,242,18,8450
"36101962400",2240,448,86,58,153,10,29,0,3024
"36101962500",1798,437,14,25,85,38,80,0,2477
"36101962600",2024,444,12,14,129,6,40,18,2687
"36101962700",2220,434,34,27,74,164,10,10,2973
"36101962800",3120,239,39,0,99,0,13,0,3510
"36101962900",2366,253,75,0,77,2,19,0,2792
"36101963000",3635,456,10,0,51,12,49,0,4213
"36103110101",3396,128,0,0,102,10,112,0,3748
"36103110102",4609,88,0,0,274,0,213,11,5195
"36103110200",4377,238,0,0,138,77,138,92,5060
"36103110300",4818,155,0,0,164,19,289,19,5464
"36103110401",2727,5,5,0,122,21,258,9,3147
"36103110402",2968,31,31,0,30,76,41,0,3177
"36103110501",2988,183,0,0,101,0,50,0,3322
"36103110502",2605,99,37,0,120,0,144,0,3005
"36103110600",6848,170,0,8,391,0,135,0,7552
"36103110801",1741,69,4,0,108,14,74,0,2010
"36103110803",5006,432,3,27,172,31,180,75,5926
"36103110901",2362,91,0,0,286,0,356,0,3095
"36103110902",1971,327,595,34,448,494,744,631,5244
"36103111001",1497,127,144,19,332,70,248,42,2479
"36103111002",2303,466,231,606,1339,628,1729,1052,8354
"36103111100",5690,533,336,63,2015,475,3969,786,13867
"36103111201",2169,485,246,72,1197,412,1727,665,6973
"36103111202",2978,310,469,0,575,2,959,113,5406
"36103111300",4348,121,103,0,96,0,164,0,4832
"36103111401",1199,13,16,11,38,13,39,0,1329
"36103111402",4567,154,110,0,281,2,296,55,5465
"36103111503",3097,145,624,363,288,10,323,12,4862
"36103111504",1070,52,53,0,254,1,37,0,1467
"36103111505",3734,114,1250,187,1160,14,1470,14,7943
"36103111506",2159,87,752,47,547,3,635,16,4246
"36103111601",3385,51,43,31,100,26,196,26,3858
"36103111602",3031,33,83,3,106,0,94,0,3350
"36103111701",5139,309,0,17,285,11,620,83,6464
"36103111703",2789,133,0,0,129,65,317,0,3433
"36103111704",3026,36,25,0,62,0,143,0,3292
"36103111801",5329,44,0,0,368,53,111,54,5959
"36103111802",2740,69,28,0,26,21,54,0,2938
"36103111803",2196,44,89,0,346,0,270,0,2945
"36103111804",2061,68,0,0,193,0,32,12,2366
"36103111900",4595,90,10,0,421,0,229,0,5345
"36103112001",3505,324,26,49,616,37,412,7,4976
"36103112002",4038,116,108,0,414,9,359,9,5053
"36103112102",3360,51,54,0,373,103,191,0,4132
"36103112103",3509,143,73,0,203,43,283,0,4254
"36103112104",1665,134,36,0,586,15,93,18,2547
"36103112204",3517,126,10,0,174,0,289,0,4116
"36103112206",6161,346,0,142,1070,83,624,0,8426
"36103112210",5950,117,232,23,949,0,189,7,7467
"36103112211",4110,85,202,0,312,21,340,15,5085
"36103112212",2230,102,272,0,533,14,152,0,3303
"36103112213",3709,194,380,24,783,47,377,12,5526
"36103112214",5516,197,700,73,767,0,120,0,7373
"36103122300",2882,136,54,7,823,83,1042,107,5134
"36103122403",682,11,1394,93,294,4,235,4,2717
"36103122404",2951,224,223,0,209,35,554,137,4333
"36103122405",721,46,2322,234,463,0,377,46,4209
"36103122406",724,22,3062,431,1023,172,1391,175,7000
"36103122501",579,83,2211,633,349,7,892,26,4780
"36103122502",219,5,3302,343,745,2,997,2,5615
"36103122601",4087,202,365,1,950,28,1048,30,6711
"36103122602",4179,88,224,15,409,27,407,0,5349
"36103122603",4724,207,373,0,490,17,725,28,6564
"36103122704",1172,67,472,0,289,56,274,51,2381
"36103122705",2179,133,79,7,297,23,313,6,3037
"36103122706",2687,252,193,6,418,0,321,44,3921
"36103122707",2459,127,21,0,569,13,319,0,3508
"36103122801",2652,343,2450,33,289,170,608,25,6570
"36103122802",3005,138,571,54,310,36,436,69,4619
"36103122901",5207,307,17,0,868,0,870,63,7332
"36103122902",4025,216,49,123,192,54,353,91,5103
"36103123001",4528,135,251,0,1051,151,1173,198,7487
"36103123002",3600,115,58,49,806,6,846,18,5498
"36103123101",3083,140,57,22,219,47,525,65,4158
"36103123102",3068,119,143,0,334,0,535,18,4217
"36103123201",756,54,578,32,448,47,506,44,2465
"36103123202",1874,181,4735,290,2212,74,3636,35,13037
"36103123301",1512,278,4496,365,1595,123,2549,213,11131
"36103123302",232,0,861,152,303,94,479,70,2191
"36103123401",3387,250,128,0,463,0,979,78,5285
"36103123402",5480,313,326,14,581,364,826,281,8185
"36103123500",3161,271,786,73,970,537,914,590,7302
"36103123600",2908,91,0,0,271,0,219,0,3489
"36103123701",3106,362,551,295,2214,236,3501,342,10607
"36103123702",5713,227,534,154,1543,69,2694,158,11092
"36103123801",3591,227,237,0,90,0,225,7,4377
"36103123802",2942,212,24,0,140,0,377,0,3695
"36103123900",4442,252,302,0,195,0,677,22,5890
"36103124001",3897,323,114,11,207,0,841,0,5393
"36103124002",3294,108,17,0,98,14,290,30,3851
"36103124101",4463,177,11,1,476,12,715,12,5867
"36103124102",2896,141,0,0,131,181,194,181,3724
"36103124200",5018,232,21,2,254,1,627,0,6155
"36103124300",5107,359,47,0,670,88,652,79,7002
"36103124401",3329,160,35,0,161,20,454,20,4179
"36103124402",3631,59,0,0,55,0,47,0,3792
"36103124500",4119,169,34,31,972,24,533,26,5908
"36103124601",2508,53,33,0,89,0,121,6,2810
"36103124602",3640,183,66,40,170,10,291,54,4454
"36103134702",5081,181,41,0,329,149,249,170,6200
"36103134703",3713,59,13,0,300,0,171,0,4256
"36103134704",2032,140,9,0,148,0,21,0,2350
"36103134902",3971,373,12,0,112,31,136,22,4657
"36103134903",1054,67,117,0,57,2,64,27,1388
"36103134904",5750,139,31,0,659,0,302,3,6884
"36103134906",5249,218,3,0,172,25,270,0,5937
"36103134907",4422,157,0,10,108,7,101,7,4812
"36103135002",4884,224,0,0,160,49,26,20,5363
"36103135003",4270,87,85,0,91,8,236,0,4777
"36103135004",2719,109,25,0,98,0,66,3,3020
"36103135005",2677,137,0,1,111,0,102,1,3029
"36103135101",3105,111,201,0,445,1,210,0,4073
"36103135102",3926,97,0,8,338,15,403,52,4839
"36103135103",4042,157,60,0,443,16,135,56,4909
"36103135104",4786,282,0,0,147,0,291,0,5506
"36103135201",1987,43,0,1,74,43,30,0,2178
"36103135204",4358,94,27,1,123,0,183,0,4786
"36103135205",4191,224,16,0,509,41,406,0,5387
"36103135208",2866,76,11,0,73,0,76,0,3102
"36103135209",2808,19,47,0,129,0,218,0,3221
"36103135301",3568,240,64,0,97,1,80,0,4050
"36103135303",3765,53,88,0,381,0,311,0,4598
"36103135304",3046,42,42,0,257,0,143,1,3531
"36103135401",5503,313,165,20,355,276,48,175,6855
"36103135402",6812,130,23,1,234,0,334,0,7534
"36103135403",3704,218,131,0,246,17,248,138,4702
"36103145602",2676,138,951,2,1494,654,3283,704,9902
"36103145603",2478,441,1132,51,2222,726,4273,938,12261
"36103145604",2559,286,268,9,1785,262,3527,529,9225
"36103145605",1632,87,797,32,834,198,1756,236,5572
"36103145701",4397,120,152,57,636,0,616,18,5996
"36103145702",2927,85,308,0,2506,484,4444,446,11200
"36103145703",2207,372,588,140,2081,445,3054,636,9523
"36103145704",3315,256,1122,648,1867,42,3178,123,10551
"36103145803",4395,169,23,0,240,0,333,36,5196
"36103145804",1956,142,520,0,656,9,797,42,4122
"36103145805",5335,171,48,0,293,2,379,26,6254
"36103145807",4010,155,90,0,170,0,501,26,4952
"36103145808",2891,200,0,79,86,53,185,80,3574
"36103145901",1870,71,643,20,1124,195,1497,237,5657
"36103145902",2740,295,2154,181,2696,380,4046,309,12801
"36103145903",4077,231,924,48,680,103,1567,73,7703
"36103146001",2188,126,1209,158,1884,333,3502,391,9791
"36103146002",2633,81,821,12,2135,261,4075,319,10337
"36103146003",4122,191,1703,30,2159,74,3386,117,11782
"36103146102",938,69,310,44,751,154,1033,94,3393
"36103146103",3301,0,20,0,493,6,489,6,4315
"36103146105",2380,192,1261,8,2529,68,3704,182,10324
"36103146106",1436,197,521,55,1608,68,2364,104,6353
"36103146201",1878,295,519,7,1559,455,2818,641,8172
"36103146202",1439,188,1843,240,1668,108,3086,244,8816
"36103146203",2666,676,1194,79,839,277,2776,819,9326
"36103146204",2408,81,1273,110,2153,310,3688,388,10411
"36103146205",2025,8,50,1,75,0,259,0,2418
"36103146206",1802,109,264,11,455,102,648,102,3493
"36103146300",1418,152,444,29,200,19,160,43,2465
"36103146402",3665,168,45,0,253,1,448,0,4580
"36103146403",1799,164,1438,137,1456,200,2696,215,8105
"36103146404",1496,334,618,89,1232,230,1801,358,6158
"36103146500",4466,251,97,0,292,0,546,67,5719
"36103146604",3460,191,164,7,580,6,341,6,4755
"36103146605",840,20,0,0,112,0,234,0,1206
"36103146606",7063,364,0,0,247,0,681,0,8355
"36103146607",2127,147,58,0,148,26,191,65,2762
"36103146608",2359,165,17,0,137,0,188,0,2866
"36103146611",2984,170,60,0,81,52,348,0,3695
"36103146612",4967,50,10,1,252,25,566,0,5871
"36103146613",3855,67,33,0,59,3,584,27,4628
"36103146614",5142,108,35,0,592,0,774,20,6671
"36103146615",3962,168,156,0,459,65,464,69,5343
"36103146703",2149,247,497,0,799,58,1126,122,4998
"36103146704",1633,28,0,0,153,9,137,0,1960
"36103146705",3264,236,5,2,0,33,313,33,3886
"36103146706",2455,29,33,4,65,42,267,2,2897
"36103146800",5754,30,0,0,131,0,176,0,6091
"36103146901",4623,412,16,0,335,0,496,46,5928
"36103146902",3262,163,0,0,123,0,63,0,3611
"36103147001",3982,145,0,0,155,0,202,0,4484
"36103147003",4117,115,108,0,231,0,884,3,5458
"36103147004",216,6,6,0,5,0,11,0,244
"36103147100",2802,58,16,7,219,8,217,19,3346
"36103147200",3080,400,1005,37,1805,37,2276,127,8767
"36103147300",3451,194,1842,158,1392,931,1808,988,10764
"36103147401",4754,224,663,18,283,16,556,136,6650
"36103147402",3411,22,0,0,112,0,166,0,3711
"36103147501",6763,491,131,0,23,0,744,0,8152
"36103147502",5977,200,0,0,196,0,277,0,6650
"36103147503",1485,49,0,1,101,0,44,0,1680
"36103147601",2138,46,26,0,31,0,253,0,2494
"36103147602",4588,206,63,6,276,0,241,0,5380
"36103147701",2964,77,8,0,126,49,133,0,3357
"36103147702",4403,88,0,0,181,13,236,11,4932
"36103147802",3464,65,0,0,30,0,297,0,3856
"36103147803",2831,128,55,0,69,20,216,11,3330
"36103147804",5564,181,0,3,137,3,128,31,6047
"36103147901",3696,246,36,51,97,59,247,33,4465
"36103147902",3914,164,0,7,85,0,222,0,4392
"36103158001",3557,71,84,0,532,9,212,9,4474
"36103158002",5386,271,66,0,515,31,315,0,6584
"36103158006",5609,92,123,0,673,264,481,2,7244
"36103158007",49,0,0,0,83,0,0,0,132
"36103158009",2616,16,0,0,141,14,119,0,2906
"36103158010",3149,27,50,0,412,21,66,0,3725
"36103158011",3947,268,103,13,389,0,113,0,4833
"36103158102",4221,110,105,0,471,9,988,28,5932
"36103158103",3408,191,182,156,391,16,832,13,5189
"36103158104",4754,234,205,0,503,27,585,0,6308
"36103158107",3318,318,17,0,378,32,555,80,4698
"36103158108",1865,216,32,0,803,79,158,39,3192
"36103158110",3207,180,0,0,178,47,419,30,4061
"36103158111",2927,134,82,9,129,12,460,16,3769
"36103158112",3547,278,92,6,275,170,671,105,5144
"36103158114",2972,162,18,0,262,7,233,26,3680
"36103158115",5666,170,398,0,523,0,355,0,7112
"36103158116",1345,94,98,0,333,122,177,20,2189
"36103158202",7004,854,126,0,645,137,1168,482,10416
"36103158203",1374,6,29,0,123,29,22,0,1583
"36103158205",1966,36,0,0,27,0,97,0,2126
"36103158206",2995,286,34,17,207,34,293,38,3904
"36103158207",4097,137,102,4,464,9,257,7,5077
"36103158304",6070,741,30,8,331,0,427,439,8046
"36103158306",5381,150,41,0,237,0,428,0,6237
"36103158308",7021,304,124,5,723,0,1714,5,9896
"36103158309",3434,257,702,25,538,53,722,19,5750
"36103158310",3205,243,170,8,267,0,228,16,4137
"36103158315",3480,185,378,37,480,72,753,119,5504
"36103158317",5135,437,0,0,154,16,791,0,6533
"36103158318",4031,149,8,2,96,13,258,13,4570
"36103158319",2554,296,250,11,311,121,333,47,3923
"36103158320",5680,157,23,0,56,51,329,4,6300
"36103158321",7174,117,938,20,1976,201,1545,71,12042
"36103158322",1882,7,175,0,210,37,35,0,2346
"36103158323",6337,367,88,3,268,0,236,0,7299
"36103158401",1267,24,0,0,89,0,125,1,1506
"36103158402",4050,186,0,6,162,0,375,0,4779
"36103158403",1650,91,163,14,136,15,231,16,2316
"36103158405",4316,131,0,0,213,9,334,35,5038
"36103158407",5710,50,4,0,115,18,507,18,6422
"36103158408",3709,312,0,0,54,58,356,17,4506
"36103158409",3325,93,72,95,249,10,218,0,4062
"36103158410",2948,264,48,1,0,0,0,0,3261
"36103158502",3478,258,18,7,28,0,385,0,4174
"36103158505",3571,385,74,0,385,109,327,146,4997
"36103158506",2132,154,9,0,323,18,202,26,2864
"36103158507",3320,128,24,0,425,44,653,0,4594
"36103158508",5868,96,112,0,290,0,896,0,7262
"36103158509",3653,480,161,91,452,83,1047,118,6085
"36103158510",6136,270,186,0,491,169,754,218,8224
"36103158511",5724,291,133,0,703,48,1264,58,8221
"36103158512",3149,128,0,37,154,13,363,62,3906
"36103158604",4425,99,40,0,345,4,564,6,5483
"36103158605",4281,188,191,13,572,1,640,10,5896
"36103158606",3923,317,16,0,458,0,646,10,5370
"36103158607",2392,251,111,0,218,14,489,30,3505
"36103158608",3089,203,18,2,404,30,333,22,4101
"36103158609",4041,34,146,28,270,20,629,7,5175
"36103158704",6172,600,863,303,637,133,1688,110,10506
"36103158705",1274,298,1798,276,168,100,818,118,4850
"36103158707",1371,71,39,0,115,8,204,8,1816
"36103158708",2239,313,656,241,308,14,142,170,4083
"36103158709",1650,378,40,13,86,8,270,22,2467
"36103158710",3064,162,278,132,103,33,312,11,4095
"36103158711",3293,179,704,1,910,102,593,44,5826
"36103158712",5877,803,574,26,132,0,1672,71,9155
"36103158802",4393,173,0,0,36,0,209,0,4811
"36103158803",5909,139,377,1,222,62,1060,1,7771
"36103158804",5698,452,245,0,263,58,1145,151,8012
"36103158900",5143,870,414,178,547,36,1636,588,9412
"36103159000",3559,550,251,39,326,10,1101,311,6147
"36103159102",4431,1020,342,52,328,0,700,318,7191
"36103159103",2493,718,1118,1066,570,498,1797,934,9194
"36103159105",5602,247,306,67,706,0,1362,24,8314
"36103159106",4331,185,510,91,534,4,868,98,6621
"36103159107",3546,154,0,0,105,0,301,0,4106
"36103159108",6768,191,284,0,556,9,1710,129,9647
"36103159201",3001,220,23,0,12,0,803,0,4059
"36103159203",4587,715,176,18,60,1,181,73,5811
"36103159204",3197,182,130,199,20,0,397,53,4178
"36103159300",1814,87,19,0,49,0,59,0,2028
"36103159404",4252,1045,595,143,1317,58,1295,704,9409
"36103159406",3411,397,134,0,170,47,719,94,4972
"36103159407",5425,186,315,38,420,260,1045,30,7719
"36103159408",3105,299,229,8,324,0,538,74,4577
"36103159410",7466,307,405,125,83,5,353,16,8760
"36103159411",2807,248,209,26,160,99,210,150,3909
"36103159412",6923,158,150,0,151,140,229,56,7807
"36103159505",6832,224,771,68,582,194,1990,0,10661
"36103159506",5644,868,803,309,766,97,1481,80,10048
"36103159508",5942,654,476,151,224,264,1431,275,9417
"36103159509",1818,372,123,163,60,0,233,32,2801
"36103159510",152,16,8,0,27,0,50,6,259
"36103159511",5505,245,206,364,462,192,908,27,7909
"36103159512",1790,148,88,460,33,0,190,35,2744
"36103159601",6196,81,28,6,29,7,100,7,6454
"36103159602",3787,167,55,0,32,0,167,0,4208
"36103169701",7010,340,78,0,145,0,459,84,8116
"36103169703",1439,50,6,0,5,0,12,0,1512
"36103169704",5877,268,288,18,296,125,1081,0,7953
"36103169800",3926,220,194,388,923,435,1889,440,8415
"36103169901",4015,144,1175,295,338,143,370,223,6703
"36103169902",4469,460,57,173,0,0,420,272,5851
"36103170001",5064,200,79,0,189,0,137,30,5699
"36103170002",3607,125,137,14,67,0,65,13,4028
"36103170101",1454,221,231,10,175,178,385,316,2970
"36103170201",5906,139,0,0,244,0,96,0,6385
"36103170202",3424,259,13,0,64,1,186,29,3976
"36103180300",2538,0,26,0,49,0,176,0,2789
"36103190401",4190,745,1125,83,732,332,2226,794,10227
"36103190402",1937,251,26,5,59,38,258,181,2755
"36103190403",2954,171,11,0,209,45,1085,64,4539
"36103190502",2083,209,29,0,119,11,213,41,2705
"36103190503",2586,220,25,24,181,0,247,129,3412
"36103190504",1698,40,0,1,15,0,5,0,1759
"36103190601",3854,129,53,0,244,2,134,2,4418
"36103190603",3689,143,108,0,244,55,1450,97,5786
"36103190604",3524,311,20,0,100,0,617,144,4716
"36103190704",2829,58,35,3,37,9,446,0,3417
"36103190705",2794,332,62,0,388,45,573,236,4430
"36103190706",3694,242,252,10,322,1,455,21,4997
"36103190707",4211,456,0,0,352,47,326,421,5813
"36103190708",1818,111,26,2,9,20,182,29,2197
"36103190800",2126,102,263,251,127,57,105,58,3089
"36103200901",1096,49,0,0,10,0,103,0,1258
"36103200902",5878,510,229,0,558,89,813,327,8404
"36103201001",5051,273,56,9,319,147,1523,13,7391
"36103201003",3374,276,258,7,38,0,1048,55,5056
"36103201004",2908,318,97,16,75,24,165,33,3636
"36103201100",2351,257,950,90,2340,112,3590,232,9922
"36103990100",0,0,0,0,0,0,0,0,0
"36105950100",2999,320,99,15,97,0,245,21,3796
"36105950200",2937,489,6,110,83,50,211,50,3936
"36105950300",1363,118,16,5,28,0,25,5,1560
"36105950400",2605,329,4,4,33,17,87,27,3106
"36105950500",1921,419,106,27,227,112,348,149,3309
"36105950600",1537,290,20,0,105,2,174,91,2219
"36105950700",2941,713,216,124,425,175,988,318,5900
"36105950800",2448,563,148,129,570,161,470,87,4576
"36105950900",1299,960,75,302,510,102,785,142,4175
"36105951000",1057,157,179,64,210,186,225,288,2366
"36105951100",1449,126,78,56,348,57,504,57,2675
"36105951200",6071,580,331,4,506,35,694,53,8274
"36105951300",3480,482,109,10,218,37,268,163,4767
"36105951500",1118,557,236,132,246,83,331,102,2805
"36105951600",1882,601,78,84,67,106,169,264,3251
"36105951700",3341,239,110,16,340,0,400,56,4502
"36105951800",1700,1048,1734,748,756,348,1082,583,7999
"36105951900",1377,323,11,92,311,36,130,116,2396
"36105952000",1765,88,48,63,47,0,68,48,2127
"36105952100",2115,282,26,49,101,51,86,27,2737
"36105952200",1137,103,6,1,39,64,38,54,1442
"36105952300",1043,109,74,10,89,0,44,0,1369
"36105952400",1893,314,84,6,55,48,42,40,2482
"36105952500",1969,415,29,0,128,0,164,49,2754
"36107020100",5673,573,2,3,93,42,36,12,6434
"36107020200",4540,482,31,0,149,0,125,0,5327
"36107020300",6176,264,15,0,103,189,70,0,6817
"36107020401",4659,315,18,4,83,5,42,0,5126
"36107020402",3567,83,0,1,135,2,69,2,3859
"36107020500",3135,427,62,15,76,31,123,24,3893
"36107020600",6431,722,9,0,161,27,55,76,7481
"36107020701",2620,392,24,2,34,0,67,0,3139
"36107020702",3824,565,26,0,0,1,26,1,4443
"36107020703",3472,555,66,30,10,6,8,6,4153
"36109000100",811,248,111,71,177,78,59,52,1607
"36109000200",695,2184,0,8,605,2224,126,276,6118
"36109000300",86,20,0,0,10,42,11,5,174
"36109000400",178,144,21,0,263,80,72,31,789
"36109000500",2501,429,281,62,1054,282,135,3,4747
"36109000600",2529,325,16,2,1221,215,305,2,4615
"36109000700",1878,478,11,21,341,586,83,111,3509
"36109000800",1202,356,266,294,159,59,263,136,2735
"36109000900",2589,431,137,144,120,197,40,200,3858
"36109001000",1853,916,174,305,347,28,221,344,4188
"36109001100",2970,1005,92,91,364,104,264,0,4890
"36109001200",58,28,2,1,43,1,37,1,171
"36109001300",3252,662,198,225,1088,906,56,59,6446
"36109001400",3105,212,27,36,196,23,54,17,3670
"36109001500",4398,527,26,161,1011,60,79,0,6262
"36109001600",3322,638,0,2,69,112,36,4,4183
"36109001700",3928,558,10,120,248,8,59,0,4931
"36109001800",4078,492,72,0,180,0,134,0,4956
"36109001900",5650,534,103,21,167,0,42,0,6517
"36109002000",3435,315,1,32,139,24,141,32,4119
"36109002100",3961,447,15,12,36,7,100,0,4578
"36109002200",3848,428,7,12,50,24,18,11,4398
"36109002300",5161,381,26,0,156,0,61,0,5785
"36111950100",4583,343,149,0,160,0,164,0,5399
"36111950200",3333,396,27,14,157,43,414,126,4510
"36111950300",3748,274,153,15,252,0,84,56,4582
"36111950400",3418,395,0,48,274,22,278,16,4451
"36111950500",2524,199,40,12,199,72,54,73,3173
"36111950600",2272,386,46,0,127,16,95,0,2942
"36111950900",1176,164,8,0,4,24,16,17,1409
"36111951000",3707,320,4,74,203,81,194,81,4664
"36111951100",1890,188,80,0,218,0,121,0,2497
"36111951200",3372,322,47,0,81,20,11,50,3903
"36111951300",2972,515,80,26,118,120,209,0,4040
"36111951400",2610,445,31,21,299,0,90,24,3520
"36111951500",2724,230,47,0,240,49,94,36,3420
"36111951600",1826,73,51,0,150,0,80,26,2206
"36111951700",2848,395,544,152,195,123,292,92,4641
"36111951800",911,90,340,90,280,45,94,7,1857
"36111951900",1557,467,222,240,308,0,395,36,3225
"36111952000",1147,330,361,119,230,31,361,56,2635
"36111952100",1878,703,664,137,543,112,695,469,5201
"36111952200",2914,187,417,64,156,17,237,46,4038
"36111952300",1159,106,108,0,198,30,153,0,1754
"36111952400",1947,359,155,196,176,27,388,252,3500
"36111952500",2743,114,168,13,217,8,62,8,3333
"36111952600",4970,512,0,22,10,17,147,41,5719
"36111952700",2454,226,1,36,37,43,175,69,3041
"36111952800",2830,176,88,15,28,18,218,7,3380
"36111952900",4973,275,25,36,256,16,42,17,5640
"36111953000",1626,138,0,4,71,0,26,3,1868
"36111953300",3551,126,89,15,194,57,284,84,4400
"36111953400",3470,821,67,71,321,88,642,156,5636
"36111953500",1310,851,48,37,106,55,101,10,2518
"36111953600",3749,588,153,103,246,152,251,379,5621
"36111953700",4592,208,361,0,96,46,245,22,5570
"36111953800",3334,247,149,1,106,15,225,1,4078
"36111953900",3908,318,196,0,203,273,302,195,5395
"36111954000",3865,506,2,0,215,0,353,47,4988
"36111954100",4036,554,651,37,436,50,1221,109,7094
"36111954200",4791,597,66,125,76,26,289,70,6040
"36111954400",6856,1841,235,229,344,179,507,411,10602
"36111954500",2390,230,8,15,73,55,197,80,3048
"36111954600",1535,154,25,0,112,54,351,4,2235
"36111954700",1408,335,19,20,179,74,295,16,2346
"36111954800",2813,519,450,144,798,123,1067,190,6104
"36111954900",1335,139,0,0,34,0,23,0,1531
"36111955000",4685,329,19,0,371,6,271,28,5709
"36111955300",1872,210,4,1,281,0,34,1,2403
"36111955400",3108,160,1,0,188,5,214,8,3684
"36113070100",2206,188,21,0,22,0,69,0,2506
"36113070200",1310,554,17,37,0,42,13,21,1994
"36113070300",3321,326,19,53,33,34,195,14,3995
"36113070400",3042,540,45,3,179,7,118,11,3945
"36113070500",1712,474,20,32,123,67,25,4,2457
"36113070601",4882,172,0,135,46,0,159,0,5394
"36113070602",1203,219,0,0,27,0,39,0,1488
"36113070701",3458,357,0,0,86,32,78,0,4011
"36113070702",3923,412,57,0,168,140,44,32,4776
"36113070800",6414,852,0,22,209,0,33,9,7539
"36113070900",4365,164,1,1,36,11,38,0,4616
"36113071000",3040,260,0,15,15,0,48,0,3378
"36113072000",3052,387,1,1,23,6,23,17,3510
"36113073000",3440,575,12,0,10,0,79,6,4122
"36113073500",1688,289,2,27,51,0,37,0,2094
"36113074000",1376,293,0,0,18,0,9,0,1696
"36113075000",2618,543,0,0,0,4,0,3,3168
"36113076000",2137,223,12,0,54,98,8,0,2532
"36113078000",2201,81,78,14,20,0,106,0,2500
"36115080100",3164,1362,0,0,7,109,30,64,4736
"36115080200",2140,284,2,55,93,23,17,55,2669
"36115080300",4836,418,10,0,151,4,157,4,5580
"36115081000",3252,216,49,3,94,3,38,1,3656
"36115082001",3690,1182,28,3,78,1,84,15,5081
"36115082002",1129,95,0,0,18,0,22,0,1264
"36115084000",5472,818,2,38,94,12,47,66,6549
"36115085000",2074,208,0,2,33,6,0,2,2325
"36115086000",1407,234,0,31,15,26,16,4,1733
"36115087000",3272,271,0,0,79,0,0,0,3622
"36115088000",4954,744,8,79,82,11,85,9,5972
"36115089000",4385,336,13,0,132,1,36,12,4915
"36115090000",2287,363,10,5,23,13,40,50,2791
"36115091000",1573,185,7,0,20,0,26,0,1811
"36115092000",3025,244,0,0,60,13,84,0,3426
"36115093000",1606,230,4,0,117,9,0,0,1966
"36115094000",2221,123,0,0,27,0,57,0,2428
"36117020101",4791,99,238,2,198,2,181,2,5513
"36117020102",4149,537,42,0,68,0,118,58,4972
"36117020201",4446,154,39,0,79,0,72,2,4792
"36117020202",4474,42,49,0,124,0,75,0,4764
"36117020301",3438,285,8,0,31,55,27,4,3848
"36117020302",4847,246,6,8,127,0,296,0,5530
"36117020401",2503,196,54,0,11,11,224,11,3010
"36117020402",3372,311,64,223,76,68,142,15,4271
"36117020500",4162,306,45,57,121,3,9,3,4706
"36117020600",3411,653,20,0,95,64,47,0,4290
"36117020700",2800,633,2,0,100,56,143,44,3778
"36117020800",2504,270,45,69,54,54,20,20,3036
"36117020900",3575,599,308,197,396,43,289,142,5549
"36117021000",5150,856,16,27,111,10,73,59,6302
"36117021100",3702,790,215,60,290,18,347,32,5454
"36117021200",3078,810,157,178,186,41,285,55,4790
"36117021400",2263,571,269,114,71,55,80,4,3427
"36117021501",1946,161,0,0,6,153,34,60,2360
"36117021502",3473,561,42,45,48,23,27,59,4278
"36117021600",3786,503,114,0,26,0,84,53,4566
"36117021700",3024,357,45,0,141,0,231,49,3847
"36117021800",1500,332,75,10,59,8,15,30,2029
"36117990100",0,0,0,0,0,0,0,0,0
"36119000101",440,512,828,46,2064,982,2503,1447,8822
"36119000103",816,272,1347,845,1300,508,1771,605,7464
"36119000104",0,0,0,0,0,0,0,0,0
"36119000201",1520,692,1164,140,3118,890,3852,1457,12833
"36119000202",1446,219,419,167,1360,246,1643,370,5870
"36119000203",1696,345,287,13,685,80,1075,219,4400
"36119000300",1147,642,767,410,696,618,1450,1270,7000
"36119000401",1055,526,824,255,858,247,1198,492,5455
"36119000402",561,286,2014,525,1235,330,1391,638,6980
"36119000500",768,308,743,363,644,267,1359,469,4921
"36119000600",1870,1101,2145,235,1414,308,2200,1136,10409
"36119000701",2218,135,673,20,299,35,588,43,4011
"36119000702",2069,158,1550,283,550,171,1422,261,6464
"36119000801",3786,294,899,0,704,66,1355,214,7318
"36119000802",1437,219,280,27,518,14,546,225,3266
"36119000803",2436,181,462,108,1094,112,1472,201,6066
"36119000900",2265,173,308,0,650,0,806,54,4256
"36119001000",169,253,558,440,340,123,406,209,2498
"36119001101",1243,482,286,226,545,860,1343,1059,6044
"36119001102",1635,122,491,551,1154,640,1543,584,6720
"36119001200",1307,470,484,373,1044,541,1385,1019,6623
"36119001301",2072,132,684,0,1718,33,1913,33,6585
"36119001302",1339,276,478,318,873,434,985,616,5319
"36119001303",649,852,747,820,2560,1629,2416,2223,11896
"36119001401",2391,213,367,0,750,152,781,218,4872
"36119001402",1081,63,112,24,434,42,414,26,2196
"36119001403",2481,179,143,7,778,98,716,103,4505
"36119001502",2141,197,298,0,152,139,583,84,3594
"36119001503",2254,129,144,0,374,73,601,8,3583
"36119001504",3006,77,467,12,987,95,940,36,5620
"36119001505",1147,103,319,16,532,9,671,59,2856
"36119001600",1536,568,280,46,485,220,1031,528,4694
"36119001700",6115,183,548,118,609,13,2067,70,9723
"36119001800",378,54,978,45,281,65,433,99,2333
"36119001900",1026,15,199,0,415,0,313,0,1968
"36119002000",3274,75,197,10,888,0,932,0,5376
"36119002101",2417,200,173,0,718,0,580,28,4116
"36119002103",2831,93,109,0,214,1,178,0,3426
"36119002104",4145,136,561,11,833,196,1267,59,7208
"36119002105",1717,47,69,2,173,0,66,9,2083
"36119002106",738,73,682,23,1099,130,446,69,3260
"36119002107",908,92,74,15,511,199,237,266,2302
"36119002201",1886,48,176,120,379,21,281,15,2926
"36119002202",4233,181,43,0,412,0,564,38,5471
"36119002203",1059,142,108,9,313,0,344,69,2044
"36119002204",3535,216,253,0,199,51,559,63,4876
"36119002300",2670,171,161,186,691,99,835,168,4981
"36119002401",1359,26,71,1,138,50,227,51,1923
"36119002402",2546,252,499,20,542,45,960,38,4902
"36119002403",3306,599,578,12,806,332,1091,104,6828
"36119002404",1992,85,121,5,766,199,513,137,3818
"36119002405",2165,91,0,23,713,114,736,39,3881
"36119002600",136,31,2534,781,476,11,350,27,4346
"36119002700",22,143,2323,972,198,178,200,297,4333
"36119002800",38,8,1630,406,196,23,49,11,2361
"36119002900",103,0,2449,1082,142,0,241,25,4042
"36119003000",99,37,1677,351,622,201,421,201,3609
"36119003100",89,1,1443,638,272,47,290,0,2780
"36119003200",132,0,1709,298,130,56,218,55,2598
"36119003300",152,27,2134,345,101,35,204,62,3060
"36119003400",312,87,3494,434,307,30,459,115,5238
"36119003500",239,76,963,470,217,188,326,240,2719
"36119003600",1093,197,1591,122,885,132,1232,246,5498
"36119003700",1275,265,1121,293,818,253,696,346,5067
"36119003800",1414,112,753,174,463,31,447,81,3475
"36119003900",2223,88,930,22,155,0,643,37,4098
"36119004000",1504,220,3573,323,604,31,898,75,7228
"36119004100",363,139,2873,392,481,50,279,205,4782
"36119004200",1072,296,2722,168,228,17,383,198,5084
"36119004300",473,51,620,5,81,11,56,0,1297
"36119004400",2149,33,846,26,280,143,49,1,3527
"36119004500",1116,281,319,14,58,7,250,10,2055
"36119004600",2435,14,0,1,364,52,146,1,3013
"36119004700",3014,82,9,0,156,11,221,0,3493
"36119004800",4320,302,1004,67,711,138,557,263,7362
"36119004900",2118,97,39,0,499,0,103,0,2856
"36119005001",2992,46,183,0,404,21,269,0,3915
"36119005002",3980,72,12,10,394,1,184,1,4654
"36119005100",3516,74,151,90,307,0,390,0,4528
"36119005200",4458,98,15,2,221,0,189,10,4993
"36119005300",3470,98,695,11,1027,37,683,56,6077
"36119005400",1407,20,30,6,129,38,79,38,1747
"36119005500",4888,104,250,7,289,1,238,1,5778
"36119005600",0,0,0,0,0,0,0,0,0
"36119005701",4431,302,768,117,400,237,1566,18,7839
"36119005702",1536,135,434,76,262,160,823,130,3556
"36119005800",2276,254,675,36,844,42,1688,149,5964
"36119005901",2267,395,414,115,430,324,1430,496,5871
"36119005902",3415,138,1149,69,635,25,772,54,6257
"36119006000",2259,495,764,67,625,64,706,448,5428
"36119006100",1782,610,760,69,675,104,1042,631,5673
"36119006200",3657,667,535,74,874,307,3089,689,9892
"36119006300",1639,188,1055,616,1767,371,2142,380,8158
"36119006400",1528,312,2542,367,1117,20,1496,120,7502
"36119006500",2057,133,1991,191,701,255,1105,382,6815
"36119006600",4214,262,822,31,328,43,504,16,6220
"36119006700",4502,80,172,0,217,72,272,7,5322
"36119006801",4839,119,138,2,474,1,129,0,5702
"36119006802",4882,116,387,40,311,23,336,0,6095
"36119006900",5425,169,31,2,398,0,248,12,6285
"36119007000",5253,179,20,19,612,0,349,0,6432
"36119007100",5045,202,101,7,542,55,270,1,6223
"36119007200",4309,300,399,59,1096,252,850,152,7417
"36119007300",2541,310,224,143,1109,355,1374,258,6314
"36119007401",3765,106,129,7,493,9,632,0,5141
"36119007402",2781,103,43,15,209,0,208,0,3359
"36119007500",4080,106,11,1,532,20,210,0,4960
"36119007600",5721,107,16,20,303,0,212,0,6379
"36119007700",4009,156,101,0,480,120,344,171,5381
"36119007800",1525,187,452,131,1404,446,2454,583,7182
"36119007900",2707,445,474,20,3351,1166,4222,1456,13841
"36119008000",837,166,354,113,2786,820,3199,902,9177
"36119008100",2773,134,90,0,1412,307,2354,327,7397
"36119008200",4388,152,296,13,1945,107,2183,159,9243
"36119008301",1962,68,175,12,382,225,498,225,3547
"36119008302",5760,155,0,6,594,19,206,0,6740
"36119008401",1787,111,9,0,193,0,141,0,2241
"36119008403",2670,149,33,4,817,83,386,53,4195
"36119008404",3382,230,270,13,1130,222,647,247,6141
"36119008500",2961,56,8,0,108,0,133,0,3266
"36119008602",3584,170,88,64,271,44,139,10,4370
"36119008700",4057,468,11,2,832,250,1585,502,7707
"36119008800",2101,216,544,100,1520,181,1534,276,6472
"36119008901",3727,317,360,37,832,22,1444,86,6825
"36119008902",1986,108,291,30,946,111,1127,202,4801
"36119009000",1890,132,429,78,1379,321,1351,331,5911
"36119009100",2380,305,808,84,2245,115,3186,255,9378
"36119009200",3213,338,738,281,2459,108,3701,502,11340
"36119009300",1121,226,503,668,736,58,473,222,4007
"36119009400",1514,218,387,155,1290,431,1239,552,5786
"36119009500",3057,189,400,90,990,214,1476,214,6630
"36119009600",3640,77,264,13,236,99,176,133,4638
"36119009701",2529,70,6,0,148,4,195,0,2952
"36119009702",1851,72,90,31,251,23,211,36,2565
"36119009703",3130,101,104,3,440,64,341,61,4244
"36119009800",4068,37,13,40,469,9,228,22,4886
"36119009900",2300,74,59,3,381,4,138,0,2959
"36119010000",3992,37,77,13,1077,31,70,0,5297
"36119010100",3743,77,0,0,905,34,262,0,5021
"36119010200",4348,36,120,5,142,47,192,27,4917
"36119010300",2246,262,32,0,303,0,258,3,3104
"36119010400",2367,113,69,97,683,0,549,35,3913
"36119010500",5586,141,167,25,713,26,387,26,7071
"36119010600",3128,79,188,0,1116,2,501,15,5029
"36119010701",3787,263,188,0,1297,11,256,0,5802
"36119010702",4085,81,238,35,1009,149,230,0,5827
"36119010801",2356,119,227,0,614,36,302,9,3663
"36119010803",2202,75,348,21,683,16,654,9,4008
"36119010804",1612,51,175,9,496,54,202,0,2599
"36119010901",1057,38,540,39,291,27,154,19,2165
"36119010902",2314,26,2314,87,1272,0,1153,3,7169
"36119010903",1383,99,1903,375,786,145,1185,187,6063
"36119011000",875,45,1117,0,690,37,605,37,3406
"36119011101",3635,98,970,12,1144,0,868,53,6780
"36119011102",2032,58,212,72,400,0,200,0,2974
"36119011200",1809,143,724,136,1049,231,1057,314,5463
"36119011300",5335,237,68,0,821,9,618,0,7088
"36119011400",4890,186,258,2,593,5,719,0,6653
"36119011500",3255,260,380,18,1066,18,1596,88,6681
"36119011600",3394,517,388,129,1810,727,3204,1206,11375
"36119011700",2352,162,0,2,433,5,269,3,3226
"36119011800",4236,47,68,6,753,9,521,2,5642
"36119011902",3565,94,0,26,513,8,427,14,4647
"36119012000",4088,118,13,48,219,26,275,0,4787
"36119012101",4613,156,34,0,446,28,310,21,5608
"36119012102",4294,99,0,0,279,94,408,86,5260
"36119012200",6061,152,106,23,443,0,510,0,7295
"36119012301",1735,54,127,0,423,178,273,178,2968
"36119012303",4651,37,43,36,246,0,364,0,5377
"36119012304",4096,146,75,0,188,0,125,0,4630
"36119012400",4577,190,62,0,266,75,165,0,5335
"36119012501",2669,63,9,2,200,2,106,4,3055
"36119012502",5484,208,166,0,245,10,318,0,6431
"36119012503",3140,31,137,1,209,0,162,0,3680
"36119012600",3616,146,176,0,478,144,168,117,4845
"36119012700",3958,167,36,0,289,10,251,9,4720
"36119012802",5145,319,278,1,1281,51,1589,226,8890
"36119012900",2393,152,95,22,1218,568,1420,602,6470
"36119013000",4074,165,286,152,1464,348,2150,352,8991
"36119013102",5296,365,112,35,616,33,263,23,6743
"36119013103",4296,44,0,4,676,10,300,14,5344
"36119013104",5341,28,76,0,604,0,278,0,6327
"36119013201",3003,65,27,14,487,28,171,1,3796
"36119013202",2025,207,61,0,650,18,121,18,3100
"36119013301",563,274,434,119,929,679,1277,811,5086
"36119013304",1756,163,683,97,1868,369,2315,551,7802
"36119013400",3132,510,731,58,1635,657,2539,758,10020
"36119013500",2174,73,146,1,974,171,1122,149,4810
"36119013600",2157,63,298,23,1647,760,1668,796,7412
"36119013700",4302,354,106,10,496,68,523,60,5919
"36119013800",2791,73,144,1,208,1,141,14,3373
"36119013900",3663,188,385,10,541,1,760,17,5565
"36119014000",1803,17,91,15,332,72,323,28,2681
"36119014100",2668,302,1040,406,1520,217,1845,180,8178
"36119014200",1080,170,767,42,1075,296,1273,289,4992
"36119014300",551,167,685,375,1813,467,1781,543,6382
"36119014400",2085,175,1418,167,1468,158,1630,176,7277
"36119014500",2542,135,403,446,900,73,687,366,5552
"36119014604",3349,215,46,0,623,56,613,55,4957
"36119014605",2173,105,184,0,570,0,485,11,3528
"36119014606",5020,84,229,0,318,68,128,67,5914
"36119014607",3174,109,431,0,499,0,676,0,4889
"36119014701",3338,105,518,53,682,21,726,56,5499
"36119014703",4922,205,168,57,709,36,1075,129,7301
"36119014704",1752,70,297,135,351,183,550,183,3521
"36119014804",6174,73,103,58,839,92,1849,114,9302
"36119014805",3345,90,70,12,344,0,463,1,4325
"36119014806",5864,0,272,0,384,0,575,0,7095
"36119014808",3284,54,42,2,259,2,219,2,3864
"36119014809",5788,72,215,68,470,11,568,1,7193
"36119014810",2037,43,49,0,90,0,154,0,2373
"36119014811",5411,48,230,7,237,10,549,10,6502
"36119014901",5431,128,8,0,494,25,357,28,6471
"36119014903",4117,142,18,0,257,0,146,7,4687
"36119014907",3469,20,66,1,319,1,276,1,4153
"36119014908",2730,24,32,1,246,0,154,3,3190
"36119014909",2663,91,0,0,138,0,147,2,3041
"36119015000",4365,155,52,3,320,3,312,57,5267
"36119981000",98,284,16,109,245,81,31,43,907
"36119982000",0,0,0,0,0,0,0,0,0
"36119983000",12,66,33,115,1,0,11,33,271
"36119984000",55,12,33,14,40,0,45,0,199
"36119985000",0,0,0,0,0,0,0,0,0
"36121970100",2302,234,14,0,3,0,16,12,2581
"36121970200",3703,138,0,0,106,14,53,0,4014
"36121970300",3200,77,0,0,49,12,81,0,3419
"36121970400",3551,255,26,39,16,14,12,31,3944
"36121970500",4002,722,0,0,1,60,0,52,4837
"36121970600",3829,664,0,4,0,0,10,1,4508
"36121970700",2510,309,12,0,42,0,10,85,2968
"36121970800",2713,303,0,1,30,0,51,13,3111
"36121970900",1856,72,4,0,19,7,0,0,1958
"36121971000",3517,554,0,1,49,41,12,15,4189
"36121971100",2258,325,3,0,46,15,72,16,2735
"36123150100",4939,992,0,9,84,26,199,40,6289
"36123150200",4405,734,41,19,36,38,17,1,5291
"36123150300",4455,883,9,11,45,12,38,66,5519
"36123150400",2600,359,4,0,72,0,47,0,3082
"36123150500",3542,614,12,9,79,0,20,15,4291
"37001020100",2084,519,509,497,181,295,191,237,4513
"37001020200",983,434,721,353,801,564,771,597,5224
"37001020300",2997,726,1610,747,1122,158,1870,501,9731
"37001020400",990,190,2688,1164,499,423,579,116,6649
"37001020501",2178,479,296,168,379,239,201,218,4158
"37001020502",1776,344,595,467,327,244,625,174,4552
"37001020601",2804,199,45,0,126,0,75,0,3249
"37001020602",2023,115,219,48,58,43,105,0,2611
"37001020701",3524,185,429,131,456,13,254,0,4992
"37001020702",2248,356,1222,193,358,78,147,176,4778
"37001020801",1178,63,71,133,58,3,92,0,1598
"37001020802",2508,724,967,878,457,359,723,159,6775
"37001020901",2066,532,288,67,467,291,699,536,4946
"37001020902",2293,234,221,18,175,570,98,718,4327
"37001021000",1218,572,648,401,338,353,302,297,4129
"37001021101",1699,278,423,187,238,131,217,166,3339
"37001021102",2287,340,220,258,169,10,89,0,3373
"37001021201",2082,577,1021,497,634,315,687,394,6207
"37001021204",2737,283,499,52,610,196,804,227,5408
"37001021205",3417,267,871,131,266,0,170,0,5122
"37001021206",2810,482,950,51,854,684,572,684,7087
"37001021207",2253,484,217,246,78,9,110,118,3515
"37001021300",3197,370,1427,333,349,90,250,49,6065
"37001021400",2009,247,70,50,44,78,69,52,2619
"37001021500",3924,490,178,3,269,12,259,12,5147
"37001021600",3553,655,561,3,212,54,65,0,5103
"37001021701",3002,50,168,1,101,0,62,0,3384
"37001021702",3083,688,271,154,164,0,0,0,4360
"37001021703",3270,482,478,16,582,422,115,422,5787
"37001021801",3411,671,208,0,0,0,126,0,4416
"37001021802",3033,596,178,0,48,0,0,0,3855
"37001021803",2538,355,13,19,47,0,257,3,3232
"37001021901",3157,515,277,25,143,242,84,242,4685
"37001021902",3374,364,218,76,146,48,212,9,4447
"37001022001",2567,218,171,74,165,66,158,74,3493
"37001022002",2565,209,566,164,270,210,203,125,4312
"37003040100",3031,503,6,10,4,0,0,4,3558
"37003040200",3366,298,89,0,23,0,48,0,3824
"37003040300",2568,137,93,171,68,0,0,0,3037
"37003040400",4073,1309,715,116,111,91,121,127,6663
"37003040500",4685,1299,455,0,641,319,477,299,8175
"37003040600",4257,768,44,0,160,241,191,229,5890
"37003040700",5468,838,201,0,50,0,90,0,6647
"37005950100",3253,579,19,0,12,137,159,148,4307
"37005950200",2366,844,26,7,357,221,392,164,4377
"37005950300",2409,409,1,7,42,73,65,80,3086
"37007920100",1508,255,937,123,51,11,0,0,2885
"37007920200",838,78,478,117,61,8,0,0,1580
"37007920300",3527,560,1226,631,238,68,26,0,6276
"37007920400",614,169,1636,496,0,68,112,67,3162
"37007920500",2335,474,1414,1275,126,63,265,0,5952
"37007920600",1221,450,2177,1009,5,0,14,305,5181
"37009970200",2334,538,0,6,43,14,15,25,2975
"37009970300",1779,491,0,4,33,12,46,0,2365
"37009970400",3008,911,7,8,101,9,101,23,4168
"37009970500",4633,1300,16,0,233,323,228,427,7160
"37009970700",4926,642,0,13,101,7,52,2,5743
"37009970800",3931,858,17,19,112,334,63,372,5706
"37011930100",1939,565,14,4,49,1,32,42,2646
"37011930200",2503,306,1,3,133,89,47,119,3201
"37011930301",2575,490,13,24,278,53,134,160,3727
"37011930302",1960,701,0,0,190,17,3,26,2897
"37011930400",2645,395,0,30,318,137,121,96,3742
"37013930100",3446,441,931,798,10,215,392,218,6451
"37013930200",4336,943,1183,298,64,0,301,150,7275
"37013930300",1353,323,1056,912,186,101,26,93,4050
"37013930400",1741,316,1085,951,85,122,192,85,4577
"37013930501",2636,254,407,134,682,169,714,269,5265
"37013930502",2202,419,660,168,58,228,46,228,4009
"37013930600",2997,236,0,256,44,0,14,0,3547
"37013930700",2466,283,144,45,22,2,0,2,2964
"37013930800",1500,61,761,251,39,55,11,0,2678
"37013930900",2841,137,548,205,69,0,110,11,3921
"37013931000",3281,455,878,566,51,18,443,13,5705
"37015960100",2450,186,1713,710,91,0,10,0,5160
"37015960200",1275,202,1693,585,2,23,11,122,3913
"37015960300",743,87,1792,818,40,0,6,0,3486
"37015960400",1843,348,2834,1976,42,32,118,4,7197
"37017950100",3157,875,869,471,43,160,21,151,5747
"37017950200",1462,383,712,437,260,5,234,106,3599
"37017950300",3258,1191,755,444,308,406,183,1098,7643
"37017950400",1937,441,1832,1601,156,244,0,183,6394
"37017950500",4272,579,851,765,84,90,232,184,7057
"37017950600",2123,267,2218,1083,482,133,131,34,6471
"37019020101",1255,330,657,399,140,36,241,175,3233
"37019020102",1953,455,201,27,255,28,149,172,3240
"37019020103",5784,708,443,384,563,25,620,0,8527
"37019020104",2505,1014,812,203,1095,228,536,371,6764
"37019020201",2179,270,611,40,227,38,147,59,3571
"37019020202",5078,495,239,427,444,0,123,0,6806
"37019020203",1913,180,220,45,47,8,80,0,2493
"37019020204",4544,612,286,14,260,82,146,0,5944
"37019020303",1865,435,253,69,88,0,0,0,2710
"37019020304",4842,208,57,0,92,0,45,0,5244
"37019020305",2221,218,282,111,37,31,32,10,2942
"37019020306",1513,303,0,2,160,0,0,0,1978
"37019020307",170,9,0,0,0,0,0,0,179
"37019020308",1671,104,0,0,20,0,5,0,1800
"37019020309",2255,205,151,0,78,0,99,0,2788
"37019020310",1899,250,0,0,76,24,73,0,2322
"37019020402",2132,528,6,21,106,88,50,20,2951
"37019020403",2994,574,223,88,110,256,0,227,4472
"37019020404",1910,614,317,59,115,13,226,0,3254
"37019020405",1971,673,138,155,53,0,32,0,3022
"37019020504",1400,0,75,52,24,0,13,0,1564
"37019020505",1714,704,763,528,184,57,185,12,4147
"37019020506",3128,449,436,95,9,0,317,7,4441
"37019020507",5447,863,265,86,127,0,74,37,6899
"37019020508",1957,346,22,0,11,0,141,0,2477
"37019020509",3862,640,62,64,23,0,113,68,4832
"37019020510",1540,512,0,0,20,17,97,63,2249
"37019020511",2065,185,0,0,17,96,117,96,2576
"37019020512",811,43,0,0,9,0,36,7,906
"37019020601",3113,591,542,138,178,84,87,106,4839
"37019020602",3678,423,817,265,39,49,72,13,5356
"37019020603",1280,328,453,503,73,69,226,8,2940
"37019990100",0,0,0,0,0,0,0,0,0
"37021000100",612,260,41,66,25,13,71,28,1116
"37021000200",884,248,115,227,45,27,46,27,1619
"37021000300",1116,413,378,164,37,23,176,32,2339
"37021000400",2040,480,149,29,68,20,19,0,2805
"37021000500",3060,305,35,2,67,0,101,58,3628
"37021000600",1253,410,334,62,135,14,49,40,2297
"37021000700",561,142,452,58,13,7,0,0,1233
"37021000800",2227,250,155,212,166,0,52,0,3062
"37021000900",562,448,884,1096,63,152,19,76,3300
"37021001000",2760,440,293,547,278,119,84,199,4720
"37021001100",3587,410,134,215,97,43,182,19,4687
"37021001200",3684,669,69,175,277,24,320,64,5282
"37021001300",2516,885,140,167,296,257,320,393,4974
"37021001400",3728,1949,444,341,676,136,618,640,8532
"37021001500",1679,501,67,1,142,0,198,131,2719
"37021001600",4692,722,167,64,114,16,110,0,5885
"37021001700",1963,260,0,0,79,0,42,0,2344
"37021001801",2836,433,223,0,26,0,89,0,3607
"37021001802",3459,365,91,0,95,0,26,38,4074
"37021001900",2375,271,80,50,184,10,161,19,3150
"37021002000",2922,967,1241,419,212,101,173,0,6035
"37021002101",1382,62,0,0,14,0,44,0,1502
"37021002102",3380,884,1116,230,254,34,722,119,6739
"37021002203",2792,948,223,444,449,80,611,686,6233
"37021002204",6028,679,163,93,771,0,375,34,8143
"37021002205",6529,87,0,109,130,10,258,30,7153
"37021002206",3782,382,260,123,439,0,196,0,5182
"37021002301",5150,428,223,300,131,189,425,489,7335
"37021002302",6539,722,55,6,319,0,228,179,8048
"37021002401",2447,885,0,2,22,18,27,18,3419
"37021002402",4206,689,0,52,48,0,310,250,5555
"37021002503",3379,860,0,0,227,61,281,196,5004
"37021002504",3159,1138,2,0,254,17,0,0,4570
"37021002505",3919,597,101,3,12,0,128,0,4760
"37021002506",2660,510,47,48,18,160,192,0,3635
"37021002603",3279,548,0,3,33,0,43,0,3906
"37021002604",4770,1049,22,45,441,48,386,67,6828
"37021002605",4197,690,272,0,97,0,292,41,5589
"37021002606",2694,568,80,0,218,150,31,196,3937
"37021002607",3454,502,55,2,190,0,272,0,4475
"37021002701",2477,496,15,1,39,0,155,240,3423
"37021002702",3362,479,9,0,104,36,61,13,4064
"37021002703",4419,889,0,0,106,0,126,1,5541
"37021002803",3402,563,24,1,89,43,120,190,4432
"37021002804",4158,228,1,0,418,61,0,76,4942
"37021002900",2628,553,0,0,144,46,10,11,3392
"37021003001",6766,763,169,195,159,42,218,20,8332
"37021003002",5414,983,220,177,159,10,262,285,7510
"37021003102",4162,610,167,111,144,73,37,0,5304
"37021003103",1441,228,69,29,67,0,0,0,1834
"37021003104",4486,992,0,103,70,0,177,252,6080
"37021003201",1534,82,58,1,93,22,46,0,1836
"37021003202",3374,352,34,0,50,0,36,0,3846
"37021003203",4607,440,155,1,234,77,427,105,6046
"37021003204",4650,252,200,0,360,112,421,0,5995
"37021003205",1449,143,0,0,41,19,32,19,1703
"37023020100",2835,911,223,129,69,293,94,359,4913
"37023020201",4585,649,272,23,68,35,15,0,5647
"37023020202",3092,406,302,19,319,124,79,0,4341
"37023020301",3071,328,694,83,609,32,33,13,4863
"37023020302",5665,784,73,2,673,121,136,0,7454
"37023020500",1936,334,231,211,122,301,206,123,3464
"37023020600",2653,1126,418,295,568,570,333,919,6882
"37023020801",3701,764,225,156,213,145,15,104,5323
"37023020802",2415,356,16,35,322,11,131,0,3286
"37023020900",5364,1005,194,55,605,9,30,167,7429
"37023021000",4397,1139,5,17,276,81,43,20,5978
"37023021100",4343,1388,36,50,285,51,230,58,6441
"37023021201",2799,773,55,28,115,92,20,14,3896
"37023021202",2886,864,0,0,241,145,144,132,4412
"37023021203",2987,1086,79,0,129,0,0,0,4281
"37023021301",3358,676,11,40,114,342,70,187,4798
"37023021302",2022,899,0,0,65,33,4,0,3023
"37023021400",2660,608,256,314,546,148,686,337,5555
"37025040500",7525,1416,1776,138,729,75,1188,836,13683
"37025040600",5290,525,120,3,149,55,0,0,6142
"37025040701",1008,497,78,0,12,0,47,0,1642
"37025040702",3331,658,2133,191,527,21,647,204,7712
"37025040703",821,139,798,411,157,0,258,0,2584
"37025040800",2047,607,537,218,101,48,201,112,3871
"37025040900",1154,337,252,0,202,25,198,9,2177
"37025041000",2969,1429,943,630,338,412,335,521,7577
"37025041100",5094,429,924,186,447,70,393,79,7622
"37025041200",4282,637,419,198,331,141,93,127,6228
"37025041301",3369,257,598,98,228,0,90,0,4640
"37025041302",5391,217,1466,37,877,39,519,0,8546
"37025041303",5503,317,1594,7,1628,0,597,205,9851
"37025041501",7065,531,1630,152,508,85,187,0,10158
"37025041502",4359,760,792,0,282,107,260,330,6890
"37025041503",2491,70,484,0,241,14,305,17,3622
"37025041601",6646,457,409,25,217,0,249,0,8003
"37025041602",2615,216,37,22,95,14,131,0,3130
"37025041701",3257,131,150,0,135,12,0,0,3685
"37025041702",2904,407,9,0,52,0,11,0,3383
"37025041901",687,394,650,102,89,45,275,287,2529
"37025041902",1706,1172,395,347,430,38,649,816,5553
"37025042000",2905,659,522,226,133,14,318,153,4930
"37025042101",921,65,1133,743,121,213,710,212,4118
"37025042102",2518,533,568,237,82,148,141,247,4474
"37025042200",5517,306,393,67,496,1,953,0,7733
"37025042300",2846,545,439,292,357,215,633,430,5757
"37025042401",2905,227,220,20,23,52,326,52,3825
"37025042402",1996,408,857,534,724,69,878,237,5703
"37025042501",3840,167,154,19,230,24,38,0,4472
"37025042502",1670,116,497,204,20,0,244,0,2751
"37025042503",2725,170,168,200,394,55,239,100,4051
"37025042504",1203,108,94,0,24,0,0,0,1429
"37025042601",3986,48,466,77,402,0,194,0,5173
"37025042602",2491,457,506,279,374,289,747,288,5431
"37025042603",5215,320,842,147,161,0,161,0,6846
"37025042604",3595,239,397,0,380,0,273,5,4889
"37027030100",2469,551,604,572,276,432,318,393,5615
"37027030200",3390,1308,402,203,252,111,400,0,6066
"37027030300",2180,752,476,224,134,15,12,387,4180
"37027030400",2916,765,26,64,652,15,619,0,5057
"37027030500",3710,438,206,4,16,34,16,0,4424
"37027030600",3856,671,2,5,40,26,98,0,4698
"37027030700",5234,1070,0,0,50,15,33,0,6402
"37027030800",5944,1338,308,75,244,253,132,208,8502
"37027030900",3110,1435,173,71,155,0,38,0,4982
"37027031000",2530,265,20,0,62,5,131,0,3013
"37027031100",3143,498,50,10,28,17,15,0,3761
"37027031201",3967,833,3,3,100,47,74,0,5027
"37027031202",3472,804,49,76,32,0,14,0,4447
"37027031300",7291,1200,0,7,246,27,274,0,9045
"37027031401",2365,578,31,26,157,446,101,217,3921
"37027031402",2300,700,0,6,143,108,191,166,3614
"37027031403",1531,483,4,5,20,0,19,0,2062
"37029950101",4014,257,552,162,152,16,97,0,5250
"37029950102",3931,117,547,127,225,0,150,0,5097
"37031970101",888,184,0,0,0,0,0,24,1096
"37031970102",2149,358,80,48,42,0,0,27,2704
"37031970103",2477,359,0,0,25,19,0,0,2880
"37031970200",1536,115,0,0,11,2,7,0,1671
"37031970301",3077,416,495,345,42,114,41,153,4683
"37031970302",533,215,48,138,4,127,0,28,1093
"37031970303",492,39,33,5,0,0,0,0,569
"37031970304",1181,409,147,266,31,115,11,40,2200
"37031970401",746,272,187,6,68,179,27,39,1524
"37031970402",986,369,116,135,60,45,3,9,1723
"37031970403",908,164,0,0,0,0,0,0,1072
"37031970501",1634,450,305,38,54,35,159,160,2835
"37031970502",1656,132,38,0,153,0,189,0,2168
"37031970503",1733,169,244,140,33,38,0,6,2363
"37031970504",1168,383,11,0,200,8,243,158,2171
"37031970601",1004,197,2,0,9,26,9,0,1247
"37031970602",1019,14,0,0,39,0,0,0,1072
"37031970603",1352,184,59,0,84,56,47,0,1782
"37031970604",1958,144,12,0,65,0,25,0,2204
"37031970605",1145,81,112,0,40,6,0,0,1384
"37031970701",960,260,63,0,35,0,88,0,1406
"37031970702",2426,303,132,197,327,39,153,269,3846
"37031970703",3420,611,229,54,411,64,146,0,4935
"37031970704",1879,376,0,1,143,66,87,7,2559
"37031970801",1878,196,55,6,45,3,0,0,2183
"37031970802",1533,72,15,0,108,0,44,0,1772
"37031970803",1523,105,5,0,22,0,31,0,1686
"37031970804",2748,252,76,4,113,15,84,10,3302
"37031970805",1383,223,7,9,45,0,52,0,1719
"37031970901",1152,77,0,0,0,0,21,0,1250
"37031970902",1027,263,5,0,0,0,70,0,1365
"37031970903",997,111,0,0,55,0,65,0,1228
"37031971001",376,25,0,0,0,0,0,0,401
"37031971002",1432,63,4,0,36,0,52,0,1587
"37031971101",871,60,0,0,9,33,0,0,973
"37031971102",533,82,9,0,21,0,0,0,645
"37031980100",0,0,0,0,0,0,0,0,0
"37031990100",0,0,0,0,0,0,0,0,0
"37031990200",0,0,0,0,0,0,0,0,0
"37033930100",865,195,886,400,96,0,91,0,2533
"37033930200",1851,412,1306,1056,244,121,140,34,5164
"37033930300",2406,952,598,207,102,45,71,116,4497
"37033930400",995,335,752,21,5,37,0,0,2145
"37033930500",2131,233,796,115,22,75,68,41,3481
"37033930600",3431,438,889,140,36,33,70,60,5097
"37035010101",5875,468,21,237,348,96,0,81,7126
"37035010102",3190,174,244,41,236,17,216,17,4135
"37035010201",3933,381,43,0,223,266,460,170,5476
"37035010202",4521,1129,511,328,1009,422,514,722,9156
"37035010301",4163,318,62,3,452,90,391,194,5673
"37035010302",4028,321,284,95,451,60,41,90,5370
"37035010303",2962,564,66,27,336,294,91,601,4941
"37035010304",2833,331,69,37,915,158,902,164,5409
"37035010401",4600,936,546,37,350,221,416,404,7510
"37035010402",1749,723,387,241,173,328,313,436,4350
"37035010501",3015,74,149,59,148,67,194,0,3706
"37035010502",2998,259,60,0,62,0,21,60,3460
"37035010600",3713,692,124,362,601,103,250,91,5936
"37035010700",1202,504,115,113,157,140,269,79,2579
"37035010900",623,387,1509,660,360,55,228,35,3857
"37035011000",972,230,330,302,488,37,456,31,2846
"37035011101",2502,171,446,81,269,0,349,0,3818
"37035011102",4523,957,574,53,838,293,883,290,8411
"37035011200",3561,574,520,166,360,0,568,13,5762
"37035011300",3646,1522,430,366,568,277,615,536,7960
"37035011401",2747,394,360,26,117,62,68,91,3865
"37035011402",3098,362,175,0,0,0,21,0,3656
"37035011501",4322,313,202,80,57,13,70,9,5066
"37035011503",3367,112,0,107,52,125,17,80,3860
"37035011504",5013,238,99,0,121,0,56,0,5527
"37035011601",3253,388,130,64,467,60,117,104,4583
"37035011602",4111,782,84,48,106,146,56,266,5599
"37035011701",3128,571,153,135,530,73,298,66,4954
"37035011702",4656,795,552,67,846,14,71,44,7045
"37035011801",5695,267,391,1,347,28,190,6,6925
"37035011802",4855,583,0,277,164,287,213,118,6497
"37037020103",2996,227,129,16,1003,173,922,178,5644
"37037020104",4506,223,191,0,21,38,0,0,4979
"37037020105",2524,274,200,95,81,0,145,138,3457
"37037020106",3405,216,225,24,290,23,106,0,4289
"37037020200",5709,916,612,24,195,50,287,322,8115
"37037020300",2028,265,490,65,14,30,49,122,3063
"37037020401",3175,910,932,175,632,56,1811,708,8399
"37037020402",1129,925,1144,168,614,648,940,1352,6920
"37037020500",2688,734,442,74,63,14,0,42,4057
"37037020600",3564,432,636,604,187,29,121,13,5586
"37037020701",4754,135,185,0,481,0,266,0,5821
"37037020702",3051,275,293,136,122,2,36,24,3939
"37037020800",5508,793,1119,280,443,325,391,459,9318
"37039930100",3368,703,23,31,388,69,171,58,4811
"37039930200",1636,260,0,0,142,0,0,0,2038
"37039930300",1489,498,0,3,201,38,89,0,2318
"37039930400",4551,1206,164,76,128,69,113,57,6364
"37039930500",3837,733,17,45,68,19,41,0,4760
"37039930601",2472,520,0,0,0,104,24,32,3152
"37039930602",3067,723,19,0,12,93,41,72,4027
"37041930101",1849,666,1086,1507,13,2,55,0,5178
"37041930102",1544,221,265,146,177,71,0,0,2424
"37041930200",4266,669,1083,626,183,42,209,200,7278
"37043950100",3701,1001,0,0,12,0,20,25,4759
"37043950200",4266,1230,2,36,75,216,11,238,6074
"37045950101",4037,1201,11,15,116,68,58,109,5615
"37045950102",1930,227,134,38,40,69,8,0,2446
"37045950200",3073,531,1049,166,62,11,69,14,4975
"37045950301",2795,294,356,184,84,81,100,0,3894
"37045950302",4341,673,544,275,16,0,114,93,6056
"37045950400",4243,1038,837,179,215,154,127,0,6793
"37045950500",2301,836,330,326,183,48,184,27,4235
"37045950601",2773,695,249,113,102,11,0,0,3943
"37045950602",3334,970,885,192,220,0,139,0,5740
"37045950700",4906,406,1067,630,51,0,176,0,7236
"37045950800",2629,340,1146,460,65,24,436,102,5202
"37045950900",561,263,1149,1081,56,27,0,44,3181
"37045951000",1652,228,611,865,18,71,27,42,3514
"37045951100",891,164,618,715,265,17,149,0,2819
"37045951200",2500,589,956,692,259,115,0,279,5390
"37045951300",2206,188,238,194,38,5,126,12,3007
"37045951400",4417,760,582,284,194,1,110,55,6403
"37045951501",3872,592,13,33,51,19,61,68,4709
"37045951502",961,83,118,7,29,11,0,17,1226
"37045951503",1951,238,163,135,43,0,7,0,2537
"37045951601",2684,146,1051,473,12,5,12,0,4383
"37045951602",3409,751,501,218,30,0,77,33,5019
"37047930100",1787,357,1505,131,133,144,125,71,4253
"37047930200",808,87,355,252,452,131,15,88,2188
"37047930300",1382,127,163,123,435,94,15,13,2352
"37047930400",1691,396,1024,665,352,134,122,76,4460
"37047930500",2480,313,877,425,485,1,425,1,5007
"37047930600",2107,414,583,392,94,23,47,56,3716
"37047930700",2105,254,1336,759,174,70,57,34,4789
"37047930800",2228,303,521,410,586,14,486,14,4562
"37047930900",1406,667,956,1260,80,287,0,0,4656
"37047931000",3065,627,721,225,14,456,14,504,5626
"37047931100",2503,605,46,329,69,0,1,26,3579
"37047931200",3379,1045,1498,1118,163,77,48,117,7445
"37047931300",3312,475,328,99,200,2,166,121,4703
"37049960101",3628,219,107,0,0,0,129,0,4083
"37049960102",3899,494,182,92,113,23,135,0,4938
"37049960200",4183,710,1504,502,152,267,113,190,7621
"37049960300",3323,635,1751,727,404,74,384,365,7663
"37049960401",3070,140,792,23,183,70,46,0,4324
"37049960402",1952,68,1068,241,263,47,8,22,3669
"37049960403",4045,147,0,0,17,0,78,14,4301
"37049960404",2813,160,110,10,0,20,63,20,3196
"37049960500",3924,465,2180,584,547,584,559,362,9205
"37049960600",2046,274,873,142,870,181,182,0,4568
"37049960700",1450,71,80,31,179,124,54,0,1989
"37049960800",405,92,946,1460,41,66,33,15,3058
"37049960900",874,210,207,1022,1,288,81,1,2684
"37049961001",8094,462,851,463,313,31,249,0,10463
"37049961002",2936,372,376,86,70,155,50,346,4391
"37049961100",6347,741,1040,223,936,66,683,1,10037
"37049961201",2880,413,347,72,198,46,586,35,4577
"37049961202",553,90,42,0,175,6,108,17,991
"37049961301",2195,619,573,0,692,185,348,530,5142
"37049961302",2862,560,890,659,235,238,375,273,6092
"37049961303",2406,137,973,373,134,0,153,0,4176
"37051000200",171,97,569,1007,21,103,23,40,2031
"37051000500",801,284,311,385,192,148,140,112,2373
"37051000600",3318,269,997,443,358,22,231,0,5638
"37051000701",4069,105,550,74,630,60,182,14,5684
"37051000702",1516,171,188,208,67,80,10,11,2251
"37051000800",1481,290,406,259,174,30,137,10,2787
"37051000900",3081,349,592,164,331,72,420,16,5025
"37051001000",199,104,1249,1067,156,77,156,68,3076
"37051001100",126,3,2042,927,75,100,31,118,3422
"37051001200",1258,185,2191,1460,314,41,178,13,5640
"37051001400",2504,352,1848,856,211,201,253,70,6295
"37051001500",1239,360,659,234,105,49,88,131,2865
"37051001601",3696,674,2022,303,807,208,489,212,8411
"37051001603",2234,296,612,430,261,201,199,35,4268
"37051001604",2614,480,2355,954,583,141,640,114,7881
"37051001700",3949,710,2556,662,1148,297,890,315,10527
"37051001800",1205,451,412,111,232,46,145,37,2639
"37051001901",941,116,357,247,239,214,165,87,2366
"37051001902",1902,533,1273,346,578,196,540,200,5568
"37051001903",1916,607,905,356,287,57,297,131,4556
"37051002001",1405,168,703,94,333,11,415,118,3247
"37051002002",2342,395,1853,427,412,153,769,107,6458
"37051002100",1918,176,878,288,508,175,280,132,4355
"37051002200",567,112,315,193,179,55,142,73,1636
"37051002300",938,261,1751,703,526,150,525,103,4957
"37051002401",229,72,827,737,46,113,102,98,2224
"37051002402",609,124,1560,682,255,127,193,54,3604
"37051002501",1909,437,3846,453,632,77,427,61,7842
"37051002502",3030,472,1774,667,603,133,503,72,7254
"37051002503",2376,57,1823,286,418,0,379,0,5339
"37051002504",3312,199,1774,381,506,202,550,122,7046
"37051002600",2398,356,710,297,183,32,5,12,3993
"37051002700",5689,389,1536,230,733,96,349,203,9225
"37051002800",4657,580,691,98,387,118,59,90,6680
"37051002900",2673,448,789,324,385,20,260,0,4899
"37051003001",6930,572,1919,304,1632,152,1137,80,12726
"37051003002",1741,138,491,182,139,46,198,16,2951
"37051003102",2720,287,745,90,428,93,650,30,5043
"37051003103",3086,342,1410,82,451,164,390,46,5971
"37051003104",3461,791,1220,228,519,158,653,299,7329
"37051003201",7076,618,3003,144,1408,92,909,99,13349
"37051003203",1830,299,1654,725,846,108,596,152,6210
"37051003204",3460,632,2744,492,971,105,919,112,9435
"37051003205",1787,88,2216,538,674,240,538,213,6294
"37051003302",1540,152,2231,938,202,245,263,38,5609
"37051003304",2618,115,3027,595,593,79,445,246,7718
"37051003305",1927,246,2504,438,410,139,428,40,6132
"37051003307",1523,66,1541,419,477,133,457,124,4740
"37051003309",3171,301,1622,221,767,26,935,26,7069
"37051003310",1992,487,1520,372,282,0,648,166,5467
"37051003311",1078,110,745,93,207,97,177,6,2513
"37051003312",2486,708,2224,733,559,24,581,390,7705
"37051003313",1701,193,2735,442,650,9,549,130,6409
"37051003314",2223,344,2598,713,454,70,680,112,7194
"37051003401",2308,195,525,184,202,15,655,51,4135
"37051003402",0,0,0,0,0,0,0,0,0
"37051003403",2163,182,367,126,1044,141,725,122,4870
"37051003404",0,0,0,0,0,0,0,0,0
"37051003405",1067,147,310,15,171,265,394,140,2509
"37051003406",755,0,45,80,9,11,84,11,995
"37051003407",488,365,157,30,218,93,207,295,1853
"37051003408",2841,448,955,23,634,82,705,139,5827
"37051003500",1383,301,1597,671,912,514,527,202,6107
"37051003600",1802,581,1790,511,695,237,530,148,6294
"37051003700",4391,699,1343,215,371,10,310,130,7469
"37051003800",248,86,791,837,170,76,74,27,2309
"37051980100",0,0,0,0,0,0,0,0,0
"37051980200",0,0,0,0,0,0,0,0,0
"37053110101",736,44,0,0,8,0,0,0,788
"37053110102",1452,109,0,0,8,0,6,0,1575
"37053110200",5813,322,322,268,416,0,262,0,7403
"37053110301",3440,519,16,93,151,0,76,0,4295
"37053110302",1980,365,257,13,32,9,9,112,2777
"37053110401",2627,373,84,3,39,34,133,13,3306
"37053110402",3578,239,415,69,191,17,187,0,4696
"37053990100",0,0,0,0,0,0,0,0,0
"37055970101",3424,98,0,2,146,0,94,0,3764
"37055970102",3062,220,0,1,31,14,21,0,3349
"37055970200",3712,193,18,8,202,72,221,53,4479
"37055970300",5508,692,85,0,324,40,278,0,6927
"37055970400",2416,242,21,3,48,0,85,0,2815
"37055970501",1167,163,5,0,156,54,232,0,1777
"37055970502",3354,318,0,0,523,12,638,1,4846
"37055970601",4360,411,458,358,412,120,430,160,6709
"37055970602",1742,97,0,0,9,10,102,0,1960
"37055990100",0,0,0,0,0,0,0,0,0
"37055990200",0,0,0,0,0,0,0,0,0
"37057060101",4248,192,1000,9,128,0,227,0,5804
"37057060102",6266,624,119,0,56,11,217,0,7293
"37057060201",4266,316,290,77,140,23,252,42,5406
"37057060202",2385,212,15,5,24,0,124,0,2765
"37057060203",4579,679,49,0,300,0,344,0,5951
"37057060301",4029,343,439,0,92,0,32,79,5014
"37057060302",3319,158,50,15,153,0,37,0,3732
"37057060303",3318,526,327,27,36,111,88,29,4462
"37057060304",2878,540,17,2,18,12,55,107,3629
"37057060400",4303,662,304,0,303,71,0,15,5658
"37057060500",4554,465,0,0,184,77,321,9,5610
"37057060601",3779,347,0,45,210,9,41,159,4590
"37057060602",2543,168,45,0,0,10,203,82,3051
"37057060700",2025,512,1017,887,202,142,526,307,5618
"37057060800",1478,471,984,940,109,87,408,168,4645
"37057060900",2752,888,698,81,229,1,378,103,5130
"37057061000",3310,712,195,652,503,161,972,366,6871
"37057061100",5247,1292,214,0,54,38,173,177,7195
"37057061201",3709,925,353,85,1084,81,128,318,6683
"37057061202",2809,158,7,13,104,20,392,0,3503
"37057061300",1210,202,260,162,79,41,113,19,2086
"37057061400",941,623,446,589,67,17,602,164,3449
"37057061500",2322,702,1439,674,139,237,758,233,6504
"37057061600",1587,564,242,349,107,65,355,311,3580
"37057061701",4394,692,22,0,73,22,103,0,5306
"37057061702",5550,592,184,52,0,0,257,0,6635
"37057061703",3375,542,119,21,7,0,59,113,4236
"37057061802",5813,1210,1,0,82,63,207,31,7407
"37057061803",2278,516,536,164,306,97,188,135,4220
"37057061804",5072,464,283,0,98,0,0,0,5917
"37057061901",4940,1306,22,0,115,0,85,25,6493
"37057061902",4474,332,0,4,116,87,26,10,5049
"37057062001",3701,727,16,0,67,0,5,0,4516
"37057062002",2778,837,0,3,18,28,8,0,3672
"37059080100",5627,1461,403,24,543,169,627,291,9145
"37059080200",4677,350,51,46,248,0,242,0,5614
"37059080300",7656,486,204,10,266,0,195,0,8817
"37059080400",4290,514,16,77,12,0,14,1,4924
"37059080500",2772,767,432,188,250,155,522,97,5183
"37059080600",2391,419,378,128,26,1,88,1,3432
"37059080700",3986,769,395,318,450,23,415,89,6445
"37061090100",5099,1514,343,45,1006,1395,1507,2365,13274
"37061090200",1935,431,601,306,397,438,659,638,5405
"37061090300",2106,203,1396,1035,343,399,477,256,6215
"37061090400",2784,189,2336,761,399,289,719,320,7797
"37061090501",4033,1303,329,53,16,280,26,300,6340
"37061090502",2396,674,849,418,177,23,243,258,5038
"37061090600",2540,451,504,81,0,62,0,0,3638
"37061090701",1787,324,512,867,578,332,719,348,5467
"37061090702",3414,595,1135,483,689,195,754,380,7645
"37061090801",465,128,863,351,572,489,651,524,4043
"37061090802",1890,396,693,744,640,504,733,515,6115
"37063000101",746,47,921,361,300,358,242,331,3306
"37063000102",1959,544,687,713,155,123,622,532,5335
"37063000200",1349,283,589,576,163,72,251,224,3507
"37063000301",891,500,669,160,136,199,240,425,3220
"37063000302",2020,426,405,105,337,95,621,36,4045
"37063000401",2475,139,0,15,119,90,94,13,2945
"37063000402",1215,408,67,54,252,37,111,46,2190
"37063000500",531,375,871,657,125,222,144,72,2997
"37063000600",2619,512,916,1025,374,182,672,200,6500
"37063000700",1699,164,862,313,180,26,254,0,3498
"37063000900",184,160,808,531,112,104,202,239,2340
"37063001001",159,421,2097,817,377,339,210,396,4816
"37063001002",798,726,1698,1302,636,469,1120,984,7733
"37063001100",353,388,819,1128,195,78,361,369,3691
"37063001301",107,26,527,346,26,55,101,36,1224
"37063001303",80,8,789,422,29,2,91,8,1429
"37063001304",27,126,1322,1059,96,56,36,125,2847
"37063001400",25,0,905,1328,79,190,95,0,2622
"37063001501",0,34,0,0,0,43,0,9,86
"37063001502",953,1165,1275,926,1521,539,1048,817,8244
"37063001503",0,0,0,0,0,0,0,0,0
"37063001601",3427,176,1862,323,603,27,698,32,7148
"37063001603",4425,217,1205,89,162,53,563,28,6742
"37063001604",5142,54,894,50,309,25,39,0,6513
"37063001705",2481,537,1354,2,354,20,503,287,5538
"37063001706",1817,353,1404,260,400,411,77,325,5047
"37063001707",5074,251,262,11,980,383,479,347,7787
"37063001708",524,181,3380,367,362,170,485,138,5607
"37063001709",957,362,2715,1866,236,103,509,267,7015
"37063001710",1426,394,1520,254,657,77,634,263,5225
"37063001711",1437,184,1591,287,676,291,901,283,5650
"37063001801",2669,405,3657,501,462,18,754,318,8784
"37063001802",1176,612,3431,682,772,461,1163,964,9261
"37063001806",2205,388,2613,94,75,0,280,171,5826
"37063001807",2748,426,4515,611,769,288,1013,498,10868
"37063001808",3530,41,1990,8,548,7,737,7,6868
"37063001809",2687,623,1799,230,532,59,569,401,6900
"37063001900",2326,99,71,43,102,21,75,0,2737
"37063002007",2810,99,1327,44,421,138,373,138,5350
"37063002008",2733,16,132,0,212,0,131,0,3224
"37063002009",139,249,2998,694,84,251,189,422,5026
"37063002013",2879,221,982,125,351,159,249,225,5191
"37063002015",2447,244,1041,531,951,98,1119,86,6517
"37063002016",1596,1143,1605,531,790,302,1311,989,8267
"37063002017",5014,256,531,72,869,123,359,17,7241
"37063002018",5640,443,810,558,873,2,308,76,8710
"37063002019",3311,575,237,10,357,129,353,0,4972
"37063002020",3950,243,1386,5,1033,13,241,2,6873
"37063002021",2517,356,1011,227,583,59,196,201,5150
"37063002022",2077,388,1257,232,549,59,469,0,5031
"37063002023",2020,22,496,33,109,18,236,0,2934
"37063002024",3919,125,1139,125,729,0,351,0,6388
"37063002025",2622,306,2566,125,519,97,713,276,7224
"37063002026",1489,44,3093,1115,161,9,556,0,6467
"37063002027",2886,306,2466,920,1390,158,863,199,9188
"37063002028",3074,189,2219,254,1215,44,391,15,7401
"37063002100",4803,246,705,12,97,57,81,79,6080
"37063002200",972,223,156,203,251,62,147,7,2021
"37063002300",40,209,298,237,45,122,50,201,1202
"37063980100",75,0,0,0,0,0,0,0,75
"37065020200",631,334,2822,1982,33,90,0,27,5919
"37065020300",454,257,3109,1562,74,140,0,59,5655
"37065020400",189,26,2681,1424,0,11,14,0,4345
"37065020600",699,184,1160,485,78,72,93,112,2883
"37065020700",429,45,765,476,176,44,112,0,2047
"37065020800",1141,238,1730,373,3,5,11,0,3501
"37065020900",136,9,2002,855,18,0,11,0,3031
"37065021000",1054,42,1357,648,142,6,0,0,3249
"37065021100",1519,297,1242,189,462,179,575,357,4820
"37065021200",2603,149,1449,428,144,0,83,0,4856
"37065021300",2823,193,1014,514,270,257,168,284,5523
"37065021400",2732,794,453,276,4,0,113,0,4372
"37065021500",1691,345,851,507,0,0,0,124,3518
"37065021600",1942,130,414,170,132,3,35,0,2826
"37067000100",712,163,156,134,39,59,4,5,1272
"37067000200",376,242,81,448,5,0,8,71,1231
"37067000301",73,54,1088,762,9,4,53,27,2070
"37067000302",32,156,683,550,5,50,32,189,1697
"37067000400",131,285,1917,1015,207,228,220,538,4541
"37067000500",28,277,870,1315,59,34,78,229,2890
"37067000600",13,116,938,1016,8,115,0,222,2428
"37067000700",6,15,636,1055,0,0,0,0,1712
"37067000801",8,183,113,395,51,82,21,220,1073
"37067000802",228,379,418,615,31,59,146,476,2352
"37067000900",1077,622,464,391,80,180,86,407,3307
"37067001000",2589,1373,428,195,148,261,676,1000,6670
"37067001100",1035,277,170,264,62,7,24,68,1907
"37067001200",1725,46,111,5,66,0,47,5,2005
"37067001300",922,530,121,100,89,0,27,26,1815
"37067001400",533,432,1626,579,221,316,447,583,4737
"37067001500",793,672,1333,711,355,283,643,586,5376
"37067001601",12,68,3106,807,128,36,101,58,4316
"37067001602",165,197,1214,1544,131,19,191,135,3596
"37067001700",821,198,2585,1062,91,251,260,432,5700
"37067001800",282,474,1667,1280,289,154,332,401,4879
"37067001901",283,529,370,175,28,136,146,427,2094
"37067001902",889,213,244,105,0,36,94,87,1668
"37067002001",693,136,790,304,185,257,381,227,2973
"37067002002",1192,456,677,229,185,129,393,499,3760
"37067002100",1461,186,154,33,61,0,103,0,1998
"37067002200",3104,342,337,56,157,43,527,46,4612
"37067002501",2398,107,18,0,62,0,60,0,2645
"37067002502",2705,9,51,0,54,0,20,0,2839
"37067002601",2312,250,66,30,14,38,15,7,2732
"37067002603",4198,549,986,213,479,85,570,68,7148
"37067002604",4738,86,438,100,121,132,457,132,6204
"37067002701",2273,1522,1161,703,260,338,1212,1363,8832
"37067002702",1787,456,2416,993,540,26,1265,216,7699
"37067002703",1965,1134,1592,861,591,132,940,280,7495
"37067002801",3350,257,401,0,35,33,24,0,4100
"37067002804",2570,266,666,293,255,0,829,151,5030
"37067002806",1215,221,838,35,110,45,445,75,2984
"37067002807",3232,466,1024,314,199,22,592,302,6151
"37067002808",2846,108,244,65,168,9,12,0,3452
"37067002809",1592,113,287,65,24,0,37,0,2118
"37067002901",2463,495,1352,112,68,28,202,148,4868
"37067002903",1924,650,1176,142,41,34,170,281,4418
"37067002904",1714,208,23,10,49,21,45,47,2117
"37067003002",1543,437,1600,548,72,61,44,110,4415
"37067003003",2051,222,579,19,26,0,208,0,3105
"37067003004",3045,238,566,23,82,0,65,0,4019
"37067003103",4716,204,394,16,87,0,161,0,5578
"37067003105",2601,286,544,182,66,104,68,118,3969
"37067003106",2779,66,98,2,93,12,209,12,3271
"37067003107",3091,290,370,183,172,90,228,30,4454
"37067003108",2615,439,132,145,205,68,524,452,4580
"37067003201",3573,161,310,238,318,72,234,72,4978
"37067003202",2258,735,147,59,217,185,242,477,4320
"37067003307",2698,364,259,41,199,46,156,9,3772
"37067003308",6034,42,983,58,407,131,378,131,8164
"37067003309",2027,253,1317,799,480,86,951,77,5990
"37067003310",2372,485,1292,168,140,90,229,190,4966
"37067003311",1419,50,351,22,57,0,129,9,2037
"37067003312",2118,161,140,2,227,12,0,1,2661
"37067003313",1224,192,15,15,0,0,0,79,1525
"37067003314",2326,288,90,123,121,22,158,0,3128
"37067003315",2596,308,432,63,275,8,310,0,3992
"37067003402",1812,340,44,0,18,128,113,152,2607
"37067003403",985,1090,642,395,269,137,503,1048,5069
"37067003404",904,668,1239,630,281,358,489,835,5404
"37067003500",2544,327,1552,579,381,243,1196,296,7118
"37067003600",3578,1126,1115,266,396,202,580,902,8165
"37067003701",2367,1467,1198,342,280,160,935,1066,7815
"37067003702",2216,182,1342,184,366,82,366,34,4772
"37067003703",3741,261,1805,260,534,17,845,19,7482
"37067003803",3100,255,1167,214,135,0,197,52,5120
"37067003804",2295,636,1125,219,376,91,114,383,5239
"37067003805",2358,1164,1580,767,347,0,302,719,7237
"37067003806",2134,140,337,176,175,0,254,0,3216
"37067003903",1836,441,836,206,462,426,354,353,4914
"37067003904",3763,627,753,220,774,0,238,312,6687
"37067003905",2351,320,288,48,291,93,139,112,3642
"37067003906",2982,139,45,9,295,0,59,0,3529
"37067003908",2843,45,32,0,63,0,8,0,2991
"37067003909",3783,65,90,0,296,0,206,0,4440
"37067004005",4363,151,94,2,123,25,93,0,4851
"37067004007",6428,277,298,43,391,0,199,0,7636
"37067004009",3420,181,71,0,138,16,123,58,4007
"37067004010",2715,85,359,36,179,0,59,0,3433
"37067004011",4428,221,554,0,137,0,114,53,5507
"37067004012",3556,277,711,72,518,72,208,72,5486
"37067004013",2238,276,58,0,598,107,538,248,4063
"37067004014",2478,259,61,0,73,0,0,0,2871
"37067004015",3122,199,640,8,172,31,109,31,4312
"37067004102",2534,466,191,35,92,34,19,0,3371
"37067004103",2947,228,362,27,247,58,97,0,3966
"37067004104",3249,299,281,0,194,0,65,0,4088
"37069060100",2133,348,1322,509,46,72,14,50,4494
"37069060200",1715,424,759,257,197,192,211,247,4002
"37069060301",2083,208,1438,781,12,15,320,0,4857
"37069060302",556,318,838,234,3,101,3,63,2116
"37069060401",1515,243,553,103,202,78,315,78,3087
"37069060402",1869,369,1552,555,116,34,198,13,4706
"37069060501",4353,328,1211,77,300,3,619,0,6891
"37069060502",6522,407,699,63,460,142,323,52,8668
"37069060600",6021,719,717,221,601,346,424,98,9147
"37069060700",3535,544,1167,117,294,83,67,323,6130
"37069060801",2424,355,677,397,160,65,548,342,4968
"37069060802",3684,464,700,77,334,0,483,17,5759
"37071030101",2540,398,281,22,143,62,45,0,3491
"37071030102",2344,448,634,72,138,30,0,61,3727
"37071030203",2020,226,46,12,15,29,0,0,2348
"37071030204",2079,135,466,0,35,51,140,51,2957
"37071030205",3014,486,9,14,11,0,0,0,3534
"37071030301",2075,467,38,14,45,44,23,58,2764
"37071030302",2355,711,16,3,72,8,19,0,3184
"37071030401",3503,686,15,18,85,33,58,0,4398
"37071030402",2759,415,342,0,91,0,116,19,3742
"37071030501",1966,264,19,0,159,0,111,0,2519
"37071030502",2739,451,204,202,63,10,73,0,3742
"37071030601",2092,546,124,18,196,0,121,183,3280
"37071030602",1445,222,168,5,66,7,66,0,1979
"37071030700",1852,215,563,12,208,0,27,0,2877
"37071030801",927,150,37,0,0,16,0,7,1137
"37071030802",2801,1054,319,131,38,233,38,191,4805
"37071030901",1519,433,128,46,133,54,110,0,2423
"37071030902",1598,652,910,150,179,29,254,32,3804
"37071031001",2111,490,7,0,181,65,35,40,2929
"37071031003",3416,219,51,0,85,22,11,0,3804
"37071031004",1881,254,51,0,166,0,14,0,2366
"37071031101",1447,253,638,154,38,0,0,0,2530
"37071031102",1195,277,211,86,46,42,67,0,1924
"37071031201",1762,222,268,0,738,126,404,113,3633
"37071031202",1204,219,95,336,49,4,74,0,1981
"37071031301",2345,302,540,90,251,41,301,16,3886
"37071031302",2906,711,409,13,518,322,539,441,5859
"37071031401",974,427,375,253,290,149,252,159,2879
"37071031402",1984,189,139,1,199,0,55,0,2567
"37071031500",1115,891,717,413,11,326,112,539,4124
"37071031600",2151,507,549,322,69,7,35,0,3640
"37071031701",2670,412,46,21,71,89,168,46,3523
"37071031703",2104,421,389,50,9,0,55,32,3060
"37071031704",2400,835,193,50,84,190,15,8,3775
"37071031800",998,401,1276,585,311,188,421,292,4472
"37071031900",319,85,910,876,60,232,67,0,2549
"37071032000",549,231,774,475,134,12,65,8,2248
"37071032100",1141,261,619,142,94,149,125,108,2639
"37071032200",2854,410,228,6,195,206,107,2,4008
"37071032301",1758,305,263,69,65,0,108,0,2568
"37071032302",1845,656,81,4,106,9,24,60,2785
"37071032401",3372,474,213,16,64,0,138,0,4277
"37071032402",3898,144,73,15,443,0,110,0,4683
"37071032502",2950,175,74,0,220,0,63,0,3482
"37071032505",1860,89,948,200,310,0,129,6,3542
"37071032506",1220,42,986,154,499,143,416,131,3591
"37071032507",2487,195,352,37,788,60,417,114,4450
"37071032508",2262,107,85,2,53,0,86,0,2595
"37071032600",3167,258,370,0,182,38,275,0,4290
"37071032702",1182,161,182,0,336,18,99,1,1979
"37071032703",1159,174,189,127,195,2,87,0,1933
"37071032704",2714,301,696,259,147,208,60,221,4606
"37071032800",2914,660,984,641,200,173,229,27,5828
"37071032900",1634,897,668,807,23,47,17,123,4216
"37071033100",1065,147,803,163,249,280,239,195,3141
"37071033202",1528,219,76,20,235,241,284,0,2603
"37071033203",861,136,695,284,216,295,519,256,3262
"37071033204",1271,350,689,616,500,323,454,312,4515
"37071033303",2954,122,66,0,27,8,87,0,3264
"37071033304",3438,427,367,23,243,0,284,16,4798
"37071033305",3280,397,248,28,253,0,58,34,4298
"37071033306",1352,207,13,14,54,28,32,0,1700
"37071033307",1633,281,104,10,30,15,32,0,2105
"37071033400",1495,469,153,160,10,86,0,55,2428
"37071033500",4010,653,225,24,508,45,290,36,5791
"37073970100",2826,395,930,347,41,10,88,10,4647
"37073970200",2282,319,1086,286,85,4,107,0,4169
"37073970300",1622,124,888,407,148,0,0,0,3189
"37075920100",2005,356,4,0,92,17,0,21,2495
"37075920200",2202,708,0,0,234,0,0,0,3144
"37075920300",1858,576,15,3,369,187,94,105,3207
"37077970101",2061,425,1762,479,3,189,3,151,5073
"37077970102",2083,150,1215,242,126,74,150,23,4063
"37077970200",2254,551,1136,364,283,3,340,319,5250
"37077970300",2412,288,750,320,123,43,46,80,4062
"37077970400",1224,40,1538,985,0,114,85,13,3999
"37077970500",1652,197,1564,399,20,403,86,487,4808
"37077970601",4079,604,580,26,292,79,198,79,5937
"37077970602",5538,596,885,157,659,34,482,23,8374
"37077970603",4025,119,1202,376,191,11,152,0,6076
"37077970701",3464,272,893,31,341,21,284,25,5331
"37077970702",526,404,612,223,283,83,325,147,2603
"37077970703",1423,237,440,114,409,0,385,73,3081
"37077970704",0,0,0,0,0,0,0,0,0
"37079950101",1865,412,781,186,397,522,444,698,5305
"37079950102",1300,107,582,699,162,230,165,197,3442
"37079950200",2722,488,1093,161,198,361,410,450,5883
"37079950300",3230,524,1974,989,161,129,171,407,7585
"37081010100",212,97,816,285,277,7,72,7,1773
"37081010200",1623,328,1079,638,437,207,343,126,4781
"37081010300",426,206,790,172,589,316,300,79,2878
"37081010401",1339,104,9,4,103,80,13,0,1652
"37081010403",1214,74,155,86,87,1,50,1,1668
"37081010404",2287,67,156,0,56,121,58,0,2745
"37081010500",1811,231,68,48,76,0,21,0,2255
"37081010601",1804,446,146,222,235,8,103,111,3075
"37081010602",1871,1537,293,127,71,142,52,116,4209
"37081010701",1119,314,40,18,93,29,8,0,1621
"37081010702",612,406,11,67,76,37,33,37,1279
"37081010800",1193,149,189,227,64,22,52,13,1909
"37081010900",708,123,277,737,210,64,11,27,2157
"37081011000",0,0,672,422,64,7,48,0,1213
"37081011101",251,121,2594,1279,77,119,37,153,4631
"37081011102",8,10,2248,640,42,0,12,0,2960
"37081011200",350,305,1850,1624,187,137,48,14,4515
"37081011300",15,260,1665,907,162,4,30,231,3274
"37081011400",82,179,1307,2999,111,88,17,131,4914
"37081011500",676,494,654,379,122,7,170,149,2651
"37081011601",788,129,765,253,325,105,162,22,2549
"37081011602",1034,334,897,398,97,400,603,455,4218
"37081011904",978,267,2233,714,292,162,210,94,4950
"37081011905",1032,249,1738,929,285,264,276,311,5084
"37081012503",3085,401,368,133,481,123,248,0,4839
"37081012504",1281,301,1121,499,218,93,371,151,4035
"37081012505",4148,69,113,15,260,0,80,0,4685
"37081012508",2771,192,99,48,208,0,74,0,3392
"37081012509",1910,57,101,0,122,16,0,16,2222
"37081012510",2829,107,115,19,153,11,50,0,3284
"37081012511",4513,109,162,11,91,0,20,0,4906
"37081012601",2749,509,1287,756,268,35,1279,216,7099
"37081012604",1355,252,2326,461,484,293,661,220,6052
"37081012607",1192,44,801,44,104,6,381,0,2572
"37081012608",685,352,925,309,489,142,772,347,4021
"37081012609",2540,336,2390,1025,1209,88,619,307,8514
"37081012610",817,255,910,417,430,245,145,123,3342
"37081012611",774,695,1190,517,373,143,428,460,4580
"37081012612",1204,321,3236,1431,31,116,0,106,6445
"37081012617",553,208,1649,316,401,102,165,202,3596
"37081012703",2363,175,1340,419,443,84,166,0,4990
"37081012704",711,174,1246,447,520,467,162,365,4092
"37081012705",32,34,2230,1420,33,185,8,99,4041
"37081012706",113,186,1562,1204,97,58,21,106,3347
"37081012707",184,131,1119,693,13,262,142,359,2903
"37081012803",1924,821,3777,688,94,138,185,383,8010
"37081012804",293,202,2690,563,147,29,157,139,4220
"37081012805",270,147,1839,281,361,12,16,14,2940
"37081013601",278,31,422,370,25,71,81,10,1288
"37081013602",1553,276,970,623,208,465,200,280,4575
"37081013700",2962,304,190,159,171,68,187,22,4063
"37081013800",663,233,1932,1125,180,308,329,239,5009
"37081013900",270,93,1015,2176,42,574,212,208,4590
"37081014000",1105,856,363,519,284,226,354,430,4137
"37081014200",409,439,1430,876,200,253,186,243,4036
"37081014300",545,305,531,939,252,122,365,138,3197
"37081014406",210,167,1532,219,162,0,123,18,2431
"37081014407",4074,375,508,555,463,23,679,103,6780
"37081014408",679,277,827,326,242,79,335,181,2946
"37081014409",2184,143,173,279,131,70,181,0,3161
"37081014410",1956,396,915,376,144,148,82,251,4268
"37081014411",1024,113,2413,550,412,138,605,36,5291
"37081014412",1571,131,457,33,62,27,198,0,2479
"37081014501",587,328,147,91,74,131,153,225,1736
"37081014502",1426,753,1178,270,392,508,171,195,4893
"37081014503",460,517,1292,528,366,514,140,214,4031
"37081015100",2977,444,658,43,325,0,352,0,4799
"37081015200",5119,589,1914,194,714,92,636,56,9314
"37081015300",4446,348,2564,397,205,47,351,10,8368
"37081015401",3072,194,1934,0,129,98,96,128,5651
"37081015402",2974,958,1615,1343,797,864,628,1115,10294
"37081015500",1667,494,3709,690,386,90,245,0,7281
"37081015600",7777,368,960,7,302,438,322,425,10599
"37081015703",3949,347,1195,140,553,0,410,0,6594
"37081015704",3879,490,1176,216,740,42,220,12,6775
"37081015705",2047,263,590,99,137,0,45,0,3181
"37081015706",3531,151,1516,36,146,40,239,26,5685
"37081015707",5130,316,927,169,282,0,101,16,6941
"37081015800",7096,206,281,0,326,0,112,0,8021
"37081015901",4091,306,233,2,336,368,366,368,6070
"37081015902",3315,85,288,0,257,0,15,0,3960
"37081016003",3675,83,238,64,204,0,102,0,4366
"37081016005",1170,84,204,0,294,0,54,0,1806
"37081016006",2214,84,891,71,241,0,129,0,3630
"37081016007",3854,415,699,115,362,95,188,40,5768
"37081016008",5912,306,381,1,450,0,244,0,7294
"37081016009",2885,190,385,30,258,39,81,10,3878
"37081016010",1776,134,237,66,679,12,668,0,3572
"37081016011",2390,331,1897,278,1180,39,728,0,6843
"37081016101",3091,438,400,27,148,27,35,27,4193
"37081016102",1467,292,988,746,305,20,84,4,3906
"37081016103",2758,195,1188,430,549,10,501,0,5631
"37081016201",4864,162,125,0,473,0,287,9,5920
"37081016203",2905,155,464,0,409,43,110,18,4104
"37081016204",2398,47,308,8,470,15,69,0,3315
"37081016205",2302,34,581,82,689,158,163,26,4035
"37081016303",2930,55,390,172,125,0,278,0,3950
"37081016304",3048,38,300,3,361,56,84,56,3946
"37081016305",2463,95,383,36,343,9,13,0,3342
"37081016306",3038,151,959,335,472,34,187,0,5176
"37081016405",604,97,815,151,85,0,31,0,1783
"37081016406",1802,98,892,85,312,100,232,0,3521
"37081016407",2686,28,817,0,1078,260,73,0,4942
"37081016408",1503,15,147,31,134,0,24,0,1854
"37081016409",2021,76,238,163,18,0,97,0,2613
"37081016410",2573,162,1986,570,792,263,221,0,6567
"37081016502",4445,347,801,192,288,6,366,53,6498
"37081016503",1981,100,1387,187,380,60,212,16,4323
"37081016505",3377,62,1442,190,325,23,58,0,5477
"37081016506",3271,134,896,31,476,47,270,23,5148
"37081016600",1848,113,50,25,261,0,140,0,2437
"37081016701",1645,387,2515,247,439,113,76,323,5745
"37081016702",2941,367,0,2,74,2,256,34,3676
"37081016800",3699,887,1598,258,178,120,350,253,7343
"37081016900",3586,311,153,0,258,0,47,80,4435
"37081017000",3526,309,130,2,134,0,115,15,4231
"37081017100",5217,472,653,55,377,0,157,56,6987
"37081017200",3941,547,1643,36,406,103,366,16,7058
"37081980100",0,0,0,0,0,0,0,0,0
"37083930100",648,144,1238,1107,24,34,0,9,3204
"37083930200",4058,91,455,288,157,20,164,0,5233
"37083930300",2881,662,808,726,180,32,154,1,5444
"37083930400",1806,179,477,687,169,59,30,59,3466
"37083930501",1489,301,1023,988,8,68,99,56,4032
"37083930502",2122,182,1911,700,79,301,27,58,5380
"37083930600",1291,197,1454,873,254,16,83,0,4168
"37083930700",1814,178,1424,524,77,123,20,0,4160
"37083930800",343,127,2026,849,1606,700,112,82,5845
"37083930900",366,70,2860,1547,49,67,0,0,4959
"37083931000",465,26,1226,357,142,0,4,2,2222
"37083931100",1445,143,2306,927,67,197,118,197,5400
"37085070100",2376,325,757,609,318,71,427,37,4920
"37085070200",1346,395,725,612,149,201,227,123,3778
"37085070300",2891,529,914,624,203,125,294,248,5828
"37085070401",2688,481,344,133,391,33,550,134,4754
"37085070402",4521,807,243,441,581,346,669,504,8112
"37085070500",4125,687,632,313,121,55,200,203,6336
"37085070600",1903,190,1520,399,255,86,185,0,4538
"37085070700",2192,324,989,540,151,34,191,33,4454
"37085070801",1520,285,91,75,155,60,173,213,2572
"37085070802",2139,323,399,134,123,162,73,3,3356
"37085070901",1749,98,447,80,91,24,445,24,2958
"37085070902",2439,252,168,13,97,0,197,62,3228
"37085070903",1713,416,204,76,132,192,216,397,3346
"37085070904",1728,238,522,63,130,0,154,44,2879
"37085071001",4145,641,705,101,68,0,384,153,6197
"37085071002",2630,232,0,82,206,85,274,65,3574
"37085071101",2129,716,265,100,232,157,161,319,4079
"37085071102",2952,254,726,173,173,103,223,52,4656
"37085071201",1297,257,390,137,188,72,218,26,2585
"37085071202",2205,471,958,341,509,378,481,366,5709
"37085071203",842,327,425,217,222,19,156,86,2294
"37085071204",3496,574,696,84,545,78,538,139,6150
"37085071301",1806,476,622,76,272,243,255,45,3795
"37085071302",3762,116,940,7,484,99,411,99,5918
"37085071303",5771,434,1393,322,961,202,826,0,9909
"37085071401",1416,689,917,491,682,59,507,130,4891
"37085071402",4323,705,1853,670,1336,430,1254,323,10894
"37087920101",2831,875,0,0,34,0,41,79,3860
"37087920102",3134,637,0,0,49,27,31,51,3929
"37087920200",5297,740,1,1,194,0,310,0,6543
"37087920300",2484,470,145,0,165,58,52,9,3383
"37087920400",1832,186,0,1,5,0,115,0,2139
"37087920500",4614,994,9,5,298,94,314,120,6448
"37087920600",3571,806,0,0,88,0,121,48,4634
"37087920700",2674,692,47,1,85,17,54,1,3571
"37087920800",2689,352,0,0,72,7,79,13,3212
"37087920900",1377,346,9,34,23,5,119,6,1919
"37087921000",2486,448,126,7,74,82,50,40,3313
"37087921100",2128,399,36,46,24,19,56,0,2708
"37087921200",4058,722,34,0,185,18,132,1,5150
"37087921301",3515,453,0,0,104,0,104,0,4176
"37087921302",4538,607,6,61,99,0,44,74,5429
"37087980100",0,0,0,0,0,0,0,0,0
"37089930100",3756,657,101,24,117,41,533,65,5294
"37089930200",6313,780,11,0,649,99,1296,85,9233
"37089930300",4702,509,82,0,70,312,866,420,6961
"37089930401",1871,549,68,0,64,500,52,660,3764
"37089930402",1782,661,66,0,54,59,149,381,3152
"37089930501",3013,394,48,148,468,117,306,222,4716
"37089930502",4243,209,171,79,291,0,32,0,5025
"37089930600",4009,509,28,1,135,1,62,76,4821
"37089930701",3275,136,142,36,18,8,65,0,3680
"37089930702",3898,433,0,0,379,22,97,22,4851
"37089930703",4810,301,0,0,127,0,0,64,5302
"37089930800",4277,424,119,0,40,0,191,31,5082
"37089930900",3066,206,45,4,174,57,465,34,4051
"37089931000",3774,1263,14,150,231,130,539,560,6661
"37089931100",803,457,193,532,209,24,117,157,2492
"37089931200",1042,532,193,158,68,279,102,178,2552
"37089931300",2291,458,265,12,442,0,486,145,4099
"37089931400",2710,1213,69,10,224,24,869,371,5490
"37089931500",3174,368,93,0,103,46,43,0,3827
"37089931600",3763,710,4,5,0,19,269,220,4990
"37089931700",2760,315,42,4,49,0,13,0,3183
"37089931801",2814,288,53,56,76,0,0,0,3287
"37089931802",4013,277,125,9,61,7,311,0,4803
"37089931901",2895,452,36,22,30,0,30,27,3492
"37089931902",2616,177,45,0,42,0,27,16,2923
"37089932000",3680,625,54,0,26,4,9,7,4405
"37089980100",0,0,0,0,0,0,0,0,0
"37091950100",2124,195,2418,1702,116,28,65,24,6672
"37091950200",1075,276,1931,924,174,72,15,13,4480
"37091950300",1411,215,1377,159,243,4,12,11,3432
"37091950401",1381,82,675,783,206,24,18,2,3171
"37091950402",977,172,1696,988,145,65,18,19,4080
"37093970101",3175,604,2744,591,1184,162,1040,274,9774
"37093970102",5047,910,2709,561,1267,605,730,835,12664
"37093970103",4595,639,2029,214,708,371,812,344,9712
"37093970201",2293,381,819,333,530,113,364,78,4911
"37093970202",1252,218,1225,411,370,400,272,128,4276
"37093970300",1534,237,1432,1183,312,199,352,240,5489
"37093970401",1263,446,647,116,961,482,206,63,4184
"37093970402",387,250,556,512,839,886,127,333,3890
"37093980100",0,0,0,0,0,0,0,0,0
"37095920100",3135,320,840,752,22,0,245,45,5359
"37095990100",0,0,0,0,0,0,0,0,0
"37095990200",0,0,0,0,0,0,0,0,0
"37097060100",2943,1013,636,402,0,136,421,332,5883
"37097060200",338,45,819,682,14,515,153,507,3073
"37097060300",735,336,687,276,340,95,496,155,3120
"37097060400",1355,484,839,1145,256,93,230,249,4651
"37097060500",1880,420,716,525,179,210,426,264,4620
"37097060601",2285,324,1374,877,298,15,236,183,5592
"37097060602",1852,28,48,23,51,7,98,1,2108
"37097060603",1029,296,181,54,164,12,64,160,1960
"37097060701",2009,183,370,19,229,89,371,67,3337
"37097060702",2957,476,502,18,104,94,219,38,4408
"37097060703",2326,284,115,18,32,31,0,31,2837
"37097060801",2484,789,184,58,196,46,302,260,4319
"37097060802",2665,565,240,24,20,25,208,66,3813
"37097060901",2803,231,0,55,200,0,206,0,3495
"37097060902",3109,501,123,0,26,16,20,16,3811
"37097061001",3588,180,115,21,185,0,219,0,4308
"37097061002",3402,417,197,45,266,130,227,173,4857
"37097061003",2431,155,786,158,319,130,150,130,4259
"37097061101",2012,215,238,35,243,0,120,0,2863
"37097061102",2621,302,390,0,223,0,244,0,3780
"37097061103",2186,280,121,109,165,0,75,9,2945
"37097061104",1471,265,139,0,13,37,67,37,2029
"37097061201",2979,191,220,7,92,0,146,12,3647
"37097061202",3644,214,401,34,147,84,91,46,4661
"37097061203",2882,603,319,13,425,0,233,0,4475
"37097061204",2722,140,0,0,135,0,161,16,3174
"37097061205",3088,685,0,0,83,0,0,0,3856
"37097061301",1353,715,224,38,250,29,233,32,2874
"37097061302",2862,281,421,368,75,0,49,12,4068
"37097061303",4124,201,155,0,70,16,264,0,4830
"37097061304",3589,318,537,47,414,103,282,0,5290
"37097061401",3684,276,0,0,125,3,126,8,4222
"37097061402",4097,214,10,0,409,0,122,65,4917
"37097061403",2667,261,190,60,101,0,168,13,3460
"37097061404",1606,41,0,8,170,10,29,0,1864
"37097061405",3487,301,37,0,74,0,202,86,4187
"37097061406",4160,194,65,0,53,0,196,8,4676
"37097061407",3445,101,0,0,55,0,34,0,3635
"37097061408",3188,149,302,60,17,0,67,0,3783
"37097061501",2781,48,338,51,105,25,109,15,3472
"37097061502",3193,190,14,0,405,0,89,9,3900
"37097061503",3413,235,369,25,108,0,142,0,4292
"37097061601",1448,245,856,405,380,0,756,38,4128
"37097061602",4681,569,737,16,1083,0,383,0,7469
"37099940200",2190,544,64,10,2579,1149,201,154,6891
"37099950200",1346,219,0,0,93,6,0,0,1664
"37099950300",4138,621,55,59,171,110,150,6,5310
"37099950400",3158,691,78,22,131,84,46,40,4250
"37099950500",4504,650,0,356,177,0,22,333,6042
"37099950600",3729,1865,41,114,35,287,8,505,6584
"37099950700",1895,694,26,0,120,44,26,205,3010
"37099950800",1583,302,0,0,64,74,99,94,2216
"37099950900",2402,318,18,0,61,19,43,0,2861
"37101040100",4179,1176,554,248,82,1,346,204,6790
"37101040201",3644,946,905,602,0,13,473,757,7340
"37101040202",4681,1011,512,144,298,42,601,490,7779
"37101040203",12203,464,795,0,876,38,1490,58,15924
"37101040301",1417,481,337,375,312,593,606,807,4928
"37101040302",2213,1209,1420,113,450,413,888,1376,8082
"37101040400",3027,530,239,216,170,128,418,304,5032
"37101040500",4906,1154,285,264,46,42,200,175,7072
"37101040600",1556,393,618,308,363,84,342,179,3843
"37101040700",1600,316,613,196,342,60,167,51,3345
"37101040800",2220,416,297,499,53,167,70,385,4107
"37101040901",7265,685,1095,723,501,180,1452,72,11973
"37101040902",4650,944,965,834,443,0,460,724,9020
"37101041001",4917,448,2223,278,438,155,834,303,9596
"37101041002",6133,384,1202,143,308,125,556,72,8923
"37101041101",5449,393,982,353,337,115,295,96,8020
"37101041102",7803,585,1427,111,592,26,749,91,11384
"37101041103",10555,523,1597,118,95,0,718,0,13606
"37101041201",2690,639,337,145,104,140,283,361,4699
"37101041202",3352,1356,110,298,5,267,613,1052,7053
"37101041300",3645,651,292,536,371,110,371,165,6141
"37101041400",4105,621,584,389,203,780,174,997,7853
"37101041501",4876,418,423,0,209,330,134,180,6570
"37101041502",6237,419,697,50,202,159,852,129,8745
"37101041503",5935,1148,183,5,234,164,367,382,8418
"37103920100",1957,187,1090,463,176,21,39,0,3933
"37103920200",1395,370,609,279,174,12,157,167,3163
"37103920300",2178,372,529,166,100,25,35,16,3421
"37105030101",2429,578,385,127,282,66,418,248,4533
"37105030102",4468,68,268,34,635,18,396,0,5887
"37105030200",956,1056,604,290,686,408,1028,925,5953
"37105030300",531,89,1099,836,50,88,346,52,3091
"37105030401",1432,531,977,441,200,576,773,727,5657
"37105030402",2966,544,1416,467,709,267,1374,475,8218
"37105030501",2741,469,129,7,344,22,473,146,4331
"37105030502",1477,332,339,44,251,62,534,220,3259
"37105030503",4691,683,929,81,469,540,846,521,8760
"37105030601",2938,32,164,114,71,0,41,0,3360
"37105030602",3886,299,624,203,345,132,448,147,6084
"37105030701",2836,447,897,106,466,96,363,181,5392
"37105030702",2866,404,178,131,302,153,350,165,4549
"37107010100",2056,288,1247,655,158,275,124,397,5200
"37107010200",97,0,1554,1033,9,20,0,0,2713
"37107010300",15,0,572,1083,49,37,0,0,1756
"37107010400",0,0,336,337,0,0,0,18,691
"37107010500",250,303,1963,1555,6,91,45,263,4476
"37107010600",1373,195,1384,246,50,0,8,35,3291
"37107010700",618,225,647,835,139,70,159,12,2705
"37107010800",2107,281,1739,380,189,8,97,0,4801
"37107010900",1491,224,935,428,327,151,155,254,3965
"37107011001",2654,235,601,228,111,80,110,32,4051
"37107011002",2649,283,333,210,264,89,204,43,4075
"37107011100",2584,427,1687,544,99,0,22,0,5363
"37107011200",4938,669,958,528,212,359,271,1045,8980
"37107011300",3077,297,1142,163,93,50,448,50,5320
"37107011400",3276,795,318,18,36,63,78,247,4831
"37109070100",2612,1101,434,241,120,97,334,207,5146
"37109070201",2363,694,340,415,298,69,432,579,5190
"37109070202",2825,237,233,3,224,0,149,0,3671
"37109070300",3033,295,139,0,103,107,253,154,4084
"37109070400",4475,1443,116,40,159,0,388,58,6679
"37109070500",4196,734,29,0,42,14,138,0,5153
"37109070600",3449,1004,25,52,67,223,45,252,5117
"37109070700",2722,266,0,1,111,0,123,0,3223
"37109070800",4145,732,614,201,125,482,768,179,7246
"37109070901",2582,707,0,0,80,23,47,27,3466
"37109070902",5121,413,199,0,676,0,440,28,6877
"37109071001",3510,603,358,74,81,0,83,0,4709
"37109071002",1638,658,118,168,83,0,25,82,2772
"37109071101",5020,467,52,17,21,7,434,0,6018
"37109071102",4545,256,23,36,164,0,6,0,5030
"37109071201",1642,66,23,0,19,0,8,0,1758
"37109071202",2899,198,18,0,112,0,37,74,3338
"37109071203",3879,57,20,1,84,9,81,15,4146
"37111970100",4267,553,0,7,350,0,280,113,5570
"37111970200",3684,922,134,3,186,97,209,133,5368
"37111970300",2120,504,121,141,166,137,196,193,3578
"37111970400",1850,871,61,6,96,339,96,339,3658
"37111970500",3088,645,298,70,53,131,73,0,4358
"37111970600",2792,354,89,20,178,249,211,242,4135
"37111970700",3783,644,103,30,160,162,104,179,5165
"37111970800",2740,742,0,40,103,32,0,0,3657
"37111970901",4961,1184,31,142,62,10,33,0,6423
"37111970902",3664,791,43,2,0,64,0,0,4564
"37113970100",2322,426,0,0,85,26,123,30,3012
"37113970200",3071,643,0,11,3,14,8,8,3758
"37113970301",2407,1176,0,0,65,292,227,606,4773
"37113970302",2651,908,3,0,117,122,67,42,3910
"37113970400",2771,745,0,0,168,373,17,368,4442
"37113970501",1119,52,17,0,12,0,0,0,1200
"37113970502",1978,225,1,3,73,12,0,3,2295
"37113970600",4269,948,0,0,409,0,258,0,5884
"37113970700",4650,906,71,0,245,54,448,6,6380
"37115010100",2258,593,0,2,2,2,84,19,2960
"37115010200",1705,481,10,0,9,58,9,84,2356
"37115010400",1311,182,0,0,46,51,0,0,1590
"37115010500",3665,897,10,9,153,43,126,0,4903
"37115010600",4506,730,13,17,61,0,21,33,5381
"37115010700",2520,557,5,0,0,7,108,0,3197
"37117970100",2290,560,1244,253,159,273,138,246,5163
"37117970200",1674,254,1059,1006,71,0,24,0,4088
"37117970300",1649,183,1682,451,28,26,10,118,4147
"37117970400",1067,196,1053,396,52,3,31,3,2801
"37117970500",3177,745,903,185,22,15,92,15,5154
"37117970600",764,227,1507,559,45,26,88,47,3263
"37119000100",2786,300,207,21,305,25,194,0,3838
"37119000300",295,42,40,93,33,0,3,0,506
"37119000400",1574,155,210,125,185,0,86,9,2344
"37119000500",2113,412,797,507,254,0,118,25,4226
"37119000600",1264,139,645,296,69,0,68,20,2501
"37119000700",389,7,217,143,2,14,27,11,810
"37119000800",136,78,1239,778,145,14,109,17,2516
"37119000900",337,47,788,487,20,0,40,0,1719
"37119001000",1957,116,177,30,112,0,90,0,2482
"37119001100",1543,174,132,4,72,4,25,0,1954
"37119001200",3099,451,700,414,268,549,860,703,7044
"37119001300",1148,380,740,886,290,303,272,13,4032
"37119001400",1622,170,440,459,48,78,137,80,3034
"37119001504",1019,168,3021,1755,1053,294,1286,309,8905
"37119001505",1055,161,1120,58,494,357,484,347,4076
"37119001507",616,174,1194,700,704,396,944,763,5491
"37119001508",2057,174,2411,407,591,97,787,204,6728
"37119001509",93,33,1844,318,485,520,480,291,4064
"37119001510",226,320,1880,221,294,20,126,125,3212
"37119001603",1891,545,913,277,513,290,834,668,5931
"37119001605",535,502,447,91,350,454,411,577,3367
"37119001606",1756,227,900,308,698,502,1153,345,5889
"37119001607",696,250,663,901,481,256,479,261,3987
"37119001608",721,219,1056,412,853,442,859,422,4984
"37119001609",684,139,1163,201,557,220,467,306,3737
"37119001701",1325,192,866,450,663,286,546,45,4373
"37119001702",1645,942,874,637,1068,461,790,994,7411
"37119001801",861,31,192,156,105,21,110,0,1476
"37119001802",1224,244,597,126,288,193,23,73,2768
"37119001910",1524,624,1583,597,776,304,1348,921,7677
"37119001911",1988,348,2115,534,523,368,494,481,6851
"37119001912",956,1243,2199,740,610,492,726,1498,8464
"37119001914",1247,263,732,332,750,453,965,394,5136
"37119001915",2118,499,1763,965,370,471,911,541,7638
"37119001916",1219,85,1286,258,517,91,512,38,4006
"37119001917",1731,576,555,168,783,467,923,751,5954
"37119001918",1074,431,1564,572,113,51,218,403,4426
"37119001919",1062,409,1078,810,496,591,472,436,5354
"37119001920",922,227,1059,1143,856,152,892,288,5539
"37119001921",836,94,592,397,244,74,361,109,2707
"37119001922",896,667,1757,438,1012,165,649,804,6388
"37119001923",966,172,1275,758,461,619,629,600,5480
"37119002002",4899,467,518,150,443,15,78,57,6627
"37119002003",4322,203,337,229,373,131,425,89,6109
"37119002004",3611,460,592,18,183,5,536,212,5617
"37119002100",1261,258,651,169,35,0,107,98,2579
"37119002200",4076,162,149,26,270,1,30,1,4715
"37119002300",299,185,906,1451,44,37,262,100,3284
"37119002400",2190,250,174,107,158,0,11,13,2903
"37119002500",1267,145,104,28,84,11,71,0,1710
"37119002600",433,64,125,115,121,0,37,18,913
"37119002701",1983,82,7,0,15,0,98,0,2185
"37119002702",4819,199,106,0,59,0,35,20,5238
"37119002800",3573,120,11,43,141,6,125,0,4019
"37119002903",3096,51,101,10,124,0,27,0,3409
"37119002904",4841,309,455,273,543,193,124,280,7018
"37119002905",2650,246,89,6,112,1,85,0,3189
"37119002906",3504,283,81,52,489,26,0,7,4442
"37119003006",3586,122,153,0,244,39,35,0,4179
"37119003007",5588,197,648,214,334,0,109,0,7090
"37119003008",4490,102,209,17,974,9,370,14,6185
"37119003011",5102,209,255,12,90,98,269,0,6035
"37119003012",3615,180,196,9,314,0,643,73,5030
"37119003013",4686,139,356,0,261,0,251,32,5725
"37119003015",3798,146,179,28,253,0,282,7,4693
"37119003016",3374,178,589,15,324,9,197,8,4694
"37119003017",2631,158,195,189,99,29,90,9,3400
"37119003018",1839,168,150,3,356,8,217,8,2749
"37119003102",2557,822,299,84,565,164,344,780,5615
"37119003103",3631,323,281,31,323,61,330,92,5072
"37119003105",3288,30,86,21,162,0,165,0,3752
"37119003106",1978,346,312,120,269,153,659,453,4290
"37119003108",1225,409,570,439,155,150,478,389,3815
"37119003109",1250,504,1041,566,594,193,1171,596,5915
"37119003201",1241,645,64,93,522,0,615,562,3742
"37119003203",1215,501,554,238,251,71,253,258,3341
"37119003204",2456,217,174,74,121,177,0,0,3219
"37119003300",1646,339,777,60,117,201,71,206,3417
"37119003400",4345,154,12,8,185,24,29,13,4770
"37119003500",2319,69,33,7,112,0,65,0,2605
"37119003600",610,140,1580,1017,69,0,19,110,3545
"37119003700",542,28,618,1248,283,0,221,0,2940
"37119003802",262,325,1802,1139,14,44,111,382,4079
"37119003805",426,42,124,190,978,17,30,9,1816
"37119003806",3134,525,3168,938,1308,421,2058,456,12008
"37119003807",1046,491,1591,758,300,460,1024,807,6477
"37119003808",1766,1264,1302,499,739,405,1944,1590,9509
"37119003902",53,5,2874,1456,455,221,14,61,5139
"37119003903",91,96,342,890,35,158,72,142,1826
"37119004000",708,167,2298,731,227,0,82,0,4213
"37119004100",1173,204,1175,575,226,110,10,111,3584
"37119004200",297,31,1191,1677,65,91,0,39,3391
"37119004302",1014,323,1835,949,310,86,253,261,5031
"37119004303",707,91,802,533,255,23,194,165,2770
"37119004304",629,41,1773,387,610,140,16,174,3770
"37119004305",1231,134,2066,1047,781,44,992,142,6437
"37119004400",361,193,3262,376,584,65,429,49,5319
"37119004500",151,57,1155,1235,386,6,26,0,3016
"37119004600",46,49,2051,975,6,84,0,0,3211
"37119004700",50,39,514,542,6,0,0,14,1165
"37119004800",92,95,2102,907,177,4,171,90,3638
"37119004900",13,16,507,111,8,0,0,0,655
"37119005000",46,4,887,602,11,22,5,58,1635
"37119005100",23,53,1139,1056,200,22,3,12,2508
"37119005200",133,90,883,1523,0,22,80,81,2812
"37119005301",457,173,920,1057,611,498,689,425,4830
"37119005305",319,178,3068,885,696,0,741,54,5941
"37119005306",156,223,1108,397,298,94,360,287,2923
"37119005307",480,298,1549,550,253,80,762,346,4318
"37119005308",817,493,470,784,455,277,1151,708,5155
"37119005401",858,0,4386,1537,228,222,409,0,7640
"37119005403",980,150,1779,522,426,110,603,11,4581
"37119005404",1016,319,2457,1025,121,1,333,290,5562
"37119005508",2489,334,1066,114,274,0,167,6,4450
"37119005509",2743,139,1991,0,441,17,669,0,6000
"37119005510",1210,725,2995,489,301,47,634,741,7142
"37119005511",1322,86,2088,131,551,36,360,38,4612
"37119005512",1128,174,2587,558,246,33,312,99,5137
"37119005513",2011,44,1369,142,327,65,246,17,4221
"37119005514",3289,380,2567,156,518,0,289,211,7410
"37119005515",1606,102,357,64,283,27,212,27,2678
"37119005516",1229,21,194,8,302,1,48,1,1804
"37119005517",2893,148,1649,10,164,0,222,0,5086
"37119005518",2584,60,1595,75,734,5,464,0,5517
"37119005519",3022,190,1537,81,291,0,279,49,5449
"37119005520",1255,196,1762,122,1095,0,367,0,4797
"37119005521",1470,685,3376,121,646,328,268,56,6950
"37119005522",1137,342,2085,222,920,0,350,0,5056
"37119005523",1481,632,878,159,1185,510,96,83,5024
"37119005524",1519,134,3892,971,1734,43,866,20,9179
"37119005604",301,619,150,205,157,239,50,91,1812
"37119005605",1419,860,1828,511,369,378,259,85,5709
"37119005609",399,1130,801,449,277,678,131,175,4040
"37119005610",948,482,1258,573,637,177,302,84,4461
"37119005611",967,198,1058,161,291,43,298,60,3076
"37119005612",1143,180,2191,18,906,286,693,158,5575
"37119005613",414,50,877,347,216,0,317,0,2221
"37119005614",2153,106,3437,113,586,0,848,78,7321
"37119005615",558,8,517,51,37,24,184,24,1403
"37119005616",582,168,694,47,416,38,568,75,2588
"37119005617",408,0,845,142,561,128,239,134,2457
"37119005618",1520,81,1526,0,378,0,448,47,4000
"37119005619",1569,100,1481,516,460,19,577,5,4727
"37119005620",2239,276,2518,459,841,140,1300,168,7941
"37119005621",2247,108,1130,170,503,267,199,176,4800
"37119005706",4360,576,674,15,856,0,415,267,7163
"37119005709",3045,169,462,27,235,0,297,15,4250
"37119005710",1204,168,1451,360,684,137,599,71,4674
"37119005711",4966,542,609,117,131,0,108,50,6523
"37119005712",3249,77,352,10,190,123,380,0,4381
"37119005713",3302,110,96,0,232,0,202,0,3942
"37119005714",3892,383,609,0,239,0,219,0,5342
"37119005715",2265,104,66,0,115,47,50,17,2664
"37119005716",2151,51,1055,278,639,147,715,180,5216
"37119005717",2864,239,1843,275,568,167,487,75,6518
"37119005811",3276,155,322,59,197,0,183,49,4241
"37119005812",3727,559,1293,104,656,145,370,125,6979
"37119005815",2926,56,306,64,333,77,260,10,4032
"37119005816",3351,97,312,0,281,59,253,0,4353
"37119005817",3356,149,98,37,417,0,400,0,4457
"37119005823",6972,139,462,17,932,0,401,0,8923
"37119005824",1288,273,889,660,190,80,933,322,4635
"37119005825",2415,774,646,362,265,197,741,504,5904
"37119005826",1987,111,215,90,162,163,511,88,3327
"37119005827",954,247,1188,347,24,0,344,0,3104
"37119005828",3480,159,107,7,108,0,41,0,3902
"37119005829",1032,98,805,72,309,38,600,20,2974
"37119005830",2640,149,188,96,409,6,521,20,4029
"37119005831",3251,163,791,14,295,10,64,0,4588
"37119005832",2335,135,159,28,313,0,237,0,3207
"37119005833",4050,229,94,0,256,0,38,0,4667
"37119005834",2974,299,448,124,451,18,201,6,4521
"37119005835",2375,110,60,9,199,0,48,0,2801
"37119005836",3111,241,446,7,341,0,797,85,5028
"37119005837",4898,121,229,58,1110,68,637,13,7134
"37119005838",4797,238,680,49,1340,0,430,238,7772
"37119005839",2009,251,171,0,360,0,59,39,2889
"37119005840",2129,22,100,0,305,0,88,0,2644
"37119005841",4998,305,288,48,553,0,332,214,6738
"37119005842",4558,139,382,0,1209,0,176,64,6528
"37119005843",2447,54,79,33,559,0,154,0,3326
"37119005844",5680,161,321,0,1312,0,437,23,7934
"37119005845",2906,32,226,0,1120,20,200,0,4504
"37119005846",3346,73,80,0,340,16,6,5,3866
"37119005847",3383,75,209,0,508,232,247,51,4705
"37119005848",4670,11,379,0,473,0,88,5,5626
"37119005906",2103,636,349,349,154,239,358,371,4559
"37119005907",2683,48,1254,11,611,132,818,175,5732
"37119005908",1175,48,207,32,80,0,0,0,1542
"37119005909",2976,374,2177,572,1195,93,1638,442,9467
"37119005910",2344,123,1540,126,907,8,1075,0,6123
"37119005911",3229,414,1230,0,354,30,260,8,5525
"37119005912",1894,272,1819,94,617,112,844,258,5910
"37119005913",3224,163,1714,290,966,170,1455,164,8146
"37119005914",2541,295,1869,21,478,411,661,352,6628
"37119005915",780,74,585,92,267,132,241,0,2171
"37119005916",489,25,706,368,310,208,317,101,2524
"37119005917",3400,93,1606,254,575,0,782,137,6847
"37119005918",1903,160,855,21,413,241,517,200,4310
"37119006005",1294,47,1156,57,160,144,121,144,3123
"37119006006",1934,715,1615,718,935,228,676,84,6905
"37119006007",2961,133,2615,361,827,13,496,8,7414
"37119006008",1932,63,1124,132,376,0,321,0,3948
"37119006009",1207,17,802,421,98,9,94,0,2648
"37119006010",3082,148,2533,588,303,11,309,55,7029
"37119006103",2248,40,915,138,268,0,175,0,3784
"37119006104",3389,308,4073,789,527,51,172,0,9309
"37119006105",1383,68,1100,204,197,18,83,18,3071
"37119006106",1770,49,1327,6,250,7,225,0,3634
"37119006107",1635,229,1184,203,796,170,268,181,4666
"37119006108",974,103,2320,277,570,24,471,92,4831
"37119006109",269,88,1932,826,61,86,206,34,3502
"37119006203",4429,178,101,0,54,0,103,0,4865
"37119006204",6806,97,74,0,122,0,330,0,7429
"37119006208",2194,99,299,0,119,0,132,14,2857
"37119006209",2879,372,521,0,159,0,203,40,4174
"37119006210",3825,21,283,10,152,43,25,0,4359
"37119006211",5281,99,333,43,319,20,135,0,6230
"37119006212",2364,123,297,0,369,0,163,6,3322
"37119006213",5099,100,436,35,406,84,202,23,6385
"37119006214",3585,114,509,0,190,0,136,0,4534
"37119006215",2782,497,544,161,82,70,250,334,4720
"37119006302",4773,162,1002,93,514,0,576,3,7123
"37119006303",3850,500,162,87,201,0,57,0,4857
"37119006304",5162,373,213,0,403,12,422,108,6693
"37119006403",2989,334,681,76,198,8,370,53,4709
"37119006404",4440,115,112,0,235,0,332,36,5270
"37119006405",2298,319,139,1,315,22,83,22,3199
"37119006406",5348,595,376,84,351,19,558,360,7691
"37119006407",3103,67,191,45,102,220,57,0,3785
"37119980100",0,0,0,0,0,0,0,0,0
"37119980200",0,0,0,0,0,0,0,0,0
"37119980300",0,0,0,0,0,0,0,0,0
"37121950100",2030,332,0,0,19,18,29,0,2428
"37121950200",2893,649,0,7,24,13,23,24,3633
"37121950300",3215,1241,0,5,41,106,162,211,4981
"37121950400",3822,427,0,4,10,131,86,121,4601
"37123960100",4282,767,219,296,156,116,1091,385,7312
"37123960200",3983,1452,330,678,68,123,198,226,7058
"37123960300",3799,441,0,0,13,15,16,15,4299
"37123960401",859,105,719,361,114,14,0,0,2172
"37123960402",1093,163,297,363,319,292,116,19,2662
"37123960500",2725,1216,561,528,137,62,1128,839,7196
"37125950100",2258,886,21,60,53,0,105,216,3599
"37125950200",5111,1700,127,74,331,41,690,682,8756
"37125950301",4438,355,385,141,38,168,276,121,5922
"37125950302",4085,461,330,2,41,2,33,2,4956
"37125950401",2993,485,104,48,53,0,11,53,3747
"37125950402",3015,449,659,467,67,63,135,3,4858
"37125950501",3684,1111,283,279,282,225,95,351,6310
"37125950502",6120,812,147,315,484,132,244,621,8875
"37125950601",3362,58,155,0,17,0,28,0,3620
"37125950602",5549,155,784,484,242,100,375,82,7771
"37125950701",3891,129,182,292,0,0,60,0,4554
"37125950702",1914,111,103,11,62,23,36,0,2260
"37125950801",1970,255,1318,819,110,166,141,0,4779
"37125950802",2952,164,211,138,66,34,0,34,3599
"37125950900",1528,359,203,113,0,86,208,50,2547
"37125951000",4249,193,58,40,133,0,101,0,4774
"37125951100",5440,512,1483,112,198,588,194,41,8568
"37125951200",2583,893,771,296,404,202,286,274,5709
"37127010200",738,95,2358,1894,132,0,91,0,5308
"37127010300",2235,166,2737,891,335,51,226,0,6641
"37127010400",555,132,1442,776,237,24,18,63,3247
"37127010502",3253,319,2060,957,367,25,140,0,7121
"37127010503",1594,92,845,212,281,39,259,39,3361
"37127010504",3123,362,1563,767,178,23,81,88,6185
"37127010601",1327,13,749,130,330,76,72,0,2697
"37127010602",2156,333,1727,502,161,167,304,265,5615
"37127010700",937,56,1168,230,144,3,45,1,2584
"37127010800",5171,435,1175,237,23,25,42,13,7121
"37127010900",2594,368,1722,386,371,30,45,113,5629
"37127011000",2054,272,1435,529,186,18,301,6,4801
"37127011101",2398,315,2143,277,331,52,382,50,5948
"37127011102",4130,697,1159,524,132,58,5,39,6744
"37127011200",4602,491,908,207,202,1,18,1,6430
"37127011300",3550,215,262,218,656,256,903,318,6378
"37127011400",2316,141,944,383,584,323,796,325,5812
"37127011500",3581,833,758,658,380,228,615,274,7327
"37129010100",516,45,830,789,2,17,0,0,2199
"37129010200",1303,364,1040,804,168,9,172,33,3893
"37129010300",1746,429,1830,790,87,0,103,0,4985
"37129010400",2348,441,148,60,57,7,27,31,3119
"37129010501",1637,1083,829,566,154,80,383,662,5394
"37129010502",3487,2905,495,712,118,675,190,395,8977
"37129010600",3547,228,70,22,83,28,76,0,4054
"37129010700",1551,420,1068,663,150,96,122,96,4166
"37129010800",995,436,215,115,163,229,333,339,2825
"37129010900",1853,362,142,14,67,25,266,40,2769
"37129011000",789,404,492,793,8,88,44,83,2701
"37129011100",97,50,1167,1122,15,68,7,0,2526
"37129011200",870,276,582,289,27,0,54,6,2104
"37129011300",875,250,48,156,108,82,15,73,1607
"37129011400",284,112,771,470,11,39,22,0,1709
"37129011500",5125,1194,1190,310,302,67,234,787,9209
"37129011603",4828,424,1122,33,143,72,166,17,6805
"37129011605",3367,376,688,134,287,208,416,0,5476
"37129011606",3394,449,460,47,117,29,231,187,4914
"37129011607",8571,748,1073,0,405,60,537,37,11431
"37129011608",4610,343,611,20,175,0,47,0,5806
"37129011701",3727,862,89,0,162,0,121,55,5016
"37129011703",3518,331,20,0,82,0,0,230,4181
"37129011705",6985,682,118,0,219,18,181,16,8219
"37129011800",1970,485,0,1,23,0,10,15,2504
"37129011902",3766,1827,464,17,59,0,337,286,6756
"37129011903",2599,2157,102,227,36,110,274,10,5515
"37129011904",1542,55,90,0,45,0,13,0,1745
"37129012001",5487,346,385,21,56,161,331,195,6982
"37129012004",3257,192,39,0,206,0,0,37,3731
"37129012006",2999,413,404,12,108,0,142,0,4078
"37129012007",3466,396,36,39,156,23,156,0,4272
"37129012008",3619,592,473,103,272,171,173,0,5403
"37129012009",6047,260,545,14,211,0,123,0,7200
"37129012010",4449,247,128,35,222,0,52,6,5139
"37129012101",5682,1107,643,109,607,233,472,377,9230
"37129012103",3969,149,98,0,17,0,96,0,4329
"37129012104",4081,634,386,3,386,30,206,60,5786
"37129012105",8528,1642,301,673,690,335,233,378,12780
"37129012201",2558,342,0,0,42,0,40,8,2990
"37129012202",2358,272,32,68,165,0,58,0,2953
"37129012203",1958,158,10,0,237,25,11,0,2399
"37129012300",6195,301,556,0,61,0,116,1,7230
"37129980100",0,0,0,0,0,0,0,0,0
"37129990100",0,0,0,0,0,0,0,0,0
"37131920100",3058,258,1130,544,86,35,82,8,5201
"37131920200",1166,274,1612,1156,76,68,7,9,4368
"37131920300",989,26,2770,1482,4,288,14,0,5573
"37131920401",1140,184,1643,806,49,70,166,67,4125
"37131920402",1005,113,353,63,18,0,0,5,1557
"37133000102",6933,1108,113,161,391,72,529,97,9404
"37133000103",4431,544,464,204,445,14,356,5,6463
"37133000201",7137,684,832,378,523,551,866,525,11496
"37133000202",7409,979,784,412,449,0,690,10,10733
"37133000301",4390,687,442,326,354,134,260,35,6628
"37133000302",6001,894,785,490,385,174,660,188,9577
"37133000401",4947,704,81,28,64,51,159,20,6054
"37133000402",4972,1276,34,73,128,159,221,195,7058
"37133000403",1270,131,28,13,59,0,4,0,1505
"37133000500",0,0,0,0,0,0,0,0,0
"37133000600",0,0,0,0,0,0,0,0,0
"37133000700",4086,428,1274,34,1107,21,1219,74,8243
"37133000800",869,154,123,19,38,0,80,28,1311
"37133000900",3163,437,501,284,981,209,863,139,6577
"37133001000",515,155,76,32,79,48,181,10,1096
"37133001101",2989,619,437,43,304,88,295,72,4847
"37133001102",2725,261,604,198,113,0,436,19,4356
"37133001200",6517,959,2512,162,585,288,719,226,11968
"37133001300",7783,780,3449,333,989,465,1524,522,15845
"37133001400",3963,169,402,191,450,25,509,30,5739
"37133001500",1519,201,579,292,224,66,198,57,3136
"37133001700",1730,30,505,41,285,47,322,0,2960
"37133001800",1084,169,74,39,143,0,132,0,1641
"37133002100",3578,451,1191,575,776,18,809,111,7509
"37133002201",3386,394,918,64,758,51,673,17,6261
"37133002202",2143,380,1401,57,480,28,872,223,5584
"37133002300",2734,295,1113,30,539,21,535,70,5337
"37133002400",3414,801,1042,273,627,422,267,520,7366
"37133002500",2102,651,80,205,301,199,320,172,4030
"37133002600",1122,322,1171,885,240,79,265,43,4127
"37133002800",7251,790,330,108,649,86,959,134,10307
"37133990100",0,0,0,0,0,0,0,0,0
"37135010701",1486,136,317,13,57,0,9,76,2094
"37135010703",3427,634,559,203,1211,534,1468,485,8521
"37135010704",3221,496,620,71,842,366,623,335,6574
"37135010705",2756,630,538,95,386,12,302,284,5003
"37135010706",3041,45,0,2,355,29,100,6,3578
"37135010801",2977,574,872,126,221,57,178,21,5026
"37135010802",3665,430,409,18,265,15,69,189,5060
"37135010901",4297,746,398,17,0,262,233,681,6634
"37135010902",2977,602,356,0,432,148,506,298,5319
"37135011000",5197,402,521,160,372,15,212,48,6927
"37135011101",4546,348,1901,951,457,73,523,87,8886
"37135011102",4117,251,622,331,274,24,185,61,5865
"37135011202",5306,579,616,76,467,314,253,151,7762
"37135011203",4248,354,536,182,169,14,38,0,5541
"37135011204",2545,227,258,54,363,181,143,256,4027
"37135011205",4163,329,215,416,2378,74,678,80,8333
"37135011300",823,1364,265,338,171,54,10,35,3060
"37135011400",1729,1458,50,125,137,147,81,26,3753
"37135011500",1307,263,18,114,159,35,136,15,2047
"37135011601",0,132,0,0,0,0,0,0,132
"37135011602",268,239,7,28,336,186,19,76,1159
"37135011700",1366,1157,215,29,264,69,35,9,3144
"37135011800",1830,834,55,253,245,198,174,31,3620
"37135011901",3295,664,429,232,716,1,184,136,5657
"37135011902",2721,138,329,0,644,52,100,34,4018
"37135012100",4531,685,411,78,1189,162,377,31,7464
"37135012201",2198,96,73,0,220,106,27,79,2799
"37135012202",3654,418,186,13,930,94,303,67,5665
"37137950101",2121,466,223,19,105,80,4,0,3018
"37137950102",1615,248,897,322,84,8,39,0,3213
"37137950201",3140,103,372,122,139,23,336,0,4235
"37137950202",1766,242,250,11,46,0,17,0,2332
"37137990100",0,0,0,0,0,0,0,0,0
"37139960100",562,254,491,166,69,0,97,55,1694
"37139960200",1401,163,1231,674,24,0,0,0,3493
"37139960300",362,212,977,1214,94,102,248,102,3311
"37139960400",1648,353,1029,835,12,94,40,30,4041
"37139960501",2313,57,409,259,65,0,54,0,3157
"37139960502",3095,317,409,314,310,0,58,62,4565
"37139960503",1296,359,806,92,12,27,76,0,2668
"37139960600",3882,380,2108,46,230,77,193,0,6916
"37139960701",3212,445,1246,548,294,198,291,321,6555
"37139960702",2475,94,430,30,19,67,86,3,3204
"37141920101",386,31,0,0,9,2,6,2,436
"37141920102",1097,194,0,0,9,13,0,0,1313
"37141920103",3797,610,122,0,115,117,79,25,4865
"37141920201",4316,416,109,52,94,0,187,2,5176
"37141920202",5889,646,51,26,0,22,175,0,6809
"37141920203",3332,395,479,78,306,222,26,156,4994
"37141920204",675,481,430,344,0,14,0,12,1956
"37141920300",2557,486,517,329,99,7,148,41,4184
"37141920401",986,115,476,373,109,2,109,2,2172
"37141920402",1454,425,615,101,92,121,80,100,2988
"37141920403",2061,459,713,152,16,391,13,391,4196
"37141920501",2087,212,1447,545,298,125,611,162,5487
"37141920502",1218,118,423,175,78,9,41,0,2062
"37141920601",2144,71,290,142,320,110,587,110,3774
"37141920602",3347,887,549,328,206,195,56,205,5773
"37141990100",0,0,0,0,0,0,0,0,0
"37143920100",4444,431,1245,318,210,49,116,10,6823
"37143920201",1521,408,638,402,87,0,40,61,3157
"37143920202",2466,483,261,432,27,0,71,0,3740
"37145920100",3283,939,2089,540,168,23,18,1,7061
"37145920200",4310,536,1292,443,263,9,241,0,7094
"37145920300",2033,1016,889,1615,305,52,205,196,6311
"37145920400",1192,190,805,341,72,122,148,72,2942
"37145920500",5385,528,1148,60,240,20,239,20,7640
"37145920601",3203,658,436,391,58,24,283,178,5231
"37145920602",3321,90,520,144,87,0,30,0,4192
"37147000100",1058,1685,490,672,74,57,29,56,4121
"37147000201",2161,1798,985,415,54,152,66,122,5753
"37147000202",1278,269,471,183,223,321,155,230,3130
"37147000301",2224,101,277,20,56,25,6,17,2726
"37147000302",4845,1915,1422,563,431,164,301,101,9742
"37147000400",1331,285,12,61,59,67,38,6,1859
"37147000501",3151,278,1309,581,379,79,162,0,5939
"37147000502",3161,2009,1211,387,229,454,0,93,7544
"37147000601",1670,527,2523,1107,369,50,14,0,6260
"37147000602",1304,599,2134,1267,110,169,13,15,5611
"37147000603",5220,456,3473,117,1149,277,608,256,11556
"37147000701",414,235,1282,2284,49,47,62,57,4430
"37147000702",148,183,1138,1476,0,0,48,6,2999
"37147000800",655,228,1261,849,490,114,425,143,4165
"37147000900",3244,1411,1640,1301,380,459,304,235,8974
"37147001001",1311,202,173,413,112,129,111,128,2579
"37147001002",4566,228,1167,23,377,0,433,13,6807
"37147001003",4489,161,576,175,147,47,0,47,5642
"37147001100",4121,172,634,219,309,145,550,142,6292
"37147001200",3585,1091,526,147,862,63,832,247,7353
"37147001301",2231,74,1049,380,225,0,151,11,4121
"37147001302",2968,86,1598,602,323,75,239,0,5891
"37147001303",5935,157,1028,63,382,89,264,0,7918
"37147001401",2005,146,1271,992,14,7,107,40,4582
"37147001402",819,177,445,410,236,150,160,141,2538
"37147001500",2068,147,694,442,121,12,172,12,3668
"37147001600",3848,703,2522,492,458,37,288,27,8375
"37147001700",2128,200,913,68,122,105,31,100,3667
"37147001800",2757,347,1483,801,300,71,282,115,6156
"37147001900",1741,307,724,182,35,14,0,72,3075
"37147002001",1254,627,1839,1255,326,430,536,683,6950
"37147002002",2140,410,1773,871,65,12,20,44,5335
"37149920101",2563,399,95,64,198,117,340,117,3893
"37149920103",2174,266,47,0,13,64,0,64,2628
"37149920104",3169,291,20,4,103,0,221,84,3892
"37149920200",3665,596,80,319,74,35,140,0,4909
"37149920301",1202,72,0,9,33,1,33,1,1351
"37149920303",1601,113,0,0,139,18,122,18,2011
"37149920304",2019,162,177,153,0,0,0,0,2511
"37151030100",2411,771,291,201,330,407,575,501,5487
"37151030201",1984,641,368,18,150,0,367,139,3667
"37151030202",3474,1291,209,22,60,13,914,713,6696
"37151030301",4436,1049,206,258,492,228,1665,334,8668
"37151030302",784,266,457,599,231,176,177,168,2858
"37151030400",2555,602,103,283,375,160,1191,296,5565
"37151030502",3227,481,136,125,183,6,363,197,4718
"37151030503",4287,742,1,14,282,0,360,0,5686
"37151030504",4658,880,7,0,228,0,126,0,5899
"37151030600",5555,615,0,12,312,95,708,3,7300
"37151030700",4833,685,1,0,239,2,318,55,6133
"37151030801",5192,1215,203,37,9,25,684,248,7613
"37151030802",5107,917,203,209,286,46,590,65,7423
"37151030900",2637,606,182,158,185,100,79,57,4004
"37151031000",4705,1010,775,137,190,277,275,398,7767
"37151031100",5035,852,247,27,141,37,625,119,7083
"37151031200",3185,805,379,121,62,224,247,151,5174
"37151031303",3376,654,17,0,35,0,0,0,4082
"37151031304",3894,583,58,8,313,0,7,97,4960
"37151031305",3487,471,33,52,96,46,51,0,4236
"37151031306",5877,522,128,26,168,4,323,4,7052
"37151031400",5494,1667,494,8,343,399,460,698,9563
"37151031501",4601,1254,41,0,189,31,59,89,6264
"37151031503",2233,465,97,24,208,48,110,27,3212
"37151031504",4314,380,176,0,393,37,105,13,5418
"37151031505",3162,91,204,0,32,30,81,0,3600
"37151031601",2610,784,213,0,104,89,124,150,4074
"37151031602",1075,170,66,23,159,5,118,23,1639
"37153970100",1606,136,816,166,208,44,294,0,3270
"37153970200",2497,753,1169,441,221,84,237,265,5667
"37153970300",2193,675,740,256,28,0,38,29,3959
"37153970400",2455,276,503,425,443,71,124,42,4339
"37153970500",1137,280,619,450,118,3,121,0,2728
"37153970600",2018,359,631,895,285,0,383,0,4571
"37153970700",1228,1048,320,149,46,576,114,592,4073
"37153970800",2709,604,1053,246,399,26,362,84,5483
"37153970900",3798,259,512,44,168,149,78,0,5008
"37153971000",1434,329,1270,869,139,71,32,0,4144
"37153971100",2047,305,1084,691,313,28,0,0,4468
"37155960101",1391,801,688,709,233,235,302,594,4953
"37155960102",2038,661,870,153,826,318,219,241,5326
"37155960201",2364,362,1468,335,725,625,244,48,6171
"37155960202",557,428,347,87,2048,946,400,471,5284
"37155960300",1181,1425,1523,994,1250,665,530,956,8524
"37155960401",246,453,103,55,4579,2305,0,55,7796
"37155960402",355,56,83,185,2140,835,38,173,3865
"37155960501",52,111,78,257,2315,799,19,8,3639
"37155960502",202,448,252,736,1180,1127,4,29,3978
"37155960503",95,65,129,0,1159,222,35,0,1705
"37155960600",854,180,510,155,3313,1646,380,38,7076
"37155960701",1036,341,250,110,2625,1779,753,510,7404
"37155960702",588,155,433,92,1398,568,225,266,3725
"37155960801",195,167,1258,1028,411,367,0,83,3509
"37155960802",269,91,1001,487,71,107,0,44,2070
"37155960900",1214,92,143,60,405,47,84,47,2092
"37155961000",750,167,389,343,260,295,78,54,2336
"37155961100",488,289,249,304,295,182,73,75,1955
"37155961200",1174,398,666,172,214,159,97,176,3056
"37155961301",1625,303,781,34,767,648,97,129,4384
"37155961302",1994,424,1200,636,801,896,817,669,7437
"37155961400",1941,330,418,271,896,240,323,66,4485
"37155961500",2573,549,585,167,1112,1046,97,342,6471
"37155961601",1561,333,298,574,892,179,100,63,4000
"37155961602",1731,346,479,315,357,201,52,0,3481
"37155961700",1261,265,1357,1178,744,498,26,234,5563
"37155961801",102,164,435,211,2587,1188,0,0,4687
"37155961802",570,118,808,154,2125,951,19,0,4745
"37155961900",1040,229,1379,680,1326,466,68,99,5287
"37155962001",371,79,1365,702,789,613,17,18,3954
"37155962002",430,46,400,119,1207,618,42,5,2867
"37157040101",2715,692,265,173,87,47,25,23,4027
"37157040102",1736,445,245,139,1,105,68,19,2758
"37157040200",1996,583,756,343,93,347,62,303,4483
"37157040300",2353,272,514,152,215,53,212,91,3862
"37157040400",3036,1302,923,424,83,118,16,0,5902
"37157040501",1779,597,594,208,87,47,40,21,3373
"37157040502",1826,285,459,115,364,0,308,18,3375
"37157040601",2917,384,183,42,256,4,332,8,4126
"37157040602",3001,343,323,212,540,546,647,668,6280
"37157040700",3623,601,210,38,46,8,2,0,4528
"37157040800",848,118,467,320,16,4,9,0,1782
"37157040900",1787,479,138,143,37,8,15,3,2610
"37157041001",4196,619,262,9,468,109,313,102,6078
"37157041002",4641,511,172,2,126,2,145,23,5622
"37157041100",4339,465,979,139,168,27,34,0,6151
"37157041200",1617,186,2104,1366,126,212,0,63,5674
"37157041300",3358,772,1585,328,298,216,524,282,7363
"37157041400",1301,600,844,305,152,115,214,148,3679
"37157041500",4972,264,665,295,119,0,204,49,6568
"37157041601",2686,287,130,22,50,6,74,19,3274
"37157041602",3817,490,280,12,89,114,21,143,4966
"37159050201",1703,525,875,577,179,40,75,42,4016
"37159050202",1575,417,1142,858,69,86,139,49,4335
"37159050300",1884,384,957,418,23,336,136,168,4306
"37159050400",100,677,1125,436,27,39,0,175,2579
"37159050500",1798,186,292,230,96,132,71,7,2812
"37159050700",1581,368,559,265,195,205,100,177,3450
"37159050800",761,69,963,896,0,59,72,75,2895
"37159050901",3292,607,73,0,152,0,98,0,4222
"37159050903",4266,690,328,77,150,119,238,136,6004
"37159050904",1999,286,29,0,0,0,0,0,2314
"37159051001",5968,689,6,32,53,73,56,109,6986
"37159051002",4566,671,119,73,100,44,76,30,5679
"37159051101",5590,729,210,32,192,155,356,111,7375
"37159051102",2662,752,44,0,506,204,535,224,4927
"37159051201",3943,1001,429,213,872,73,930,200,7661
"37159051202",2403,385,326,57,269,11,543,163,4157
"37159051204",2455,377,331,69,212,287,504,357,4592
"37159051301",1177,270,305,77,115,22,85,22,2073
"37159051302",3086,251,742,327,291,55,190,27,4969
"37159051303",2715,342,871,958,287,56,247,85,5561
"37159051400",5651,693,88,74,240,124,752,114,7736
"37159051501",2106,282,1072,55,295,122,830,156,4918
"37159051502",2581,338,0,0,21,42,134,42,3158
"37159051600",4147,1157,488,381,111,31,532,56,6903
"37159051700",5626,979,162,461,309,280,329,244,8390
"37159051801",4290,265,0,0,0,0,151,0,4706
"37159051802",3916,201,44,49,63,15,258,15,4561
"37159051901",3268,475,256,156,26,196,197,89,4663
"37159051902",4034,854,755,298,64,83,74,106,6268
"37159052000",729,196,571,398,74,60,99,26,2153
"37161960100",4564,962,54,14,85,0,86,11,5776
"37161960200",5745,1227,135,3,136,21,195,0,7462
"37161960300",2056,402,42,44,66,9,0,0,2619
"37161960400",2501,427,107,0,190,0,5,10,3240
"37161960500",5371,459,475,319,485,92,292,0,7493
"37161960600",2264,258,670,585,118,8,87,8,3998
"37161960700",2485,725,568,259,155,101,95,89,4477
"37161960800",1854,910,576,901,44,364,252,398,5299
"37161960900",3370,1293,575,4,139,6,271,120,5778
"37161961000",5901,1400,149,186,120,46,32,0,7834
"37161961101",4002,1429,244,36,155,317,48,213,6444
"37161961102",2466,200,209,94,14,6,57,0,3046
"37161961200",3943,683,0,12,106,16,186,16,4962
"37163970100",2667,860,1331,417,1462,252,1413,555,8957
"37163970200",4342,972,673,199,851,169,1246,531,8983
"37163970301",3669,789,767,133,388,186,255,538,6725
"37163970302",3391,657,643,93,364,230,466,490,6334
"37163970400",2695,915,676,391,337,69,182,8,5273
"37163970500",3145,505,1401,694,189,257,171,206,6568
"37163970600",1952,263,774,952,313,193,253,148,4848
"37163970700",2900,600,1403,728,491,521,675,697,8015
"37163970800",2246,427,1466,725,1199,737,1072,771,8643
"37163970900",1538,256,652,511,301,114,280,95,3747
"37163971000",1582,460,986,688,645,561,604,451,5977
"37165010101",2125,205,581,244,259,171,46,42,3673
"37165010102",2603,241,728,948,300,149,135,0,5104
"37165010200",456,281,1197,1513,210,228,0,70,3955
"37165010300",981,374,1444,932,241,165,45,2,4184
"37165010400",1239,249,368,182,620,343,52,24,3077
"37165010500",3287,616,1057,692,658,590,78,22,7000
"37165010600",2606,866,1626,1232,731,338,43,264,7706
"37167930101",3013,428,137,43,59,7,30,0,3717
"37167930102",2318,700,535,135,94,0,22,0,3804
"37167930200",2459,406,289,52,250,20,22,10,3508
"37167930300",3167,452,154,0,134,54,70,36,4067
"37167930500",2052,424,359,152,259,4,62,80,3392
"37167930700",3864,663,2,10,15,0,25,0,4579
"37167930801",3860,496,26,37,170,61,135,53,4838
"37167930802",4207,613,1,0,63,31,263,159,5337
"37167930900",4756,871,591,65,113,59,444,239,7138
"37167931000",3907,744,355,8,153,79,36,0,5282
"37167931100",3867,611,525,258,111,23,44,107,5546
"37167931201",2686,691,1001,1100,327,48,237,0,6090
"37167931202",2249,241,233,74,360,35,48,0,3240
"37169070100",4631,1145,234,17,249,18,360,33,6687
"37169070200",3098,470,0,12,48,53,23,53,3757
"37169070300",3249,1081,137,20,56,172,15,0,4730
"37169070400",4155,862,13,0,48,0,25,0,5103
"37169070501",5369,1219,143,0,0,50,88,279,7148
"37169070503",4862,451,133,1,199,46,32,22,5746
"37169070504",3053,404,0,1,21,25,86,78,3668
"37169070600",4407,552,25,0,57,0,92,0,5133
"37169070700",3341,983,753,285,132,42,81,0,5617
"37171930101",1518,549,106,34,99,38,84,79,2507
"37171930102",3654,1001,0,1,138,30,129,383,5336
"37171930201",2605,713,126,26,95,113,91,12,3781
"37171930202",2934,384,16,0,0,7,314,15,3670
"37171930301",1573,148,88,164,20,81,22,71,2167
"37171930302",2483,444,367,160,42,31,146,36,3709
"37171930400",1682,766,106,215,116,48,404,178,3515
"37171930501",2581,276,81,0,0,0,153,0,3091
"37171930502",2061,563,148,30,44,95,137,50,3128
"37171930600",2442,690,51,55,111,11,229,277,3866
"37171930700",3516,561,117,0,54,0,53,59,4360
"37171930801",3694,709,24,37,113,5,187,84,4853
"37171930802",2333,786,19,7,57,1,97,1,3301
"37171930901",2824,505,269,122,415,79,1018,86,5318
"37171930902",1333,48,48,0,63,0,22,0,1514
"37171931001",1780,662,0,12,135,47,386,119,3141
"37171931002",3309,917,14,11,88,250,389,416,5394
"37171931003",1961,953,52,9,82,187,147,906,4297
"37171931101",2403,452,9,0,0,0,171,0,3035
"37171931102",2925,477,0,4,42,38,183,10,3679
"37171931103",1749,250,40,4,0,8,17,8,2076
"37171931200",3089,492,113,30,66,31,8,112,3941
"37173940100",821,225,0,33,2015,1742,82,29,4947
"37173960200",2245,524,0,327,144,46,50,0,3336
"37173960301",2293,598,0,2,128,53,4,4,3082
"37173960302",2094,202,0,0,272,81,58,0,2707
"37173980200",0,0,0,0,0,0,0,0,0
"37175960100",3790,763,130,1,98,53,57,52,4944
"37175960200",2873,453,353,362,421,237,88,175,4962
"37175960300",5067,507,15,56,324,22,200,0,6191
"37175960401",3663,338,41,0,161,2,181,0,4386
"37175960402",3466,284,36,0,44,9,96,0,3935
"37175960500",4752,829,0,8,172,113,41,36,5951
"37175960600",2063,361,18,0,64,0,10,0,2516
"37177960100",1966,406,547,295,269,128,287,100,3998
"37179020100",5410,496,156,29,0,125,37,23,6276
"37179020202",5835,322,175,65,222,0,44,0,6663
"37179020203",3476,246,68,0,332,0,296,57,4475
"37179020204",3437,149,48,0,135,0,97,0,3866
"37179020305",3845,174,397,0,214,2,245,2,4879
"37179020306",4283,1031,1107,36,483,94,562,958,8554
"37179020307",5322,233,675,48,335,0,572,0,7185
"37179020308",4616,196,362,99,471,31,504,15,6294
"37179020309",2020,387,12,79,59,0,99,108,2764
"37179020310",4425,121,748,64,308,33,272,0,5971
"37179020311",4381,348,263,40,231,84,301,70,5718
"37179020312",2566,213,1036,0,337,70,587,82,4891
"37179020313",1816,170,130,5,251,0,114,0,2486
"37179020314",4464,394,268,0,554,18,352,57,6107
"37179020315",4501,101,397,0,166,0,279,9,5453
"37179020316",3965,34,425,0,123,0,171,0,4718
"37179020317",3689,26,1422,5,502,18,579,18,6259
"37179020401",4744,153,483,218,452,21,576,78,6725
"37179020403",3027,723,532,125,437,100,424,321,5689
"37179020404",2767,982,878,568,584,463,1450,1013,8705
"37179020501",2711,449,999,350,454,291,946,569,6769
"37179020502",2180,82,664,112,372,106,405,10,3931
"37179020601",2845,580,985,352,211,8,1574,206,6761
"37179020602",1986,916,644,492,491,244,1102,620,6495
"37179020701",2120,352,1283,220,338,472,915,562,6262
"37179020702",2810,184,777,182,81,0,829,34,4897
"37179020800",3146,350,1137,542,47,4,170,61,5457
"37179020901",3676,392,482,35,189,0,51,36,4861
"37179020902",4932,356,294,161,95,0,232,40,6110
"37179021004",3957,272,237,0,84,0,267,0,4817
"37179021005",3027,697,341,128,76,0,177,24,4470
"37179021006",5567,35,117,0,118,47,380,0,6264
"37179021007",5149,157,307,21,927,0,245,0,6806
"37179021008",5909,190,597,0,668,47,320,0,7731
"37179021009",2444,78,123,0,63,0,64,0,2772
"37179021010",6451,182,160,0,364,14,307,0,7478
"37179021011",5553,215,298,0,387,0,750,0,7203
"37179021012",3213,160,16,0,8,241,112,246,3996
"37179021013",3586,272,647,0,117,66,422,49,5159
"37179021014",2102,224,262,111,6,0,83,0,2788
"37179021015",3474,520,195,0,103,117,0,0,4409
"37181960100",2153,277,1445,658,180,2,180,0,4895
"37181960200",1359,199,2203,647,130,15,73,1,4627
"37181960300",2661,234,1745,358,113,41,52,90,5294
"37181960400",2371,171,918,320,41,63,0,0,3884
"37181960500",769,172,1996,1229,64,2,80,45,4357
"37181960600",247,176,370,429,149,46,168,46,1631
"37181960700",231,135,1488,2033,0,177,130,86,4280
"37181960800",364,209,778,344,28,242,42,201,2208
"37181960900",3163,729,1729,837,885,326,1135,389,9193
"37181961000",3183,470,2054,451,146,283,126,263,6976
"37183050100",1673,225,266,180,121,20,10,11,2506
"37183050300",1760,184,274,216,56,56,0,25,2571
"37183050400",1128,67,261,45,3,3,0,0,1507
"37183050500",2052,277,415,760,75,0,52,5,3636
"37183050600",636,24,1182,710,96,20,29,0,2697
"37183050700",470,41,1585,905,203,55,269,103,3631
"37183050800",393,497,650,874,18,125,399,552,3508
"37183050900",144,47,687,841,153,121,116,74,2183
"37183051000",1380,239,123,177,69,9,66,4,2067
"37183051101",232,409,467,425,153,65,81,28,1860
"37183051102",32,28,0,1,1,8,5,8,83
"37183051200",2217,902,92,37,122,89,18,64,3541
"37183051400",2817,1371,101,137,505,162,155,0,5248
"37183051501",2680,178,15,13,125,0,17,0,3028
"37183051502",1874,247,38,38,193,365,37,6,2798
"37183051600",4181,244,12,0,65,28,0,28,4558
"37183051700",3049,93,0,1,65,0,9,0,3217
"37183051800",3383,242,408,282,83,17,101,134,4650
"37183051900",1429,197,1877,1166,207,123,400,295,5694
"37183052001",769,535,1412,936,104,28,707,570,5061
"37183052002",156,439,3219,1016,27,0,46,350,5253
"37183052101",733,591,4187,879,556,226,470,665,8307
"37183052102",876,308,3481,1586,65,41,717,282,7356
"37183052301",2921,1211,745,182,399,361,265,87,6171
"37183052302",2714,1943,933,612,523,325,106,51,7207
"37183052401",1356,368,914,31,54,118,116,0,2957
"37183052404",2270,1013,217,156,658,152,345,231,5042
"37183052406",2971,1154,1492,785,491,139,687,303,8022
"37183052407",1831,924,487,539,168,137,170,341,4597
"37183052408",1118,730,343,432,83,66,63,127,2962
"37183052409",874,756,262,177,936,584,348,209,4146
"37183052503",4764,380,579,237,259,28,90,14,6351
"37183052504",3874,236,563,353,401,21,600,134,6182
"37183052505",3317,126,857,201,678,0,365,0,5544
"37183052506",1422,50,171,0,127,17,33,18,1838
"37183052507",2103,162,318,280,151,22,349,35,3420
"37183052601",2578,54,48,1,73,1,12,1,2768
"37183052602",3421,108,203,124,98,0,33,9,3996
"37183052603",2240,94,113,94,99,64,70,54,2828
"37183052701",2835,234,527,166,946,427,815,523,6473
"37183052704",1366,1115,2107,861,1281,327,1650,1375,10082
"37183052705",2606,641,575,72,327,68,432,386,5107
"37183052706",1763,720,1094,54,435,117,687,784,5654
"37183052707",3612,394,1302,741,558,19,279,127,7032
"37183052801",4869,71,1512,202,94,31,285,0,7064
"37183052802",3538,167,1115,1103,707,8,847,118,7603
"37183052803",1702,790,5676,975,365,0,439,721,10668
"37183052806",2936,1478,10062,589,1193,65,1588,1406,19317
"37183052807",2079,541,1947,338,415,14,399,364,6097
"37183052808",5194,606,2590,169,352,15,598,187,9711
"37183052809",1814,152,820,21,311,55,267,47,3487
"37183052901",1894,128,265,2,34,0,112,0,2435
"37183052902",4197,388,686,57,264,2,164,86,5844
"37183052903",2503,130,348,82,59,0,89,1,3212
"37183052904",5790,333,860,19,386,23,433,21,7865
"37183053003",3891,768,854,18,681,482,130,269,7093
"37183053004",2162,47,47,0,254,0,33,0,2543
"37183053005",4505,150,106,0,447,0,187,0,5395
"37183053006",2729,44,19,0,235,0,34,0,3061
"37183053007",2618,40,119,0,174,0,0,0,2951
"37183053008",5413,568,794,222,1199,103,452,0,8751
"37183053009",4387,1708,1002,0,340,412,1142,1713,10704
"37183053105",2921,25,527,28,164,70,153,9,3897
"37183053106",2206,75,495,671,367,11,444,11,4280
"37183053107",6349,659,1455,484,596,0,845,261,10649
"37183053108",5153,385,462,94,370,180,334,141,7119
"37183053109",6535,493,891,11,359,41,785,173,9288
"37183053110",4485,278,634,84,219,60,397,60,6217
"37183053111",3566,784,490,248,476,14,331,647,6556
"37183053201",9105,203,1280,26,765,355,580,318,12632
"37183053202",4225,34,439,15,156,0,74,0,4943
"37183053203",5412,114,1235,74,661,67,413,11,7987
"37183053204",3363,37,1052,25,227,0,126,0,4830
"37183053205",1621,43,138,51,21,0,6,0,1880
"37183053206",2817,160,434,180,548,27,125,72,4363
"37183053207",6012,303,666,30,324,0,360,0,7695
"37183053405",4080,66,359,0,335,0,115,0,4955
"37183053408",2955,110,0,0,1092,67,29,0,4253
"37183053409",5077,46,271,117,1506,0,349,0,7366
"37183053410",2923,70,248,0,1895,32,228,12,5408
"37183053411",4424,281,203,0,1787,0,64,0,6759
"37183053412",5063,144,245,0,1186,28,469,0,7135
"37183053413",4695,69,314,15,472,42,239,45,5891
"37183053414",6897,20,395,0,900,86,796,0,9094
"37183053415",2407,14,151,0,780,34,320,7,3713
"37183053416",4374,224,1018,43,668,0,378,48,6753
"37183053417",1475,136,935,0,105,0,76,40,2767
"37183053418",4506,305,374,111,505,144,445,87,6477
"37183053419",2597,9,85,0,93,0,34,0,2818
"37183053420",4019,383,927,0,471,0,902,219,6921
"37183053421",4017,158,290,50,575,38,363,0,5491
"37183053422",2040,79,79,0,335,0,19,0,2552
"37183053423",1728,96,51,0,189,0,72,0,2136
"37183053424",3204,64,268,0,894,96,258,55,4839
"37183053425",1617,23,81,7,1035,0,59,5,2827
"37183053505",2695,221,576,39,128,0,44,12,3715
"37183053506",4283,204,78,3,413,0,653,15,5649
"37183053507",2325,282,522,154,267,104,409,97,4160
"37183053509",4323,171,126,0,569,0,439,31,5659
"37183053512",4453,135,409,0,913,0,246,36,6192
"37183053513",2112,216,747,145,613,100,492,100,4525
"37183053516",2276,174,888,108,558,21,885,112,5022
"37183053517",2497,701,287,70,1147,391,1713,707,7513
"37183053518",3379,214,53,2,189,0,50,25,3912
"37183053519",2279,582,677,414,382,377,577,519,5807
"37183053520",3009,273,1014,96,826,407,592,222,6439
"37183053521",2566,152,157,15,524,0,211,0,3625
"37183053522",2803,70,519,0,1875,0,442,0,5709
"37183053523",3786,98,379,79,1187,44,138,41,5752
"37183053524",2655,250,188,16,590,39,357,0,4095
"37183053525",2034,12,158,0,266,5,125,5,2605
"37183053601",4138,127,496,310,2873,15,650,102,8711
"37183053602",1604,16,1083,0,2379,21,290,0,5393
"37183053603",2814,79,237,6,780,75,20,0,4011
"37183053604",3153,17,7,0,1125,16,61,0,4379
"37183053605",1278,14,131,0,360,0,23,0,1806
"37183053606",1749,66,324,8,366,0,46,8,2567
"37183053607",3594,185,462,0,3554,378,761,0,8934
"37183053608",1314,0,654,56,1255,98,37,0,3414
"37183053609",420,14,106,0,143,0,31,0,714
"37183053610",5603,172,2186,69,1169,101,251,81,9632
"37183053707",4366,196,991,57,256,293,150,195,6504
"37183053709",4384,391,1265,81,597,144,248,145,7255
"37183053711",4408,84,553,83,554,31,473,0,6186
"37183053712",2388,94,273,0,82,0,17,0,2854
"37183053713",1914,247,1326,66,105,6,144,0,3808
"37183053714",3224,466,406,246,320,62,69,0,4793
"37183053715",2715,152,313,15,193,11,115,22,3536
"37183053716",2233,187,1038,16,175,112,141,19,3921
"37183053717",1632,41,415,23,460,25,226,10,2832
"37183053718",2957,65,200,1,100,0,204,0,3527
"37183053719",3448,34,40,311,229,8,169,0,4239
"37183053720",3686,106,144,0,271,10,171,29,4417
"37183053721",2943,9,62,0,354,5,63,0,3436
"37183053722",3686,237,126,0,323,7,46,43,4468
"37183053723",2482,249,394,0,328,0,341,0,3794
"37183053724",4709,191,295,0,1418,0,385,0,6998
"37183053725",3658,179,764,106,407,0,298,0,5412
"37183053726",1281,49,1111,375,666,33,619,0,4134
"37183053803",3306,86,462,0,139,0,75,0,4068
"37183053804",3300,12,180,1,61,0,274,0,3828
"37183053805",1876,96,59,0,111,0,64,0,2206
"37183053806",3030,50,210,2,149,0,54,0,3495
"37183053807",3704,22,85,9,262,0,83,0,4165
"37183053808",4604,56,350,0,273,0,160,0,5443
"37183053900",6821,461,402,0,169,0,280,0,8133
"37183054001",3594,394,1141,34,220,12,422,330,6147
"37183054004",3612,229,1077,105,282,444,682,499,6930
"37183054006",2034,250,396,96,267,435,202,245,3925
"37183054007",2581,114,831,49,181,27,225,10,4018
"37183054008",1482,888,2148,746,849,447,1023,1159,8742
"37183054011",2554,116,99,87,60,0,100,93,3109
"37183054012",2937,48,373,34,395,11,349,6,4153
"37183054013",10405,620,700,400,1220,36,551,0,13932
"37183054014",5503,1034,2901,1053,1953,97,2436,837,15814
"37183054015",994,59,606,156,613,47,483,21,2979
"37183054016",4562,124,455,40,234,23,183,0,5621
"37183054017",1614,122,682,61,77,134,109,132,2931
"37183054018",1041,39,1427,291,190,232,137,212,3569
"37183054104",4645,69,3753,564,1594,61,2257,17,12960
"37183054105",6551,113,4168,510,417,156,817,4,12736
"37183054106",1781,700,4065,194,735,329,810,719,9333
"37183054108",3225,311,2072,161,644,54,1433,174,8074
"37183054109",2155,236,889,20,170,87,48,142,3747
"37183054110",4845,227,2159,283,1316,249,452,0,9531
"37183054111",1126,380,322,64,135,10,28,21,2086
"37183054112",1450,258,1211,169,287,0,515,187,4077
"37183054113",1347,44,760,72,55,105,342,38,2763
"37183054114",2716,366,1359,3,550,27,1243,326,6590
"37183054115",3995,174,2779,252,541,119,775,0,8635
"37183054203",3150,25,103,0,239,0,260,0,3777
"37183054204",2934,507,606,188,182,25,122,0,4564
"37183054205",2631,380,644,618,340,22,253,16,4904
"37183054206",4419,304,271,304,108,0,21,41,5468
"37183054207",6259,291,1246,0,841,87,650,40,9414
"37183054208",5545,243,483,132,563,17,423,105,7511
"37183054209",5807,104,2618,23,874,2,507,0,9935
"37183054210",7157,439,1299,131,320,12,380,0,9738
"37183054211",7700,621,1004,45,563,5,578,291,10807
"37183054301",3504,560,1269,108,13,0,110,259,5823
"37183054302",3985,389,1560,343,191,188,1488,376,8520
"37183054402",3951,757,801,54,293,0,783,368,7007
"37183054403",2034,509,645,216,232,96,443,516,4691
"37183054404",3359,103,1115,243,1295,152,1131,0,7398
"37183054500",3179,1666,1309,788,432,108,676,1308,9466
"37183980100",0,0,0,0,0,0,0,0,0
"37183980200",95,0,0,0,2,0,0,0,97
"37185950101",1507,193,314,53,239,0,82,0,2388
"37185950102",606,95,287,52,18,0,60,0,1118
"37185950103",549,81,849,239,707,374,119,35,2953
"37185950200",1918,492,2236,881,102,168,19,24,5840
"37185950300",741,88,1734,1081,194,105,142,86,4171
"37185950400",1051,279,1759,587,30,124,35,120,3985
"37187950100",2213,441,1404,761,281,32,344,47,5523
"37187950200",1801,268,2570,1345,13,27,55,98,6177
"37187950300",1094,96,246,96,5,0,0,0,1537
"37189920100",3571,1171,16,28,73,62,29,6,4956
"37189920200",3488,368,2,0,68,126,30,100,4182
"37189920300",1921,372,0,6,74,58,153,53,2637
"37189920400",3396,5182,75,10,61,355,123,220,9422
"37189920500",805,1341,2,18,23,43,6,38,2276
"37189920601",2063,2344,36,13,81,58,96,96,4787
"37189920602",1061,473,9,6,6,87,0,88,1730
"37189920701",1619,115,7,9,32,0,20,0,1802
"37189920702",2688,302,0,35,57,11,11,0,3104
"37189920703",4113,668,31,13,166,207,201,149,5548
"37189920800",2178,479,0,0,7,24,15,59,2762
"37189920900",3249,742,9,0,61,163,41,55,4320
"37189921000",533,58,0,0,13,0,8,0,612
"37191000101",5100,707,1192,109,188,18,317,46,7677
"37191000102",4573,341,1091,16,300,38,93,30,6482
"37191000200",2106,279,562,233,128,222,139,238,3907
"37191000302",2914,721,1973,202,292,596,131,596,7425
"37191000303",4068,448,1339,186,514,62,78,30,6725
"37191000304",3553,912,929,128,162,0,165,102,5951
"37191000401",3574,542,519,246,128,241,11,82,5343
"37191000402",1776,566,511,748,452,812,176,740,5781
"37191000500",1050,204,583,0,228,35,116,10,2226
"37191000601",1209,309,1587,519,592,471,518,394,5599
"37191000602",3291,589,960,269,1795,1489,2119,1579,12091
"37191000700",620,106,1219,510,84,246,125,246,3156
"37191000800",889,266,355,202,164,433,167,473,2949
"37191000901",2503,573,531,544,403,709,380,622,6265
"37191000902",1982,426,1257,630,526,181,510,267,5779
"37191001000",2899,525,299,2,380,359,323,445,5232
"37191001101",4777,1116,263,164,98,200,42,200,6860
"37191001102",2530,147,287,25,30,0,0,0,3019
"37191001200",1532,103,1189,726,243,26,164,0,3983
"37191001301",2456,218,2496,214,434,34,428,9,6289
"37191001302",1792,203,907,57,164,155,89,0,3367
"37191001400",1439,170,2924,1906,345,24,229,169,7206
"37191001500",326,31,1473,867,8,66,58,0,2829
"37191001800",416,247,840,951,30,42,0,72,2598
"37191001900",1037,210,1528,891,131,79,21,48,3945
"37191002000",170,57,472,248,58,0,58,0,1063
"37193960100",5537,1468,161,3,58,51,208,141,7627
"37193960200",2575,738,59,0,35,6,18,0,3431
"37193960300",4838,1092,24,54,147,19,136,114,6424
"37193960400",6108,1646,54,0,39,163,133,132,8275
"37193960500",1839,819,204,102,75,181,121,116,3457
"37193960600",1157,903,142,133,24,285,44,294,2982
"37193960700",1823,934,60,0,36,404,111,272,3640
"37193960801",2988,1118,229,0,235,110,354,110,5144
"37193960802",3043,817,2,21,63,120,48,120,4234
"37193960900",3560,1129,0,0,0,0,0,27,4716
"37193961001",4055,670,50,131,189,245,391,61,5792
"37193961002",3728,601,76,63,144,15,234,163,5024
"37193961100",2049,454,510,248,218,98,245,98,3920
"37193961200",4814,1562,434,0,48,136,120,70,7184
"37195000100",285,131,1084,955,52,319,108,312,3246
"37195000200",10,88,138,505,74,6,74,98,993
"37195000300",319,27,1064,1039,192,239,224,245,3349
"37195000400",3286,265,2536,863,484,200,167,376,8177
"37195000501",3383,143,214,0,11,7,0,7,3765
"37195000502",3154,129,1410,547,109,0,109,0,5458
"37195000600",3875,177,1512,1172,407,0,230,35,7408
"37195000700",359,365,1883,1749,353,694,481,486,6370
"37195000801",25,22,573,871,68,138,93,125,1915
"37195000802",599,298,1415,588,333,359,238,454,4284
"37195000900",2377,578,479,142,297,30,293,195,4391
"37195001000",796,95,674,129,94,9,147,9,1953
"37195001100",781,129,610,79,0,1,0,0,1600
"37195001200",1635,158,952,616,154,424,218,307,4464
"37195001300",2823,237,1160,657,222,72,205,52,5428
"37195001400",4918,425,2062,713,587,679,147,660,10191
"37195001500",3441,503,742,122,740,120,801,163,6632
"37195001600",1840,326,435,204,307,23,258,23,3416
"37195001700",2470,350,692,143,235,280,276,295,4741
"37197050101",4170,1108,166,1,68,33,284,131,5961
"37197050102",3396,607,29,28,0,18,217,18,4313
"37197050200",3768,417,283,34,48,0,55,83,4688
"37197050300",4681,842,256,24,253,290,238,340,6924
"37197050400",4530,729,95,26,112,343,354,296,6485
"37197050501",4759,1119,70,122,163,531,513,666,7943
"37197050502",3510,689,12,87,76,270,305,383,5332
"37199960101",2973,635,10,0,22,62,27,110,3839
"37199960102",1665,802,0,0,16,21,135,0,2639
"37199960200",2894,893,128,0,106,69,93,75,4258
"37199960300",2599,667,6,16,0,77,86,254,3705
"37199960400",3263,507,0,0,24,9,0,41,3844
"38001965600",1998,179,11,0,63,30,31,0,2312
"38003967900",1456,117,0,0,34,1,0,4,1612
"38003968000",2687,114,5,0,40,37,52,0,2935
"38003968200",2040,244,30,0,230,6,47,0,2597
"38003968300",3144,221,24,7,66,28,36,3,3529
"38005940100",366,46,0,0,745,1316,79,3,2555
"38005940200",257,72,0,0,1058,716,22,2,2127
"38005956500",1086,100,0,0,11,0,6,3,1206
"38005956600",807,135,0,0,1,0,5,0,948
"38007963100",752,68,4,0,13,18,0,1,856
"38009952300",1841,200,0,0,190,12,46,15,2304
"38009952400",1883,207,0,0,65,31,7,0,2193
"38009952500",1608,201,14,0,28,0,32,0,1883
"38011965200",1493,167,0,0,98,0,82,4,1844
"38011965300",1244,70,2,1,30,8,36,0,1391
"38013953300",1797,279,10,0,46,13,39,66,2250
"38015010100",2339,542,71,0,118,39,125,0,3234
"38015010200",3754,362,42,0,257,44,57,0,4516
"38015010300",5950,407,0,32,118,0,47,0,6554
"38015010400",3334,137,72,0,143,0,107,7,3800
"38015010500",3972,417,0,0,175,12,11,12,4599
"38015010600",3547,139,62,0,113,591,0,22,4474
"38015010700",3887,327,0,0,80,58,48,8,4408
"38015010800",2981,394,0,0,221,232,0,0,3828
"38015010900",3603,199,44,32,118,47,34,24,4101
"38015011001",4245,479,52,0,393,40,88,0,5297
"38015011002",5644,91,56,0,334,0,129,0,6254
"38015011101",4206,504,56,0,287,236,194,0,5483
"38015011103",2820,80,39,0,150,22,32,13,3156
"38015011104",4310,44,0,0,189,27,22,0,4592
"38015011105",3962,0,0,0,180,0,27,0,4169
"38015011200",4743,344,0,0,295,62,47,50,5541
"38015011300",5486,162,5,0,262,214,89,0,6218
"38015011400",2205,88,0,0,88,9,18,0,2408
"38015011500",1428,144,0,0,34,2,6,27,1641
"38017000100",4902,75,5,0,61,8,0,0,5051
"38017000201",3003,408,0,0,211,1,38,0,3661
"38017000202",2282,531,52,64,312,51,173,0,3465
"38017000300",1239,266,39,65,181,266,7,0,2063
"38017000400",2693,535,28,31,64,219,35,0,3605
"38017000501",2634,490,13,0,138,202,30,121,3628
"38017000502",1414,1076,68,15,120,128,42,7,2870
"38017000600",3349,865,2,97,293,323,0,22,4951
"38017000700",1042,621,135,28,11,69,42,30,1978
"38017000801",2541,242,0,0,259,0,158,0,3200
"38017000802",3080,651,80,393,486,92,241,66,5089
"38017000901",4662,218,14,40,149,154,13,89,5339
"38017000903",2596,654,72,86,249,144,30,171,4002
"38017000904",3331,303,14,11,46,150,35,0,3890
"38017001001",4373,517,116,37,288,352,17,154,5854
"38017001002",2066,320,85,0,59,12,84,2,2628
"38017010106",2713,1070,115,169,504,76,90,16,4753
"38017010107",1891,430,100,28,54,230,36,4,2773
"38017010108",4474,541,291,332,299,0,36,14,5987
"38017010109",2986,497,10,1,296,196,171,27,4184
"38017010201",4778,177,0,0,242,0,9,0,5206
"38017010203",2360,312,65,37,23,30,35,37,2899
"38017010204",5467,384,351,144,222,143,0,0,6711
"38017010303",5529,407,12,0,443,0,167,0,6558
"38017010305",4977,552,398,151,398,88,167,125,6856
"38017010306",3176,273,61,123,149,69,80,164,4095
"38017010307",2143,38,0,0,38,0,0,0,2219
"38017040100",1830,76,0,0,4,0,11,0,1921
"38017040200",2212,99,0,0,37,3,5,0,2356
"38017040300",3140,110,0,0,79,0,0,6,3335
"38017040400",3689,139,13,57,58,1,15,1,3973
"38017040500",25234,1329,385,38,985,159,587,0,28717
"38017040600",2791,114,4,0,26,7,18,6,2966
"38019950900",1637,104,0,0,56,0,0,0,1797
"38019951100",1866,63,3,0,74,0,0,0,2006
"38021973200",2127,112,8,17,33,0,118,0,2415
"38021973300",1183,89,5,0,0,3,0,0,1280
"38021973400",1058,186,25,5,41,10,12,5,1342
"38023954500",1970,160,8,0,51,0,0,0,2189
"38025962200",2883,347,7,0,536,97,139,0,4009
"38027959200",1851,305,0,0,76,55,62,21,2370
"38029966500",2944,465,0,0,25,0,8,0,3442
"38031959600",2878,368,0,3,34,8,57,0,3348
"38033962900",1614,124,0,0,0,15,7,0,1760
"38035010100",2318,647,98,0,196,14,186,112,3571
"38035010200",3075,896,9,5,134,168,137,81,4505
"38035010300",613,1101,120,94,122,191,0,6,2247
"38035010400",3058,1465,12,327,509,410,127,170,6078
"38035010600",1625,351,0,0,46,25,22,0,2069
"38035010700",1661,215,14,26,28,5,60,0,2009
"38035010801",3346,699,0,0,172,238,10,0,4465
"38035010803",3294,1095,250,272,383,136,103,48,5581
"38035010804",2968,794,0,0,375,144,42,0,4323
"38035010900",1466,100,0,0,68,7,49,0,1690
"38035011000",2050,80,28,0,181,191,128,0,2658
"38035011100",4743,46,24,0,120,0,57,0,4990
"38035011200",5454,817,42,0,472,110,81,0,6976
"38035011400",2031,238,0,0,36,21,12,134,2472
"38035011700",5079,214,31,0,102,37,175,5,5643
"38035011800",1327,75,0,0,25,0,17,0,1444
"38035011900",1314,82,229,0,179,9,196,0,2009
"38035012000",2450,129,0,11,95,31,121,17,2854
"38037965900",1936,304,1,7,57,16,7,1,2329
"38039968600",2095,143,6,7,13,0,4,0,2268
"38041964700",923,127,0,0,16,14,11,0,1091
"38041964800",1245,76,0,0,28,0,25,0,1374
"38043966800",2156,211,0,0,60,0,97,16,2540
"38045972100",1414,151,0,0,12,0,10,3,1590
"38045972200",2207,209,0,1,40,0,9,0,2466
"38047972500",1693,165,0,7,21,0,28,0,1914
"38049955600",2200,305,2,2,86,4,53,24,2676
"38049955900",2556,440,0,0,18,11,37,9,3071
"38051972900",2246,329,2,0,65,25,3,5,2675
"38053940100",86,22,13,0,763,678,72,51,1685
"38053962300",2005,133,0,0,38,95,0,70,2341
"38053962400",2582,182,5,0,93,2,51,51,2966
"38053962500",1401,83,0,0,33,5,30,10,1562
"38055960800",3580,457,6,0,77,1,29,84,4234
"38055961000",3842,447,0,0,528,153,31,0,5001
"38057961600",2390,149,23,16,90,26,85,16,2795
"38057961700",2893,315,0,0,19,0,52,0,3279
"38057961800",2129,175,3,0,152,20,10,0,2489
"38059020100",4178,682,0,0,399,155,0,111,5525
"38059020200",6117,347,159,0,319,80,0,29,7051
"38059020300",7629,592,60,0,386,76,201,0,8944
"38059020400",2897,132,0,0,100,6,34,0,3169
"38059020500",3017,321,15,0,181,23,144,32,3733
"38061940300",629,72,8,0,438,203,52,6,1408
"38061940400",804,53,21,0,1578,400,193,29,3078
"38061955200",3789,288,0,0,298,17,141,0,4533
"38063959000",2647,238,18,19,59,0,43,0,3024
"38065961200",1610,104,3,0,50,35,16,26,1844
"38067950100",1180,85,4,0,34,8,14,0,1325
"38067950200",1276,154,0,0,128,6,40,15,1619
"38067950300",1171,43,0,0,73,11,51,0,1349
"38067950400",1350,87,0,0,13,6,7,0,1463
"38067950500",1296,97,0,0,56,0,77,0,1526
"38069956100",1293,95,5,0,7,16,7,0,1423
"38069956200",2380,268,0,0,33,110,8,29,2828
"38071957600",3029,353,58,0,242,314,0,0,3996
"38071957700",2574,160,0,0,92,47,163,0,3036
"38071957800",3313,291,32,0,325,217,53,0,4231
"38073968900",1350,219,14,0,21,7,2,2,1615
"38073969000",1502,41,14,0,18,0,23,0,1598
"38073969100",1857,172,0,0,51,3,42,12,2137
"38075952900",2228,200,6,0,43,14,4,0,2495
"38077970700",1835,54,0,0,0,43,0,0,1932
"38077970800",1957,169,0,0,24,17,40,5,2212
"38077970900",2444,336,20,0,109,46,57,0,3012
"38077971000",3055,488,0,0,252,101,113,81,4090
"38077971100",1150,66,0,0,112,4,5,2,1339
"38077971400",2415,367,0,0,114,12,38,3,2949
"38079941800",92,34,6,0,3578,2377,33,90,6210
"38079951600",657,107,2,19,307,324,0,0,1416
"38079951700",599,139,3,0,2092,1856,0,63,4752
"38079951900",1069,118,6,0,471,232,8,0,1904
"38081974000",1418,59,0,0,18,8,24,0,1527
"38081974200",2045,167,22,11,64,2,48,11,2370
"38083960200",1157,139,9,0,14,1,4,0,1324
"38085940800",341,81,0,0,636,542,4,0,1604
"38085940900",126,6,0,0,1577,902,80,45,2736
"38087965000",654,53,2,0,6,0,0,3,718
"38089963300",1250,132,0,0,27,4,18,0,1431
"38089963400",3398,208,10,0,141,7,0,7,3771
"38089963500",4455,250,0,0,158,64,110,0,5037
"38089963600",1778,209,33,52,33,5,122,9,2241
"38089963700",3543,364,102,16,291,53,201,52,4622
"38089963800",3920,293,48,0,329,36,251,36,4913
"38089963900",2859,127,9,0,212,52,96,1,3356
"38089964000",1664,115,0,0,40,1,3,1,1824
"38091968700",1809,129,0,0,11,0,29,1,1979
"38093967000",2381,83,0,0,30,1,11,0,2506
"38093967200",2113,275,0,0,41,33,13,0,2475
"38093967300",1822,203,0,0,10,27,12,7,2081
"38093967400",3927,404,23,0,213,33,181,0,4781
"38093967500",3223,404,0,0,166,0,0,65,3858
"38093967800",3148,619,0,58,158,61,14,45,4103
"38095951500",1921,193,0,0,67,67,2,17,2267
"38097970100",2092,214,0,0,72,15,0,0,2393
"38097970200",1784,280,25,23,51,18,12,6,2199
"38097970300",1424,50,0,0,10,4,40,0,1528
"38097970400",1477,170,6,0,7,10,101,61,1832
"38099957800",1411,124,3,0,189,4,234,67,2032
"38099957900",1038,189,0,0,177,45,295,73,1817
"38099958000",1970,352,0,0,268,42,140,72,2844
"38099958100",1998,89,0,0,117,0,149,10,2363
"38099958200",1224,204,6,6,53,14,38,26,1571
"38099958300",1117,84,4,0,19,12,1,0,1237
"38101010100",1988,524,109,75,275,19,94,6,3090
"38101010200",3522,422,0,88,60,91,28,0,4211
"38101010301",3359,67,73,0,331,89,203,42,4164
"38101010302",5011,540,183,0,425,141,257,0,6557
"38101010400",4037,526,77,5,288,107,208,46,5294
"38101010500",6246,292,16,31,352,21,209,0,7167
"38101010600",5889,783,365,33,658,120,144,21,8013
"38101010700",6555,669,191,0,447,54,129,120,8165
"38101010800",3129,132,30,0,92,84,115,2,3584
"38101010900",3253,111,519,22,634,188,572,148,5447
"38101011000",1627,216,0,14,77,3,103,14,2054
"38101011200",3130,106,0,0,63,11,31,0,3341
"38101011300",4254,263,23,2,289,36,53,6,4926
"38103959800",1503,236,0,0,7,4,0,0,1750
"38103960000",2225,79,0,0,63,0,15,0,2382
"38105953400",1485,86,0,0,106,0,116,10,1803
"38105953500",1171,98,8,0,396,33,94,20,1820
"38105953600",2265,185,31,0,173,20,8,0,2682
"38105953700",7347,743,0,0,710,0,76,271,9147
"38105953800",2249,245,33,0,301,106,170,8,3112
"38105953900",3324,35,5,0,0,0,16,0,3380
"38105954100",4483,363,18,201,257,64,154,18,5558
"39001770100",3495,1195,8,15,69,65,52,10,4909
"39001770200",3670,1070,0,0,0,129,30,38,4937
"39001770300",5820,1274,0,0,79,0,32,0,7205
"39001770400",3273,1221,3,23,0,0,0,0,4520
"39001770500",1847,1132,0,2,39,76,0,1,3097
"39001770600",2422,826,0,0,126,23,39,28,3464
"39003010100",3481,309,34,28,25,28,70,28,4003
"39003010200",3830,241,40,0,36,0,44,0,4191
"39003010300",1402,142,11,0,16,4,16,4,1595
"39003010600",4121,492,35,11,260,41,3,4,4967
"39003010800",6904,154,149,27,246,0,183,0,7663
"39003010900",2751,422,351,28,305,60,44,31,3992
"39003011000",3781,1300,320,197,650,38,237,45,6568
"39003011200",1009,172,16,12,11,0,49,45,1314
"39003011300",5986,357,194,160,264,131,97,213,7402
"39003011400",2800,187,0,0,6,0,47,1,3041
"39003011500",2163,440,0,0,114,10,73,0,2800
"39003011600",2242,219,26,1,26,0,17,0,2531
"39003011800",2054,120,209,30,98,8,70,0,2589
"39003011900",2329,276,276,0,19,35,0,8,2943
"39003012000",2103,61,57,0,51,0,8,6,2286
"39003012100",2775,330,44,2,290,0,49,11,3501
"39003012200",1847,492,722,170,154,63,78,6,3532
"39003012300",2458,796,241,272,135,47,29,112,4090
"39003012400",1250,770,325,186,122,33,5,28,2719
"39003012600",1044,682,78,133,30,48,8,50,2073
"39003012700",610,481,277,371,96,27,0,15,1877
"39003012900",613,307,104,425,161,20,10,0,1640
"39003013000",2925,921,279,16,64,130,70,125,4530
"39003013100",1670,153,192,228,10,0,118,35,2406
"39003013200",977,110,351,182,114,65,27,41,1867
"39003013300",582,23,269,174,129,9,4,3,1193
"39003013400",444,1122,493,415,110,38,63,38,2723
"39003013600",557,153,180,298,4,59,4,0,1255
"39003013700",261,177,301,391,19,26,0,17,1192
"39003013800",685,289,794,722,104,167,0,98,2859
"39003013900",3110,237,24,1,14,9,59,0,3454
"39003014000",2914,275,47,0,0,0,21,0,3257
"39003014100",578,538,372,284,127,21,117,8,2045
"39005970100",6338,1861,0,0,148,0,124,9,8480
"39005970200",5003,755,6,6,129,4,55,4,5962
"39005970300",3154,638,29,9,63,0,0,0,3893
"39005970400",2662,842,0,13,91,95,74,30,3807
"39005970500",2069,474,10,4,41,2,29,0,2629
"39005970600",3325,374,0,0,91,2,40,0,3832
"39005970700",4511,511,38,50,137,38,75,0,5360
"39005970800",3028,608,45,16,73,35,17,0,3822
"39005970900",4404,426,9,0,46,14,28,10,4937
"39005971000",4484,439,5,5,22,19,16,0,4990
"39005971100",3080,583,6,2,14,0,2,0,3687
"39007000101",2230,663,23,53,12,34,45,6,3066
"39007000102",2676,493,34,7,168,0,28,0,3406
"39007000103",2549,899,79,10,30,23,0,21,3611
"39007000200",3778,320,54,2,120,0,105,42,4421
"39007000300",1734,268,5,2,24,51,38,0,2122
"39007000400",1123,547,30,7,21,13,8,0,1749
"39007000500",3166,960,80,0,71,55,130,7,4469
"39007000601",1360,544,247,44,76,42,0,126,2439
"39007000602",2527,511,0,11,55,54,31,55,3244
"39007000603",3178,586,46,0,325,27,70,38,4270
"39007000701",1468,709,293,441,129,84,180,120,3424
"39007000702",2015,270,76,0,67,0,209,28,2665
"39007000703",1755,1370,254,195,147,150,139,204,4214
"39007000704",2599,1181,46,41,253,68,146,484,4818
"39007000801",1431,438,0,2,19,7,92,25,2014
"39007000802",4403,647,29,0,244,32,233,210,5798
"39007000900",3843,411,0,11,34,16,86,92,4493
"39007001001",4868,441,58,22,91,0,45,0,5525
"39007001002",2729,394,3,0,35,0,57,3,3221
"39007001101",1936,138,0,0,37,12,6,12,2141
"39007001102",5168,584,0,0,27,0,13,0,5792
"39007001200",5894,1304,42,43,72,0,106,0,7461
"39007001301",2606,704,2,77,58,264,7,16,3734
"39007001302",2809,931,0,7,1,56,63,13,3880
"39007001400",6627,1070,42,11,140,0,68,3,7961
"39007990000",0,0,0,0,0,0,0,0,0
"39009972600",2918,1295,10,25,141,29,35,0,4453
"39009972700",2878,977,2,0,28,0,33,53,3971
"39009972800",2190,1150,0,144,49,65,0,0,3598
"39009972900",3097,1312,70,8,392,211,15,166,5271
"39009973000",2074,1356,26,41,80,45,129,0,3751
"39009973101",370,1398,12,47,35,93,10,0,1965
"39009973200",3044,1435,39,206,210,151,49,52,5186
"39009973300",2717,492,81,30,286,275,145,45,4071
"39009973400",2446,982,13,0,48,84,0,0,3573
"39009973500",2865,472,85,0,220,0,55,0,3697
"39009973600",3012,424,0,1,68,0,0,0,3505
"39009973700",3082,490,19,9,71,67,0,0,3738
"39009973800",4238,560,26,16,15,40,22,3,4920
"39009973901",77,711,19,4,98,526,0,81,1516
"39009973902",595,2096,0,76,62,142,55,20,3046
"39011040100",3675,252,1,0,114,7,52,2,4103
"39011040200",3629,463,1,0,56,0,55,53,4257
"39011040300",2789,745,13,29,22,11,26,26,3661
"39011040400",5565,469,7,26,267,10,104,70,6518
"39011040500",4502,279,1,0,26,22,7,0,4837
"39011040600",3006,278,10,2,158,9,44,0,3507
"39011040900",3453,242,0,0,50,2,53,2,3802
"39011041000",3382,164,2,0,6,21,0,18,3593
"39011041100",3935,147,4,0,82,0,6,0,4174
"39011041201",1628,289,23,0,13,0,31,0,1984
"39011041202",4520,656,7,1,49,24,44,0,5301
"39013010100",3141,721,146,11,125,20,1,0,4165
"39013010200",3100,714,145,55,37,39,4,12,4106
"39013010300",2882,276,0,1,12,1,1,1,3174
"39013010600",3024,470,1,1,30,0,1,90,3617
"39013010700",2322,278,0,0,26,0,2,0,2628
"39013010802",2034,395,0,0,53,54,0,0,2536
"39013010900",5299,736,42,67,146,27,4,27,6348
"39013011000",4198,482,0,0,113,6,15,0,4814
"39013011200",3365,477,8,0,27,0,7,0,3884
"39013011300",3123,517,0,0,35,42,0,0,3717
"39013011400",3856,546,4,0,0,0,0,0,4406
"39013011500",1272,204,21,25,20,0,0,0,1542
"39013011600",734,518,0,0,0,0,0,0,1252
"39013011700",753,486,102,38,0,0,0,10,1389
"39013011900",2361,279,179,15,28,0,31,0,2893
"39013012000",1681,625,65,5,66,228,0,41,2711
"39013012100",713,297,20,1,27,172,0,0,1230
"39013012200",2883,267,8,14,45,0,34,0,3251
"39013012300",3525,216,67,0,97,12,10,0,3927
"39013012400",4058,217,175,0,2,0,7,0,4459
"39015951201",3947,356,0,0,3,2,18,0,4326
"39015951202",3823,576,0,0,78,17,64,0,4558
"39015951300",6864,1066,87,0,94,0,152,0,8263
"39015951400",3336,742,0,0,21,47,0,0,4146
"39015951500",4708,456,0,0,138,0,7,0,5309
"39015951600",2501,874,0,18,72,26,42,24,3557
"39015951700",1989,501,104,11,49,32,0,0,2686
"39015951800",3810,981,178,0,36,35,15,0,5055
"39015951900",5287,587,0,0,19,0,0,0,5893
"39017000100",3728,402,119,43,87,6,59,83,4527
"39017000200",3177,864,234,19,106,22,194,13,4629
"39017000300",962,261,783,725,221,172,205,125,3454
"39017000400",1262,991,263,560,145,190,184,357,3952
"39017000500",2781,1135,216,75,188,97,162,45,4699
"39017000600",3138,1608,30,133,127,179,253,258,5726
"39017001001",4135,603,243,53,101,0,31,53,5219
"39017001002",4612,625,279,37,214,27,0,59,5853
"39017001100",3106,1044,42,65,195,0,112,0,4564
"39017001300",3973,267,63,0,137,0,52,0,4492
"39017010101",1221,4081,14,130,241,195,77,45,6004
"39017010102",2073,478,89,46,44,65,73,31,2899
"39017010103",3806,1358,58,74,173,343,150,34,5996
"39017010104",11,56,9,13,0,0,0,0,89
"39017010201",20,0,0,0,0,0,0,0,20
"39017010202",3738,358,27,0,98,0,0,0,4221
"39017010203",5214,325,0,0,23,0,0,0,5562
"39017010301",4028,299,0,0,156,7,29,0,4519
"39017010302",3291,110,0,0,100,0,157,0,3658
"39017010500",1582,612,30,48,53,35,47,78,2485
"39017010600",2907,357,2,4,123,71,118,0,3582
"39017010800",6472,64,1,0,72,0,24,0,6633
"39017010901",3738,318,105,11,252,67,413,22,4926
"39017010903",4227,174,335,0,278,0,51,0,5065
"39017010904",2966,185,182,141,181,25,89,35,3804
"39017010906",3904,657,1735,489,342,140,473,348,8088
"39017010907",2120,75,143,0,113,0,38,0,2489
"39017010908",3658,261,1001,117,162,0,122,0,5321
"39017010909",2620,286,1224,162,451,150,508,149,5550
"39017010910",3918,100,253,74,121,0,174,14,4654
"39017010911",3782,139,139,0,64,0,29,0,4153
"39017011002",10911,168,1277,7,264,0,165,0,12792
"39017011003",5543,92,172,0,148,134,17,0,6106
"39017011004",3427,1121,683,164,162,143,138,637,6475
"39017011109",3482,370,71,114,107,82,115,28,4369
"39017011110",4687,134,231,3,190,0,117,0,5362
"39017011111",5651,290,86,0,665,41,39,0,6772
"39017011112",4177,89,575,0,524,0,159,0,5524
"39017011116",6465,420,417,0,914,56,77,82,8431
"39017011117",9291,395,642,29,899,181,452,359,12248
"39017011118",2802,19,71,0,193,0,46,0,3131
"39017011120",5782,109,626,308,536,183,0,0,7544
"39017011121",6773,352,489,0,284,85,96,53,8132
"39017011122",3708,29,820,0,918,18,514,18,6025
"39017011123",2211,787,537,751,199,60,502,648,5695
"39017011125",2899,16,69,0,365,166,74,0,3589
"39017011126",3648,498,594,58,1360,218,552,98,7026
"39017011127",3725,8,344,0,366,108,29,0,4580
"39017011128",2749,67,196,0,254,0,66,0,3332
"39017011129",3130,179,186,24,264,0,138,0,3921
"39017011130",4123,144,442,0,193,249,421,273,5845
"39017011131",2465,89,266,0,77,5,94,0,2996
"39017011200",6632,298,222,32,270,141,241,93,7929
"39017011300",4075,488,111,45,228,0,182,229,5358
"39017011800",5163,224,34,0,121,0,200,0,5742
"39017012100",2806,401,0,0,27,0,12,0,3246
"39017012200",1801,937,215,52,71,118,13,0,3207
"39017012300",1808,543,11,62,16,5,0,10,2455
"39017012400",2052,20,83,0,10,3,12,0,2180
"39017012500",4078,192,92,1,490,0,119,0,4972
"39017012600",2045,61,220,24,141,39,68,0,2598
"39017012700",2276,424,263,0,8,0,19,0,2990
"39017013000",306,206,579,208,12,4,46,30,1391
"39017013100",478,370,674,343,25,151,51,123,2215
"39017013200",2221,888,157,196,141,103,134,107,3947
"39017013300",1882,149,4,12,87,0,31,0,2165
"39017013400",1399,362,169,177,4,24,11,0,2146
"39017013500",1767,575,74,179,345,180,0,0,3120
"39017013600",3289,1038,245,222,179,24,508,125,5630
"39017013900",1954,593,7,0,26,135,21,0,2736
"39017014000",754,791,377,295,77,50,146,246,2736
"39017014100",1077,751,139,114,123,58,61,0,2323
"39017014300",4344,248,13,10,38,31,0,0,4684
"39017014400",741,632,25,74,10,9,18,68,1577
"39017014600",339,391,65,30,37,51,14,58,985
"39017014700",3010,664,49,129,59,13,6,22,3952
"39017014800",5481,753,136,348,213,153,261,0,7345
"39017014900",4539,330,61,0,57,19,42,0,5048
"39017015000",6894,478,149,0,96,26,354,26,8023
"39017015100",5444,1254,59,33,328,62,178,0,7358
"39019720100",3053,429,0,0,69,3,38,0,3592
"39019720200",2638,696,71,0,138,0,55,0,3598
"39019720300",4409,645,24,3,52,28,8,0,5169
"39019720400",3649,451,59,2,0,0,30,0,4191
"39019720500",3954,1102,6,25,35,21,30,0,5173
"39019720600",2920,525,0,0,32,5,77,0,3559
"39019720700",2481,559,0,0,112,0,47,10,3209
"39021010100",1898,50,0,0,32,14,10,0,2004
"39021010200",6091,944,43,12,142,27,27,45,7331
"39021010400",2631,1164,84,78,111,78,110,39,4295
"39021010500",2831,607,138,40,288,82,32,39,4057
"39021010600",2817,249,245,56,77,10,0,0,3454
"39021011001",2429,302,0,0,14,0,0,0,2745
"39021011501",3962,261,0,0,38,0,106,4,4371
"39021011504",4475,221,0,0,107,0,8,17,4828
"39021011505",2645,412,19,35,93,43,8,4,3259
"39021011506",2497,156,3,0,88,27,49,0,2820
"39023000200",300,227,493,483,89,97,5,73,1767
"39023000300",491,541,108,157,34,0,7,2,1340
"39023000400",872,566,184,66,192,113,121,188,2302
"39023000500",770,411,41,8,165,108,110,75,1688
"39023000600",1270,758,233,200,27,211,12,0,2711
"39023000700",558,716,97,91,41,139,12,123,1777
"39023000901",961,873,250,380,116,38,34,52,2704
"39023000902",128,189,589,91,35,24,13,0,1069
"39023001000",864,56,319,117,46,48,0,0,1450
"39023001101",263,231,483,187,130,104,81,53,1532
"39023001102",719,190,1642,400,79,106,0,0,3136
"39023001200",1012,1284,717,1115,78,296,5,40,4547
"39023001300",2442,848,127,23,105,33,59,0,3637
"39023001400",2187,500,420,43,150,11,93,0,3404
"39023001500",2960,1180,218,70,271,182,117,66,5064
"39023001600",3327,662,78,0,52,0,19,0,4138
"39023001700",1258,385,201,119,242,96,11,5,2317
"39023001900",2266,403,20,0,80,22,0,0,2791
"39023002000",2064,82,8,0,11,0,0,0,2165
"39023002100",897,425,30,0,75,28,67,8,1530
"39023002200",3795,253,125,0,86,0,46,0,4305
"39023002301",2650,528,0,0,27,0,18,16,3239
"39023002403",3034,310,235,34,197,124,89,164,4187
"39023002404",2398,251,211,17,105,0,34,0,3016
"39023002501",1784,139,31,5,9,5,1,5,1979
"39023002502",2391,366,59,0,78,62,8,0,2964
"39023002601",3498,270,4,0,47,0,2,0,3821
"39023002602",3375,611,9,3,51,13,25,13,4100
"39023002605",3470,107,107,7,54,0,6,0,3751
"39023002606",6726,444,0,1,222,0,46,38,7477
"39023002701",2614,608,95,0,54,0,369,119,3859
"39023002702",1613,359,0,0,197,145,229,199,2742
"39023002800",4301,158,0,0,127,1,4,0,4591
"39023002901",2875,525,23,0,321,78,93,87,4002
"39023002902",3304,781,0,0,208,65,209,182,4749
"39023003001",2698,135,29,0,112,0,41,0,3015
"39023003002",2948,315,37,0,83,0,62,0,3445
"39023003101",2271,93,31,0,97,0,28,0,2520
"39023003102",1714,242,0,0,54,34,7,0,2051
"39023003200",2511,195,22,0,45,0,42,0,2815
"39023003301",3119,262,0,15,82,38,137,12,3665
"39023003302",2025,430,0,0,45,3,0,0,2503
"39023003400",1854,1148,105,42,94,206,68,78,3595
"39023003700",3559,327,303,10,161,0,43,1,4404
"39025040101",4044,702,24,27,42,0,51,0,4890
"39025040102",2698,312,0,1,58,0,8,18,3095
"39025040202",1956,276,0,0,27,12,17,12,2300
"39025040203",5595,428,27,0,226,0,113,0,6389
"39025040204",5903,723,3,58,18,38,187,3,6933
"39025040301",3301,16,6,0,409,0,61,16,3809
"39025040302",3152,164,0,0,55,6,170,0,3547
"39025040303",6937,176,41,0,323,77,83,0,7637
"39025040401",3067,213,250,0,59,154,0,0,3743
"39025040403",2310,235,112,0,58,76,32,0,2823
"39025040404",3284,37,28,0,106,0,84,0,3539
"39025040405",2256,385,0,23,175,0,87,0,2926
"39025040500",3242,1036,222,26,103,12,12,0,4653
"39025040600",6314,139,44,0,199,0,104,0,6800
"39025040701",5629,765,141,116,63,0,46,0,6760
"39025040702",3502,346,16,0,66,10,212,74,4226
"39025040800",5119,548,14,4,278,0,50,0,6013
"39025040900",4254,1431,0,47,24,0,5,12,5773
"39025041000",5830,732,10,205,235,80,81,18,7191
"39025041101",2550,156,69,6,26,8,17,0,2832
"39025041102",2921,992,135,97,96,244,99,86,4670
"39025041103",7135,849,98,0,472,17,302,0,8873
"39025041200",7728,454,79,0,254,26,109,15,8665
"39025041303",4620,275,15,0,107,311,0,355,5683
"39025041304",44,0,0,0,0,0,0,0,44
"39025041305",4705,254,1,1,167,0,49,0,5177
"39025041306",3309,315,37,29,299,0,26,0,4015
"39025041307",4043,179,19,16,281,0,118,0,4656
"39025041403",3556,632,0,0,98,0,54,0,4340
"39025041404",3656,337,56,0,104,30,0,8,4191
"39025041405",4816,765,55,15,23,0,77,10,5761
"39025041406",4758,0,0,0,196,0,11,0,4965
"39025041501",5966,571,249,0,43,0,22,30,6881
"39025041502",6992,425,20,0,149,50,0,18,7654
"39025041600",4033,1025,59,0,39,0,5,27,5188
"39025041701",3803,712,44,0,61,0,24,0,4644
"39025041702",2849,254,20,0,23,23,15,23,3207
"39025041800",3104,611,0,10,27,7,36,6,3801
"39025041900",5064,586,0,0,15,0,0,0,5665
"39025042000",5506,848,13,0,146,0,64,17,6594
"39027964300",2719,1011,2,0,30,54,32,0,3848
"39027964400",4730,378,12,0,39,9,156,0,5324
"39027964500",5310,849,33,165,185,105,12,12,6671
"39027964600",1232,614,236,114,33,162,16,135,2542
"39027964700",3298,1031,238,74,0,49,10,187,4887
"39027964800",4489,419,9,0,19,10,0,0,4946
"39027964900",3992,753,0,0,107,32,0,0,4884
"39027965000",3485,387,54,0,101,0,34,0,4061
"39027965100",3263,564,0,0,84,75,19,0,4005
"39029950100",4285,1222,8,0,40,51,13,5,5624
"39029950200",4291,276,0,0,19,0,50,0,4636
"39029950300",4565,506,18,0,60,23,83,0,5255
"39029950400",3753,624,11,0,27,10,10,10,4445
"39029950500",4952,827,53,0,42,0,259,0,6133
"39029950600",4100,809,20,0,60,32,82,0,5103
"39029950700",3512,1326,0,1,193,20,56,1,5109
"39029950800",3755,525,0,0,23,0,35,0,4338
"39029950900",3599,267,26,25,27,2,11,0,3957
"39029951000",4309,1082,113,0,108,15,45,0,5672
"39029951100",3569,860,10,19,38,1,51,0,4548
"39029951200",3828,759,0,0,93,57,27,0,4764
"39029951300",3348,260,0,0,60,0,17,0,3685
"39029951400",4419,682,12,9,26,7,9,40,5204
"39029951500",3652,487,0,81,141,17,38,97,4513
"39029951600",5225,256,0,1,102,17,0,0,5601
"39029951700",4340,530,0,0,42,0,18,0,4930
"39029951800",2012,902,49,62,129,127,0,34,3315
"39029951900",2718,783,48,58,15,11,0,0,3633
"39029952000",2087,553,28,14,22,9,0,0,2713
"39029952100",734,380,78,28,28,2,0,0,1250
"39029952200",1217,515,88,97,60,36,2,44,2059
"39029952300",1959,680,107,129,71,119,68,0,3133
"39029952400",3464,308,51,72,120,56,1,0,4072
"39031960900",3945,499,0,0,35,6,0,0,4485
"39031961000",3820,925,123,0,67,9,23,0,4967
"39031961100",3712,587,45,0,17,6,28,0,4395
"39031961200",2246,413,0,0,7,0,7,0,2673
"39031961300",2723,996,45,0,72,39,97,0,3972
"39031961400",2416,764,0,68,19,26,0,0,3293
"39031961500",1479,656,35,26,64,111,11,17,2399
"39031961600",2186,267,0,3,74,31,0,0,2561
"39031961700",2358,318,0,0,66,0,88,0,2830
"39031961800",4151,783,3,0,19,46,31,9,5042
"39033974100",3120,226,0,1,69,5,34,5,3460
"39033974200",3818,290,0,0,27,0,28,0,4163
"39033974300",2242,504,5,0,80,11,54,4,2900
"39033974400",2678,596,4,0,55,4,17,0,3354
"39033974500",2883,820,0,50,97,80,4,0,3934
"39033974600",1937,472,68,0,0,21,64,100,2662
"39033974700",3609,216,94,0,21,8,44,0,3992
"39033974800",1552,439,4,0,9,103,0,0,2107
"39033974900",2658,635,0,43,29,0,11,0,3376
"39033975000",3204,457,0,0,30,58,36,95,3880
"39033975100",2083,600,0,62,96,18,14,0,2873
"39033975200",2327,273,0,0,0,0,46,0,2646
"39033975300",2522,826,0,0,9,51,11,0,3419
"39035101101",331,414,301,315,141,116,146,150,1914
"39035101102",2839,282,952,137,113,48,52,56,4479
"39035101200",957,715,304,264,56,117,191,351,2955
"39035101300",506,426,257,249,156,95,60,123,1872
"39035101400",873,395,309,142,212,42,176,170,2319
"39035101501",788,367,282,392,157,345,337,412,3080
"39035101603",718,558,340,447,238,51,474,361,3187
"39035101700",828,418,468,432,176,238,549,168,3277
"39035101800",886,524,158,416,19,135,143,229,2510
"39035101901",669,209,366,169,100,85,202,213,2013
"39035102101",1041,630,543,603,305,13,455,100,3690
"39035102102",1148,365,547,119,254,79,481,225,3218
"39035102200",1716,280,367,163,267,108,360,215,3476
"39035102300",831,419,496,78,181,171,295,452,2923
"39035102401",992,460,160,292,140,160,496,393,3093
"39035102402",1308,548,473,329,246,223,835,184,4146
"39035102700",1212,878,605,760,126,244,531,334,4690
"39035102800",491,661,89,289,176,27,348,392,2473
"39035102900",1032,491,118,100,225,131,722,396,3215
"39035103100",507,382,67,26,72,17,77,226,1374
"39035103300",497,88,422,1158,30,138,32,117,2482
"39035103400",1017,498,266,271,179,149,324,306,3010
"39035103500",1017,320,219,265,123,177,231,242,2594
"39035103602",1493,480,281,505,168,142,115,112,3296
"39035103800",950,326,273,44,131,150,344,210,2428
"39035103900",481,444,164,389,119,165,231,413,2406
"39035104100",385,390,39,74,61,38,181,248,1416
"39035104200",604,145,154,224,27,20,34,69,1277
"39035104300",1300,228,110,150,20,12,65,0,1885
"39035104400",814,419,41,83,21,44,56,38,1516
"39035104600",256,325,184,187,163,106,116,256,1593
"39035104800",907,253,152,294,85,280,416,420,2807
"39035104900",745,466,151,206,239,297,465,537,3106
"39035105100",1568,856,269,196,87,140,607,279,4002
"39035105300",1078,864,171,207,340,251,820,662,4393
"39035105400",1623,662,528,171,318,263,809,422,4796
"39035105500",606,543,163,271,75,219,132,314,2323
"39035105602",820,515,319,309,167,343,297,277,3047
"39035105700",2287,925,423,162,447,28,436,14,4722
"39035105900",1969,581,46,23,182,125,202,161,3289
"39035106100",2431,383,261,77,515,21,774,112,4574
"39035106200",2467,406,122,129,384,283,499,192,4482
"39035106300",1928,385,194,204,258,172,561,98,3800
"39035106400",727,108,79,5,59,59,94,60,1191
"39035106500",2193,391,91,0,178,0,311,0,3164
"39035106600",2474,779,103,10,116,234,242,236,4194
"39035106800",1367,617,219,363,278,85,474,239,3642
"39035106900",2679,630,157,51,167,96,287,153,4220
"39035107000",1375,62,33,3,96,0,156,18,1743
"39035107101",1726,284,272,210,76,33,63,21,2685
"39035107701",892,310,235,276,166,50,19,20,1968
"39035107802",684,589,264,958,614,296,83,18,3506
"39035108201",791,223,139,134,210,54,61,14,1626
"39035108301",289,118,161,192,523,167,140,12,1602
"39035108400",141,189,110,262,442,88,16,139,1387
"39035108701",75,106,1044,2705,49,82,5,62,4128
"39035109301",6,91,526,721,8,52,0,70,1474
"39035109701",0,0,368,1165,0,61,0,0,1594
"39035109801",0,0,403,1365,0,13,0,0,1781
"39035110501",136,140,210,88,118,18,108,24,842
"39035110801",462,193,307,177,0,75,149,134,1497
"39035110901",674,710,498,954,86,157,46,65,3190
"39035111202",157,66,432,497,152,36,66,24,1430
"39035111401",12,0,542,660,48,0,0,0,1262
"39035111500",149,161,269,354,24,18,10,25,1010
"39035111600",66,49,383,676,79,31,30,14,1328
"39035111700",67,41,364,513,0,5,19,20,1029
"39035111800",23,6,567,166,12,0,16,0,790
"39035111902",23,23,367,334,5,0,0,0,752
"39035112100",2,23,603,865,0,13,20,0,1526
"39035112200",9,9,553,584,8,15,8,33,1219
"39035112301",0,0,461,620,10,0,0,0,1091
"39035112400",11,9,743,248,14,4,15,8,1052
"39035112500",16,0,808,476,35,0,0,0,1335
"39035112600",38,5,355,624,15,46,15,0,1098
"39035112800",40,19,637,291,102,43,5,18,1155
"39035113101",0,13,255,345,0,0,0,0,613
"39035113500",0,0,780,482,0,14,0,0,1276
"39035113600",0,2,525,240,24,0,0,0,791
"39035113801",34,73,768,865,11,9,0,26,1786
"39035114100",0,2,677,493,0,0,27,0,1199
"39035114300",0,0,328,1230,0,5,0,0,1563
"39035114501",27,123,629,431,1,0,0,1,1212
"39035114600",336,179,402,324,0,11,0,0,1252
"39035114700",0,24,132,277,25,0,0,31,489
"39035114900",367,385,345,797,0,29,18,189,2130
"39035115100",445,183,159,330,24,32,60,18,1251
"39035115200",195,143,145,339,13,75,0,131,1041
"39035115300",104,162,218,448,0,0,0,0,932
"39035115400",507,315,340,361,32,16,32,0,1603
"39035115700",376,404,301,361,106,59,9,41,1657
"39035115800",1008,562,686,1005,25,0,176,0,3462
"39035115900",1249,254,1595,598,48,31,77,0,3852
"39035116100",0,10,502,509,12,9,0,4,1046
"39035116200",7,0,565,391,16,39,0,11,1029
"39035116300",15,0,1263,648,11,0,0,0,1937
"39035116400",44,2,1559,1457,56,57,0,23,3198
"39035116500",0,0,1257,737,16,0,1,0,2011
"39035116600",2,3,1488,1018,10,56,1,26,2604
"39035116700",10,0,992,655,0,0,21,0,1678
"39035116800",0,1,1886,765,6,0,0,0,2658
"39035116900",4,43,730,410,17,95,0,0,1299
"39035117101",502,52,1174,937,130,0,37,29,2861
"39035117102",0,5,687,521,0,0,0,0,1213
"39035117201",380,96,908,1630,0,42,0,18,3074
"39035117202",267,96,921,547,0,30,0,73,1934
"39035117300",74,70,1156,1107,23,51,25,62,2568
"39035117400",117,38,591,683,34,12,0,0,1475
"39035117500",318,75,1644,724,74,0,0,0,2835
"39035117600",624,121,1733,533,94,0,69,0,3174
"39035117700",1973,330,1605,624,126,9,0,0,4667
"39035117800",293,251,1015,611,22,22,4,0,2218
"39035117900",83,13,1678,613,21,4,0,4,2416
"39035118101",40,0,899,953,94,5,6,0,1997
"39035118200",16,16,783,1079,13,47,9,0,1963
"39035118301",256,0,1357,912,87,0,39,0,2651
"39035118400",10,6,1071,527,5,32,0,0,1651
"39035118500",0,56,526,184,5,3,0,0,774
"39035118602",1,15,948,1255,11,31,11,0,2272
"39035118700",353,384,267,351,34,155,0,22,1566
"39035118800",967,557,160,27,276,302,32,171,2492
"39035118900",87,40,711,589,117,16,39,19,1618
"39035119100",54,18,49,0,0,4,0,0,125
"39035119202",156,10,331,261,0,16,0,0,774
"39035119300",0,87,1327,2331,0,38,47,90,3920
"39035119401",181,96,994,313,250,36,23,0,1893
"39035119402",15,15,969,743,10,22,5,2,1781
"39035119501",683,147,1183,461,206,83,25,62,2850
"39035119502",447,135,1012,305,83,1,81,11,2075
"39035119600",96,27,1431,766,11,0,62,0,2393
"39035119701",8,16,878,427,65,38,29,8,1469
"39035119702",1,0,979,994,24,27,24,27,2076
"39035119800",0,2,1823,1877,9,26,0,1,3738
"39035119900",0,97,1122,461,42,17,7,0,1746
"39035120200",10,22,1393,958,18,26,0,40,2467
"39035120400",0,0,1617,738,33,0,13,0,2401
"39035120500",27,0,1421,1122,116,17,0,0,2703
"39035120600",10,33,2105,409,0,10,0,0,2567
"39035120701",1,13,873,611,0,0,0,0,1498
"39035120702",5,10,1039,540,24,0,7,0,1625
"39035120801",5,0,1395,534,30,0,74,9,2047
"39035120802",59,7,1226,619,0,5,0,0,1916
"39035121100",0,11,1260,936,0,25,0,0,2232
"39035121200",0,12,961,672,13,7,0,0,1665
"39035121300",74,92,1289,761,24,91,11,10,2352
"39035121401",0,0,1187,733,12,72,0,0,2004
"39035121403",10,14,1734,874,7,0,0,29,2668
"39035121500",8,32,2400,802,37,0,0,82,3361
"39035121700",9,13,2777,768,40,0,37,0,3644
"39035121800",14,32,1279,485,50,29,3,0,1892
"39035121900",0,0,950,264,11,0,11,0,1236
"39035122100",2,75,2224,773,28,41,0,1,3144
"39035122200",10,0,1200,377,14,59,28,0,1688
"39035122300",13,6,1201,767,80,0,42,15,2124
"39035123100",2215,141,27,0,136,56,0,0,2575
"39035123200",2591,373,96,0,120,15,127,9,3331
"39035123400",3211,340,70,0,112,12,196,113,4054
"39035123501",2057,550,183,238,86,110,188,84,3496
"39035123502",1714,439,179,78,303,175,255,231,3374
"39035123601",2441,226,223,37,83,7,103,43,3163
"39035123602",2246,191,87,122,102,30,77,30,2885
"39035123603",2898,173,62,62,74,9,137,28,3443
"39035123700",1874,189,30,31,262,0,175,43,2604
"39035123800",512,594,234,683,77,141,19,238,2498
"39035123900",1590,340,253,70,395,6,372,7,3033
"39035124100",2135,1002,564,387,585,247,607,582,6109
"39035124201",1893,260,206,239,168,77,371,182,3396
"39035124202",937,263,90,24,96,97,143,99,1749
"39035124300",1689,302,1147,613,704,182,526,364,5527
"39035124500",2305,525,326,112,396,99,338,31,4132
"39035124600",2010,990,326,237,228,149,534,227,4701
"39035126100",113,51,1954,539,11,0,2,0,2670
"39035127501",112,124,1879,1100,29,22,0,18,3284
"39035130103",4236,8,7,0,112,0,7,0,4370
"39035130104",3965,115,30,4,126,0,11,0,4251
"39035130105",3178,124,10,3,40,0,93,0,3448
"39035130106",3135,197,35,0,8,0,25,0,3400
"39035131102",1868,137,542,33,468,0,98,0,3146
"39035131103",3660,37,96,4,284,0,10,0,4091
"39035131104",2906,136,166,0,436,94,37,0,3775
"39035132100",1647,326,2048,290,94,231,223,0,4859
"39035132200",1352,202,1106,115,49,18,15,147,3004
"39035132301",1266,128,1707,247,97,23,9,49,3526
"39035132302",801,85,753,275,51,0,0,0,1965
"39035133103",398,156,2188,362,132,0,0,0,3236
"39035133104",511,76,1483,330,75,84,72,77,2708
"39035134100",920,87,160,36,57,47,91,0,1398
"39035134203",2934,153,68,3,187,0,112,0,3457
"39035134204",3264,519,125,21,37,63,0,0,4029
"39035134205",2545,192,119,0,47,0,153,1,3057
"39035134206",2561,213,64,28,84,71,46,0,3067
"39035134300",1804,151,258,16,6,0,4,0,2239
"39035135103",2174,32,31,0,11,6,49,0,2303
"39035135104",3839,42,47,0,80,13,25,0,4046
"39035135105",5185,299,22,19,276,0,0,0,5801
"39035135106",1234,31,0,0,0,0,0,0,1265
"39035136101",4710,309,36,0,719,5,69,0,5848
"39035136102",6026,175,486,38,811,154,292,0,7982
"39035136103",4968,366,0,1,341,0,0,1,5677
"39035137101",1639,313,138,69,296,46,186,19,2706
"39035137102",3093,608,203,18,458,21,406,140,4947
"39035137103",3087,394,68,0,496,76,411,12,4544
"39035138105",938,101,90,97,84,0,46,74,1430
"39035138106",2729,567,56,0,88,10,109,237,3796
"39035138107",1946,114,52,0,0,0,27,3,2142
"39035138108",3601,208,44,4,216,0,131,10,4214
"39035138109",3479,243,139,14,217,0,251,5,4348
"39035138110",3230,261,89,2,255,42,177,48,4104
"39035140100",170,66,1117,86,61,0,1,0,1501
"39035140301",74,21,1330,804,17,37,6,0,2289
"39035140302",907,205,1002,265,126,23,14,0,2542
"39035140400",1046,70,1531,184,181,0,4,0,3016
"39035140500",1257,167,1406,479,139,49,70,0,3567
"39035140600",395,32,397,81,81,0,60,0,1046
"39035140701",723,39,820,517,94,30,35,0,2258
"39035140702",529,29,883,103,78,30,0,4,1656
"39035140800",1528,515,1074,209,357,145,46,6,3880
"39035140900",557,31,1091,353,12,0,15,26,2085
"39035141000",272,53,262,559,5,0,24,60,1235
"39035141100",2261,591,219,378,697,121,44,31,4342
"39035141200",2067,334,360,15,250,96,76,0,3198
"39035141300",1555,206,133,252,108,118,52,0,2424
"39035141400",2050,16,194,121,139,36,88,0,2644
"39035141500",1256,158,138,111,55,29,1,35,1783
"39035141601",1296,53,188,25,96,0,48,0,1706
"39035141602",465,60,713,119,32,0,7,0,1396
"39035141700",985,29,315,21,129,0,67,0,1546
"39035150100",16,62,1726,486,7,0,16,0,2313
"39035150300",17,11,933,884,11,0,0,0,1856
"39035150400",0,0,793,530,0,26,0,21,1370
"39035151100",25,14,655,388,27,249,0,262,1620
"39035151200",39,7,586,683,42,0,0,0,1357
"39035151300",216,250,797,571,17,26,17,0,1894
"39035151400",1,119,1036,346,23,0,0,0,1525
"39035151500",5,4,781,464,25,9,3,0,1291
"39035151600",17,0,692,603,18,8,0,0,1338
"39035151700",26,65,629,462,18,51,33,59,1343
"39035151800",9,5,819,948,16,9,0,0,1806
"39035152101",1632,85,479,48,9,1,9,0,2263
"39035152102",1672,210,1473,662,116,24,22,0,4179
"39035152201",904,68,1669,452,87,0,45,0,3225
"39035152202",1771,132,1259,427,69,33,27,0,3718
"39035152301",1091,58,1197,139,117,0,19,0,2621
"39035152302",2335,404,1470,397,146,0,76,10,4838
"39035152303",2024,189,1110,478,96,0,148,0,4045
"39035152400",566,99,870,308,51,0,15,0,1909
"39035152501",1562,314,1352,67,142,11,109,0,3557
"39035152502",671,156,1174,375,162,30,63,17,2648
"39035152603",189,41,504,211,13,50,13,0,1021
"39035152604",1382,171,1546,1167,0,130,25,18,4439
"39035152701",91,10,1207,640,13,8,0,0,1969
"39035152702",379,23,1420,359,70,16,29,8,2304
"39035152703",532,102,1034,19,21,0,49,0,1757
"39035153103",2433,118,0,19,53,0,98,8,2729
"39035153104",2536,275,48,0,199,0,168,0,3226
"39035153105",3129,376,200,9,82,46,74,0,3916
"39035153106",3154,223,0,0,113,59,95,168,3812
"39035153107",2857,324,28,35,282,23,169,17,3735
"39035154100",1007,181,399,237,57,82,32,76,2071
"39035154200",826,149,190,284,6,37,90,0,1582
"39035154300",18,22,713,263,19,0,3,0,1038
"39035154400",1209,160,937,480,103,0,46,8,2943
"39035154501",2271,214,498,374,91,10,47,7,3512
"39035154502",1849,42,621,257,150,0,81,0,3000
"39035154601",2754,248,1212,167,206,60,137,0,4784
"39035154603",1897,221,805,174,50,0,50,0,3197
"39035154604",2345,167,830,147,154,12,60,0,3715
"39035154700",63,0,1912,679,0,0,30,0,2684
"39035155101",4678,128,71,1,312,45,115,14,5364
"39035155102",2817,111,42,8,107,0,35,47,3167
"39035156101",1187,43,29,0,40,0,70,0,1369
"39035156102",5636,162,1,0,38,0,14,1,5852
"39035160100",1849,89,18,0,11,0,63,16,2046
"39035160200",1913,77,61,15,83,0,61,0,2210
"39035160300",1717,51,30,0,51,122,81,12,2064
"39035160400",2240,573,171,0,137,69,35,8,3233
"39035160500",2755,486,61,34,65,0,150,38,3589
"39035160601",4062,360,516,24,95,15,307,30,5409
"39035160602",1671,363,360,169,240,155,168,32,3158
"39035160700",1124,484,120,7,11,31,57,38,1872
"39035160800",826,85,0,5,62,5,19,0,1002
"39035160900",3200,274,74,68,136,0,94,52,3898
"39035161000",1467,180,46,7,111,28,100,31,1970
"39035161100",3135,364,44,128,39,5,217,12,3944
"39035161200",2080,270,108,117,331,0,43,0,2949
"39035161300",1915,454,173,67,200,55,67,4,2935
"39035161400",2541,399,98,95,174,10,67,10,3394
"39035161500",2750,672,177,109,45,27,17,51,3848
"39035161600",1477,417,88,67,88,18,70,32,2257
"39035161700",1008,467,170,115,370,50,89,22,2291
"39035161800",408,392,97,72,155,24,11,2,1161
"39035170101",2144,68,393,28,104,0,0,0,2737
"39035170102",4374,174,247,376,72,10,113,1,5367
"39035170201",1869,108,50,4,1,0,9,0,2041
"39035170202",3399,71,73,12,58,22,9,0,3644
"39035171102",824,140,3045,659,20,85,36,0,4809
"39035171103",521,61,2316,791,126,0,35,0,3850
"39035171104",577,35,2384,1433,28,166,0,51,4674
"39035171203",1010,161,1160,194,85,32,0,0,2642
"39035171204",488,128,783,410,16,0,36,76,1937
"39035171205",831,151,1459,129,121,0,42,0,2733
"39035171206",1095,42,888,206,145,1,30,0,2407
"39035172101",2092,128,173,6,137,0,44,0,2580
"39035172102",2963,365,114,63,154,10,108,11,3788
"39035172103",2511,506,927,47,746,146,196,0,5079
"39035172201",3347,127,138,60,233,20,40,0,3965
"39035172202",2972,116,543,0,89,97,44,0,3861
"39035173103",2348,271,32,1,138,12,85,8,2895
"39035173104",3313,347,0,17,262,0,284,50,4273
"39035173105",2266,46,19,0,165,0,70,0,2566
"39035173106",1982,274,154,0,1252,117,38,57,3874
"39035173107",2296,47,4,0,46,0,26,0,2419
"39035174103",2533,274,13,89,38,12,146,0,3105
"39035174104",1971,144,57,0,37,0,114,0,2323
"39035174105",2463,247,16,0,221,0,158,0,3105
"39035174106",2515,123,72,0,178,9,37,0,2934
"39035174107",3583,328,14,0,81,0,0,0,4006
"39035174203",2845,75,131,0,164,0,35,0,3250
"39035174204",3299,188,19,0,361,0,124,15,4006
"39035174205",4262,163,89,0,288,15,355,12,5184
"39035174206",1617,53,26,23,261,0,127,0,2107
"39035174207",2492,379,149,1,109,7,142,7,3286
"39035175103",5756,379,185,0,345,0,168,0,6833
"39035175104",5103,481,170,0,460,10,96,20,6340
"39035175105",4473,128,0,1,251,1,24,18,4896
"39035175106",2787,76,0,0,177,0,0,0,3040
"39035175201",5706,144,32,1,275,10,177,0,6345
"39035175202",2877,108,33,34,48,9,73,0,3182
"39035176100",1969,60,0,2,5,7,15,0,2058
"39035176200",5272,217,37,4,144,0,122,15,5811
"39035177101",2737,466,272,54,249,148,203,53,4182
"39035177103",2619,698,142,31,282,135,165,130,4202
"39035177104",2910,478,6,4,68,67,93,52,3678
"39035177201",3310,254,5,26,257,49,97,41,4039
"39035177202",2927,373,188,0,91,56,275,0,3910
"39035177302",2196,117,0,0,43,0,231,0,2587
"39035177303",3869,643,9,15,179,59,225,19,5018
"39035177304",2025,514,108,65,186,181,96,210,3385
"39035177403",2764,322,0,0,139,0,141,0,3366
"39035177404",2624,182,7,10,36,18,33,17,2927
"39035177405",3975,250,0,0,140,9,68,0,4442
"39035177406",3112,478,292,2,276,11,285,103,4559
"39035177501",3406,567,12,0,121,1,241,73,4421
"39035177503",3167,218,42,10,176,0,171,0,3784
"39035177504",3478,316,28,104,40,33,68,11,4078
"39035177505",4144,138,0,0,60,0,76,0,4418
"39035177604",1867,115,32,8,35,7,53,7,2124
"39035177605",2651,184,0,0,61,0,120,0,3016
"39035177606",2917,145,48,37,182,21,231,27,3608
"39035177607",3060,416,34,15,578,11,356,10,4480
"39035177608",4229,530,321,11,61,90,27,14,5283
"39035177609",1780,138,3,11,55,0,31,0,2018
"39035178101",2102,253,63,56,319,0,109,50,2952
"39035178102",3658,586,91,216,393,11,68,0,5023
"39035178201",3035,200,34,2,182,0,171,10,3634
"39035178204",3106,964,116,0,215,33,217,13,4664
"39035178205",1722,105,0,0,40,6,18,13,1904
"39035178206",2399,214,1,3,110,18,18,0,2763
"39035179101",2568,191,141,0,177,8,128,0,3213
"39035179102",2308,43,56,0,327,11,60,0,2805
"39035180102",1897,241,1239,52,352,52,74,0,3907
"39035180103",1663,154,1450,68,228,0,16,0,3579
"39035180104",910,33,1446,286,206,26,156,0,3063
"39035181100",5718,162,0,0,92,0,29,2,6003
"39035181201",4993,486,166,29,118,22,22,104,5940
"39035181203",2908,115,70,0,24,0,60,15,3192
"39035181204",4782,146,0,17,98,12,58,0,5113
"39035182103",2406,131,15,0,61,0,0,0,2613
"39035182104",2289,91,19,1,126,0,105,0,2631
"39035182105",3178,202,0,0,86,0,7,0,3473
"39035182106",2981,54,25,1,61,8,24,0,3154
"39035183100",1559,169,421,61,568,178,0,25,2981
"39035183200",2026,13,174,9,182,2,73,0,2479
"39035183300",3471,67,440,41,295,0,152,18,4484
"39035183401",1368,31,387,104,221,37,73,38,2259
"39035183402",137,20,873,115,86,4,4,0,1239
"39035183501",1493,122,1155,44,472,5,193,9,3493
"39035183502",2409,73,592,278,268,27,54,0,3701
"39035183603",30,43,788,417,73,0,15,0,1366
"39035183604",409,89,1335,253,72,29,12,7,2206
"39035183605",1250,29,1014,67,411,0,23,0,2794
"39035183606",509,22,887,29,126,42,10,0,1625
"39035184103",3322,39,199,0,336,14,50,0,3960
"39035184104",1254,32,235,47,156,0,109,0,1833
"39035184105",2869,25,812,22,1025,8,65,0,4826
"39035184106",1577,157,367,24,196,0,123,8,2452
"39035184108",5363,130,605,6,996,224,148,0,7472
"39035185101",505,18,1642,180,198,0,0,0,2543
"39035185102",1311,101,1286,0,100,0,0,0,2798
"39035185103",1180,101,760,5,153,0,69,44,2312
"39035185104",2549,148,653,361,149,0,51,0,3911
"39035185201",366,62,1191,60,52,15,22,0,1768
"39035185202",2181,113,2413,317,150,0,192,0,5366
"39035185203",1945,238,632,43,137,172,64,0,3231
"39035186103",3831,79,126,0,240,0,65,0,4341
"39035186104",2372,194,29,0,74,0,24,62,2755
"39035186105",3059,122,191,7,91,0,131,0,3601
"39035186106",3201,837,137,155,511,115,343,44,5343
"39035186107",4993,195,165,1,338,0,0,0,5692
"39035186201",4888,163,94,14,440,0,178,0,5777
"39035186202",4031,90,238,11,351,1,125,1,4848
"39035186203",3373,43,140,0,120,0,107,0,3783
"39035186205",4605,33,27,0,359,10,51,0,5085
"39035186206",3616,27,51,0,473,0,9,0,4176
"39035187103",1309,278,886,393,65,55,43,0,3029
"39035187104",2306,247,517,45,145,15,82,0,3357
"39035187105",1491,143,136,16,112,23,186,10,2117
"39035187106",2698,292,297,12,151,0,56,0,3506
"39035188103",78,14,2589,680,127,18,23,7,3536
"39035188104",81,0,1261,307,5,0,5,0,1659
"39035188105",157,1,2539,571,55,8,9,0,3340
"39035188106",107,28,1803,398,0,2,0,0,2338
"39035188107",129,0,1782,458,45,0,0,0,2414
"39035189105",3788,128,1,4,180,49,97,1,4248
"39035189107",4150,243,0,3,308,0,30,73,4807
"39035189108",4223,253,37,10,416,3,264,3,5209
"39035189109",2978,96,53,0,92,9,61,5,3294
"39035189110",3521,189,193,0,202,16,255,0,4376
"39035189111",5390,312,119,0,737,74,127,119,6878
"39035189112",3209,87,55,7,486,0,35,0,3879
"39035190502",1944,193,0,0,17,0,0,0,2154
"39035190503",1678,4,19,3,25,7,82,4,1822
"39035190504",9439,388,263,0,454,0,302,0,10846
"39035192300",1418,76,2,2,10,10,38,0,1556
"39035192800",936,33,128,12,30,30,4,0,1173
"39035192900",1814,80,0,41,34,0,19,0,1988
"39035193800",62,10,526,192,11,3,11,0,815
"39035193900",57,11,304,194,8,10,9,8,601
"39035194100",1894,63,111,8,45,0,0,0,2121
"39035194300",2934,65,105,0,256,64,7,0,3431
"39035194500",2033,93,30,6,72,14,45,0,2293
"39035194800",100,61,648,68,78,49,29,18,1051
"39035194900",2557,24,253,89,332,37,120,0,3412
"39035195600",753,87,3066,365,430,17,65,4,4787
"39035195700",1213,359,2500,170,276,25,93,172,4808
"39035195800",3003,127,385,0,374,0,61,0,3950
"39035195900",3875,159,0,1,89,0,22,0,4146
"39035196000",543,68,920,33,26,0,6,0,1596
"39035196100",1675,354,160,221,87,60,41,2,2600
"39035196200",219,74,2103,1413,57,6,9,0,3881
"39035196300",3509,140,41,3,229,0,150,0,4072
"39035196400",725,229,1043,552,71,30,419,140,3209
"39035196500",14,6,797,709,18,0,14,0,1558
"39035980100",0,0,0,0,0,0,0,0,0
"39035980500",0,0,0,0,0,0,0,0,0
"39035981100",0,0,0,0,0,0,0,0,0
"39035990000",0,0,0,0,0,0,0,0,0
"39037500100",3711,279,4,3,10,2,4,2,4015
"39037510100",2972,712,23,8,72,19,255,70,4131
"39037520100",2680,494,6,0,7,7,43,12,3249
"39037530100",3891,437,0,0,42,0,15,0,4385
"39037540100",2891,462,0,0,39,10,38,7,3447
"39037550100",3148,289,11,0,8,12,27,0,3495
"39037555000",4800,824,8,30,108,9,16,33,5828
"39037555101",2868,491,13,144,28,38,35,0,3617
"39037555102",2961,960,23,2,121,30,8,9,4114
"39037560100",6112,991,25,14,74,36,46,7,7305
"39037570101",2655,228,0,0,100,18,14,0,3015
"39037570102",5075,660,2,0,46,0,8,53,5844
"39039958100",3999,209,6,0,175,0,123,0,4512
"39039958200",4166,721,19,12,61,11,141,65,5196
"39039958300",3210,465,0,0,226,38,237,28,4204
"39039958400",3424,521,28,0,182,32,233,85,4505
"39039958500",2742,637,123,5,223,48,348,89,4215
"39039958600",2873,451,53,136,200,64,224,154,4155
"39039958700",3453,348,103,19,139,303,363,323,5051
"39039958800",2199,748,99,23,112,15,475,89,3760
"39039958900",4493,253,53,60,405,0,501,0,5765
"39041010100",3233,524,57,28,47,51,115,26,4081
"39041010200",4814,357,39,13,60,18,57,0,5358
"39041010420",2364,309,64,14,168,0,71,0,2990
"39041010421",2035,217,48,0,41,0,36,0,2377
"39041010422",5374,220,114,14,187,50,86,0,6045
"39041010520",4540,152,351,77,121,27,33,0,5301
"39041010530",1725,703,177,167,279,30,45,0,3126
"39041011101",2354,567,0,0,95,1,74,17,3108
"39041011102",4820,228,53,27,131,0,55,0,5314
"39041011200",2851,177,46,0,30,0,21,0,3125
"39041011411",2445,35,99,0,320,17,36,0,2952
"39041011412",3909,49,47,0,463,25,125,0,4618
"39041011413",6044,146,154,4,673,22,62,0,7105
"39041011421",5752,28,279,7,528,0,152,11,6757
"39041011423",6449,11,86,0,366,41,9,0,6962
"39041011430",2441,86,79,0,59,0,107,0,2772
"39041011520",2990,87,169,106,282,17,146,0,3797
"39041011530",3042,194,66,0,390,43,262,0,3997
"39041011540",4769,40,210,0,666,0,104,0,5789
"39041011550",6437,616,357,4,1425,0,274,96,9209
"39041011560",7333,81,291,8,624,0,122,49,8508
"39041011561",3329,239,420,87,560,14,220,0,4869
"39041011604",5161,175,133,3,169,2,202,38,5883
"39041011710",4963,158,356,0,492,0,49,0,6018
"39041011730",5843,74,370,0,451,0,373,0,7111
"39041011740",5054,67,262,0,363,0,89,15,5850
"39041011750",6217,47,180,0,317,0,84,0,6845
"39041011760",3931,449,40,0,40,0,79,0,4539
"39041011762",4695,209,146,0,349,0,43,0,5442
"39041011900",4129,237,225,0,622,0,64,30,5307
"39041012000",4916,311,0,0,20,0,167,46,5460
"39041012100",6138,144,184,0,673,45,80,0,7264
"39041012200",4110,141,57,81,244,0,0,5,4638
"39041012300",3854,367,51,0,94,0,37,16,4419
"39041012400",4099,172,361,0,876,91,156,103,5858
"39043040100",5192,449,24,0,51,47,206,72,6041
"39043040200",3347,348,0,0,68,0,90,0,3853
"39043040300",5565,362,0,23,138,102,56,38,6284
"39043040400",4827,281,24,0,100,12,28,0,5272
"39043040500",3786,828,59,0,161,155,89,0,5078
"39043040600",843,22,10,0,20,0,9,0,904
"39043040700",2157,659,601,187,144,211,118,45,4122
"39043040800",1905,939,572,288,354,71,75,71,4275
"39043040900",2498,369,50,291,71,21,50,60,3410
"39043041000",1667,248,788,171,184,90,173,109,3430
"39043041100",2008,562,714,105,226,99,151,94,3959
"39043041200",1348,179,631,76,177,64,201,47,2723
"39043041300",2026,410,611,433,46,132,55,186,3899
"39043041400",1823,120,171,36,55,137,35,12,2389
"39043041500",3129,87,51,7,118,8,43,37,3480
"39043041600",5157,145,115,23,277,0,219,11,5947
"39043041700",5540,594,4,0,175,16,177,116,6622
"39043041800",5773,132,41,1,168,3,133,0,6251
"39043990100",0,0,0,0,0,0,0,0,0
"39045030100",3324,443,0,0,16,15,115,0,3913
"39045030200",2502,386,0,0,92,35,9,0,3024
"39045030300",2582,732,0,0,32,0,21,77,3444
"39045030400",4352,200,26,0,30,7,50,7,4672
"39045030600",7504,265,1147,55,628,85,306,0,9990
"39045030700",2782,125,189,0,147,20,0,7,3270
"39045030800",4903,246,2,5,122,0,64,0,5342
"39045030900",7450,214,14,0,157,6,43,0,7884
"39045031000",4984,494,2,0,28,26,3,0,5537
"39045031100",5158,767,32,6,6,16,47,3,6035
"39045031200",3845,532,6,1,33,1,10,1,4429
"39045031300",2395,536,0,16,55,11,0,0,3013
"39045031400",5526,767,96,2,244,100,113,27,6875
"39045031500",2270,330,0,129,16,8,117,7,2877
"39045031600",4892,1017,45,0,234,33,94,64,6379
"39045031700",2824,1385,0,0,40,31,0,0,4280
"39045032000",1871,868,0,29,71,8,78,13,2938
"39045032100",3189,357,22,8,38,0,52,0,3666
"39045032200",2259,1316,12,0,55,49,22,45,3758
"39045032300",3299,703,0,0,124,0,0,0,4126
"39045032500",4607,434,0,0,100,6,29,0,5176
"39045032600",6202,473,3,0,39,63,29,7,6816
"39045032701",2713,90,859,89,451,8,18,0,4228
"39045032702",3509,306,1723,724,1206,166,691,36,8361
"39045032800",3458,32,391,0,152,0,139,0,4172
"39045032900",8339,268,863,9,728,0,62,0,10269
"39045033000",3212,302,528,0,146,12,19,0,4219
"39045033100",7111,234,885,126,457,64,231,0,9108
"39047925800",3211,528,15,8,47,174,55,231,4269
"39047925900",2972,472,11,0,294,2,12,29,3792
"39047926000",3125,396,0,49,74,10,30,0,3684
"39047926100",3083,1364,112,18,121,22,43,0,4763
"39047926200",3227,967,225,24,125,52,81,0,4701
"39047926300",2663,559,0,0,83,15,30,17,3367
"39047926400",3591,454,6,16,56,12,0,0,4135
"39049000110",3291,142,22,0,155,17,44,0,3671
"39049000120",2793,129,18,16,172,0,32,0,3160
"39049000210",3077,110,25,3,74,0,83,15,3387
"39049000220",3656,134,35,0,88,0,48,0,3961
"39049000310",1706,186,774,240,95,52,54,19,3126
"39049000320",1611,108,516,24,108,31,12,18,2428
"39049000330",989,665,215,252,204,9,67,27,2428
"39049000410",2046,85,167,8,166,0,24,0,2496
"39049000420",2772,165,39,13,189,44,67,0,3289
"39049000500",3484,268,52,44,366,397,117,17,4745
"39049000600",2320,795,89,27,496,229,132,7,4095
"39049000710",1419,701,290,707,112,300,12,220,3761
"39049000720",439,188,828,566,127,206,10,7,2371
"39049000730",77,97,1717,1291,131,38,66,27,3444
"39049000810",1677,244,405,161,217,6,217,0,2927
"39049000820",1051,304,725,373,119,117,16,120,2825
"39049000910",590,344,1322,1225,82,110,10,42,3725
"39049000920",234,84,682,566,81,63,10,0,1720
"39049001000",2690,1492,54,188,179,226,129,48,5006
"39049001110",616,1455,0,28,135,426,46,36,2742
"39049001121",23,257,0,0,4,4,7,4,299
"39049001122",443,361,33,73,262,238,18,27,1455
"39049001200",626,2563,50,126,58,306,45,61,3835
"39049001300",877,2940,74,173,142,212,81,146,4645
"39049001400",97,102,722,773,149,0,0,15,1858
"39049001500",26,43,393,1286,70,146,8,0,1972
"39049001600",330,281,140,419,27,63,33,87,1380
"39049001700",500,564,67,366,125,346,87,180,2235
"39049001810",630,1923,19,81,223,245,53,45,3219
"39049001820",1621,412,216,116,212,65,97,29,2768
"39049001901",1672,323,129,0,78,9,108,0,2319
"39049001902",2631,386,13,70,244,77,94,11,3526
"39049002000",2666,333,98,59,256,0,102,0,3514
"39049002100",1232,178,77,3,81,11,42,0,1624
"39049002200",1276,358,84,52,104,0,49,9,1932
"39049002300",149,119,522,464,12,64,5,27,1362
"39049002510",380,274,1785,540,132,81,69,153,3414
"39049002520",369,114,1226,685,51,60,0,0,2505
"39049002600",858,413,1011,781,386,311,526,349,4635
"39049002710",146,97,705,616,149,145,87,153,2098
"39049002730",336,26,647,814,170,170,92,97,2352
"39049002740",1737,198,329,102,37,0,10,0,2413
"39049002750",600,155,750,807,58,0,166,0,2536
"39049002760",1513,220,900,594,111,82,94,66,3580
"39049002770",413,87,682,564,161,129,74,86,2196
"39049002780",1137,118,735,34,112,0,65,0,2201
"39049002800",308,212,876,596,129,61,9,7,2198
"39049002900",106,143,555,1389,6,322,54,97,2672
"39049003000",1773,330,146,400,176,108,56,53,3042
"39049003200",1731,316,63,19,205,0,157,9,2500
"39049003600",234,70,785,302,18,19,68,1,1497
"39049003700",533,236,1209,769,270,46,24,10,3097
"39049003800",838,178,586,330,74,23,0,0,2029
"39049004000",1621,483,369,274,177,26,41,22,3013
"39049004200",99,134,11,394,0,54,0,0,692
"39049004300",3055,1265,332,195,142,101,80,0,5170
"39049004500",2509,1047,289,358,261,82,212,18,4776
"39049004610",2116,412,179,11,172,70,152,86,3198
"39049004620",1010,750,298,58,104,132,31,40,2423
"39049004700",1138,1611,940,600,90,323,168,218,5088
"39049004810",2069,792,196,87,69,103,62,114,3492
"39049004820",1069,738,161,194,54,135,99,170,2620
"39049004900",2258,1273,627,412,52,380,96,62,5160
"39049005000",1832,1272,279,643,160,250,67,56,4559
"39049005100",438,485,43,606,10,137,5,62,1786
"39049005200",2397,103,173,0,125,7,20,0,2825
"39049005300",467,183,1123,715,227,98,132,0,2945
"39049005410",95,73,524,590,18,137,42,27,1506
"39049005420",86,99,900,1036,104,56,0,0,2281
"39049005500",278,153,2240,1628,172,265,92,164,4992
"39049005610",352,108,667,576,58,54,12,0,1827
"39049005620",965,464,439,432,77,234,18,61,2690
"39049005700",2570,428,106,0,123,65,42,0,3334
"39049005810",2016,319,144,9,36,18,12,64,2618
"39049005820",1295,457,78,16,138,23,35,0,2042
"39049005900",444,127,908,617,64,59,25,11,2255
"39049006000",776,325,268,381,50,98,5,0,1903
"39049006100",1071,1033,366,191,119,90,128,148,3146
"39049006220",6051,117,164,0,883,30,543,31,7819
"39049006230",10091,570,371,51,4503,60,223,0,15869
"39049006236",5495,170,15,0,478,0,326,10,6494
"39049006310",4158,109,17,0,277,9,158,14,4742
"39049006321",3991,80,9,0,410,20,168,0,4678
"39049006323",2833,213,0,155,209,80,55,0,3545
"39049006330",4213,419,18,17,133,14,145,0,4959
"39049006340",2650,39,20,0,211,51,0,0,2971
"39049006351",2976,257,89,7,351,138,132,0,3950
"39049006352",1524,685,124,34,445,171,127,141,3251
"39049006353",3072,405,174,0,474,0,90,0,4215
"39049006371",4960,677,314,47,892,160,184,0,7234
"39049006372",3385,1199,990,34,1073,182,718,44,7625
"39049006383",6899,627,645,35,1027,194,774,207,10408
"39049006384",5597,64,185,16,813,2,262,0,6939
"39049006386",3050,150,38,19,746,62,537,105,4707
"39049006387",4482,336,355,18,525,319,254,311,6600
"39049006391",4194,62,207,0,364,0,81,0,4908
"39049006392",3701,24,136,0,502,0,85,0,4448
"39049006393",4331,84,181,212,804,54,48,42,5756
"39049006394",2026,89,497,65,112,0,11,12,2812
"39049006395",2288,198,81,0,577,113,148,31,3436
"39049006396",3363,416,407,36,460,144,253,0,5079
"39049006410",2408,127,44,35,203,0,37,47,2901
"39049006430",3866,100,43,0,640,0,355,0,5004
"39049006500",3471,59,0,0,82,0,0,0,3612
"39049006600",3295,302,29,0,147,9,32,0,3814
"39049006710",2490,105,23,0,230,0,125,0,2973
"39049006721",3222,8,0,1,123,9,52,9,3424
"39049006722",2484,203,35,0,165,18,31,0,2936
"39049006810",2024,45,0,0,40,0,61,0,2170
"39049006821",2206,644,188,156,228,72,223,7,3724
"39049006822",1868,43,6,1,49,0,42,0,2009
"39049006910",1484,3,9,0,76,0,0,0,1572
"39049006921",2173,640,522,192,322,140,344,343,4676
"39049006923",1848,224,747,115,184,45,94,65,3322
"39049006924",1956,157,899,237,123,111,129,0,3612
"39049006931",1857,298,2130,977,975,141,430,175,6983
"39049006932",2308,277,2068,765,797,66,452,71,6804
"39049006933",898,363,2322,1224,307,147,320,165,5746
"39049006942",517,50,423,112,134,63,88,21,1408
"39049006943",2291,269,939,654,278,54,123,54,4662
"39049006944",2860,120,578,252,236,33,246,0,4325
"39049006945",1604,724,2129,721,332,353,284,670,6817
"39049006950",2401,92,0,1,126,0,0,0,2620
"39049006990",4768,189,665,421,354,78,385,42,6902
"39049007010",1579,317,120,317,121,0,155,12,2621
"39049007020",5138,422,114,0,287,152,124,29,6266
"39049007041",1513,46,75,0,195,0,45,5,1879
"39049007043",3432,207,287,189,486,17,622,233,5473
"39049007044",3982,119,460,0,1558,59,235,0,6413
"39049007047",2450,387,416,121,457,32,203,136,4202
"39049007048",4278,110,444,179,1013,84,120,0,6228
"39049007112",3121,159,2080,542,502,16,51,24,6495
"39049007113",1885,328,1456,282,297,102,106,46,4502
"39049007114",2003,367,1483,514,173,98,20,9,4667
"39049007115",2114,249,1429,769,389,16,302,14,5282
"39049007120",3583,266,707,43,433,83,106,0,5221
"39049007132",5205,139,1401,103,874,63,488,68,8341
"39049007193",5602,76,306,0,241,18,148,0,6391
"39049007194",5013,384,235,149,552,22,0,30,6385
"39049007198",2201,216,281,43,195,12,43,0,2991
"39049007199",3616,175,1317,83,481,0,203,0,5875
"39049007201",435,48,0,0,31,0,0,0,514
"39049007202",1869,142,992,64,185,97,8,0,3357
"39049007203",2804,296,153,0,672,0,65,0,3990
"39049007205",3686,19,152,0,270,0,44,0,4171
"39049007207",3392,79,320,63,488,26,100,0,4468
"39049007209",4851,127,259,327,828,0,71,0,6463
"39049007210",7558,115,73,0,764,0,269,0,8779
"39049007393",7179,135,897,169,503,22,14,0,8919
"39049007394",2375,9,42,0,94,0,87,0,2607
"39049007395",7925,563,3087,596,1050,0,299,0,13520
"39049007396",6135,371,1824,1259,575,76,136,15,10391
"39049007424",3784,329,732,124,369,76,119,33,5566
"39049007425",2306,146,219,6,72,0,4,0,2753
"39049007426",2237,246,210,40,44,0,18,0,2795
"39049007427",4436,294,884,223,192,44,80,0,6153
"39049007492",4734,96,811,0,396,0,105,0,6142
"39049007494",3227,239,347,53,195,58,95,0,4214
"39049007511",96,55,902,540,55,11,34,18,1711
"39049007512",253,57,2441,973,98,0,17,0,3839
"39049007520",273,338,943,1272,346,66,171,27,3436
"39049007531",603,176,774,853,196,127,248,52,3029
"39049007532",289,142,1026,612,190,6,266,93,2624
"39049007533",122,146,1032,234,104,169,109,203,2119
"39049007534",178,247,1464,1166,55,152,0,196,3458
"39049007550",296,92,1494,540,196,28,128,0,2774
"39049007551",1119,230,4519,2492,610,24,395,53,9442
"39049007710",1647,523,1108,506,179,264,120,162,4509
"39049007721",1264,425,1110,780,492,1068,319,71,5529
"39049007722",1336,673,481,201,124,208,22,11,3056
"39049007730",1729,307,798,51,137,37,69,10,3138
"39049007740",1220,270,203,61,73,7,25,111,1970
"39049007811",2601,553,71,40,128,124,44,39,3600
"39049007812",2904,850,142,90,157,91,128,19,4381
"39049007820",1290,604,104,46,1010,541,33,9,3637
"39049007830",1282,369,84,41,357,193,41,71,2438
"39049007921",7066,555,98,427,874,0,61,0,9081
"39049007922",3906,109,84,0,417,20,54,0,4590
"39049007931",3931,154,0,138,257,0,257,0,4737
"39049007933",7180,393,95,0,727,0,258,0,8653
"39049007941",1907,86,223,21,395,52,8,0,2692
"39049007951",8279,342,364,47,651,110,217,0,10010
"39049007952",6508,343,45,47,310,0,154,0,7407
"39049007953",5012,567,125,149,699,142,174,18,6886
"39049007954",4788,1153,472,785,691,283,439,461,9072
"39049008000",4879,200,19,10,250,28,55,0,5441
"39049008110",2633,422,554,19,170,15,172,23,4008
"39049008120",2661,580,71,96,203,29,409,151,4200
"39049008132",4987,932,445,165,611,115,1106,346,8707
"39049008141",6722,443,261,188,1038,0,769,0,9421
"39049008142",4556,528,318,117,1142,60,707,0,7428
"39049008161",5224,839,688,272,466,49,612,130,8280
"39049008162",6355,842,271,228,822,152,888,590,10148
"39049008163",2137,1401,89,13,131,41,324,781,4917
"39049008164",2357,1093,209,179,137,49,359,528,4911
"39049008210",870,661,288,31,132,108,17,364,2471
"39049008230",491,344,227,125,212,134,454,110,2097
"39049008241",1208,513,219,109,36,14,43,154,2296
"39049008242",4416,339,277,0,630,176,46,166,6050
"39049008311",2602,399,268,1301,395,110,621,388,6084
"39049008312",1880,781,225,1173,178,284,229,386,5136
"39049008321",1624,442,161,80,168,183,55,125,2838
"39049008322",2378,972,175,194,290,86,93,39,4227
"39049008330",1011,366,0,0,36,0,0,15,1428
"39049008340",3298,795,406,268,606,100,114,0,5587
"39049008350",2819,982,457,2447,377,148,681,255,8166
"39049008360",4387,619,307,130,581,0,41,0,6065
"39049008370",5770,1080,86,55,299,12,22,0,7324
"39049008380",3509,319,188,13,241,60,164,50,4544
"39049008400",2767,80,23,0,118,14,18,0,3020
"39049008500",4223,183,0,22,186,0,146,0,4760
"39049008710",516,138,1524,417,257,0,0,12,2864
"39049008720",732,247,1186,189,486,294,343,300,3777
"39049008730",162,122,423,574,111,182,131,174,1879
"39049008811",1032,549,232,6,41,0,11,24,1895
"39049008812",669,69,1600,491,154,9,117,0,3109
"39049008813",324,111,1269,790,75,0,6,0,2575
"39049008821",2024,606,61,0,77,31,8,58,2865
"39049008822",2584,631,536,375,156,155,97,44,4578
"39049008825",5337,961,332,153,162,46,75,0,7066
"39049008900",3153,609,299,0,124,11,68,12,4276
"39049009000",2701,198,182,1,29,1,0,0,3112
"39049009100",4044,266,221,10,264,8,191,0,5004
"39049009210",1177,389,1588,579,467,329,317,49,4895
"39049009220",1089,229,174,181,185,77,173,0,2108
"39049009230",2410,558,824,653,421,105,628,242,5841
"39049009240",1229,289,137,42,179,82,147,90,2195
"39049009250",1200,328,234,4,134,0,114,17,2031
"39049009311",945,117,1109,369,374,82,78,184,3258
"39049009312",778,104,1198,599,292,23,333,0,3327
"39049009321",426,56,914,172,528,229,264,226,2815
"39049009322",1116,75,1599,394,376,269,223,133,4185
"39049009323",637,111,1458,656,369,240,349,50,3870
"39049009325",508,651,1514,1078,0,0,75,493,4319
"39049009326",289,121,826,259,18,54,78,60,1705
"39049009331",209,13,295,317,36,55,10,50,985
"39049009332",389,137,1917,440,188,34,44,0,3149
"39049009333",316,84,1194,520,319,95,55,39,2622
"39049009334",357,40,1766,587,40,226,33,0,3049
"39049009336",760,259,1183,453,142,135,30,70,3032
"39049009337",485,8,2250,1126,31,58,206,0,4164
"39049009340",1249,236,610,492,405,28,521,0,3541
"39049009350",906,159,1051,122,314,38,241,90,2921
"39049009361",2636,107,1943,489,275,21,241,21,5733
"39049009362",4618,351,1157,636,132,0,76,0,6970
"39049009371",1404,375,2820,463,204,69,35,38,5408
"39049009372",1120,249,1660,590,365,18,180,0,4182
"39049009373",1234,141,2559,1868,352,138,139,74,6505
"39049009374",3731,558,2638,788,472,34,164,124,8509
"39049009381",3583,425,1231,245,367,0,440,0,6291
"39049009382",1863,251,187,49,360,91,34,126,2961
"39049009383",1347,135,501,152,210,0,23,2,2370
"39049009384",1355,216,360,96,274,0,191,84,2576
"39049009385",2451,147,630,89,125,13,23,7,3485
"39049009386",1255,328,981,548,61,0,415,44,3632
"39049009390",3627,444,915,0,648,0,34,36,5704
"39049009410",1549,420,532,373,0,0,49,19,2942
"39049009420",3498,387,1198,93,405,14,159,28,5782
"39049009430",4063,258,1996,774,595,306,352,26,8370
"39049009440",3446,278,758,14,132,0,36,0,4664
"39049009450",7189,167,1223,0,632,1,99,0,9311
"39049009495",2285,617,1108,135,473,45,301,26,4990
"39049009497",1558,62,1,0,18,0,9,7,1655
"39049009520",3367,300,295,222,28,28,18,0,4258
"39049009590",3871,648,430,38,190,17,86,0,5280
"39049009600",2790,428,400,243,127,34,114,31,4167
"39049009711",3378,610,117,0,172,40,107,0,4424
"39049009712",2367,256,7,2,19,0,0,0,2651
"39049009720",4944,899,170,73,229,247,117,258,6937
"39049009740",12784,425,94,43,795,31,43,0,14215
"39049009751",5052,248,30,27,169,13,0,0,5539
"39049009752",5203,375,265,47,187,0,217,0,6294
"39049009800",5756,814,48,49,141,69,0,0,6877
"39049009900",506,102,588,166,111,112,155,145,1885
"39049010000",3918,323,485,80,436,21,135,0,5398
"39049010100",259,11,620,0,152,5,0,0,1047
"39049010200",9183,351,4221,2019,1160,255,707,28,17924
"39049010300",1541,821,356,89,103,66,132,6,3114
"39049010400",5653,191,31,15,1572,77,304,0,7843
"39049010500",6520,132,212,0,1195,17,441,0,8517
"39049010601",3997,52,141,0,712,45,86,0,5033
"39049010602",5584,252,86,0,457,0,40,69,6488
"39049010700",1095,190,87,44,25,10,77,0,1528
"39049980000",0,0,0,0,0,0,0,0,0
"39051040100",2882,223,10,8,101,0,80,0,3304
"39051040200",4040,421,35,0,15,6,150,0,4667
"39051040300",4107,348,0,0,127,0,95,0,4677
"39051040400",3177,553,46,6,104,3,336,86,4311
"39051040500",4817,208,0,0,37,15,175,6,5258
"39051040600",3757,498,0,30,41,0,341,0,4667
"39051040700",5940,789,3,7,147,441,798,391,8516
"39051040800",3889,688,26,1,100,62,137,81,4984
"39051040900",3444,459,0,39,213,231,430,308,5124
"39053953500",3954,516,156,72,74,0,98,0,4870
"39053953600",3176,919,37,0,38,16,32,17,4235
"39053953700",2686,1082,50,120,108,18,110,0,4174
"39053953800",3321,595,0,0,41,11,0,0,3968
"39053953900",5530,1205,68,43,122,79,11,0,7058
"39053954000",2615,756,70,15,108,9,0,35,3608
"39053954100",1628,482,54,20,151,4,8,0,2347
"39055310100",1998,230,0,0,0,7,0,0,2235
"39055310200",1838,124,0,0,49,6,9,0,2026
"39055310600",6095,119,0,0,69,0,16,0,6299
"39055310700",3687,291,0,0,45,0,9,0,4032
"39055310800",6011,237,65,9,170,0,50,0,6542
"39055310900",2619,441,45,13,77,2,3,28,3228
"39055311000",3076,403,35,0,61,0,0,0,3575
"39055311300",3962,304,0,0,25,39,24,8,4362
"39055311400",4687,622,30,2,144,0,19,0,5504
"39055311500",4990,221,0,0,117,12,79,0,5419
"39055311600",3776,39,0,0,25,0,20,0,3860
"39055311700",3620,172,316,54,73,0,65,0,4300
"39055311800",6579,144,284,0,195,0,147,0,7349
"39055311900",6053,317,0,1,114,0,17,0,6502
"39055312000",2363,392,0,7,0,39,2,22,2825
"39055312100",3510,597,0,2,55,0,43,0,4207
"39055312201",4687,394,0,137,167,63,187,0,5635
"39055312202",3939,108,0,14,141,33,29,33,4297
"39055312203",4239,409,0,0,22,0,94,0,4764
"39055312300",3666,642,0,14,115,14,146,0,4597
"39055312400",1878,693,8,0,14,0,19,37,2649
"39057200101",1790,527,67,70,40,67,99,29,2689
"39057200103",2061,615,227,433,386,27,222,15,3986
"39057200104",1442,1329,380,394,288,216,39,45,4133
"39057200300",2373,881,62,59,72,67,12,1,3527
"39057200400",1343,454,68,5,153,11,14,0,2048
"39057200500",3722,1386,16,156,345,53,0,28,5706
"39057200600",2635,353,46,135,122,0,96,5,3392
"39057200700",2163,969,419,74,245,344,113,205,4532
"39057200900",4803,294,119,0,484,26,101,0,5827
"39057210100",3775,277,337,20,683,157,214,0,5463
"39057210200",7062,383,210,5,451,0,262,0,8373
"39057210300",3071,179,33,13,194,7,19,26,3542
"39057210401",4100,338,216,0,324,19,86,19,5102
"39057210402",4493,128,22,0,481,0,0,0,5124
"39057210500",4963,32,17,8,335,0,168,0,5523
"39057210601",7036,486,394,68,723,100,421,0,9228
"39057210602",4718,145,19,2,378,136,167,77,5642
"39057210603",5184,263,133,0,423,44,206,44,6297
"39057220100",7442,176,0,0,440,0,166,0,8224
"39057220200",5970,788,57,200,286,142,58,0,7501
"39057230100",2441,180,0,0,13,0,0,0,2634
"39057240100",2181,512,461,55,89,9,28,0,3335
"39057240200",2644,1052,291,133,60,165,82,44,4471
"39057240301",5887,1494,866,68,229,296,74,2,8916
"39057240302",1924,792,225,265,46,69,40,27,3388
"39057240500",3306,435,285,80,84,27,74,7,4298
"39057240600",1326,738,843,406,46,27,0,0,3386
"39057240700",1913,241,61,20,27,11,0,0,2273
"39057255000",2339,359,358,41,85,92,53,48,3375
"39057260100",3414,542,48,9,75,40,22,11,4161
"39057270100",3201,413,24,0,48,3,7,8,3704
"39057280101",2447,100,26,0,19,0,39,0,2631
"39057280102",1950,108,0,9,15,43,3,3,2131
"39057280200",1181,71,77,0,60,0,22,0,1411
"39057280300",1440,73,259,0,47,0,243,0,2062
"39059977100",3431,849,69,0,111,13,12,0,4485
"39059977200",4337,744,0,0,0,0,0,1,5082
"39059977300",2003,968,40,38,38,103,22,0,3212
"39059977400",3159,432,68,19,43,43,36,38,3838
"39059977500",2734,413,0,56,125,41,112,0,3481
"39059977600",2170,712,45,3,39,61,0,0,3030
"39059977700",3215,294,46,4,64,6,43,0,3672
"39059977800",2899,711,0,13,29,4,22,0,3678
"39059977900",3152,1105,247,0,44,0,0,0,4548
"39059978000",3677,693,36,0,71,7,5,0,4489
"39061000200",54,24,396,401,48,4,18,0,945
"39061000700",1035,129,147,20,175,28,98,19,1651
"39061000900",384,266,115,325,28,76,12,91,1297
"39061001000",601,140,269,355,87,0,35,0,1487
"39061001100",165,60,341,473,0,3,0,0,1042
"39061001600",129,47,161,561,48,15,0,0,961
"39061001700",115,67,184,368,3,176,0,0,913
"39061001800",633,97,248,305,134,3,26,3,1449
"39061001900",887,63,419,194,34,12,91,15,1715
"39061002000",904,62,406,131,73,11,35,13,1635
"39061002200",283,166,1191,458,34,59,8,0,2199
"39061002300",191,62,200,529,149,24,0,0,1155
"39061002500",824,1089,194,89,29,136,0,61,2422
"39061002600",1101,2129,180,277,224,111,87,68,4177
"39061002700",718,495,140,322,99,91,24,38,1927
"39061002800",606,202,134,137,18,219,7,71,1394
"39061002900",1819,932,322,35,478,609,0,0,4195
"39061003000",301,560,37,54,105,235,30,67,1389
"39061003200",254,405,221,211,233,133,17,6,1480
"39061003300",302,587,287,297,94,100,10,11,1688
"39061003600",10,40,407,633,27,0,17,0,1134
"39061003700",79,17,416,988,75,88,0,0,1663
"39061003800",37,39,1269,741,0,63,0,0,2149
"39061003900",83,113,797,829,13,0,0,0,1835
"39061004000",499,71,1013,542,83,3,54,37,2302
"39061004100",638,46,317,360,56,29,4,3,1453
"39061004200",1134,72,394,155,92,0,17,0,1864
"39061004500",919,126,0,0,19,0,37,0,1101
"39061004602",4091,225,62,222,95,11,18,12,4736
"39061004603",2531,167,119,13,107,0,73,0,3010
"39061004604",2885,362,97,75,0,45,136,0,3600
"39061004605",2008,136,157,0,35,94,0,0,2430
"39061004701",2758,78,25,21,74,7,29,0,2992
"39061004702",523,288,0,9,9,0,0,5,834
"39061004800",3095,76,0,0,123,33,31,0,3358
"39061004900",5644,441,270,89,403,45,86,0,6978
"39061005000",3667,211,454,83,411,38,208,55,5127
"39061005100",2148,142,49,19,120,0,88,2,2568
"39061005200",2912,114,54,158,197,15,70,0,3520
"39061005301",2040,233,202,59,164,20,62,0,2780
"39061005302",2271,212,142,74,169,20,50,11,2949
"39061005400",631,50,151,57,19,23,51,0,982
"39061005500",1037,133,1449,1128,113,52,36,10,3958
"39061005600",2880,511,1552,708,19,102,0,49,5821
"39061005701",1941,284,499,260,73,0,55,0,3112
"39061005702",2497,59,1147,548,121,48,39,2,4461
"39061005800",1256,65,2573,1061,174,61,67,0,5257
"39061005900",578,76,309,191,51,16,25,20,1266
"39061006000",2599,471,2095,537,198,0,229,177,6306
"39061006100",1298,547,610,214,51,54,464,38,3276
"39061006300",315,20,2776,426,144,0,38,0,3719
"39061006400",42,7,1766,1090,86,16,27,0,3034
"39061006500",1378,156,1606,917,151,33,38,0,4279
"39061006600",254,222,643,1021,42,50,30,0,2262
"39061006800",110,22,2273,1143,0,0,16,0,3564
"39061006900",81,25,1348,979,44,0,22,0,2499
"39061007000",1049,421,514,353,129,167,20,4,2657
"39061007100",2596,267,178,123,194,117,90,14,3579
"39061007200",1352,265,147,55,138,166,75,0,2198
"39061007300",549,137,796,372,47,75,24,62,2062
"39061007400",816,231,208,228,63,0,45,0,1591
"39061007500",922,248,291,256,75,0,20,0,1812
"39061007700",37,25,712,1790,26,144,0,24,2758
"39061007800",1101,304,480,242,31,60,28,0,2246
"39061007900",755,171,456,206,43,33,21,0,1685
"39061008000",337,185,1144,3033,22,141,89,10,4961
"39061008100",287,10,1657,495,164,30,94,0,2737
"39061008201",1276,137,2034,293,167,49,0,0,3956
"39061008202",977,226,1268,699,145,34,7,13,3369
"39061008300",1788,255,1817,361,110,0,230,196,4757
"39061008400",729,68,309,795,44,7,0,0,1952
"39061008501",358,103,592,2220,60,0,0,0,3333
"39061008502",15,114,213,1176,12,116,18,121,1785
"39061008601",157,82,871,1211,99,83,32,0,2535
"39061008800",283,192,1290,1503,43,54,129,125,3619
"39061009200",983,644,523,1014,264,403,224,347,4402
"39061009300",780,501,576,423,66,35,46,0,2427
"39061009400",511,451,128,473,35,171,0,143,1912
"39061009500",869,441,414,475,232,41,119,219,2810
"39061009600",2086,603,431,642,171,39,105,183,4260
"39061009700",2256,1475,851,1023,369,184,496,48,6702
"39061009800",622,371,477,472,66,208,40,169,2425
"39061009901",2974,507,480,18,114,0,0,0,4093
"39061009902",1933,660,295,360,184,6,92,6,3536
"39061010002",876,260,2690,1482,227,18,0,3,5556
"39061010003",1121,185,1818,659,100,332,9,220,4444
"39061010004",701,144,2561,937,282,419,31,396,5471
"39061010005",806,174,557,215,20,0,4,27,1803
"39061010100",1981,645,1543,691,98,118,78,20,5174
"39061010201",3051,734,888,508,104,24,43,0,5352
"39061010202",1523,85,492,268,123,0,86,0,2577
"39061010300",566,492,331,284,0,88,0,88,1849
"39061010400",893,142,40,0,24,0,0,0,1099
"39061010500",974,388,26,6,8,12,18,142,1574
"39061010600",1221,147,1,1,42,23,0,0,1435
"39061010700",1288,196,108,31,43,51,40,0,1757
"39061010800",312,36,299,33,109,0,0,0,789
"39061010900",1256,355,550,119,278,12,21,0,2591
"39061011000",253,28,1399,1085,0,127,0,0,2892
"39061011100",1146,90,1680,149,89,0,12,0,3166
"39061020401",4193,812,31,43,74,15,50,0,5218
"39061020403",4863,486,0,0,105,69,150,0,5673
"39061020404",4727,159,0,0,85,50,16,0,5037
"39061020501",2156,106,4,25,30,0,0,0,2321
"39061020502",4299,106,216,47,254,8,42,0,4972
"39061020504",2411,139,670,62,263,0,61,0,3606
"39061020505",3063,198,920,105,116,8,44,7,4461
"39061020601",5404,420,26,0,230,0,59,0,6139
"39061020602",6696,350,161,0,114,93,81,0,7495
"39061020701",5404,798,335,82,361,13,78,252,7323
"39061020705",1987,177,475,299,291,11,0,1,3241
"39061020707",4609,140,30,0,96,0,101,0,4976
"39061020741",1998,134,619,349,98,146,0,11,3355
"39061020742",2456,414,1051,147,121,17,193,51,4450
"39061020761",4472,615,988,34,520,0,10,33,6672
"39061020762",1567,600,643,215,31,21,12,30,3119
"39061020802",5215,304,100,6,91,0,0,0,5716
"39061020811",4326,540,1282,147,187,0,24,0,6506
"39061020812",3758,281,28,35,100,0,0,0,4202
"39061020901",2811,265,203,63,93,43,112,0,3590
"39061020902",3372,1147,613,110,29,86,7,121,5485
"39061021001",2529,106,27,90,19,0,0,0,2771
"39061021002",3319,297,0,0,71,0,73,0,3760
"39061021003",2839,369,0,0,0,0,0,0,3208
"39061021101",4680,206,0,0,71,1,58,0,5016
"39061021102",6116,176,0,0,197,0,22,0,6511
"39061021201",1926,73,0,0,0,0,0,0,1999
"39061021202",4878,341,131,53,98,0,0,0,5501
"39061021302",5176,215,0,0,60,2,0,0,5453
"39061021303",4298,413,28,2,55,0,34,0,4830
"39061021304",3932,314,62,32,91,38,6,0,4475
"39061021401",4037,699,110,44,107,84,80,104,5265
"39061021421",4082,137,0,0,151,0,0,0,4370
"39061021422",2393,177,12,0,177,79,126,0,2964
"39061021501",2031,227,1412,206,496,96,51,184,4703
"39061021504",1541,124,3023,1130,140,0,425,40,6423
"39061021505",901,64,1440,212,110,15,45,0,2787
"39061021506",486,7,2026,462,222,105,12,0,3320
"39061021508",3830,128,1008,18,326,20,87,20,5437
"39061021509",3303,169,1589,1412,216,115,26,0,6830
"39061021571",1332,81,1381,542,353,34,84,0,3807
"39061021572",1290,393,3519,521,191,38,531,184,6667
"39061021602",427,4,1443,964,188,55,0,0,3081
"39061021603",1886,249,845,440,166,0,176,0,3762
"39061021604",1105,30,1579,655,264,0,43,0,3676
"39061021701",1517,205,645,167,203,0,55,49,2841
"39061021702",1421,704,1089,860,167,117,62,0,4420
"39061021801",2546,476,2087,716,315,0,187,13,6340
"39061021802",1472,48,1276,264,30,13,0,0,3103
"39061021900",518,38,330,338,0,64,0,23,1311
"39061022000",3237,250,139,23,49,0,155,3,3856
"39061022101",2821,194,606,130,85,65,0,13,3914
"39061022102",3919,93,1426,501,482,36,200,0,6657
"39061022200",3116,165,857,88,181,19,182,0,4608
"39061022301",2762,1358,1093,330,280,308,607,1255,7993
"39061022302",4245,394,261,36,255,94,175,271,5731
"39061022400",1763,94,233,6,115,0,28,6,2245
"39061022500",1010,269,2051,218,213,49,58,0,3868
"39061022601",4733,107,349,12,506,0,0,0,5707
"39061022602",1478,214,628,0,297,7,110,75,2809
"39061022700",0,31,1898,1332,87,0,41,0,3389
"39061023001",2388,563,539,395,493,48,68,210,4704
"39061023002",4050,279,490,9,343,0,0,0,5171
"39061023100",2265,102,205,0,196,0,0,0,2768
"39061023201",2076,499,138,72,64,56,0,0,2905
"39061023210",3948,553,532,250,158,51,53,0,5545
"39061023222",2314,183,319,28,22,0,62,0,2928
"39061023300",3316,169,270,31,96,0,82,0,3964
"39061023400",559,165,2257,408,90,116,12,0,3607
"39061023501",3193,79,186,0,791,54,212,0,4515
"39061023521",1781,71,184,95,125,21,99,0,2376
"39061023522",4770,252,421,28,510,166,27,0,6174
"39061023600",3128,522,148,233,99,7,56,6,4199
"39061023701",2204,155,95,61,102,0,18,0,2635
"39061023702",2397,267,46,0,159,0,55,0,2924
"39061023800",2085,215,1928,457,345,0,89,18,5137
"39061023901",3349,227,199,0,857,9,84,41,4766
"39061023902",4453,75,17,1,302,0,54,0,4902
"39061024001",3798,154,521,37,488,73,143,0,5214
"39061024002",2111,180,21,8,155,1,19,0,2495
"39061024100",6180,246,2,0,177,0,205,0,6810
"39061024200",1838,11,242,221,132,27,13,0,2484
"39061024301",2363,120,253,330,786,7,71,0,3930
"39061024303",5432,497,214,151,313,0,48,0,6655
"39061024321",6709,295,150,0,459,0,341,0,7954
"39061024322",7128,258,196,0,516,65,555,0,8718
"39061024400",5962,135,340,42,748,12,81,0,7320
"39061024700",1455,97,43,32,31,4,17,0,1679
"39061024800",3066,116,0,0,110,0,114,0,3406
"39061024901",939,214,0,0,16,0,144,0,1313
"39061024902",7456,78,21,0,264,15,220,0,8054
"39061025001",5251,374,16,130,262,9,94,0,6136
"39061025002",6494,308,0,82,76,0,0,0,6960
"39061025101",4685,39,26,0,169,0,61,0,4980
"39061025102",6505,674,15,0,467,11,70,0,7742
"39061025103",5413,612,131,13,428,0,0,0,6597
"39061025104",1945,59,1,4,49,0,42,0,2100
"39061025200",2818,531,215,113,273,12,21,0,3983
"39061025300",2038,528,29,35,282,30,379,30,3351
"39061025401",1252,352,31,16,5,11,22,11,1700
"39061025402",2278,316,0,209,47,0,10,54,2914
"39061025500",2854,628,325,345,143,0,207,0,4502
"39061025600",2264,751,129,1,91,23,24,17,3300
"39061025700",948,583,204,96,24,9,36,15,1915
"39061025800",2987,288,515,369,186,0,26,8,4379
"39061026001",4558,231,11,0,54,13,51,23,4941
"39061026002",4217,297,37,0,111,0,0,0,4662
"39061026101",7105,523,0,2,26,46,0,45,7747
"39061026102",2582,317,59,0,0,0,14,0,2972
"39061026200",980,802,0,0,35,0,14,142,1973
"39061026300",319,581,56,115,15,16,0,59,1161
"39061026400",199,39,866,1169,31,0,8,0,2312
"39061026500",1322,129,243,525,43,17,110,10,2399
"39061026600",977,327,91,40,28,1,6,0,1470
"39061026700",80,42,523,584,0,6,0,0,1235
"39061026800",1387,86,32,0,46,4,14,0,1569
"39061026900",113,202,594,746,69,25,0,0,1749
"39061027000",65,228,1019,1934,81,68,35,46,3476
"39061027100",466,87,2049,1013,63,15,17,15,3725
"39061027200",406,316,752,580,63,55,18,9,2199
"39061027300",2417,121,42,0,16,7,14,0,2617
"39061027400",2215,619,886,563,51,41,272,296,4943
"39063000100",3313,433,1,1,180,68,180,93,4269
"39063000200",5278,108,62,35,150,0,95,0,5728
"39063000300",7771,659,15,0,242,67,188,197,9139
"39063000400",5937,604,12,10,343,347,465,245,7963
"39063000500",3098,1612,63,139,157,107,189,170,5535
"39063000600",4897,1145,88,58,611,218,223,231,7471
"39063000700",4814,382,99,13,211,15,183,0,5717
"39063000800",2714,581,86,80,171,63,108,8,3811
"39063000900",2699,1812,24,3,99,20,204,168,5029
"39063001000",5313,806,25,76,99,2,148,23,6492
"39063001100",3294,574,14,9,172,28,189,104,4384
"39063001200",5158,436,12,27,104,22,68,10,5837
"39063001300",4914,292,0,0,59,10,82,4,5361
"39065000100",2990,450,15,0,21,0,29,0,3505
"39065000200",3616,886,9,21,157,0,139,0,4828
"39065000300",3373,397,3,8,77,8,13,9,3888
"39065000400",3505,929,0,20,199,78,28,27,4786
"39065000500",3291,738,48,6,15,45,9,31,4183
"39065000600",2601,792,19,5,45,127,63,79,3731
"39065000700",3824,1069,8,3,94,6,13,0,5017
"39067975600",2775,1069,72,3,145,27,2,13,4106
"39067975700",2884,598,0,0,42,5,77,0,3606
"39067975800",1780,351,0,0,43,0,0,2,2176
"39067975900",1982,197,0,0,0,0,0,0,2179
"39067976000",2823,370,60,116,10,16,13,0,3408
"39069000100",4198,460,0,23,64,37,222,48,5052
"39069000200",3503,61,2,1,50,4,89,1,3711
"39069000300",4317,634,11,0,140,60,141,71,5374
"39069000400",2234,611,11,0,224,116,166,120,3482
"39069000500",2644,461,3,2,163,10,188,17,3488
"39069000600",2878,442,2,0,109,36,191,59,3717
"39069000700",3298,463,10,7,240,64,428,168,4678
"39071954400",2807,979,35,6,22,54,0,0,3903
"39071954500",2862,1218,0,0,20,10,22,0,4132
"39071954600",4525,774,10,0,7,20,12,0,5348
"39071954700",5252,922,0,0,40,0,6,0,6220
"39071954800",2801,1100,39,33,61,171,13,59,4277
"39071954900",2483,568,195,83,211,81,0,11,3632
"39071955000",2992,1101,68,19,0,49,0,17,4246
"39071955100",4944,770,76,0,185,11,161,0,6147
"39071955200",4385,696,0,0,38,0,33,0,5152
"39073964900",3944,488,0,1,43,11,22,0,4509
"39073965000",2547,567,0,0,41,0,0,0,3155
"39073965100",4074,667,10,11,6,21,0,0,4789
"39073965200",3649,821,42,21,68,72,56,51,4780
"39073965300",2846,682,0,5,23,16,0,13,3585
"39073965400",3084,823,27,14,120,0,67,0,4135
"39073965500",2942,553,0,0,126,0,6,0,3627
"39075976301",3796,938,0,0,0,0,16,0,4750
"39075976302",5249,639,12,0,24,0,0,0,5924
"39075976400",7924,1015,0,0,22,0,47,0,9008
"39075976500",4597,709,0,0,16,0,0,83,5405
"39075976600",3382,582,97,29,70,57,50,65,4332
"39075976700",3018,572,2,0,38,57,90,16,3793
"39075976801",4288,342,0,0,43,13,6,0,4692
"39075976802",3561,1123,0,0,57,8,0,0,4749
"39077915400",4401,439,0,0,74,9,56,11,4990
"39077915500",4714,616,0,3,447,13,368,46,6207
"39077915600",3867,509,1,81,244,68,94,34,4898
"39077915700",3033,610,81,1,91,176,300,216,4508
"39077915800",3927,852,57,17,42,75,83,246,5299
"39077915900",3811,250,0,0,32,0,37,0,4130
"39077916000",3580,306,0,0,18,43,53,14,4014
"39077916100",3125,369,39,0,71,49,57,0,3710
"39077916200",3491,870,9,26,284,553,384,670,6287
"39077916300",2385,480,13,36,209,156,358,224,3861
"39077916400",4178,588,1,2,149,7,60,7,4992
"39077916500",4589,287,0,14,0,22,25,6,4943
"39077916600",3096,567,117,17,146,4,96,0,4043
"39079957200",3989,853,0,0,68,154,0,0,5064
"39079957300",2404,902,3,0,24,65,8,0,3406
"39079957400",3969,1334,107,0,42,0,8,0,5460
"39079957500",4081,1039,0,67,73,49,79,87,5475
"39079957600",2153,634,0,12,27,0,6,55,2887
"39079957700",3827,1258,0,0,96,58,12,0,5251
"39079957800",3888,1204,0,0,75,60,46,0,5273
"39081000200",275,603,196,207,21,124,44,0,1470
"39081000400",1032,1140,536,476,83,94,26,19,3406
"39081000600",1766,264,41,33,42,16,0,23,2185
"39081000800",258,137,92,185,31,28,0,1,732
"39081001000",2213,176,100,1,0,0,39,0,2529
"39081001200",3872,413,327,89,112,93,40,0,4946
"39081001300",707,369,21,60,63,56,0,0,1276
"39081001400",2889,439,204,78,52,0,140,0,3802
"39081001700",856,339,236,226,128,65,0,127,1977
"39081011000",1321,271,1,0,2,2,0,0,1597
"39081011100",2648,549,21,0,36,7,0,0,3261
"39081011200",1310,641,0,54,0,6,40,2,2053
"39081011300",2156,379,0,0,91,4,39,0,2669
"39081011401",3503,655,77,16,43,63,0,0,4357
"39081011402",3557,244,0,0,101,0,48,0,3950
"39081011500",4565,336,36,8,23,0,90,7,5065
"39081011700",3727,323,120,0,132,14,18,0,4334
"39081011800",2773,377,111,0,45,90,0,0,3396
"39081011900",3048,553,0,8,14,0,0,0,3623
"39081012000",2735,202,26,28,12,20,49,0,3072
"39081012100",2604,313,9,2,5,3,7,0,2943
"39081012200",1594,332,2,0,10,0,4,0,1942
"39081012300",1928,353,9,0,16,0,0,0,2306
"39083006700",4173,752,0,7,98,9,64,0,5103
"39083006801",5118,418,20,2,86,0,12,0,5656
"39083006802",3438,689,15,0,119,0,54,41,4356
"39083006900",5714,711,21,0,54,33,29,11,6573
"39083007000",2588,194,0,0,93,0,78,0,2953
"39083007100",2848,1116,0,25,54,53,20,0,4116
"39083007200",3656,917,0,16,111,20,0,0,4720
"39083007300",3545,666,49,18,136,0,32,0,4446
"39083007400",4629,957,80,0,27,2,40,0,5735
"39083007500",2879,678,18,13,0,0,0,41,3629
"39083007600",3797,763,43,0,123,11,0,0,4737
"39083007700",4906,774,57,10,250,96,305,0,6398
"39085200100",1502,134,70,15,50,20,43,21,1855
"39085200200",2229,169,15,0,136,25,174,10,2758
"39085200300",2916,204,0,0,12,1,23,0,3156
"39085200400",2787,419,78,0,46,0,32,0,3362
"39085200500",2851,122,32,0,248,0,13,0,3266
"39085200600",3243,139,0,0,77,45,23,0,3527
"39085200700",3222,315,224,59,84,0,44,0,3948
"39085200800",3057,177,170,52,114,27,37,0,3634
"39085200900",1152,140,34,0,50,51,2,0,1429
"39085201000",3385,228,1055,108,124,0,47,0,4947
"39085201100",3425,167,422,0,504,14,44,0,4576
"39085201200",2783,186,185,6,239,91,110,14,3614
"39085201300",3332,213,0,0,92,0,45,0,3682
"39085201400",3506,150,10,0,40,0,60,0,3766
"39085201500",1807,0,0,0,35,0,38,0,1880
"39085201600",3008,159,124,109,381,21,18,0,3820
"39085201700",4779,294,160,297,81,0,70,0,5681
"39085201800",3245,234,9,0,20,0,9,0,3517
"39085201900",2547,148,196,0,16,0,17,13,2937
"39085202000",5598,401,20,0,149,0,57,0,6225
"39085202100",1624,465,88,0,26,7,194,0,2404
"39085202400",2849,160,0,0,66,0,38,6,3119
"39085202500",3569,517,88,9,124,0,32,0,4339
"39085202600",3545,252,0,0,45,1,6,0,3849
"39085202700",5661,279,10,34,80,0,38,0,6102
"39085202800",5437,561,3,2,173,0,16,0,6192
"39085202900",6074,432,189,0,49,0,86,0,6830
"39085203000",6318,157,0,0,79,25,45,0,6624
"39085203200",2510,641,89,112,127,0,84,0,3563
"39085203400",3657,297,19,77,47,0,17,0,4114
"39085203500",6431,233,21,15,222,0,131,0,7053
"39085203700",3055,170,0,1,1,0,19,0,3246
"39085204000",2587,497,1,10,8,1,0,200,3304
"39085204200",2301,557,384,229,481,397,1423,172,5944
"39085204301",1500,179,75,0,53,26,100,0,1933
"39085204302",3443,799,688,830,394,82,950,228,7414
"39085204400",2067,572,85,62,300,132,654,334,4206
"39085204500",1566,817,282,25,250,154,743,290,4127
"39085204700",3818,507,0,0,100,0,117,61,4603
"39085204800",4181,515,155,30,26,0,168,55,5130
"39085204900",5282,295,121,54,358,16,64,0,6190
"39085205001",5280,377,74,0,104,13,0,0,5848
"39085205002",5360,153,179,0,88,0,107,0,5887
"39085205100",6053,78,2,1,231,0,0,0,6365
"39085205200",2911,105,8,0,67,0,19,0,3110
"39085205300",2348,86,58,12,0,24,0,0,2528
"39085205400",1454,113,0,2,34,5,8,1,1617
"39085205701",3797,743,0,17,138,0,213,260,5168
"39085205702",2934,126,7,3,71,0,0,1,3142
"39085205800",976,93,24,0,169,0,6,0,1268
"39085205900",712,47,7,17,65,0,0,0,848
"39085206000",4450,779,0,0,70,16,43,0,5358
"39085206100",2653,465,0,4,36,0,14,0,3172
"39085206200",1370,203,96,7,16,0,38,5,1735
"39085206300",4267,310,118,31,82,36,318,51,5213
"39085206400",4358,147,0,1,43,0,108,0,4657
"39085206500",2314,154,152,0,124,24,29,0,2797
"39085206600",4009,483,3,0,167,0,14,0,4676
"39085990000",0,0,0,0,0,0,0,0,0
"39087050100",1716,364,19,42,0,13,0,0,2154
"39087050200",2036,302,21,0,11,25,0,0,2395
"39087050300",1264,346,425,155,170,10,11,0,2381
"39087050400",2594,566,26,44,0,0,78,0,3308
"39087050500",5613,644,0,0,297,12,22,0,6588
"39087050600",1304,123,0,6,17,0,0,0,1450
"39087050700",2912,619,0,0,25,0,0,0,3556
"39087050800",2667,909,30,23,76,0,24,0,3729
"39087050900",1805,443,0,0,18,0,12,0,2278
"39087051001",3271,467,74,147,121,211,52,119,4462
"39087051002",3463,1335,0,0,85,0,19,0,4902
"39087051100",5110,1178,44,0,182,0,0,0,6514
"39087051200",3934,1206,12,3,105,14,109,0,5383
"39087051300",3050,695,0,0,10,16,0,15,3786
"39087051401",4906,187,31,0,23,0,27,0,5174
"39087051402",2914,522,15,7,161,18,0,1,3638
"39089750700",2389,904,9,36,10,182,0,0,3530
"39089751000",1478,593,28,40,179,49,62,0,2429
"39089751300",2643,720,115,42,168,65,35,26,3814
"39089751600",2699,532,26,8,116,0,36,16,3433
"39089751900",3187,783,29,28,153,33,21,11,4245
"39089752200",3485,783,55,100,48,0,10,4,4485
"39089752500",2061,1087,104,71,126,172,0,11,3632
"39089752800",5963,514,143,2,425,49,43,19,7158
"39089753100",4311,432,69,26,100,29,16,8,4991
"39089753300",5263,1116,257,232,153,82,40,0,7143
"39089753600",1573,294,17,16,10,14,9,0,1933
"39089753900",4024,371,108,19,81,19,8,19,4649
"39089754101",5816,1146,64,0,288,40,197,133,7684
"39089754102",2199,28,0,0,20,0,0,0,2247
"39089754400",5407,726,0,0,72,0,0,0,6205
"39089754700",5507,669,0,0,155,117,90,103,6641
"39089755000",6178,125,5,7,140,0,81,0,6536
"39089755300",6761,245,38,16,55,73,294,54,7536
"39089755600",4765,382,6,0,59,26,49,0,5287
"39089755900",5962,526,274,51,95,0,51,0,6959
"39089756201",1574,197,438,13,10,9,1,3,2245
"39089756202",4941,397,2046,19,631,74,470,0,8578
"39089756500",3409,609,45,9,230,0,0,0,4302
"39089756800",7039,476,158,0,140,83,27,0,7923
"39089757100",3815,160,20,0,9,0,0,0,4004
"39089757400",5502,333,33,149,120,0,232,6,6375
"39089757700",4949,245,0,0,116,0,69,0,5379
"39089758300",1972,718,0,0,71,15,67,70,2913
"39089758600",6766,566,18,0,228,93,39,0,7710
"39089758900",4888,1060,19,14,52,50,14,0,6097
"39089759000",1978,733,202,93,68,74,0,5,3153
"39089759100",6468,462,31,0,219,0,26,14,7220
"39091003800",3164,658,11,0,73,20,5,0,3931
"39091003900",3874,528,16,0,51,12,57,11,4549
"39091004000",2234,238,0,7,55,0,16,0,2550
"39091004100",2314,479,0,2,36,15,4,2,2852
"39091004200",1121,298,40,12,7,30,0,6,1514
"39091004300",4638,1657,40,0,166,44,65,0,6610
"39091004400",3261,966,24,71,83,307,64,32,4808
"39091004500",3042,992,225,20,134,119,9,93,4634
"39091004600",3992,553,137,19,113,38,17,83,4952
"39091004700",4840,167,0,39,66,0,51,3,5166
"39091004800",3481,291,5,16,67,8,65,0,3933
"39093010200",3875,57,0,0,145,71,89,71,4308
"39093010300",4685,250,0,0,214,0,60,0,5209
"39093010400",2518,125,62,12,86,0,18,12,2833
"39093013100",9262,167,21,2,484,14,254,2,10206
"39093013200",9155,319,768,556,396,20,527,0,11741
"39093021100",2854,266,30,0,153,0,150,23,3476
"39093021200",4519,944,23,21,257,0,329,0,6093
"39093022100",1450,137,119,8,38,25,157,24,1958
"39093022200",1618,594,78,41,180,57,369,161,3098
"39093022400",1766,688,269,653,333,141,511,267,4628
"39093022500",1195,90,150,8,102,19,193,11,1768
"39093022601",1094,496,290,539,198,40,53,76,2786
"39093022800",1681,551,659,782,300,301,757,449,5480
"39093023000",2496,1311,325,716,169,306,498,125,5946
"39093023100",1715,504,265,276,406,463,1456,901,5986
"39093023200",1339,545,354,264,121,235,658,464,3980
"39093023300",1127,422,318,508,145,144,552,358,3574
"39093023400",1546,161,271,12,0,21,136,0,2147
"39093023500",1590,318,70,25,101,14,445,148,2711
"39093023600",1413,535,176,36,507,177,1027,430,4301
"39093023700",3344,1028,214,453,318,416,831,1511,8115
"39093023800",910,313,11,38,333,70,511,191,2377
"39093023900",975,225,118,14,212,171,327,168,2210
"39093024000",1151,163,143,112,142,25,275,38,2049
"39093024100",1780,469,159,82,288,235,316,348,3677
"39093024200",2898,367,399,111,516,44,826,24,5185
"39093028100",3658,39,122,37,118,30,351,0,4355
"39093030100",5385,741,0,5,184,14,129,0,6458
"39093050100",3084,62,63,0,88,0,102,0,3399
"39093050200",3155,361,0,0,73,16,130,9,3744
"39093050300",6486,588,34,0,241,0,224,0,7573
"39093050400",2120,67,6,157,68,0,88,0,2506
"39093057100",3478,302,21,0,31,3,194,19,4048
"39093060100",1762,335,931,138,452,115,132,117,3982
"39093060200",1896,646,376,17,45,53,15,21,3069
"39093070101",2891,121,213,6,233,0,205,0,3669
"39093070102",4420,368,454,302,203,43,277,38,6105
"39093070200",1694,93,57,5,123,29,223,43,2267
"39093070300",2192,528,279,50,52,34,21,0,3156
"39093070400",2581,610,855,331,184,285,128,90,5064
"39093070500",1537,734,213,128,97,184,73,144,3110
"39093070600",3276,700,191,43,147,0,58,27,4442
"39093070700",1638,551,194,18,48,131,202,99,2881
"39093070800",363,236,70,154,10,13,36,19,901
"39093070901",513,342,244,319,159,204,42,86,1909
"39093070902",2399,351,250,352,104,13,34,0,3503
"39093071000",717,492,94,117,92,94,72,12,1690
"39093071100",3606,394,109,53,246,79,179,42,4708
"39093071201",3158,672,604,154,99,66,157,81,4991
"39093071202",3397,197,293,122,228,13,84,0,4334
"39093071300",3775,447,25,158,441,32,202,0,5080
"39093071400",1506,170,629,665,211,150,124,165,3620
"39093071500",1472,133,10,7,65,0,0,0,1687
"39093077100",3042,330,102,0,11,4,112,0,3601
"39093080101",2043,104,24,5,35,5,60,0,2276
"39093080103",3928,313,44,12,102,31,192,31,4653
"39093080104",3192,122,23,0,167,12,131,12,3659
"39093080500",5500,100,184,1,112,1,255,1,6154
"39093080600",4680,563,34,1,149,182,197,14,5820
"39093080700",7677,646,78,2,189,94,237,19,8942
"39093090100",3129,136,0,2,11,58,70,0,3406
"39093090200",3230,281,0,0,107,0,0,0,3618
"39093091100",2402,241,40,35,86,37,77,0,2918
"39093091200",1855,155,48,0,54,0,11,5,2128
"39093092100",2264,160,14,0,45,24,112,0,2619
"39093093100",2777,276,3,0,69,8,35,0,3168
"39093094100",7269,420,24,0,44,0,141,34,7932
"39093095100",5863,348,6,0,108,0,73,0,6398
"39093096100",5427,504,67,20,50,90,45,47,6250
"39093097100",3121,78,22,0,39,0,28,21,3309
"39093097200",5950,686,338,132,426,181,1108,15,8836
"39093097300",781,735,749,241,186,228,517,523,3960
"39093097400",9635,492,220,5,303,37,184,176,11052
"39093990200",0,0,0,0,0,0,0,0,0
"39095000200",3157,333,549,219,214,103,572,0,5147
"39095000300",3268,251,198,443,83,15,209,0,4467
"39095000400",2106,589,37,95,115,356,75,276,3649
"39095000600",2656,922,687,235,374,194,289,154,5511
"39095000700",3228,384,670,752,247,99,425,4,5809
"39095000800",130,15,712,353,73,9,25,12,1329
"39095000900",723,288,1196,236,157,92,115,106,2913
"39095001000",1137,296,998,713,346,124,478,144,4236
"39095001100",418,241,787,536,44,246,71,94,2437
"39095001201",1341,201,278,182,283,60,213,57,2615
"39095001202",344,277,115,846,89,371,70,299,2411
"39095001301",2117,129,132,8,61,170,105,0,2722
"39095001302",428,472,384,310,62,206,52,53,1967
"39095001303",1210,121,1032,152,189,17,60,0,2781
"39095001400",139,126,598,453,48,82,25,7,1478
"39095001500",105,57,713,586,16,48,31,69,1625
"39095001600",751,174,1365,504,59,104,16,24,2997
"39095001700",349,226,242,570,40,56,118,34,1635
"39095001800",707,272,770,485,198,110,188,134,2864
"39095001900",125,266,492,428,70,258,108,30,1777
"39095002000",809,438,107,218,155,74,163,69,2033
"39095002100",1021,198,713,624,147,10,59,2,2774
"39095002200",161,56,357,749,0,139,0,35,1497
"39095002300",64,159,544,773,18,14,0,31,1603
"39095002401",694,748,1186,473,111,299,96,51,3658
"39095002402",16,54,951,638,47,0,9,18,1733
"39095002500",44,20,908,995,74,37,0,0,2078
"39095002600",8,0,716,306,41,4,0,0,1075
"39095002700",265,171,69,328,27,56,15,38,969
"39095002800",337,123,119,308,62,45,72,39,1105
"39095002900",84,212,83,944,134,44,133,25,1659
"39095003000",664,288,139,481,84,82,143,108,1989
"39095003100",60,52,463,228,6,24,71,0,904
"39095003200",32,8,571,736,0,18,0,18,1383
"39095003300",34,37,841,872,16,33,16,3,1852
"39095003400",12,178,192,370,1,56,3,138,950
"39095003500",36,85,820,528,68,6,5,57,1605
"39095003600",16,76,533,554,6,18,0,5,1208
"39095003700",252,73,231,637,22,6,7,8,1236
"39095003900",2669,662,518,535,405,364,404,136,5693
"39095004000",686,379,310,171,239,95,357,104,2341
"39095004200",621,401,157,251,88,82,122,120,1842
"39095004400",2033,879,669,146,193,310,171,166,4567
"39095004501",2058,227,252,152,22,7,228,0,2946
"39095004503",2001,277,47,11,87,87,62,8,2580
"39095004504",3090,53,111,0,178,52,174,7,3665
"39095004600",1581,701,44,79,119,40,201,137,2902
"39095004701",1197,892,79,194,205,200,288,244,3299
"39095004702",1779,886,72,405,405,447,651,500,5145
"39095004800",973,981,265,321,55,302,105,366,3368
"39095004900",1453,638,48,141,172,227,233,249,3161
"39095005000",1115,368,18,96,284,224,344,92,2541
"39095005100",1410,1028,322,760,372,399,369,305,4965
"39095005200",2109,969,118,0,343,56,460,154,4209
"39095005300",858,738,114,11,229,287,374,403,3014
"39095005400",1327,423,198,797,321,148,618,132,3964
"39095005501",2021,443,0,172,110,50,62,21,2879
"39095005502",2992,200,20,8,24,6,70,0,3320
"39095005503",1868,263,20,0,151,0,165,11,2478
"39095005600",4822,408,60,0,100,67,218,0,5675
"39095005701",2546,710,137,288,19,228,134,296,4358
"39095005702",3739,582,149,102,191,112,50,41,4966
"39095005703",1898,511,28,0,161,35,209,11,2853
"39095005801",2661,524,342,160,89,99,133,0,4008
"39095005802",3607,662,281,61,77,79,169,94,5030
"39095005901",2260,111,96,0,155,0,116,0,2738
"39095005902",2558,945,168,125,211,40,186,103,4336
"39095006000",1761,165,223,54,151,21,68,0,2443
"39095006100",2512,70,384,8,223,22,153,2,3374
"39095006200",2123,360,85,9,164,25,115,0,2881
"39095006300",2161,430,319,44,42,49,122,12,3179
"39095006400",1691,181,56,180,141,0,176,0,2425
"39095006500",1383,373,370,122,65,14,0,0,2327
"39095006600",283,344,1142,308,47,113,1,43,2281
"39095006700",307,310,730,186,99,8,63,49,1752
"39095006800",1551,573,731,784,427,277,184,85,4612
"39095006900",2307,68,100,47,45,0,74,0,2641
"39095007001",3706,263,0,0,83,0,154,20,4226
"39095007002",1840,98,32,0,16,0,44,0,2030
"39095007101",3431,356,186,102,166,197,158,44,4640
"39095007102",3233,274,30,0,72,23,49,14,3695
"39095007202",2232,294,485,184,129,46,50,28,3448
"39095007203",3489,78,557,65,167,0,155,41,4552
"39095007204",2846,402,988,48,254,39,180,56,4813
"39095007205",2368,449,1548,629,335,181,265,0,5775
"39095007301",2822,402,1162,206,384,0,214,29,5219
"39095007302",1015,205,1284,326,282,78,99,23,3312
"39095007303",875,472,1451,1320,330,413,114,157,5132
"39095007400",1386,845,1945,827,638,107,382,11,6141
"39095007500",1882,745,870,188,188,307,62,0,4242
"39095007600",4035,135,87,0,292,7,15,0,4571
"39095007700",2656,550,85,13,88,6,68,6,3472
"39095007800",3073,433,113,48,98,0,77,18,3860
"39095007901",1890,196,0,0,7,9,131,19,2252
"39095007902",4333,630,279,82,225,129,19,0,5697
"39095008000",3365,493,53,120,74,0,147,20,4272
"39095008100",2985,395,53,232,242,201,130,78,4316
"39095008201",4106,227,0,0,250,0,108,0,4691
"39095008202",4864,224,395,23,85,0,24,0,5615
"39095008203",5970,238,317,160,413,124,163,68,7453
"39095008301",4341,751,28,0,277,31,43,62,5533
"39095008302",1508,87,40,0,27,0,20,0,1682
"39095008400",3605,239,466,104,216,0,80,16,4726
"39095008500",2519,240,608,368,147,103,119,33,4137
"39095008600",3677,643,588,274,217,155,85,134,5773
"39095008700",4577,1642,730,605,456,377,423,229,9039
"39095008800",5923,446,362,48,540,26,418,3,7766
"39095008901",4808,287,0,47,117,0,131,18,5408
"39095008902",5420,217,21,0,259,0,115,0,6032
"39095009000",10538,432,546,0,636,8,252,6,12418
"39095009101",3080,218,178,0,426,34,65,27,4028
"39095009102",3726,628,359,4,178,23,297,109,5324
"39095009201",7226,537,85,15,533,10,43,36,8485
"39095009202",6185,246,304,0,476,24,155,0,7390
"39095009300",1497,105,14,0,15,0,4,0,1635
"39095009400",1588,172,387,214,99,53,82,22,2617
"39095009500",2531,266,0,5,151,0,222,24,3199
"39095009600",2884,258,19,0,165,15,114,6,3461
"39095009700",2744,135,36,0,111,53,73,0,3152
"39095009800",3651,170,0,0,375,0,374,0,4570
"39095009900",3699,456,58,0,300,56,241,14,4824
"39095010001",3189,420,75,121,168,67,325,173,4538
"39095010002",2692,284,16,0,178,260,151,233,3814
"39095010100",2968,591,19,5,139,12,173,97,4004
"39095010200",1709,460,124,69,89,112,126,177,2866
"39095010300",877,492,174,235,158,277,426,299,2938
"39095010400",95,49,52,0,0,10,14,9,229
"39095990000",0,0,0,0,0,0,0,0,0
"39097040101",1977,107,0,6,82,0,8,0,2180
"39097040102",4784,254,0,0,86,3,115,3,5245
"39097040201",2172,64,8,0,46,51,20,0,2361
"39097040202",2409,218,0,0,33,0,28,0,2688
"39097040400",2406,188,0,0,22,0,3,0,2619
"39097040500",3754,503,8,26,84,48,21,3,4447
"39097040600",4621,476,53,0,331,74,155,0,5710
"39097040700",2011,587,122,150,126,49,76,11,3132
"39097041000",163,268,154,176,17,51,13,38,880
"39097041100",3993,556,68,26,85,18,32,0,4778
"39097041200",2515,424,8,1,15,17,4,1,2985
"39097041300",1974,135,0,0,3,0,0,0,2112
"39099800300",116,80,706,307,7,73,53,46,1388
"39099800400",10,86,639,217,90,8,19,6,1075
"39099800500",278,396,716,1102,54,36,72,327,2981
"39099800600",189,161,378,361,105,34,128,127,1483
"39099801000",386,289,356,264,32,107,111,91,1636
"39099801100",690,504,461,458,144,170,330,85,2842
"39099801200",821,338,390,66,18,64,90,12,1799
"39099801300",999,526,239,525,67,19,111,81,2567
"39099801400",1680,353,106,22,16,0,88,9,2274
"39099801500",943,155,519,209,119,58,60,6,2069
"39099801600",464,291,732,1152,289,181,219,74,3402
"39099801700",165,159,203,300,75,15,32,99,1048
"39099802100",30,29,422,240,30,5,0,11,767
"39099802300",107,123,308,107,31,238,31,234,1179
"39099802400",210,199,1059,649,163,91,23,237,2631
"39099802500",195,205,701,427,0,25,45,131,1729
"39099802600",1074,383,210,158,92,93,96,90,2196
"39099802701",2407,292,150,23,10,20,115,0,3017
"39099802702",2469,177,223,9,64,3,33,0,2978
"39099802800",1836,514,112,26,23,42,51,37,2641
"39099802900",1199,638,168,526,6,29,0,72,2638
"39099803000",1348,446,103,145,53,4,74,17,2190
"39099804000",281,396,605,302,34,60,60,29,1767
"39099804100",269,66,596,231,9,0,8,0,1179
"39099804200",561,94,1343,213,171,114,59,86,2641
"39099804300",222,164,205,297,49,51,40,65,1093
"39099810100",2701,464,324,249,103,89,250,27,4207
"39099810200",1299,379,515,79,26,84,317,150,2849
"39099810300",451,242,539,281,136,114,238,106,2107
"39099810600",2081,707,61,23,98,0,189,95,3254
"39099810700",4634,694,2,1,14,62,8,52,5467
"39099810800",1519,393,60,31,42,89,19,81,2234
"39099810900",1853,157,121,14,22,0,47,0,2214
"39099811001",3613,170,71,0,52,0,101,0,4007
"39099811002",6997,475,0,0,158,0,263,0,7893
"39099811100",931,183,0,3,10,5,44,5,1181
"39099811200",2269,139,0,0,5,0,5,0,2418
"39099811300",4802,913,450,80,280,0,575,292,7392
"39099811400",2019,437,506,161,207,20,46,0,3396
"39099811500",5164,126,76,0,110,19,86,52,5633
"39099811600",2869,156,279,56,39,8,89,24,3520
"39099811700",2150,207,129,0,53,0,39,7,2585
"39099811800",1001,177,34,25,28,0,46,18,1329
"39099811901",3692,194,142,52,124,28,135,52,4419
"39099811902",2952,120,41,1,310,44,40,43,3551
"39099812001",4753,346,54,54,222,18,71,0,5518
"39099812002",3572,187,196,0,144,0,59,0,4158
"39099812100",8396,492,142,0,381,48,133,0,9592
"39099812200",5503,607,0,0,404,0,47,0,6561
"39099812301",3166,606,50,175,79,0,107,0,4183
"39099812302",5086,490,293,165,247,0,170,0,6451
"39099812400",2304,511,115,66,74,3,61,0,3134
"39099812500",4438,421,147,25,27,19,67,0,5144
"39099812601",2709,631,339,309,70,0,156,0,4214
"39099812602",4469,163,219,2,32,6,0,0,4891
"39099812603",7176,453,390,0,229,12,188,23,8471
"39099812700",1815,180,0,0,29,0,30,0,2054
"39099812800",2899,663,0,0,77,25,23,38,3725
"39099812900",3805,308,0,7,68,3,38,0,4229
"39099813000",3779,503,17,0,148,4,0,5,4456
"39099813200",3456,669,0,1,0,0,206,0,4332
"39099813300",2890,264,0,0,0,0,32,0,3186
"39099813400",3132,318,0,21,20,35,47,0,3573
"39099813500",6224,553,33,0,18,0,0,0,6828
"39099813600",7046,779,16,0,225,0,184,14,8264
"39099813700",320,691,562,609,20,45,129,401,2777
"39099813800",239,150,1074,779,15,88,93,193,2631
"39099813900",98,117,1024,657,26,8,0,0,1930
"39099814000",272,410,774,846,133,41,59,295,2830
"39099814100",894,434,157,761,57,115,76,12,2506
"39101000100",736,398,21,4,62,0,55,0,1276
"39101000200",1894,838,90,110,66,47,24,39,3108
"39101000300",1629,522,2,3,0,24,0,6,2186
"39101000400",2525,1239,0,41,32,0,0,0,3837
"39101000501",1526,605,29,5,85,48,75,45,2418
"39101000502",1907,483,21,32,16,0,17,0,2476
"39101000600",3856,336,97,0,406,117,275,0,5087
"39101000700",2229,272,17,7,38,0,27,20,2610
"39101000800",1412,796,24,5,9,63,0,2,2311
"39101000900",2108,1499,164,141,11,44,41,80,4088
"39101001000",2733,210,22,0,23,0,7,0,2995
"39101001100",1624,528,130,0,54,25,94,0,2455
"39101010100",4466,279,11,0,269,0,33,2,5060
"39101010201",4207,717,18,0,189,0,57,0,5188
"39101010202",199,153,141,179,24,12,36,24,768
"39101010300",3772,672,1,11,98,224,35,129,4942
"39101010400",4077,534,8,0,45,0,17,0,4681
"39101010500",5250,185,0,0,136,30,25,30,5656
"39103400100",7343,290,37,5,94,0,62,0,7831
"39103402000",4721,317,0,0,41,8,220,0,5307
"39103403001",2931,305,0,1,31,0,1,0,3269
"39103403002",2937,178,22,0,50,0,57,0,3244
"39103404000",3803,188,21,0,52,0,91,0,4155
"39103405000",4099,334,0,0,92,0,51,0,4576
"39103406000",4675,386,51,1,213,0,50,0,5376
"39103407000",6003,197,14,17,335,184,92,0,6842
"39103408001",2446,276,67,0,38,24,60,0,2911
"39103408002",1626,47,0,0,67,4,80,0,1824
"39103408003",2511,219,19,11,120,0,36,0,2916
"39103408100",5578,439,278,349,70,52,47,72,6885
"39103408201",3069,810,38,105,103,41,64,10,4240
"39103408202",5033,182,34,0,120,0,46,0,5415
"39103408301",3450,42,38,0,60,0,43,0,3633
"39103408302",8779,725,240,49,157,140,120,0,10210
"39103409001",1972,108,4,0,70,4,88,0,2246
"39103409002",4025,300,97,0,131,3,22,2,4580
"39103410000",3550,722,0,0,0,0,46,0,4318
"39103411001",1566,154,0,0,8,0,3,0,1731
"39103411002",2253,572,0,58,32,25,24,24,2988
"39103412000",4110,168,2,2,28,0,28,0,4338
"39103413000",5071,269,6,0,25,114,12,0,5497
"39103415100",3865,121,0,0,31,8,8,0,4033
"39103415200",4117,201,5,0,73,0,124,0,4520
"39103415300",3694,156,26,0,308,8,112,0,4304
"39103415400",4264,273,0,0,125,0,309,0,4971
"39103415800",6175,177,93,0,381,25,199,0,7050
"39103416000",4832,406,10,7,124,31,111,0,5521
"39103416100",4296,432,67,0,17,0,146,0,4958
"39103416200",3432,277,60,32,63,0,23,89,3976
"39103416300",2388,137,56,0,23,0,26,0,2630
"39103416400",2672,494,33,0,154,0,161,0,3514
"39103417000",7090,339,49,41,217,0,115,0,7851
"39103417100",5478,283,51,0,322,32,53,0,6219
"39103417200",6448,360,0,88,194,108,77,9,7284
"39103417300",3728,461,0,72,115,21,0,10,4407
"39105964100",3411,734,67,0,21,21,5,63,4322
"39105964200",3774,920,0,0,16,0,0,0,4710
"39105964300",3955,603,25,0,54,21,0,0,4658
"39105964400",1832,1172,46,0,50,47,0,0,3147
"39105964500",2006,968,59,36,34,6,2,4,3115
"39105964600",2488,804,4,0,49,14,3,38,3400
"39107967200",3042,502,2,5,7,8,3,17,3586
"39107967300",4320,363,0,0,16,22,0,0,4721
"39107967400",3679,713,5,28,120,14,39,17,4615
"39107967500",4217,347,91,0,121,11,68,0,4855
"39107967600",2242,531,4,2,93,109,23,79,3083
"39107967700",5764,230,0,5,107,2,122,10,6240
"39107967800",1671,230,0,0,25,30,17,0,1973
"39107967900",6028,326,5,0,73,0,179,0,6611
"39107968000",4890,63,2,0,67,0,85,7,5114
"39109300100",3696,412,153,0,104,68,8,0,4441
"39109315001",3281,332,120,10,174,35,106,0,4058
"39109315002",3460,1054,44,51,209,44,6,0,4868
"39109315100",3923,1237,255,152,141,174,0,30,5912
"39109315300",3445,1073,67,115,29,16,60,13,4818
"39109320100",3238,461,0,0,14,0,8,0,3721
"39109325000",2117,519,0,0,13,38,22,0,2709
"39109330100",3065,260,14,2,23,41,69,1,3475
"39109340100",4586,529,0,2,14,7,6,1,5145
"39109345000",4132,455,0,0,146,34,46,0,4813
"39109350100",7373,246,0,0,137,59,186,11,8012
"39109355001",5329,543,46,1,103,1,47,0,6070
"39109355002",1568,66,0,3,13,0,1,1,1652
"39109365000",6464,919,217,17,811,31,93,234,8786
"39109365101",3501,268,46,0,104,33,0,0,3952
"39109365102",4370,431,76,28,117,0,62,32,5116
"39109365200",2606,721,146,3,0,0,4,2,3482
"39109365301",3893,1013,240,230,34,111,16,56,5593
"39109365302",4958,409,64,7,298,44,31,0,5811
"39109380100",5542,474,26,0,68,7,157,100,6374
"39109390100",4148,290,23,0,107,0,57,0,4625
"39111966600",2667,526,0,0,37,7,9,0,3246
"39111966700",2890,698,13,0,44,50,41,0,3736
"39111966800",2902,780,11,30,41,0,0,0,3764
"39111966900",3058,599,0,8,35,7,36,0,3743
"39113000100",348,217,1607,509,23,0,0,0,2704
"39113000200",105,121,1414,849,18,29,0,0,2536
"39113000300",56,20,974,677,13,33,54,0,1827
"39113000400",156,54,2457,1073,70,0,51,0,3861
"39113000500",608,121,2468,819,54,0,0,0,4070
"39113000600",108,8,1317,254,74,0,4,0,1765
"39113000700",32,38,1151,1364,17,33,0,0,2635
"39113000801",604,113,1503,867,197,0,72,0,3356
"39113000802",223,140,954,706,123,32,16,68,2262
"39113000900",497,555,742,572,8,26,11,0,2411
"39113001000",139,42,359,561,20,23,9,14,1167
"39113001100",790,679,1500,983,81,88,15,220,4356
"39113001200",342,83,308,291,12,41,0,0,1077
"39113001501",1409,553,180,467,41,64,53,14,2781
"39113001600",1224,250,293,255,103,31,46,42,2244
"39113001700",345,231,24,51,4,27,4,3,689
"39113001800",2631,1461,483,822,130,40,43,104,5714
"39113001900",2263,1715,132,131,34,230,108,388,5001
"39113002000",1477,633,477,200,122,164,117,238,3428
"39113002200",1135,1653,14,85,162,268,256,301,3874
"39113002300",1088,1262,50,254,74,119,55,31,2933
"39113002400",1583,742,34,34,0,94,64,299,2850
"39113002500",3381,1203,158,274,225,93,89,240,5663
"39113002600",3199,1612,133,67,51,158,73,102,5395
"39113002700",1510,381,179,10,67,25,4,12,2188
"39113002800",1658,249,60,24,48,14,10,0,2063
"39113002900",3201,506,168,17,14,104,0,16,4026
"39113003000",2473,338,0,26,76,91,73,19,3096
"39113003100",1900,453,58,36,78,10,72,0,2607
"39113003201",2127,585,109,106,85,114,24,104,3254
"39113003300",2659,800,140,452,244,48,203,0,4546
"39113003402",483,670,20,117,19,24,0,16,1349
"39113003403",103,272,0,16,15,0,0,0,406
"39113003404",1074,569,59,143,26,42,50,21,1984
"39113003500",33,0,897,1261,17,0,0,0,2208
"39113003800",23,172,1733,1244,9,86,0,69,3336
"39113003900",31,16,1377,669,86,111,158,29,2477
"39113004100",13,35,1065,1124,24,82,0,0,2343
"39113004200",26,72,910,1356,29,24,0,0,2417
"39113004300",43,160,1078,843,29,36,0,49,2238
"39113004400",39,0,1636,608,0,0,0,0,2283
"39113004600",62,145,604,569,20,30,0,32,1462
"39113010100",1856,72,0,0,61,0,35,0,2024
"39113010200",6596,269,24,0,234,0,32,0,7155
"39113020100",2529,152,57,7,65,69,27,14,2920
"39113020200",2261,340,30,0,71,0,19,4,2725
"39113020300",2391,164,12,0,68,22,201,0,2858
"39113020400",5095,546,204,126,215,116,55,92,6449
"39113020500",1052,188,76,13,107,24,63,7,1530
"39113020601",1610,104,0,0,60,0,41,33,1848
"39113020602",1604,15,0,0,44,0,48,0,1711
"39113020700",2695,199,37,0,65,37,54,0,3087
"39113020800",2163,76,63,30,61,0,9,12,2414
"39113020900",2048,337,23,8,52,41,27,0,2536
"39113021000",1407,204,0,0,65,0,5,0,1681
"39113021100",2281,541,82,36,175,51,45,0,3211
"39113021200",1387,100,33,18,120,59,10,0,1727
"39113021301",2254,529,13,8,13,73,34,0,2924
"39113021302",1678,263,0,0,58,48,51,4,2102
"39113021400",2087,465,0,38,61,15,50,0,2716
"39113021501",2257,473,78,20,101,34,32,24,3019
"39113021502",1244,150,49,31,33,4,38,25,1574
"39113021601",1747,250,59,0,39,63,9,0,2167
"39113021602",3111,146,55,1,59,0,94,0,3466
"39113021700",2095,230,0,10,98,0,15,0,2448
"39113021800",1190,422,139,144,100,104,11,30,2140
"39113021900",1776,76,50,5,104,9,66,0,2086
"39113030100",2801,616,280,719,60,49,40,0,4565
"39113030200",1959,469,242,103,26,15,43,6,2863
"39113040101",1676,25,5,0,38,7,5,0,1756
"39113040102",1865,113,23,0,157,19,85,0,2262
"39113040103",2249,60,26,0,63,20,63,9,2490
"39113040201",2557,74,0,0,147,13,94,0,2885
"39113040203",2086,95,43,0,295,11,10,0,2540
"39113040204",3847,317,300,9,325,32,8,2,4840
"39113040302",4372,248,446,454,110,0,144,49,5823
"39113040303",4403,94,48,0,147,194,138,156,5180
"39113040305",2518,20,0,0,338,0,128,0,3004
"39113040306",4290,105,337,0,296,0,18,0,5046
"39113040401",4135,250,227,6,281,11,61,11,4982
"39113040403",3246,173,115,0,419,0,86,0,4039
"39113040405",3846,558,496,77,566,29,78,2,5652
"39113040406",5028,108,123,3,1081,0,47,0,6390
"39113050101",2667,340,140,177,225,25,23,0,3597
"39113050103",5148,606,774,44,1748,171,186,110,8787
"39113050104",1884,82,133,115,105,8,18,0,2345
"39113050105",3633,278,462,208,183,17,101,17,4899
"39113050301",2125,404,180,58,69,31,72,0,2939
"39113050302",4328,577,336,23,65,0,31,0,5360
"39113050303",2323,719,558,391,240,94,136,128,4589
"39113050401",4512,397,29,0,106,28,46,18,5136
"39113050402",1488,636,131,0,76,0,31,0,2362
"39113050502",2132,520,73,20,140,0,43,3,2931
"39113050503",5076,776,107,71,24,0,141,0,6195
"39113050504",4758,1067,109,0,412,0,41,0,6387
"39113050600",3297,539,21,0,44,16,28,9,3954
"39113060100",1646,189,936,276,71,37,0,70,3225
"39113060200",432,360,493,304,41,41,0,0,1671
"39113060300",128,46,1916,762,25,17,24,4,2922
"39113070101",1375,183,2366,632,141,67,12,0,4776
"39113070102",678,45,2012,468,106,0,41,0,3350
"39113070201",474,308,237,361,104,30,10,0,1524
"39113070202",90,81,1137,476,54,15,0,4,1857
"39113070300",364,134,1287,805,7,137,27,153,2914
"39113070400",751,158,1054,318,96,15,8,0,2400
"39113070500",638,74,2293,833,94,31,5,0,3968
"39113070600",43,16,803,76,143,10,134,0,1225
"39113070700",467,140,1978,734,28,0,32,9,3388
"39113080100",1321,375,2600,1023,209,41,131,43,5743
"39113080200",1229,177,1028,259,69,0,38,0,2800
"39113080300",368,249,1292,178,40,94,37,184,2442
"39113080400",926,303,893,604,231,89,108,7,3161
"39113080500",3483,596,712,1140,178,441,114,72,6736
"39113080600",1163,416,0,11,32,0,0,10,1632
"39113080700",1616,451,7,0,0,0,0,26,2100
"39113090302",4349,737,342,149,280,81,90,12,6040
"39113090303",2546,79,509,16,354,0,152,10,3666
"39113090304",4917,417,913,56,699,0,129,0,7131
"39113090600",2548,960,47,13,86,17,61,18,3750
"39113090700",1101,267,52,0,30,0,7,21,1478
"39113090800",1123,123,28,55,0,15,12,0,1356
"39113090900",3111,316,71,41,150,0,107,22,3818
"39113091000",2019,192,177,0,62,16,17,0,2483
"39113091100",2199,171,133,0,319,0,426,0,3248
"39113100101",4073,540,754,175,339,291,257,59,6488
"39113100102",4042,241,1052,44,327,100,102,0,5908
"39113100201",3102,447,729,76,260,43,185,0,4842
"39113100202",1822,77,293,80,144,44,76,0,2536
"39113100203",3739,520,396,5,376,79,303,90,5508
"39113100301",2749,260,430,1,540,75,81,0,4136
"39113100302",2315,498,98,0,150,0,50,0,3111
"39113100400",3252,430,491,84,484,90,120,10,4961
"39113110100",1213,23,0,0,30,0,0,0,1266
"39113110201",3877,146,228,0,144,0,74,0,4469
"39113110202",2072,204,287,61,196,17,8,0,2845
"39113115002",3061,458,14,0,115,0,60,0,3708
"39113115011",4261,705,160,83,357,81,55,58,5760
"39113115012",4460,160,582,76,189,37,22,0,5526
"39113120101",4047,147,700,0,219,5,32,0,5150
"39113120102",3276,333,851,250,71,73,55,0,4909
"39113120103",1614,93,714,115,202,40,101,9,2888
"39113125000",5780,412,0,0,59,0,159,0,6410
"39113125101",5048,401,678,45,630,477,0,0,7279
"39113125102",4881,564,544,25,94,16,22,12,6158
"39113130101",2219,194,7,0,45,6,9,0,2480
"39113130102",5643,547,0,21,84,0,82,21,6398
"39113140100",5123,801,0,0,44,0,0,0,5968
"39113150100",5654,439,0,0,104,0,37,0,6234
"39113160100",1852,113,0,0,0,0,0,0,1965
"39113165000",5469,729,0,0,219,11,58,22,6508
"39113165100",65,104,1379,1075,0,33,0,36,2692
"39113165200",545,185,351,510,29,47,25,0,1692
"39113980000",0,0,0,0,0,0,0,0,0
"39115968800",3105,401,0,0,107,0,19,0,3632
"39115968900",2884,801,101,68,86,78,0,0,4018
"39115969000",2914,716,90,14,76,35,36,43,3924
"39115969100",2183,647,196,31,56,60,8,0,3181
"39117965000",3417,618,45,0,0,0,38,0,4118
"39117965100",3895,637,0,0,67,0,76,0,4675
"39117965200",5593,947,39,21,151,25,39,55,6870
"39117965300",4767,906,0,3,163,21,0,5,5865
"39117965400",5414,753,24,0,121,0,3,0,6315
"39117965500",5999,677,0,0,77,0,185,0,6938
"39119911000",3927,804,0,0,59,0,26,20,4836
"39119911100",5126,522,14,0,75,9,29,0,5775
"39119911200",5601,671,100,11,210,53,26,0,6672
"39119911300",5374,582,80,27,14,61,0,0,6138
"39119911400",1780,987,160,239,168,200,24,0,3558
"39119911500",3629,645,176,53,0,76,0,28,4607
"39119911600",4899,391,342,0,245,78,23,0,5978
"39119911700",2210,676,104,17,95,89,19,0,3210
"39119911800",2184,522,126,15,83,70,25,0,3025
"39119911900",2097,942,45,148,111,23,0,0,3366
"39119912000",1994,1018,0,88,48,0,17,17,3182
"39119912100",1551,1258,350,68,180,96,0,0,3503
"39119912200",1981,691,154,59,279,168,0,0,3332
"39119912300",3245,703,96,39,90,99,24,0,4296
"39119912400",3051,719,41,0,133,93,44,0,4081
"39119912500",3296,1062,0,0,71,44,0,36,4509
"39119912600",3074,504,0,0,5,0,0,19,3602
"39119912700",4504,907,13,14,49,45,129,0,5661
"39119912800",4139,452,16,13,35,7,10,11,4683
"39121968300",3436,602,0,0,22,2,1,0,4063
"39121968400",3869,624,2,2,42,14,13,2,4568
"39121968500",2903,397,0,0,38,0,0,0,3338
"39123050100",649,32,5,3,9,7,36,0,741
"39123050201",1679,83,0,5,25,16,93,1,1902
"39123050202",1613,45,68,3,35,5,66,5,1840
"39123050301",2383,226,44,23,0,0,16,0,2692
"39123050302",2103,276,0,0,40,0,16,0,2435
"39123050500",2277,371,15,0,200,80,177,83,3203
"39123050600",2607,689,69,35,60,29,169,65,3723
"39123050700",2919,339,0,0,66,48,68,86,3526
"39123050800",3891,213,0,0,6,0,82,19,4211
"39123050900",5101,310,0,34,91,12,224,44,5816
"39123051000",4041,521,0,0,299,103,263,17,5244
"39123051100",3308,276,0,10,117,0,202,0,3913
"39123051200",2692,410,19,0,79,0,7,131,3338
"39125960100",2516,276,11,0,28,0,39,17,2887
"39125960200",3699,538,28,0,76,30,204,2,4577
"39125960300",3292,536,13,13,112,22,165,32,4185
"39125960400",3173,527,25,47,215,115,165,144,4411
"39125960500",3053,545,2,1,83,16,49,13,3762
"39127965800",6760,454,0,0,98,9,71,0,7392
"39127965900",5845,800,0,0,0,0,0,0,6645
"39127966000",3582,1341,0,0,85,33,9,0,5050
"39127966100",3633,891,0,7,52,13,0,20,4616
"39127966200",4175,1315,40,0,135,144,23,27,5859
"39127966300",4430,1630,76,0,41,52,76,5,6310
"39129020100",1154,379,52,5,36,17,0,0,1643
"39129020200",1939,622,21,6,4,0,0,0,2592
"39129020310",3918,686,43,0,307,0,118,0,5072
"39129020320",2637,458,4,11,30,0,0,0,3140
"39129020400",1843,505,13,27,105,9,0,0,2502
"39129021100",7157,574,1,1,21,0,86,0,7840
"39129021200",6170,979,6,33,295,116,115,121,7835
"39129021300",0,0,0,0,0,0,0,0,0
"39129021401",2967,380,0,0,21,6,0,0,3374
"39129021402",5917,355,4,9,232,5,50,0,6572
"39129021500",3196,132,0,0,35,10,15,0,3388
"39129021600",2909,398,0,0,16,1,35,9,3368
"39129021700",3869,863,17,10,79,0,15,0,4853
"39131952200",3892,1577,159,0,84,1,0,6,5719
"39131952300",3652,1108,0,0,132,71,52,11,5026
"39131952400",2422,438,61,1,128,9,62,0,3121
"39131952500",2892,864,0,8,0,4,0,24,3792
"39131952600",4082,1639,0,0,180,19,55,19,5994
"39131952700",3312,1026,1,0,177,0,0,0,4516
"39133600102",2674,145,0,10,14,17,48,3,2911
"39133600103",5097,655,17,0,101,33,67,51,6021
"39133600200",5293,697,0,2,72,47,81,0,6192
"39133600301",7095,341,562,30,444,73,133,0,8678
"39133600302",6067,139,159,21,332,0,72,0,6790
"39133600401",4954,264,476,140,364,28,236,0,6462
"39133600402",4598,381,71,27,138,0,57,0,5272
"39133600403",3708,394,278,68,194,59,162,0,4863
"39133600500",4588,631,0,14,33,0,15,0,5281
"39133600602",2390,423,0,0,6,0,10,0,2829
"39133600603",2413,933,5,67,20,66,50,13,3567
"39133600703",1408,407,0,0,9,0,35,20,1879
"39133600704",1486,137,0,0,12,22,0,0,1657
"39133600705",2292,153,0,0,131,0,85,0,2661
"39133600706",2510,234,117,11,21,0,29,0,2922
"39133600800",2403,512,73,33,122,57,8,40,3248
"39133600901",2418,945,157,174,41,79,18,0,3832
"39133600902",4548,737,10,0,140,44,77,56,5612
"39133601000",1419,498,234,60,75,117,0,34,2437
"39133601100",4528,990,111,32,33,5,33,0,5732
"39133601200",2780,948,63,82,266,133,24,17,4313
"39133601300",5121,1041,370,534,217,438,53,0,7774
"39133601400",3105,852,149,570,260,59,120,91,5206
"39133601501",1096,993,30,33,45,51,4,6,2258
"39133601502",460,656,142,16,161,223,0,51,1709
"39133601503",2022,1689,56,263,203,263,0,81,4577
"39133601600",3187,484,10,0,174,45,36,30,3966
"39133601701",4340,628,209,81,260,128,0,0,5646
"39133601702",4974,843,109,0,136,32,109,0,6203
"39133601801",3466,247,27,37,82,19,32,0,3910
"39133601802",3969,275,0,0,48,0,1,0,4293
"39133601901",2476,229,0,0,11,0,141,15,2872
"39133601902",2247,562,0,0,0,0,53,0,2862
"39133602000",4801,421,0,0,0,48,0,0,5270
"39133602100",6494,811,20,0,30,0,0,0,7355
"39135400100",2497,585,23,0,44,38,26,42,3255
"39135410100",1919,320,0,11,23,0,0,0,2273
"39135420100",4020,373,0,6,41,26,0,0,4466
"39135430100",2519,200,4,0,44,0,9,0,2776
"39135440100",3119,545,29,0,49,70,3,5,3820
"39135450100",1893,73,0,0,53,27,0,0,2046
"39135455001",1713,470,3,7,70,19,0,20,2302
"39135455002",4029,1168,0,31,90,0,63,0,5381
"39135460100",2720,230,12,0,35,18,0,32,3047
"39135470101",3399,93,0,0,15,0,0,0,3507
"39135470102",3470,673,24,0,71,0,26,6,4270
"39135480100",3949,295,24,0,51,2,28,0,4349
"39137030100",3584,392,0,8,327,187,506,260,5264
"39137030200",5548,287,7,12,24,19,42,4,5943
"39137030300",6814,378,0,0,428,28,587,75,8310
"39137030400",2733,222,14,18,111,11,67,136,3312
"39137030500",3433,213,0,0,63,16,190,6,3921
"39137030600",4070,193,10,2,20,0,0,0,4295
"39137030700",4378,267,3,0,42,0,47,3,4740
"39139000400",1360,611,219,125,104,45,16,0,2480
"39139000500",1919,797,399,253,125,32,33,0,3558
"39139000600",1003,818,531,398,206,150,134,16,3256
"39139000700",778,566,973,641,35,59,0,0,3052
"39139000800",1900,499,151,29,60,27,47,7,2720
"39139000900",3266,859,4,1,69,5,44,0,4248
"39139001000",2844,968,144,264,164,297,0,115,4796
"39139001100",2428,269,95,13,12,7,34,0,2858
"39139001200",2899,468,129,125,88,0,55,0,3764
"39139001300",2494,489,221,83,100,8,63,0,3458
"39139001400",1251,342,184,82,5,168,54,0,2086
"39139001500",1181,523,5,55,8,125,7,6,1910
"39139001600",1310,715,33,0,42,66,0,25,2191
"39139001700",286,18,13,0,0,0,0,0,317
"39139001800",2804,391,184,59,73,0,22,0,3533
"39139001900",5287,570,63,0,64,12,100,0,6096
"39139002000",5004,309,0,0,75,0,0,0,5388
"39139002101",3957,319,694,0,389,0,27,0,5386
"39139002102",3979,196,69,0,229,0,39,0,4512
"39139002200",5749,751,62,0,187,112,68,0,6929
"39139002300",5015,469,144,9,233,0,119,0,5989
"39139002400",4672,284,58,0,551,0,117,0,5682
"39139002500",3312,491,0,0,17,6,11,0,3837
"39139002600",3926,892,0,0,45,0,138,0,5001
"39139002700",4468,321,0,0,0,12,0,12,4813
"39139002800",3525,471,0,0,39,9,62,0,4106
"39139002900",3662,609,0,0,38,66,30,66,4471
"39139003001",4580,409,26,0,7,0,73,0,5095
"39139003002",3048,278,25,0,109,112,8,0,3580
"39139003100",420,361,655,241,81,75,41,51,1925
"39141955500",5228,748,1,4,153,39,120,22,6315
"39141955601",1869,307,40,0,4,11,0,0,2231
"39141955602",211,76,13,0,29,0,18,0,347
"39141955603",3127,831,3,3,53,23,26,0,4066
"39141955700",4610,964,28,3,246,4,74,0,5929
"39141955800",5456,1205,52,139,156,57,6,0,7071
"39141955900",3311,211,251,23,200,48,78,0,4122
"39141956000",3466,1250,105,66,112,54,14,98,5165
"39141956100",2572,497,156,87,129,30,14,0,3485
"39141956200",1459,320,189,225,136,24,42,0,2395
"39141956300",1981,496,151,8,136,65,32,13,2882
"39141956400",2207,956,114,16,42,112,0,3,3450
"39141956500",2358,1191,142,75,205,100,35,3,4109
"39141956600",4540,519,30,0,76,51,0,0,5216
"39141956700",3556,543,56,31,147,16,0,0,4349
"39141956800",4510,1330,66,0,92,16,0,0,6014
"39141956900",3526,1015,30,0,116,31,16,0,4734
"39143960800",3012,347,3,0,110,0,42,0,3514
"39143960900",2944,413,25,1,100,15,113,26,3637
"39143961000",3431,266,3,3,328,121,407,89,4648
"39143961100",3416,354,0,1,208,101,287,7,4374
"39143961200",3485,224,27,7,142,0,213,17,4115
"39143961300",3421,484,133,42,84,69,275,322,4830
"39143961400",1852,535,205,53,131,309,400,245,3730
"39143961500",2770,608,310,163,412,0,698,229,5190
"39143961600",1976,711,184,76,204,0,295,55,3501
"39143961700",1984,286,64,81,172,181,337,150,3255
"39143961800",2659,543,98,311,258,149,305,158,4481
"39143961900",3044,428,0,25,119,13,195,49,3873
"39143962000",4983,777,0,0,293,0,366,82,6501
"39143962100",4169,578,10,0,60,0,47,0,4864
"39143962200",3791,450,10,0,87,0,119,6,4463
"39145002100",3712,970,9,0,105,11,0,11,4818
"39145002200",2953,872,0,0,44,0,0,0,3869
"39145002300",3045,1541,0,0,166,0,0,0,4752
"39145002400",4635,1307,0,15,11,64,16,71,6119
"39145002500",2254,539,0,0,34,8,0,0,2835
"39145002600",3096,909,65,0,23,5,8,29,4135
"39145002700",4811,356,0,1,109,0,5,0,5282
"39145002800",2961,1312,0,0,42,31,0,8,4354
"39145002900",4678,1004,80,0,83,27,108,0,5980
"39145003000",2438,1069,0,0,21,17,7,0,3552
"39145003100",2292,1144,0,0,49,9,39,26,3559
"39145003200",1092,700,0,18,47,0,0,0,1857
"39145003300",1565,353,12,11,295,41,0,0,2277
"39145003400",1946,900,246,31,14,28,0,45,3210
"39145003500",1184,1055,0,0,92,10,75,24,2440
"39145003600",551,907,112,17,15,7,4,0,1613
"39145003700",1385,1050,473,70,103,68,64,16,3229
"39145003800",3618,637,29,38,111,0,108,83,4624
"39145003900",2157,471,0,0,159,12,0,0,2799
"39145004000",3300,644,0,0,64,5,48,25,4086
"39147962500",3210,390,0,0,74,4,66,7,3751
"39147962600",3735,321,0,0,34,84,86,106,4366
"39147962700",3022,282,0,6,48,34,117,15,3524
"39147962800",2528,566,139,43,254,98,334,50,4012
"39147962900",1996,1218,230,141,162,189,269,23,4228
"39147963000",2209,677,37,68,91,27,213,57,3379
"39147963100",4168,266,0,7,45,1,8,34,4529
"39147963200",3118,887,17,2,77,0,105,0,4206
"39147963300",2675,591,7,0,51,55,71,167,3617
"39147963400",2626,1166,11,91,54,0,292,34,4274
"39147963500",2756,342,12,12,41,135,0,0,3298
"39147963600",3348,374,7,63,51,27,130,119,4119
"39147963700",3818,384,0,0,175,0,139,58,4574
"39147963800",3224,493,0,0,53,24,28,5,3827
"39149971400",4004,306,2,0,41,8,15,4,4380
"39149971500",4870,345,11,24,156,10,23,10,5449
"39149971600",4581,298,0,0,2,0,23,3,4907
"39149971700",3788,396,29,6,8,0,64,0,4291
"39149971800",3725,1260,223,267,135,0,117,60,5787
"39149971900",3578,447,98,23,235,24,171,0,4576
"39149972000",2008,1085,209,41,66,37,47,41,3534
"39149972100",4777,298,212,0,122,10,10,10,5439
"39149972200",4606,454,0,0,367,10,89,16,5542
"39149972300",4972,203,8,0,139,1,0,0,5323
"39151700100",243,291,152,234,12,65,0,13,1010
"39151700200",2806,1005,1530,369,317,122,207,11,6367
"39151700300",908,739,369,537,23,139,8,10,2733
"39151700400",3179,677,449,230,206,75,51,0,4867
"39151700500",1033,522,617,174,169,374,36,70,2995
"39151700600",1588,372,632,213,46,10,96,64,3021
"39151700700",4273,738,371,57,150,15,219,64,5887
"39151700800",1889,688,544,560,184,129,63,30,4087
"39151701000",1517,525,333,408,219,126,0,94,3222
"39151701100",2079,426,294,23,197,134,47,56,3256
"39151701200",2340,714,132,260,40,60,9,0,3555
"39151701300",2236,1148,204,221,224,567,103,35,4738
"39151701500",1235,835,308,137,208,104,61,23,2911
"39151701700",1300,917,214,283,29,97,156,11,3007
"39151701800",445,504,471,638,41,306,0,15,2420
"39151702100",386,546,1528,598,99,131,8,2,3298
"39151702300",369,921,796,986,36,303,0,77,3488
"39151702500",1836,863,69,128,215,127,99,11,3348
"39151710200",3013,815,421,249,81,230,36,123,4968
"39151710300",2243,714,178,154,147,0,128,21,3585
"39151710400",158,512,48,63,25,35,25,0,866
"39151710500",2098,1199,383,233,144,115,11,25,4208
"39151710600",3678,752,179,5,172,0,165,0,4951
"39151710700",1953,148,125,0,32,0,17,0,2275
"39151710800",4004,824,126,69,48,1,69,0,5141
"39151710900",3972,165,69,51,72,28,7,0,4364
"39151711000",6594,483,43,6,206,0,7,0,7339
"39151711111",4622,260,10,0,40,0,113,0,5045
"39151711112",4977,99,0,0,65,0,15,0,5156
"39151711121",6190,93,46,2,260,0,165,0,6756
"39151711122",4978,576,43,0,220,34,29,58,5938
"39151711202",3786,233,0,0,123,0,16,0,4158
"39151711211",6008,497,62,12,140,9,18,9,6755
"39151711212",2056,451,0,0,32,27,0,0,2566
"39151711311",7035,283,40,1,479,0,152,0,7990
"39151711312",6137,496,22,0,249,0,104,0,7008
"39151711321",3422,263,123,0,135,0,65,0,4008
"39151711322",2513,294,182,0,100,59,0,6,3154
"39151711402",5477,458,159,69,421,2,29,1,6616
"39151711411",3588,57,0,1,150,0,0,0,3796
"39151711412",3863,234,46,2,63,49,14,0,4271
"39151711501",3205,346,95,1,113,97,69,11,3937
"39151711502",2628,164,104,0,250,0,37,9,3192
"39151711600",4857,750,167,29,155,0,22,228,6208
"39151711700",4204,522,299,54,214,215,113,108,5729
"39151711800",4195,320,104,31,128,0,125,88,4991
"39151711900",4255,314,18,6,188,0,26,0,4807
"39151712000",3739,242,13,0,76,0,43,0,4113
"39151712102",5982,659,100,100,376,55,65,114,7451
"39151712111",5577,272,83,0,46,82,89,0,6149
"39151712112",1663,59,0,33,0,0,24,0,1779
"39151712201",4473,499,112,194,164,17,110,81,5650
"39151712202",5038,210,375,1,130,0,33,0,5787
"39151712300",4928,487,401,40,89,0,110,0,6055
"39151712400",4770,723,157,524,266,17,0,6,6463
"39151712500",1864,89,0,0,0,0,3,4,1960
"39151712601",2121,209,0,0,27,0,16,0,2373
"39151712602",4316,317,0,0,72,27,96,0,4828
"39151712700",4852,334,0,0,103,0,33,0,5322
"39151712800",4394,261,0,0,81,0,18,0,4754
"39151712900",3479,472,0,0,50,17,55,33,4106
"39151713000",3376,186,5,0,40,89,76,87,3859
"39151713100",4398,675,297,35,176,218,43,14,5856
"39151713201",5840,783,287,5,110,42,59,0,7126
"39151713202",1874,117,31,0,13,1,7,1,2044
"39151713300",3662,586,132,34,162,0,100,15,4691
"39151713401",4843,429,0,2,179,51,29,0,5533
"39151713402",3478,625,76,0,8,26,43,0,4256
"39151713501",4597,309,82,14,79,1,59,0,5141
"39151713502",4488,691,59,35,25,0,10,0,5308
"39151713600",2096,196,35,14,37,0,12,0,2390
"39151713700",1528,246,266,83,104,83,0,0,2310
"39151713900",1249,646,57,11,24,21,26,123,2157
"39151714000",3666,475,64,0,54,16,18,0,4293
"39151714100",2376,872,147,68,74,7,113,22,3679
"39151714200",810,809,712,244,66,191,49,70,2951
"39151714302",3364,390,228,135,68,0,78,21,4284
"39151714400",2453,385,253,10,168,80,42,175,3566
"39151714600",3785,215,10,0,102,0,31,0,4143
"39151714701",5142,377,27,61,12,32,18,0,5669
"39151714702",2547,173,0,0,59,0,0,0,2779
"39151714801",5620,554,8,0,131,8,29,7,6357
"39151714802",2357,383,0,0,4,35,0,0,2779
"39151714901",3416,463,0,0,49,10,0,10,3948
"39151714902",3051,367,42,70,28,90,24,4,3676
"39151715000",1900,498,191,67,30,20,70,0,2776
"39153501100",467,104,444,299,36,23,0,0,1373
"39153501700",374,565,152,203,135,0,44,23,1496
"39153501800",26,15,542,222,0,0,7,0,812
"39153501900",145,618,588,1009,58,59,0,199,2676
"39153502101",1171,383,493,159,578,209,114,0,3107
"39153502102",2139,543,991,246,415,31,0,26,4391
"39153502200",2586,1026,593,395,707,284,51,264,5906
"39153502300",2575,574,1338,373,186,94,0,0,5140
"39153502500",269,180,102,180,23,101,13,0,868
"39153502600",1655,558,322,138,70,217,22,14,2996
"39153502700",4555,495,606,481,251,86,36,1,6511
"39153502800",3502,335,269,31,139,65,57,0,4398
"39153503100",622,405,394,342,277,117,0,18,2175
"39153503200",370,220,656,430,145,176,49,27,2073
"39153503300",2696,541,800,1003,88,156,0,27,5311
"39153503400",76,54,673,476,3,24,0,16,1322
"39153503500",992,608,909,618,178,154,7,184,3650
"39153503600",3425,391,30,16,175,87,21,1,4146
"39153503701",5136,501,54,54,42,0,214,0,6001
"39153503702",4952,860,48,2,42,13,40,1,5958
"39153503800",1880,728,335,751,93,146,51,134,4118
"39153504100",265,828,30,206,0,78,0,0,1407
"39153504200",510,882,412,208,102,85,86,24,2309
"39153504400",419,270,269,282,12,39,4,0,1295
"39153504500",774,408,287,435,262,44,58,135,2403
"39153504600",1076,662,906,330,161,297,54,0,3486
"39153504700",3001,383,633,275,334,103,63,32,4824
"39153504800",3588,504,184,61,272,79,0,0,4688
"39153505200",346,79,505,298,76,34,31,7,1376
"39153505300",193,240,391,480,118,30,1,0,1453
"39153505400",2255,611,221,219,194,50,27,0,3577
"39153505500",1987,361,233,21,100,0,9,0,2711
"39153505600",425,181,159,301,194,10,7,0,1277
"39153505700",1332,830,104,97,140,45,36,12,2596
"39153505800",3251,548,385,230,406,311,280,0,5411
"39153505900",1825,643,85,5,56,24,0,0,2638
"39153506100",2907,572,1369,484,87,142,55,0,5616
"39153506200",398,140,2634,645,154,69,70,26,4136
"39153506400",1365,584,645,342,63,71,10,0,3080
"39153506500",237,107,1231,931,86,36,0,0,2628
"39153506600",1139,378,562,496,75,92,38,21,2801
"39153506700",11,9,739,465,23,75,0,19,1341
"39153506800",144,117,574,594,0,17,21,30,1497
"39153507101",2931,104,1041,240,108,33,125,0,4582
"39153507102",2132,161,227,11,152,0,32,0,2715
"39153507201",1708,163,441,147,82,6,7,0,2554
"39153507202",2623,275,222,60,148,22,71,13,3434
"39153507203",3442,291,606,7,246,184,174,0,4950
"39153507300",2142,255,249,66,123,35,0,0,2870
"39153507400",204,110,299,76,24,104,0,0,817
"39153507500",2298,640,1925,947,264,203,234,45,6556
"39153507600",2979,535,310,127,274,175,196,0,4596
"39153508000",3132,343,824,81,108,41,50,91,4670
"39153508301",279,557,182,601,22,213,21,25,1900
"39153508399",1316,541,1786,991,187,62,0,0,4883
"39153508600",86,107,1836,760,77,67,9,10,2952
"39153508800",225,344,3661,1776,121,54,6,0,6187
"39153508900",478,1042,78,334,330,316,0,0,2578
"39153509000",344,247,369,429,115,168,0,0,1672
"39153510100",1691,702,65,55,82,116,50,17,2778
"39153510200",3396,607,0,51,145,25,41,9,4274
"39153510301",2524,892,869,437,242,65,55,82,5166
"39153510302",4924,940,84,49,37,0,19,0,6053
"39153510400",3170,385,22,11,37,11,0,0,3636
"39153510500",3549,525,141,0,154,0,169,0,4538
"39153520103",1580,135,89,0,84,3,0,6,1897
"39153520104",3608,633,153,66,63,31,60,0,4614
"39153520105",3429,544,97,6,44,0,25,22,4167
"39153520106",1957,477,125,0,141,0,52,0,2752
"39153520201",2613,100,16,1,81,23,28,22,2884
"39153520202",3765,549,94,2,39,5,0,18,4472
"39153520301",2825,381,70,70,124,7,142,0,3619
"39153520302",3104,191,55,0,40,0,51,0,3441
"39153520400",4090,310,0,0,204,77,368,74,5123
"39153520500",3929,343,5,38,66,64,79,3,4527
"39153520600",2894,401,0,0,0,107,71,57,3530
"39153530101",4262,8,711,0,434,0,87,0,5502
"39153530103",3622,51,622,0,321,0,35,0,4651
"39153530104",5375,354,1102,59,288,96,145,0,7419
"39153530105",975,220,343,357,90,107,10,0,2102
"39153530108",2989,86,854,0,554,71,167,0,4721
"39153530401",3045,147,134,44,112,9,10,15,3516
"39153530402",2732,257,37,43,115,34,9,0,3227
"39153530501",4752,311,31,15,42,155,0,63,5369
"39153530502",2977,196,63,24,131,15,45,0,3451
"39153530603",3986,362,25,1,242,0,111,0,4727
"39153530604",2988,167,118,2,174,0,34,0,3483
"39153530605",4609,123,55,30,292,24,56,0,5189
"39153530606",5315,190,105,2,78,0,66,0,5756
"39153530700",2368,87,0,1,63,0,12,0,2531
"39153530800",5883,136,102,0,295,0,60,0,6476
"39153530901",3134,431,153,448,194,159,8,0,4527
"39153530902",4998,737,106,0,23,15,46,0,5925
"39153530903",4677,254,16,18,168,12,66,12,5223
"39153531001",2979,385,0,0,77,8,26,0,3475
"39153531002",4919,627,43,4,125,0,48,0,5766
"39153531101",2912,213,211,0,108,3,17,0,3464
"39153531102",3765,405,8,0,78,0,19,0,4275
"39153531103",2546,436,57,3,174,0,60,59,3335
"39153531401",6714,193,28,0,211,0,109,0,7255
"39153531405",3790,441,94,0,74,41,27,0,4467
"39153531500",7580,339,73,3,102,115,116,0,8328
"39153531601",4025,177,0,23,164,9,0,0,4398
"39153531602",2870,52,0,0,55,0,0,0,2977
"39153531701",3324,239,19,8,32,8,19,4,3653
"39153531702",4166,381,0,0,17,0,46,0,4610
"39153531801",4481,598,57,1,135,6,48,0,5326
"39153531802",3862,398,168,29,148,85,10,0,4700
"39153532001",3395,165,85,0,11,0,43,9,3708
"39153532003",4093,266,0,0,24,10,57,49,4499
"39153532004",3643,208,100,15,28,0,60,0,4054
"39153532202",4780,146,798,41,342,12,54,12,6185
"39153532301",4732,265,188,12,355,0,174,0,5726
"39153532302",4980,86,131,17,189,0,0,0,5403
"39153532501",2816,133,56,0,0,0,24,0,3029
"39153532502",2810,33,13,1,90,1,20,0,2968
"39153532600",2799,75,44,0,87,0,33,0,3038
"39153532701",5403,153,1208,0,434,0,147,0,7345
"39153532702",2606,267,64,9,615,97,76,0,3734
"39153532703",4615,158,626,147,272,0,192,0,6010
"39153532705",6129,198,374,92,167,60,122,0,7142
"39153532706",3394,156,103,0,47,0,109,0,3809
"39153532708",4578,57,568,0,208,0,81,0,5492
"39153532901",1374,71,14,0,27,0,49,0,1535
"39153532902",5927,900,538,52,667,33,152,0,8269
"39153532999",4623,612,235,54,191,93,11,0,5819
"39153533000",1430,131,0,1,31,0,0,0,1593
"39153533101",4546,172,0,0,191,33,42,0,4984
"39153533102",2343,101,54,16,136,20,167,0,2837
"39153533200",4736,141,116,7,360,28,51,0,5439
"39153533400",4151,292,1071,85,162,0,104,0,5865
"39153533501",6108,144,495,0,1256,15,163,0,8181
"39153533502",3443,172,214,9,72,0,76,0,3986
"39153534000",5925,139,90,0,319,22,55,0,6550
"39153534100",2500,25,0,0,167,25,43,25,2785
"39155920300",2280,215,220,18,43,51,7,7,2841
"39155920400",1520,548,216,146,72,28,27,13,2570
"39155920500",143,69,145,458,18,19,0,0,852
"39155920600",616,695,704,1320,0,100,0,48,3483
"39155920700",1627,588,636,555,104,11,70,34,3625
"39155920800",720,586,119,389,30,175,22,74,2115
"39155920900",1175,525,897,616,186,41,0,121,3561
"39155921000",2419,398,1564,602,38,170,8,0,5199
"39155921100",1947,761,344,406,160,90,0,0,3708
"39155921200",1088,405,108,282,24,32,11,143,2093
"39155921300",1640,445,67,10,0,0,29,66,2257
"39155921400",2768,312,127,0,51,0,68,0,3326
"39155921500",3969,723,245,130,76,9,115,18,5285
"39155921600",1782,1325,653,212,115,119,48,38,4292
"39155930101",2225,541,24,18,92,29,0,0,2929
"39155930102",2305,268,0,0,7,0,62,0,2642
"39155930200",2533,129,0,0,0,19,0,0,2681
"39155930300",3460,244,18,0,47,11,97,0,3877
"39155930400",3746,296,6,25,23,0,49,10,4155
"39155930500",4795,1091,86,21,28,12,56,8,6097
"39155930600",3345,300,7,20,0,0,0,0,3672
"39155930700",3629,429,62,0,0,10,62,0,4192
"39155930800",4298,347,50,15,137,0,28,0,4875
"39155930900",6454,471,49,0,33,0,17,0,7024
"39155931000",4920,527,68,9,213,0,0,0,5737
"39155931100",2200,231,4,0,48,0,0,0,2483
"39155931200",3198,641,31,14,22,15,0,90,4011
"39155931300",3958,287,43,1,7,0,0,0,4296
"39155931400",3064,902,107,96,56,32,0,0,4257
"39155931500",3601,105,0,0,70,15,31,0,3822
"39155931601",3480,639,0,40,126,77,95,0,4457
"39155931602",2893,308,0,0,21,0,36,0,3258
"39155931700",1646,165,121,4,5,0,99,7,2047
"39155931900",3742,401,808,522,273,33,46,26,5851
"39155932000",4974,469,325,48,253,0,0,0,6069
"39155932200",1917,438,84,50,45,205,39,67,2845
"39155932300",4662,738,41,15,70,58,204,12,5800
"39155932500",2658,497,23,0,0,0,25,63,3266
"39155932600",2631,457,41,56,130,23,14,0,3352
"39155932701",4554,924,63,151,88,192,13,9,5994
"39155932702",1873,323,95,7,23,18,38,7,2384
"39155932801",1916,794,188,41,65,0,11,45,3060
"39155932802",2788,609,0,15,142,74,36,13,3677
"39155932900",1916,184,41,5,107,0,64,0,2317
"39155933001",5497,376,1,0,119,0,67,0,6060
"39155933002",3764,288,26,58,72,10,27,16,4261
"39155933100",2153,280,23,0,43,0,27,0,2526
"39155933301",1965,785,18,0,0,0,6,32,2806
"39155933302",3995,296,15,0,7,0,37,0,4350
"39155933400",2970,317,22,0,33,32,15,0,3389
"39155933500",3281,307,24,0,122,43,63,0,3840
"39155933600",4004,814,11,0,15,75,73,63,5055
"39155933700",2342,363,83,33,0,0,5,82,2908
"39155933800",1181,578,345,407,36,54,14,34,2649
"39155933900",1471,531,18,138,65,27,3,0,2253
"39157020100",4719,436,0,0,32,6,19,0,5212
"39157020200",3373,348,6,0,40,28,151,0,3946
"39157020300",3452,97,32,4,18,8,0,0,3611
"39157020400",4482,1044,0,0,20,0,0,0,5546
"39157020500",4559,470,0,0,58,0,47,85,5219
"39157020600",4666,191,24,0,82,3,0,0,4966
"39157020700",4729,1507,0,13,71,0,192,221,6733
"39157020800",4646,938,66,13,104,205,360,205,6537
"39157020900",2994,544,87,72,194,187,32,108,4218
"39157021000",3948,736,5,0,12,72,43,20,4836
"39157021100",1949,301,16,93,51,45,186,44,2685
"39157021200",2466,343,9,4,45,0,75,0,2942
"39157021300",4348,261,0,0,48,0,36,0,4693
"39157021400",2014,175,0,0,111,0,7,0,2307
"39157021500",6618,586,0,2,101,0,0,0,7307
"39157021600",3729,721,81,15,41,9,22,11,4629
"39157021700",4185,872,56,206,102,16,70,14,5521
"39157021800",2277,510,0,0,32,0,0,0,2819
"39157021900",2368,286,0,1,5,0,0,0,2660
"39157022001",2934,533,0,6,19,0,0,0,3492
"39157022002",2304,1082,0,0,0,44,0,20,3450
"39159050100",3389,264,0,0,34,5,53,5,3750
"39159050200",3765,615,0,2,176,0,27,0,4585
"39159050301",3515,75,0,0,70,0,45,0,3705
"39159050303",5873,368,104,0,295,0,0,18,6658
"39159050304",2205,47,33,0,24,0,0,0,2309
"39159050400",5820,268,0,1,463,0,139,0,6691
"39159050500",3734,1111,0,30,281,13,0,0,5169
"39159050601",3710,204,220,0,827,0,100,0,5061
"39159050602",3143,407,22,0,391,49,118,0,4130
"39159050700",7498,323,4,139,35,2,90,6,8097
"39161020100",3497,198,5,0,42,0,178,7,3927
"39161020200",3821,351,9,45,136,27,71,0,4460
"39161020300",2411,253,0,0,18,39,0,0,2721
"39161020400",2688,267,6,0,20,7,7,8,3003
"39161020500",2873,367,0,0,32,0,0,24,3296
"39161020600",1208,530,18,3,62,23,73,12,1929
"39161020700",1431,343,0,7,12,19,20,0,1832
"39161020800",2965,810,54,21,61,78,75,149,4213
"39161020900",2893,321,24,10,62,28,130,6,3474
"39163953000",3960,1062,0,33,137,24,0,0,5216
"39163953100",3803,948,0,0,113,37,3,9,4913
"39163953200",2193,892,0,0,16,4,0,0,3105
"39165030101",4168,51,0,0,38,0,14,0,4271
"39165030102",3124,410,0,36,108,31,30,1,3740
"39165030200",997,188,0,0,4,12,0,7,1208
"39165030501",2894,507,0,30,188,22,0,22,3663
"39165030503",4575,462,30,0,356,9,37,14,5483
"39165030504",4558,53,28,0,160,0,108,0,4907
"39165030600",3356,353,0,0,107,32,13,16,3877
"39165030700",6314,173,83,177,81,0,117,30,6975
"39165030800",6179,91,35,11,131,0,76,0,6523
"39165030900",11954,144,429,0,757,38,218,38,13578
"39165031000",7570,618,4,0,127,12,143,4,8478
"39165031100",3327,267,0,16,113,0,15,0,3738
"39165031200",7799,180,0,4,102,0,194,0,8279
"39165031300",4382,179,0,3,166,0,50,0,4780
"39165031400",3193,590,424,356,308,0,240,0,5111
"39165031500",4057,556,233,2,46,51,63,0,5008
"39165031600",7131,485,237,3,131,0,0,0,7987
"39165031700",0,0,0,0,0,0,0,0,0
"39165031902",7823,452,724,0,1211,75,420,30,10735
"39165031903",13173,182,619,0,2948,0,872,0,17794
"39165031904",5219,315,69,25,704,0,0,0,6332
"39165032003",6040,320,93,0,409,0,88,0,6950
"39165032004",4983,13,222,17,820,0,162,0,6217
"39165032005",6890,358,562,10,2502,0,220,0,10542
"39165032006",3049,131,44,26,267,0,193,49,3759
"39165032007",5652,305,18,1,589,60,268,2,6895
"39165032100",5242,337,162,5,328,0,287,0,6361
"39165032201",17959,1075,461,2,206,10,382,76,20171
"39165032202",5019,176,101,0,165,0,105,3,5569
"39165032300",4013,386,3,5,47,11,43,0,4508
"39165032400",4625,182,1,0,28,2,132,0,4970
"39165032501",2940,518,27,0,122,5,70,0,3682
"39165032502",3153,936,8,41,105,29,22,36,4330
"39167020101",3058,527,107,13,76,0,69,24,3874
"39167020102",1315,640,74,63,53,1,0,0,2146
"39167020200",5235,1451,0,0,0,69,0,0,6755
"39167020300",3191,391,10,0,96,0,134,0,3822
"39167020400",1776,276,22,0,10,10,0,0,2094
"39167020500",983,758,10,0,11,11,0,0,1773
"39167020800",3106,645,0,0,110,27,15,0,3903
"39167020900",1824,334,4,0,25,17,0,44,2248
"39167021000",2384,1082,76,0,58,118,0,67,3785
"39167021100",3076,769,10,1,122,67,0,0,4045
"39167021200",4749,861,0,0,0,4,12,5,5631
"39167021300",4267,461,6,0,142,10,5,6,4897
"39167021400",3311,279,0,1,129,15,110,0,3845
"39167021500",1330,63,0,0,6,11,7,0,1417
"39167021600",3627,163,14,0,40,29,0,0,3873
"39167021700",5048,653,117,12,78,27,20,0,5955
"39169000100",2069,709,73,65,48,91,8,14,3077
"39169000200",2632,152,1,0,244,0,29,0,3058
"39169000300",1807,428,43,42,54,26,89,0,2489
"39169000500",2343,590,53,193,122,65,129,32,3527
"39169000600",3969,1107,42,45,32,12,16,18,5241
"39169000700",6303,421,44,8,197,0,100,14,7087
"39169000800",5260,1167,142,11,382,0,116,0,7078
"39169000900",3367,462,23,0,12,0,24,0,3888
"39169001000",2231,215,8,11,43,192,0,24,2724
"39169001100",1299,66,57,0,0,0,26,0,1448
"39169001200",1110,150,9,11,24,23,13,0,1340
"39169001300",2971,898,69,19,102,37,15,56,4167
"39169001400",2331,702,55,82,19,0,75,176,3440
"39169001700",6349,1163,0,2,32,0,171,10,7727
"39169001800",3346,532,0,0,0,0,13,0,3891
"39169001900",2623,336,3,0,72,29,25,10,3098
"39169002000",2701,298,12,1,60,29,49,0,3150
"39169002100",2325,453,0,4,15,0,0,0,2797
"39169002200",3388,461,43,0,75,7,12,3,3989
"39169002300",2669,156,0,33,143,0,135,0,3136
"39169002400",3200,354,11,0,37,0,0,5,3607
"39169002500",2269,218,8,0,42,17,13,0,2567
"39169002901",3180,139,76,0,30,70,34,70,3599
"39169002902",4771,207,0,29,77,0,161,20,5265
"39169003000",2086,89,0,0,20,0,4,0,2199
"39169003100",1980,118,0,0,169,0,0,0,2267
"39169003200",3425,63,56,0,31,3,18,16,3612
"39169003300",2500,475,19,0,5,9,0,0,3008
"39169003400",2351,710,14,14,184,0,0,0,3273
"39169003500",3134,283,0,4,24,11,0,0,3456
"39169003700",3002,529,0,0,16,16,29,4,3596
"39169980000",111,26,0,0,0,0,0,0,137
"39171950100",4171,589,14,7,116,59,163,47,5166
"39171950200",3614,474,1,0,32,29,30,2,4182
"39171950300",3517,740,0,6,145,24,144,11,4587
"39171950400",4117,369,0,0,57,19,72,4,4638
"39171950500",2697,313,32,23,143,51,148,83,3490
"39171950600",3123,1307,11,0,126,76,175,96,4914
"39171950700",3617,408,0,4,81,40,199,0,4349
"39171950800",2863,382,0,0,62,3,42,3,3355
"39171950900",2391,320,31,7,55,7,110,26,2947
"39173020100",4651,436,0,0,145,53,303,0,5588
"39173020200",2376,158,133,0,56,57,98,0,2878
"39173020300",4326,301,29,0,86,19,173,29,4963
"39173020401",4458,367,79,0,150,14,27,0,5095
"39173020402",4347,224,246,9,588,0,121,14,5549
"39173020500",1772,198,5,11,58,126,12,34,2216
"39173020601",3419,312,58,0,507,20,384,38,4738
"39173020602",6161,206,96,0,520,0,273,0,7256
"39173020700",5086,1164,156,2,274,158,193,75,7108
"39173020800",3601,459,0,0,19,6,69,0,4154
"39173020900",5877,591,247,90,164,2,288,187,7446
"39173021000",3388,316,0,2,109,36,122,43,4016
"39173021100",3381,334,0,9,72,152,195,42,4185
"39173021200",5251,311,48,12,239,4,196,0,6061
"39173021300",3208,253,5,18,41,13,58,15,3611
"39173021400",2766,303,13,1,100,51,316,41,3591
"39173021500",2221,119,0,0,77,0,107,14,2538
"39173021600",5536,839,37,48,164,149,218,55,7046
"39173021701",1563,1388,66,114,69,59,55,24,3338
"39173021702",2968,1840,41,59,147,236,196,83,5570
"39173021800",38,115,0,2,3,28,5,1,192
"39173021901",3380,259,4,0,235,0,219,1,4098
"39173021902",2669,2194,49,347,280,169,484,210,6402
"39173022100",3445,661,2,0,137,25,240,108,4618
"39173022200",1765,603,43,4,37,9,12,77,2550
"39173022300",3371,302,17,16,208,43,93,49,4099
"39173022400",2964,482,0,0,170,28,239,26,3909
"39173022500",2867,826,156,120,192,41,147,42,4391
"39175938000",3629,281,3,2,0,0,31,0,3946
"39175938100",4006,391,19,3,169,0,102,0,4690
"39175938200",3534,320,0,1,33,0,77,0,3965
"39175938300",3115,467,1,0,22,22,0,0,3627
"39175938400",2253,581,0,0,69,0,110,129,3142
"39175938500",2497,417,21,0,234,5,95,8,3277
"40001376600",1379,250,0,0,784,238,102,22,2775
"40001376700",2067,703,26,0,1895,680,87,59,5517
"40001376800",1523,371,10,1,1959,610,57,40,4571
"40001376900",1036,652,0,16,1829,819,252,430,5034
"40001377000",1227,664,0,8,2254,984,122,84,5343
"40003955600",1021,220,0,0,173,16,38,9,1477
"40003955700",1100,166,0,0,126,19,34,0,1445
"40003956000",1462,179,3,0,115,48,24,2,1833
"40005587600",865,90,5,8,299,30,25,15,1337
"40005587700",1874,776,79,193,456,263,114,55,3810
"40005587800",2461,463,4,0,578,227,96,11,3840
"40005587900",2353,620,16,4,727,158,73,13,3964
"40007951600",1702,296,33,18,506,9,655,116,3335
"40007951700",1165,91,0,0,53,17,49,4,1379
"40007951800",1206,70,0,0,330,4,344,11,1965
"40009966100",5814,883,127,5,695,130,886,273,8813
"40009966200",5139,570,74,0,482,54,328,98,6745
"40009966500",1115,489,0,0,102,15,24,27,1772
"40009966800",3824,821,48,0,467,51,440,122,5773
"40011958600",1117,102,5,0,84,0,69,38,1415
"40011958700",1292,121,0,0,101,64,75,0,1653
"40011958800",1255,155,0,0,70,79,45,21,1625
"40011958900",1182,385,114,24,171,54,172,23,2125
"40011959000",1190,129,31,0,222,110,92,28,1802
"40013795600",1683,371,0,0,405,112,16,68,2655
"40013795700",2224,560,9,7,648,153,32,15,3648
"40013795900",1112,164,32,20,274,62,11,0,1675
"40013796001",3786,569,31,2,1153,245,177,179,6142
"40013796002",3060,375,52,7,1013,200,63,30,4800
"40013796100",5683,875,36,26,1309,256,249,17,8451
"40013796200",1980,509,78,87,629,291,298,55,3927
"40013796300",1035,241,10,27,309,44,126,23,1815
"40013796400",769,556,37,0,534,344,289,79,2608
"40013796500",1366,210,32,0,382,234,0,43,2267
"40013796600",3733,729,215,56,1101,171,373,65,6443
"40015161600",3580,614,11,18,900,194,582,217,6116
"40015161700",1317,151,5,3,154,102,139,81,1952
"40015161800",1645,453,6,12,796,319,384,69,3684
"40015161900",975,196,9,14,266,167,30,7,1664
"40015162000",2084,181,28,0,777,102,110,30,3312
"40015162100",1937,704,179,134,2660,1698,501,596,8409
"40015162200",1600,54,7,26,890,230,100,43,2950
"40015162300",1935,295,29,2,460,19,46,17,2803
"40017300100",1782,460,8,25,184,212,40,30,2741
"40017300201",5022,204,34,0,462,6,205,7,5940
"40017300202",3439,274,63,51,451,133,199,72,4682
"40017300300",2436,379,40,3,816,252,682,198,4806
"40017300400",295,21,411,21,132,157,69,86,1192
"40017300500",1726,423,199,38,1011,76,419,128,4020
"40017300600",2726,104,0,0,443,123,212,30,3638
"40017300700",3034,386,52,5,671,146,174,3,4471
"40017300801",7292,75,553,0,1380,0,1013,0,10313
"40017300802",2084,80,0,0,103,119,40,0,2426
"40017300901",4610,305,68,0,752,41,295,0,6071
"40017300902",1960,153,42,0,317,8,117,0,2597
"40017300904",2586,107,83,0,622,59,351,0,3808
"40017300905",3888,57,171,0,571,23,98,27,4835
"40017301001",165,18,9,0,69,24,0,0,285
"40017301003",4898,167,0,0,1116,32,526,0,6739
"40017301006",2332,89,21,0,513,35,346,11,3347
"40017301007",4175,252,79,49,944,0,298,0,5797
"40017301008",4546,197,103,0,1926,0,425,0,7197
"40017301009",2627,133,50,0,206,59,8,59,3142
"40017301100",5018,628,0,0,567,0,260,206,6679
"40017301201",2928,543,106,0,291,16,217,66,4167
"40017301202",2387,287,3,0,158,76,167,59,3137
"40017301300",4151,197,8,0,507,73,261,0,5197
"40017301406",4391,354,32,0,472,146,356,124,5875
"40017301407",4652,419,0,0,458,37,202,42,5810
"40017301408",1610,294,0,0,169,0,72,0,2145
"40017301409",2657,141,17,0,222,4,161,0,3202
"40017301410",3704,207,0,0,632,0,393,0,4936
"40019892100",1489,325,243,62,320,75,16,45,2575
"40019892200",1025,108,46,0,98,19,64,11,1371
"40019892300",2447,371,0,0,270,7,47,30,3172
"40019892400",2458,477,3,0,341,73,70,34,3456
"40019892500",6969,988,130,54,1383,187,290,0,10001
"40019892600",3654,569,567,166,934,189,171,5,6255
"40019892700",3505,273,182,40,696,227,202,0,5125
"40019892800",1704,647,558,337,819,728,231,409,5433
"40019892900",1368,214,194,42,315,22,130,41,2326
"40019893000",4266,567,263,0,1349,104,623,0,7172
"40019893100",1709,329,305,55,473,142,413,78,3504
"40021977600",2172,526,32,11,1889,403,82,73,5188
"40021977700",3566,487,108,4,2416,402,159,91,7233
"40021977800",2255,621,0,0,2642,981,133,156,6788
"40021977900",2023,887,144,19,2057,749,187,150,6216
"40021978000",1543,860,0,37,820,574,221,394,4449
"40021978100",2050,665,0,13,1613,736,153,195,5425
"40021978201",966,236,12,25,1273,285,159,103,3059
"40021978202",1386,128,0,4,1048,307,45,64,2982
"40021978300",3300,528,8,29,2143,853,348,205,7414
"40023966900",1669,490,4,20,485,101,57,28,2854
"40023967000",1890,360,102,26,559,158,65,20,3180
"40023967100",1540,679,283,140,423,291,0,129,3485
"40023967200",654,474,368,449,415,260,50,61,2731
"40023967300",1343,360,102,57,974,287,73,22,3218
"40025950100",821,187,0,0,173,9,121,43,1354
"40025950300",740,205,0,0,131,83,244,83,1486
"40027200100",109,114,0,0,14,9,0,10,256
"40027200200",1055,456,0,0,153,177,70,257,2168
"40027200300",2505,687,106,7,284,103,450,6,4148
"40027200400",1398,374,0,0,137,107,154,76,2246
"40027200500",2220,986,96,0,213,100,152,104,3871
"40027200601",2489,1390,345,171,898,680,255,77,6305
"40027200602",2182,1048,115,63,227,79,240,125,4079
"40027200700",83,56,0,0,0,10,0,10,159
"40027200800",5287,248,717,96,502,57,364,0,7271
"40027200900",3294,338,122,8,192,56,131,78,4219
"40027201000",4146,612,319,107,491,144,392,211,6422
"40027201101",3612,411,202,0,813,373,96,20,5527
"40027201102",1975,347,89,8,167,221,109,56,2972
"40027201201",646,653,41,73,138,194,85,101,1931
"40027201202",92,323,0,36,12,69,12,19,563
"40027201203",2666,839,171,264,510,320,279,46,5095
"40027201301",3855,1909,283,353,1014,325,433,113,8285
"40027201403",4181,380,43,0,542,18,344,112,5620
"40027201404",2317,561,19,44,198,112,178,86,3515
"40027201405",4449,355,0,77,599,0,117,0,5597
"40027201505",4663,130,72,0,459,20,142,0,5486
"40027201507",4755,360,131,89,1110,375,127,123,7070
"40027201508",2238,538,29,0,351,122,292,42,3612
"40027201509",2035,46,12,4,531,30,101,0,2759
"40027201510",5474,220,389,0,1086,90,217,12,7488
"40027201602",2222,166,77,0,348,177,98,87,3175
"40027201603",2383,518,96,81,536,164,472,56,4306
"40027201604",2640,231,0,0,362,175,316,10,3734
"40027201607",4002,42,102,117,869,103,220,0,5455
"40027201609",2977,266,214,0,859,0,192,0,4508
"40027201610",2528,132,39,0,981,0,519,0,4199
"40027201611",1807,29,50,0,204,40,206,0,2336
"40027201612",3753,362,125,0,791,250,385,239,5905
"40027201700",1647,88,92,0,141,0,76,0,2044
"40027201801",2962,15,0,0,1091,5,170,0,4243
"40027201802",2677,183,41,0,490,7,406,9,3813
"40027201902",2800,278,734,48,702,82,446,128,5218
"40027201903",1614,112,512,68,513,140,218,28,3205
"40027201904",2964,85,603,7,764,128,563,62,5176
"40027202002",2899,334,90,38,489,88,219,14,4171
"40027202004",2467,220,132,63,486,40,326,75,3809
"40027202005",3316,1355,225,36,994,80,251,325,6582
"40027202006",1853,232,350,9,457,70,99,120,3190
"40027202007",2548,310,236,0,441,59,214,290,4098
"40027202008",3055,297,221,0,438,104,53,0,4168
"40027202102",1869,346,71,0,232,87,147,21,2773
"40027202104",1725,192,44,0,491,11,89,17,2569
"40027202105",3138,320,179,16,880,87,666,139,5425
"40027202106",4731,609,45,181,1617,105,554,55,7897
"40027202107",1728,75,212,0,485,6,227,0,2733
"40027202201",2810,120,292,0,440,11,498,0,4171
"40027202203",2933,206,91,8,698,95,362,45,4438
"40027202205",4871,71,96,73,1614,166,654,110,7655
"40027202206",1975,131,151,18,467,69,180,7,2998
"40027202301",4670,352,118,0,397,11,232,30,5810
"40027202302",4065,524,12,0,680,0,238,27,5546
"40027202402",4315,593,64,0,822,183,77,29,6083
"40027202403",4118,273,12,34,605,66,380,43,5531
"40027202404",3423,354,0,16,520,47,85,16,4461
"40027202405",3076,777,0,0,314,39,60,56,4322
"40027202500",4899,787,19,0,692,144,245,178,6964
"40027202600",1846,390,20,7,356,50,151,118,2938
"40029388100",2194,666,27,0,797,206,139,35,4064
"40029388200",1072,248,0,0,472,103,10,5,1910
"40031000100",2157,317,574,366,470,400,449,198,4931
"40031000200",898,434,359,258,366,333,506,211,3365
"40031000300",2736,670,1032,239,824,359,478,241,6579
"40031000401",2990,520,1073,149,1712,140,952,42,7578
"40031000402",2410,168,825,187,684,220,544,122,5160
"40031000403",2888,207,473,43,639,51,360,37,4698
"40031000501",4175,514,1729,408,815,126,673,25,8465
"40031000502",3828,473,1282,544,2235,128,1394,47,9931
"40031000600",1444,251,148,175,257,51,277,14,2617
"40031000700",1594,183,260,152,529,50,481,0,3249
"40031000800",977,368,262,262,201,128,191,10,2399
"40031000900",1262,187,128,4,298,32,165,6,2082
"40031001000",1276,213,132,48,253,71,166,36,2195
"40031001100",954,356,57,168,137,134,175,34,2015
"40031001400",280,326,143,59,187,184,52,143,1374
"40031001500",1489,764,202,357,176,195,160,105,3448
"40031001600",322,398,512,408,150,310,74,97,2271
"40031001700",1381,441,256,93,334,313,447,131,3396
"40031001901",1113,215,256,73,268,0,335,30,2290
"40031001902",621,267,450,255,152,16,108,42,1911
"40031002001",3242,49,631,195,982,71,636,31,5837
"40031002003",1724,67,65,0,63,20,38,0,1977
"40031002004",2097,221,519,282,761,30,209,1,4120
"40031002005",1749,184,444,173,622,181,323,97,3773
"40031002100",5570,775,98,0,978,129,374,69,7993
"40031002200",3997,534,226,48,1053,236,387,9,6490
"40031002301",4013,294,298,63,521,142,269,16,5616
"40031002302",3184,443,93,3,739,373,160,65,5060
"40031002401",18,0,3,0,12,0,0,0,33
"40031002403",924,432,421,0,129,22,337,371,2636
"40031002404",1592,341,342,0,817,77,731,110,4010
"40031002500",998,339,262,258,216,148,103,88,2412
"40033871100",2402,318,26,0,502,226,190,5,3669
"40033871200",1748,317,70,11,241,138,59,150,2734
"40035373100",1850,296,13,0,790,138,100,25,3212
"40035373200",1299,264,0,0,780,134,65,16,2558
"40035373300",1686,486,219,6,691,347,16,0,3451
"40035373400",1501,305,84,9,629,176,72,0,2776
"40035373500",1399,285,12,0,508,42,17,13,2276
"40037020101",1488,232,0,40,290,38,82,11,2181
"40037020102",770,194,0,18,240,92,51,25,1390
"40037020103",2445,131,0,0,442,121,84,36,3259
"40037020601",4166,747,32,12,903,364,351,23,6598
"40037020602",2496,358,19,23,364,100,153,0,3513
"40037020702",2803,348,14,0,631,41,61,17,3915
"40037020704",1304,300,0,0,197,8,38,0,1847
"40037020705",2156,223,0,0,398,71,39,0,2887
"40037020706",3594,455,0,0,667,233,13,62,5024
"40037020707",1421,153,5,0,241,23,30,2,1875
"40037020800",2180,597,0,5,398,122,42,0,3344
"40037020900",1841,473,115,98,269,174,27,0,2997
"40037021000",1907,573,201,95,483,177,53,17,3506
"40037021101",2093,342,95,56,428,87,60,8,3169
"40037021102",2248,509,59,17,708,236,57,5,3839
"40037021201",1693,91,0,0,306,12,140,0,2242
"40037021202",2555,378,246,122,505,180,171,0,4157
"40037021300",1291,435,8,0,251,153,56,108,2302
"40037021400",4204,354,46,86,835,225,233,68,6051
"40037021500",3695,424,49,13,920,134,335,0,5570
"40037021600",1763,176,0,12,404,35,2,9,2401
"40039950800",2419,502,152,69,558,191,1311,340,5542
"40039960400",5341,385,31,62,913,117,1151,177,8177
"40039960600",2713,1033,23,144,323,394,421,181,5232
"40039960700",6802,664,89,109,437,187,522,47,8857
"40039961000",2386,422,0,0,311,207,129,19,3474
"40041375601",2098,637,18,0,565,191,46,209,3764
"40041375602",2328,390,0,0,479,136,22,4,3359
"40041375700",4971,958,0,1,1168,295,167,0,7560
"40041375801",2002,560,9,0,540,189,33,7,3340
"40041375802",2012,385,0,0,414,92,36,3,2942
"40041375900",1890,586,32,0,825,380,49,14,3776
"40041376000",2018,520,0,0,2094,1056,183,168,6039
"40041376100",2004,166,3,17,2070,954,51,52,5317
"40041976200",2914,651,48,3,1491,570,160,85,5922
"40043959100",1330,138,0,0,232,46,78,4,1828
"40043959200",1186,270,0,0,81,37,82,60,1716
"40043959300",1088,139,3,0,139,15,34,12,1430
"40045952600",2278,465,0,0,94,30,135,79,3081
"40045952800",971,141,0,0,94,2,52,21,1281
"40047000100",3372,1343,124,22,800,95,670,16,6442
"40047000200",2029,253,5,2,315,277,46,6,2933
"40047000600",4216,767,469,76,745,21,688,0,6982
"40047000700",3195,967,109,0,952,702,871,805,7601
"40047001100",2813,269,0,0,202,46,99,20,3449
"40047001200",3157,447,12,0,261,44,198,72,4191
"40047001300",6707,301,89,0,615,0,248,45,8005
"40047001401",2802,185,180,0,280,35,86,9,3577
"40047001402",3549,178,17,0,587,134,253,26,4744
"40047001500",3900,674,361,105,988,372,1035,567,8002
"40047001601",4619,319,61,14,454,2,355,32,5856
"40047001602",3677,179,163,80,265,13,50,0,4427
"40049681100",1929,560,0,0,472,188,45,10,3204
"40049681200",2583,369,5,15,428,85,170,69,3724
"40049681300",1740,531,224,30,257,176,415,250,3623
"40049681400",3186,542,158,9,698,238,376,139,5346
"40049681500",1659,380,102,94,253,101,49,31,2669
"40049681600",1301,377,0,0,287,59,40,30,2094
"40049681700",1379,274,0,0,230,14,26,0,1923
"40049681800",2062,520,0,0,322,74,145,13,3136
"40049681900",2334,407,4,10,276,105,57,36,3229
"40051000100",653,521,0,0,55,55,70,0,1354
"40051000400",2230,632,0,26,368,135,202,51,3644
"40051000500",4864,524,38,14,482,245,279,135,6581
"40051000600",4141,490,81,3,477,166,290,54,5702
"40051000700",5068,1119,27,0,852,88,250,104,7508
"40051000800",5383,576,14,0,683,101,147,44,6948
"40051000901",1966,150,0,0,208,40,46,53,2463
"40051000902",4386,683,15,0,1016,138,183,124,6545
"40051000903",8487,522,115,0,706,250,77,195,10352
"40051001000",2004,425,571,20,348,134,237,32,3771
"40053956400",1343,127,0,0,117,41,61,16,1705
"40053956500",2353,194,7,3,173,47,80,15,2872
"40055967100",1322,140,0,0,137,47,121,32,1799
"40055967200",2368,424,25,78,478,27,430,8,3838
"40057967800",1647,276,111,70,370,295,457,291,3517
"40059952100",1526,245,0,0,3,28,287,105,2194
"40059952200",1553,210,0,0,47,88,215,106,2219
"40061279100",1322,319,0,0,484,99,21,17,2262
"40061279200",2372,693,0,0,766,111,52,98,4092
"40061279300",2282,507,73,21,659,164,173,24,3903
"40061279400",1745,249,0,0,664,178,63,17,2916
"40063484600",1213,333,30,33,704,293,34,47,2687
"40063484700",1813,200,20,0,514,115,19,0,2681
"40063484800",1091,320,76,29,380,233,30,14,2173
"40063484900",1235,308,39,36,381,292,119,182,2592
"40063485000",1552,378,1,10,367,126,54,26,2514
"40065968100",2304,225,3,0,139,8,200,41,2920
"40065968200",1116,203,10,0,246,105,182,100,1962
"40065968300",1147,281,17,5,222,84,212,129,2097
"40065968400",3885,242,135,0,657,76,682,36,5713
"40065968500",2979,114,497,75,455,19,439,23,4601
"40065968600",2287,664,316,65,809,605,1126,779,6651
"40065968700",773,237,141,204,232,168,430,244,2429
"40065968800",2014,491,294,72,525,102,890,140,4528
"40067371600",1277,322,0,2,321,197,113,43,2275
"40067371700",1105,202,0,0,233,99,152,96,1887
"40067371800",1769,442,29,0,96,94,57,99,2586
"40069660198",2103,301,31,5,640,150,92,8,3330
"40069660200",2533,701,26,64,1115,366,180,45,5030
"40069660300",1644,406,0,2,512,132,89,49,2834
"40071000100",3690,871,230,92,629,426,199,183,6320
"40071000201",2147,320,57,18,550,100,125,21,3338
"40071000202",3452,508,43,20,605,61,117,17,4823
"40071000300",3523,126,13,32,368,39,127,7,4235
"40071000400",1149,435,138,61,311,238,149,133,2614
"40071000500",2252,666,22,71,534,546,212,392,4695
"40071000600",2635,219,0,2,477,313,84,22,3752
"40071001100",2473,457,1,1,596,285,183,108,4104
"40071001200",3183,473,6,0,540,136,94,44,4476
"40071001301",2850,614,0,8,604,113,360,46,4595
"40071001302",3040,695,0,0,483,180,314,118,4830
"40073958100",3520,355,23,0,832,91,1272,262,6355
"40073958200",1922,113,12,2,241,27,206,17,2540
"40073958300",4636,249,2,0,542,48,349,31,5857
"40073958400",2024,145,0,0,200,0,11,0,2380
"40075963600",1023,204,0,0,163,132,42,2,1566
"40075963700",2282,750,158,57,430,305,253,218,4453
"40075964200",2547,505,72,62,256,204,259,140,4045
"40077087100",1351,153,5,3,804,118,6,28,2468
"40077087200",3454,612,2,0,1020,318,134,48,5588
"40077087300",1368,259,46,8,634,310,29,45,2699
"40079040102",2749,802,37,37,602,129,36,3,4395
"40079040198",1171,583,0,7,147,99,11,10,2028
"40079040299",2253,800,46,94,575,95,92,63,4018
"40079040301",3909,1150,26,6,666,205,86,32,6080
"40079040302",2590,482,0,0,580,254,37,6,3949
"40079040303",2014,417,307,63,674,85,53,15,3628
"40079040401",2765,586,47,175,860,184,476,108,5201
"40079040402",1986,656,37,44,433,361,230,342,4089
"40079040500",3174,801,8,0,1110,219,134,21,5467
"40079040601",2132,794,0,0,741,390,421,438,4916
"40079040602",2447,719,4,44,853,399,222,269,4957
"40079040700",1465,369,18,25,816,246,35,92,3066
"40081961100",3127,629,10,23,662,44,148,13,4656
"40081961200",2993,718,26,6,412,155,76,36,4422
"40081961300",3299,535,37,21,329,53,105,48,4427
"40081961400",5548,1093,54,14,849,206,145,79,7988
"40081961500",4134,394,40,18,632,76,152,0,5446
"40081961600",2248,377,38,47,293,40,92,7,3142
"40081961700",3522,583,111,85,287,177,20,10,4795
"40083600100",2429,513,556,338,379,60,30,14,4319
"40083600200",1526,536,121,372,148,117,125,61,3006
"40083600300",1763,215,316,33,97,81,116,1,2622
"40083600400",8376,516,0,1,531,166,1003,84,10677
"40083600500",5125,390,187,236,572,36,147,140,6833
"40083600600",1932,589,630,232,215,154,43,73,3868
"40083600700",3670,495,114,18,611,38,87,77,5110
"40083600800",6929,211,139,0,646,14,354,0,8293
"40085094100",1846,499,34,53,322,87,726,242,3809
"40085094200",3582,389,109,0,488,149,196,98,5011
"40085094300",1540,225,0,0,152,6,2,7,1932
"40087400101",5570,532,62,0,932,47,281,18,7442
"40087400102",7245,683,49,0,1121,188,412,48,9746
"40087400201",2710,401,0,4,764,41,200,12,4132
"40087400202",6557,637,6,0,998,106,689,81,9074
"40087400300",3878,754,142,35,772,130,555,298,6564
"40087400400",821,142,2,0,145,107,9,14,1240
"40089098200",1559,299,0,0,693,272,98,43,2964
"40089098300",760,137,24,21,442,165,6,1,1556
"40089098400",2520,962,135,51,798,172,239,3,4880
"40089098500",3435,868,138,17,1139,255,123,21,5996
"40089098600",2864,639,249,97,1207,712,262,217,6247
"40089098700",1467,535,580,526,474,426,138,166,4312
"40089098800",3012,716,417,257,820,438,270,28,5958
"40089098900",1424,326,170,52,251,61,15,38,2337
"40091779600",3372,493,95,12,856,190,110,35,5163
"40091779700",1940,610,236,60,375,275,106,41,3643
"40091779900",1391,298,29,48,772,284,22,0,2844
"40091780100",1343,206,11,29,495,206,13,5,2308
"40091780200",1266,429,65,64,801,329,103,9,3066
"40091780300",2211,462,49,0,548,150,10,10,3440
"40093955100",2608,216,0,0,391,49,351,40,3655
"40093955200",1256,99,0,0,63,78,42,108,1646
"40093955300",2110,501,0,15,50,126,32,71,2905
"40095094698",2305,286,13,14,737,115,176,0,3646
"40095094700",2547,446,144,58,1382,208,1685,168,6638
"40095094801",2178,684,0,0,506,161,49,79,3657
"40095094802",2495,600,0,0,687,138,206,44,4170
"40097040100",2324,882,0,13,1074,234,204,208,4939
"40097040200",2798,617,0,0,1197,217,143,12,4984
"40097040300",2529,164,0,0,887,325,79,0,3984
"40097040400",3515,985,36,24,1054,654,42,101,6411
"40097040501",2117,313,0,0,789,285,84,0,3588
"40097040502",1757,548,0,0,1018,364,64,11,3762
"40097040600",1737,416,0,0,1148,479,40,45,3865
"40097040700",1833,771,26,30,822,426,76,26,4010
"40097040800",3851,380,17,0,1493,202,60,13,6016
"40099790600",1626,214,31,14,363,23,27,0,2298
"40099790700",3639,438,70,37,1024,79,216,0,5503
"40099790800",3262,807,0,11,1091,466,335,147,6119
"40101000100",1451,693,736,356,680,301,34,63,4314
"40101000200",417,327,321,318,175,194,21,21,1794
"40101000300",1010,361,787,674,421,183,34,18,3488
"40101000400",269,174,476,167,122,181,58,77,1524
"40101000600",2003,530,363,311,865,273,80,166,4591
"40101000700",2339,767,138,147,895,523,607,321,5737
"40101000801",3193,374,79,35,1229,291,33,205,5439
"40101000802",1512,301,98,15,430,122,119,0,2597
"40101000900",4663,800,387,105,1595,354,432,77,8413
"40101001000",918,310,255,78,182,184,98,85,2110
"40101001100",1814,316,143,104,857,147,36,1,3418
"40101001200",1346,185,199,80,607,77,42,0,2536
"40101001300",3276,689,80,21,1869,389,64,247,6635
"40101001400",4054,577,90,47,1845,380,206,196,7395
"40101001500",2972,723,24,30,1594,545,89,37,6014
"40101001600",2124,744,384,61,713,115,95,66,4302
"40103956600",2068,248,12,4,744,137,127,30,3370
"40103956900",2804,311,38,23,323,189,131,0,3819
"40103957000",1115,348,0,64,103,36,0,0,1666
"40103957100",2428,215,0,26,111,11,46,0,2837
"40105172100",1751,169,6,9,447,96,71,7,2556
"40105172200",800,176,17,1,440,99,10,10,1553
"40105172300",1345,205,0,0,352,118,91,3,2114
"40105172400",2215,478,91,36,1125,335,74,16,4370
"40107080600",1678,266,70,18,642,244,50,0,2968
"40107080700",1342,473,206,133,400,106,42,11,2713
"40107080900",1630,579,41,62,605,570,67,90,3644
"40107081000",1087,194,57,84,522,248,47,72,2311
"40109100100",1903,542,241,130,500,217,236,269,4038
"40109100200",2882,1275,329,131,592,421,294,799,6723
"40109100300",2113,115,29,11,359,70,65,11,2773
"40109100400",21,53,1394,559,165,67,34,51,2344
"40109100500",166,0,1212,558,101,18,57,0,2112
"40109100600",680,61,5,0,27,38,34,8,853
"40109100700",760,137,40,53,168,20,144,5,1327
"40109100800",1043,395,543,42,459,131,186,116,2915
"40109100900",1194,170,94,3,118,20,63,6,1668
"40109101000",464,496,74,46,628,299,126,263,2396
"40109101100",472,139,41,43,65,16,27,0,803
"40109101200",706,184,29,49,238,13,52,0,1271
"40109101300",36,91,1692,1078,97,31,0,24,3049
"40109101400",11,167,530,282,18,27,18,53,1106
"40109101500",346,127,588,206,193,89,4,0,1553
"40109101600",294,28,6,19,58,12,28,0,445
"40109101700",1050,12,0,0,138,8,13,0,1221
"40109101800",1102,102,43,6,152,30,62,0,1497
"40109101900",1727,262,82,120,539,34,358,133,3255
"40109102000",1344,523,356,93,790,45,409,229,3789
"40109102100",1236,250,21,108,364,127,539,244,2889
"40109102200",986,561,27,120,386,70,443,349,2942
"40109102300",1729,682,133,55,330,379,707,827,4842
"40109102400",1034,904,122,167,1301,296,1377,603,5804
"40109102500",221,150,35,24,16,31,10,14,501
"40109102600",47,71,109,177,15,100,4,9,532
"40109102700",25,39,0,6,17,11,0,0,98
"40109102800",266,206,963,717,86,206,85,233,2762
"40109102900",14,0,612,135,75,38,3,8,885
"40109103000",25,3,67,171,3,13,0,0,282
"40109103200",743,145,103,40,168,47,28,9,1283
"40109103300",410,390,130,64,273,224,414,311,2216
"40109103400",145,229,12,20,36,39,60,223,764
"40109103500",109,76,21,19,40,0,107,22,394
"40109103601",140,15,0,0,37,0,14,0,206
"40109103602",112,229,0,157,9,50,0,28,585
"40109103700",115,29,0,8,40,7,52,17,268
"40109103800",508,72,7,0,84,8,16,0,695
"40109103900",1170,1153,152,109,956,336,1578,1220,6674
"40109104000",79,73,32,4,0,3,69,64,324
"40109104100",1271,1012,25,240,180,440,870,931,4969
"40109104200",941,422,0,17,439,242,1111,440,3612
"40109104300",1559,974,129,0,686,424,1832,1242,6846
"40109104400",1269,955,26,142,713,260,1429,1033,5827
"40109104500",1521,1057,0,122,940,169,1753,1093,6655
"40109104600",629,116,0,0,76,135,548,188,1692
"40109104700",400,266,42,36,373,279,632,254,2282
"40109104800",1383,581,13,74,687,449,1408,802,5397
"40109104900",1458,755,85,32,1028,330,1720,489,5897
"40109105000",1089,292,17,11,594,112,1283,286,3684
"40109105100",1146,246,71,52,183,79,44,0,1821
"40109105201",34,0,849,569,86,23,2,23,1586
"40109105202",54,7,635,251,55,129,13,0,1144
"40109105300",961,884,75,287,570,325,678,688,4468
"40109105400",742,407,113,77,601,178,703,466,3287
"40109105500",1719,504,56,65,742,468,1616,844,6014
"40109105600",2033,1582,209,90,675,349,1959,1423,8320
"40109105700",161,213,12,40,130,60,154,166,936
"40109105800",444,389,15,4,92,53,148,155,1300
"40109105903",1356,240,240,178,573,7,377,54,3025
"40109105904",1980,459,187,53,990,78,1282,162,5191
"40109105905",1372,441,223,138,221,148,620,310,3473
"40109105906",1671,423,125,0,347,91,530,159,3346
"40109105907",2586,1107,190,61,958,122,1756,571,7351
"40109106000",468,63,1341,126,226,40,96,0,2360
"40109106100",253,151,1244,486,221,61,104,18,2538
"40109106200",89,18,1378,159,80,0,21,0,1745
"40109106301",710,421,1215,1159,273,230,112,467,4587
"40109106302",745,796,1848,1102,532,181,176,537,5917
"40109106303",1899,392,308,353,241,51,449,245,3938
"40109106401",1837,53,37,0,174,0,34,0,2135
"40109106402",1901,172,0,0,127,0,60,9,2269
"40109106403",3592,292,289,39,267,243,106,0,4828
"40109106501",2305,154,77,6,307,60,75,21,3005
"40109106502",2303,428,209,223,612,35,350,96,4256
"40109106503",1092,259,95,6,61,3,104,53,1673
"40109106601",1837,352,178,229,309,72,107,105,3189
"40109106602",1954,248,115,0,257,75,238,14,2901
"40109106604",938,273,398,62,337,62,77,111,2258
"40109106606",1418,525,17,14,218,1,122,154,2469
"40109106607",2255,573,347,180,541,158,340,329,4723
"40109106608",2083,128,53,0,408,16,150,6,2844
"40109106609",1059,39,35,0,152,0,37,0,1322
"40109106610",878,124,171,31,93,81,24,0,1402
"40109106702",2711,430,109,47,439,61,849,123,4769
"40109106704",1577,242,238,68,110,0,47,124,2406
"40109106705",1267,132,107,45,603,33,225,24,2436
"40109106706",2284,413,535,160,439,30,302,26,4189
"40109106707",3148,764,941,393,1144,164,705,167,7426
"40109106708",1620,18,20,0,537,14,19,0,2228
"40109106801",798,259,84,0,89,85,50,19,1384
"40109106802",1396,128,27,67,48,16,46,20,1748
"40109106803",1603,496,41,64,312,469,619,353,3957
"40109106804",2169,479,236,152,433,164,461,137,4231
"40109106902",1688,274,53,62,192,117,164,153,2703
"40109106903",4070,773,219,142,710,59,266,359,6598
"40109106906",2001,336,201,163,210,103,546,343,3903
"40109106907",1494,379,64,151,87,37,363,178,2753
"40109106909",1045,153,208,50,110,55,111,16,1748
"40109106910",1465,317,49,48,148,15,139,71,2252
"40109106911",1377,77,85,11,190,76,265,0,2081
"40109106912",1224,596,728,225,240,64,282,56,3415
"40109106913",1595,602,448,578,350,432,687,376,5068
"40109106914",1833,450,315,149,827,189,910,453,5126
"40109106915",2639,973,811,483,732,1068,1714,1427,9847
"40109107001",2493,855,107,23,1376,994,2105,1158,9111
"40109107002",1240,499,20,24,292,154,510,377,3116
"40109107101",0,0,0,0,0,0,0,0,0
"40109107103",736,351,55,176,256,235,530,195,2534
"40109107104",1566,626,126,120,392,300,902,324,4356
"40109107206",2167,408,98,53,828,939,767,848,6108
"40109107207",1156,228,138,7,509,67,217,94,2416
"40109107209",2296,1082,174,33,996,539,824,1211,7155
"40109107210",821,59,4,0,165,0,134,16,1199
"40109107211",1645,83,82,0,415,6,361,0,2592
"40109107212",3155,464,354,262,1237,145,426,45,6088
"40109107213",2892,327,263,56,1279,219,1795,210,7041
"40109107214",1607,397,25,29,637,55,811,225,3786
"40109107215",2332,501,157,15,675,436,1273,698,6087
"40109107216",1606,991,30,37,277,269,953,609,4772
"40109107217",1060,331,18,161,476,98,702,274,3120
"40109107218",1722,463,87,247,332,281,1213,349,4694
"40109107219",1745,119,0,46,845,497,1331,499,5082
"40109107220",2007,696,12,26,505,489,1435,543,5713
"40109107221",1289,184,126,6,266,107,352,184,2514
"40109107222",782,330,12,53,404,262,371,344,2558
"40109107223",1155,465,137,100,476,74,402,243,3052
"40109107302",1197,777,32,139,248,266,305,523,3487
"40109107303",852,268,17,16,122,98,104,35,1512
"40109107305",579,199,77,186,74,44,211,53,1423
"40109107306",754,531,540,317,429,426,163,382,3542
"40109107401",1512,998,1581,1302,703,258,171,287,6812
"40109107403",3157,300,1094,489,686,48,378,0,6152
"40109107404",1696,147,813,289,625,35,182,21,3808
"40109107405",2213,262,851,14,907,70,328,26,4671
"40109107500",1065,27,68,0,276,0,356,0,1792
"40109107601",1198,408,393,161,198,26,196,0,2580
"40109107604",1394,159,94,0,255,48,98,14,2062
"40109107605",1521,282,79,64,169,121,50,18,2304
"40109107606",198,45,12,0,24,10,5,0,294
"40109107607",2607,381,474,0,175,79,224,83,4023
"40109107703",2663,283,312,18,320,0,305,0,3901
"40109107704",942,208,197,58,147,0,96,52,1700
"40109107705",1301,90,133,93,318,21,156,0,2112
"40109107706",1718,284,117,31,581,235,312,250,3528
"40109107707",1105,133,47,0,142,10,128,23,1588
"40109107801",1399,224,769,652,289,371,173,89,3966
"40109107804",1450,262,62,219,218,112,120,62,2505
"40109107805",1453,214,575,177,162,169,205,171,3126
"40109107806",2425,499,334,362,371,8,221,79,4299
"40109107807",1360,327,438,0,426,17,252,10,2830
"40109107808",1081,110,232,120,287,7,280,9,2126
"40109107809",1091,408,133,46,163,52,145,103,2141
"40109107810",1503,226,144,150,402,64,200,0,2689
"40109107900",64,38,1064,375,84,34,5,13,1677
"40109108003",995,371,1468,381,292,295,13,81,3896
"40109108005",700,107,1168,260,95,0,35,0,2365
"40109108006",2156,468,643,27,401,19,153,234,4101
"40109108007",2205,128,144,212,211,197,58,7,3162
"40109108008",1830,279,891,641,581,331,259,54,4866
"40109108009",1349,67,953,25,370,112,248,89,3213
"40109108010",1154,500,694,187,201,61,130,21,2948
"40109108011",962,198,1333,863,270,111,144,0,3881
"40109108101",3284,43,211,36,164,5,243,0,3986
"40109108106",4645,58,40,0,399,0,113,0,5255
"40109108107",2550,8,78,0,291,0,29,0,2956
"40109108109",4541,69,39,0,767,90,186,0,5692
"40109108110",3122,251,99,24,363,0,97,0,3956
"40109108113",4054,359,132,46,491,82,207,76,5447
"40109108114",3095,486,66,281,386,436,134,50,4934
"40109108201",2646,477,236,115,155,136,179,17,3961
"40109108203",2034,292,114,77,542,54,105,17,3235
"40109108204",1284,474,344,62,486,209,454,259,3572
"40109108206",4055,127,177,26,456,23,128,0,4992
"40109108207",398,203,24,73,40,99,0,4,841
"40109108208",1721,863,279,226,334,196,151,44,3814
"40109108213",7668,153,43,0,733,15,191,20,8823
"40109108215",3701,173,541,0,354,5,303,5,5082
"40109108216",2215,217,324,0,185,13,22,0,2976
"40109108217",3176,309,495,27,344,44,190,0,4585
"40109108218",6668,0,1242,0,651,0,347,0,8908
"40109108219",4776,153,320,60,165,0,251,0,5725
"40109108220",3890,366,252,8,749,8,143,7,5423
"40109108221",5975,127,352,29,734,9,373,10,7609
"40109108301",598,43,760,267,216,10,69,32,1995
"40109108302",3106,215,793,268,381,118,250,37,5168
"40109108303",4166,775,158,103,487,310,216,115,6330
"40109108304",3198,392,152,0,366,458,91,427,5084
"40109108307",2260,265,1868,214,253,310,347,40,5557
"40109108309",330,93,1101,664,166,0,157,0,2511
"40109108310",763,57,884,288,153,105,47,76,2373
"40109108313",2325,421,1963,292,467,293,161,236,6158
"40109108314",1209,208,707,263,132,106,245,16,2886
"40109108315",3556,163,661,133,1054,37,341,0,5945
"40109108316",4740,95,1145,24,873,14,126,0,7017
"40109108317",2550,354,266,0,316,124,120,0,3730
"40109108318",3620,201,741,33,894,36,97,0,5622
"40109108402",1127,14,49,0,188,4,0,0,1382
"40109108403",1322,96,302,71,236,33,195,29,2284
"40109108404",1902,155,350,40,288,3,234,8,2980
"40109108504",5454,331,263,72,836,243,279,0,7478
"40109108506",2654,282,444,0,189,28,65,0,3662
"40109108507",932,62,41,12,64,5,40,0,1156
"40109108508",1321,53,203,20,304,35,125,17,2078
"40109108511",4650,416,463,92,842,0,141,19,6623
"40109108512",3876,110,111,14,380,23,102,1,4617
"40109108513",2856,223,343,21,597,47,269,0,4356
"40109108514",2432,677,1144,531,439,225,221,91,5760
"40109108515",3381,137,128,243,486,123,79,12,4589
"40109108519",2518,97,286,18,238,22,80,4,3263
"40109108520",1737,73,104,37,113,10,13,0,2087
"40109108521",677,64,311,23,138,88,99,24,1424
"40109108523",3984,186,621,31,693,98,242,0,5855
"40109108524",1980,75,326,0,800,104,12,0,3297
"40109108525",1043,109,417,0,474,15,7,0,2065
"40109108526",2654,407,626,352,713,95,244,272,5363
"40109108527",3018,113,608,17,1064,293,147,12,5272
"40109108528",1422,114,247,157,325,47,112,25,2449
"40109108529",2358,35,154,0,337,0,30,0,2914
"40109108530",3120,190,619,0,556,0,151,30,4666
"40109108601",1575,157,176,0,263,48,362,138,2719
"40109108602",832,125,0,10,16,13,57,18,1071
"40109108603",2055,99,138,13,221,20,365,0,2911
"40109108701",2085,72,235,0,229,0,101,0,2722
"40109108703",4603,351,128,49,535,46,177,0,5889
"40109108704",4092,248,17,0,566,100,127,1,5151
"40109108706",1906,107,332,8,374,0,78,0,2805
"40109108707",2554,54,424,0,387,39,93,20,3571
"40109108708",2516,321,0,0,189,21,9,66,3122
"40109108709",2909,111,0,0,409,48,113,19,3609
"40109108801",4684,662,403,424,505,56,212,28,6974
"40109108802",3899,405,59,0,656,46,102,11,5178
"40109108803",73,14,674,271,132,22,22,0,1208
"40109108804",1680,74,500,488,124,13,23,0,2902
"40109108900",2523,376,365,114,337,89,100,132,4036
"40109109001",1491,140,74,54,283,3,43,0,2088
"40109109003",3522,431,39,23,510,301,121,128,5075
"40109109004",2883,173,22,1,283,100,256,13,3731
"40109109100",40,67,4,48,5,45,0,0,209
"40109109201",4395,214,115,48,483,13,268,10,5546
"40109109202",1792,185,33,8,183,7,74,98,2380
"40111000100",428,183,992,305,516,75,28,0,2527
"40111000200",1342,442,326,145,396,300,110,48,3109
"40111000300",1209,411,86,20,321,252,15,75,2389
"40111000400",2473,401,362,126,770,623,80,0,4835
"40111000500",2483,241,166,72,924,153,24,0,4063
"40111000600",4692,604,82,85,1099,256,207,69,7094
"40111000700",2262,435,91,16,872,200,254,20,4150
"40111000800",1794,334,118,69,794,274,81,16,3480
"40111000901",2043,354,26,1,543,204,117,48,3336
"40111000902",2499,638,0,0,822,407,80,59,4505
"40113940001",2390,490,238,41,964,463,59,30,4675
"40113940002",2174,515,55,33,1276,376,173,25,4627
"40113940003",3052,679,35,16,914,280,111,19,5106
"40113940004",1696,217,5,0,694,37,55,49,2753
"40113940005",2443,269,146,75,710,76,118,35,3872
"40113940006",855,212,3225,1012,422,48,173,119,6066
"40113940007",3642,413,45,0,858,67,118,46,5189
"40113940008",1844,419,0,0,682,169,64,0,3178
"40113940009",2537,304,0,0,821,66,66,0,3794
"40113940010",5023,537,0,44,1037,365,26,64,7096
"40113940011",951,155,9,0,198,55,1,20,1389
"40115574100",2295,561,14,2,997,405,93,22,4389
"40115574200",1388,610,9,1,715,274,311,265,3573
"40115574300",1535,313,18,13,617,186,91,17,2790
"40115574400",1332,426,10,9,510,324,73,107,2791
"40115574500",1100,567,27,7,417,239,60,84,2501
"40115574600",2110,487,9,9,869,246,76,44,3850
"40115574700",3105,232,0,5,1125,297,85,0,4849
"40115574800",2155,658,0,15,826,233,33,22,3942
"40115574900",1983,640,14,4,791,196,88,25,3741
"40117957100",2603,451,0,36,565,86,30,0,3771
"40117957200",3274,459,2,0,611,62,157,2,4567
"40117957300",2078,401,52,0,554,138,75,0,3298
"40117957400",1980,328,0,0,271,51,44,4,2678
"40117957500",1295,226,50,13,648,126,83,11,2452
"40119010101",3007,391,117,32,535,134,80,4,4300
"40119010102",2463,1469,107,116,346,482,268,80,5331
"40119010200",2781,1207,181,365,812,320,114,78,5858
"40119010300",751,854,6,19,21,93,54,55,1853
"40119010400",149,92,26,4,489,154,39,0,953
"40119010500",1080,1234,0,49,253,468,52,32,3168
"40119010600",2180,1421,444,46,521,259,217,86,5174
"40119010700",1399,1408,30,28,244,132,24,117,3382
"40119010800",1041,646,31,36,135,108,86,25,2108
"40119010900",7179,828,56,49,644,289,395,44,9484
"40119011000",4504,535,61,0,509,158,101,0,5868
"40119011101",3856,814,11,0,505,60,81,0,5327
"40119011102",4410,982,150,10,645,245,21,99,6562
"40119011200",1535,482,0,0,315,10,41,3,2386
"40119011301",2672,507,12,23,429,35,199,33,3910
"40119011302",2902,551,66,0,496,162,125,112,4414
"40119011400",2465,492,29,10,259,69,194,61,3579
"40121485600",2024,504,61,0,184,179,0,28,2980
"40121485700",1297,378,9,0,419,172,23,100,2398
"40121485800",3058,649,13,0,819,164,153,21,4877
"40121485900",1521,206,28,0,462,73,7,6,2303
"40121486000",3244,552,42,0,968,322,93,20,5241
"40121486100",2211,509,308,90,690,657,97,242,4804
"40121486200",2138,387,63,105,574,358,82,232,3939
"40121486300",7,0,8,0,6,0,0,0,21
"40121486400",1044,591,105,22,607,177,138,49,2733
"40121486500",3700,582,69,79,877,281,101,31,5720
"40121486600",2061,158,73,2,489,132,49,0,2964
"40121486700",2756,475,24,30,1150,222,137,43,4837
"40121486800",1065,272,0,0,254,129,16,68,1804
"40123088600",3105,414,65,8,1148,236,146,65,5187
"40123088700",1303,312,21,42,365,67,2,27,2139
"40123088800",4757,584,222,68,1210,379,107,23,7350
"40123088900",1709,871,63,77,682,377,189,90,4058
"40123089000",2036,439,30,0,863,256,47,78,3749
"40123089100",845,483,58,0,462,343,99,26,2316
"40123089200",603,318,54,0,108,244,59,129,1515
"40123089300",2614,370,30,4,974,165,178,46,4381
"40123089598",3317,405,4,2,1031,199,179,6,5143
"40123089600",1446,279,0,0,372,88,25,20,2230
"40125500200",1002,882,135,281,472,452,76,171,3471
"40125500301",1889,305,88,16,615,268,98,13,3292
"40125500302",1516,291,63,64,384,402,251,117,3088
"40125500400",2047,542,18,63,521,338,85,51,3665
"40125500500",1808,540,47,94,591,279,278,112,3749
"40125500600",2247,529,41,42,483,184,189,41,3756
"40125500700",1923,203,110,7,509,187,151,0,3090
"40125500800",2905,134,24,0,367,121,0,0,3551
"40125500900",5157,409,112,19,975,369,135,24,7200
"40125501001",4869,1028,13,19,1193,364,330,107,7923
"40125501003",3429,601,8,7,526,78,175,0,4824
"40125501004",2946,385,83,40,546,131,73,78,4282
"40125501101",3289,611,68,38,1256,147,124,44,5577
"40125501102",5103,904,83,23,1338,241,255,16,7963
"40125501201",1342,245,0,0,204,64,2,0,1857
"40125501300",1986,457,15,0,304,102,42,32,2938
"40127097600",1794,345,31,6,607,226,72,12,3093
"40127097700",3121,1289,48,27,715,415,134,37,5786
"40127097800",1509,309,2,0,531,169,52,18,2590
"40129960000",2894,469,3,0,229,109,170,50,3924
"40131050101",2672,458,53,0,1041,280,182,114,4800
"40131050103",1659,47,10,12,542,125,106,35,2536
"40131050104",758,387,97,30,472,151,41,21,1957
"40131050105",2825,326,83,9,898,110,250,119,4620
"40131050201",1635,100,0,0,557,64,142,7,2505
"40131050202",1741,231,18,0,797,86,155,0,3028
"40131050203",982,74,18,0,405,92,28,11,1610
"40131050301",1645,166,0,0,441,56,54,11,2373
"40131050302",1463,270,24,45,578,155,48,16,2599
"40131050303",1842,134,0,0,535,139,47,27,2724
"40131050304",2470,116,0,0,606,37,15,0,3244
"40131050403",4173,179,36,0,1077,45,91,10,5611
"40131050404",4834,139,119,9,745,24,272,49,6191
"40131050405",3172,240,56,0,396,39,34,100,4037
"40131050406",1808,14,0,0,465,25,154,0,2466
"40131050407",1544,55,45,81,653,4,122,33,2537
"40131050408",1859,284,16,0,506,265,181,27,3138
"40131050409",1173,119,0,0,514,42,114,128,2090
"40131050501",1907,69,0,0,784,42,155,0,2957
"40131050502",2009,278,20,14,836,129,60,30,3376
"40131050601",2529,162,0,0,651,86,99,0,3527
"40131050602",2407,125,10,0,720,0,43,0,3305
"40131050603",1937,115,0,0,541,5,38,0,2636
"40131050604",2743,39,0,0,678,122,76,0,3658
"40131050701",1036,368,0,3,518,261,65,26,2277
"40131050702",1932,287,0,2,699,140,17,16,3093
"40131050801",3166,222,18,0,695,48,126,0,4275
"40131050802",2401,261,0,0,737,59,22,0,3480
"40133583100",1033,188,53,36,442,74,54,28,1908
"40133583200",2100,405,11,0,565,328,66,69,3544
"40133583300",1710,219,38,22,563,82,126,27,2787
"40133583400",2495,578,153,117,760,305,150,20,4578
"40133583500",979,507,64,48,255,142,135,42,2172
"40133583600",1525,550,270,322,641,655,53,64,4080
"40133583700",1304,211,0,0,384,108,62,2,2071
"40133583800",1713,326,0,6,659,134,22,6,2866
"40133583900",870,226,54,13,432,116,43,22,1776
"40135030101",2034,643,5,3,1651,391,67,38,4832
"40135030103",1289,632,113,122,433,206,106,60,2961
"40135030104",3581,958,60,11,1477,552,144,59,6842
"40135030201",1769,130,0,2,425,225,54,28,2633
"40135030202",2572,757,140,60,1165,475,30,79,5278
"40135030301",878,392,16,21,565,472,125,180,2649
"40135030302",3736,1022,50,47,1495,359,173,0,6882
"40135030401",1932,349,36,22,885,219,97,51,3591
"40135030402",3508,899,96,38,1577,599,173,38,6928
"40137000101",4362,410,46,31,618,246,217,113,6043
"40137000102",2438,359,25,46,134,134,107,35,3278
"40137000200",3036,396,57,0,341,47,141,24,4042
"40137000300",1479,245,35,17,173,28,111,37,2125
"40137000400",3228,966,298,25,656,311,712,354,6550
"40137000600",1427,452,240,177,379,255,329,102,3361
"40137000800",4153,229,0,0,417,42,40,66,4947
"40137000901",3683,552,27,6,346,139,33,9,4795
"40137000902",2756,295,0,0,390,284,119,13,3857
"40137001000",1635,229,0,0,210,26,95,0,2195
"40137001100",4436,638,7,12,423,67,283,20,5886
"40139950600",2559,316,34,16,687,361,796,493,5262
"40139950700",1969,282,25,112,571,154,582,189,3884
"40139950800",2598,235,62,38,1848,16,2813,130,7740
"40139950900",3741,548,64,0,2924,336,3524,455,11592
"40139951000",980,68,0,0,336,90,402,90,1966
"40141070100",691,165,0,0,90,39,53,33,1071
"40141070200",674,155,111,6,118,93,112,93,1362
"40141070300",1345,317,78,28,216,241,339,300,2864
"40141070400",868,359,89,38,221,73,345,315,2308
"40141070500",907,141,141,95,104,57,163,55,1663
"40143000100",847,447,149,60,358,155,288,202,2506
"40143000200",68,36,823,292,162,4,78,27,1490
"40143000300",1073,473,595,784,946,280,850,368,5369
"40143000400",1224,684,438,296,771,693,920,779,5805
"40143000500",58,137,1182,572,117,216,69,64,2415
"40143000600",24,14,655,317,107,75,16,34,1242
"40143000700",126,191,900,391,116,77,7,32,1840
"40143000800",181,81,702,302,72,19,0,2,1359
"40143000900",333,164,473,231,102,115,11,23,1452
"40143001000",64,67,832,380,74,37,0,0,1454
"40143001200",694,251,55,104,341,371,580,436,2832
"40143001300",747,357,87,48,441,405,541,363,2989
"40143001400",1943,978,625,208,969,770,1388,581,7462
"40143001500",1971,506,176,142,828,625,649,468,5365
"40143001600",2308,600,244,301,1311,353,1515,470,7102
"40143001700",1733,376,143,0,314,31,81,130,2808
"40143001800",1109,195,53,0,300,118,114,66,1955
"40143001900",964,239,69,8,252,27,180,106,1845
"40143002000",1040,240,40,68,203,124,272,49,2036
"40143002100",692,674,114,224,301,436,323,291,3055
"40143002301",1083,459,116,132,539,315,440,355,3439
"40143002500",844,277,123,187,181,103,81,5,1801
"40143002700",1423,474,196,137,574,175,298,81,3358
"40143002900",1652,512,86,201,374,58,116,0,2999
"40143003000",1139,472,28,42,210,91,194,9,2185
"40143003100",1781,323,159,40,206,32,8,0,2549
"40143003200",1045,128,10,7,202,30,52,5,1479
"40143003300",1736,119,0,0,196,8,12,0,2071
"40143003400",915,342,161,58,267,99,51,38,1931
"40143003500",1480,159,85,13,304,43,46,8,2138
"40143003600",1829,80,44,0,244,8,23,0,2228
"40143003700",1933,131,46,8,346,102,103,0,2669
"40143003800",1307,220,80,7,214,85,71,0,1984
"40143003900",2963,251,71,19,651,63,155,18,4191
"40143004000",3233,335,147,65,438,76,152,0,4446
"40143004101",2028,5,0,0,202,3,13,0,2251
"40143004200",2532,113,32,44,68,49,114,0,2952
"40143004301",2057,34,8,0,165,0,4,0,2268
"40143004302",2956,114,0,0,177,29,49,0,3325
"40143004400",2036,272,90,26,259,47,57,10,2797
"40143004500",2276,117,0,10,160,11,51,11,2636
"40143004600",901,796,311,337,320,389,309,466,3829
"40143004700",952,328,15,20,412,151,37,52,1967
"40143004800",2330,738,59,0,754,187,210,157,4435
"40143004900",1098,195,134,38,450,57,225,22,2219
"40143005001",1305,194,0,12,249,69,94,35,1958
"40143005002",2403,455,122,52,544,116,172,42,3906
"40143005100",1652,35,43,0,197,17,0,0,1944
"40143005200",2252,238,77,22,401,26,66,0,3082
"40143005300",3539,281,232,50,487,23,230,0,4842
"40143005401",2196,83,18,0,486,44,59,25,2911
"40143005402",5151,561,146,0,1092,221,206,12,7389
"40143005500",2356,546,0,0,333,188,61,0,3484
"40143005600",1559,273,26,0,369,38,73,29,2367
"40143005700",333,130,1207,719,149,66,47,14,2665
"40143005801",2979,449,37,0,721,150,402,75,4813
"40143005805",5219,552,182,47,1119,266,370,185,7940
"40143005806",3915,271,116,8,863,48,178,35,5434
"40143005807",9779,606,259,42,2396,148,569,126,13925
"40143005808",1978,51,31,0,763,55,170,0,3048
"40143005900",1016,355,229,131,357,294,665,385,3432
"40143006000",2162,530,344,269,1160,298,1211,305,6279
"40143006200",104,64,1368,805,90,174,49,0,2654
"40143006506",2005,30,24,0,329,0,76,0,2464
"40143006507",1087,64,39,8,278,67,159,0,1702
"40143006600",1876,239,0,54,545,156,26,38,2934
"40143006701",1229,378,337,337,425,351,229,150,3436
"40143006703",2498,484,153,0,390,63,266,16,3870
"40143006705",3880,248,338,89,721,54,272,0,5602
"40143006707",6888,153,370,0,1397,25,385,0,9218
"40143006708",5729,91,30,0,565,0,278,0,6693
"40143006801",1252,506,187,182,266,236,222,222,3073
"40143006803",1578,165,364,185,257,100,66,15,2730
"40143006804",1360,286,186,151,320,192,394,76,2965
"40143006901",3530,125,243,0,220,11,254,25,4408
"40143006902",1516,56,25,0,76,0,10,0,1683
"40143006903",3017,257,143,25,499,70,220,0,4231
"40143006905",1927,515,652,174,518,245,860,316,5207
"40143006906",1175,247,148,69,324,69,207,84,2323
"40143006907",1761,264,229,108,525,64,312,74,3337
"40143007000",1415,297,209,415,306,90,91,72,2895
"40143007101",1677,660,375,144,422,211,529,248,4266
"40143007102",865,220,367,294,333,359,223,109,2770
"40143007200",2616,460,119,290,520,207,801,216,5229
"40143007304",1933,340,393,129,682,37,1213,245,4972
"40143007305",3227,760,682,362,1193,569,1502,762,9057
"40143007306",2470,559,216,504,1222,398,1567,472,7408
"40143007308",1973,150,67,153,481,97,235,10,3166
"40143007309",1119,15,106,42,136,33,248,41,1740
"40143007310",2207,290,246,34,719,188,1206,260,5150
"40143007311",973,544,278,72,530,228,381,233,3239
"40143007312",2335,700,330,303,1020,200,1241,519,6648
"40143007402",2265,218,46,0,326,73,76,5,3009
"40143007407",2386,70,144,62,421,30,109,10,3232
"40143007408",824,81,84,0,196,24,90,0,1299
"40143007409",2340,209,298,74,818,58,421,165,4383
"40143007410",1258,247,290,75,287,74,303,136,2670
"40143007411",1548,106,115,103,408,92,407,42,2821
"40143007412",2588,184,224,0,582,30,353,0,3961
"40143007413",2789,60,255,38,768,0,368,21,4299
"40143007414",1926,380,131,25,287,13,165,91,3018
"40143007415",1253,112,112,17,221,8,68,4,1795
"40143007503",2046,143,27,0,392,79,184,22,2893
"40143007506",2570,83,100,0,500,71,314,0,3638
"40143007507",2513,145,236,0,726,8,196,17,3841
"40143007508",4881,139,291,144,792,87,265,0,6599
"40143007510",3836,369,173,52,742,130,528,228,6058
"40143007511",2354,155,16,43,402,15,124,18,3127
"40143007512",3089,211,17,0,671,54,240,68,4350
"40143007513",3195,194,9,0,686,20,139,10,4253
"40143007515",3593,270,0,0,591,167,146,0,4767
"40143007516",3383,339,59,91,561,285,90,30,4838
"40143007518",2625,69,76,0,822,0,44,5,3641
"40143007519",2415,15,119,0,274,43,182,0,3048
"40143007520",3501,86,37,0,469,8,135,0,4236
"40143007522",1516,77,73,6,284,16,84,6,2062
"40143007523",1956,277,56,0,252,17,106,183,2847
"40143007524",2188,113,122,0,375,97,152,20,3067
"40143007608",651,500,529,276,196,114,109,71,2446
"40143007609",1383,501,1033,575,584,256,191,295,4818
"40143007611",905,88,58,37,109,69,52,4,1322
"40143007612",1347,18,46,0,185,55,38,0,1689
"40143007613",2441,146,127,0,394,45,195,62,3410
"40143007614",1872,159,96,23,289,54,62,0,2555
"40143007615",1379,107,222,32,204,91,44,28,2107
"40143007616",2516,196,151,9,232,79,122,9,3314
"40143007617",2161,423,530,57,577,162,356,232,4498
"40143007618",3821,451,400,111,1339,85,126,19,6352
"40143007619",3254,293,60,0,385,115,364,83,4554
"40143007620",3834,516,220,58,669,141,320,0,5758
"40143007624",2608,176,41,0,385,33,120,0,3363
"40143007625",2847,734,42,226,681,509,439,337,5815
"40143007629",2528,241,170,18,528,38,126,65,3714
"40143007630",3360,200,189,97,825,15,388,7,5081
"40143007631",2777,88,81,0,399,58,67,0,3470
"40143007632",2391,179,95,121,202,36,58,23,3105
"40143007633",2191,54,167,0,248,0,142,0,2802
"40143007634",2744,231,115,0,428,57,85,15,3675
"40143007635",5174,137,22,0,651,55,42,0,6081
"40143007636",3381,251,81,0,286,12,220,0,4231
"40143007637",4315,203,25,0,452,17,49,0,5061
"40143007638",3596,80,28,0,249,5,105,0,4063
"40143007639",3818,185,376,59,606,53,200,22,5319
"40143007641",1636,343,633,236,785,517,415,138,4703
"40143007642",988,183,180,162,359,128,261,40,2301
"40143007701",3714,287,61,0,1119,76,221,9,5487
"40143007702",6155,700,99,8,1220,219,267,94,8762
"40143007801",1855,469,42,11,391,42,215,8,3033
"40143007802",4149,351,115,9,771,74,152,0,5621
"40143007900",125,285,1980,1240,280,232,51,72,4265
"40143008001",277,525,250,683,188,200,88,149,2360
"40143008002",46,14,1328,760,180,212,78,31,2649
"40143008200",941,383,181,61,491,372,493,300,3222
"40143008300",796,301,30,16,174,44,143,153,1657
"40143008400",2295,294,164,9,495,67,295,41,3660
"40143008501",1821,409,176,25,386,98,635,317,3867
"40143008502",3210,459,439,133,618,88,468,107,5522
"40143008600",2834,656,259,196,449,165,817,288,5664
"40143008700",2287,269,98,48,359,62,237,21,3381
"40143008800",1088,761,57,81,194,238,53,57,2529
"40143008900",1552,542,194,329,869,135,890,308,4819
"40143009003",4037,594,550,0,1219,52,370,58,6880
"40143009004",2124,396,375,301,1057,443,1464,494,6654
"40143009006",3605,393,674,283,1132,276,1539,451,8353
"40143009007",3761,972,702,389,1406,400,1388,508,9526
"40143009008",1364,651,299,257,587,308,1126,640,5232
"40143009009",5644,174,408,21,1659,154,384,168,8612
"40143009101",728,207,743,524,232,85,63,6,2588
"40143009104",1131,236,306,57,344,170,178,82,2504
"40143009200",2240,338,17,0,535,191,29,0,3350
"40143009300",2709,533,64,6,619,256,172,96,4455
"40143009401",3837,291,35,9,753,114,277,10,5326
"40143009402",4006,240,0,0,916,35,87,0,5284
"40143009500",3848,510,38,100,556,126,73,10,5261
"40143011100",270,4,101,34,93,21,105,0,628
"40145030101",2152,573,76,26,973,391,158,12,4361
"40145030102",2668,671,225,209,765,248,176,0,4962
"40145030201",1720,191,0,0,708,61,14,0,2694
"40145030202",1968,217,26,10,830,178,3,35,3267
"40145030300",1061,155,28,38,384,172,81,0,1919
"40145030402",3588,225,17,0,504,18,108,0,4460
"40145030403",1405,244,20,21,490,123,173,51,2527
"40145030405",4299,142,136,0,1048,399,450,67,6541
"40145030406",3327,277,318,0,861,55,152,7,4997
"40145030502",1491,116,42,0,435,72,106,0,2262
"40145030505",1540,20,6,0,243,32,30,0,1871
"40145030506",1181,179,0,0,154,12,42,0,1568
"40145030507",1518,427,25,0,318,116,288,300,2992
"40145030508",1701,45,12,0,281,26,32,23,2120
"40145030509",3270,72,131,0,609,0,309,0,4391
"40145030510",1453,35,68,0,246,76,148,0,2026
"40145030511",1755,33,0,0,287,18,130,7,2230
"40145030512",3023,268,200,0,616,11,116,88,4322
"40145030601",3135,133,129,0,924,38,78,0,4437
"40145030602",4760,731,83,121,984,312,287,112,7390
"40145030798",1925,211,294,215,480,114,131,32,3402
"40145030800",2344,200,31,0,605,105,72,47,3404
"40147000100",958,333,59,73,241,86,78,77,1905
"40147000200",741,465,17,15,252,316,179,82,2067
"40147000300",1505,417,120,51,184,92,125,19,2513
"40147000400",3131,520,25,40,546,107,136,130,4635
"40147000500",4233,559,240,202,1254,119,270,13,6890
"40147000600",5739,550,35,1,918,83,406,81,7813
"40147000700",4707,37,26,0,379,40,124,12,5325
"40147000800",2481,285,19,19,611,40,182,49,3686
"40147000900",1065,572,141,105,350,305,105,23,2666
"40147001000",1461,198,0,0,469,91,7,6,2232
"40147001100",3500,472,42,0,918,239,302,70,5543
"40147001200",1726,130,9,0,458,66,31,39,2459
"40147001300",3629,503,30,0,1188,114,77,102,5643
"40149964900",3042,627,84,10,318,99,353,108,4641
"40149965000",1853,324,0,0,143,38,222,100,2680
"40149965100",2734,323,0,0,175,29,174,7,3442
"40149965400",1303,185,0,0,76,11,46,22,1643
"40151954200",2813,445,22,50,236,43,112,57,3778
"40151954300",1742,505,0,46,92,14,23,73,2495
"40151954400",1679,173,5,0,89,15,108,20,2089
"40153953100",2113,248,0,0,59,0,193,0,2613
"40153953200",3120,413,0,2,177,22,124,0,3858
"40153953300",2751,674,64,5,285,14,295,190,4278
"40153953400",2603,643,0,0,359,52,462,146,4265
"40153953500",4826,781,0,0,493,0,639,131,6870
"41001950100",2224,454,29,0,81,14,50,154,3006
"41001950200",2475,411,0,0,113,72,102,64,3237
"41001950300",1983,429,0,0,34,93,31,8,2578
"41001950400",2427,470,0,0,51,13,0,0,2961
"41001950500",1850,476,0,0,54,39,36,77,2532
"41001950600",1332,360,0,0,40,18,20,0,1770
"41003000100",5486,1591,6,0,441,209,738,233,8704
"41003000202",3895,628,94,14,382,51,100,15,5179
"41003000400",5804,912,0,0,873,264,232,96,8181
"41003000500",2600,319,5,0,188,18,45,46,3221
"41003000600",2793,950,0,64,287,285,346,124,4849
"41003000900",3853,867,0,44,520,212,101,72,5669
"41003001001",2452,1069,69,14,497,84,702,191,5078
"41003001002",1964,734,0,0,254,176,59,24,3211
"41003001101",755,1495,0,43,60,344,63,82,2842
"41003001102",1749,1858,0,0,108,636,276,54,4681
"41003010100",7543,201,24,0,444,49,330,0,8591
"41003010200",3546,476,11,0,315,34,70,52,4504
"41003010300",2689,341,0,0,138,17,71,0,3256
"41003010400",3277,588,97,0,209,76,208,223,4678
"41003010600",1266,1152,54,0,184,242,84,71,3053
"41003010702",836,613,74,120,207,239,107,13,2209
"41003010800",2770,663,35,0,205,29,377,74,4153
"41003010900",3365,619,46,29,255,11,71,72,4468
"41005020100",3166,274,28,0,118,222,122,211,4141
"41005020200",5388,367,0,0,598,0,87,0,6440
"41005020302",2942,179,0,0,437,1,177,2,3738
"41005020303",4085,451,21,0,412,50,106,0,5125
"41005020304",4326,588,60,0,916,64,288,21,6263
"41005020401",3858,331,8,0,564,19,487,3,5270
"41005020403",2961,71,0,0,272,2,43,1,3350
"41005020404",3355,120,38,0,234,0,180,0,3927
"41005020501",5861,383,13,0,673,100,367,17,7414
"41005020503",1979,123,0,0,79,5,33,0,2219
"41005020504",5341,290,84,19,631,78,84,97,6624
"41005020505",2483,102,0,0,111,112,34,0,2842
"41005020600",6795,392,27,2,909,18,710,16,8869
"41005020700",3526,169,0,0,200,65,107,45,4112
"41005020800",2904,529,84,13,546,102,264,94,4536
"41005020900",2829,428,69,1,227,26,107,36,3723
"41005021000",3365,505,61,72,271,42,356,101,4773
"41005021100",4437,487,321,0,590,51,124,44,6054
"41005021200",2903,505,0,0,263,99,553,25,4348
"41005021300",4936,598,194,4,369,57,322,25,6505
"41005021400",3947,502,103,0,345,38,601,75,5611
"41005021500",4115,261,18,0,382,0,136,0,4912
"41005021601",3819,1047,43,1,450,130,236,158,5884
"41005021602",4145,551,25,18,409,159,597,176,6080
"41005021700",4689,537,203,0,449,150,373,35,6436
"41005021801",4543,357,42,0,369,0,43,39,5393
"41005021802",2698,736,4,0,713,54,597,51,4853
"41005021900",2890,552,0,16,66,180,176,250,4130
"41005022000",5373,623,31,127,516,108,418,145,7341
"41005022101",5303,909,37,5,414,146,600,145,7559
"41005022103",4802,84,0,0,1480,139,339,0,6844
"41005022105",4449,426,81,0,1056,68,359,0,6439
"41005022107",2699,455,95,30,388,85,424,53,4229
"41005022108",1927,464,72,0,118,14,539,0,3134
"41005022201",3257,617,15,40,540,278,1241,509,6497
"41005022205",2269,106,104,0,687,47,305,1,3519
"41005022206",4317,405,70,24,1699,87,175,0,6777
"41005022207",4175,15,37,0,1145,0,285,0,5657
"41005022208",4850,365,183,0,1466,1,248,1,7114
"41005022301",3170,468,28,5,135,54,90,19,3969
"41005022302",4728,331,0,0,265,12,319,0,5655
"41005022400",3431,359,11,8,290,55,207,0,4361
"41005022500",5856,1253,89,28,137,591,569,507,9030
"41005022602",3657,100,0,0,199,20,319,0,4295
"41005022603",2556,537,0,0,337,69,349,23,3871
"41005022605",6323,216,21,0,536,24,772,44,7936
"41005022606",3506,524,12,0,140,70,44,171,4467
"41005022702",5756,145,35,0,653,51,282,0,6922
"41005022707",3576,288,0,0,445,180,425,114,5028
"41005022708",3903,195,76,0,266,42,1041,0,5523
"41005022710",1890,202,7,0,305,133,121,151,2809
"41005022800",3726,165,0,0,21,8,63,17,4000
"41005022901",2798,178,0,0,330,36,146,37,3525
"41005022904",2974,439,0,0,123,88,712,235,4571
"41005022905",3364,275,0,0,277,12,293,195,4416
"41005022906",2483,263,0,0,161,0,388,15,3310
"41005022907",2964,730,0,0,301,338,780,739,5852
"41005023001",2740,309,0,0,221,0,7,58,3335
"41005023002",3073,251,19,0,83,0,273,29,3728
"41005023100",5247,451,51,0,417,14,69,93,6342
"41005023201",3849,249,32,4,188,51,64,6,4443
"41005023202",5352,447,0,0,818,17,360,69,7063
"41005023300",4142,257,0,0,138,71,179,71,4858
"41005023401",3604,416,0,0,235,77,344,150,4826
"41005023403",4311,132,0,0,100,0,143,0,4686
"41005023404",4905,567,19,0,424,51,280,67,6313
"41005023500",5010,485,0,21,115,18,296,18,5963
"41005023600",3482,431,7,0,133,9,189,0,4251
"41005023700",4213,747,5,0,284,35,90,25,5399
"41005023800",5718,723,0,0,309,38,701,410,7899
"41005023901",5319,287,0,0,81,0,455,0,6142
"41005023902",4159,365,0,0,328,119,207,90,5268
"41005024000",2589,120,0,0,39,0,18,0,2766
"41005024100",4436,220,24,0,94,17,123,0,4914
"41005024200",5116,874,20,16,222,139,286,158,6831
"41005024302",4387,494,29,0,96,0,174,256,5436
"41005024303",3161,276,0,0,31,0,192,0,3660
"41005024304",1857,184,0,0,50,3,37,23,2154
"41005024400",5558,372,83,15,635,256,700,104,7723
"41005980000",51,20,6,0,85,5,98,18,283
"41007950100",2241,246,16,2,237,120,282,15,3159
"41007950200",2615,668,22,26,209,136,86,46,3808
"41007950300",1936,514,25,0,114,131,223,189,3132
"41007950400",3233,254,34,22,121,11,210,39,3924
"41007950500",3545,764,19,0,299,33,307,44,5011
"41007950600",2123,346,0,0,209,74,142,7,2901
"41007950700",1638,277,18,0,44,55,65,51,2148
"41007950900",3097,574,6,0,287,314,296,288,4862
"41007951100",3505,590,1,0,218,108,257,140,4819
"41007951200",2634,256,0,0,149,10,140,5,3194
"41007951300",1977,204,14,0,117,14,21,14,2361
"41007990000",0,0,0,0,0,0,0,0,0
"41009970200",5692,773,0,0,151,187,179,64,7046
"41009970300",3175,478,20,16,319,22,159,3,4192
"41009970400",1971,228,0,0,115,11,14,4,2343
"41009970500",5435,394,0,0,198,0,155,7,6189
"41009970600",5251,352,0,12,257,0,212,94,6178
"41009970700",2669,636,0,0,382,308,136,285,4416
"41009970800",4862,938,0,0,611,267,298,59,7035
"41009970900",3818,624,0,0,327,37,112,150,5068
"41009971000",3866,627,16,0,146,57,77,31,4820
"41009971100",2970,439,21,0,86,7,57,1,3581
"41011000100",4442,631,6,4,476,57,143,73,5832
"41011000200",2083,451,6,4,123,109,20,31,2827
"41011000300",2172,411,9,0,263,158,156,95,3264
"41011000400",5135,635,0,19,572,150,290,54,6855
"41011000502",1517,721,4,19,93,31,39,1,2425
"41011000503",1885,668,0,62,256,56,151,32,3110
"41011000504",3793,1359,13,318,1073,216,674,423,7869
"41011000600",1997,281,38,0,159,60,48,18,2601
"41011000700",4535,881,0,0,541,181,380,61,6579
"41011000800",2176,513,0,0,103,0,32,28,2852
"41011000900",5776,888,0,0,430,116,277,22,7509
"41011001000",6061,951,0,43,172,64,206,12,7509
"41011001100",4165,929,0,0,350,85,104,75,5708
"41011990101",0,0,0,0,0,0,0,0,0
"41013950100",5153,1202,37,0,356,73,548,132,7501
"41013950200",3323,870,0,0,187,12,281,8,4681
"41013950300",3667,1240,7,88,461,67,296,64,5890
"41013950400",3088,622,0,0,69,117,94,90,4080
"41015950100",2405,768,0,0,44,29,68,69,3383
"41015950200",4163,717,0,0,226,14,281,105,5506
"41015950301",3566,431,0,0,371,0,105,0,4473
"41015950302",3973,444,0,0,461,23,427,10,5338
"41015950400",3195,790,0,0,351,190,185,86,4797
"41015990101",0,0,0,0,0,0,0,0,0
"41017000100",1693,89,0,0,103,0,8,0,1893
"41017000200",3283,895,0,16,148,29,146,36,4553
"41017000300",6930,1226,16,0,202,205,83,135,8797
"41017000401",4275,574,0,0,119,0,368,0,5336
"41017000402",2023,252,0,0,10,26,0,0,2311
"41017000500",4611,620,2,0,143,247,190,226,6039
"41017000600",5590,800,0,0,138,16,26,44,6614
"41017000700",6263,844,44,0,595,61,504,53,8364
"41017000800",5120,1299,0,0,50,186,578,237,7470
"41017000900",4265,2333,0,52,273,440,803,919,9085
"41017001001",10304,2436,42,0,870,0,602,162,14416
"41017001002",2032,427,0,0,82,0,390,14,2945
"41017001100",9165,480,38,0,242,139,215,0,10279
"41017001200",5709,538,0,0,379,162,242,65,7095
"41017001300",9399,1104,102,18,588,227,494,178,12110
"41017001400",4581,299,8,0,445,17,93,17,5460
"41017001500",4550,849,0,0,469,50,478,131,6527
"41017001600",3587,969,40,0,504,145,510,254,6009
"41017001700",6298,1592,0,0,197,43,582,130,8842
"41017001800",5069,1352,54,82,215,142,381,88,7383
"41017001901",1651,86,0,0,57,22,51,22,1889
"41017001902",7455,682,51,24,1063,150,951,71,10447
"41017002000",6418,375,0,0,539,134,700,60,8226
"41017002100",9281,1406,23,0,249,158,420,695,12232
"41019010000",1402,459,0,0,138,67,57,21,2144
"41019020000",2786,493,0,0,166,128,251,27,3851
"41019030000",3269,538,0,0,208,79,102,43,4239
"41019040000",1999,408,0,2,70,61,15,47,2602
"41019050001",3996,368,0,1,97,13,40,0,4515
"41019050002",4743,1229,62,0,372,81,187,97,6771
"41019060000",2955,329,0,0,122,7,90,0,3503
"41019070000",4400,344,0,30,191,31,50,0,5046
"41019080000",6691,421,48,5,322,12,46,0,7545
"41019090000",3889,1605,0,0,323,87,150,114,6168
"41019100000",2067,476,46,0,307,83,81,118,3178
"41019110000",2351,374,0,0,102,7,88,38,2960
"41019120000",5405,1894,0,53,268,135,222,149,8126
"41019130000",3389,1438,0,0,227,145,206,105,5510
"41019140000",4143,797,6,0,217,219,155,213,5750
"41019150000",5766,1518,0,0,362,19,473,160,8298
"41019160000",4922,1979,0,0,300,119,322,221,7863
"41019170000",2503,550,43,0,202,31,17,96,3442
"41019180000",3172,705,0,0,263,236,185,169,4730
"41019190000",3091,895,0,0,186,307,177,254,4910
"41019200000",3510,1053,0,0,361,295,167,48,5434
"41019210000",3342,610,0,0,160,71,178,24,4385
"41019990000",0,0,0,0,0,0,0,0,0
"41021960100",1731,148,9,2,22,0,122,22,2056
"41023960100",1718,378,2,0,53,19,35,0,2205
"41023960200",4149,656,7,8,174,53,135,67,5249
"41025960100",3602,993,32,3,262,74,208,49,5223
"41025960200",1629,353,10,0,100,85,48,2,2227
"41027950100",2888,322,17,0,380,326,636,343,4912
"41027950200",5674,666,42,0,248,45,869,35,7579
"41027950300",3935,1241,0,0,321,167,869,831,7364
"41027950400",4733,531,14,0,558,195,2800,296,9127
"41029000100",715,1119,23,32,198,54,266,440,2847
"41029000201",2091,792,0,0,87,92,494,108,3664
"41029000202",2265,981,0,84,292,242,539,355,4758
"41029000203",3236,717,0,0,200,18,865,133,5169
"41029000300",3742,1264,9,11,337,95,762,214,6434
"41029000403",3441,287,0,7,182,0,113,8,4038
"41029000404",4129,429,0,0,190,0,146,14,4908
"41029000405",3167,861,14,27,146,75,370,189,4849
"41029000406",3027,460,0,0,309,392,597,87,4872
"41029000501",1922,834,0,5,22,57,230,149,3219
"41029000502",2562,1431,71,26,438,162,338,118,5146
"41029000601",5587,811,0,0,266,18,256,43,6981
"41029000602",4325,828,0,0,223,0,203,62,5641
"41029000700",6648,1425,15,86,535,557,625,626,10517
"41029000800",4020,1291,145,0,269,324,242,676,6967
"41029000900",7136,930,50,0,439,38,959,298,9850
"41029001001",5349,908,0,0,125,58,224,75,6739
"41029001002",3643,467,29,0,174,77,280,0,4670
"41029001100",4392,464,0,0,485,0,547,111,5999
"41029001200",2880,640,0,26,243,23,381,274,4467
"41029001301",3851,790,1,12,489,344,869,96,6452
"41029001302",7716,862,114,42,934,75,2734,232,12709
"41029001400",7754,1304,0,0,1130,179,928,0,11295
"41029001500",4280,296,24,0,178,0,74,2,4854
"41029001601",2662,766,11,0,249,58,617,197,4560
"41029001602",5066,1102,0,23,739,25,1316,278,8549
"41029001700",5122,1497,75,0,229,248,472,214,7857
"41029001800",6198,1178,283,20,467,54,337,49,8586
"41029001900",1179,758,12,0,129,67,160,56,2361
"41029002000",1766,328,31,0,45,6,61,6,2243
"41029002100",2638,477,0,0,228,83,163,36,3625
"41029002200",3418,676,76,0,126,96,27,13,4432
"41029002300",1299,216,0,0,77,19,84,0,1695
"41029002400",1588,195,0,0,121,99,187,49,2239
"41029002500",2190,190,16,0,167,42,43,0,2648
"41029002600",2254,407,0,0,100,48,48,10,2867
"41029002700",4955,1120,0,0,262,21,327,98,6783
"41029002800",4248,455,3,0,218,63,326,212,5525
"41029002900",5668,827,7,0,330,112,446,73,7463
"41029003001",3444,346,0,0,172,0,197,0,4159
"41029003002",3499,1263,21,0,138,11,0,27,4959
"41031940000",204,16,0,0,2042,915,202,93,3472
"41031960100",1304,163,0,11,53,35,62,84,1712
"41031960201",1861,485,0,0,623,507,1151,310,4937
"41031960202",3270,801,33,0,814,233,727,503,6381
"41031960301",2815,197,0,25,184,0,82,0,3303
"41031960302",2955,629,49,5,428,361,376,517,5320
"41033360100",1890,584,0,3,229,6,18,5,2735
"41033360300",4556,585,0,0,304,127,17,2,5591
"41033360400",3357,346,14,0,183,47,353,55,4355
"41033360500",3171,2036,0,0,859,150,546,234,6996
"41033360600",4817,1069,0,11,445,36,268,77,6723
"41033360701",2695,923,31,0,183,147,405,68,4452
"41033360702",3770,932,15,0,179,148,442,36,5522
"41033360800",3971,770,8,0,38,58,485,42,5372
"41033360900",1780,618,0,0,92,0,50,26,2566
"41033361000",3995,503,0,0,119,75,101,0,4793
"41033361100",7116,1585,0,0,297,32,644,132,9806
"41033361200",5326,1159,19,0,169,297,429,150,7549
"41033361300",6148,836,2,0,289,21,117,13,7426
"41033361400",1981,413,0,0,116,0,42,0,2552
"41033361500",1585,466,10,0,177,46,34,103,2421
"41033361600",5617,2058,117,11,230,46,484,150,8713
"41035970100",2491,394,0,8,126,158,46,123,3346
"41035970200",2893,517,96,0,568,422,20,26,4542
"41035970300",2416,405,0,0,87,27,71,82,3088
"41035970400",1006,243,19,0,55,10,98,0,1431
"41035970500",1010,383,0,0,61,56,40,24,1574
"41035970600",1127,197,0,0,168,34,445,160,2131
"41035970700",1645,366,3,0,203,8,573,249,3047
"41035970800",2232,313,0,16,43,1,48,95,2748
"41035970900",2895,574,10,27,326,52,193,13,4090
"41035971000",2200,250,0,0,39,16,64,22,2591
"41035971100",4186,665,16,0,396,84,567,37,5951
"41035971200",1458,371,0,40,201,127,170,223,2590
"41035971300",4881,520,0,78,136,105,635,88,6443
"41035971400",4307,392,35,33,365,190,539,137,5998
"41035971500",2698,595,0,14,481,111,325,67,4291
"41035971600",1497,982,66,27,710,148,536,279,4245
"41035971700",1914,646,7,0,283,159,332,171,3512
"41035971800",1214,719,0,32,326,111,127,20,2549
"41035971900",2229,693,28,0,282,49,227,20,3528
"41035972000",3165,624,21,0,232,76,149,179,4446
"41037960100",1911,403,0,6,101,27,89,29,2566
"41037960200",3672,745,0,24,393,111,358,87,5390
"41039000100",4031,555,6,0,301,75,260,16,5244
"41039000200",4207,705,5,0,241,88,83,24,5353
"41039000300",1690,168,0,16,192,16,87,0,2169
"41039000402",3087,314,6,0,165,0,314,0,3886
"41039000403",4143,627,0,0,42,40,78,32,4962
"41039000404",2569,609,19,0,323,139,215,199,4073
"41039000500",1313,414,5,0,84,59,40,11,1926
"41039000702",1963,346,8,0,84,145,42,0,2588
"41039000705",2853,553,0,1,118,34,64,2,3625
"41039000706",2094,401,7,0,34,39,59,22,2656
"41039000707",2912,606,50,0,238,3,10,3,3822
"41039000708",1447,586,0,0,80,9,31,36,2189
"41039000800",1185,93,6,0,67,7,40,0,1398
"41039000902",3549,438,0,0,272,71,101,0,4431
"41039000903",4081,719,19,1,403,41,368,75,5707
"41039000904",1887,643,0,8,192,29,28,72,2859
"41039001001",1721,258,0,0,131,19,22,8,2159
"41039001002",3281,433,17,8,358,91,221,114,4523
"41039001101",5127,351,0,0,355,38,298,0,6169
"41039001102",2834,235,33,14,132,92,95,39,3474
"41039001201",3096,346,0,0,108,168,365,226,4309
"41039001202",3116,572,2,0,224,153,354,21,4442
"41039001301",2453,756,19,0,136,107,22,0,3493
"41039001302",3607,985,0,0,250,197,354,123,5516
"41039001400",1769,306,0,0,226,52,89,2,2444
"41039001500",3279,899,0,0,167,3,85,3,4436
"41039001600",3838,928,0,0,230,106,176,20,5298
"41039001700",4782,509,0,0,211,39,98,10,5649
"41039001801",4591,400,35,31,467,105,397,76,6102
"41039001803",3430,448,15,0,273,82,108,52,4408
"41039001804",3051,445,0,0,143,18,101,6,3764
"41039001902",4966,1402,83,40,357,115,752,255,7970
"41039001903",1895,637,0,0,118,132,131,113,3026
"41039001904",3580,845,9,19,400,127,991,222,6193
"41039002001",3020,632,0,0,123,0,414,155,4344
"41039002002",3619,533,0,0,435,163,214,16,4980
"41039002101",1734,614,0,23,331,6,323,37,3068
"41039002102",4282,1611,0,0,559,228,495,178,7353
"41039002201",3201,213,9,1,221,6,195,7,3853
"41039002202",4629,683,0,0,466,128,211,0,6117
"41039002301",2165,812,0,37,417,278,284,152,4145
"41039002302",3532,642,28,5,426,174,610,137,5554
"41039002401",3020,533,56,0,362,16,96,0,4083
"41039002403",3386,262,154,0,335,10,106,0,4253
"41039002404",3369,546,19,0,420,19,288,101,4762
"41039002501",3521,894,74,33,244,118,243,366,5493
"41039002503",5674,1024,250,0,1168,126,1071,424,9737
"41039002504",2289,464,0,0,216,94,373,130,3566
"41039002600",4356,802,11,0,566,80,669,41,6525
"41039002700",2397,898,85,0,594,38,457,74,4543
"41039002800",3213,450,6,3,394,40,454,9,4569
"41039002902",2840,488,53,0,316,164,44,69,3974
"41039002903",2155,117,0,0,261,51,108,0,2692
"41039002904",2415,406,103,0,235,72,57,0,3288
"41039003000",3804,168,8,8,253,19,86,10,4356
"41039003101",3859,1086,7,0,756,127,65,121,6021
"41039003102",3446,1942,78,17,711,1020,249,139,7602
"41039003201",1664,697,16,19,113,292,120,333,3254
"41039003202",2693,662,0,50,196,25,248,30,3904
"41039003301",1934,1103,0,27,278,200,222,144,3908
"41039003302",1842,802,0,31,168,363,41,264,3511
"41039003400",3369,827,41,8,419,73,723,201,5661
"41039003500",3589,219,0,0,342,75,229,60,4514
"41039003600",2343,578,5,12,443,67,75,0,3523
"41039003700",624,597,0,59,42,163,15,77,1577
"41039003800",918,3833,134,0,92,723,19,144,5863
"41039003900",965,821,21,12,104,401,6,156,2486
"41039004000",1466,685,47,68,200,118,90,197,2871
"41039004100",2991,407,22,1,259,173,120,137,4110
"41039004200",1545,1392,68,21,346,261,453,105,4191
"41039004300",5084,1349,26,0,284,443,1262,374,8822
"41039004401",3529,876,174,128,629,70,642,117,6165
"41039004403",2409,1530,18,0,343,200,97,102,4699
"41039004404",2639,247,0,0,250,29,82,0,3247
"41039004405",3842,321,52,0,480,8,163,0,4866
"41039004501",1721,622,0,0,216,161,209,17,2946
"41039004502",2279,858,34,14,97,61,168,182,3693
"41039004600",2096,373,19,0,295,2,94,24,2903
"41039004700",2559,1011,42,13,82,202,124,138,4171
"41039004800",1748,2165,84,80,213,618,200,133,5241
"41039004900",2540,961,48,74,350,229,85,86,4373
"41039005000",3508,658,0,0,557,133,418,14,5288
"41039005100",2135,630,11,92,394,107,172,46,3587
"41039005200",1638,123,0,0,151,20,85,22,2039
"41039005300",2013,115,25,0,157,89,185,12,2596
"41039005400",4608,225,24,0,598,82,246,17,5800
"41039990000",0,0,0,0,0,0,0,0,0
"41041950100",2667,500,0,0,158,37,71,0,3433
"41041950303",1009,243,0,0,41,101,39,23,1456
"41041950304",1992,481,0,9,492,62,448,65,3549
"41041950400",2770,916,0,0,363,66,290,313,4718
"41041950601",1747,366,0,2,322,1,7,1,2446
"41041950602",1850,258,0,0,429,34,388,71,3030
"41041950800",2511,694,14,0,275,58,234,69,3855
"41041950900",2309,343,0,0,705,111,591,0,4059
"41041951000",1187,360,25,39,159,71,178,37,2056
"41041951100",1357,145,0,0,80,0,145,17,1744
"41041951200",1500,156,0,0,75,12,45,0,1788
"41041951300",2067,241,0,0,114,0,67,0,2489
"41041951400",1988,604,0,0,170,6,156,0,2924
"41041951500",1633,306,0,0,40,0,0,0,1979
"41041951600",2663,410,7,0,139,33,114,9,3375
"41041951700",1551,260,0,18,173,105,141,75,2323
"41041951800",2435,447,28,0,749,306,67,49,4081
"41041990100",0,0,0,0,0,0,0,0,0
"41043020100",7042,1789,0,0,759,141,689,757,11177
"41043020200",1563,247,0,0,82,18,49,6,1965
"41043020300",5988,547,84,0,631,34,472,135,7891
"41043020400",2479,1224,0,0,525,138,541,391,5298
"41043020500",2580,949,0,0,117,64,242,94,4046
"41043020600",6921,807,68,0,442,219,650,197,9304
"41043020700",3796,1442,0,0,399,30,254,48,5969
"41043020801",1404,805,0,9,143,214,362,208,3145
"41043020802",2909,2174,81,88,341,744,721,937,7995
"41043030100",5046,712,8,0,221,82,206,6,6281
"41043030200",5607,635,3,0,329,51,363,88,7076
"41043030300",1702,251,0,0,84,0,91,0,2128
"41043030401",4352,1472,0,14,293,61,290,0,6482
"41043030402",5376,1254,0,0,147,27,76,15,6895
"41043030500",3527,500,16,0,74,10,89,0,4216
"41043030600",5499,770,0,0,242,154,310,146,7121
"41043030700",2964,376,21,0,75,63,232,73,3804
"41043030800",5549,1206,13,0,155,301,51,159,7434
"41043030902",6331,869,25,0,397,22,125,107,7876
"41043030903",4563,1353,0,52,172,110,92,108,6450
"41043030904",2854,739,27,0,149,34,136,10,3949
"41045940000",0,0,0,0,0,0,0,0,0
"41045970200",2674,701,36,0,384,610,650,1049,6104
"41045970300",2519,892,30,5,275,292,654,488,5155
"41045970400",2051,1128,0,12,519,867,1033,1334,6944
"41045970500",3483,1030,33,39,423,140,1762,806,7716
"41045970600",3019,885,12,0,331,20,609,155,5031
"41045970700",1312,128,0,0,95,34,189,12,1770
"41045970900",2392,939,13,7,172,110,260,224,4117
"41047000200",1563,452,0,0,127,111,82,60,2395
"41047000300",2844,963,58,14,583,674,593,801,6530
"41047000400",2032,1193,22,17,788,903,948,1008,6911
"41047000501",1885,537,135,0,1171,357,1336,227,5648
"41047000502",1456,969,26,62,757,2143,837,1603,7853
"41047000600",3630,637,16,0,399,66,653,109,5510
"41047000701",2720,1016,62,100,793,913,1244,686,7534
"41047000900",3135,1012,16,17,1286,279,1507,268,7520
"41047001000",1998,1022,0,0,581,262,509,635,5007
"41047001100",3490,429,87,18,437,122,398,26,5007
"41047001200",2435,737,23,0,212,69,151,74,3701
"41047001300",3291,355,9,0,418,39,177,63,4352
"41047001401",4255,951,0,10,651,41,736,172,6816
"41047001402",4824,365,94,0,408,95,1150,143,7079
"41047001501",3332,449,40,0,551,103,466,179,5120
"41047001502",3334,744,27,0,785,348,1129,433,6800
"41047001503",3188,723,0,91,433,234,1005,345,6019
"41047001601",4534,643,168,0,1053,536,1255,643,8832
"41047001602",3303,1763,53,57,2309,1393,2943,2137,13958
"41047001603",4421,695,94,0,1281,71,1833,138,8533
"41047001604",4498,1413,56,0,1484,642,1747,1252,11092
"41047001701",3309,1114,41,0,1142,921,2050,1139,9716
"41047001702",2629,907,33,17,1298,363,1429,670,7346
"41047001703",3624,324,8,0,516,99,986,113,5670
"41047001801",3629,1014,90,18,1338,602,2005,707,9403
"41047001802",4480,1370,12,231,1807,597,2984,693,12174
"41047001803",2048,630,0,6,274,53,614,394,4019
"41047002000",7746,552,22,44,989,186,1114,133,10786
"41047002101",1682,368,0,0,120,43,233,20,2466
"41047002102",5275,355,0,0,480,174,1300,23,7607
"41047002201",1660,301,6,0,213,3,171,0,2354
"41047002202",4887,611,33,124,695,75,349,49,6823
"41047002301",2279,243,12,0,372,6,85,9,3006
"41047002303",5480,704,263,29,510,50,273,56,7365
"41047002304",4649,180,13,0,427,111,270,18,5668
"41047002400",3071,363,0,24,105,0,81,0,3644
"41047002501",7459,783,0,0,498,128,827,2,9697
"41047002502",3663,825,12,0,755,185,956,385,6781
"41047002600",1730,247,0,0,6,2,189,40,2214
"41047002700",7421,480,4,0,367,31,695,76,9074
"41047002800",3036,556,31,0,187,47,234,0,4091
"41047010100",1182,141,0,0,174,46,172,62,1777
"41047010201",2045,209,39,0,171,87,295,154,3000
"41047010202",6002,505,0,0,405,455,1264,571,9202
"41047010303",3325,738,0,3,887,255,1931,499,7638
"41047010304",3305,1694,16,0,1347,325,2843,1746,11276
"41047010305",1866,772,9,0,937,407,1665,1019,6675
"41047010306",3549,2074,15,0,2221,963,2905,2370,14097
"41047010307",4407,548,0,0,572,46,1192,46,6811
"41047010400",3597,619,0,5,616,46,1096,142,6121
"41047010501",4773,305,0,0,279,64,305,51,5777
"41047010502",5279,836,0,0,472,137,340,85,7149
"41047010503",3146,474,15,0,113,42,331,23,4144
"41047010600",1772,193,0,0,253,15,218,2,2453
"41047010701",5719,1315,39,0,714,407,1307,122,9623
"41047010702",5033,692,2,0,770,0,525,28,7050
"41047010801",4553,833,0,0,464,77,455,90,6472
"41047010802",4579,909,0,0,792,84,810,297,7471
"41049970100",5273,1358,34,0,1075,238,2555,1059,11592
"41049970200",2504,547,0,0,128,14,62,21,3276
"41051000100",5013,505,0,0,370,42,258,42,6230
"41051000200",4586,686,38,11,600,161,309,202,6593
"41051000301",3241,830,50,2,348,111,282,59,4923
"41051000302",5681,512,0,0,597,0,185,2,6977
"41051000401",2959,284,29,0,284,12,63,19,3650
"41051000402",2491,284,0,0,374,35,72,33,3289
"41051000501",2629,341,0,0,533,78,97,35,3713
"41051000502",3218,699,140,11,592,125,295,139,5219
"41051000601",3015,689,295,8,931,426,861,292,6517
"41051000602",3498,516,164,90,1191,154,919,53,6585
"41051000701",3332,280,21,289,617,264,107,182,5092
"41051000702",2834,425,87,113,858,198,362,46,4923
"41051000801",3532,440,72,0,406,148,95,53,4746
"41051000802",3093,598,50,197,605,80,301,79,5003
"41051000901",2796,503,8,0,439,138,54,26,3964
"41051000902",2738,474,85,453,421,270,252,79,4772
"41051001000",3974,990,30,27,276,83,458,118,5956
"41051001101",1086,564,21,55,121,105,43,37,2032
"41051001102",1145,221,12,6,194,25,98,39,1740
"41051001201",4037,812,77,6,237,53,217,31,5470
"41051001202",2685,208,13,17,449,8,97,0,3477
"41051001301",2696,567,30,0,505,22,275,28,4123
"41051001302",2524,189,1,0,321,6,132,0,3173
"41051001400",3630,380,40,87,620,63,259,13,5092
"41051001500",2766,166,13,0,175,7,53,8,3188
"41051001601",4122,248,148,3,657,36,328,71,5613
"41051001602",2511,432,307,170,803,414,378,143,5158
"41051001701",4080,607,246,299,802,397,160,104,6695
"41051001702",2198,462,197,111,676,308,256,101,4309
"41051001801",3000,492,35,140,480,149,277,87,4660
"41051001802",2882,354,18,0,217,92,63,7,3633
"41051001900",4220,204,11,0,336,10,119,0,4900
"41051002000",4112,1251,56,22,459,82,220,101,6303
"41051002100",1422,385,33,48,116,49,102,0,2155
"41051002203",1713,481,288,397,217,83,139,108,3426
"41051002303",1120,388,101,172,223,73,43,51,2171
"41051002401",2309,110,158,7,170,0,63,14,2831
"41051002402",2548,266,36,212,300,62,103,11,3538
"41051002501",3932,216,73,0,336,3,118,8,4686
"41051002502",2985,375,164,31,403,2,346,21,4327
"41051002600",2639,181,23,0,85,6,143,13,3090
"41051002701",2912,159,8,0,351,0,64,0,3494
"41051002702",2133,393,34,84,204,42,85,103,3078
"41051002801",2052,174,100,0,439,24,8,0,2797
"41051002802",2284,196,108,0,255,7,111,8,2969
"41051002901",3657,181,39,8,340,80,287,1,4593
"41051002902",3858,496,320,0,608,92,205,40,5619
"41051002903",3140,451,234,234,699,344,334,126,5562
"41051003000",3390,303,251,0,438,34,122,0,4538
"41051003100",3870,333,134,76,264,89,168,67,5001
"41051003200",2857,418,325,35,302,93,67,28,4125
"41051003301",1881,121,386,170,342,349,241,241,3731
"41051003302",1565,411,573,44,179,70,151,77,3070
"41051003401",1555,486,475,617,265,82,94,108,3682
"41051003402",2213,325,618,180,337,58,403,110,4244
"41051003501",2318,340,124,252,313,129,209,88,3773
"41051003502",1489,306,178,39,101,20,36,6,2175
"41051003601",2485,496,972,232,252,61,268,0,4766
"41051003602",3581,425,908,250,432,151,321,93,6161
"41051003603",995,55,178,54,207,9,53,0,1551
"41051003701",2040,237,599,368,625,38,507,30,4444
"41051003702",1722,375,385,52,203,40,130,51,2958
"41051003801",2063,237,113,11,249,231,64,21,2989
"41051003802",1943,339,105,0,437,297,145,270,3536
"41051003803",2699,474,169,284,520,42,347,61,4596
"41051003901",4149,804,805,424,1252,76,925,157,8592
"41051003902",2242,145,69,47,405,53,164,34,3159
"41051004001",3643,1395,436,1244,521,852,1006,744,9841
"41051004002",2734,1021,65,25,404,171,317,41,4778
"41051004101",4108,531,286,211,1015,643,787,390,7971
"41051004102",3299,663,114,62,620,560,367,577,6262
"41051004200",2280,441,66,102,369,44,387,127,3816
"41051004300",829,56,6,5,96,4,35,0,1031
"41051004500",1642,114,0,0,293,92,239,32,2412
"41051004601",2658,127,10,0,379,42,93,42,3351
"41051004602",1691,105,0,0,106,32,97,0,2031
"41051004700",3602,424,18,60,721,38,422,80,5365
"41051004800",1920,641,27,0,506,74,244,49,3461
"41051004900",2016,495,82,212,176,239,166,69,3455
"41051005000",2338,151,0,0,214,33,103,0,2839
"41051005100",5269,1405,82,146,502,96,227,64,7791
"41051005200",2901,742,163,100,312,246,240,77,4781
"41051005500",1257,698,64,35,395,171,117,42,2779
"41051005600",1893,707,13,120,331,355,172,31,3622
"41051005700",2401,482,87,16,780,172,171,59,4168
"41051005800",4063,536,135,0,751,87,218,0,5790
"41051005900",4737,723,54,68,1063,92,318,65,7120
"41051006001",1029,243,17,19,121,37,48,0,1514
"41051006002",1746,146,98,7,188,29,118,0,2332
"41051006100",2113,131,18,2,77,5,98,54,2498
"41051006200",2514,283,23,0,157,91,124,12,3204
"41051006300",3243,354,11,0,261,15,151,13,4048
"41051006402",5040,167,0,0,431,4,79,0,5721
"41051006403",2773,229,309,362,400,73,68,1,4215
"41051006404",2709,95,57,0,432,17,81,9,3400
"41051006501",4931,425,30,55,449,42,142,55,6129
"41051006502",3453,388,0,2,274,78,260,0,4455
"41051006601",2210,86,14,0,102,33,35,0,2480
"41051006602",3997,960,44,0,341,0,273,0,5615
"41051006701",2539,250,8,25,321,13,71,13,3240
"41051006702",2414,265,16,0,366,23,218,13,3315
"41051006801",1684,227,53,13,367,44,141,16,2545
"41051006802",2807,264,58,14,357,0,242,40,3782
"41051006900",2238,91,67,6,240,0,60,0,2702
"41051007000",6070,359,107,0,1638,57,330,0,8561
"41051007100",2283,116,0,0,109,26,69,0,2603
"41051007201",1464,261,28,0,94,10,69,8,1934
"41051007202",1593,188,384,111,704,120,241,17,3358
"41051007300",214,178,6,6,122,18,94,70,708
"41051007400",1453,492,511,326,497,402,444,490,4615
"41051007500",2590,667,689,360,762,442,404,636,6550
"41051007600",1932,506,126,111,570,390,702,658,4995
"41051007700",1249,239,35,52,333,59,251,31,2249
"41051007800",1108,170,101,73,273,122,199,115,2161
"41051007900",2086,580,492,38,969,239,357,85,4846
"41051008001",2234,428,29,32,756,60,238,266,4043
"41051008002",2042,148,175,39,779,50,319,51,3603
"41051008100",3573,694,703,256,1100,1016,978,696,9016
"41051008201",1779,226,31,0,614,143,189,62,3044
"41051008202",4234,1291,87,430,1685,1175,823,1172,10897
"41051008301",1410,539,183,409,932,654,285,108,4520
"41051008302",1953,657,30,105,952,469,505,354,5025
"41051008400",2553,693,160,142,564,406,599,298,5415
"41051008500",2193,920,43,39,649,125,338,220,4527
"41051008600",2430,912,0,84,552,293,729,482,5482
"41051008700",2533,687,0,0,1125,90,402,46,4883
"41051008800",3181,672,51,1,555,121,365,115,5061
"41051008901",5734,488,226,980,1631,474,664,404,10601
"41051008902",2190,615,35,156,585,187,253,303,4324
"41051009000",4975,1991,342,132,1635,621,1060,468,11224
"41051009101",2953,906,206,186,139,1477,380,856,7103
"41051009102",4172,717,34,96,707,336,573,204,6839
"41051009201",4502,1623,131,81,987,695,166,365,8550
"41051009202",2534,627,235,234,1429,147,619,111,5936
"41051009301",3011,1066,489,198,1412,340,1038,564,8118
"41051009302",2593,424,121,76,973,137,293,125,4742
"41051009400",4962,670,114,41,1119,104,830,324,8164
"41051009501",2189,583,458,301,762,289,77,217,4876
"41051009502",2078,553,336,381,734,123,307,224,4736
"41051009603",2653,418,71,16,619,148,881,54,4860
"41051009604",2390,1118,182,352,807,605,1059,635,7148
"41051009605",2676,755,520,215,824,372,270,138,5770
"41051009606",2385,1151,216,136,958,785,877,1171,7679
"41051009701",2727,1434,190,63,865,379,472,392,6522
"41051009702",4301,1854,127,420,1518,395,895,264,9774
"41051009801",2085,1031,39,175,332,531,636,715,5544
"41051009803",3738,1654,172,43,1311,437,765,1249,9369
"41051009804",2131,617,32,24,126,125,268,319,3642
"41051009903",4730,95,37,0,923,3,43,1,5832
"41051009904",2364,582,22,0,135,101,99,402,3705
"41051009905",2482,97,5,0,233,164,254,0,3235
"41051009906",2682,186,49,39,177,34,123,33,3323
"41051009907",3743,597,50,10,512,54,421,57,5444
"41051010001",3489,1258,66,15,526,314,692,601,6961
"41051010002",3436,640,42,10,841,59,383,57,5468
"41051010100",6202,1033,128,192,1367,757,1461,1417,12557
"41051010200",3892,740,182,8,767,283,407,411,6690
"41051010303",3163,1129,83,36,1000,62,908,315,6696
"41051010304",2496,1042,132,100,519,482,656,706,6133
"41051010305",3087,398,34,0,251,142,38,0,3950
"41051010306",3352,593,71,85,788,0,218,0,5107
"41051010402",5082,292,74,51,554,55,311,0,6419
"41051010405",4253,700,241,24,516,55,826,227,6842
"41051010407",3817,879,26,119,735,125,732,364,6797
"41051010408",4077,922,0,0,503,213,679,429,6823
"41051010409",6644,751,174,0,734,35,696,463,9497
"41051010410",2827,1033,16,20,599,241,494,300,5530
"41051010411",2281,337,64,42,139,137,255,47,3302
"41051010500",3269,600,15,7,394,17,252,28,4582
"41051010600",967,954,86,79,201,181,26,214,2708
"41051980000",0,0,0,0,0,0,0,0,0
"41053005100",1094,536,78,0,371,308,380,317,3084
"41053005201",7059,516,45,0,1301,29,1476,16,10442
"41053005202",7775,447,40,0,961,200,1026,37,10486
"41053005300",7165,620,43,0,481,444,466,393,9612
"41053020202",4432,943,0,0,169,0,227,52,5823
"41053020203",1841,880,0,0,113,93,41,36,3004
"41053020204",4023,543,0,11,546,7,461,7,5598
"41053020302",6043,2001,47,0,992,561,2016,997,12657
"41053020303",1619,816,0,24,465,190,154,84,3352
"41053020304",4837,1489,0,17,339,223,599,160,7664
"41053020400",3998,789,17,0,679,119,97,18,5717
"41053020500",5086,916,0,0,322,5,296,31,6656
"41055950100",1337,305,4,2,88,37,47,50,1870
"41057960100",2542,652,12,0,73,32,124,342,3777
"41057960200",1896,295,5,7,47,38,80,6,2374
"41057960300",2251,234,0,0,160,7,157,9,2818
"41057960400",4779,1411,0,0,717,239,616,224,7986
"41057960500",1529,427,0,1,116,226,107,310,2716
"41057960600",1811,249,0,6,150,5,117,13,2351
"41057960700",2128,186,0,0,18,0,29,0,2361
"41057960800",1945,269,14,0,24,43,106,94,2495
"41057990100",0,0,0,0,0,0,0,0,0
"41059940000",1304,194,0,0,981,343,131,33,2986
"41059950100",3757,283,18,0,312,42,375,9,4796
"41059950200",4314,2200,12,8,565,531,1972,2036,11638
"41059950300",2257,335,5,0,81,57,94,2,2831
"41059950400",4771,452,21,0,232,32,259,43,5810
"41059950500",3759,420,5,7,185,110,227,0,4713
"41059950600",4232,682,122,24,602,173,498,0,6333
"41059950700",1772,337,30,0,202,107,167,90,2705
"41059950800",4763,746,0,0,269,37,2198,333,8346
"41059950900",2268,621,0,20,723,37,1356,306,5331
"41059951000",3826,1035,9,6,1164,148,1771,193,8152
"41059951100",4706,784,0,0,250,22,1349,250,7361
"41059951200",5873,1506,0,8,1158,389,2599,1349,12882
"41059951300",2971,424,0,0,428,38,743,76,4680
"41059951400",1997,199,0,0,151,24,87,8,2466
"41061970100",2467,420,0,0,115,59,60,17,3138
"41061970200",2503,387,6,0,140,102,43,72,3253
"41061970300",2103,167,0,0,96,57,94,22,2539
"41061970400",2434,393,11,4,65,6,170,125,3208
"41061970500",2493,821,0,0,130,37,35,55,3571
"41061970600",2831,540,33,30,269,18,102,12,3835
"41061970700",1389,736,53,0,238,163,77,46,2702
"41061970800",2875,713,0,0,42,47,51,20,3748
"41063960100",1322,352,12,0,118,0,46,33,1883
"41063960200",1568,204,0,0,93,1,31,2,1899
"41063960300",2736,349,0,19,14,19,53,7,3197
"41065970100",3210,507,0,24,350,37,502,116,4746
"41065970200",2453,365,0,7,113,35,334,105,3412
"41065970300",2174,280,27,0,237,7,254,0,2979
"41065970400",1851,621,35,0,666,0,771,283,4227
"41065970500",2181,504,0,0,180,46,321,30,3262
"41065970600",1702,426,36,0,169,16,293,44,2686
"41065970700",1517,345,22,10,155,128,403,137,2717
"41065970800",2778,504,11,0,815,334,290,132,4864
"41067030101",6395,264,103,0,919,45,323,19,8068
"41067030102",4064,271,39,0,904,69,265,60,5672
"41067030200",5615,213,343,28,576,202,154,152,7283
"41067030300",4014,135,53,12,257,52,162,17,4702
"41067030401",3642,439,70,181,424,144,233,252,5385
"41067030402",3062,488,88,0,591,30,237,1,4497
"41067030501",3625,462,50,0,333,165,251,263,5149
"41067030502",3067,310,35,10,427,78,295,56,4278
"41067030600",4711,326,19,0,485,13,446,19,6019
"41067030700",936,240,22,0,234,7,212,0,1651
"41067030801",5001,374,93,104,1059,293,785,297,8006
"41067030803",4168,466,38,0,300,114,272,97,5455
"41067030805",3255,133,30,29,123,79,74,30,3753
"41067030806",1963,362,25,9,163,30,232,94,2878
"41067030900",2980,630,120,77,542,336,758,322,5765
"41067031003",5566,511,77,0,699,470,460,189,7972
"41067031004",5542,291,225,19,984,174,476,0,7711
"41067031005",3309,629,34,0,1031,498,1453,777,7731
"41067031006",4075,840,260,19,536,738,466,438,7372
"41067031100",1447,290,192,40,197,225,548,208,3147
"41067031200",4429,688,34,8,1526,1293,1324,1060,10362
"41067031300",4604,1269,30,73,1119,453,1517,961,10026
"41067031402",1206,296,56,59,734,305,227,131,3014
"41067031403",2750,362,85,0,1205,349,758,241,5750
"41067031404",3590,372,123,0,499,294,457,288,5623
"41067031504",4240,247,249,0,1243,264,560,73,6876
"41067031506",2860,344,5,33,514,106,91,35,3988
"41067031507",3803,286,145,45,1228,2,238,2,5749
"41067031508",5749,216,0,0,1363,155,215,0,7698
"41067031509",2301,228,0,0,849,125,256,90,3849
"41067031511",2043,202,42,0,709,9,340,144,3489
"41067031512",5049,206,137,12,2560,117,482,36,8599
"41067031513",5871,18,102,0,5869,138,592,2,12592
"41067031514",4143,153,226,0,2003,0,350,0,6875
"41067031606",3559,754,105,297,1610,185,1802,197,8509
"41067031609",5380,851,212,109,1834,855,1362,679,11282
"41067031610",4614,1113,216,73,1691,396,1509,645,10257
"41067031611",3675,513,89,47,3276,30,450,28,8108
"41067031612",1556,686,89,11,1144,102,557,293,4438
"41067031613",3536,901,21,142,1749,450,1209,415,8423
"41067031614",3321,482,214,0,1381,74,717,100,6289
"41067031615",3374,294,82,9,1487,277,1505,230,7258
"41067031616",2097,138,12,0,1187,33,882,90,4439
"41067031617",2449,209,71,0,1941,40,413,67,5190
"41067031703",3152,425,9,37,1127,186,1025,169,6130
"41067031704",6263,485,110,0,1779,331,1373,377,10718
"41067031705",2677,923,221,69,922,302,1022,579,6715
"41067031706",2884,734,196,0,928,659,1036,573,7010
"41067031804",3870,250,228,0,1231,345,727,305,6956
"41067031805",5613,157,77,0,1456,45,840,55,8243
"41067031806",3836,124,239,0,943,226,457,182,6007
"41067031807",2779,232,53,0,553,46,273,18,3954
"41067031812",4018,351,129,0,844,418,298,28,6086
"41067031813",3839,298,325,0,1123,61,200,134,5980
"41067031814",2756,143,100,2,794,8,271,8,4082
"41067031815",5096,356,113,0,1427,36,491,53,7572
"41067031904",2506,91,22,0,383,10,106,0,3118
"41067031907",5158,452,11,0,203,80,58,116,6078
"41067031908",5470,238,0,14,1046,601,804,3,8176
"41067031909",3629,43,9,0,946,63,98,0,4788
"41067031910",6262,556,46,0,1469,99,437,0,8869
"41067031911",3445,290,88,0,895,147,297,139,5301
"41067031912",3610,374,0,0,405,168,503,223,5283
"41067032001",4377,559,121,0,253,105,786,259,6460
"41067032003",2575,599,55,0,199,136,679,171,4414
"41067032004",1662,129,33,0,67,10,257,78,2236
"41067032005",2137,1049,10,43,389,123,735,692,5178
"41067032103",8478,678,25,0,971,202,628,120,11102
"41067032104",4358,151,0,0,260,2,242,0,5013
"41067032107",1943,35,0,0,239,21,313,3,2554
"41067032108",3587,347,195,10,368,67,403,290,5267
"41067032109",2694,89,13,0,204,0,214,29,3243
"41067032110",1781,129,0,0,154,0,63,0,2127
"41067032200",6185,295,34,0,714,132,423,100,7883
"41067032300",3513,358,119,112,693,357,512,250,5914
"41067032404",5720,539,67,39,542,217,757,286,8167
"41067032406",5709,247,61,0,1757,519,651,367,9311
"41067032407",4425,252,12,0,982,107,744,163,6685
"41067032408",3700,455,123,0,2564,258,730,130,7960
"41067032409",1721,1726,0,14,1168,712,1987,2095,9423
"41067032410",2308,500,24,0,1046,356,1316,650,6200
"41067032501",1443,488,0,49,355,293,696,243,3567
"41067032502",1798,393,70,0,482,86,214,168,3211
"41067032503",2600,324,14,23,642,238,589,425,4855
"41067032603",5665,273,13,1,1040,313,955,313,8573
"41067032604",3951,578,0,49,755,302,1284,435,7354
"41067032606",5111,860,0,0,483,51,1910,465,8880
"41067032607",2577,132,119,11,770,92,261,1,3963
"41067032608",1620,48,9,0,312,73,281,0,2343
"41067032609",1661,42,41,0,693,0,230,5,2672
"41067032610",1957,83,46,0,684,148,647,34,3599
"41067032700",4038,472,0,0,322,16,344,81,5273
"41067032800",1027,66,22,0,24,25,19,27,1210
"41067032901",3657,660,24,10,1155,168,1665,469,7808
"41067032902",5710,435,24,35,921,383,3416,393,11317
"41067033000",4386,349,0,0,417,49,433,51,5685
"41067033101",2184,617,2,0,249,12,296,86,3446
"41067033102",2165,242,0,0,353,129,779,183,3851
"41067033200",3918,499,60,0,842,822,1696,452,8289
"41067033301",4175,813,0,0,539,282,715,491,7015
"41067033302",4317,346,31,17,193,16,241,16,5177
"41067033400",1971,203,0,6,184,31,41,0,2436
"41067033500",3276,193,0,0,240,52,136,36,3933
"41067033600",1946,162,15,0,67,46,0,38,2274
"41069960100",1011,238,0,0,74,5,41,0,1369
"41071030101",4706,531,0,0,238,43,251,31,5800
"41071030102",6195,397,0,0,278,1,491,45,7407
"41071030201",3622,760,36,68,534,112,673,107,5912
"41071030202",3632,1699,0,2,1009,286,668,1002,8298
"41071030301",7759,1025,37,4,728,222,1026,438,11239
"41071030302",1870,163,0,0,70,0,33,0,2136
"41071030400",6794,378,0,0,263,11,208,0,7654
"41071030501",3733,530,11,0,109,60,127,84,4654
"41071030502",3176,702,26,0,606,74,304,12,4900
"41071030601",2366,467,0,0,332,17,823,27,4032
"41071030602",4196,1200,71,0,492,0,224,511,6694
"41071030701",5799,1036,0,25,459,273,395,692,8679
"41071030702",4628,1378,128,0,1047,570,1432,582,9765
"41071030801",3408,680,38,0,640,12,849,193,5820
"41071030802",1737,1447,32,232,413,276,818,541,5496
"41071030900",3680,583,63,0,455,144,814,338,6077
"41071031000",3263,421,0,0,355,22,435,22,4518
"42001030101",2390,79,22,0,84,14,80,14,2683
"42001030102",5330,255,0,0,191,0,182,0,5958
"42001030200",4214,477,29,0,273,168,339,199,5699
"42001030300",3583,250,43,10,203,130,280,150,4649
"42001030400",4441,771,33,0,323,115,347,235,6265
"42001030500",3082,291,20,0,214,35,394,59,4095
"42001030600",3644,339,0,2,131,327,24,302,4769
"42001030700",5587,599,46,13,68,288,298,377,7276
"42001030800",6196,374,162,10,220,60,188,115,7325
"42001030900",5874,896,89,7,428,263,484,413,8454
"42001031000",1639,184,7,1,14,0,0,0,1845
"42001031101",4380,185,0,31,187,81,174,0,5038
"42001031102",3158,30,0,0,134,7,82,7,3418
"42001031201",3392,57,21,0,109,0,67,0,3646
"42001031202",2564,120,0,0,19,0,0,0,2703
"42001031203",3123,36,0,0,0,0,47,0,3206
"42001031300",3927,357,0,0,126,0,41,24,4475
"42001031401",2934,282,262,0,185,202,67,135,4067
"42001031402",1792,157,30,0,26,0,43,4,2052
"42001031501",562,328,30,7,67,162,33,11,1200
"42001031502",2083,599,117,137,395,473,240,512,4556
"42001031600",6506,192,31,7,156,0,201,9,7102
"42001031700",2538,240,15,15,78,5,40,0,2931
"42003010300",299,185,59,27,57,3,12,12,654
"42003020100",1698,357,176,117,248,59,109,6,2770
"42003020300",527,33,52,0,77,0,5,0,694
"42003030500",105,79,1074,694,37,157,37,22,2205
"42003040200",135,203,475,338,84,82,0,0,1317
"42003040400",908,378,14,64,174,511,31,45,2125
"42003040500",570,1785,19,97,103,167,55,44,2840
"42003040600",532,1324,156,14,179,118,46,29,2398
"42003040900",1023,1157,441,33,130,207,50,27,3068
"42003050100",132,29,915,505,83,11,0,0,1675
"42003050600",227,14,1093,429,81,85,17,0,1946
"42003050900",0,28,354,741,0,46,0,0,1169
"42003051000",72,136,465,343,11,27,0,37,1091
"42003051100",0,53,136,389,0,0,0,0,578
"42003060300",1528,491,219,117,50,85,129,4,2623
"42003060500",1126,138,132,17,34,6,47,17,1517
"42003070300",1453,198,139,0,93,37,31,0,1951
"42003070500",2003,304,55,5,277,208,83,36,2971
"42003070600",1438,162,19,1,258,92,52,8,2030
"42003070800",974,174,71,12,327,167,47,13,1785
"42003070900",1837,543,59,40,1196,636,11,67,4389
"42003080200",1325,245,78,46,22,5,58,0,1779
"42003080400",844,284,21,43,109,154,19,33,1507
"42003080600",1658,171,88,27,100,11,0,0,2055
"42003080700",858,204,286,29,268,106,44,0,1795
"42003080900",1170,189,125,121,53,42,20,0,1720
"42003090100",1204,256,154,17,81,9,44,17,1782
"42003090200",2024,320,114,35,115,27,98,8,2741
"42003090300",1154,356,161,25,34,41,0,14,1785
"42003100500",441,193,1110,442,44,91,0,12,2333
"42003101100",1823,486,209,116,94,85,32,59,2904
"42003101400",2581,227,314,77,82,45,82,45,3453
"42003101600",4,6,411,528,0,0,0,6,955
"42003101700",235,86,863,274,30,6,16,0,1510
"42003101800",1950,64,621,0,9,45,0,0,2689
"42003110200",2354,115,1297,226,248,236,110,30,4616
"42003110600",1708,264,321,22,70,13,21,0,2419
"42003111300",595,199,1109,169,157,18,16,114,2377
"42003111400",135,49,548,391,72,77,12,29,1313
"42003111500",569,190,1142,734,413,58,0,28,3134
"42003120300",36,13,1032,366,42,72,10,39,1610
"42003120400",8,11,361,335,30,0,14,0,759
"42003120700",77,5,546,148,25,11,77,10,899
"42003120800",29,28,463,208,18,13,0,0,759
"42003130100",2,17,1027,719,53,20,0,17,1855
"42003130200",19,0,844,510,10,0,5,0,1388
"42003130300",31,23,729,481,8,37,31,0,1340
"42003130400",1,15,593,362,36,38,0,0,1045
"42003130600",151,44,1284,1323,23,117,0,9,2951
"42003140100",1741,297,13,70,161,134,11,45,2472
"42003140200",1702,181,37,13,191,120,100,36,2380
"42003140300",2878,283,235,1,185,39,109,17,3747
"42003140400",1963,134,32,0,221,10,74,8,2442
"42003140500",789,137,688,117,32,0,0,0,1763
"42003140600",2394,218,203,9,74,71,31,25,3025
"42003140800",3691,312,35,14,482,178,148,17,4877
"42003141000",935,49,0,0,7,18,0,0,1009
"42003141100",1120,51,47,0,68,0,38,0,1324
"42003141300",3277,687,16,1,405,479,190,79,5134
"42003141400",4160,486,105,25,498,60,198,0,5532
"42003151600",2401,56,29,0,55,62,157,0,2760
"42003151700",3909,284,165,231,224,49,214,0,5076
"42003160800",1954,405,36,40,113,195,20,26,2789
"42003160900",2221,779,59,34,138,0,103,41,3375
"42003170200",2398,900,12,0,166,19,119,0,3614
"42003170600",1279,535,13,58,5,31,12,0,1933
"42003180300",1113,325,636,369,125,56,0,0,2624
"42003180700",1317,404,248,131,71,6,12,20,2209
"42003190300",1703,115,27,54,44,0,68,26,2037
"42003191100",2051,405,6,0,93,0,0,0,2555
"42003191400",2153,269,76,114,33,0,17,0,2662
"42003191500",1274,385,219,48,34,11,170,0,2141
"42003191600",3037,571,460,216,258,39,78,216,4875
"42003191700",2801,198,178,28,352,51,76,0,3684
"42003191800",4574,407,23,32,193,28,80,1,5338
"42003191900",1421,212,282,23,80,15,0,0,2033
"42003192000",2344,535,341,53,168,59,37,160,3697
"42003202200",1374,178,511,167,159,89,61,0,2539
"42003202300",3019,125,238,0,435,127,106,0,4050
"42003210700",371,87,998,301,70,11,21,8,1867
"42003220600",873,133,270,181,34,18,54,1,1564
"42003240600",1780,250,167,54,122,28,20,0,2421
"42003241200",465,80,88,21,116,7,96,5,878
"42003250300",452,81,327,388,27,107,0,87,1469
"42003250700",105,31,371,258,5,16,0,16,802
"42003250900",323,41,603,315,6,25,0,59,1372
"42003260200",1348,121,317,146,39,0,27,0,1998
"42003260700",970,38,643,340,100,0,211,0,2302
"42003260900",38,24,217,1070,9,22,0,54,1434
"42003261200",889,72,198,9,0,0,0,0,1168
"42003261400",232,137,804,581,23,11,7,0,1795
"42003261500",365,195,622,253,54,18,11,0,1518
"42003262000",1283,190,225,522,87,74,0,87,2468
"42003270100",1890,59,307,95,66,19,14,0,2450
"42003270300",1102,256,464,156,97,13,0,0,2088
"42003270400",431,103,257,111,36,37,29,7,1011
"42003270800",1882,289,418,47,78,11,33,0,2758
"42003271500",1324,305,1092,277,76,81,98,37,3290
"42003281400",1168,171,360,480,56,53,31,0,2319
"42003281500",1167,56,134,24,43,20,19,0,1463
"42003290100",1398,276,158,113,172,0,17,18,2152
"42003290200",2869,393,73,308,125,280,0,13,4061
"42003290400",2867,417,166,151,224,55,131,8,4019
"42003300100",1222,182,1230,1177,184,167,47,102,4311
"42003310200",3031,293,0,0,141,0,28,0,3493
"42003310300",804,7,51,19,36,16,9,0,942
"42003320400",1719,201,31,52,17,0,3,6,2029
"42003320600",1807,134,32,65,87,168,18,10,2321
"42003320700",1333,188,21,17,80,0,49,0,1688
"42003401100",3915,412,93,0,174,20,0,0,4614
"42003401200",2066,804,57,69,43,67,0,0,3106
"42003401300",2419,134,29,1,99,0,44,1,2727
"42003402000",2552,329,121,0,69,93,0,0,3164
"42003403500",3291,668,323,105,62,26,0,0,4475
"42003404000",1079,169,21,4,38,12,0,10,1333
"42003405000",987,104,0,0,20,0,0,0,1111
"42003406000",2146,137,20,0,43,8,37,0,2391
"42003407001",4757,129,1,2,81,0,46,0,5016
"42003407002",6150,482,0,1,124,0,0,0,6757
"42003408001",4573,273,0,0,64,0,67,0,4977
"42003408002",5583,262,196,0,279,0,146,0,6466
"42003409000",10982,134,279,0,562,1,160,0,12118
"42003410000",1185,45,0,0,16,3,7,3,1259
"42003411000",6192,86,183,0,674,90,35,0,7260
"42003412001",6851,102,144,0,1271,20,63,0,8451
"42003412002",5022,50,29,0,380,0,41,0,5522
"42003413100",5555,202,227,15,1065,97,127,12,7300
"42003413201",3458,113,25,0,101,0,15,0,3712
"42003413202",2494,120,0,1,52,0,0,0,2667
"42003413300",4278,186,78,0,175,0,85,0,4802
"42003413400",3868,167,19,0,183,0,62,0,4299
"42003413500",4559,431,29,55,366,0,0,26,5466
"42003414101",5176,70,0,0,96,0,11,0,5353
"42003414102",6639,271,48,0,411,1,81,33,7484
"42003414200",5414,213,16,2,60,0,59,0,5764
"42003415001",3991,387,9,13,276,0,183,12,4871
"42003415002",2174,72,60,7,108,0,0,0,2421
"42003416000",1437,191,0,0,7,4,0,0,1639
"42003417100",1850,138,6,13,49,58,25,23,2162
"42003417200",1053,188,12,0,23,0,23,0,1299
"42003418000",1599,119,0,1,4,0,0,0,1723
"42003419000",2374,331,0,0,48,8,0,8,2769
"42003420000",1134,186,20,13,159,0,16,10,1538
"42003421100",3166,181,55,1,710,8,27,0,4148
"42003421200",3868,131,9,0,322,7,56,7,4400
"42003422000",4711,191,0,0,404,86,65,34,5491
"42003423000",2492,166,11,0,113,12,37,0,2831
"42003424000",2208,428,285,183,121,203,16,153,3597
"42003425000",2676,594,78,1,48,34,69,0,3500
"42003426300",5953,212,0,0,13,0,101,0,6279
"42003426400",3952,211,0,24,85,0,0,0,4272
"42003426700",1982,170,5,1,102,12,21,0,2293
"42003426800",5210,77,19,0,100,0,0,0,5406
"42003427000",2718,836,105,4,58,15,7,22,3765
"42003427100",5356,313,16,0,0,0,0,0,5685
"42003427200",4257,369,203,13,29,0,72,0,4943
"42003428100",1101,89,0,0,11,0,0,0,1201
"42003428200",1920,77,112,0,15,0,0,0,2124
"42003429100",2036,276,101,27,154,0,46,0,2640
"42003429201",3536,120,45,25,440,0,51,15,4232
"42003429202",3986,285,64,0,131,0,99,0,4565
"42003429300",4818,136,11,0,167,0,48,0,5180
"42003429400",3816,297,177,0,85,5,16,0,4396
"42003429500",3308,419,147,5,392,0,103,0,4374
"42003429600",2596,219,142,6,158,10,14,0,3145
"42003429700",2255,173,0,2,45,0,0,0,2475
"42003430100",1787,108,33,7,16,17,6,0,1974
"42003430200",4282,400,73,0,20,0,22,12,4809
"42003431100",2490,320,232,32,189,11,73,26,3373
"42003431400",1373,216,51,50,106,15,0,0,1811
"42003431500",2320,505,163,83,171,0,47,0,3289
"42003432300",1413,261,148,12,42,51,0,0,1927
"42003432400",2096,161,163,20,246,33,0,0,2719
"42003434000",1655,35,27,10,27,1,11,0,1766
"42003435000",2168,131,21,16,38,0,17,0,2391
"42003437000",4743,200,212,16,284,0,55,0,5510
"42003439000",1219,98,68,0,40,3,11,0,1439
"42003445500",3128,174,239,91,199,0,118,0,3949
"42003446000",1570,29,6,0,39,6,55,0,1705
"42003447000",1370,35,4,5,163,0,18,0,1595
"42003448000",1039,80,57,0,77,0,21,0,1274
"42003449000",2340,177,76,0,35,9,14,2,2653
"42003450700",2230,290,257,18,184,97,92,43,3211
"42003450800",1622,237,346,139,152,56,95,21,2668
"42003451101",3588,172,40,12,70,0,0,0,3882
"42003451102",3556,396,157,78,331,50,83,19,4670
"42003451104",2987,83,127,2,34,47,80,32,3392
"42003451105",3433,613,169,35,230,97,186,128,4891
"42003451300",6433,330,273,0,383,0,88,0,7507
"42003452000",4559,257,178,19,118,66,16,64,5277
"42003453003",1783,103,6,0,102,0,19,11,2024
"42003453004",5989,722,83,50,230,0,247,0,7321
"42003455000",1269,118,6,0,21,0,16,0,1430
"42003456001",3001,496,20,0,190,0,32,0,3739
"42003456003",6053,78,59,2,514,0,60,0,6766
"42003456004",3625,110,94,1,317,35,35,0,4217
"42003457100",1097,276,27,0,97,12,0,12,1521
"42003457200",3223,248,17,0,104,0,26,0,3618
"42003458000",6531,501,58,2,346,12,131,0,7581
"42003459101",1261,111,48,0,72,17,15,0,1524
"42003459102",5056,283,142,15,307,3,14,7,5827
"42003459201",5227,156,81,19,591,59,273,0,6406
"42003459202",616,36,24,5,9,0,3,0,693
"42003460001",3754,305,9,175,168,0,20,0,4431
"42003460002",3037,136,49,0,150,12,1,0,3385
"42003461000",915,122,0,4,24,23,7,8,1103
"42003462100",1736,358,65,439,129,82,0,12,2821
"42003462600",2181,274,410,336,90,170,34,22,3517
"42003463900",1689,479,252,147,54,42,72,0,2735
"42003464300",2706,328,87,85,88,10,16,0,3320
"42003464400",1627,409,604,530,163,87,1,15,3436
"42003465600",1951,98,228,17,34,6,46,0,2380
"42003465800",3153,140,158,0,118,17,11,0,3597
"42003468700",1162,312,136,8,20,101,9,0,1748
"42003468800",1545,496,116,10,133,107,24,16,2447
"42003468900",2531,518,257,414,41,53,8,0,3822
"42003469000",3998,218,90,0,225,0,0,0,4531
"42003470300",3173,271,51,0,45,33,25,0,3598
"42003470400",2760,216,39,0,35,17,57,17,3141
"42003470501",1877,72,271,0,1408,100,8,41,3777
"42003470502",2562,98,0,0,132,12,22,0,2826
"42003470600",2560,365,345,23,34,51,27,0,3405
"42003471000",1222,84,12,0,3,0,27,10,1358
"42003472100",2102,188,11,48,69,25,104,64,2611
"42003472200",2171,172,0,3,59,0,74,0,2479
"42003472300",1479,166,37,2,76,1,49,0,1810
"42003472400",1756,74,16,0,66,0,6,4,1922
"42003473100",3943,185,1,1,144,7,219,7,4507
"42003473200",2624,171,0,12,154,150,80,7,3198
"42003473300",4804,381,162,44,158,7,1,0,5557
"42003473401",3126,288,0,13,220,17,22,0,3686
"42003473402",3540,82,12,0,214,0,9,0,3857
"42003473500",3550,43,9,0,224,5,108,0,3939
"42003473601",3305,157,54,0,231,0,92,0,3839
"42003473602",3844,240,26,4,494,7,185,12,4812
"42003474101",3034,136,0,0,324,54,17,0,3565
"42003474102",3412,162,0,0,150,0,150,24,3898
"42003474201",2355,6,4,0,157,0,0,0,2522
"42003474202",4426,60,10,0,500,10,80,10,5096
"42003474203",3873,139,19,1,352,44,168,0,4596
"42003475101",3672,320,89,0,203,0,59,14,4357
"42003475102",1501,43,0,0,60,0,19,0,1623
"42003475200",4389,274,10,1,201,0,43,0,4918
"42003475301",3901,125,311,0,262,25,30,0,4654
"42003475303",3797,95,9,0,42,0,8,0,3951
"42003475304",5302,26,72,1,242,26,33,0,5702
"42003475401",3638,214,0,0,94,27,17,27,4017
"42003475402",2999,81,0,0,33,0,32,11,3156
"42003476100",3627,551,77,28,308,258,30,48,4927
"42003476200",3180,184,8,1,48,42,25,85,3573
"42003477100",3361,291,0,0,24,9,0,7,3692
"42003477200",3879,179,0,0,152,9,8,0,4227
"42003477300",3892,209,405,248,549,409,79,15,5806
"42003478100",3595,328,92,10,205,96,68,73,4467
"42003478200",4339,457,134,6,264,86,40,0,5326
"42003479000",1801,128,0,0,30,14,11,0,1984
"42003480101",3736,107,217,543,278,264,0,42,5187
"42003480102",2728,126,95,52,47,6,22,0,3076
"42003480200",3467,112,67,11,39,0,38,0,3734
"42003480300",3161,83,12,0,5,8,42,0,3311
"42003480400",4092,294,75,110,0,12,0,0,4583
"42003481000",1429,376,692,543,90,267,7,24,3428
"42003482500",1458,78,131,89,21,16,0,0,1793
"42003483800",595,199,1612,618,110,23,0,0,3157
"42003484300",2123,299,513,66,240,24,69,0,3334
"42003484500",5283,518,21,0,55,0,99,12,5988
"42003484600",1773,141,106,17,114,8,0,0,2159
"42003485000",949,189,105,13,18,4,21,0,1299
"42003486700",669,272,340,703,179,234,15,25,2437
"42003486800",400,203,712,288,70,43,9,14,1739
"42003486900",343,89,396,398,36,107,0,5,1374
"42003487000",1557,172,5,32,33,7,20,0,1826
"42003488100",1496,245,369,11,28,0,0,0,2149
"42003488200",2242,274,442,481,36,68,29,15,3587
"42003488300",2012,160,0,0,35,0,57,0,2264
"42003488400",3406,300,347,57,61,0,36,41,4248
"42003488500",2644,214,85,33,63,37,20,0,3096
"42003488600",3896,457,229,136,47,263,62,10,5100
"42003489001",3884,325,26,31,60,0,0,0,4326
"42003489002",3467,134,115,55,84,16,41,0,3912
"42003490002",4024,300,194,1,264,45,41,0,4869
"42003490003",3115,382,37,1,123,0,7,1,3666
"42003490004",4563,254,11,7,52,0,34,85,5006
"42003491101",5805,183,141,45,86,0,47,0,6307
"42003491200",1875,123,11,0,36,9,10,0,2064
"42003492700",1141,289,349,149,40,0,41,9,2018
"42003492800",690,148,913,625,67,156,19,0,2618
"42003492900",1193,240,343,234,151,0,117,8,2286
"42003494000",1093,225,16,0,52,7,36,0,1429
"42003495000",2922,270,136,1,40,0,40,72,3481
"42003496101",2853,160,0,0,25,0,0,0,3038
"42003496102",3996,297,42,0,109,0,7,25,4476
"42003496200",5186,488,0,77,18,0,26,0,5795
"42003497000",867,88,6,2,36,1,60,0,1060
"42003498000",2184,215,55,0,40,0,18,0,2512
"42003499300",1460,178,0,14,0,0,0,0,1652
"42003499400",2254,368,21,30,122,27,20,0,2842
"42003500300",3284,383,0,0,113,4,0,21,3805
"42003501000",1243,244,56,27,32,18,5,0,1625
"42003503002",5466,148,215,37,14,0,13,0,5893
"42003504100",3145,488,673,1046,118,68,26,0,5564
"42003507000",1771,212,65,41,129,15,26,0,2259
"42003508000",886,327,289,104,16,68,11,13,1714
"42003509400",3068,1050,874,128,49,15,113,30,5327
"42003510000",704,146,572,348,67,73,0,35,1945
"42003512000",1780,164,243,87,115,57,0,0,2446
"42003512800",399,103,287,355,29,124,0,7,1304
"42003512900",168,81,628,165,0,7,0,38,1087
"42003513800",426,139,761,504,27,50,9,11,1927
"42003514000",398,125,776,756,7,80,5,68,2215
"42003515100",871,132,1051,352,20,0,0,0,2426
"42003515200",1361,129,522,94,132,0,72,10,2320
"42003515300",898,140,431,184,120,95,51,13,1932
"42003515401",1600,264,273,152,118,9,67,0,2483
"42003516100",1169,54,31,54,29,28,31,0,1396
"42003516200",1357,108,135,28,81,25,79,0,1813
"42003517000",995,198,358,115,11,36,3,0,1716
"42003518001",2739,155,446,0,118,0,15,50,3523
"42003519000",2205,90,326,1,246,0,46,0,2914
"42003520001",2186,329,638,20,80,28,0,20,3301
"42003520002",2224,262,360,131,90,0,68,0,3135
"42003521100",3293,184,828,120,241,39,24,44,4773
"42003521200",3367,118,385,256,281,46,11,0,4464
"42003521301",2308,289,767,97,404,82,15,0,3962
"42003521302",2700,231,433,10,547,17,40,15,3993
"42003521401",2157,146,98,39,168,0,160,19,2787
"42003521402",3146,214,205,0,478,0,23,0,4066
"42003521500",3700,244,117,0,106,141,29,9,4346
"42003522000",2111,484,499,26,131,32,29,35,3347
"42003523100",335,132,2869,539,186,9,20,8,4098
"42003523200",1250,125,1797,754,104,95,17,0,4142
"42003523300",2231,212,1122,196,95,9,105,14,3984
"42003523400",2900,142,1308,518,207,2,50,0,5127
"42003523501",2126,63,2033,375,142,0,30,0,4769
"42003523502",952,71,227,110,156,0,14,0,1530
"42003523600",3055,139,1408,140,171,0,181,0,5094
"42003523701",3219,268,488,142,103,33,10,18,4281
"42003523702",3066,324,1039,138,277,22,91,8,4965
"42003523800",3715,138,499,13,184,1,39,0,4589
"42003524000",1822,401,116,104,27,31,53,20,2574
"42003525100",1934,65,6,0,41,0,25,0,2071
"42003525200",1765,176,10,1,0,0,15,0,1967
"42003525300",1980,122,0,0,49,14,72,0,2237
"42003526101",6343,249,178,16,195,1,140,0,7122
"42003526102",2018,127,0,0,0,0,13,0,2158
"42003526201",3357,146,135,0,42,4,63,0,3747
"42003526202",4093,255,110,78,220,24,127,36,4943
"42003526301",4150,184,62,19,53,0,19,0,4487
"42003526302",4752,137,172,18,92,0,20,0,5191
"42003550900",606,232,532,216,77,68,20,6,1757
"42003551200",1628,477,375,675,48,176,49,36,3464
"42003551300",2255,330,0,49,63,0,90,0,2787
"42003551900",398,391,199,376,239,91,20,3,1717
"42003552000",1178,257,533,306,296,72,123,164,2929
"42003552100",50,113,216,527,0,0,0,0,906
"42003552200",726,175,59,31,12,6,6,9,1024
"42003552300",509,259,725,421,43,115,69,86,2227
"42003552400",1946,444,162,235,46,0,11,0,2844
"42003560400",300,145,806,219,52,72,28,0,1622
"42003560500",1723,155,249,46,110,0,20,0,2303
"42003560600",166,33,400,129,163,0,6,0,897
"42003561000",228,25,850,258,32,54,26,0,1473
"42003561100",14,7,452,249,13,49,0,4,788
"42003561200",66,16,583,470,98,12,39,11,1295
"42003561400",1002,10,2301,627,152,39,47,29,4207
"42003561500",891,60,1577,579,131,106,0,0,3344
"42003561600",1146,389,451,232,52,0,75,0,2345
"42003561700",374,29,251,154,7,14,10,0,839
"42003561900",38,69,1621,493,136,39,0,0,2396
"42003562000",1063,802,152,209,584,313,119,117,3359
"42003562300",889,310,1107,942,81,66,18,25,3438
"42003562400",762,163,1110,448,151,83,54,0,2771
"42003562500",978,247,922,411,123,98,72,0,2851
"42003562600",1602,434,244,154,160,133,14,38,2779
"42003562700",681,185,101,281,118,95,8,0,1469
"42003562800",1185,222,110,32,40,23,6,3,1621
"42003562900",1109,155,274,117,65,32,5,0,1757
"42003563000",1606,244,1018,179,121,71,52,8,3299
"42003563100",2807,287,129,6,286,312,34,24,3885
"42003563200",1241,270,303,452,92,59,21,0,2438
"42003563300",1291,38,19,0,43,0,70,0,1461
"42003563800",3203,150,28,9,100,10,19,6,3525
"42003563900",3185,225,364,139,80,0,28,9,4030
"42003564000",4782,365,92,0,224,0,23,0,5486
"42003564100",948,13,4,0,18,0,6,0,989
"42003564200",2060,160,12,0,59,0,18,0,2309
"42003564400",4501,478,249,63,58,5,28,3,5385
"42003564500",2839,235,14,29,55,14,23,32,3241
"42003980000",133,0,16,0,15,0,6,0,170
"42003980100",13,13,0,0,0,0,0,0,26
"42003980300",0,0,0,0,0,0,0,0,0
"42003980400",0,0,0,0,0,0,0,0,0
"42003980500",4,0,0,0,0,0,0,0,4
"42003980600",0,0,0,0,0,0,0,0,0
"42003980700",12,0,0,0,0,0,0,0,12
"42003980800",0,0,0,0,0,0,0,0,0
"42003980900",0,0,0,0,0,0,0,0,0
"42003981000",0,0,0,0,0,0,0,0,0
"42003981100",4,0,0,0,0,0,0,0,4
"42003981200",0,0,0,0,0,0,0,0,0
"42003981800",30,10,10,39,0,26,7,21,143
"42003982200",40,101,0,4,0,9,0,0,154
"42005950100",3698,840,11,0,63,26,10,5,4653
"42005950200",1944,259,5,0,19,4,26,3,2260
"42005950300",2915,428,25,15,28,8,14,11,3444
"42005950400",2168,262,0,0,29,0,0,0,2459
"42005950500",5196,388,10,0,27,3,0,0,5624
"42005950600",2720,301,17,0,25,14,9,0,3086
"42005950700",3402,381,0,0,24,16,16,0,3839
"42005950800",3557,468,14,0,29,17,11,0,4096
"42005950900",4402,636,41,0,5,6,6,0,5096
"42005951000",2039,607,108,9,20,162,0,162,3107
"42005951100",2809,915,0,15,65,27,0,0,3831
"42005951200",5418,444,3,0,7,1,10,0,5883
"42005951300",2204,226,3,0,29,8,4,4,2478
"42005951400",2236,299,122,29,10,8,18,1,2723
"42005951500",2382,478,37,8,30,6,1,3,2945
"42005951600",4122,520,0,61,6,0,24,0,4733
"42005951700",3178,470,8,3,34,2,53,0,3748
"42005951800",1610,445,31,1,46,0,0,0,2133
"42005951900",1607,153,0,0,22,3,19,0,1804
"42007600601",1868,317,4,4,15,5,24,0,2237
"42007600602",2436,72,14,0,35,0,46,0,2603
"42007600700",6933,615,0,9,162,0,85,0,7804
"42007601000",3338,171,24,1,108,0,12,0,3654
"42007601100",1564,605,63,66,106,86,0,16,2506
"42007601200",1491,576,562,191,38,129,9,0,2996
"42007601300",1245,607,243,72,36,75,86,5,2369
"42007601400",2546,284,119,32,193,41,51,9,3275
"42007601600",1015,215,57,7,46,7,27,1,1375
"42007601700",2930,396,3,0,68,0,1,0,3398
"42007601800",6477,772,64,0,94,0,0,0,7407
"42007602100",2373,475,383,188,25,47,37,15,3543
"42007602300",2138,183,9,4,40,44,0,32,2450
"42007602400",1821,53,39,0,21,0,48,0,1982
"42007602500",1256,133,32,5,4,0,16,0,1446
"42007602601",4677,102,48,3,89,0,74,0,4993
"42007602602",2990,87,19,7,11,0,9,0,3123
"42007602701",1713,170,8,0,20,0,42,0,1953
"42007602702",3086,317,47,0,58,17,0,0,3525
"42007602800",1252,509,203,427,125,88,96,0,2700
"42007602900",2313,349,38,2,134,8,48,8,2900
"42007603000",2921,93,0,0,29,0,0,5,3048
"42007603202",6262,529,211,9,141,0,160,0,7312
"42007603300",3160,363,0,73,48,119,8,9,3780
"42007603400",1701,219,10,7,4,0,0,0,1941
"42007603500",1119,298,22,81,80,11,26,12,1649
"42007603600",1903,165,22,0,76,0,18,0,2184
"42007603700",3298,359,69,70,168,0,0,0,3964
"42007603801",2755,76,18,0,106,0,102,0,3057
"42007603802",2807,83,42,0,47,0,30,0,3009
"42007603803",2803,309,59,0,28,0,54,0,3253
"42007603900",2812,300,57,0,0,0,24,0,3193
"42007604000",1225,503,252,225,318,14,93,34,2664
"42007604100",1690,237,157,435,179,164,88,29,2979
"42007604200",887,344,189,34,57,52,35,15,1613
"42007604500",213,39,1297,588,44,0,0,0,2181
"42007604600",2144,181,280,318,86,29,9,6,3053
"42007604700",1004,176,191,46,97,8,8,0,1530
"42007604800",3764,365,54,0,30,0,68,0,4281
"42007604901",3347,230,88,9,115,21,179,0,3989
"42007604902",4355,202,34,0,27,0,57,0,4675
"42007605001",2240,180,14,17,26,0,16,0,2493
"42007605002",3508,152,24,1,97,7,76,0,3865
"42007605100",4620,257,15,1,42,16,2,0,4953
"42007605200",2026,378,101,10,64,40,19,22,2660
"42007605300",2793,286,23,34,40,0,32,0,3208
"42007605400",2298,609,265,184,138,56,54,8,3612
"42007605500",4392,356,171,78,60,13,15,0,5085
"42007605600",2951,257,67,22,45,0,26,3,3371
"42007605700",1038,404,713,245,49,61,35,35,2580
"42007605800",5342,544,42,0,107,53,2,1,6091
"42009960100",3203,418,0,3,53,1,23,0,3701
"42009960200",3046,472,6,0,34,0,10,0,3568
"42009960300",4351,629,42,37,62,12,0,0,5133
"42009960400",4453,760,17,0,23,14,6,51,5324
"42009960500",2945,602,20,0,65,13,40,13,3698
"42009960600",3990,1029,30,24,12,7,7,15,5114
"42009960700",2488,268,0,0,48,0,48,3,2855
"42009960800",4059,735,0,0,47,60,19,4,4924
"42009960900",4068,470,22,2,25,36,65,0,4688
"42009961000",5121,461,3,3,70,0,58,9,5725
"42009961100",3654,515,0,0,48,4,22,0,4243
"42011000100",1212,1062,285,452,1072,1145,1628,1463,8319
"42011000200",1613,803,267,61,358,966,1150,1530,6748
"42011000300",819,300,225,6,483,299,668,504,3304
"42011000400",1289,693,380,201,665,844,1175,1420,6667
"42011000500",1869,419,307,75,381,372,1210,673,5306
"42011000600",1567,134,190,25,264,183,512,228,3103
"42011000700",1695,360,52,52,1334,672,1784,889,6838
"42011000800",1380,496,532,371,598,903,1683,1341,7304
"42011000900",1084,338,255,15,526,213,863,369,3663
"42011001000",697,687,327,179,797,582,1209,1275,5753
"42011001100",766,1262,483,183,624,985,1139,2087,7529
"42011001200",219,285,281,261,373,427,632,648,3126
"42011001300",743,464,354,206,674,683,1088,1060,5272
"42011001400",1366,889,119,148,775,846,1437,1492,7072
"42011001500",1019,626,248,183,920,478,1518,969,5961
"42011001600",940,568,20,103,651,406,1096,808,4592
"42011001700",882,513,158,110,749,708,1327,1001,5448
"42011001800",1491,564,199,68,332,177,484,422,3737
"42011001900",759,815,213,220,504,402,778,693,4384
"42011002000",1364,1177,251,122,675,441,772,1131,5933
"42011002100",950,756,236,135,257,462,620,842,4258
"42011002200",494,370,119,58,433,377,778,689,3318
"42011002300",568,518,73,111,714,92,1048,478,3602
"42011002500",1150,698,310,186,532,651,1338,1206,6071
"42011002600",758,932,171,317,301,839,749,1576,5643
"42011002700",1409,170,71,12,277,4,318,52,2313
"42011002900",1283,217,238,100,281,48,468,65,2700
"42011010100",5280,463,110,0,59,24,17,35,5988
"42011010201",4178,203,0,0,19,0,104,52,4556
"42011010202",4181,327,0,280,147,5,143,53,5136
"42011010302",2597,197,6,27,57,5,96,30,3015
"42011010303",1925,79,70,0,57,0,128,31,2290
"42011010304",4287,218,0,0,39,18,178,0,4740
"42011010400",6818,839,71,25,135,28,217,77,8210
"42011010500",5250,401,225,59,561,0,256,26,6778
"42011010600",6932,509,160,0,375,70,313,67,8426
"42011010700",5997,362,185,64,316,177,257,200,7558
"42011010801",1559,111,0,0,46,36,46,83,1881
"42011010802",7711,245,557,132,359,79,506,155,9744
"42011010902",2947,344,319,17,332,55,439,129,4582
"42011010903",4672,264,84,0,263,0,111,157,5551
"42011010904",3382,109,177,10,229,98,176,0,4181
"42011010905",4013,147,73,0,232,9,550,27,5051
"42011011000",3997,142,129,0,280,110,559,65,5282
"42011011101",1493,231,71,0,132,0,177,9,2113
"42011011102",4936,102,36,1,309,0,116,0,5500
"42011011200",2614,357,395,32,336,10,679,31,4454
"42011011300",2088,281,156,30,228,33,229,36,3081
"42011011400",4385,271,256,36,157,91,598,112,5906
"42011011500",2642,170,55,16,74,75,89,92,3213
"42011011601",4074,303,107,0,557,16,669,21,5747
"42011011602",3259,224,48,5,459,109,276,91,4471
"42011011603",5142,272,145,12,259,0,384,12,6226
"42011011701",6816,250,2,1,228,0,161,0,7458
"42011011702",4027,153,8,0,321,15,42,11,4577
"42011011703",3655,125,24,0,226,0,17,0,4047
"42011011800",4389,438,76,0,196,59,100,0,5258
"42011011902",3257,48,129,53,22,0,100,1,3610
"42011011903",4413,59,132,0,343,0,172,0,5119
"42011011904",6370,547,470,0,142,107,98,0,7734
"42011012001",2080,181,52,0,109,0,92,0,2514
"42011012002",7338,389,416,142,635,0,347,0,9267
"42011012101",1549,138,22,0,116,38,143,63,2069
"42011012103",1954,139,14,0,208,4,15,0,2334
"42011012104",2902,304,126,1,53,47,45,0,3478
"42011012105",7577,63,515,1,99,0,235,0,8490
"42011012200",2632,303,15,15,109,111,423,64,3672
"42011012300",3212,677,93,74,363,17,257,259,4952
"42011012400",5032,470,120,36,561,17,1462,37,7735
"42011012500",1594,48,21,0,248,78,364,87,2440
"42011012600",1588,364,57,0,401,29,557,170,3166
"42011012700",7299,214,264,1,845,146,765,70,9604
"42011012800",3077,464,35,0,261,57,524,130,4548
"42011012900",6968,271,55,0,78,0,52,23,7447
"42011013000",5985,411,111,0,82,11,18,6,6624
"42011013100",4823,219,0,0,38,0,55,12,5147
"42011013200",3577,307,12,31,88,8,82,26,4131
"42011013301",2650,116,0,0,163,0,172,10,3111
"42011013302",5154,519,5,126,166,0,85,8,6063
"42011013401",7417,324,59,0,101,0,150,0,8051
"42011013402",2957,235,24,0,39,0,23,6,3284
"42011013500",9857,431,173,38,429,102,583,81,11694
"42011013600",3704,132,40,14,90,97,274,118,4469
"42011013701",2829,502,22,27,27,11,38,0,3456
"42011013702",3532,350,0,0,43,35,80,59,4099
"42011013800",3827,364,16,1,12,23,83,61,4387
"42011013900",7290,446,40,5,67,6,73,81,8008
"42011014000",3309,1008,62,44,358,93,332,128,5334
"42011014100",3463,511,0,97,64,2,35,17,4189
"42011014200",6908,653,51,0,89,0,152,8,7861
"42013010101",3748,253,11,5,22,0,24,0,4063
"42013010102",2134,680,0,0,3,10,34,0,2861
"42013010103",2137,280,0,0,0,0,91,0,2508
"42013010401",1577,195,0,3,18,0,33,0,1826
"42013010402",5570,527,132,0,101,0,0,0,6330
"42013010500",3253,214,0,0,63,0,0,1,3531
"42013010600",2501,81,0,0,81,0,0,0,2663
"42013010700",5027,1317,35,98,22,0,60,63,6622
"42013010800",3196,533,14,22,28,6,33,6,3838
"42013010900",6747,336,0,0,144,0,58,0,7285
"42013011001",3401,265,0,0,99,5,0,0,3770
"42013011002",3388,416,0,10,16,6,0,0,3836
"42013011100",5170,559,91,0,201,111,47,0,6179
"42013011200",4866,520,1,11,75,0,219,41,5733
"42013011300",5160,484,32,0,4,3,0,0,5683
"42013011400",2247,215,1,18,76,6,1,7,2571
"42013011500",5045,558,44,0,55,0,74,8,5784
"42013011600",3191,838,36,10,21,0,0,9,4105
"42013100200",1937,214,8,0,0,0,8,0,2167
"42013100300",2061,732,4,0,53,0,31,0,2881
"42013100400",1466,222,52,48,6,37,10,12,1853
"42013100500",2558,632,149,133,59,120,0,39,3690
"42013100600",2261,258,8,17,39,0,4,0,2587
"42013100700",1340,796,23,206,9,86,11,21,2492
"42013100800",1074,168,14,40,0,3,0,3,1302
"42013100900",3709,480,0,15,64,6,79,6,4359
"42013101100",1222,149,152,0,18,42,13,0,1596
"42013101200",3417,257,0,2,151,7,115,15,3964
"42013101400",2927,772,37,21,47,10,0,0,3814
"42013101500",2844,150,37,0,97,24,0,0,3152
"42013101600",2036,1351,7,8,182,25,8,0,3617
"42013101700",2652,689,101,166,184,53,33,0,3878
"42013101800",2395,311,0,0,0,0,0,0,2706
"42013101900",661,634,0,46,97,67,0,13,1518
"42015950100",3392,740,0,2,52,34,50,0,4270
"42015950200",4605,312,8,0,118,10,38,0,5091
"42015950300",4851,495,15,0,53,16,23,0,5453
"42015950400",2295,790,0,0,38,22,74,6,3225
"42015950500",5368,828,80,0,105,7,0,0,6388
"42015950600",3268,562,0,0,44,3,31,4,3912
"42015950700",3905,786,6,23,65,57,43,0,4885
"42015950800",3529,310,15,0,58,16,30,17,3975
"42015950900",4611,487,15,8,139,0,128,4,5392
"42015951000",2268,411,0,0,141,9,113,0,2942
"42015951100",2544,181,8,5,65,0,72,4,2879
"42015951200",4369,737,6,3,76,23,64,33,5311
"42015951300",3760,407,7,35,43,6,73,2,4333
"42015951400",3412,781,11,0,37,0,14,2,4257
"42017100102",1936,166,83,0,509,12,203,12,2921
"42017100103",2026,74,141,40,58,0,160,0,2499
"42017100104",2486,383,280,99,1000,16,227,179,4670
"42017100105",3075,263,32,0,63,0,70,50,3553
"42017100201",2937,389,805,1,268,24,125,24,4573
"42017100206",3624,120,182,84,944,40,344,49,5387
"42017100207",2847,395,343,262,643,19,179,6,4694
"42017100208",4379,381,449,107,438,149,1152,320,7375
"42017100209",5117,260,715,55,2698,27,464,27,9363
"42017100210",5652,517,130,132,1125,0,176,18,7750
"42017100211",6105,114,333,11,507,0,101,0,7171
"42017100212",3527,117,62,2,419,1,198,0,4326
"42017100302",4657,202,65,0,171,157,235,77,5564
"42017100303",2828,162,925,612,376,120,764,168,5955
"42017100304",1217,319,412,114,175,0,71,60,2368
"42017100306",2211,48,694,98,346,13,237,0,3647
"42017100307",3462,428,450,47,441,0,449,0,5277
"42017100401",4890,567,269,82,445,0,563,0,6816
"42017100402",5671,629,416,44,372,16,403,81,7632
"42017100403",937,183,832,284,18,0,41,106,2401
"42017100404",5161,187,200,49,144,74,316,74,6205
"42017100406",3195,100,38,102,395,0,75,0,3905
"42017100407",1055,114,0,0,63,1,62,1,1296
"42017100408",5951,221,224,0,375,10,296,0,7077
"42017100500",2334,472,24,12,30,0,133,20,3025
"42017100600",2448,250,515,147,132,30,451,86,4059
"42017100700",2107,215,381,233,177,142,688,66,4009
"42017100803",3886,589,376,0,211,10,318,278,5668
"42017100804",3592,56,63,53,92,0,195,0,4051
"42017100805",5153,178,56,115,116,0,198,0,5816
"42017100807",3392,261,261,19,147,0,137,36,4253
"42017100808",4628,125,105,0,86,6,323,0,5273
"42017100809",5196,27,245,0,277,0,262,0,6007
"42017100811",2949,318,521,72,639,18,170,28,4715
"42017100900",6561,209,215,5,529,65,89,0,7673
"42017101100",1621,195,262,133,144,44,251,46,2696
"42017101401",3796,145,12,0,287,0,54,29,4323
"42017101403",5474,68,0,0,176,0,38,0,5756
"42017101404",2020,48,87,0,118,5,29,0,2307
"42017101405",5931,407,112,4,213,51,215,33,6966
"42017101503",3354,216,4,0,274,11,264,0,4123
"42017101504",2512,93,35,3,83,0,39,0,2765
"42017101505",2967,78,11,0,161,25,27,0,3269
"42017101506",4842,193,0,2,139,2,120,0,5298
"42017101603",2634,578,4,0,74,46,160,274,3770
"42017101605",2570,467,220,113,611,354,1101,322,5758
"42017101607",2754,116,0,0,34,0,163,0,3067
"42017101609",3918,197,30,0,241,31,176,31,4624
"42017101610",4379,218,29,0,71,16,51,66,4830
"42017101611",6326,69,38,2,213,40,206,14,6908
"42017101802",5215,341,86,13,1060,41,55,42,6853
"42017101803",6861,468,41,0,674,10,62,0,8116
"42017101805",2144,54,0,0,16,0,17,0,2231
"42017101807",2933,452,317,0,154,102,255,270,4483
"42017101808",1946,178,85,0,282,0,102,0,2593
"42017101900",3752,116,70,5,101,0,96,0,4140
"42017102002",2393,156,48,0,100,10,29,4,2740
"42017102003",3542,87,49,0,193,0,58,0,3929
"42017102004",4151,89,23,0,235,0,30,0,4528
"42017102102",3283,114,0,0,27,21,0,0,3445
"42017102104",4975,214,44,43,266,18,230,60,5850
"42017102300",5402,213,26,2,71,2,41,0,5757
"42017102401",3504,145,59,35,14,0,63,0,3820
"42017102402",4313,328,16,0,35,40,160,7,4899
"42017102500",3639,379,23,0,214,0,32,20,4307
"42017102600",1680,114,0,90,236,0,179,0,2299
"42017102700",4448,336,140,60,117,0,35,30,5166
"42017102801",3109,167,122,0,70,0,0,0,3468
"42017103101",2083,469,0,26,0,10,55,0,2643
"42017103102",1618,175,11,0,77,0,159,4,2044
"42017103103",3686,386,91,11,97,0,90,109,4470
"42017103300",1916,68,0,0,15,0,26,0,2025
"42017103400",4554,326,0,13,101,0,0,66,5060
"42017103700",3179,200,16,0,23,0,17,0,3435
"42017103800",1140,110,8,4,24,0,37,0,1323
"42017103900",3444,446,0,0,64,0,50,14,4018
"42017104000",6255,286,0,0,208,45,15,73,6882
"42017104100",1847,150,8,0,110,26,279,64,2484
"42017104201",2502,35,81,0,210,0,144,0,2972
"42017104203",5077,345,0,0,69,0,224,123,5838
"42017104204",4104,102,38,0,142,0,11,0,4397
"42017104301",2473,152,12,0,49,0,195,0,2881
"42017104303",4218,119,24,0,305,18,154,0,4838
"42017104304",1209,53,0,0,26,0,0,0,1288
"42017104400",2280,94,15,1,136,0,86,0,2612
"42017104502",6654,241,12,0,427,0,80,0,7414
"42017104503",3783,229,12,15,230,55,216,19,4559
"42017104505",5060,461,0,0,592,66,80,95,6354
"42017104506",1958,143,0,0,171,6,62,0,2340
"42017104601",4217,85,0,0,90,0,133,0,4525
"42017104603",4839,155,0,0,119,1,70,1,5185
"42017104604",5254,133,61,2,160,0,43,7,5660
"42017104701",2928,217,58,20,83,20,30,0,3356
"42017104702",2139,116,77,0,13,20,36,19,2420
"42017104703",2024,80,12,0,107,0,68,0,2291
"42017104800",2070,139,5,2,86,0,33,29,2364
"42017104901",6826,258,2,0,496,0,38,1,7621
"42017104902",6321,241,16,0,419,0,222,0,7219
"42017105003",4622,63,0,0,231,14,91,0,5021
"42017105004",4954,72,26,0,319,16,22,16,5425
"42017105006",5395,164,0,1,351,1,182,0,6094
"42017105008",3155,18,0,0,405,10,129,0,3717
"42017105009",2923,216,43,0,73,0,11,0,3266
"42017105010",3849,22,42,0,157,0,41,0,4111
"42017105011",3019,139,0,0,325,0,74,0,3557
"42017105012",2824,51,8,0,104,0,54,0,3041
"42017105013",5389,26,66,0,409,0,46,0,5936
"42017105100",2803,37,8,2,194,0,1,0,3045
"42017105202",4455,280,0,0,365,0,222,13,5335
"42017105203",1706,55,9,0,200,0,62,0,2032
"42017105206",4008,217,8,0,532,0,19,0,4784
"42017105207",4238,86,20,0,557,7,136,0,5044
"42017105208",1846,39,32,0,648,0,137,0,2702
"42017105300",2152,41,8,0,18,0,0,0,2219
"42017105400",7208,291,67,0,545,111,283,26,8531
"42017105505",3642,21,84,1,199,0,41,0,3988
"42017105506",3333,121,55,16,607,0,55,0,4187
"42017105507",6687,149,95,0,295,0,118,0,7344
"42017105508",3249,66,33,0,326,0,67,0,3741
"42017105509",4153,85,66,0,318,0,91,0,4713
"42017105510",3619,124,118,16,701,63,116,0,4757
"42017105511",3485,137,172,0,425,23,30,0,4272
"42017105600",2036,70,79,20,119,0,92,0,2416
"42017105702",2105,99,219,29,205,27,247,27,2958
"42017105704",4364,139,1289,142,627,59,848,0,7468
"42017105801",4307,170,760,103,973,81,403,176,6973
"42017105805",4388,404,335,17,282,52,353,0,5831
"42017105807",2673,312,254,61,494,0,224,0,4018
"42017105808",3032,292,72,53,220,0,115,0,3784
"42017105809",3883,281,11,0,259,0,136,0,4570
"42017105810",2069,125,6,0,16,6,110,11,2343
"42017105811",5195,292,84,11,145,18,139,0,5884
"42017105812",1534,67,0,7,45,5,63,5,1726
"42017105900",1493,188,19,2,58,13,18,2,1793
"42017106000",3742,209,207,2,127,42,144,2,4475
"42017106100",2006,130,27,29,70,17,7,10,2296
"42017106200",5711,218,23,0,832,10,577,15,7386
"42017106300",6100,410,175,13,331,12,383,42,7466
"42017106401",6283,421,51,0,909,72,549,51,8336
"42017106402",6783,336,44,182,77,0,219,124,7765
"42017106500",5740,431,160,4,99,0,369,18,6821
"42017106600",1784,119,0,3,71,12,18,9,2016
"42017980000",0,0,0,0,0,0,0,0,0
"42019902100",2052,208,0,0,36,0,12,0,2308
"42019902200",1337,354,137,11,8,11,0,11,1869
"42019902300",1901,1041,62,77,0,48,16,75,3220
"42019902400",1293,679,0,59,10,0,50,18,2109
"42019902500",2499,1070,15,55,113,54,60,0,3866
"42019902600",2382,220,87,0,87,0,8,13,2797
"42019902700",1749,345,25,0,23,7,16,0,2165
"42019902800",2457,187,45,10,68,30,0,24,2821
"42019902900",1844,35,0,0,28,23,16,0,1946
"42019903000",4228,143,12,0,47,5,108,0,4543
"42019903100",2352,337,27,0,6,50,0,0,2772
"42019910100",3686,631,17,10,14,24,1,0,4383
"42019910200",4301,569,8,0,61,22,46,2,5009
"42019910301",3291,1365,11,113,59,2,44,29,4914
"42019910302",3407,412,62,0,71,23,83,10,4068
"42019910400",1484,847,38,18,202,89,0,3,2681
"42019910500",8,0,0,0,0,0,0,0,8
"42019910600",3927,437,3,0,37,0,43,11,4458
"42019910700",2718,141,23,0,76,10,0,0,2968
"42019910800",2440,201,10,0,48,0,15,0,2714
"42019910900",4658,325,51,0,70,0,25,0,5129
"42019911000",5775,527,0,0,97,14,104,24,6541
"42019911100",4248,335,44,0,99,0,67,113,4906
"42019911200",4548,677,14,0,5,0,5,0,5249
"42019911300",4789,585,6,0,14,18,58,5,5475
"42019911400",3107,302,0,0,33,0,0,0,3442
"42019911501",5058,183,0,0,31,0,24,0,5296
"42019911502",3908,286,0,0,54,4,56,0,4308
"42019911600",4606,329,0,0,79,13,41,13,5081
"42019911700",3969,280,12,0,45,0,0,0,4306
"42019911800",5791,243,20,0,19,2,2,0,6077
"42019911900",4257,257,0,0,62,1,18,0,4595
"42019912001",4643,96,78,0,177,17,0,0,5011
"42019912002",3838,50,99,0,241,12,26,12,4278
"42019912101",4129,49,12,0,13,0,20,0,4223
"42019912102",2292,176,10,0,143,140,0,0,2761
"42019912200",2825,34,113,0,213,0,121,0,3306
"42019912301",5773,0,0,0,244,10,116,0,6143
"42019912303",2647,27,59,0,157,2,38,0,2930
"42019912304",3302,64,0,0,25,0,0,0,3391
"42019912401",7603,187,0,0,477,0,152,30,8449
"42019912402",5787,334,21,0,249,0,86,0,6477
"42019912700",6895,296,30,0,42,0,154,59,7476
"42019912800",5232,196,2,6,0,0,57,0,5493
"42021000100",597,349,51,107,0,35,0,51,1190
"42021000200",435,133,94,77,34,40,3,8,824
"42021000300",916,328,144,241,40,215,0,129,2013
"42021000500",1099,280,69,192,37,60,8,5,1750
"42021000600",1035,478,46,50,44,104,0,24,1781
"42021000700",1887,284,44,35,63,103,20,21,2457
"42021001200",2262,829,175,77,32,79,1,61,3516
"42021010100",3782,278,28,8,53,12,53,8,4222
"42021010200",1120,260,50,2,10,0,2,0,1444
"42021010300",2058,259,44,0,25,4,11,3,2404
"42021010500",3058,410,39,0,152,3,0,0,3662
"42021010600",2185,161,3,22,31,24,17,0,2443
"42021010700",2594,269,24,13,10,0,9,0,2919
"42021010801",4590,604,0,9,189,176,62,180,5810
"42021011000",1207,298,22,0,28,0,40,8,1603
"42021011100",4736,108,11,1,63,11,9,0,4939
"42021011200",1986,127,14,0,115,0,23,6,2271
"42021011300",4373,402,104,0,68,45,50,44,5086
"42021011400",2931,374,9,3,44,0,6,18,3385
"42021011500",4046,249,0,1,0,7,9,10,4322
"42021011600",2248,408,0,0,15,0,4,0,2675
"42021011700",2165,326,1,0,0,0,25,0,2517
"42021011800",3240,512,0,1,22,3,2,0,3780
"42021011900",3224,530,0,0,0,0,0,0,3754
"42021012000",5272,573,9,16,46,0,30,10,5956
"42021012100",2110,404,3,0,13,10,17,4,2561
"42021012200",3150,535,1,9,24,15,26,16,3776
"42021012300",1635,261,2,0,41,13,0,19,1971
"42021012400",3201,322,6,7,16,9,20,34,3615
"42021012500",4773,379,70,16,61,17,7,0,5323
"42021012600",2934,355,0,0,0,0,32,0,3321
"42021012700",2382,215,0,0,23,0,8,17,2645
"42021012800",3431,629,9,0,82,18,16,0,4185
"42021012900",2896,562,0,0,17,0,35,6,3516
"42021013000",2099,438,23,0,30,0,6,0,2596
"42021013100",2389,281,0,0,5,0,5,0,2680
"42021013200",3468,378,0,0,20,0,8,20,3894
"42021013300",5078,675,0,0,7,99,10,99,5968
"42021013400",1192,480,261,234,116,59,17,10,2369
"42021013500",1323,724,62,148,66,193,6,106,2628
"42021013600",2020,614,114,499,68,221,14,19,3569
"42021013700",2567,395,0,13,49,14,98,6,3142
"42023960100",1467,338,2,16,5,1,13,5,1847
"42023960200",2718,263,0,2,51,3,7,5,3049
"42025020102",3739,801,80,0,53,19,76,70,4838
"42025020103",3622,547,0,0,139,6,207,0,4521
"42025020105",4479,256,216,0,376,0,494,0,5821
"42025020106",1798,97,0,0,10,38,101,0,2044
"42025020200",5286,647,27,8,78,52,54,40,6192
"42025020300",5058,940,0,25,68,35,207,152,6485
"42025020400",2934,567,70,59,124,83,154,95,4086
"42025020500",6098,577,5,94,136,0,55,13,6978
"42025020600",4720,467,0,0,139,0,65,0,5391
"42025020700",4648,377,117,9,34,44,103,44,5376
"42025020800",7939,693,15,0,51,16,108,44,8866
"42025020900",4662,525,0,0,65,130,218,86,5686
"42027010100",3913,220,11,0,9,2,11,4,4170
"42027010200",2696,281,0,0,4,3,9,0,2993
"42027010300",2567,495,9,10,60,3,14,13,3171
"42027010400",3050,336,0,0,36,0,42,9,3473
"42027010500",4961,411,10,7,40,4,17,5,5455
"42027010600",3287,586,12,0,21,0,90,0,3996
"42027010700",5147,415,3,0,121,2,201,0,5889
"42027010800",4373,860,0,0,60,0,25,3,5321
"42027010900",6871,768,1,9,30,22,5,3,7709
"42027011000",6748,465,195,26,55,66,82,0,7637
"42027011100",4656,1085,118,85,54,0,28,79,6105
"42027011201",4848,316,23,0,33,54,72,0,5346
"42027011300",4514,1777,649,530,751,476,285,169,9151
"42027011400",5387,554,107,0,500,223,40,36,6847
"42027011501",2498,143,153,12,337,60,142,0,3345
"42027011502",4190,1576,167,53,811,838,263,20,7918
"42027011600",2846,114,108,0,254,0,76,0,3398
"42027011702",4991,191,31,0,176,0,0,0,5389
"42027011800",4263,428,150,0,200,0,152,0,5193
"42027011901",2549,64,16,0,71,0,32,0,2732
"42027011902",5865,253,105,0,784,40,128,43,7218
"42027012000",1759,3047,0,63,312,459,50,187,5877
"42027012100",9,220,62,46,14,43,0,21,415
"42027012200",181,75,13,0,174,44,40,60,587
"42027012300",1575,372,0,0,123,6,8,50,2134
"42027012400",1922,1904,32,50,428,339,159,52,4886
"42027012500",694,2935,8,99,126,221,49,193,4325
"42027012600",998,2251,64,183,91,211,48,107,3953
"42027012700",2316,303,101,29,100,44,53,20,2966
"42027012800",2559,790,147,197,824,550,131,0,5198
"42027981202",0,0,0,0,0,0,0,0,0
"42029300101",2466,35,11,0,443,18,70,0,3043
"42029300103",1828,114,152,0,437,62,21,0,2614
"42029300104",4400,105,36,0,459,0,130,0,5130
"42029300106",3294,124,189,0,876,0,96,0,4579
"42029300107",3729,7,8,0,435,33,59,0,4271
"42029300108",4606,505,98,3,1097,99,88,2,6498
"42029300109",3296,138,24,7,287,0,27,5,3784
"42029300201",4132,150,231,13,397,14,191,0,5128
"42029300202",4853,149,30,0,517,0,85,0,5634
"42029300301",3565,24,115,18,216,22,97,0,4057
"42029300302",3524,47,14,9,39,0,58,0,3691
"42029300303",2506,60,61,3,210,0,70,0,2910
"42029300400",2639,169,40,146,161,14,263,42,3474
"42029300501",4047,115,31,17,150,0,97,0,4457
"42029300502",3418,170,51,10,196,0,118,0,3963
"42029300600",3961,137,197,328,555,10,101,42,5331
"42029300700",3655,352,481,59,585,104,877,147,6260
"42029300800",3105,253,210,0,311,0,226,115,4220
"42029300900",1696,240,40,18,119,0,15,44,2172
"42029301000",6413,197,26,0,385,164,193,164,7542
"42029301100",2959,104,156,11,88,19,47,22,3406
"42029301300",5924,300,67,0,273,0,205,13,6782
"42029301401",2304,81,106,0,79,57,63,0,2690
"42029301402",4783,89,79,62,243,0,55,0,5311
"42029301500",2297,185,58,0,20,0,11,0,2571
"42029301600",2358,95,0,0,50,13,4,13,2533
"42029301700",1544,120,28,0,47,0,50,0,1789
"42029301800",4226,259,76,8,190,9,160,12,4940
"42029301900",3829,36,14,0,153,0,156,0,4188
"42029302000",4136,136,93,0,749,0,78,0,5192
"42029302101",5001,214,55,0,1036,157,660,95,7218
"42029302102",2719,149,205,74,370,0,23,24,3564
"42029302202",5269,149,280,0,981,84,118,49,6930
"42029302203",4168,21,299,27,758,0,91,0,5364
"42029302204",4864,280,205,40,822,0,93,123,6427
"42029302300",2155,299,100,28,5,52,74,9,2722
"42029302400",2694,580,498,58,116,35,734,257,4972
"42029302500",3051,601,197,69,65,11,107,24,4125
"42029302600",1806,2025,465,205,301,10,748,307,5867
"42029302702",3532,201,287,26,570,279,313,60,5268
"42029302703",3601,102,18,0,179,2,9,2,3913
"42029302704",4517,145,94,0,369,0,115,0,5240
"42029302705",3198,248,100,28,599,0,157,25,4355
"42029302706",3379,795,46,9,84,0,70,8,4391
"42029302802",4912,23,0,0,14,0,41,0,4990
"42029302803",1831,55,1,0,0,0,20,0,1907
"42029302804",3712,197,0,0,59,0,0,0,3968
"42029302805",6364,242,349,18,337,0,201,0,7511
"42029302901",4319,104,98,23,215,30,86,2,4877
"42029302902",5190,314,208,32,308,32,85,0,6169
"42029303000",2462,92,118,14,337,6,26,0,3055
"42029303100",3757,54,90,0,341,0,99,0,4341
"42029303301",2639,27,57,0,192,0,442,0,3357
"42029303302",4457,167,59,0,80,0,161,0,4924
"42029303401",2820,493,145,0,521,43,1773,455,6250
"42029303402",1563,105,157,41,161,43,713,99,2882
"42029303501",3690,111,19,9,222,0,117,2,4170
"42029303502",2690,14,34,18,153,0,51,0,2960
"42029303801",3450,222,5,0,178,0,98,15,3968
"42029303802",6830,177,492,0,996,0,146,5,8646
"42029303901",3143,418,14,16,31,23,84,24,3753
"42029303902",4924,174,107,1,202,22,43,98,5571
"42029304000",3787,203,255,0,607,0,123,0,4975
"42029304101",3253,137,576,84,436,4,239,4,4733
"42029304102",2394,118,346,89,184,108,181,79,3499
"42029304201",5119,201,706,139,683,0,291,0,7139
"42029304300",7001,156,0,0,154,0,196,0,7507
"42029304403",3151,179,107,0,297,36,95,0,3865
"42029304404",4096,327,161,48,418,0,100,0,5150
"42029304405",5522,145,206,0,304,3,31,24,6235
"42029304406",3038,21,129,7,130,0,35,0,3360
"42029304501",5964,92,0,0,2364,0,161,0,8581
"42029304502",2825,28,35,2,85,17,14,17,3023
"42029304600",3096,226,86,10,50,0,33,0,3501
"42029304900",6509,867,53,0,136,0,0,0,7565
"42029305000",1506,80,18,0,45,22,12,10,1693
"42029305101",3689,158,104,0,233,0,105,8,4297
"42029305102",4174,209,372,36,46,34,220,85,5176
"42029305300",4528,415,1565,95,466,73,340,75,7557
"42029305400",1685,662,668,583,161,96,377,548,4780
"42029305500",680,351,1162,743,345,179,658,360,4478
"42029305600",525,285,1293,1053,257,124,389,258,4184
"42029305700",1089,154,704,150,145,0,163,69,2474
"42029306000",6049,277,633,56,348,152,243,94,7852
"42029306300",2425,9,147,38,195,35,827,35,3711
"42029306501",3875,350,63,0,146,14,146,177,4771
"42029306503",1900,570,85,50,190,6,1003,491,4295
"42029306504",4209,332,0,51,219,12,954,256,6033
"42029306600",2991,38,48,0,105,9,83,9,3283
"42029306700",4037,216,7,6,144,5,202,106,4723
"42029306800",1459,70,37,3,109,0,51,14,1743
"42029306900",5203,214,59,0,268,23,369,11,6147
"42029307000",4731,309,103,0,226,44,289,136,5838
"42029307100",2156,126,17,0,40,0,206,14,2559
"42029307200",1089,101,37,0,27,9,39,9,1311
"42029307300",2842,350,301,0,166,15,114,101,3889
"42029307400",2965,154,226,1,290,0,452,46,4134
"42029307700",2371,172,0,0,25,0,139,0,2707
"42029307800",2094,342,42,0,15,0,85,0,2578
"42029307900",2816,237,91,4,170,24,705,128,4175
"42029308000",3281,990,228,109,103,209,690,650,6260
"42029308101",4068,241,93,16,125,0,130,0,4673
"42029308102",3600,395,78,9,137,13,358,286,4876
"42029308200",2232,257,132,0,99,0,140,0,2860
"42029310400",3,2,0,0,0,0,0,0,5
"42029311000",5566,217,174,288,304,0,23,98,6670
"42029311100",3043,88,129,0,298,0,15,0,3573
"42029311200",2014,68,3,4,24,0,124,0,2237
"42029311300",2821,98,0,0,194,0,98,0,3211
"42029311401",4645,332,1284,352,322,17,381,2,7335
"42029311403",2901,67,110,0,200,26,38,26,3368
"42029311404",3423,417,97,0,78,0,86,54,4155
"42029311500",3026,151,1,1,74,18,53,14,3338
"42029311600",832,202,575,251,134,82,103,100,2279
"42029311700",8289,355,192,15,524,59,3257,285,12976
"42029311800",3189,150,260,15,87,40,246,32,4019
"42031160101",1675,201,4,1,0,0,0,0,1881
"42031160102",2985,1809,25,141,29,44,6,31,5070
"42031160200",2874,570,1,0,48,6,13,0,3512
"42031160300",4008,499,35,0,71,13,26,0,4652
"42031160400",3219,480,4,8,17,0,49,0,3777
"42031160500",3246,396,0,4,62,5,14,0,3727
"42031160600",2247,1174,36,7,144,99,0,0,3707
"42031160700",3543,738,4,0,62,8,26,0,4381
"42031160800",3015,402,0,6,34,3,43,0,3503
"42031160900",3141,518,0,0,17,3,4,0,3683
"42033330100",3790,516,0,10,83,37,0,0,4436
"42033330200",2527,599,0,0,14,18,83,110,3351
"42033330300",3330,1005,14,21,76,51,71,216,4784
"42033330400",5406,328,0,0,15,21,160,0,5930
"42033330500",3684,643,0,0,39,53,44,18,4481
"42033330600",2599,238,0,0,64,2,0,2,2905
"42033330700",1674,294,0,0,3,8,8,6,1993
"42033330800",5801,1211,0,0,38,21,78,0,7149
"42033330900",4497,980,1,0,102,20,0,20,5620
"42033331000",4237,612,0,0,32,8,0,0,4889
"42033331100",2763,553,8,1,63,11,0,98,3497
"42033331200",2229,472,0,0,12,0,0,47,2760
"42033331300",3634,524,2,0,71,0,0,0,4231
"42033331401",2957,449,7,0,20,0,10,27,3470
"42033331402",2894,455,1,0,35,0,35,14,3434
"42033331500",1584,289,0,0,7,2,0,0,1882
"42033331600",1967,392,0,0,8,1,0,0,2368
"42033331700",3827,666,4,1,14,11,0,0,4523
"42033331800",2586,516,2,0,20,4,10,7,3145
"42033331900",1955,359,0,0,42,2,26,0,2384
"42035030100",2285,543,12,5,13,0,8,20,2886
"42035030200",4516,680,23,4,80,12,41,8,5364
"42035030300",3605,287,0,0,75,0,16,0,3983
"42035030400",4521,325,36,0,104,0,56,0,5042
"42035030500",3463,382,12,5,66,41,46,24,4039
"42035030600",1330,659,3,32,72,53,10,21,2180
"42035030700",3144,2244,17,69,25,90,8,11,5608
"42035030800",3729,353,4,27,25,0,42,5,4185
"42035030900",3552,413,17,0,28,24,31,4,4069
"42037050100",4464,529,70,5,19,21,17,0,5125
"42037050200",4858,548,12,0,24,0,88,0,5530
"42037050300",4441,569,24,2,142,5,97,13,5293
"42037050400",3692,183,0,0,63,31,20,0,3989
"42037050500",3074,513,2,3,172,81,146,0,3991
"42037050600",4246,717,51,10,96,23,148,23,5314
"42037050700",3868,841,35,0,161,62,0,54,5021
"42037050800",3098,450,1,0,52,1,69,0,3671
"42037050900",2746,257,8,39,81,3,0,3,3137
"42037051000",2184,281,116,90,19,8,171,0,2869
"42037051100",1722,1403,0,33,106,215,251,107,3837
"42037051200",2938,1806,12,121,78,57,86,0,5098
"42037051300",2519,398,23,42,45,11,24,24,3086
"42037051400",2510,153,0,0,33,0,20,0,2716
"42037051500",5051,413,6,1,59,0,59,21,5610
"42039110100",5033,1123,18,2,105,19,36,5,6341
"42039110201",3183,277,33,3,38,2,16,0,3552
"42039110202",2989,475,25,1,12,12,21,0,3535
"42039110300",3975,780,29,2,52,24,34,7,4903
"42039110400",2373,357,0,0,14,0,8,0,2752
"42039110501",1573,153,0,0,26,6,33,10,1801
"42039110502",3165,346,17,3,58,8,15,0,3612
"42039110600",2533,330,27,0,19,0,0,0,2909
"42039110700",3269,318,0,0,36,0,44,1,3668
"42039110800",4372,687,32,8,78,43,14,1,5235
"42039110900",2561,415,0,0,18,3,10,0,3007
"42039111000",2154,268,0,0,13,7,6,0,2448
"42039111100",1668,1088,0,43,35,43,0,21,2898
"42039111200",1793,490,0,9,20,6,6,30,2354
"42039111300",4936,623,23,2,93,15,50,16,5758
"42039111400",4164,528,63,6,66,57,25,0,4909
"42039111500",3626,1180,100,0,63,95,5,20,5089
"42039111600",2016,1152,149,337,77,95,25,19,3870
"42039111700",2738,155,17,6,45,11,4,0,2976
"42039111800",4896,458,92,12,110,0,140,7,5715
"42039111900",3094,411,7,8,34,18,5,12,3589
"42039112001",1967,380,0,0,19,0,12,1,2379
"42039112002",1102,234,5,0,4,0,0,0,1345
"42041010100",3814,523,240,0,322,211,265,0,5375
"42041010201",5153,162,7,0,257,83,108,83,5853
"42041010203",2079,182,114,2,555,57,28,60,3077
"42041010204",4261,336,34,0,369,171,125,0,5296
"42041010300",3172,584,130,22,501,77,195,31,4712
"42041010400",3366,109,70,21,112,73,51,28,3830
"42041010500",3249,175,70,0,395,28,132,0,4049
"42041010600",3358,523,61,30,481,68,240,0,4761
"42041010700",3482,89,93,0,86,0,39,12,3801
"42041010800",2774,445,7,0,245,41,158,15,3685
"42041010900",4301,148,66,0,217,16,188,16,4952
"42041011002",1838,143,31,101,48,60,20,183,2424
"42041011101",2959,98,6,0,235,73,0,9,3380
"42041011102",3579,246,61,139,304,31,157,0,4517
"42041011200",1402,98,19,0,82,5,80,5,1691
"42041011301",3767,87,72,0,480,31,134,0,4571
"42041011302",6452,164,12,0,930,0,225,0,7783
"42041011303",5848,162,0,0,329,8,90,0,6437
"42041011304",4292,87,148,27,446,10,97,14,5121
"42041011305",3821,235,141,0,581,23,103,0,4904
"42041011400",3732,442,243,0,245,15,141,0,4818
"42041011500",3845,101,144,0,133,43,71,0,4337
"42041011601",6561,382,111,278,424,16,90,0,7862
"42041011602",3561,8,53,0,93,0,15,0,3730
"42041011605",3895,146,38,0,376,6,15,8,4484
"42041011700",5767,82,1,2,55,0,125,0,6032
"42041011801",6779,521,80,0,631,225,289,255,8780
"42041011802",5743,231,114,2,200,23,171,25,6509
"42041011803",5942,375,50,0,231,0,133,46,6777
"42041011901",4582,448,78,0,178,197,64,185,5732
"42041011902",5098,383,66,1,35,31,159,14,5787
"42041012000",3661,465,219,196,366,178,23,86,5194
"42041012100",1502,243,47,45,88,93,70,55,2143
"42041012200",1112,262,133,192,90,24,40,18,1871
"42041012300",813,227,112,148,110,97,6,20,1533
"42041012400",4604,374,69,315,279,22,111,0,5774
"42041012501",3226,203,48,0,206,23,344,23,4073
"42041012502",6122,176,0,0,464,20,56,30,6868
"42041012600",5738,210,172,0,13,0,90,0,6223
"42041012701",4792,321,2,0,149,0,0,0,5264
"42041012702",3980,310,36,1,142,30,74,5,4578
"42041012800",7115,479,0,1,317,51,176,8,8147
"42041012900",1101,175,27,0,41,8,5,9,1366
"42041013000",6245,570,5,21,96,0,34,21,6992
"42041013101",7988,840,225,39,178,89,105,3,9467
"42041013102",1413,1528,0,56,21,44,26,0,3088
"42041013200",2466,1427,98,12,298,78,185,152,4716
"42041981001",0,0,0,0,0,0,0,0,0
"42041981606",0,0,0,0,0,0,0,0,0
"42043020100",1110,406,511,703,133,78,74,108,3123
"42043020300",583,163,642,261,64,82,167,52,2014
"42043020400",918,207,317,166,61,31,81,119,1900
"42043020500",1745,203,654,483,164,58,381,79,3767
"42043020600",207,34,687,248,63,30,61,35,1365
"42043020700",246,85,1166,674,136,120,193,104,2724
"42043020800",844,355,675,491,273,32,20,18,2708
"42043020900",1204,120,1003,696,263,380,371,217,4254
"42043021100",264,307,1633,251,154,239,288,415,3551
"42043021200",173,122,901,565,192,116,258,160,2487
"42043021300",1049,860,790,1720,1145,795,1554,1048,8961
"42043021400",558,768,1219,1762,635,572,556,1179,7249
"42043021500",602,255,1649,245,284,186,290,268,3779
"42043021600",503,134,1340,197,364,231,491,151,3411
"42043021700",1988,96,2210,599,901,370,589,283,7036
"42043021800",1499,92,493,0,198,0,46,4,2332
"42043021901",3347,115,627,0,285,0,73,0,4447
"42043021903",2147,97,1100,38,215,29,221,37,3884
"42043021904",2644,154,1128,71,642,8,24,8,4679
"42043022000",2297,131,1826,355,443,0,310,0,5362
"42043022100",2860,142,646,74,438,15,372,25,4572
"42043022200",1389,369,636,127,200,267,231,23,3242
"42043022300",4255,236,712,205,407,35,758,0,6608
"42043022401",3194,129,59,0,252,0,136,0,3770
"42043022403",4015,439,674,265,574,25,362,17,6371
"42043022501",5040,110,195,0,110,186,30,0,5671
"42043022502",4904,507,133,0,144,0,106,0,5794
"42043022601",5460,143,498,91,405,0,192,0,6789
"42043022604",4888,236,429,1,797,0,151,0,6502
"42043022605",2545,62,793,44,695,258,244,89,4730
"42043022606",1520,55,903,205,220,92,238,58,3291
"42043022701",2469,82,594,158,242,158,69,91,3863
"42043022702",2897,104,621,203,593,232,170,31,4851
"42043022800",3845,166,462,1,671,173,675,92,6085
"42043022900",3878,407,1335,148,1021,56,749,355,7949
"42043023000",1241,56,217,20,115,69,28,44,1790
"42043023100",1033,101,101,0,205,9,159,5,1613
"42043023300",1717,226,1545,465,179,117,224,278,4751
"42043023400",840,124,425,67,21,211,149,50,1887
"42043023500",1737,271,100,73,246,11,308,109,2855
"42043023601",2623,102,0,0,30,0,15,0,2770
"42043023602",3913,341,441,138,307,53,98,53,5344
"42043023700",819,295,174,242,63,125,46,123,1887
"42043023800",2724,262,376,127,198,94,159,1,3941
"42043023900",2355,341,49,0,254,97,174,97,3367
"42043024001",5599,539,11,17,36,56,2,81,6341
"42043024002",2752,169,14,15,31,0,70,0,3051
"42043024101",1078,282,25,23,248,74,79,71,1880
"42043024102",3122,602,0,373,338,296,66,349,5146
"42043024104",4809,181,38,8,840,0,94,6,5976
"42043024105",4495,354,265,0,368,40,115,11,5648
"42043024200",2438,193,100,42,154,36,224,6,3193
"42043024300",3086,436,20,0,249,14,204,23,4032
"42043024400",3867,350,0,0,189,106,174,29,4715
"42043024502",5433,112,121,3,135,0,125,0,5929
"42043024503",5400,289,195,90,468,12,242,42,6738
"42043024600",8755,255,316,0,122,0,35,15,9498
"42043024700",5241,395,8,2,309,18,156,12,6141
"42043024800",7413,786,30,4,76,71,64,12,8456
"42043024900",1900,308,8,15,14,25,11,13,2294
"42043025000",2371,335,0,0,30,27,89,33,2885
"42043025100",3289,491,28,0,43,8,16,31,3906
"42043025200",3209,398,38,10,81,0,29,0,3765
"42043025300",3728,207,0,2,25,1,47,0,4010
"42043025400",2202,242,45,2,42,2,69,0,2604
"42045400301",569,298,3136,1325,309,130,248,110,6125
"42045400302",748,303,2008,382,325,43,286,11,4106
"42045400401",909,238,1641,558,1228,514,363,125,5576
"42045400402",785,79,2026,451,788,211,395,0,4735
"42045400500",1000,137,1658,181,834,208,194,66,4278
"42045400600",2605,279,1565,0,557,140,160,30,5336
"42045400700",2206,459,1072,213,1437,644,526,195,6752
"42045400801",250,132,1474,189,151,143,33,105,2477
"42045400802",2134,90,580,265,437,123,116,10,3755
"42045400900",1342,45,68,5,198,33,67,0,1758
"42045401000",1683,71,158,13,104,0,10,0,2039
"42045401101",2276,235,427,61,114,0,200,6,3319
"42045401103",2882,67,173,18,211,0,40,0,3391
"42045401104",3393,207,256,0,346,0,226,113,4541
"42045401200",3237,297,269,0,42,31,24,31,3931
"42045401301",1077,189,209,13,517,25,70,0,2100
"42045401302",2091,91,190,189,313,6,80,0,2960
"42045401401",1412,149,268,32,138,3,30,36,2068
"42045401402",2673,176,681,127,249,10,149,65,4130
"42045401501",3418,211,32,0,26,44,15,0,3746
"42045401502",2759,134,606,338,396,25,6,0,4264
"42045401600",1177,30,498,18,124,0,5,0,1852
"42045401700",677,185,1191,109,419,75,137,6,2799
"42045401800",1249,201,2238,202,132,23,44,70,4159
"42045401900",2029,87,1615,250,430,43,11,0,4465
"42045402000",762,122,847,151,209,28,33,8,2160
"42045402100",368,54,4809,397,37,0,134,13,5812
"42045402200",66,15,1686,96,73,36,18,4,1994
"42045402300",40,9,2573,857,25,0,15,0,3519
"42045402400",204,62,2130,786,22,113,22,176,3515
"42045402500",169,119,1975,1048,66,6,121,63,3567
"42045402600",573,255,1849,757,0,52,3,198,3687
"42045402700",328,64,1621,438,79,12,29,5,2576
"42045402800",1642,55,3074,487,359,52,36,0,5705
"42045402900",90,97,2601,603,147,42,60,54,3694
"42045403001",3001,80,0,0,8,0,16,0,3105
"42045403002",1846,515,182,6,64,11,0,11,2635
"42045403101",1963,335,1176,40,24,0,83,0,3621
"42045403103",1478,170,919,55,166,0,63,0,2851
"42045403104",678,332,898,373,143,14,33,55,2526
"42045403200",2914,263,933,33,0,14,23,0,4180
"42045403300",4056,664,1121,100,571,138,170,37,6857
"42045403401",1525,148,784,217,50,91,7,138,2960
"42045403402",1986,546,596,338,191,93,30,129,3909
"42045403501",3180,139,265,103,343,0,149,0,4179
"42045403502",2382,303,220,12,203,0,0,0,3120
"42045403601",3348,281,110,0,153,25,17,32,3966
"42045403602",1745,44,76,0,74,4,32,0,1975
"42045403701",1517,295,8,0,24,0,18,40,1902
"42045403702",1849,293,0,1,38,10,57,0,2248
"42045403800",4960,610,211,61,341,23,69,73,6348
"42045403901",2515,357,0,81,252,0,56,5,3266
"42045403902",3506,161,0,0,82,0,0,6,3755
"42045404003",1415,159,202,0,342,83,47,17,2265
"42045404004",5536,262,44,0,255,0,61,1,6159
"42045404101",4949,824,236,189,168,16,44,153,6579
"42045404102",3439,378,596,148,537,97,163,51,5409
"42045404103",2701,406,88,11,38,59,17,22,3342
"42045404300",1747,268,262,40,109,142,57,7,2632
"42045404400",469,189,666,170,23,28,79,56,1680
"42045404500",942,269,2479,677,322,188,532,194,5603
"42045404600",448,49,1124,631,105,43,105,69,2574
"42045404700",408,470,650,609,64,20,66,20,2307
"42045404800",113,31,1033,538,75,130,117,108,2145
"42045404900",24,103,859,245,17,76,32,124,1480
"42045405000",0,75,1306,621,22,20,8,25,2077
"42045405100",40,39,1524,589,0,11,67,64,2334
"42045405200",63,50,1933,1227,47,49,64,153,3586
"42045405300",274,160,1176,349,128,205,312,260,2864
"42045405400",150,169,1050,747,122,75,118,175,2606
"42045406100",1490,184,202,117,199,0,104,0,2296
"42045406201",2782,235,129,4,114,0,48,0,3312
"42045406202",4328,211,58,71,54,58,139,0,4919
"42045406300",1646,220,727,569,35,19,350,16,3582
"42045406401",392,22,1497,521,114,102,28,81,2757
"42045406402",240,90,525,481,65,0,19,4,1424
"42045406500",1157,203,273,44,32,0,66,9,1784
"42045406600",1539,304,355,114,23,59,0,93,2487
"42045406700",2589,208,240,280,101,40,34,10,3502
"42045406801",3356,231,663,41,179,41,221,40,4772
"42045406802",2934,317,635,59,100,18,10,0,4073
"42045406803",6475,333,755,186,489,0,219,173,8630
"42045406902",5699,64,0,8,13,0,45,0,5829
"42045406903",5052,87,0,0,73,11,0,0,5223
"42045406904",4367,277,235,0,199,26,19,0,5123
"42045407000",2130,90,130,12,187,2,67,2,2620
"42045407101",3499,41,27,8,234,26,130,0,3965
"42045407102",3251,63,19,0,47,0,35,7,3422
"42045407201",3744,223,155,0,631,0,185,34,4972
"42045407202",2583,221,12,0,96,0,25,21,2958
"42045407401",3230,60,240,50,530,26,63,11,4210
"42045407404",2692,113,76,4,131,0,71,23,3110
"42045407501",1857,114,189,94,77,0,8,0,2339
"42045407502",2111,209,297,11,164,17,46,19,2874
"42045407600",4133,273,250,14,261,0,374,0,5305
"42045407700",1680,139,627,77,136,4,15,0,2678
"42045407801",3789,226,77,8,119,0,7,7,4233
"42045407802",6079,255,0,1,411,0,32,0,6778
"42045407803",4912,259,60,0,190,0,76,0,5497
"42045407804",4291,132,9,0,179,0,26,0,4637
"42045407805",1440,21,29,67,95,0,17,21,1690
"42045407806",1188,29,142,0,66,0,0,0,1425
"42045407901",3662,50,89,25,339,26,72,10,4273
"42045407902",2280,59,41,5,246,10,74,0,2715
"42045407903",2733,144,190,22,318,0,36,1,3444
"42045408001",5769,433,16,1,524,0,73,277,7093
"42045408002",3468,121,93,6,142,31,0,0,3861
"42045408101",4238,148,38,16,362,0,123,0,4925
"42045408102",2908,67,62,4,263,0,27,0,3331
"42045408103",3276,141,369,28,334,9,37,20,4214
"42045408300",2962,35,104,3,95,9,27,0,3235
"42045408400",1493,55,45,15,53,0,4,0,1665
"42045408500",3476,221,41,0,444,0,30,0,4212
"42045408600",3219,72,31,3,145,44,28,43,3585
"42045408700",4238,123,48,0,228,62,71,46,4816
"42045408800",4142,248,218,0,320,11,105,0,5044
"42045408900",2498,87,247,0,201,0,48,0,3081
"42045409000",2836,95,19,0,468,0,7,0,3425
"42045409100",3972,303,17,0,101,20,104,1,4518
"42045409200",3741,144,124,0,85,0,87,0,4181
"42045409300",2215,56,11,0,87,22,6,0,2397
"42045409400",2664,13,55,0,168,0,0,2,2902
"42045409500",4286,128,88,1,97,28,0,0,4628
"42045409601",3581,121,256,0,777,83,81,0,4899
"42045409602",1918,340,234,41,224,0,59,0,2816
"42045409701",4720,347,125,2,673,7,99,12,5985
"42045409702",325,17,42,4,4,0,14,0,406
"42045409802",2999,474,61,20,269,10,93,51,3977
"42045409803",5590,325,416,11,417,0,316,0,7075
"42045409902",4415,76,4,0,259,0,26,0,4780
"42045409903",3484,166,40,1,190,0,55,0,3936
"42045409904",3160,229,31,23,100,15,14,5,3577
"42045410000",3600,49,23,0,228,0,11,0,3911
"42045410100",5570,278,38,8,558,0,174,0,6626
"42045410200",3079,83,59,1,454,15,100,0,3791
"42045410301",5384,105,65,1,477,59,175,0,6266
"42045410302",8039,397,293,45,541,91,14,0,9420
"42045410400",7919,120,184,11,696,38,62,0,9030
"42045410500",518,253,663,243,2103,1004,54,372,5210
"42045410601",2949,98,20,0,429,0,145,0,3641
"42045410602",4205,190,79,117,352,18,90,6,5057
"42045410700",200,173,2875,1146,15,80,80,181,4750
"42045410800",6371,106,163,0,596,10,52,0,7298
"42045980000",0,0,0,0,0,0,0,0,0
"42047950100",1463,87,15,0,0,0,22,0,1587
"42047950200",2633,290,3,0,17,0,6,10,2959
"42047950400",3406,518,0,0,15,23,0,9,3971
"42047950500",2112,300,0,0,4,31,24,3,2474
"42047950900",2117,388,7,0,25,9,26,0,2572
"42047951000",4730,267,19,1,47,10,0,0,5074
"42047951100",4481,518,0,0,15,12,95,0,5121
"42047951200",1898,386,0,0,13,0,0,0,2297
"42047951300",4680,363,103,11,123,0,16,0,5296
"42049000100",537,676,92,131,58,234,0,81,1809
"42049000200",3508,210,67,8,60,6,102,0,3961
"42049000300",1751,800,491,188,15,98,54,265,3662
"42049000400",852,624,262,277,142,225,45,13,2440
"42049000500",1385,715,246,304,139,116,118,317,3340
"42049000600",1747,648,311,591,91,235,201,260,4084
"42049000700",1011,513,512,507,238,61,125,130,3097
"42049000800",522,729,437,318,146,396,27,212,2787
"42049000900",2076,1012,478,526,323,88,130,98,4731
"42049001000",2244,848,127,154,205,100,111,131,3920
"42049001100",1789,661,39,54,239,180,227,252,3441
"42049001200",853,381,160,402,126,318,148,280,2668
"42049001300",312,286,325,386,39,315,57,96,1816
"42049001400",404,244,158,133,83,77,82,34,1215
"42049001500",367,564,592,896,25,231,95,451,3221
"42049001600",2549,544,795,110,268,106,122,97,4591
"42049001700",838,362,817,296,322,160,322,226,3343
"42049001800",439,320,704,359,185,244,157,90,2498
"42049001900",623,559,51,210,37,153,4,75,1712
"42049002000",1968,754,155,54,154,44,19,38,3186
"42049002100",3268,365,28,102,238,5,77,0,4083
"42049002200",3185,633,57,23,280,0,158,0,4336
"42049002300",1973,437,109,0,75,73,180,21,2868
"42049002400",2439,391,171,56,5,1,51,9,3123
"42049002500",1583,162,261,203,284,120,51,9,2673
"42049002600",2605,317,885,42,243,44,112,8,4256
"42049002700",5169,591,816,54,173,23,147,14,6987
"42049002800",4024,894,223,0,98,21,65,17,5342
"42049002900",2521,130,88,0,128,0,0,0,2867
"42049003000",3151,671,91,41,166,190,44,317,4671
"42049010101",2764,545,0,0,77,21,19,21,3447
"42049010103",1859,246,12,0,9,0,38,0,2164
"42049010104",2057,163,31,0,45,8,22,4,2330
"42049010107",1280,171,9,12,34,16,28,3,1553
"42049010201",5346,523,32,12,133,24,56,63,6189
"42049010202",4917,567,6,0,27,0,31,2,5550
"42049010301",4383,315,4,30,52,26,24,0,4834
"42049010303",4875,230,39,0,112,0,201,0,5457
"42049010304",4186,201,39,6,31,0,43,34,4540
"42049010400",4275,175,19,16,5,20,48,11,4569
"42049010500",3191,729,140,155,70,50,60,0,4395
"42049010700",2909,404,49,16,284,83,136,29,3910
"42049010800",3214,234,2,0,36,6,46,0,3538
"42049010902",3599,397,54,9,205,0,105,29,4398
"42049010903",6372,364,68,0,114,12,63,41,7034
"42049010904",4759,114,148,9,203,0,73,0,5306
"42049011001",4815,933,36,214,391,105,93,22,6609
"42049011002",3345,434,97,2,226,113,45,12,4274
"42049011101",4202,767,32,9,152,0,51,19,5232
"42049011102",2950,203,103,0,156,0,104,6,3522
"42049011201",4390,196,42,1,59,0,54,0,4742
"42049011202",6220,258,68,0,109,0,27,0,6682
"42049011300",2520,442,116,0,201,0,52,0,3331
"42049011400",3328,287,0,0,132,0,208,0,3955
"42049011503",3349,216,58,0,116,6,109,0,3854
"42049011505",2443,159,0,0,13,0,84,0,2699
"42049011507",2688,250,22,0,45,16,73,0,3094
"42049011600",3273,855,0,0,40,0,118,38,4324
"42049011701",2447,278,30,0,37,36,23,5,2856
"42049011702",4569,418,3,16,142,3,28,4,5183
"42049011801",2474,204,5,0,41,5,25,0,2754
"42049011802",2751,357,3,0,70,13,2,9,3205
"42049011900",4668,1432,35,4,180,116,12,0,6447
"42049012001",2455,207,14,0,33,12,21,3,2745
"42049012002",2632,528,19,0,74,8,29,0,3290
"42049012100",6913,581,43,3,84,3,14,17,7658
"42049012201",5158,752,3,0,65,16,222,5,6221
"42049012202",3440,1234,50,0,295,62,249,0,5330
"42049012300",5312,568,135,1,81,0,60,0,6157
"42049012400",1161,163,17,0,16,18,8,0,1383
"42049980109",0,0,0,0,0,0,0,0,0
"42049990000",0,0,0,0,0,0,0,0,0
"42051260100",4597,640,87,17,65,83,9,38,5536
"42051260200",3768,448,56,22,22,66,3,32,4417
"42051260300",3209,532,21,18,82,12,0,0,3874
"42051260401",2184,391,0,0,0,14,0,0,2589
"42051260402",3738,560,0,0,15,0,10,10,4333
"42051260500",4854,1513,0,0,58,7,4,0,6436
"42051260600",3260,751,51,0,37,8,20,19,4146
"42051260700",2767,780,44,5,79,107,0,6,3788
"42051260800",2646,1066,66,0,13,20,74,3,3888
"42051260900",4043,710,0,13,0,0,35,0,4801
"42051261000",2217,206,15,0,119,0,13,0,2570
"42051261100",2375,242,8,0,12,18,14,16,2685
"42051261200",1369,488,129,157,95,112,40,26,2416
"42051261300",4221,281,89,94,18,33,13,0,4749
"42051261401",1862,699,192,10,7,108,29,0,2907
"42051261402",1761,439,246,73,22,98,16,21,2676
"42051261500",3206,569,124,20,210,0,13,1,4143
"42051261600",2246,180,0,0,0,44,16,0,2486
"42051261700",2396,355,56,60,124,101,18,0,3110
"42051261800",2729,577,88,0,101,125,0,0,3620
"42051261900",1921,745,141,22,134,148,0,12,3123
"42051262000",4008,371,91,0,206,0,81,0,4757
"42051262100",1703,530,70,0,0,0,0,0,2303
"42051262200",2654,573,60,105,51,0,8,0,3451
"42051262300",1056,796,605,530,204,104,48,32,3375
"42051262400",2877,313,57,0,93,0,53,0,3393
"42051262500",2650,478,30,0,0,0,0,0,3158
"42051262600",2135,553,61,0,49,0,9,0,2807
"42051262701",2914,477,0,0,17,0,0,0,3408
"42051262702",2086,376,0,0,5,8,15,0,2490
"42051262800",5283,1201,96,79,179,33,27,0,6898
"42051262900",3694,1115,44,157,38,0,29,0,5077
"42051263000",2135,670,154,45,109,252,18,99,3482
"42051263100",3888,1499,11,8,46,18,19,14,5503
"42051263200",1961,552,0,0,0,0,0,0,2513
"42051263300",1109,337,34,49,21,2,0,0,1552
"42053530100",1406,217,0,20,14,36,7,11,1711
"42053530201",988,149,0,0,54,4,47,0,1242
"42053530300",1111,251,0,0,15,0,4,0,1381
"42055010100",3708,690,16,1,23,0,16,0,4454
"42055010200",4143,426,14,0,49,11,88,0,4731
"42055010300",7808,1345,148,154,37,16,158,77,9743
"42055010400",7117,722,234,274,121,169,146,78,8861
"42055010500",6734,1252,112,7,170,17,231,102,8625
"42055010600",5392,189,453,26,233,0,60,0,6353
"42055010700",6967,772,57,0,245,0,13,199,8253
"42055010800",3220,212,98,33,242,46,459,21,4331
"42055010900",2802,811,253,83,363,32,448,275,5067
"42055011000",2560,914,347,583,443,135,715,568,6265
"42055011100",2722,623,156,17,102,0,184,257,4061
"42055011200",1544,925,98,43,142,227,320,589,3888
"42055011301",4762,109,25,0,123,0,99,0,5118
"42055011302",5312,265,48,0,249,9,280,86,6249
"42055011400",4904,712,46,34,184,68,86,0,6034
"42055011500",5171,490,157,38,56,6,90,0,6008
"42055011600",6001,298,59,46,23,0,12,12,6451
"42055011700",7378,725,107,13,88,31,200,105,8647
"42055011800",3337,252,340,25,37,32,42,0,4065
"42055011900",6050,239,99,0,122,0,101,1,6612
"42055012000",5642,565,74,13,53,0,0,0,6347
"42055012100",3592,276,22,0,35,0,28,0,3953
"42055012200",2987,306,2,142,85,31,0,85,3638
"42055012300",3092,711,112,82,137,8,35,66,4243
"42055012400",2165,372,172,79,83,0,82,112,3065
"42055012501",5697,258,44,0,289,0,264,0,6552
"42055012502",3505,261,141,0,122,19,12,27,4087
"42057960100",3924,541,134,45,37,19,18,28,4746
"42057960200",4567,761,0,0,41,9,45,0,5423
"42057960300",4159,320,6,3,59,11,33,0,4591
"42059970100",5624,1041,41,0,127,52,31,0,6916
"42059970200",2632,330,208,0,11,0,30,0,3211
"42059970300",3893,541,0,0,28,14,12,0,4488
"42059970400",3404,593,0,0,19,5,3,1,4025
"42059970501",1721,76,1,0,18,0,12,0,1828
"42059970502",2895,521,6,0,8,4,5,0,3439
"42059970600",2432,791,28,3,24,0,11,12,3301
"42059970700",2498,237,9,0,18,0,9,1,2772
"42059970800",3203,697,4,0,59,12,7,4,3986
"42061950100",1462,87,21,0,13,0,5,1,1589
"42061950200",3204,243,12,3,76,2,54,2,3596
"42061950300",4045,478,5,0,31,4,33,28,4624
"42061950400",4436,1078,35,16,47,30,13,9,5664
"42061950500",3010,441,0,0,73,22,0,0,3546
"42061950600",3891,196,0,0,17,12,22,3,4141
"42061950800",3161,452,4,2,4,28,30,0,3681
"42061950900",1676,646,64,175,20,28,17,18,2644
"42061951000",2079,441,6,1,63,29,4,9,2632
"42061951100",1635,238,0,4,14,3,9,3,1906
"42061951200",4239,519,8,2,6,3,37,42,4856
"42061951300",1818,418,0,0,9,0,2,0,2247
"42063960100",3329,895,18,34,42,0,3,26,4347
"42063960200",3775,1023,0,0,20,16,0,0,4834
"42063960300",2115,379,0,9,16,11,12,0,2542
"42063960400",3265,281,1,76,54,65,0,66,3808
"42063960500",3026,240,0,8,5,0,3,0,3282
"42063960600",4676,342,0,0,294,22,0,0,5334
"42063960700",5618,1052,0,0,251,112,19,0,7052
"42063960800",3298,315,69,30,133,29,55,0,3929
"42063960900",3065,371,183,6,70,32,0,0,3727
"42063961000",1463,634,52,69,90,54,97,8,2467
"42063961101",2221,1809,49,292,6,50,0,6,4433
"42063961102",83,699,2,0,0,22,0,19,825
"42063961200",2237,369,4,40,111,0,55,15,2831
"42063961300",3344,538,24,0,61,16,27,0,4010
"42063961400",2473,553,0,6,12,0,9,1,3054
"42063961500",3601,614,5,0,78,1,8,0,4307
"42063961600",3875,752,0,0,36,0,50,69,4782
"42063961700",1468,179,6,0,13,0,17,0,1683
"42063961800",1521,191,0,6,27,0,0,0,1745
"42063961900",3819,467,0,0,14,0,74,51,4425
"42063962000",3254,726,13,131,167,12,17,45,4365
"42063962100",2820,334,26,40,118,30,34,30,3432
"42063962200",2209,241,0,0,22,0,25,0,2497
"42065950100",1621,355,0,22,21,0,13,0,2032
"42065950200",2618,475,2,10,14,2,8,0,3129
"42065950300",4805,552,23,7,71,0,48,0,5506
"42065950400",1610,265,0,0,27,8,8,0,1918
"42065950500",1637,245,0,0,36,0,8,7,1933
"42065950600",4773,716,17,0,79,13,19,3,5620
"42065950700",2043,673,19,0,0,0,13,0,2748
"42065950800",3200,608,0,0,15,0,0,0,3823
"42065950900",3563,402,5,0,35,8,26,0,4039
"42065951000",3416,673,0,4,17,16,22,4,4152
"42065951100",3209,469,0,4,73,8,6,0,3769
"42065951200",2570,491,0,0,75,29,95,7,3267
"42065951300",1912,431,0,0,15,68,0,13,2439
"42067070100",5925,1084,12,0,141,39,330,96,7627
"42067070201",1405,309,0,1,10,0,8,0,1733
"42067070202",5282,615,31,52,242,41,172,8,6443
"42067070300",4589,589,8,0,43,15,43,9,5296
"42067070400",3652,282,47,0,38,0,23,3,4045
"42069100200",707,529,67,6,754,197,72,72,2404
"42069100300",704,1098,170,84,145,96,165,108,2570
"42069100400",1157,217,110,174,152,114,153,26,2103
"42069100500",1546,278,14,16,18,44,135,22,2073
"42069100600",2268,617,250,86,515,533,406,33,4708
"42069100800",1525,341,0,29,32,28,236,5,2196
"42069100900",972,208,53,103,0,76,61,76,1549
"42069101000",2842,570,19,27,8,20,98,24,3608
"42069101100",1822,577,133,12,29,60,69,0,2702
"42069101200",1813,450,168,77,74,0,45,161,2788
"42069101300",1876,465,110,4,32,0,0,29,2516
"42069101400",1837,565,185,182,110,0,327,339,3545
"42069101600",1569,474,80,44,44,0,26,47,2284
"42069101700",2519,380,40,31,90,4,387,147,3598
"42069101800",3619,483,266,0,214,0,190,89,4861
"42069101900",1293,133,0,0,81,4,136,10,1657
"42069102000",1502,542,165,17,67,17,404,152,2866
"42069102100",2241,399,9,83,14,5,44,45,2840
"42069102200",1956,298,31,3,61,21,37,55,2462
"42069102300",2465,375,125,18,55,83,338,169,3628
"42069102500",1786,435,552,250,54,57,376,186,3696
"42069102600",1660,535,82,67,115,64,317,192,3032
"42069102700",1984,168,90,0,49,92,209,126,2718
"42069102800",2416,126,13,0,140,0,49,0,2744
"42069102900",1727,1045,322,420,142,461,119,651,4887
"42069103000",1680,180,18,36,101,64,430,119,2628
"42069103100",1268,287,20,0,21,0,36,80,1712
"42069110100",2533,307,8,0,12,19,48,20,2947
"42069110201",3580,494,10,0,10,0,4,0,4098
"42069110202",4509,269,0,0,79,54,17,54,4982
"42069110300",3586,265,23,3,86,6,127,6,4102
"42069110401",6159,181,9,0,123,3,71,0,6546
"42069110402",2178,48,0,0,281,0,63,0,2570
"42069110403",2124,19,20,0,118,6,13,0,2300
"42069110500",4814,159,0,0,118,10,22,0,5123
"42069110600",2625,221,4,2,11,8,105,30,3006
"42069110700",1461,635,0,4,0,6,0,105,2211
"42069110800",2354,850,0,125,148,11,0,0,3488
"42069110900",2440,458,0,0,118,0,163,120,3299
"42069111000",1796,310,43,4,55,0,55,21,2284
"42069111100",6334,549,15,2,104,49,59,92,7204
"42069111200",5066,740,0,11,213,209,157,11,6407
"42069111300",3989,643,1,0,17,0,160,43,4853
"42069111400",4631,521,6,0,20,0,150,13,5341
"42069111500",3032,388,44,1,36,13,33,31,3578
"42069111600",2094,285,0,12,116,17,79,0,2603
"42069111700",3432,431,23,121,28,42,110,0,4187
"42069111800",8301,525,12,0,95,48,72,11,9064
"42069112000",2979,399,0,0,144,8,49,5,3584
"42069112100",4005,411,22,0,118,1,386,1,4944
"42069112200",2144,300,0,18,20,0,13,9,2504
"42069112300",2263,85,26,25,120,83,137,29,2768
"42069112400",3852,257,0,2,58,28,49,0,4246
"42069112500",5183,634,66,21,146,17,416,90,6573
"42069112600",4664,561,34,1,54,0,53,0,5367
"42069112700",2514,342,0,14,52,0,101,121,3144
"42069112800",5189,523,0,0,0,0,6,13,5731
"42069112901",3764,183,21,0,29,5,16,8,4026
"42069112902",5241,640,59,0,77,0,70,63,6150
"42071000100",1104,286,250,90,138,399,361,340,2968
"42071000200",1521,85,224,82,689,134,770,157,3662
"42071000300",2251,867,483,135,683,741,943,1027,7130
"42071000400",2467,380,303,116,164,381,676,327,4814
"42071000500",2337,389,22,272,225,180,277,162,3864
"42071000600",2262,287,307,53,218,48,651,64,3890
"42071000700",1261,717,173,186,328,334,364,572,3935
"42071000800",1154,433,522,211,951,669,1877,1012,6829
"42071000900",870,476,516,558,653,425,1141,916,5555
"42071001000",1185,595,539,332,596,310,1286,647,5490
"42071001100",1653,279,277,396,469,200,635,383,4292
"42071001200",2958,214,849,256,900,265,1709,529,7680
"42071001400",1584,753,648,216,680,549,1429,903,6762
"42071010101",6707,480,44,0,98,0,163,0,7492
"42071010102",3385,182,20,0,174,10,182,0,3953
"42071010201",4414,278,13,0,75,14,0,0,4794
"42071010202",4826,548,51,28,186,12,164,44,5859
"42071010300",7912,216,15,133,545,0,543,19,9383
"42071010400",4252,450,10,14,122,16,196,0,5060
"42071010501",4285,197,106,0,42,7,299,7,4943
"42071010502",5772,269,37,35,54,0,205,0,6372
"42071010600",8217,1561,0,35,400,12,351,34,10610
"42071010701",5187,511,15,0,228,0,241,0,6182
"42071010702",3344,347,32,0,49,9,29,0,3810
"42071010801",7333,282,27,2,85,0,65,0,7794
"42071010802",3182,123,0,0,11,0,0,0,3316
"42071010900",6290,517,341,47,254,244,281,115,8089
"42071011000",2192,249,59,51,30,0,19,61,2661
"42071011100",7267,264,96,0,255,31,146,0,8059
"42071011200",1056,341,168,34,100,54,93,212,2058
"42071011300",3531,529,98,1,152,150,261,106,4828
"42071011400",3122,338,230,48,19,207,246,126,4336
"42071011502",5116,401,62,52,357,182,491,241,6902
"42071011503",4032,339,257,4,299,0,169,66,5166
"42071011504",7027,265,82,3,450,50,588,20,8485
"42071011600",5068,583,59,0,349,2,654,29,6744
"42071011701",3947,181,94,0,518,58,573,92,5463
"42071011703",7374,123,125,6,226,0,110,0,7964
"42071011704",3646,262,12,0,350,44,81,64,4459
"42071011705",4009,292,303,0,417,10,432,0,5463
"42071011801",2973,68,1,0,54,32,79,32,3239
"42071011802",4882,269,314,0,184,0,308,99,6056
"42071011803",4885,253,76,22,436,118,452,118,6360
"42071011804",6699,274,204,78,952,106,724,39,9076
"42071011805",1426,258,142,1,333,49,601,178,2988
"42071011901",4940,63,174,95,523,0,277,95,6167
"42071011902",6038,367,39,13,401,43,152,30,7083
"42071012001",4657,123,54,13,400,0,244,12,5503
"42071012002",3162,392,17,10,101,126,21,187,4016
"42071012102",7337,137,98,1,166,0,121,0,7860
"42071012103",3710,221,0,0,26,2,0,0,3959
"42071012104",5282,428,266,0,88,0,220,0,6284
"42071012200",6167,729,96,0,368,0,368,29,7757
"42071012301",2566,270,52,0,155,0,28,16,3087
"42071012302",2650,224,43,1,181,17,11,2,3129
"42071012402",3555,268,0,4,112,2,138,0,4079
"42071012403",3788,403,0,0,334,6,121,11,4663
"42071012404",4250,442,168,0,115,0,104,0,5079
"42071012501",6427,263,65,35,494,21,430,21,7756
"42071012502",3933,772,0,0,65,0,164,217,5151
"42071012601",6676,423,0,0,153,24,145,0,7421
"42071012602",4201,396,9,12,49,0,13,0,4680
"42071012700",6754,591,0,92,535,29,287,90,8378
"42071012800",4663,201,252,0,291,0,307,0,5714
"42071012900",5581,1034,0,0,359,0,74,0,7048
"42071013000",6189,855,45,0,740,9,250,0,8088
"42071013101",3891,990,171,0,218,0,244,82,5596
"42071013102",2847,502,0,0,154,0,239,0,3742
"42071013202",3779,712,566,101,875,46,787,72,6938
"42071013203",3892,286,217,251,448,2,269,0,5365
"42071013204",5151,361,280,61,309,157,280,180,6779
"42071013301",3720,158,233,0,324,17,631,16,5099
"42071013303",4462,174,9,0,118,1,35,0,4799
"42071013304",6361,476,0,0,299,0,163,0,7299
"42071013400",1502,179,217,0,311,127,653,219,3208
"42071013501",5203,1040,707,293,1617,475,2077,955,12367
"42071013502",3101,402,141,0,320,25,360,81,4430
"42071013503",2477,26,19,0,73,0,42,0,2637
"42071013601",1349,164,0,1,114,0,45,0,1673
"42071013602",3411,743,267,0,87,37,29,74,4648
"42071013701",3884,474,182,0,363,31,352,67,5353
"42071013702",7601,881,427,46,301,75,653,306,10290
"42071013800",3651,53,0,0,77,6,8,6,3801
"42071013901",4248,156,122,0,84,32,137,4,4783
"42071013902",3455,159,0,0,121,56,105,11,3907
"42071014000",6557,312,25,0,78,51,109,4,7136
"42071014101",4967,307,15,0,0,18,46,54,5407
"42071014102",4622,480,24,3,45,59,16,34,5283
"42071014201",5212,552,13,0,7,7,6,0,5797
"42071014202",4716,386,65,11,131,23,121,66,5519
"42071014300",6519,756,65,18,61,74,181,46,7720
"42071014401",5893,763,0,0,277,0,188,0,7121
"42071014402",4257,525,50,0,63,12,144,23,5074
"42071014501",4788,369,13,0,36,0,112,0,5318
"42071014502",4675,969,0,0,18,0,98,19,5779
"42071014601",3405,221,40,0,21,0,170,24,3881
"42071014602",7350,395,25,0,22,5,95,5,7897
"42071014700",935,935,709,411,387,996,1117,1822,7312
"42073000100",3582,270,80,21,45,24,92,0,4114
"42073000200",1085,533,36,104,173,40,45,13,2029
"42073000300",2097,661,340,336,185,31,8,85,3743
"42073000400",416,508,249,579,67,78,6,12,1915
"42073000600",810,121,0,12,14,0,5,4,966
"42073000700",797,492,141,74,66,126,25,14,1735
"42073000800",3271,582,399,193,112,56,41,0,4654
"42073000900",774,350,165,200,11,24,3,6,1533
"42073001000",1333,375,0,0,8,0,12,0,1728
"42073010100",3384,544,12,2,36,3,30,0,4011
"42073010201",3327,120,15,0,33,0,0,0,3495
"42073010202",4542,517,0,0,64,16,64,9,5212
"42073010300",1097,158,0,0,5,3,16,0,1279
"42073010400",3014,328,0,12,6,29,1,0,3390
"42073010500",2321,589,0,0,77,0,62,0,3049
"42073010600",2032,207,18,79,35,0,2,23,2396
"42073010700",2329,284,101,17,12,9,29,0,2781
"42073010800",5256,376,77,64,179,8,30,37,6027
"42073010900",3085,147,0,1,5,0,3,0,3241
"42073011000",4726,364,0,0,107,0,0,0,5197
"42073011100",2989,842,0,6,3,0,23,16,3879
"42073011200",2262,199,0,0,16,0,26,0,2503
"42073011300",4139,181,22,2,65,12,51,0,4472
"42073011400",1855,329,10,2,27,0,30,0,2253
"42073011500",3609,325,2,0,102,13,7,0,4058
"42073011600",3313,434,0,0,194,6,99,0,4046
"42073011700",1778,239,3,0,44,6,12,6,2088
"42073011800",2070,397,88,0,70,0,0,0,2625
"42075000100",2680,503,66,86,475,288,869,221,5188
"42075000200",2755,822,37,90,395,216,506,311,5132
"42075000300",1490,422,119,58,1772,766,2151,777,7555
"42075000401",1846,761,121,212,956,1074,1083,1289,7342
"42075000402",1942,591,20,4,790,353,1011,406,5117
"42075000500",2457,435,63,76,247,407,392,712,4789
"42075002000",2897,138,0,0,113,0,53,0,3201
"42075002100",4387,539,48,0,68,13,42,13,5110
"42075002200",5252,387,91,0,356,92,340,100,6618
"42075002300",2678,68,0,0,32,0,19,0,2797
"42075002400",2202,90,0,0,19,0,5,7,2323
"42075002500",2759,378,91,2,107,88,40,29,3494
"42075002600",2044,101,14,0,83,6,148,13,2409
"42075002701",5248,263,0,1,382,36,226,37,6193
"42075002702",4926,238,69,1,330,76,333,76,6049
"42075002800",7683,360,53,0,152,0,142,0,8390
"42075002900",2491,262,8,0,194,0,319,80,3354
"42075003000",4744,767,0,0,112,49,112,49,5833
"42075003100",3669,262,159,9,6,0,26,0,4131
"42075003200",3896,309,44,0,248,0,281,62,4840
"42075003300",1649,101,9,0,173,13,172,30,2147
"42075003400",2453,102,15,7,19,0,62,0,2658
"42075003500",3853,282,220,27,518,0,315,0,5215
"42075003600",2474,296,208,66,195,158,368,133,3898
"42075003700",2482,259,46,0,41,21,24,10,2883
"42075003800",7601,229,0,0,244,0,90,0,8164
"42075003901",2725,378,90,0,102,34,25,0,3354
"42075003902",3454,180,30,22,312,26,206,26,4256
"42075004000",6421,265,132,10,235,0,97,0,7160
"42075004100",1854,128,0,0,93,26,48,0,2149
"42075004200",3792,50,0,0,181,0,31,0,4054
"42077000101",2179,180,175,65,532,45,723,1,3900
"42077000102",2675,357,804,11,644,19,1213,120,5843
"42077000400",1497,873,133,195,587,162,908,849,5204
"42077000500",742,376,271,292,562,371,1084,658,4356
"42077000600",3462,539,1166,0,1018,166,2176,567,9094
"42077000700",1338,481,154,227,1128,887,1771,1366,7352
"42077000800",815,824,296,453,661,925,1261,1582,6817
"42077000900",369,191,196,49,293,309,422,416,2245
"42077001000",848,479,213,157,645,595,1157,949,5043
"42077001200",401,345,141,83,147,249,376,563,2305
"42077001401",4337,982,412,280,1496,957,2520,1764,12748
"42077001402",1509,89,150,0,186,68,339,85,2426
"42077001501",3355,782,576,296,1237,693,2034,1458,10431
"42077001502",4424,568,1038,198,982,61,2222,270,9763
"42077001600",879,284,406,378,606,1053,1064,1517,6187
"42077001700",1540,512,261,376,1461,746,2540,1089,8525
"42077001800",1113,946,804,525,1266,540,1804,1486,8484
"42077001900",2834,648,225,57,611,111,1335,439,6260
"42077002000",2552,1271,353,111,581,279,2038,1003,8188
"42077002100",2666,831,681,372,1097,862,1540,1113,9162
"42077002201",3256,165,213,9,239,28,432,133,4475
"42077002202",866,337,116,53,153,95,208,302,2130
"42077002301",5477,386,377,0,487,0,534,22,7283
"42077002302",2214,74,33,16,251,9,537,56,3190
"42077005100",3475,577,34,34,65,28,241,39,4493
"42077005200",5991,538,31,2,62,39,184,17,6864
"42077005301",3363,39,0,0,51,0,139,0,3592
"42077005302",3966,272,0,27,0,2,41,2,4310
"42077005401",1982,107,34,0,83,0,57,0,2263
"42077005402",4484,317,0,0,187,23,91,23,5125
"42077005503",4459,179,0,0,27,0,206,48,4919
"42077005504",4237,339,0,0,22,0,96,14,4708
"42077005505",3109,10,0,2,42,0,8,0,3171
"42077005506",2927,200,0,0,204,27,148,0,3506
"42077005601",4096,135,372,39,171,0,479,38,5330
"42077005602",4240,147,158,0,421,17,109,0,5092
"42077005702",3455,337,229,17,246,0,328,0,4612
"42077005703",2291,536,255,92,441,3,754,163,4535
"42077005704",1943,118,221,22,713,372,462,266,4117
"42077005705",3263,514,589,0,1147,83,784,48,6428
"42077005800",2533,475,36,0,99,65,153,145,3506
"42077005901",5335,675,112,50,277,28,308,73,6858
"42077005902",1240,220,77,5,140,0,96,45,1823
"42077006001",4116,75,15,0,233,0,247,0,4686
"42077006002",4637,292,117,3,566,152,128,68,5963
"42077006101",2728,311,227,2,126,2,402,4,3802
"42077006102",4344,96,198,88,466,57,220,108,5577
"42077006202",7319,235,365,0,1392,162,525,132,10130
"42077006203",6132,185,175,0,1174,168,506,23,8363
"42077006204",3471,14,69,4,513,2,18,2,4093
"42077006302",5565,193,423,62,665,30,298,69,7305
"42077006303",2702,197,64,0,129,5,190,104,3391
"42077006304",3408,234,52,0,218,87,184,9,4192
"42077006305",5725,240,207,0,539,106,514,34,7365
"42077006307",7021,501,51,0,723,33,421,0,8750
"42077006308",6230,86,298,0,679,0,442,1,7736
"42077006401",2389,411,0,0,78,23,108,23,3032
"42077006402",4535,171,9,0,155,0,96,0,4966
"42077006500",4584,531,64,0,382,15,210,100,5886
"42077006600",4768,199,26,0,331,0,145,0,5469
"42077006701",3733,307,53,0,544,1,521,29,5188
"42077006702",2555,123,15,38,46,0,195,13,2985
"42077006703",4787,295,441,1,326,0,311,0,6161
"42077006800",3249,314,238,124,319,135,686,224,5289
"42077006902",1942,114,0,0,42,0,31,28,2157
"42077006903",4938,260,6,6,480,109,44,100,5943
"42077006905",4415,60,0,0,53,0,403,0,4931
"42077006906",3495,92,13,0,411,15,29,0,4055
"42077007000",3668,121,0,0,12,0,70,0,3871
"42077009100",2351,307,166,0,184,26,250,47,3331
"42077009200",3349,130,32,13,207,38,315,0,4084
"42077009300",2633,159,144,39,199,0,393,0,3567
"42077009400",2377,671,232,47,503,215,928,528,5501
"42077009500",3169,405,437,30,305,316,617,324,5603
"42077009600",2940,1032,786,288,725,1050,2310,1283,10414
"42077009700",950,754,375,367,539,492,1065,1021,5563
"42079200100",700,276,27,35,0,4,18,26,1086
"42079200200",2122,828,377,157,132,9,286,151,4062
"42079200300",1232,206,139,121,73,88,58,59,1976
"42079200400",1769,253,177,83,44,34,208,23,2591
"42079200500",1299,762,43,240,252,161,317,375,3449
"42079200600",1462,205,135,86,37,82,51,28,2086
"42079200700",1861,715,299,250,284,102,223,353,4087
"42079200800",1808,263,298,423,199,137,255,145,3528
"42079200900",1470,899,228,377,143,193,76,535,3921
"42079201000",942,304,215,652,65,210,0,337,2725
"42079201100",668,432,119,26,95,18,285,190,1833
"42079201200",865,247,118,34,199,55,71,128,1717
"42079201300",1152,540,133,0,242,12,385,206,2670
"42079201400",1394,299,25,100,295,40,246,38,2437
"42079201500",1453,595,94,20,46,62,43,105,2418
"42079201600",2122,302,0,74,39,0,0,0,2537
"42079210100",2929,352,14,0,24,0,0,0,3319
"42079210200",2319,233,0,0,41,115,0,0,2708
"42079210300",2402,204,0,0,20,33,13,0,2672
"42079210400",1282,131,0,0,6,17,7,0,1443
"42079210500",3944,738,24,0,15,197,107,39,5064
"42079210600",909,129,0,0,0,1,6,0,1045
"42079210700",1309,255,0,0,0,5,0,21,1590
"42079210800",2476,611,3,20,172,0,208,0,3490
"42079210900",1366,367,1,0,66,11,18,7,1836
"42079211000",4131,622,1,1,0,0,20,0,4775
"42079211101",4348,988,91,25,57,0,65,438,6012
"42079211102",2149,56,0,0,16,11,24,0,2256
"42079211201",2317,282,0,0,152,0,48,0,2799
"42079211203",1551,203,9,0,38,0,23,0,1824
"42079211204",5037,349,0,0,48,0,120,0,5554
"42079211205",2468,119,0,0,0,0,0,0,2587
"42079211301",2309,125,0,0,30,0,17,0,2481
"42079211302",3114,319,0,0,56,0,0,0,3489
"42079211303",2351,218,0,1,60,126,23,0,2779
"42079211304",1806,268,0,0,16,0,14,0,2104
"42079211400",6414,340,10,43,126,25,124,0,7082
"42079211500",2389,309,0,0,4,0,10,50,2762
"42079211600",2641,374,3,7,23,0,0,0,3048
"42079211701",4580,237,5,0,4,0,88,0,4914
"42079211702",1406,31,0,1,122,1,18,4,1583
"42079211800",1245,164,36,4,185,56,25,35,1750
"42079211900",4964,909,20,0,80,21,0,1,5995
"42079212000",1471,277,0,0,105,0,41,0,1894
"42079212100",3809,359,16,0,0,0,0,0,4184
"42079212200",4453,551,0,0,19,1,1,1,5026
"42079212300",2116,611,25,0,91,0,1,52,2896
"42079212700",3178,580,124,365,217,106,0,158,4728
"42079212800",3119,293,34,17,273,0,251,6,3993
"42079212900",1214,89,12,0,33,0,26,0,1374
"42079213000",1096,101,0,67,51,5,41,0,1361
"42079213100",1126,321,85,0,69,38,8,21,1668
"42079213200",2934,1387,286,121,30,25,0,10,4793
"42079213300",1351,237,0,11,0,6,6,6,1617
"42079213400",3788,605,0,0,69,0,120,12,4594
"42079213600",1258,630,0,22,51,60,25,53,2099
"42079213700",1759,300,0,0,13,17,13,0,2102
"42079213800",1240,316,76,0,39,120,11,50,1852
"42079213900",1610,161,0,0,10,0,10,0,1791
"42079214000",933,85,0,0,33,34,66,0,1151
"42079214100",1726,580,97,37,44,16,50,14,2564
"42079214200",2097,623,41,0,47,0,22,0,2830
"42079214300",1399,392,20,0,20,0,16,25,1872
"42079214400",1406,538,27,5,17,14,50,47,2104
"42079214500",1500,104,0,20,42,0,0,0,1666
"42079214600",3322,402,32,59,18,18,64,18,3933
"42079214900",1114,157,0,0,50,10,11,0,1342
"42079215000",1256,204,2,0,15,0,3,3,1483
"42079215100",2261,420,21,10,30,0,19,0,2761
"42079215200",1943,527,45,86,214,112,138,130,3195
"42079215300",3731,214,7,0,66,7,26,2,4053
"42079215400",2268,242,0,0,71,7,46,16,2650
"42079215501",3906,270,60,0,223,0,83,19,4561
"42079215502",5044,88,15,13,334,34,61,0,5589
"42079215503",3153,44,39,0,203,0,0,8,3447
"42079215504",3774,234,0,1,21,0,0,0,4030
"42079215600",3166,1014,23,0,0,10,0,34,4247
"42079215701",2389,104,0,0,42,31,0,0,2566
"42079215702",1877,183,20,0,0,5,9,0,2094
"42079215800",2675,233,0,0,28,0,0,0,2936
"42079215900",3048,533,18,0,28,5,39,10,3681
"42079216000",580,107,0,1,7,5,38,3,741
"42079216100",3793,258,21,0,57,0,185,0,4314
"42079216200",4707,480,18,4,110,32,101,80,5532
"42079216400",1860,162,0,0,29,0,51,0,2102
"42079216501",1795,86,0,0,35,0,0,0,1916
"42079216502",3561,93,20,0,0,0,88,0,3762
"42079216600",7701,875,128,134,297,40,110,47,9332
"42079216700",2892,526,3,1,82,0,99,0,3603
"42079216800",2904,414,12,4,96,0,13,0,3443
"42079216900",3720,626,21,9,49,27,70,235,4757
"42079217001",1824,180,0,0,28,0,147,36,2215
"42079217002",1773,609,2,124,157,171,283,454,3573
"42079217100",1891,572,26,12,459,122,610,594,4286
"42079217200",1569,595,37,273,345,388,1137,911,5255
"42079217300",2603,299,32,7,42,131,329,195,3638
"42079217400",735,459,33,167,149,291,380,743,2957
"42079217500",1232,441,72,35,403,297,841,618,3939
"42079217600",1369,737,222,83,684,113,1137,563,4908
"42079217700",2461,438,112,86,891,650,1193,741,6572
"42079217800",1958,695,45,0,301,206,1115,510,4830
"42079217900",2551,995,111,10,852,30,1693,450,6692
"42079218000",2962,959,70,16,41,31,135,0,4214
"42079980100",0,0,0,0,0,0,0,0,0
"42081000100",2602,667,58,178,20,29,195,24,3773
"42081000200",1829,139,85,0,175,36,30,36,2330
"42081000300",2963,1583,459,147,91,87,29,24,5383
"42081000400",1318,781,1016,699,203,285,43,151,4496
"42081000500",1158,327,171,16,76,36,73,40,1897
"42081000600",1564,355,65,55,71,64,0,96,2270
"42081000800",162,598,45,202,0,60,0,61,1128
"42081000900",1782,472,163,403,62,24,50,43,2999
"42081001000",2154,427,261,125,19,159,99,82,3326
"42081010100",2122,268,0,0,9,8,1,0,2408
"42081010200",951,116,1,0,4,0,2,0,1074
"42081010300",2985,178,15,0,27,6,15,0,3226
"42081010400",4630,470,46,2,142,5,71,2,5368
"42081010500",5152,417,65,1,65,0,23,6,5729
"42081010600",3963,382,0,0,20,6,20,0,4391
"42081010700",5095,748,46,5,40,0,45,0,5979
"42081010800",6287,473,0,0,269,0,63,10,7102
"42081010900",2494,235,14,11,50,0,18,0,2822
"42081011000",4019,381,0,1,169,0,64,0,4634
"42081011100",4531,590,84,60,189,103,111,0,5668
"42081011200",4390,223,28,0,210,0,0,0,4851
"42081011301",1679,372,8,3,85,0,8,0,2155
"42081011302",4585,281,93,0,43,14,16,0,5032
"42081011400",1486,139,13,5,3,12,0,2,1660
"42081011601",1130,99,0,1,0,7,1,0,1238
"42081011602",5283,911,65,0,75,28,57,0,6419
"42081011700",5130,786,6,0,129,28,9,37,6125
"42081011800",2986,160,0,0,17,0,15,1,3179
"42081011900",5065,890,90,8,59,8,30,8,6158
"42083420100",3180,223,0,1,74,0,77,0,3555
"42083420200",1866,1232,14,0,14,57,0,9,3192
"42083420300",1585,981,0,17,23,11,0,4,2621
"42083420400",2152,436,0,15,0,0,39,0,2642
"42083420500",3030,115,14,0,43,0,35,0,3237
"42083420600",4659,657,27,0,74,27,40,4,5488
"42083420700",3554,739,10,0,41,0,17,5,4366
"42083420800",2983,516,0,0,12,22,2,0,3535
"42083420900",1766,341,0,0,27,0,0,0,2134
"42083421000",3138,336,0,0,14,46,17,74,3625
"42083421100",2604,611,0,0,139,69,3,67,3493
"42083421200",2099,170,0,0,64,0,43,0,2376
"42085030100",1124,600,151,31,76,91,21,0,2094
"42085030300",2354,665,104,126,340,78,0,0,3667
"42085030400",2067,162,63,0,200,0,0,0,2492
"42085030500",1355,315,404,80,168,62,14,61,2459
"42085030900",1652,133,1096,133,175,8,88,0,3285
"42085031100",926,261,105,217,32,83,3,9,1636
"42085031200",5100,109,13,0,82,0,90,0,5394
"42085031300",2533,23,11,0,17,23,31,11,2649
"42085031400",4934,242,177,2,91,0,142,0,5588
"42085031700",2281,156,0,31,20,0,42,7,2537
"42085031800",4384,453,0,2,50,8,26,0,4923
"42085031900",4043,479,0,0,58,3,65,3,4651
"42085032000",4580,477,0,0,71,0,21,0,5149
"42085032100",1433,862,0,18,6,0,0,0,2319
"42085032200",2468,150,75,0,58,0,61,0,2812
"42085032300",2973,268,0,0,53,4,3,0,3301
"42085032400",4659,1122,0,0,9,69,59,82,6000
"42085032501",4896,1046,9,3,59,24,27,14,6078
"42085032502",1937,248,9,0,16,3,0,0,2213
"42085032601",5015,406,12,4,67,6,14,0,5524
"42085032602",2812,284,19,0,55,4,7,0,3181
"42085032701",4254,402,9,0,46,15,49,0,4775
"42085032702",1899,746,10,0,2,0,4,0,2661
"42085032800",4782,443,0,0,31,2,0,18,5276
"42085032900",2578,215,0,1,45,58,22,0,2919
"42085033000",2448,252,32,0,50,0,36,0,2818
"42085033100",4315,445,8,0,52,8,46,0,4874
"42085033200",1167,708,398,574,95,102,10,38,3092
"42085033300",2179,553,18,45,14,0,0,0,2809
"42085033400",750,278,539,616,92,148,9,17,2449
"42087960100",3367,435,7,0,40,11,8,0,3868
"42087960200",3115,883,0,0,59,0,0,0,4057
"42087960300",4158,932,16,3,28,1,29,1,5168
"42087960400",2582,410,6,21,54,10,54,31,3168
"42087960500",3215,349,4,10,65,2,18,14,3677
"42087960600",5042,616,15,9,92,27,4,55,5860
"42087960700",1474,674,34,26,44,0,24,58,2334
"42087960800",2324,1157,14,41,156,31,59,51,3833
"42087960900",1557,511,40,0,79,0,25,15,2227
"42087961000",1731,216,0,1,13,0,22,0,1983
"42087961100",6427,557,30,4,38,7,72,0,7135
"42087961200",2745,301,21,0,37,3,24,0,3131
"42089300101",2441,146,486,183,217,83,182,83,3821
"42089300102",5268,320,756,16,390,21,1022,104,7897
"42089300201",3375,325,187,13,228,0,180,0,4308
"42089300202",4483,277,677,234,518,40,1258,99,7586
"42089300301",2550,155,462,73,32,1,199,1,3473
"42089300304",3968,624,1346,13,626,128,1357,302,8364
"42089300305",3092,907,1877,278,543,105,1124,277,8203
"42089300307",2396,576,2815,661,808,96,1024,403,8779
"42089300308",1635,266,536,155,363,31,684,65,3735
"42089300309",3049,513,542,32,376,24,512,493,5541
"42089300311",1553,199,110,54,169,33,43,0,2161
"42089300312",1413,93,38,31,45,183,239,17,2059
"42089300401",3177,545,412,39,443,0,268,143,5027
"42089300402",4526,585,805,147,174,27,573,0,6837
"42089300403",5062,755,640,0,376,82,1152,21,8088
"42089300501",1454,535,366,122,156,16,193,113,2955
"42089300502",4201,356,354,0,334,91,716,59,6111
"42089300600",2938,830,399,50,249,65,478,351,5360
"42089300700",1686,694,455,156,471,14,503,65,4044
"42089300800",2722,1361,384,235,481,321,195,617,6316
"42089300900",3707,485,650,49,438,33,363,147,5872
"42089301001",7200,1205,2133,13,1073,147,1597,507,13875
"42089301002",1674,99,20,40,37,0,104,0,1974
"42089301101",5131,279,124,0,134,0,162,0,5830
"42089301102",2359,85,50,0,175,0,78,0,2747
"42089301202",3505,450,191,0,109,0,445,16,4716
"42089301203",4996,423,106,0,180,110,31,110,5956
"42089301204",3430,229,152,25,197,39,864,74,5010
"42089301205",6489,605,951,0,405,0,939,111,9500
"42089301301",6280,1132,217,0,103,21,427,145,8325
"42089301302",2453,267,63,0,79,5,56,69,2992
"42089301401",2532,186,1114,112,208,0,666,58,4876
"42089301402",3433,700,289,38,414,24,828,65,5791
"42091200103",3390,111,57,0,463,11,55,0,4087
"42091200104",3828,45,0,0,258,0,11,0,4142
"42091200105",2335,43,11,0,401,172,26,0,2988
"42091200106",1604,140,15,1,112,0,57,0,1929
"42091200200",1041,68,3,20,60,0,30,0,1222
"42091200301",3862,301,662,0,708,0,309,51,5893
"42091200305",2065,116,35,0,40,0,103,41,2400
"42091200306",3153,206,95,1,60,0,54,21,3590
"42091200307",2491,75,149,171,139,21,151,20,3217
"42091200308",2962,104,190,18,473,180,37,0,3964
"42091200309",2519,157,57,1,80,0,31,122,2967
"42091200310",2615,83,0,4,51,0,0,0,2753
"42091200401",2785,81,16,2,84,35,377,0,3380
"42091200402",3700,261,96,0,269,74,209,37,4646
"42091200501",3403,79,0,0,295,0,54,0,3831
"42091200502",4419,184,404,21,165,17,217,0,5427
"42091200505",5522,373,94,1,696,0,296,0,6982
"42091200506",3789,43,98,0,386,21,89,0,4426
"42091200507",5125,107,120,0,405,41,167,0,5965
"42091200602",5308,80,577,16,2172,394,70,174,8791
"42091200603",2830,49,59,17,398,0,57,11,3421
"42091200605",4113,135,237,49,949,54,132,0,5669
"42091200606",2438,22,118,1,481,20,41,0,3121
"42091200607",3425,80,186,0,917,0,58,0,4666
"42091200703",2709,94,328,0,862,149,147,0,4289
"42091200704",2761,121,320,13,437,0,244,0,3896
"42091200707",2547,262,163,9,1188,30,373,7,4579
"42091200708",4116,146,176,0,992,1,122,0,5553
"42091200800",2104,108,86,23,900,71,220,121,3633
"42091200901",2709,114,239,110,620,193,154,0,4139
"42091200902",846,97,102,9,91,15,91,41,1292
"42091200903",3020,177,385,221,717,20,183,12,4735
"42091200906",1150,60,163,0,166,51,40,0,1630
"42091200907",2335,42,80,16,157,0,23,0,2653
"42091200908",1398,95,158,6,452,28,122,12,2271
"42091201003",3566,323,177,0,1066,92,85,0,5309
"42091201004",3812,178,90,0,720,1,214,33,5048
"42091201005",2946,2,118,0,138,9,28,9,3250
"42091201006",1992,55,23,0,219,0,49,0,2338
"42091201100",2610,188,78,9,241,52,24,0,3202
"42091201201",4402,319,81,0,707,107,66,0,5682
"42091201203",2615,57,21,48,286,0,32,0,3059
"42091201204",1458,35,684,35,61,119,23,5,2420
"42091201301",2557,127,355,7,312,48,246,77,3729
"42091201302",2002,178,429,107,121,22,121,26,3006
"42091201404",3657,87,133,0,513,23,178,29,4620
"42091201406",3752,29,316,31,460,0,11,0,4599
"42091201407",1774,90,616,55,94,1,39,90,2759
"42091201408",3930,9,22,1,533,0,77,0,4572
"42091201409",3882,53,59,0,295,42,33,0,4364
"42091201410",2109,178,18,77,148,12,50,0,2592
"42091201411",2425,48,110,1,216,0,29,0,2829
"42091201501",2412,176,30,0,444,0,114,0,3176
"42091201502",1672,53,45,0,87,0,45,0,1902
"42091201603",2317,135,1372,227,176,56,256,28,4567
"42091201604",1796,147,1037,93,113,0,35,0,3221
"42091201605",2023,3,457,0,371,27,78,1,2960
"42091201606",1211,105,694,135,251,17,98,0,2511
"42091201607",2684,196,205,17,333,0,69,0,3504
"42091201608",3805,156,190,9,546,16,396,13,5131
"42091201703",2628,54,133,38,177,0,81,0,3111
"42091201704",2548,113,378,25,121,0,66,0,3251
"42091201705",4115,186,178,36,190,61,135,0,4901
"42091201706",3465,393,390,103,316,8,131,199,5005
"42091201800",2260,160,155,0,181,14,221,0,2991
"42091201901",3881,331,44,0,462,41,76,52,4887
"42091201902",3857,224,808,17,679,39,145,0,5769
"42091202000",2233,144,5,0,147,19,82,6,2636
"42091202100",3650,382,283,1,125,0,141,18,4600
"42091202201",3279,137,689,170,563,77,227,0,5142
"42091202202",1028,87,1184,25,870,33,274,23,3524
"42091202301",3466,146,701,45,394,20,55,0,4827
"42091202302",1217,79,453,16,133,0,178,0,2076
"42091202401",162,135,2693,215,273,61,76,10,3625
"42091202402",2285,81,1478,214,451,103,364,32,5008
"42091202500",967,212,3093,285,516,134,131,43,5381
"42091202602",1976,227,22,23,69,29,121,0,2467
"42091202603",1934,252,374,0,97,34,60,0,2751
"42091202604",1645,100,347,27,241,34,116,0,2510
"42091203000",2829,110,99,0,192,11,116,0,3357
"42091203103",2620,106,4,0,209,0,12,0,2951
"42091203104",3652,67,44,0,165,0,60,0,3988
"42091203105",4287,208,389,0,285,50,132,18,5369
"42091203106",1429,256,44,27,132,36,78,0,2002
"42091203203",3331,80,159,1,548,25,240,7,4391
"42091203204",4680,45,473,3,1270,91,186,0,6748
"42091203205",1744,114,122,31,116,24,121,0,2272
"42091203207",2937,58,57,1,194,8,1,0,3256
"42091203208",2307,75,48,0,389,0,57,0,2876
"42091203302",5005,240,640,2,223,9,154,9,6282
"42091203303",2729,296,188,7,549,45,108,0,3922
"42091203304",2949,80,404,9,209,0,80,0,3731
"42091203401",4876,139,667,71,197,37,200,17,6204
"42091203402",4887,263,557,27,616,101,89,118,6658
"42091203403",2399,101,454,17,176,32,43,0,3222
"42091203500",2924,54,1910,588,376,29,555,29,6465
"42091203601",1169,273,1096,404,87,19,811,229,4088
"42091203602",1827,266,1308,194,300,19,504,71,4489
"42091203700",621,356,437,78,130,32,184,138,1976
"42091203801",1629,350,711,416,498,130,503,363,4600
"42091203803",2782,573,1381,547,360,98,1037,290,7068
"42091203804",1449,98,932,248,60,94,701,52,3634
"42091203901",1418,710,920,434,180,136,1279,645,5722
"42091203902",1208,804,347,259,540,213,452,595,4418
"42091204002",2580,238,230,73,379,0,253,0,3753
"42091204007",1694,143,92,20,295,19,50,0,2313
"42091204008",2248,24,89,0,372,25,10,0,2768
"42091204009",1092,60,47,1,155,0,85,0,1440
"42091204010",2246,38,171,0,174,0,65,0,2694
"42091204101",3645,245,63,12,66,49,76,10,4166
"42091204102",2942,328,231,15,196,59,60,149,3980
"42091204200",1107,106,25,0,78,6,39,22,1383
"42091204300",2138,84,205,18,231,9,53,0,2738
"42091204400",2842,113,141,2,250,7,118,0,3473
"42091204500",3633,108,182,0,189,0,40,0,4152
"42091204600",3709,114,73,0,381,12,10,0,4299
"42091204701",1842,74,26,0,259,0,0,1,2202
"42091204702",2856,114,43,0,331,0,86,0,3430
"42091204800",4105,103,0,50,577,15,119,15,4984
"42091204900",4135,91,109,16,237,0,163,22,4773
"42091205000",1101,147,166,8,102,19,85,5,1633
"42091205100",934,134,10,15,145,12,6,18,1274
"42091205200",2541,152,13,11,177,32,104,23,3053
"42091205300",966,225,504,171,183,15,212,47,2323
"42091205400",4843,261,220,0,941,40,710,48,7063
"42091205501",2546,219,447,48,224,63,201,0,3748
"42091205502",2850,45,199,0,429,0,103,0,3626
"42091205503",3342,116,328,25,771,29,61,6,4678
"42091205600",3814,148,53,0,243,28,101,0,4387
"42091205700",3092,593,477,68,298,15,180,72,4795
"42091205801",1276,193,190,9,1108,90,152,12,3030
"42091205805",2214,306,102,0,566,70,268,9,3535
"42091205806",1729,143,72,11,193,123,208,127,2606
"42091205807",983,50,143,25,684,26,31,0,1942
"42091205808",3680,178,123,25,1062,184,53,7,5312
"42091205809",2222,52,85,0,342,0,30,8,2739
"42091205903",2132,59,175,0,268,0,30,0,2664
"42091205904",1807,75,175,0,81,1,52,0,2191
"42091205905",2420,78,161,8,821,42,81,8,3619
"42091205906",1347,117,59,5,334,0,178,34,2074
"42091206004",3497,177,210,4,473,43,7,0,4411
"42091206005",3743,162,162,1,250,136,334,0,4788
"42091206006",2422,75,52,0,179,0,31,0,2759
"42091206007",4210,204,188,187,1624,1,47,0,6461
"42091206102",6739,222,434,2,1066,0,196,61,8720
"42091206104",2531,180,22,0,308,41,146,0,3228
"42091206105",4674,68,27,0,403,0,62,0,5234
"42091206106",4325,99,36,30,195,0,155,0,4840
"42091206201",1710,445,79,23,160,8,100,0,2525
"42091206202",2032,102,60,5,22,4,17,0,2242
"42091206300",2947,143,169,0,185,21,22,0,3487
"42091206400",2808,201,85,79,360,0,133,0,3666
"42091206501",3334,46,395,0,530,27,224,12,4568
"42091206502",4074,398,245,0,90,0,86,0,4893
"42091206600",1196,109,7,4,22,5,100,0,1443
"42091206702",26,0,0,0,0,0,0,0,26
"42091206703",3302,100,34,0,292,0,117,0,3845
"42091206704",6685,300,102,0,425,0,94,48,7654
"42091206801",5480,127,310,2,862,36,371,0,7188
"42091206802",2895,20,7,4,216,0,0,1,3143
"42091206901",3563,200,120,52,399,187,311,24,4856
"42091206904",4000,274,396,16,375,0,98,39,5198
"42091206905",4083,75,249,38,811,88,100,0,5444
"42091206906",2377,51,202,0,207,31,101,19,2988
"42091207001",7075,71,92,91,429,58,243,51,8110
"42091207003",2578,47,172,8,154,5,0,0,2964
"42091207004",3706,70,233,3,342,10,90,0,4454
"42091207101",5246,375,97,2,166,90,87,0,6063
"42091207103",3736,106,74,0,166,78,237,9,4406
"42091207104",2595,108,0,18,124,0,0,0,2845
"42091207201",2102,113,81,12,165,0,29,0,2502
"42091207202",3408,291,42,0,400,12,317,70,4540
"42091207300",1912,143,96,137,326,30,225,0,2869
"42091207400",2506,89,0,0,48,15,6,0,2664
"42091207500",3234,42,12,0,0,16,9,0,3313
"42091207600",3536,92,0,3,22,12,42,0,3707
"42091207800",6315,315,40,25,55,0,22,0,6772
"42091207900",2221,141,34,0,103,0,108,0,2607
"42091208000",3067,400,48,4,135,0,103,10,3767
"42091208100",2677,145,40,0,70,5,68,5,3010
"42091208201",2141,115,0,0,9,0,15,0,2280
"42091208203",4109,151,58,2,56,0,43,0,4419
"42091208204",3305,99,159,26,64,0,88,0,3741
"42091208301",2481,67,0,1,68,0,0,0,2617
"42091208302",8151,237,73,1,565,0,384,12,9423
"42091208400",3223,78,72,0,87,6,49,0,3515
"42091208500",4546,142,109,2,81,0,234,0,5114
"42091208601",5260,265,151,1,377,0,288,0,6342
"42091208603",6307,68,327,0,83,0,248,0,7033
"42091208604",4447,253,193,0,714,0,56,37,5700
"42091208702",2949,202,25,0,73,0,26,0,3275
"42091208703",3394,340,88,0,134,0,33,80,4069
"42091208704",3455,106,349,494,357,49,321,42,5173
"42091208801",585,307,179,295,40,17,40,28,1491
"42091208802",2678,550,52,321,144,117,41,146,4049
"42091208901",2660,247,276,120,82,12,69,42,3508
"42091208903",1762,220,522,206,75,62,205,14,3066
"42091208904",1555,341,459,212,302,153,289,101,3412
"42091208905",2289,121,54,0,171,0,141,13,2789
"42091208906",2269,186,709,104,153,49,299,26,3795
"42091209000",754,311,226,245,11,99,18,55,1719
"42091209100",4899,81,252,20,130,0,172,0,5554
"42091209201",1456,106,128,0,31,0,0,0,1721
"42091209202",1459,277,254,57,34,84,145,0,2310
"42091210100",3109,238,185,27,305,82,130,36,4112
"42091210200",2374,26,302,40,67,0,74,0,2883
"42091210300",3102,146,96,14,136,2,188,2,3686
"42091210400",2937,432,706,23,259,0,99,0,4456
"42091210500",3014,114,479,10,241,97,85,60,4100
"42091210600",3256,64,212,1,374,0,241,7,4155
"42091210700",4719,74,26,0,788,13,8,0,5628
"42093050100",3488,343,25,1,23,0,0,0,3880
"42093050200",3022,358,0,1,340,0,0,122,3843
"42093050300",3437,891,59,0,163,19,122,38,4729
"42093050400",5143,261,91,1,100,0,35,13,5644
"42095010100",2954,118,130,43,495,52,952,94,4838
"42095010200",2920,175,198,0,294,0,145,0,3732
"42095010300",2175,98,148,75,237,53,261,63,3110
"42095010400",4510,144,272,2,143,16,395,54,5536
"42095010500",1321,1045,146,399,850,541,1291,1587,7180
"42095010600",5430,511,320,44,803,34,1166,139,8447
"42095010700",3309,503,246,196,640,92,1132,135,6253
"42095010800",1569,458,35,76,65,51,55,179,2488
"42095010900",1870,447,388,61,414,275,1027,494,4976
"42095011000",959,1165,44,104,355,348,415,470,3860
"42095011100",136,71,0,0,0,0,29,12,248
"42095011200",1696,1422,367,330,1000,674,1440,1803,8732
"42095011300",2270,635,231,140,777,574,941,932,6500
"42095014100",2781,169,98,25,245,0,206,6,3530
"42095014200",2795,655,417,245,723,536,699,726,6796
"42095014300",1078,796,437,401,666,280,869,722,5249
"42095014400",1166,289,124,266,154,111,192,290,2592
"42095014500",1208,228,655,198,526,177,225,110,3327
"42095014600",1710,385,605,184,326,71,538,307,4126
"42095014700",1908,63,344,70,226,171,489,159,3430
"42095015201",6142,788,3,1,27,62,38,0,7061
"42095015300",4786,167,27,0,21,18,147,0,5166
"42095015400",2869,191,0,0,31,0,155,12,3258
"42095015500",5583,334,35,43,127,19,152,19,6312
"42095015600",3069,386,34,0,61,0,66,0,3616
"42095015700",2321,291,11,0,89,0,42,29,2783
"42095015801",4943,129,0,0,123,0,9,0,5204
"42095015802",2643,310,18,0,109,0,54,1,3135
"42095015901",5315,343,178,0,2,0,85,0,5923
"42095015902",3283,200,0,0,38,9,122,9,3661
"42095016001",5611,270,0,6,190,0,160,6,6243
"42095016002",3887,296,150,0,48,1,53,1,4436
"42095016100",1755,117,21,0,87,0,97,7,2084
"42095016201",4758,477,20,41,270,0,177,0,5743
"42095016202",3740,213,11,27,332,16,312,28,4679
"42095016300",2537,166,24,10,107,0,28,0,2872
"42095016400",4066,46,131,0,158,0,86,0,4487
"42095016500",4453,107,109,1,198,11,109,11,4999
"42095016600",2192,258,101,40,33,0,166,49,2839
"42095016700",5432,199,40,0,50,0,256,40,6017
"42095016800",4676,455,149,19,134,132,35,19,5619
"42095016901",2935,181,17,0,49,0,0,0,3182
"42095016902",2477,44,0,0,35,8,74,1,2639
"42095017000",1842,40,10,39,122,2,45,0,2100
"42095017101",5424,187,322,55,425,31,985,0,7429
"42095017102",7229,300,461,0,524,24,756,25,9319
"42095017200",4895,350,464,2,677,12,925,195,7520
"42095017300",1975,333,99,22,111,66,141,56,2803
"42095017401",5757,243,824,46,743,43,405,0,8061
"42095017402",3349,53,190,82,172,10,284,16,4156
"42095017501",3074,125,198,67,447,0,112,81,4104
"42095017502",4234,192,265,0,387,44,149,0,5271
"42095017603",3198,182,61,25,238,41,366,47,4158
"42095017604",3851,119,105,20,195,48,585,86,5009
"42095017605",2883,64,184,0,533,31,346,0,4041
"42095017606",4356,71,143,0,315,21,297,6,5209
"42095017607",5248,189,473,43,630,0,439,7,7029
"42095017702",2023,56,72,1,107,0,70,2,2331
"42095017703",2163,150,124,1,208,31,470,22,3169
"42095017704",5085,193,76,1,691,68,659,1,6774
"42095017800",2006,96,211,33,258,22,630,69,3325
"42095017901",3264,295,19,0,37,0,265,0,3880
"42095017902",1992,189,0,0,33,9,34,5,2262
"42095018001",3851,233,0,0,54,0,234,0,4372
"42095018002",6082,292,17,2,194,0,274,1,6862
"42095018100",5596,140,241,11,283,7,46,0,6324
"42095018200",3130,211,0,0,289,0,77,0,3707
"42095018300",4200,356,134,23,119,12,242,55,5141
"42097080100",3865,529,14,8,15,1,67,0,4499
"42097080200",6067,647,138,10,47,36,88,29,7062
"42097080300",5351,1164,82,114,139,28,246,113,7237
"42097080400",2936,439,1,1,50,0,59,0,3486
"42097080500",3082,445,0,8,29,0,83,64,3711
"42097080600",3266,412,6,0,29,15,61,0,3789
"42097080700",2786,260,43,0,121,0,29,11,3250
"42097080800",6625,439,0,0,68,0,44,0,7176
"42097080900",2982,585,0,2,4,0,0,0,3573
"42097081000",2455,709,30,0,49,55,0,55,3353
"42097081100",2215,314,0,0,0,0,91,25,2645
"42097081200",2834,377,2,2,0,0,0,2,3217
"42097081300",1491,426,4,6,82,66,0,14,2089
"42097081400",1557,206,1,2,2,0,3,0,1771
"42097081500",1885,399,0,2,0,40,0,5,2331
"42097081600",2230,679,4,0,50,0,0,0,2963
"42097081700",1497,411,0,0,16,0,0,14,1938
"42097081800",2857,336,10,10,61,3,32,1,3310
"42097081900",5565,247,24,0,58,0,107,0,6001
"42097082000",2734,602,18,9,21,20,90,75,3569
"42097082100",1598,733,28,0,60,117,111,126,2773
"42097082200",2416,739,42,27,135,75,167,65,3666
"42097082300",4488,531,0,2,46,14,64,8,5153
"42097082400",2489,366,3,5,41,0,56,1,2961
"42099030100",4323,328,11,6,80,6,47,6,4807
"42099030201",2266,219,6,0,20,0,20,32,2563
"42099030202",3740,928,65,11,114,43,103,32,5036
"42099030301",4243,289,20,0,143,38,13,0,4746
"42099030302",4314,403,0,4,41,1,51,1,4815
"42099030400",4278,210,13,0,233,21,118,0,4873
"42099030501",4745,382,0,0,83,12,85,0,5307
"42099030502",5256,439,25,7,23,6,71,0,5827
"42099030601",4061,480,30,0,43,12,26,12,4664
"42099030602",2490,489,7,10,38,11,22,3,3070
"42101000100",2415,308,304,65,397,38,143,45,3715
"42101000200",638,85,60,46,1033,299,33,0,2194
"42101000300",2388,265,122,20,385,58,341,52,3631
"42101000401",1327,202,187,144,376,330,42,118,2726
"42101000402",2521,240,62,0,157,87,50,0,3117
"42101000500",551,189,78,175,319,90,15,27,1444
"42101000600",574,169,28,13,130,31,45,0,990
"42101000700",1644,380,229,112,322,396,167,55,3305
"42101000801",1147,180,169,55,196,17,36,24,1824
"42101000803",2821,522,0,17,318,10,85,0,3773
"42101000804",2998,197,82,17,431,60,511,0,4296
"42101000901",1042,221,91,67,325,107,90,29,1972
"42101000902",1328,214,66,33,234,190,37,23,2125
"42101001001",1859,224,9,18,290,0,49,0,2449
"42101001002",2956,107,7,16,243,11,178,8,3526
"42101001101",2268,344,88,36,167,0,214,15,3132
"42101001102",1802,344,88,10,126,48,83,0,2501
"42101001201",3435,148,34,9,274,112,139,2,4153
"42101001202",3645,470,267,0,390,37,293,87,5189
"42101001300",2786,252,1356,310,821,37,98,1,5661
"42101001400",2546,292,641,134,708,51,160,78,4610
"42101001500",1664,175,181,203,443,43,123,9,2841
"42101001600",1601,142,76,0,86,0,68,0,1973
"42101001700",2094,148,176,23,379,0,154,8,2982
"42101001800",1950,126,362,167,392,10,212,1,3220
"42101001900",1372,77,798,211,163,20,83,24,2748
"42101002000",350,28,1273,392,48,28,27,1,2147
"42101002100",446,61,1191,359,90,0,60,0,2207
"42101002200",520,61,748,707,179,105,43,43,2406
"42101002300",2058,164,52,1,330,112,322,16,3055
"42101002400",3679,192,202,296,928,64,946,67,6374
"42101002500",1996,129,654,386,330,40,238,42,3815
"42101002701",1635,46,617,442,714,306,474,6,4240
"42101002702",3255,131,160,18,246,18,220,8,4056
"42101002801",1879,371,128,127,1567,500,1014,271,5857
"42101002802",3368,483,0,18,1466,197,298,53,5883
"42101002900",3095,378,17,0,513,237,188,232,4660
"42101003001",998,247,883,75,1884,462,347,84,4980
"42101003002",504,171,1617,665,264,24,91,1,3337
"42101003100",280,85,2286,822,124,255,11,28,3891
"42101003200",270,256,2880,1241,28,70,28,0,4773
"42101003300",1009,537,2458,2144,251,163,142,88,6792
"42101003600",1115,240,1670,2737,649,936,98,740,8185
"42101003701",364,198,2605,1669,783,218,564,178,6579
"42101003702",1115,181,1441,161,556,275,177,47,3953
"42101003800",3551,186,36,1,31,0,70,11,3886
"42101003901",3774,825,445,16,1412,195,277,81,7025
"42101003902",5056,412,66,0,456,0,61,0,6051
"42101004001",3093,466,121,17,381,212,290,20,4600
"42101004002",4174,204,0,0,407,0,391,0,5176
"42101004101",1754,531,1062,187,1126,1857,438,427,7382
"42101004102",2531,2139,626,531,2715,880,745,804,10971
"42101004201",3759,489,317,73,173,848,145,0,5804
"42101004202",3160,797,230,69,619,309,179,221,5584
"42101005000",0,0,0,0,0,0,0,0,0
"42101005400",170,48,778,66,152,16,27,17,1274
"42101005500",646,55,4456,952,73,185,44,17,6428
"42101005600",75,0,615,348,54,24,7,7,1130
"42101006000",1085,59,3563,1245,332,151,128,11,6574
"42101006100",401,53,1993,586,263,218,59,15,3588
"42101006200",420,20,2820,1341,181,0,128,0,4910
"42101006300",281,226,1508,1236,377,204,138,153,4123
"42101006400",136,133,2065,702,204,304,11,10,3565
"42101006500",82,9,2423,1463,150,67,145,0,4339
"42101006600",76,18,1929,794,121,422,0,0,3360
"42101006700",535,340,3504,1316,106,703,230,183,6917
"42101006900",6,24,1245,904,0,74,0,92,2345
"42101007000",27,90,2481,970,13,179,13,12,3785
"42101007101",0,90,2200,552,43,9,0,46,2940
"42101007102",58,0,3037,1608,8,51,16,0,4778
"42101007200",84,23,2651,1570,25,4,40,0,4397
"42101007300",82,0,1656,816,55,0,13,0,2622
"42101007400",230,190,2487,1427,75,45,43,28,4525
"42101007700",278,357,328,114,117,284,14,24,1516
"42101007800",1721,410,692,277,467,168,147,44,3926
"42101007900",2090,262,1141,415,552,114,152,15,4741
"42101008000",455,113,2073,893,186,210,144,70,4144
"42101008101",0,8,1626,754,19,41,18,8,2474
"42101008102",0,2,3811,1520,112,56,117,0,5618
"42101008200",13,4,5619,1566,65,23,3,2,7295
"42101008301",0,39,2972,926,62,66,47,1,4113
"42101008302",12,1,2617,1210,95,120,67,11,4133
"42101008400",84,59,2592,2162,101,93,0,131,5222
"42101008500",211,103,4813,1839,26,0,75,129,7196
"42101008601",1394,162,454,524,282,36,20,18,2890
"42101008602",340,163,1246,933,98,113,49,158,3100
"42101008701",1651,1155,499,57,1002,928,306,479,6077
"42101008702",808,875,168,480,677,377,38,89,3512
"42101008801",110,85,0,19,63,87,0,35,399
"42101008802",309,2456,229,297,375,964,93,262,4985
"42101009000",519,1166,79,88,249,492,59,60,2712
"42101009100",557,281,502,741,269,325,44,8,2727
"42101009200",214,213,1210,1089,223,258,10,0,3217
"42101009300",98,7,2567,1191,64,9,98,0,4034
"42101009400",7,34,2263,1666,85,51,26,33,4165
"42101009500",0,20,1690,1407,40,29,3,13,3202
"42101009600",53,25,2793,1331,65,52,44,32,4395
"42101009801",398,11,1386,413,77,57,4,16,2362
"42101009802",592,42,4175,970,147,0,59,0,5985
"42101010000",437,75,2775,1438,66,10,22,13,4836
"42101010100",140,369,3200,1397,206,39,167,431,5949
"42101010200",18,0,1167,1828,24,0,34,34,3105
"42101010300",7,0,1528,792,0,165,7,108,2607
"42101010400",46,45,2343,993,24,8,14,30,3503
"42101010500",95,27,2048,1115,37,40,134,0,3496
"42101010600",6,68,512,761,25,26,6,22,1426
"42101010700",108,0,1543,1449,138,75,57,67,3437
"42101010800",116,95,1423,1880,78,10,18,0,3620
"42101010900",114,173,947,905,25,83,19,4,2270
"42101011000",185,37,1556,1429,71,0,124,13,3415
"42101011100",38,92,1660,1435,9,45,0,87,3366
"42101011200",12,19,3119,1724,45,0,123,2,5044
"42101011300",0,0,1890,1094,0,9,0,1,2994
"42101011400",40,72,5381,1763,210,37,83,40,7626
"42101011500",372,81,3241,814,105,68,111,0,4792
"42101011700",203,248,447,24,83,15,11,30,1061
"42101011800",111,24,4961,579,410,86,291,0,6462
"42101011900",2,9,3154,1440,188,104,57,138,5092
"42101012000",289,81,872,153,147,9,53,0,1604
"42101012100",189,250,1386,386,149,92,73,25,2550
"42101012201",406,661,809,322,380,573,85,68,3304
"42101012203",229,260,172,198,158,53,25,0,1095
"42101012204",660,154,1391,521,95,161,12,23,3017
"42101012500",3574,708,220,33,407,90,241,37,5310
"42101013100",324,52,736,200,169,19,52,10,1562
"42101013200",66,126,1555,834,66,42,50,53,2792
"42101013300",1157,393,1102,604,158,261,239,169,4083
"42101013401",2073,107,45,21,139,0,39,16,2440
"42101013402",2001,269,189,94,271,22,147,178,3171
"42101013500",1610,99,788,350,303,220,308,229,3907
"42101013601",2103,27,295,0,281,55,22,11,2794
"42101013602",2810,241,351,291,244,20,67,13,4037
"42101013700",845,185,1856,1408,61,57,151,0,4563
"42101013800",367,44,1229,500,55,45,106,17,2363
"42101013900",248,55,874,1593,80,46,92,58,3046
"42101014000",280,524,1188,698,67,50,59,25,2891
"42101014100",235,227,883,467,238,126,83,81,2340
"42101014200",2561,207,289,47,457,54,553,59,4227
"42101014300",1138,191,30,1,232,20,113,39,1764
"42101014400",1362,387,242,199,700,432,752,540,4614
"42101014500",109,53,845,238,307,58,378,113,2101
"42101014600",116,78,1440,459,14,89,44,0,2240
"42101014700",89,955,950,606,150,216,8,69,3043
"42101014800",0,97,565,334,10,8,6,0,1020
"42101014900",52,54,1817,869,134,293,35,293,3547
"42101015101",51,32,1005,822,3,70,0,43,2026
"42101015102",1,29,1452,1790,149,54,96,42,3613
"42101015200",12,275,2199,3330,131,100,134,150,6331
"42101015300",227,1505,817,463,38,128,0,62,3240
"42101015600",325,323,168,136,642,387,786,555,3322
"42101015700",896,468,51,20,979,225,1097,297,4033
"42101015800",4366,1260,96,3,142,0,99,59,6025
"42101016000",4778,885,96,18,451,193,252,70,6743
"42101016100",1828,786,270,141,896,778,747,760,6206
"42101016200",288,356,257,225,545,535,880,954,4040
"42101016300",337,857,288,136,671,1556,679,2169,6693
"42101016400",165,482,891,1687,704,614,986,1298,6827
"42101016500",81,15,596,947,219,207,313,225,2603
"42101016600",101,212,599,567,33,16,45,29,1602
"42101016701",0,24,1591,1256,35,14,0,0,2920
"42101016702",0,239,1730,892,42,27,0,27,2957
"42101016800",152,20,2542,1390,89,0,13,14,4220
"42101016901",8,50,1872,1322,54,23,0,3,3332
"42101016902",73,86,3662,1967,10,0,83,319,6200
"42101017000",452,102,1598,653,123,29,67,33,3057
"42101017100",10,81,2705,1107,44,89,0,127,4163
"42101017201",21,49,1603,1602,37,63,19,5,3399
"42101017202",7,151,1827,1295,0,61,0,133,3474
"42101017300",20,15,1526,1423,12,0,59,41,3096
"42101017400",0,15,1097,978,0,121,0,136,2347
"42101017500",657,1013,1296,1187,999,2031,1740,3327,12250
"42101017601",1102,714,109,602,1180,2205,2153,3263,11328
"42101017602",559,800,234,312,716,1285,1225,2006,7137
"42101017701",545,487,492,744,1085,584,1594,750,6281
"42101017702",646,1219,552,885,632,2373,975,3614,10896
"42101017800",851,1123,833,918,1104,1855,1243,2259,10186
"42101017900",2456,714,1795,1182,162,898,678,1014,8899
"42101018001",1687,529,0,36,119,1,106,3,2481
"42101018002",4356,865,0,1,0,280,0,443,5945
"42101018300",3182,582,13,2,0,13,19,1,3812
"42101018400",2070,278,0,2,88,59,87,35,2619
"42101018800",1780,2037,841,1867,690,1392,1519,2558,12684
"42101019000",1590,1132,1108,541,2098,1490,3023,2279,13261
"42101019100",2326,1229,671,496,2625,1050,3175,1590,13162
"42101019200",907,1805,1901,1543,1673,1321,2166,3262,14578
"42101019501",674,952,131,476,948,1364,1618,2292,8455
"42101019502",404,1494,474,188,529,656,855,1803,6403
"42101019700",789,475,1351,1947,1069,1274,1996,2018,10919
"42101019800",438,750,1570,767,1404,1648,2000,2445,11022
"42101019900",437,659,1018,876,551,1345,950,2107,7943
"42101020000",139,21,526,454,38,77,173,58,1486
"42101020101",17,24,2536,1195,0,74,104,0,3950
"42101020102",14,122,2267,828,0,119,12,96,3458
"42101020200",73,68,3177,1418,0,0,0,8,4744
"42101020300",10,33,1547,1232,16,23,6,26,2893
"42101020400",6,7,1740,664,12,109,0,62,2600
"42101020500",200,40,1664,419,137,86,119,23,2688
"42101020600",628,164,411,205,160,88,95,9,1760
"42101020700",3712,378,665,49,387,0,150,95,5436
"42101020800",730,193,561,135,140,103,25,10,1897
"42101020900",2394,314,52,42,151,9,91,7,3060
"42101021000",3570,1077,249,37,115,33,108,1,5190
"42101021100",1822,191,140,18,195,34,70,0,2470
"42101021200",1757,302,186,2,296,43,193,0,2779
"42101021300",2839,320,119,21,107,25,107,10,3548
"42101021400",2625,839,457,44,13,7,87,120,4192
"42101021500",3054,400,77,5,203,133,95,34,4001
"42101021600",1440,407,79,23,156,0,50,0,2155
"42101021700",5250,344,644,21,288,0,75,0,6622
"42101021800",2273,702,557,65,466,214,74,109,4460
"42101021900",1262,65,104,61,74,12,9,0,1587
"42101022000",1203,46,238,2,153,0,109,1,1752
"42101023100",1237,7,0,0,25,0,68,0,1337
"42101023500",629,12,349,40,190,56,0,0,1276
"42101023600",1951,64,520,213,115,55,46,55,3019
"42101023700",1242,79,2371,363,594,28,141,28,4846
"42101023800",991,63,2346,519,169,124,102,79,4393
"42101023900",279,62,650,159,95,15,76,19,1355
"42101024000",847,286,1461,663,271,174,148,37,3887
"42101024100",171,124,437,349,25,14,0,59,1179
"42101024200",317,161,2181,833,175,59,136,17,3879
"42101024300",415,90,2082,1321,26,39,58,6,4037
"42101024400",74,66,1797,741,37,0,0,0,2715
"42101024500",92,84,2268,1042,96,0,46,67,3695
"42101024600",246,35,1475,1022,48,67,20,37,2950
"42101024700",199,72,2050,2194,186,24,43,37,4805
"42101024800",10,18,1555,399,69,0,7,11,2069
"42101024900",0,24,1836,951,0,75,0,81,2967
"42101025200",349,72,4355,2191,58,0,22,0,7047
"42101025300",209,17,2278,1030,194,110,34,54,3926
"42101025400",417,25,2980,447,307,53,76,54,4359
"42101025500",661,90,1790,135,247,0,266,0,3189
"42101025600",1256,127,1055,170,80,37,24,33,2782
"42101025700",2081,126,956,119,224,105,227,0,3838
"42101025800",29,0,1455,76,4,0,21,0,1585
"42101025900",45,13,3925,976,166,0,16,0,5141
"42101026000",111,49,2444,306,42,34,26,34,3046
"42101026100",40,47,2959,293,0,0,7,44,3390
"42101026200",79,0,3900,534,52,0,50,0,4615
"42101026301",40,0,3497,715,60,23,0,0,4335
"42101026302",154,60,4462,1012,213,15,123,101,6140
"42101026400",69,2,4588,785,159,2,183,1,5789
"42101026500",78,3,3774,1025,85,0,69,3,5037
"42101026600",19,2,4927,1308,163,13,46,1,6479
"42101026700",154,0,4923,1364,15,0,96,0,6552
"42101026800",136,45,3371,792,408,57,83,8,4900
"42101026900",348,31,1144,243,145,0,147,13,2071
"42101027000",265,39,1633,319,378,28,9,0,2671
"42101027100",103,105,1229,655,727,123,143,51,3136
"42101027200",229,92,3293,561,475,69,81,58,4858
"42101027300",720,108,3486,553,2237,320,928,65,8417
"42101027401",240,59,1421,319,815,497,148,0,3499
"42101027402",358,197,3309,559,2583,387,1676,203,9272
"42101027500",389,145,2746,540,578,569,412,387,5766
"42101027600",53,1,2440,1021,164,28,1,0,3708
"42101027700",71,5,3241,1247,141,186,50,60,5001
"42101027800",176,144,2905,1192,18,0,138,110,4683
"42101027901",89,5,2339,1345,54,727,152,0,4711
"42101027902",82,479,1277,789,93,174,43,189,3126
"42101028000",18,31,2713,1490,0,9,121,21,4403
"42101028100",89,101,2852,711,10,38,79,32,3912
"42101028200",193,31,2984,1143,253,140,134,132,5010
"42101028300",219,147,3240,1950,137,395,152,272,6512
"42101028400",148,315,1985,1703,455,335,461,604,6006
"42101028500",432,184,885,439,577,477,832,364,4190
"42101028600",847,64,2552,1848,1504,1160,2027,1093,11095
"42101028700",412,223,378,269,675,700,1057,869,4583
"42101028800",770,506,675,128,1610,725,1475,1045,6934
"42101028901",500,108,443,576,1728,1072,1788,1043,7258
"42101028902",709,779,1570,725,2356,1189,2351,1700,11379
"42101029000",605,328,2029,626,2072,1349,1527,1168,9704
"42101029100",670,118,987,592,838,655,388,481,4729
"42101029200",991,216,1384,185,904,208,821,266,4975
"42101029300",757,225,655,661,384,456,568,536,4242
"42101029400",539,397,620,794,179,262,505,417,3713
"42101029800",1685,782,866,720,826,246,1047,487,6659
"42101029900",701,597,1224,1031,271,197,365,725,5111
"42101030000",1166,642,2667,1855,871,307,1008,526,9042
"42101030100",1581,452,1952,653,386,63,520,90,5697
"42101030200",1404,627,2392,600,1515,135,1471,520,8664
"42101030501",648,747,1844,1215,1071,126,846,601,7098
"42101030502",860,348,2658,685,1039,887,694,677,7848
"42101030600",2806,394,1592,384,1537,1042,1343,524,9622
"42101030700",1653,452,1368,232,397,20,338,10,4470
"42101030800",2976,249,372,15,848,443,647,229,5779
"42101030900",840,552,1256,370,964,530,824,526,5862
"42101031000",2797,802,1825,381,2268,476,1146,25,9720
"42101031101",1274,619,1621,494,1031,357,983,517,6896
"42101031102",767,88,2227,248,609,247,442,231,4859
"42101031200",808,518,1731,683,775,489,997,310,6311
"42101031300",2273,445,990,555,1062,628,601,555,7109
"42101031401",1845,670,1546,59,2594,653,1489,428,9284
"42101031402",2439,586,816,180,1136,541,633,277,6608
"42101031501",4215,610,106,118,755,368,516,127,6815
"42101031502",2502,368,216,8,429,97,374,41,4035
"42101031600",3632,652,515,207,449,581,473,490,6999
"42101031700",3074,239,1230,295,1054,243,1105,240,7480
"42101031800",1149,285,1681,235,693,117,708,116,4984
"42101031900",1932,571,991,80,541,72,820,348,5355
"42101032000",4498,689,713,253,607,231,893,190,8074
"42101032100",1827,478,952,280,359,46,599,247,4788
"42101032300",1852,394,607,140,274,29,396,50,3742
"42101032500",3056,658,576,632,222,724,414,679,6961
"42101032600",3492,689,889,355,680,223,1063,109,7500
"42101032900",1736,556,474,107,256,326,303,122,3880
"42101033000",4303,2060,672,254,287,59,685,411,8731
"42101033101",4256,150,131,13,155,81,285,29,5100
"42101033102",3018,252,104,16,75,97,67,6,3635
"42101033200",2244,229,0,8,116,63,54,14,2728
"42101033300",2555,306,497,126,256,59,230,47,4076
"42101033400",2684,347,816,194,587,491,315,194,5628
"42101033500",1829,328,588,88,616,472,710,184,4815
"42101033600",4793,546,422,141,1202,124,729,67,8024
"42101033701",3397,830,103,117,315,92,192,28,5074
"42101033702",3561,150,291,0,1078,214,313,110,5717
"42101033800",4219,420,735,33,864,114,471,18,6874
"42101033900",2073,227,321,128,269,31,127,31,3207
"42101034000",1951,208,227,5,474,73,281,44,3263
"42101034100",4514,731,279,63,151,0,294,101,6133
"42101034200",2428,204,388,46,307,142,124,46,3685
"42101034400",5990,312,219,50,1208,0,308,0,8087
"42101034501",1600,1030,260,30,682,17,129,434,4182
"42101034502",2814,270,384,24,991,36,528,0,5047
"42101034600",1268,223,614,90,518,0,305,36,3054
"42101034701",3621,545,394,100,1757,145,507,165,7234
"42101034702",3363,16,285,12,397,0,178,0,4251
"42101034801",3410,317,204,197,200,86,150,30,4594
"42101034802",3603,281,863,508,196,47,331,0,5829
"42101034803",3804,235,270,12,192,0,265,11,4789
"42101034900",3141,865,620,82,270,0,364,53,5395
"42101035100",3123,231,114,0,70,0,84,0,3622
"42101035200",3431,173,42,18,393,24,287,5,4373
"42101035301",4585,392,91,58,232,166,240,238,6002
"42101035302",3429,374,267,90,100,19,160,0,4439
"42101035500",5022,883,117,53,979,68,332,19,7473
"42101035601",4452,422,47,1,505,66,257,66,5816
"42101035602",1951,157,117,30,909,48,59,11,3282
"42101035701",2115,676,309,105,1122,218,170,0,4715
"42101035702",2976,538,0,67,453,0,182,0,4216
"42101035800",4986,657,594,0,480,24,255,0,6996
"42101035900",3692,575,238,0,610,0,29,0,5144
"42101036000",1562,201,217,62,750,0,45,0,2837
"42101036100",2659,288,742,77,119,106,50,143,4184
"42101036201",4288,155,408,43,87,0,132,0,5113
"42101036202",4699,196,421,118,491,196,484,116,6721
"42101036203",4458,472,0,23,270,66,164,77,5530
"42101036301",2495,300,114,0,568,0,237,0,3714
"42101036302",2021,465,464,109,251,8,206,217,3741
"42101036303",5603,235,0,0,272,87,124,0,6321
"42101036400",163,94,56,107,58,19,11,19,527
"42101036501",3840,444,595,181,252,42,138,113,5605
"42101036502",3703,205,0,4,119,0,94,0,4125
"42101036600",1204,61,112,0,321,7,46,22,1773
"42101036700",1883,106,488,0,82,23,167,23,2772
"42101036900",493,141,74,13,169,289,36,12,1227
"42101037200",2921,307,161,12,515,292,144,17,4369
"42101037300",4181,196,271,38,433,36,187,30,5372
"42101037500",1423,477,1381,221,163,64,88,47,3864
"42101037600",974,272,330,316,465,242,254,104,2957
"42101037700",301,477,1324,760,96,551,327,630,4466
"42101037800",1284,461,227,45,52,18,104,45,2236
"42101037900",4328,507,11,142,15,36,93,98,5230
"42101038000",1559,423,60,26,302,17,373,109,2869
"42101038100",363,221,169,75,13,19,55,45,960
"42101038200",1149,232,213,184,362,142,500,63,2845
"42101038300",448,501,404,621,825,766,1242,1200,6007
"42101038400",1971,107,163,43,168,0,66,4,2522
"42101038500",1513,95,93,27,136,14,51,0,1929
"42101038600",1095,71,158,7,36,14,34,0,1415
"42101038700",1351,132,78,21,150,0,65,0,1797
"42101038800",1968,91,1213,195,255,41,79,13,3855
"42101038900",163,132,2322,684,11,34,9,38,3393
"42101039000",1392,615,3117,1597,631,499,1016,990,9857
"42101980000",95,0,4,2,32,0,0,0,133
"42101980100",61,0,0,0,0,0,4,0,65
"42101980200",86,17,0,6,17,0,0,0,126
"42101980300",0,0,0,0,0,0,0,0,0
"42101980400",0,0,0,0,0,0,0,0,0
"42101980500",0,0,0,0,0,0,0,0,0
"42101980600",0,0,0,0,0,0,0,0,0
"42101980700",0,0,0,0,0,0,0,0,0
"42101980800",0,0,0,0,0,0,0,0,0
"42101980900",5,0,0,0,0,0,0,0,5
"42101989100",25,21,21,52,11,12,11,0,153
"42103950102",2051,272,24,0,41,13,180,31,2612
"42103950103",1936,271,0,19,92,9,129,55,2511
"42103950104",2111,170,14,0,48,0,119,24,2486
"42103950201",2909,247,148,1,162,0,155,44,3666
"42103950202",1339,59,79,0,57,0,54,0,1588
"42103950301",2229,242,0,0,23,0,24,0,2518
"42103950302",733,50,0,0,20,0,0,0,803
"42103950501",863,101,114,0,44,0,60,0,1182
"42103950502",2696,168,185,0,266,12,274,27,3628
"42103950601",1344,61,30,0,70,8,57,5,1575
"42103950603",897,96,0,0,5,0,18,10,1026
"42103950605",5098,334,303,91,101,73,570,0,6570
"42103950606",5010,133,52,0,474,76,497,76,6318
"42103950701",3168,387,12,0,93,17,146,18,3841
"42103950702",2778,409,108,0,136,83,110,0,3624
"42103950801",3450,602,685,61,276,57,756,89,5976
"42103950802",3108,715,960,47,477,99,1398,285,7089
"42103950900",3751,416,0,9,66,74,101,74,4491
"42105950100",4182,832,6,4,54,17,48,0,5143
"42105950200",2680,433,14,0,17,2,8,0,3154
"42105950300",3293,393,17,6,99,6,46,4,3864
"42105950400",2553,424,0,0,56,0,60,0,3093
"42105950500",1693,346,7,0,6,12,0,0,2064
"42107000100",4199,481,11,18,78,59,84,57,4987
"42107000200",2140,330,19,5,86,45,195,56,2876
"42107000300",4946,139,0,0,138,0,138,25,5386
"42107000400",2000,188,2,0,4,0,19,4,2217
"42107000500",2844,1005,0,173,87,17,65,96,4287
"42107000601",2105,1202,90,0,93,78,444,242,4254
"42107000602",689,193,68,0,160,143,230,84,1567
"42107000700",2816,583,0,0,64,10,62,3,3538
"42107000800",2975,578,21,0,26,7,95,0,3702
"42107000900",5584,404,0,4,0,19,66,31,6108
"42107001000",2261,434,0,0,0,73,0,64,2832
"42107001100",2140,144,10,0,18,0,6,0,2318
"42107001200",3850,237,0,0,66,0,14,0,4167
"42107001300",2443,589,0,0,27,0,20,0,3079
"42107001400",2067,140,0,7,9,23,22,0,2268
"42107001500",3426,697,1,0,169,25,97,0,4415
"42107001600",3529,237,11,21,29,0,6,21,3854
"42107001700",2787,246,46,1,40,0,0,0,3120
"42107001800",1892,306,6,13,74,59,0,0,2350
"42107001900",3146,1202,128,18,238,14,58,241,5045
"42107002000",2285,468,74,163,104,116,53,71,3334
"42107002100",1352,138,0,2,74,0,29,3,1598
"42107002200",2519,249,6,14,30,6,5,46,2875
"42107002300",2436,397,0,68,18,0,0,0,2919
"42107002400",2122,222,0,0,37,0,24,0,2405
"42107002500",1843,389,3,0,33,0,39,2,2309
"42107002600",2787,1158,35,0,0,0,29,79,4088
"42107002700",2416,529,0,0,18,0,88,131,3182
"42107002800",1518,671,0,0,38,0,23,108,2358
"42107002900",4974,300,3,0,25,28,5,0,5335
"42107003000",4907,479,27,11,72,1,63,7,5567
"42107003100",2442,81,42,0,130,83,14,10,2802
"42107003200",5035,313,9,11,126,3,115,3,5615
"42107003300",4360,941,0,0,29,0,31,0,5361
"42107003400",3230,201,5,0,32,0,84,7,3559
"42107003500",4702,352,0,0,30,13,86,33,5216
"42107003600",2696,200,3,65,4,25,31,0,3024
"42107003700",2996,358,9,0,116,4,96,0,3579
"42107003800",1817,91,26,13,26,132,43,0,2148
"42107003900",3852,217,0,0,38,0,0,0,4107
"42109070100",5038,292,36,0,185,11,98,4,5664
"42109070200",7257,733,30,9,89,101,248,17,8484
"42109070300",4585,788,66,1,75,23,28,0,5566
"42109070400",4765,697,14,0,35,15,27,7,5560
"42109070500",3270,434,0,0,45,2,21,0,3772
"42109070600",4800,478,0,0,74,0,111,0,5463
"42109070701",2874,516,43,0,73,9,104,6,3625
"42109980705",92,11,24,0,0,19,0,19,165
"42111020101",1766,196,0,0,0,0,16,4,1982
"42111020102",4791,424,53,0,89,0,12,0,5369
"42111020200",4050,199,0,0,41,0,36,0,4326
"42111020300",3369,488,0,8,105,108,30,7,4115
"42111020400",3230,429,6,0,54,0,16,16,3751
"42111020500",2424,444,0,0,10,0,0,0,2878
"42111020600",5297,645,0,24,63,16,17,10,6072
"42111020700",2626,238,2,0,1,3,15,0,2885
"42111020800",3453,450,6,33,37,0,0,0,3979
"42111020900",3908,551,0,5,38,2,45,10,4559
"42111021000",3137,701,13,0,97,17,13,35,4013
"42111021100",1311,695,0,0,17,0,66,0,2089
"42111021200",2489,385,3,0,22,0,2,0,2901
"42111021300",3035,441,8,0,1,0,11,0,3496
"42111021400",3747,460,0,0,45,21,45,0,4318
"42111021500",2292,338,0,6,26,0,28,0,2690
"42111021600",1646,313,0,0,16,0,0,0,1975
"42111021700",2556,398,0,2,16,0,11,35,3018
"42111021800",3152,333,0,4,43,5,15,0,3552
"42111021901",2139,341,0,26,11,4,0,2,2523
"42111021902",2017,452,4,0,7,1,17,4,2502
"42113960100",3210,480,5,103,10,14,65,5,3892
"42113960200",1971,236,0,57,110,30,6,2,2412
"42115032000",2825,265,0,0,61,0,31,0,3182
"42115032100",3573,417,0,0,81,0,48,0,4119
"42115032200",3492,509,22,0,9,0,18,0,4050
"42115032300",2658,794,7,0,67,33,74,28,3661
"42115032400",3565,366,23,11,58,41,20,0,4084
"42115032500",3778,438,70,7,34,27,75,58,4487
"42115032600",3831,481,17,0,27,0,37,35,4428
"42115032700",3078,367,10,4,39,4,109,9,3620
"42115032800",4477,660,15,0,49,5,54,0,5260
"42115032901",3458,484,5,0,12,10,15,13,3997
"42115032902",1500,411,0,0,35,20,0,33,1999
"42117950100",3577,502,23,3,64,0,19,1,4189
"42117950200",2923,575,12,8,31,35,17,8,3609
"42117950300",2953,639,5,4,14,45,18,2,3680
"42117950400",3520,543,5,1,49,6,39,14,4177
"42117950500",4073,611,0,0,47,22,30,10,4793
"42117950600",3985,1118,0,0,97,12,126,10,5348
"42117950700",4344,699,0,7,107,14,4,0,5175
"42117950800",2551,421,6,0,97,33,59,74,3241
"42117950900",3437,481,0,0,83,46,25,5,4077
"42117951000",2561,362,10,0,48,12,14,18,3025
"42119090102",5388,667,5,35,9,9,24,6,6143
"42119090200",5340,811,36,0,18,14,87,13,6319
"42119090300",3223,314,106,0,24,13,0,22,3702
"42119090400",3896,282,35,77,54,0,239,0,4583
"42119090502",5703,618,296,69,241,48,147,1,7123
"42119090600",4346,344,0,0,227,0,91,87,5095
"42119090700",2405,819,17,56,47,28,0,195,3567
"42119980101",7,0,0,0,0,0,0,0,7
"42119980501",51,0,0,0,0,0,0,0,51
"42119980800",46,13,0,0,0,0,0,0,59
"42121200000",2955,420,0,0,38,22,9,11,3455
"42121200100",3625,298,9,0,57,6,11,2,4008
"42121200200",4913,743,9,10,94,12,39,0,5820
"42121200300",1260,348,6,4,65,0,3,63,1749
"42121200400",1665,334,30,3,99,25,62,31,2249
"42121200500",1898,373,20,4,47,7,59,0,2408
"42121200600",4302,666,14,0,5,108,0,0,5095
"42121200700",1229,546,5,10,30,61,11,15,1907
"42121200800",1716,418,61,0,58,0,12,0,2265
"42121200900",1243,1254,22,13,10,22,29,3,2596
"42121201000",2661,638,3,5,39,6,0,0,3352
"42121201100",3951,466,1,5,72,22,15,12,4544
"42121201200",2550,270,0,0,28,27,16,0,2891
"42121201300",3257,376,0,0,51,0,0,0,3684
"42121201400",3357,463,1,12,38,33,39,10,3953
"42121201500",3028,398,4,2,111,57,8,43,3651
"42123970100",1990,323,6,10,17,8,0,0,2354
"42123970200",3601,235,13,0,60,0,40,0,3949
"42123970300",4587,959,3,0,60,76,29,90,5804
"42123970400",2438,263,6,1,27,20,4,1,2760
"42123970500",2882,405,3,2,62,39,13,9,3415
"42123970600",3128,196,17,1,53,6,0,2,3403
"42123970700",2407,186,26,0,19,0,48,0,2686
"42123970800",2566,456,0,26,11,48,10,0,3117
"42123970900",2678,768,10,0,12,0,19,0,3487
"42123971000",2002,245,0,0,15,11,12,0,2285
"42123971100",2679,175,0,2,38,0,15,0,2909
"42123971200",2016,458,0,5,2,0,4,0,2485
"42123971400",1528,292,0,3,35,5,0,0,1863
"42125704100",347,255,146,45,49,80,22,4,948
"42125711000",3694,208,0,7,37,38,58,0,4042
"42125712700",1215,143,15,3,5,0,29,0,1410
"42125713700",3879,492,0,0,24,0,19,0,4414
"42125714000",2367,277,26,0,48,9,5,9,2741
"42125715700",1313,220,49,0,17,0,65,5,1669
"42125721000",3798,357,18,4,54,20,17,15,4283
"42125722700",3360,153,6,0,4,0,54,0,3577
"42125731000",5479,517,13,0,63,1,52,0,6125
"42125732000",3140,161,0,0,30,0,21,0,3352
"42125741100",4127,107,20,1,138,1,66,1,4461
"42125741300",3131,151,6,0,79,0,8,0,3375
"42125742100",5193,258,226,0,32,28,0,0,5737
"42125742200",1734,81,0,0,0,23,144,39,2021
"42125743700",1003,148,58,8,14,6,16,0,1253
"42125744100",4661,441,190,98,327,8,56,0,5781
"42125744200",2476,330,169,55,193,5,116,26,3370
"42125745100",7701,298,338,0,301,24,112,0,8774
"42125745200",4526,118,57,11,113,39,110,0,4974
"42125746100",5586,103,46,0,121,0,27,0,5883
"42125746200",3935,196,7,0,227,0,75,12,4452
"42125746301",5008,78,11,0,102,0,140,0,5339
"42125746302",5407,170,0,0,322,0,135,0,6034
"42125751100",4400,448,104,27,0,90,0,0,5069
"42125751200",2456,486,74,142,4,0,41,39,3242
"42125752700",3867,324,62,1,95,58,125,74,4606
"42125753700",1561,103,27,11,0,55,42,30,1829
"42125754200",1419,374,222,32,19,0,34,0,2100
"42125754300",1543,460,613,304,63,117,31,0,3131
"42125754400",890,403,283,98,67,90,5,16,1852
"42125754500",1976,334,69,52,71,106,1,0,2609
"42125754600",1328,305,144,45,28,11,0,12,1873
"42125755100",3625,319,62,70,8,5,13,0,4102
"42125755200",4891,239,68,0,39,0,0,9,5246
"42125755700",3580,64,0,0,40,0,7,0,3691
"42125761000",5012,419,0,0,78,14,41,1,5565
"42125762000",2290,349,26,33,35,14,0,18,2765
"42125763700",1474,149,67,52,14,11,10,0,1777
"42125764000",2376,750,23,3,96,53,21,0,3322
"42125771100",4897,553,0,0,140,27,0,27,5644
"42125771200",3110,406,7,2,34,0,10,3,3572
"42125772700",1768,232,8,11,40,95,24,1,2179
"42125773100",2229,509,103,13,36,50,35,25,3000
"42125773200",1092,119,53,17,0,0,3,0,1284
"42125774700",5093,208,140,0,53,0,132,0,5626
"42125775200",1311,581,298,6,98,13,0,12,2319
"42125775300",1366,431,250,61,197,48,62,0,2415
"42125781700",3535,465,184,0,40,70,34,0,4328
"42125782700",941,160,64,15,48,16,7,10,1261
"42125783200",1690,482,10,120,0,0,0,0,2302
"42125783300",1260,448,9,0,5,9,0,0,1731
"42125784000",2299,339,6,3,20,21,16,5,2709
"42125791000",1238,199,4,0,26,9,2,0,1478
"42125792100",2505,698,93,49,93,13,0,0,3451
"42125792200",1117,536,68,76,58,104,36,97,2092
"42125795700",1866,349,8,12,13,50,0,18,2316
"42125795800",3552,71,57,0,120,0,58,0,3858
"42125795900",3550,517,22,2,9,38,12,3,4153
"42125796000",3011,321,4,0,56,7,0,0,3399
"42127960100",1126,168,0,0,8,4,17,0,1323
"42127960200",2479,364,19,1,62,28,46,25,3024
"42127960300",2312,187,0,0,15,0,15,0,2529
"42127960400",2708,343,0,0,35,15,74,43,3218
"42127960500",3303,274,0,0,41,0,52,9,3679
"42127960600",4140,664,48,0,170,11,190,42,5265
"42127960700",2927,1298,0,9,23,0,73,0,4330
"42127960800",3604,510,75,2,37,8,97,25,4358
"42127960900",3070,562,3,6,59,57,49,62,3868
"42127961000",4493,199,245,86,40,14,114,0,5191
"42127961100",3344,359,0,0,49,14,18,13,3797
"42127961200",3590,529,27,0,26,8,383,17,4580
"42127961300",2310,296,68,0,32,3,30,0,2739
"42127961400",1394,205,32,24,66,7,62,0,1790
"42129800100",407,364,139,113,0,57,9,34,1123
"42129800200",702,214,145,177,79,58,7,0,1382
"42129800300",1601,346,147,301,45,67,12,142,2661
"42129800400",1174,142,12,15,103,0,86,0,1532
"42129800500",2060,112,97,0,100,1,7,0,2377
"42129800600",1186,488,204,517,85,232,11,0,2723
"42129800700",907,748,117,291,72,139,9,0,2283
"42129800800",1387,141,67,29,42,14,0,0,1680
"42129800900",2066,171,21,37,135,0,23,0,2453
"42129801001",3296,206,0,0,68,0,8,0,3578
"42129801002",2406,240,27,27,12,39,55,25,2831
"42129801100",4553,606,0,1,36,22,36,0,5254
"42129801200",5176,395,128,1,52,0,68,0,5820
"42129801300",3733,494,40,10,41,12,2,0,4332
"42129801400",1470,261,149,0,61,18,0,0,1959
"42129801500",1916,424,145,29,19,14,17,0,2564
"42129801600",923,200,101,44,14,14,17,0,1313
"42129801701",2124,62,55,16,0,0,5,0,2262
"42129801702",4398,193,0,0,6,0,12,0,4609
"42129801703",2474,111,0,0,0,0,11,0,2596
"42129801800",5586,639,71,5,70,3,111,20,6505
"42129801900",6092,212,65,1,124,98,0,23,6615
"42129802001",2341,67,0,1,61,10,13,4,2497
"42129802002",6792,454,45,5,303,45,70,21,7735
"42129802101",4449,333,50,0,224,0,0,0,5056
"42129802102",5523,282,0,0,150,59,134,59,6207
"42129802103",2129,35,0,0,280,0,40,0,2484
"42129802200",2796,201,50,0,16,0,0,0,3063
"42129802301",5297,229,82,0,9,29,0,0,5646
"42129802303",3012,135,0,0,26,0,0,0,3173
"42129802304",6301,263,0,0,28,0,0,0,6592
"42129802400",4202,303,21,0,8,0,0,0,4534
"42129802500",2001,192,49,29,75,90,25,0,2461
"42129802600",2898,265,41,21,145,0,0,0,3370
"42129802700",1703,228,61,0,32,0,10,0,2034
"42129802800",1564,346,100,76,99,51,24,0,2260
"42129802900",5177,272,0,0,0,0,8,0,5457
"42129803000",4204,448,1,30,14,0,21,0,4718
"42129803100",3704,112,0,0,199,14,40,0,4069
"42129803200",2182,136,0,0,0,0,0,0,2318
"42129803301",5426,49,0,15,163,0,118,0,5771
"42129803302",4186,135,37,9,55,5,76,0,4503
"42129803400",3025,85,21,0,45,0,26,0,3202
"42129803501",4419,199,46,0,74,0,0,0,4738
"42129803502",3770,219,13,0,37,0,32,0,4071
"42129803600",1768,109,0,1,25,0,41,0,1944
"42129803700",4198,270,11,0,44,0,51,0,4574
"42129803800",5027,139,16,0,40,0,39,0,5261
"42129803901",2816,138,82,20,154,0,73,15,3298
"42129803902",2209,598,43,4,111,172,52,59,3248
"42129804000",656,363,56,37,50,57,0,17,1236
"42129804100",1478,659,154,25,19,120,0,9,2464
"42129804200",2936,447,218,34,52,48,16,21,3772
"42129804300",1729,373,26,2,0,0,12,0,2142
"42129804400",1739,201,1,9,85,20,5,0,2060
"42129804501",4412,223,15,0,90,0,51,6,4797
"42129804502",4195,583,10,0,114,51,72,0,5025
"42129804600",2508,407,0,0,34,0,37,0,2986
"42129804701",2716,82,70,3,38,0,0,0,2909
"42129804702",4063,220,0,0,0,0,0,0,4283
"42129804801",2007,277,31,45,61,15,0,0,2436
"42129804802",5700,477,0,0,75,76,129,0,6457
"42129804900",4944,511,8,45,152,35,57,8,5760
"42129805000",3345,470,1,0,11,19,21,0,3867
"42129805100",2271,367,15,0,12,2,0,0,2667
"42129805200",1152,284,268,242,54,44,0,2,2046
"42129805400",609,532,299,210,115,0,19,127,1911
"42129805500",3293,175,134,0,89,0,0,0,3691
"42129805600",1572,288,6,0,14,0,45,5,1930
"42129805800",2390,384,65,85,123,1,0,0,3048
"42129805901",1368,49,0,0,45,0,0,0,1462
"42129805902",6206,219,36,47,186,38,87,0,6819
"42129806000",2173,407,0,0,9,10,0,19,2618
"42129806100",3201,191,1,19,22,19,15,12,3480
"42129806200",2239,329,0,0,5,48,0,48,2669
"42129806300",1697,176,145,0,7,0,14,0,2039
"42129806400",1863,319,92,0,29,8,0,0,2311
"42129806500",4001,517,4,0,26,214,27,56,4845
"42129806600",2372,550,43,7,90,0,9,0,3071
"42129806700",2157,448,9,0,40,1,7,0,2662
"42129806800",1243,289,7,0,91,0,4,0,1634
"42129806900",3373,536,0,0,16,0,17,0,3942
"42129807000",2943,324,1,1,6,0,6,0,3281
"42129807100",3425,156,0,0,0,0,88,0,3669
"42129807200",6625,331,20,0,170,0,11,0,7157
"42129807300",4540,512,0,4,19,79,33,54,5241
"42129807401",2336,138,0,9,48,6,5,0,2542
"42129807402",5758,538,97,39,12,43,61,0,6548
"42129807500",1988,211,0,0,39,0,10,11,2259
"42129807600",2084,420,0,0,15,17,0,3,2539
"42129807700",2998,330,38,33,49,0,0,0,3448
"42129807800",3256,576,2,4,96,30,32,0,3996
"42129807900",5451,634,12,0,86,19,0,0,6202
"42129808100",3488,775,104,44,16,121,48,7,4603
"42129808200",2139,426,0,0,28,26,7,6,2632
"42129808300",4507,644,12,25,64,20,20,1,5293
"42129808401",1842,54,0,0,53,16,4,0,1969
"42129808402",4325,335,0,0,47,0,76,4,4787
"42129808500",1302,144,0,1,0,11,0,11,1469
"42129808600",3983,409,0,0,100,0,85,0,4577
"42131400100",2561,420,2,4,86,22,69,63,3227
"42131400200",3633,509,1,0,13,16,71,18,4261
"42131400300",3959,368,15,19,34,10,20,47,4472
"42131400400",3750,306,28,0,81,18,19,0,4202
"42131400500",3521,486,7,0,46,0,51,8,4119
"42131400600",2957,464,5,0,49,2,26,0,3503
"42131400700",3560,452,7,1,85,21,15,10,4151
"42133000100",501,123,142,279,17,136,31,298,1527
"42133000200",781,415,336,476,337,142,400,41,2928
"42133000300",821,386,183,249,323,273,361,411,3007
"42133000400",1130,260,258,50,217,259,314,222,2710
"42133000500",1113,471,310,254,205,144,246,318,3061
"42133000600",1342,361,269,178,89,338,400,420,3397
"42133000700",851,593,394,410,132,338,569,673,3960
"42133000800",1065,239,427,145,117,49,246,196,2484
"42133000900",577,747,563,381,183,255,280,307,3293
"42133001000",346,257,539,449,176,86,287,155,2295
"42133001100",1010,510,815,538,694,286,726,567,5146
"42133001200",777,1049,164,502,451,602,583,1197,5325
"42133001300",1455,253,1039,100,247,131,261,125,3611
"42133001400",2656,425,527,352,263,110,550,199,5082
"42133001500",994,968,597,447,193,726,380,1115,5420
"42133001600",795,263,81,88,107,148,258,255,1995
"42133010110",5423,286,593,68,483,23,400,59,7335
"42133010120",3867,170,160,19,306,0,117,1,4640
"42133010130",3089,155,56,0,155,12,101,0,3568
"42133010210",2516,84,12,6,228,85,55,0,2986
"42133010220",4653,235,329,0,267,0,495,61,6040
"42133010300",1115,76,192,36,102,0,26,27,1574
"42133010400",3238,89,97,15,319,59,276,10,4103
"42133010510",2657,89,130,0,279,7,203,0,3365
"42133010520",1979,62,68,20,41,34,49,0,2253
"42133020100",2865,340,24,0,21,24,146,156,3576
"42133020220",3962,217,15,0,68,28,22,2,4314
"42133020221",4020,265,55,0,133,36,216,0,4725
"42133020222",4431,170,46,1,82,0,75,0,4805
"42133020310",2467,83,12,0,48,4,26,0,2640
"42133020320",7013,383,0,0,98,18,52,2,7566
"42133020410",4786,438,9,0,92,0,255,8,5588
"42133020420",7650,495,69,0,417,0,103,22,8756
"42133020510",3514,271,0,1,10,0,24,0,3820
"42133020521",5018,479,151,7,103,65,93,57,5973
"42133020522",3837,82,147,0,43,10,70,0,4189
"42133020600",6293,551,3,0,228,30,139,0,7244
"42133020710",5423,408,387,8,398,38,46,0,6708
"42133020720",7792,658,300,0,406,0,394,30,9580
"42133020800",6466,488,411,167,133,41,458,242,8406
"42133020910",5531,414,12,39,103,30,97,53,6279
"42133020921",6366,587,106,0,298,31,314,0,7702
"42133020922",3620,222,0,0,35,0,24,0,3901
"42133021010",4341,324,261,23,213,147,188,110,5607
"42133021020",5611,382,64,36,259,29,179,29,6589
"42133021100",3882,230,228,33,302,0,281,0,4956
"42133021210",6384,452,485,154,483,21,317,75,8371
"42133021220",5828,77,793,0,468,0,85,0,7251
"42133021300",2874,426,338,101,570,267,385,137,5098
"42133021410",3713,465,362,79,312,14,259,107,5311
"42133021420",6452,234,240,17,247,0,439,0,7629
"42133021500",3184,246,89,0,180,27,89,6,3821
"42133021600",1957,151,365,30,202,18,182,39,2944
"42133021711",2899,133,10,0,12,0,0,0,3054
"42133021712",5826,417,0,0,143,7,119,0,6512
"42133021720",3736,329,317,6,131,0,169,3,4691
"42133021801",3928,232,150,0,52,114,193,140,4809
"42133021802",3727,18,76,0,118,42,77,0,4058
"42133021900",5940,635,0,0,392,130,213,153,7463
"42133022000",2743,500,37,19,89,257,37,212,3894
"42133022100",1886,542,52,73,381,238,340,229,3741
"42133022200",4284,280,0,0,108,31,179,31,4913
"42133022300",3061,187,24,0,312,0,205,6,3795
"42133022401",3290,105,0,0,9,0,0,0,3404
"42133022402",7299,222,23,17,360,1,46,1,7969
"42133022500",3455,246,28,0,75,0,22,0,3826
"42133022600",7534,175,269,15,344,31,107,0,8475
"42133022700",5067,530,100,44,211,78,153,10,6193
"42133022800",6681,615,190,16,107,0,248,0,7857
"42133022910",7905,525,398,0,820,26,502,26,10202
"42133022920",3791,136,105,0,247,0,87,0,4366
"42133023000",3704,863,9,10,118,118,61,108,4991
"42133023100",5502,681,55,14,85,6,220,0,6563
"42133023200",5711,258,376,0,144,0,188,5,6682
"42133023301",5409,274,349,0,241,0,177,0,6450
"42133023302",5272,650,63,0,165,0,102,0,6252
"42133023400",5251,345,44,6,49,45,110,0,5850
"42133023500",4665,345,55,54,120,12,47,80,5378
"42133023601",3137,317,0,0,109,129,51,5,3748
"42133023602",4305,622,42,3,51,60,72,78,5233
"42133023710",3646,282,0,6,49,0,12,3,3998
"42133023721",5199,814,29,0,64,0,77,0,6183
"42133023722",2579,396,0,0,71,0,12,0,3058
"42133023810",4276,204,8,2,51,0,30,4,4575
"42133023821",4841,142,58,0,118,0,207,0,5366
"42133023822",6435,151,203,0,249,45,59,58,7200
"42133023901",6776,400,30,94,106,0,128,0,7534
"42133023902",2892,102,36,0,14,2,91,0,3137
"42133024001",4533,724,56,0,172,0,18,0,5503
"42133024002",3097,230,13,0,112,13,17,17,3499
"44001030100",4167,86,56,0,376,2,74,12,4773
"44001030200",2871,89,0,0,168,0,0,0,3128
"44001030300",4083,34,0,36,364,0,58,12,4587
"44001030400",3727,31,0,3,82,17,81,0,3941
"44001030500",2468,422,18,0,85,0,93,21,3107
"44001030601",3384,222,0,0,18,0,92,0,3716
"44001030602",3255,404,6,0,5,18,32,15,3735
"44001030700",3200,708,0,0,44,89,63,67,4171
"44001030800",3152,175,46,0,78,34,72,3,3560
"44001030901",5503,272,0,0,118,16,236,14,6159
"44001030902",5555,412,154,0,159,59,19,42,6400
"44003020101",5237,348,139,0,223,27,90,0,6064
"44003020102",3645,719,179,0,254,11,317,201,5326
"44003020200",3188,708,112,0,839,42,315,15,5219
"44003020300",4012,1642,91,21,225,118,278,166,6553
"44003020400",2028,278,44,30,63,27,26,0,2496
"44003020500",3567,605,55,0,275,16,63,44,4625
"44003020601",5418,429,0,1,266,124,179,0,6417
"44003020602",2954,277,0,0,66,0,73,0,3370
"44003020603",6154,304,0,0,62,0,48,0,6568
"44003020604",4381,790,0,0,0,1,36,86,5294
"44003020701",1504,225,17,0,80,2,0,0,1828
"44003020702",4453,193,7,1,0,0,47,0,4701
"44003020703",6040,385,129,22,178,1,51,23,6829
"44003020800",5113,327,90,12,560,0,158,0,6260
"44003020901",3011,305,73,0,88,41,126,0,3644
"44003020903",5400,380,0,0,264,0,125,0,6169
"44003020904",3119,58,62,1,233,15,57,3,3548
"44003021001",2312,207,12,0,199,3,321,13,3067
"44003021002",3673,493,50,2,536,108,543,43,5448
"44003021100",4133,197,119,28,466,25,315,28,5311
"44003021200",2946,198,86,0,136,38,127,21,3552
"44003021300",3859,267,141,11,337,0,351,0,4966
"44003021401",3579,74,7,5,245,0,148,0,4058
"44003021402",3307,165,155,0,84,66,104,18,3899
"44003021501",2686,270,17,0,60,0,87,0,3120
"44003021502",3482,482,14,9,154,6,113,0,4260
"44003021600",1357,28,11,1,42,0,24,1,1464
"44003021700",4414,374,95,0,79,19,90,0,5071
"44003021800",3567,222,28,6,311,0,37,0,4171
"44003021901",2884,93,48,0,392,29,233,0,3679
"44003021902",2111,297,43,1,69,118,124,85,2848
"44003021903",3479,213,81,1,106,28,81,18,4007
"44003022000",3016,213,9,30,90,2,48,0,3408
"44003022100",4547,613,0,0,164,38,20,115,5497
"44003022201",5913,240,115,1,462,12,193,12,6948
"44003022202",3167,243,41,0,423,11,118,0,4003
"44003022300",2845,325,0,0,431,105,58,1,3765
"44003022400",2063,32,3,0,75,13,115,0,2301
"44003980000",0,0,0,0,0,0,0,0,0
"44005040101",4225,366,34,1,143,1,66,0,4836
"44005040102",5085,573,0,0,184,65,90,34,6031
"44005040103",5636,306,177,21,288,22,130,48,6628
"44005040200",753,33,192,9,171,10,69,0,1237
"44005040302",1957,74,116,0,414,0,193,0,2754
"44005040303",1684,199,230,204,613,122,450,1,3503
"44005040304",2076,247,103,60,230,82,102,29,2929
"44005040400",5819,73,48,4,301,12,178,4,6439
"44005040500",2817,393,551,86,331,186,423,181,4968
"44005040600",3304,181,246,0,421,199,675,95,5121
"44005040700",2776,317,17,54,226,0,58,9,3457
"44005040800",1819,201,27,10,293,67,139,60,2616
"44005040900",3085,177,48,16,169,6,112,0,3613
"44005041000",1486,248,41,10,38,19,19,0,1861
"44005041100",1060,144,10,29,46,72,97,33,1491
"44005041200",191,34,92,20,89,24,39,11,500
"44005041300",4765,453,21,0,205,0,97,28,5569
"44005041400",3012,381,38,0,54,6,23,23,3537
"44005041601",2588,261,0,0,44,0,0,1,2894
"44005041602",3919,245,89,3,66,5,88,3,4418
"44005041701",3006,169,0,0,150,0,39,0,3364
"44005041702",4920,260,0,0,0,0,15,0,5195
"44005990000",0,0,0,0,0,0,0,0,0
"44007000101",1018,614,528,118,1197,351,1190,562,5578
"44007000102",1029,590,647,234,1857,561,1740,1093,7751
"44007000200",666,1278,726,408,2189,1062,2144,1825,10298
"44007000300",1768,573,1038,142,2003,799,3155,875,10353
"44007000400",609,332,1076,332,724,801,1295,1149,6318
"44007000500",296,230,792,265,381,911,652,1093,4620
"44007000600",290,403,392,270,382,111,536,443,2827
"44007000700",298,214,488,579,474,476,501,620,3650
"44007000800",1126,346,88,107,161,611,248,327,3014
"44007000900",915,690,91,58,352,126,507,303,3042
"44007001000",825,411,92,359,649,329,788,420,3873
"44007001100",1395,377,70,48,353,159,352,118,2872
"44007001200",889,179,276,471,553,627,1187,781,4963
"44007001300",1383,421,338,183,1638,803,1753,900,7419
"44007001400",1446,642,662,336,2357,1227,2277,1483,10430
"44007001500",1013,350,515,88,1026,44,1189,312,4537
"44007001600",2159,415,669,270,3272,1669,4585,1936,14975
"44007001700",1108,315,121,122,987,589,1156,643,5041
"44007001800",2040,728,614,342,2248,662,2869,1189,10692
"44007001900",1026,919,452,308,1436,1243,1718,1645,8747
"44007002000",2239,1308,446,139,1093,1005,1746,1752,9728
"44007002101",1203,129,613,78,503,240,762,284,3812
"44007002102",1745,456,943,477,1605,375,2603,683,8887
"44007002200",1242,404,844,555,1527,634,2157,946,8309
"44007002300",2750,1135,393,3,297,92,136,306,5112
"44007002400",4216,233,299,2,417,8,834,4,6013
"44007002500",864,502,346,38,698,348,423,277,3496
"44007002600",718,359,696,257,804,314,1109,382,4639
"44007002700",909,742,753,391,835,938,954,1374,6896
"44007002800",2161,841,1041,302,1146,985,1404,1148,9028
"44007002900",2793,736,1130,879,975,257,1029,881,8680
"44007003100",1836,394,383,530,257,799,49,549,4797
"44007003200",2343,16,343,46,354,89,261,24,3476
"44007003300",2986,236,234,37,357,90,131,32,4103
"44007003400",4410,378,74,2,261,0,44,27,5196
"44007003500",3286,656,111,0,656,109,229,127,5174
"44007003601",866,528,10,0,119,249,0,112,1884
"44007003602",919,296,5,1,90,65,15,20,1411
"44007003700",2255,806,34,8,273,189,50,263,3878
"44007010101",3562,185,121,1,99,35,113,26,4142
"44007010102",3205,185,92,0,168,7,199,19,3875
"44007010200",4186,414,368,417,1229,162,562,0,7338
"44007010300",2643,305,333,0,447,166,224,22,4140
"44007010400",4668,654,486,75,780,221,319,157,7360
"44007010501",2808,387,344,75,262,454,140,390,4860
"44007010502",3234,275,355,177,473,0,72,0,4586
"44007010600",5122,539,0,16,153,94,197,0,6121
"44007010701",2086,108,36,0,39,0,32,0,2301
"44007010702",3583,265,25,0,93,98,19,0,4083
"44007010800",1763,807,503,311,718,273,1798,850,7023
"44007010900",2125,851,584,209,680,307,2181,951,7888
"44007011000",1817,1175,730,178,743,617,2138,1491,8889
"44007011100",2015,424,941,150,299,703,2050,1069,7651
"44007011200",4388,600,185,0,336,237,444,340,6530
"44007011301",3732,302,109,0,149,16,368,72,4748
"44007011302",4006,105,0,0,142,0,92,0,4345
"44007011401",6855,151,31,2,572,16,210,0,7837
"44007011402",4304,98,0,1,50,0,35,0,4488
"44007011403",6646,366,0,0,285,0,131,89,7517
"44007011500",5080,648,559,0,143,10,393,288,7121
"44007011600",4862,238,0,0,539,1,0,3,5643
"44007011701",3861,526,0,154,188,1,222,14,4966
"44007011702",3897,168,13,1,229,0,232,1,4541
"44007011800",4719,665,593,91,456,71,285,0,6880
"44007011901",2078,266,335,65,148,35,227,157,3311
"44007011902",4338,416,82,0,133,0,182,0,5151
"44007012000",5187,341,34,15,427,17,552,34,6607
"44007012102",3493,384,172,113,145,44,446,199,4996
"44007012103",1899,230,255,17,100,38,45,0,2584
"44007012104",3145,557,393,74,190,16,75,25,4475
"44007012200",6218,225,131,0,551,136,341,0,7602
"44007012300",5192,625,66,0,247,44,252,77,6503
"44007012401",5614,380,179,2,954,0,367,0,7496
"44007012402",2047,92,49,0,354,0,286,2,2830
"44007012500",3736,1234,0,0,279,123,180,182,5734
"44007012601",1472,36,0,1,117,4,103,3,1736
"44007012602",6407,317,0,0,244,1,148,19,7136
"44007012701",4743,111,0,0,102,7,0,0,4963
"44007012702",4194,268,94,1,56,8,66,53,4740
"44007012801",4311,297,1,0,38,1,105,1,4754
"44007012802",2048,210,6,0,13,0,12,44,2333
"44007012803",4618,31,22,0,184,0,0,0,4855
"44007012900",3984,628,28,12,143,52,53,43,4943
"44007013001",3357,275,0,0,67,0,78,0,3777
"44007013002",6562,339,30,0,67,35,136,7,7176
"44007013101",4499,214,25,0,123,10,55,10,4936
"44007013102",4739,156,9,0,69,0,67,0,5040
"44007013201",4473,138,0,2,68,0,68,1,4750
"44007013202",4971,492,0,0,248,0,21,0,5732
"44007013300",4122,285,60,0,156,0,0,0,4623
"44007013400",3106,418,76,79,214,0,164,16,4073
"44007013500",2760,695,262,17,400,339,650,516,5639
"44007013600",2240,279,289,7,87,138,288,64,3392
"44007013701",2540,360,232,0,552,95,444,0,4223
"44007013702",1773,134,114,23,567,12,70,0,2693
"44007013800",3997,433,162,1,135,0,163,1,4892
"44007013900",2298,224,42,0,102,61,235,29,2991
"44007014000",3838,402,61,267,892,42,875,0,6377
"44007014100",2607,608,267,207,1262,451,1033,417,6852
"44007014200",1831,241,46,5,94,41,49,10,2317
"44007014300",4213,86,153,0,544,214,84,0,5294
"44007014400",3259,223,59,0,146,0,97,87,3871
"44007014501",4965,41,64,3,104,0,105,0,5282
"44007014502",3712,481,67,1,187,0,219,87,4754
"44007014600",6160,86,97,1,683,20,193,0,7240
"44007014700",4411,1104,376,0,1053,65,1821,490,9320
"44007014800",4483,437,85,0,124,186,251,141,5707
"44007015000",2315,701,795,60,732,0,851,330,5784
"44007015100",915,516,1125,498,984,416,580,696,5730
"44007015200",654,739,26,247,356,236,360,558,3176
"44007015300",868,430,357,80,166,124,215,249,2489
"44007015400",679,233,377,301,460,102,519,184,2855
"44007015500",2350,457,492,31,812,221,581,226,5170
"44007015600",1542,343,164,40,313,58,465,57,2982
"44007015700",2962,176,193,0,172,2,204,0,3709
"44007015800",3031,215,73,0,262,11,287,19,3898
"44007015900",2083,233,348,101,239,25,297,2,3328
"44007016000",1283,399,435,368,495,118,432,442,3972
"44007016100",1422,671,801,802,870,306,780,696,6348
"44007016300",1920,108,261,0,384,168,326,173,3340
"44007016400",1253,511,1187,519,991,418,742,600,6221
"44007016500",2235,541,311,72,577,44,260,55,4095
"44007016600",757,192,301,78,152,245,341,312,2378
"44007016700",1570,312,414,190,335,304,468,108,3701
"44007016800",2112,252,244,31,306,0,395,0,3340
"44007016900",1442,216,58,1,215,0,82,0,2014
"44007017000",2843,300,411,110,364,73,299,0,4400
"44007017100",2633,744,504,68,574,326,676,764,6289
"44007017300",2238,273,77,156,282,150,122,50,3348
"44007017400",1761,867,254,280,361,299,319,678,4819
"44007017500",2614,446,24,52,214,61,139,176,3726
"44007017600",1105,500,426,57,404,28,362,207,3089
"44007017700",2861,206,95,30,395,73,133,0,3793
"44007017800",1412,688,117,126,195,113,318,185,3154
"44007017900",1491,1169,83,25,28,148,214,314,3472
"44007018000",1094,1080,37,61,322,16,9,344,2963
"44007018100",2042,674,148,74,62,2,544,339,3885
"44007018200",1259,528,289,75,467,23,263,98,3002
"44007018300",811,571,200,110,89,55,55,105,1996
"44007018400",3707,378,0,423,782,155,345,334,6124
"44007018500",1844,521,10,2,243,19,24,73,2736
"44009041500",800,59,3,3,8,17,12,3,905
"44009050102",1909,132,5,0,53,1,54,0,2154
"44009050103",4303,643,90,146,515,92,162,83,6034
"44009050104",3553,141,0,0,190,14,169,14,4081
"44009050301",3722,399,0,0,123,74,23,6,4347
"44009050302",2493,164,27,40,66,35,39,25,2889
"44009050401",4324,208,11,0,101,0,36,0,4680
"44009050402",2421,62,7,3,144,8,98,1,2744
"44009050500",5770,480,26,62,177,75,202,61,6853
"44009050600",6955,341,83,0,207,39,122,0,7747
"44009050700",7380,296,241,13,180,0,121,0,8231
"44009050801",4671,825,66,48,98,179,132,35,6054
"44009050802",3106,226,25,2,304,24,134,0,3821
"44009050901",5032,558,17,7,386,0,44,11,6055
"44009050902",4919,167,0,72,119,45,85,0,5407
"44009051000",1424,95,11,0,27,1,15,0,1573
"44009051101",4024,514,0,9,218,9,109,0,4883
"44009051102",2529,322,0,0,141,22,53,20,3087
"44009051201",3660,470,233,9,123,109,67,128,4799
"44009051202",3930,251,23,2,208,128,10,0,4552
"44009051302",3831,118,27,0,46,0,70,0,4092
"44009051304",1836,83,14,0,62,0,56,0,2051
"44009051305",3209,282,27,16,351,63,0,15,3963
"44009051306",4732,232,40,11,505,17,282,0,5819
"44009051400",311,313,0,77,12,35,0,22,770
"44009051502",6050,748,57,7,176,33,115,37,7223
"44009051503",3525,532,0,0,78,21,209,8,4373
"44009051504",3321,1167,0,4,18,13,16,0,4539
"44009990100",0,0,0,0,0,0,0,0,0
"44009990200",0,0,0,0,0,0,0,0,0
"45001950100",2257,412,329,86,23,21,48,0,3176
"45001950200",2185,390,752,58,60,62,0,27,3534
"45001950300",2620,551,146,53,9,5,46,0,3430
"45001950400",3699,673,776,901,5,0,14,0,6068
"45001950500",1902,557,1418,886,110,0,0,0,4873
"45001950600",1250,297,1002,653,127,13,0,0,3342
"45003020100",2869,446,731,359,65,231,256,213,5170
"45003020200",3232,777,907,470,31,135,57,14,5623
"45003020301",1335,487,189,0,37,28,110,0,2186
"45003020302",2292,346,1873,701,98,52,226,16,5604
"45003020400",4566,476,896,983,33,47,249,111,7361
"45003020500",6068,292,1026,254,197,56,158,0,8051
"45003020601",2414,64,888,0,140,0,28,0,3534
"45003020602",3105,581,1103,922,284,440,286,474,7195
"45003020701",4053,349,1081,163,115,47,99,0,5907
"45003020702",2031,153,814,552,437,239,761,161,5148
"45003020801",2339,54,108,0,64,0,62,0,2627
"45003020802",3625,433,845,77,276,57,199,87,5599
"45003020901",1504,259,635,143,39,24,70,6,2680
"45003020902",3846,836,1188,677,112,0,87,11,6757
"45003021001",2653,721,806,130,262,252,276,169,5269
"45003021002",2850,1117,802,34,33,385,45,355,5621
"45003021101",1609,959,59,82,43,0,0,0,2752
"45003021102",2593,599,222,91,0,0,0,0,3505
"45003021201",5064,231,350,127,132,0,60,0,5964
"45003021202",3026,236,156,90,161,7,87,0,3763
"45003021203",6979,309,581,40,444,106,879,15,9353
"45003021300",2787,232,542,50,155,42,94,10,3912
"45003021400",611,76,2953,1924,58,78,53,48,5801
"45003021500",3190,98,780,347,223,0,183,0,4821
"45003021601",2178,332,1330,2036,24,485,102,423,6910
"45003021602",6037,207,1083,288,316,15,353,0,8299
"45003021700",2048,807,944,399,18,69,0,128,4413
"45003021800",1208,167,662,516,76,14,24,0,2667
"45003021900",3653,682,764,149,426,457,280,423,6834
"45003022001",2664,590,835,96,221,14,291,20,4731
"45003022002",4556,466,1270,489,292,0,220,0,7293
"45003022100",1846,442,671,131,71,1,79,0,3241
"45003980100",0,0,0,0,0,0,0,0,0
"45005970200",722,67,2414,1696,159,0,202,0,5260
"45005970300",615,171,172,34,2,0,3,51,1048
"45005970400",464,62,1468,867,4,0,0,0,2865
"45007000200",2386,301,494,119,74,4,234,6,3618
"45007000300",2517,481,989,25,302,0,76,106,4496
"45007000500",764,74,1574,601,0,0,0,23,3036
"45007000600",360,341,852,1397,0,97,7,44,3098
"45007000700",1020,713,1407,1177,101,118,147,138,4821
"45007000800",1198,514,395,243,7,28,108,0,2493
"45007000900",1403,337,609,453,45,54,0,101,3002
"45007001000",1583,301,379,196,219,5,530,0,3213
"45007001100",3838,217,492,349,185,0,61,0,5142
"45007010102",6532,157,162,61,33,1,89,22,7057
"45007010103",5796,568,149,215,263,0,635,0,7626
"45007010104",6303,873,497,0,135,50,99,132,8089
"45007010200",4295,347,158,0,0,0,16,0,4816
"45007010300",2896,893,200,29,18,95,58,80,4269
"45007010401",4836,619,329,47,294,18,358,32,6533
"45007010402",4697,920,323,0,31,53,20,40,6084
"45007010500",4938,476,363,0,303,0,362,0,6442
"45007010600",6080,849,474,14,314,11,45,0,7787
"45007010700",3108,1037,442,317,363,131,192,28,5618
"45007010800",4037,370,378,15,133,0,85,0,5018
"45007010900",4046,323,82,25,110,0,10,0,4596
"45007011001",3702,807,138,45,113,28,38,44,4915
"45007011002",3265,281,323,0,143,91,18,24,4145
"45007011100",1777,427,374,93,95,50,53,6,2875
"45007011201",3161,235,299,0,223,29,0,0,3947
"45007011202",6214,413,823,14,268,0,146,43,7921
"45007011300",5271,754,732,332,45,125,66,125,7450
"45007011401",2832,324,671,98,135,0,174,0,4234
"45007011402",2226,366,421,53,180,0,114,6,3366
"45007011500",4855,809,490,361,23,19,115,0,6672
"45007011600",1665,292,36,13,13,8,0,0,2027
"45007011700",3882,1008,392,370,83,57,0,43,5835
"45007011800",2847,580,265,79,82,0,161,0,4014
"45007011901",3016,700,1062,792,115,17,283,32,6017
"45007011902",972,267,815,547,0,9,1,0,2611
"45007012001",3589,151,898,29,145,40,189,77,5118
"45007012002",2632,758,1058,284,157,6,177,89,5161
"45007012200",3984,1124,721,334,112,245,0,0,6520
"45007012300",1154,444,941,754,71,45,33,45,3487
"45009960100",484,25,2518,1809,84,5,55,0,4980
"45009960200",2507,272,2797,1176,50,24,66,24,6916
"45009960300",877,253,255,60,21,44,4,40,1554
"45009960400",706,235,238,195,26,0,0,0,1400
"45011970100",2684,513,1500,942,58,12,0,0,5709
"45011970200",914,233,1615,899,41,220,36,118,4076
"45011970300",1266,382,1198,1181,42,0,18,0,4087
"45011970400",2851,720,333,174,122,126,98,130,4554
"45011970500",1681,168,1286,728,86,9,73,12,4043
"45011980100",0,0,0,0,0,0,0,0,0
"45013000100",1186,367,2146,999,26,74,50,0,4848
"45013000200",1659,279,1848,1132,57,0,189,21,5185
"45013000300",3262,550,981,17,471,53,550,115,5999
"45013000400",144,0,48,0,2,0,0,0,194
"45013000501",3284,37,1172,678,679,22,661,0,6533
"45013000502",3062,29,1092,513,298,170,573,144,5881
"45013000503",2432,500,1467,299,79,27,34,265,5103
"45013000600",1269,385,533,135,111,31,80,13,2557
"45013000700",3442,308,523,364,929,210,819,27,6622
"45013000800",2169,548,1247,521,245,0,112,25,4867
"45013000901",1710,248,328,78,313,0,236,4,2917
"45013000902",5974,462,1130,116,170,22,273,74,8221
"45013000903",1027,112,244,83,77,142,35,213,1933
"45013001000",728,26,135,0,59,0,75,14,1037
"45013001101",1964,191,1000,153,98,13,1,2,3422
"45013001102",1091,57,2779,1009,418,177,359,116,6006
"45013001200",876,25,0,0,1,0,1,0,903
"45013002101",367,273,0,0,8,0,0,0,648
"45013002102",1486,114,73,12,192,4,179,75,2135
"45013002103",2497,84,371,0,214,1,335,2,3504
"45013002104",11242,744,211,0,226,0,469,22,12914
"45013002105",2519,90,297,0,146,0,501,28,3581
"45013002106",5679,311,749,256,1231,176,1207,272,9881
"45013002107",7032,911,683,689,1039,636,2771,1165,14926
"45013002108",3589,512,422,60,300,16,816,133,5848
"45013002201",6339,271,292,101,37,0,213,0,7253
"45013002202",3053,110,182,0,127,0,73,0,3545
"45013010100",1508,77,0,0,13,7,15,7,1627
"45013010200",2996,106,66,0,229,27,406,27,3857
"45013010300",3762,167,0,0,223,20,200,0,4372
"45013010400",4353,77,738,140,109,0,144,0,5561
"45013010500",2211,118,473,205,821,71,1195,89,5183
"45013010600",3932,173,0,0,134,0,54,0,4293
"45013010700",4168,235,125,7,0,0,15,23,4573
"45013010800",1220,319,614,317,966,723,1613,835,6607
"45013010900",1384,107,35,62,6,0,34,34,1662
"45013011000",1061,132,351,88,114,44,313,47,2150
"45013011100",2025,72,29,0,23,97,138,104,2488
"45013011200",632,71,0,0,11,0,9,0,723
"45013011300",1106,109,0,0,132,0,140,0,1487
"45013990100",0,0,0,0,0,0,0,0,0
"45015020101",913,278,1586,193,20,25,36,9,3060
"45015020102",1929,259,814,355,18,70,10,0,3455
"45015020201",1857,50,1120,950,32,0,0,3,4012
"45015020202",145,123,1833,785,0,0,0,0,2886
"45015020301",2016,368,340,7,55,0,55,0,2841
"45015020302",3537,1076,1586,750,182,2,0,2,7135
"45015020401",1655,392,1419,208,135,3,28,3,3843
"45015020403",5975,194,382,0,197,27,56,27,6858
"45015020404",3449,75,729,6,99,39,283,7,4687
"45015020405",1135,203,1374,199,107,0,0,0,3018
"45015020503",2632,872,1170,307,177,23,89,238,5508
"45015020504",1962,100,1068,480,270,0,11,0,3891
"45015020505",1888,383,761,366,47,0,15,283,3743
"45015020506",2619,467,1480,453,176,264,22,264,5745
"45015020600",4349,236,798,281,564,0,277,0,6505
"45015020707",3547,411,1222,37,347,63,56,10,5693
"45015020710",3552,185,1074,247,255,24,281,12,5630
"45015020711",2787,144,408,34,7,31,81,0,3492
"45015020712",2760,375,24,42,210,20,22,0,3453
"45015020713",1920,148,210,33,61,32,103,0,2507
"45015020714",3877,310,767,674,146,0,307,148,6229
"45015020715",3182,247,498,271,344,304,231,0,5077
"45015020716",4917,680,1695,232,760,214,366,276,9140
"45015020717",3053,291,834,245,414,15,207,7,5066
"45015020718",2783,402,835,389,40,103,325,280,5157
"45015020719",5001,358,1014,94,675,110,579,0,7831
"45015020720",2596,103,339,15,136,0,47,34,3270
"45015020721",2716,68,415,15,413,33,288,22,3970
"45015020722",2305,287,332,0,171,0,49,0,3144
"45015020723",1897,276,376,101,390,112,194,0,3346
"45015020724",757,41,3,5,33,4,31,4,878
"45015020725",834,100,289,2,170,93,281,62,1831
"45015020804",950,64,736,228,552,56,197,57,2840
"45015020806",2290,240,444,81,194,6,260,0,3515
"45015020807",3180,434,1699,655,837,136,374,0,7315
"45015020808",2062,146,1000,119,259,112,181,0,3879
"45015020809",1688,479,762,78,484,144,142,135,3912
"45015020810",1888,776,905,39,546,350,539,703,5746
"45015020811",2181,414,1288,476,415,189,630,219,5812
"45015020812",4058,54,413,82,638,0,224,0,5469
"45015020901",934,236,313,9,37,124,0,183,1836
"45015020903",2221,525,179,165,92,25,53,222,3482
"45015020904",2310,187,700,0,413,0,135,0,3745
"45015021000",2436,914,735,170,391,165,618,230,5659
"45015980100",0,0,0,0,0,0,0,0,0
"45017950100",3343,325,1273,358,237,100,248,6,5890
"45017950200",2378,295,2245,938,35,61,42,97,6091
"45017950400",1633,96,921,570,59,51,38,51,3419
"45019000100",2283,158,23,153,48,42,71,9,2787
"45019000200",1344,67,0,0,0,0,0,0,1411
"45019000400",809,856,39,286,16,34,0,0,2040
"45019000500",1114,759,0,24,35,0,15,0,1947
"45019000600",554,480,24,28,56,42,30,34,1248
"45019000700",488,1088,479,121,14,55,17,0,2262
"45019000900",225,158,669,339,19,21,19,26,1476
"45019001000",536,712,471,120,59,123,23,0,2044
"45019001100",451,321,571,818,74,69,45,41,2390
"45019001500",395,38,701,239,40,0,28,6,1447
"45019001600",876,63,477,41,74,0,56,0,1587
"45019001901",3002,400,353,162,59,2,57,44,4079
"45019001902",2829,348,527,568,181,16,53,52,4574
"45019002002",4743,541,359,163,94,0,47,0,5947
"45019002003",4805,467,2424,401,217,14,309,11,8648
"45019002004",1803,245,0,0,105,0,50,0,2203
"45019002005",5427,141,293,7,147,0,65,0,6080
"45019002006",3375,359,419,147,136,71,80,0,4587
"45019002007",3383,86,50,11,108,0,73,12,3723
"45019002101",7877,1546,2418,675,102,0,507,1135,14260
"45019002103",1963,227,1163,230,47,0,239,87,3956
"45019002104",1173,130,8,0,0,0,8,0,1319
"45019002105",1601,115,5,4,26,0,35,0,1786
"45019002200",1286,35,890,550,35,58,35,0,2889
"45019002300",723,55,597,68,36,0,0,0,1479
"45019002400",1703,335,1877,413,43,9,16,1,4397
"45019002502",3864,193,2330,715,105,3,19,0,7229
"45019002604",2791,226,365,347,80,11,28,0,3848
"45019002605",1719,155,879,643,179,55,20,0,3650
"45019002606",1815,26,118,14,87,0,66,0,2126
"45019002611",2005,422,332,151,65,31,85,31,3122
"45019002612",3322,564,1502,786,69,318,139,129,6829
"45019002613",4001,206,724,402,148,18,0,32,5531
"45019002614",1985,334,1008,261,83,14,156,130,3971
"45019002701",661,132,952,471,29,81,12,8,2346
"45019002702",892,315,2318,884,178,44,140,0,4771
"45019002801",3457,270,600,41,50,95,109,0,4622
"45019002802",2452,245,15,0,137,0,19,0,2868
"45019002900",1829,142,554,144,44,0,0,0,2713
"45019003000",2976,269,50,1,35,0,17,0,3348
"45019003104",1402,1125,938,693,803,162,1188,833,7144
"45019003105",1268,911,1074,500,147,22,681,656,5259
"45019003106",2749,452,2418,309,219,129,179,152,6607
"45019003107",1252,156,2589,294,628,267,577,270,6033
"45019003108",684,114,1564,413,277,10,217,15,3294
"45019003109",1485,236,1291,61,297,11,100,148,3629
"45019003110",1700,1030,2332,1251,371,117,265,376,7442
"45019003111",1426,146,2685,704,604,173,1021,134,6893
"45019003113",1020,309,751,338,223,21,381,169,3212
"45019003114",4094,444,1845,715,744,57,319,126,8344
"45019003115",2254,964,1790,1199,261,85,280,283,7116
"45019003200",243,27,99,0,42,0,35,0,446
"45019003300",833,412,1245,1242,138,14,603,149,4636
"45019003400",1051,464,1435,1209,288,127,525,209,5308
"45019003500",1793,277,198,198,41,0,30,0,2537
"45019003600",1127,360,484,386,20,46,25,78,2526
"45019003700",353,182,1080,1310,116,55,67,9,3172
"45019003800",366,113,1966,842,59,0,41,0,3387
"45019003900",1130,183,546,327,84,0,66,37,2373
"45019004000",276,50,1208,1067,0,33,0,0,2634
"45019004300",205,46,1125,1066,31,19,23,0,2515
"45019004400",135,77,1344,608,43,7,40,7,2261
"45019004606",6890,423,698,301,361,81,93,0,8847
"45019004607",4743,799,48,8,109,19,179,31,5936
"45019004608",18691,1131,885,13,941,0,591,0,22252
"45019004609",4574,556,1450,218,154,7,16,0,6975
"45019004610",2249,135,491,0,21,0,34,60,2990
"45019004611",7329,528,441,9,116,0,86,0,8509
"45019004612",5835,532,17,8,287,65,552,36,7332
"45019004613",1527,86,0,0,61,0,14,0,1688
"45019004614",5334,471,938,83,164,10,42,11,7053
"45019004701",4580,370,298,112,71,0,207,0,5638
"45019004702",1667,147,233,17,80,1,73,8,2226
"45019004800",1844,157,7,0,34,0,28,0,2070
"45019004901",1725,283,0,0,0,0,29,0,2037
"45019004902",1883,282,0,55,13,0,130,11,2374
"45019005000",1575,310,1788,947,101,0,3,34,4758
"45019005100",1027,250,184,223,4,21,84,0,1793
"45019005200",1262,225,604,50,88,0,38,4,2271
"45019005300",684,204,1135,1841,5,24,39,18,3950
"45019005400",170,31,802,1171,4,4,4,0,2186
"45019005500",158,67,372,468,33,3,33,0,1134
"45019005600",6857,375,1683,797,399,0,299,293,10703
"45019005700",6975,397,686,131,312,0,211,9,8721
"45019005800",4416,298,869,107,494,0,127,0,6311
"45019990100",0,0,0,0,0,0,0,0,0
"45021970100",6143,1518,248,95,164,91,468,236,8963
"45021970201",1716,239,300,403,97,0,30,0,2785
"45021970202",4728,512,924,162,553,76,410,0,7365
"45021970301",1445,258,1373,711,145,104,51,0,4087
"45021970302",1471,1003,1020,416,104,52,95,213,4374
"45021970401",1953,918,240,185,17,65,9,17,3404
"45021970402",3930,1200,194,263,83,102,37,39,5848
"45021970501",1380,425,278,56,15,75,9,121,2359
"45021970502",1520,591,1628,1202,81,49,62,66,5199
"45021970503",978,177,10,0,8,0,0,0,1173
"45021970601",3328,687,498,216,16,94,0,82,4921
"45021970602",1978,465,72,0,3,4,0,0,2522
"45021970700",2796,378,312,0,167,95,198,0,3946
"45023020100",768,110,861,630,23,5,10,14,2421
"45023020200",624,349,630,1157,38,11,0,0,2809
"45023020300",619,151,2056,961,86,15,27,32,3947
"45023020400",1511,509,401,80,15,64,119,45,2744
"45023020500",1521,360,508,155,28,0,0,0,2572
"45023020601",1898,311,287,24,42,0,0,0,2562
"45023020602",1790,463,1179,202,83,0,107,0,3824
"45023020700",1302,125,330,274,114,0,0,0,2145
"45023020800",2910,791,815,396,197,11,24,7,5151
"45023020900",1772,388,331,149,22,0,45,0,2707
"45023021000",873,292,522,170,17,13,10,0,1897
"45025950101",2923,1172,674,241,204,116,201,476,6007
"45025950102",1833,791,1124,305,79,16,177,209,4534
"45025950200",2301,452,1085,362,165,30,38,0,4433
"45025950300",1315,175,387,264,82,39,41,16,2319
"45025950400",4322,480,932,1045,33,14,29,7,6862
"45025950501",788,217,929,140,5,21,0,0,2100
"45025950502",2453,1084,1592,882,42,120,66,0,6239
"45025950600",2251,425,1752,1661,101,12,59,0,6261
"45025950700",3441,1298,442,208,5,43,74,127,5638
"45025950800",1400,267,684,363,65,13,129,40,2961
"45027960100",2149,448,417,368,39,193,44,207,3865
"45027960201",828,111,451,146,26,0,58,0,1620
"45027960202",0,0,0,0,0,0,0,0,0
"45027960300",900,129,537,234,92,83,126,110,2211
"45027960400",698,143,829,451,68,12,20,0,2221
"45027960500",891,145,1858,2322,153,13,59,0,5441
"45027960600",1354,221,770,327,10,27,0,32,2741
"45027960701",1753,148,1338,394,116,4,105,0,3858
"45027960702",695,227,218,86,18,36,9,36,1325
"45027960703",2192,330,746,226,13,0,35,10,3552
"45027960801",832,136,1612,1110,1,0,1,28,3720
"45027960802",1327,216,1175,248,24,0,27,0,3017
"45029970100",719,57,587,532,92,20,0,0,2007
"45029970200",1010,96,331,130,9,5,15,0,1596
"45029970300",3304,346,1259,1028,213,187,83,60,6480
"45029970401",2001,751,938,235,11,19,97,0,4052
"45029970402",2290,196,538,505,63,0,134,0,3726
"45029970500",1511,402,2055,1159,151,41,19,0,5338
"45029970600",3155,964,2461,349,175,20,540,20,7684
"45029970700",3272,513,1213,315,215,33,122,24,5707
"45029970800",1225,53,750,225,11,0,0,0,2264
"45029990100",0,0,0,0,0,0,0,0,0
"45031010100",943,258,1949,563,127,24,103,41,4008
"45031010200",4395,922,443,152,100,181,145,0,6338
"45031010300",2799,867,1204,148,67,0,279,0,5364
"45031010400",4692,594,572,64,23,0,133,0,6078
"45031010500",1628,181,465,118,21,38,16,0,2467
"45031010600",1449,279,1062,906,143,151,13,16,4019
"45031010700",22,9,1556,838,7,18,0,0,2450
"45031010800",1124,206,1042,296,90,31,97,0,2886
"45031010900",3577,645,1811,951,82,0,68,47,7181
"45031011000",1581,398,371,746,105,0,0,0,3201
"45031011100",778,171,200,221,58,3,0,0,1431
"45031011200",1880,457,1101,782,56,101,53,104,4534
"45031011300",1740,744,2098,662,35,152,10,0,5441
"45031011400",913,79,1392,1730,57,0,15,0,4186
"45031011500",2131,243,1206,1100,55,0,34,0,4769
"45031011600",1618,450,1107,257,105,34,0,25,3596
"45033970100",884,195,1432,409,133,119,29,55,3256
"45033970200",1948,789,1845,568,355,128,153,97,5883
"45033970300",2238,383,898,870,132,326,231,0,5078
"45033970400",786,302,1714,2055,62,173,24,139,5255
"45033970500",2266,313,719,699,92,0,20,0,4109
"45033970600",3388,1071,1866,1178,269,136,15,13,7936
"45035010100",1379,39,692,192,15,0,0,0,2317
"45035010200",1868,225,1398,975,70,4,55,0,4595
"45035010300",2984,408,1316,604,13,53,158,0,5536
"45035010400",2193,262,1407,237,365,119,88,54,4725
"45035010501",3100,278,754,283,323,66,79,53,4936
"45035010503",2420,108,301,165,16,0,36,0,3046
"45035010504",4153,312,1007,366,810,0,531,74,7253
"45035010505",3933,439,424,343,606,116,410,106,6377
"45035010603",4622,585,882,0,332,115,404,99,7039
"45035010604",2704,333,826,226,148,0,79,0,4316
"45035010605",5825,544,1191,323,230,109,153,36,8411
"45035010606",1330,9,347,53,33,0,40,0,1812
"45035010700",2507,309,1522,543,63,68,113,7,5132
"45035010801",4532,276,529,228,7,0,152,6,5730
"45035010807",3961,161,487,0,44,3,189,8,4853
"45035010808",4840,373,766,313,206,32,35,14,6579
"45035010809",2679,313,244,194,194,9,0,44,3677
"45035010813",5392,962,2013,630,259,94,127,226,9703
"45035010814",4677,497,1597,91,317,0,175,0,7354
"45035010815",1973,337,637,411,476,25,177,24,4060
"45035010816",7679,82,3142,177,1054,32,741,20,12927
"45035010817",2834,91,579,144,300,30,240,17,4235
"45035010818",3713,722,3144,1021,822,13,944,402,10781
"45035010819",2936,61,771,13,333,6,18,6,4144
"45035010820",4266,185,1488,149,888,96,473,0,7545
"45037970201",1267,314,473,53,14,0,3,0,2124
"45037970202",2074,343,1832,543,105,34,30,236,5197
"45037970300",1913,233,1504,696,42,25,71,38,4522
"45037970400",1137,302,1095,108,4,39,4,54,2743
"45037970501",2348,542,1241,228,145,4,180,4,4692
"45037970502",3775,466,410,309,210,89,65,155,5479
"45039960100",199,17,1002,561,45,1,1,2,1828
"45039960200",1360,341,1403,417,137,0,0,27,3685
"45039960300",2626,317,2129,538,84,97,35,11,5837
"45039960400",1633,357,2023,1262,234,4,289,60,5862
"45039960500",1782,284,2687,1221,44,206,0,0,6224
"45041000101",1883,170,324,24,122,8,74,0,2605
"45041000102",4364,158,799,0,341,23,19,0,5704
"45041000201",1569,29,534,273,209,1,0,1,2616
"45041000202",4765,501,1539,516,299,90,258,0,7968
"45041000300",715,96,3024,551,18,0,1,0,4405
"45041000400",2047,656,1532,532,128,0,150,0,5045
"45041000500",1645,667,1112,805,105,230,92,34,4690
"45041000600",2569,182,1901,46,150,0,105,0,4953
"45041000700",18,97,1311,1477,0,0,0,0,2903
"45041000800",21,64,2611,1200,0,0,66,0,3962
"45041000900",19,2,1574,1704,31,0,0,0,3330
"45041001000",545,217,311,353,61,16,86,0,1589
"45041001100",2650,442,1034,638,22,37,46,0,4869
"45041001200",2833,149,357,61,117,0,126,0,3643
"45041001300",2609,132,448,394,29,4,183,0,3799
"45041001400",5603,246,1537,264,265,52,92,0,8059
"45041001503",2194,220,1104,264,23,0,72,150,4027
"45041001504",3048,299,1786,407,126,0,92,0,5758
"45041001505",2568,328,893,591,21,6,33,0,4440
"45041001506",1131,50,330,390,12,3,0,0,1916
"45041001601",2179,263,3140,1071,445,0,50,0,7148
"45041001602",3095,392,910,371,142,0,98,66,5074
"45041001700",1238,42,542,546,51,0,43,0,2462
"45041001800",1991,260,915,268,223,27,300,0,3984
"45041001900",2973,620,1128,751,150,21,17,45,5705
"45041002000",1731,501,933,389,54,109,12,0,3729
"45041002201",828,364,1760,1596,242,0,0,193,4983
"45041002202",1123,334,1660,612,27,228,0,228,4212
"45041002300",2325,416,349,76,12,0,44,10,3232
"45041002400",2501,526,604,209,85,73,132,16,4146
"45041002500",1856,314,501,381,0,0,127,0,3179
"45041002600",1106,51,1326,1043,20,75,25,30,3676
"45041980100",3,0,0,0,0,0,0,0,3
"45043920100",1498,115,964,771,38,0,16,0,3402
"45043920201",2128,918,1213,1157,69,0,4,49,5538
"45043920202",807,510,473,695,61,26,61,25,2658
"45043920301",2073,248,1210,585,94,295,69,232,4806
"45043920302",1958,147,449,195,34,26,21,14,2844
"45043920400",603,220,1388,577,148,16,12,0,2964
"45043920501",4270,335,152,0,86,0,0,0,4843
"45043920502",3017,229,153,156,20,0,12,0,3587
"45043920503",3987,479,611,249,62,0,141,0,5529
"45043920504",4130,154,576,84,87,0,137,0,5168
"45043920505",3182,200,96,25,98,0,0,0,3601
"45043920600",1980,592,2908,1001,47,23,51,0,6602
"45043920700",2817,193,988,925,212,397,412,514,6458
"45043920800",1120,295,1372,763,0,0,37,0,3587
"45043990100",0,0,0,0,0,0,0,0,0
"45045000100",720,102,13,80,72,0,91,29,1107
"45045000200",812,126,25,13,39,5,36,0,1056
"45045000400",720,31,117,130,7,14,1,4,1024
"45045000500",172,43,695,337,18,21,0,0,1286
"45045000700",118,193,727,693,0,71,0,66,1868
"45045000800",134,124,440,496,11,0,23,24,1252
"45045000900",201,155,390,340,51,16,2,39,1194
"45045001000",1362,245,249,133,133,9,58,9,2198
"45045001101",3182,136,223,12,89,25,238,18,3923
"45045001102",1686,96,99,7,67,0,199,0,2154
"45045001203",582,63,0,0,47,4,29,0,725
"45045001204",1445,243,580,165,90,80,54,0,2657
"45045001205",803,155,152,80,61,31,146,62,1490
"45045001302",1079,152,112,92,47,7,3,0,1492
"45045001400",2657,197,258,190,26,0,0,0,3328
"45045001501",3522,216,24,81,72,28,280,30,4253
"45045001502",261,77,1381,808,10,0,0,0,2537
"45045001600",4126,434,165,33,187,16,201,254,5416
"45045001700",2678,622,299,76,148,132,530,191,4676
"45045001803",2948,567,437,215,248,22,282,99,4818
"45045001804",3201,258,484,20,146,8,166,37,4320
"45045001805",3500,221,129,71,149,34,89,0,4193
"45045001807",4236,144,376,182,446,30,83,30,5527
"45045001808",2035,446,542,605,257,113,121,97,4216
"45045001809",2067,159,452,110,144,103,113,0,3148
"45045001810",1854,309,899,247,362,76,788,118,4653
"45045001900",3671,282,560,392,164,0,40,13,5122
"45045002001",259,132,1496,1242,26,16,92,81,3344
"45045002003",1393,379,1921,835,96,445,636,721,6426
"45045002005",777,168,1640,1143,34,91,106,38,3997
"45045002103",1667,198,968,259,36,42,202,142,3514
"45045002104",583,65,362,52,80,27,108,0,1277
"45045002105",481,413,926,433,7,46,71,192,2569
"45045002106",1473,432,542,411,46,56,44,218,3222
"45045002107",1435,342,680,307,25,15,382,257,3443
"45045002108",738,118,311,378,9,0,16,12,1582
"45045002201",2571,2123,519,609,294,318,944,1006,8384
"45045002202",889,597,231,141,170,129,271,350,2778
"45045002301",2187,805,273,144,100,147,469,600,4725
"45045002302",1712,718,295,624,43,34,208,309,3943
"45045002303",459,742,474,226,23,0,95,267,2286
"45045002304",621,371,649,691,48,20,112,258,2770
"45045002402",5621,949,101,16,212,144,138,126,7307
"45045002403",3353,964,26,7,113,4,152,6,4625
"45045002404",3104,308,0,0,59,0,13,20,3504
"45045002503",6857,1153,850,149,626,61,751,418,10865
"45045002504",1078,366,427,50,6,0,88,179,2194
"45045002505",2328,788,246,212,113,96,400,215,4398
"45045002506",2769,422,119,113,92,35,7,78,3635
"45045002507",3568,513,627,133,91,46,285,108,5371
"45045002602",2849,431,212,9,483,0,523,99,4606
"45045002604",3549,967,619,267,100,44,231,188,5965
"45045002606",5227,167,214,1,71,12,83,0,5775
"45045002608",7702,331,438,15,709,133,524,125,9977
"45045002609",5500,264,446,0,480,21,167,129,7007
"45045002610",1861,315,471,147,99,8,128,26,3055
"45045002611",3808,281,868,157,302,0,364,65,5845
"45045002701",3894,183,36,41,44,0,224,0,4422
"45045002702",6047,1545,425,9,291,0,125,0,8442
"45045002803",6271,336,390,56,538,24,508,147,8270
"45045002804",2283,16,27,0,33,18,300,0,2677
"45045002805",3792,174,349,50,169,44,441,0,5019
"45045002808",4341,327,466,592,682,218,299,155,7080
"45045002811",5544,143,1088,0,680,396,391,0,8242
"45045002812",5523,236,610,0,512,69,419,24,7393
"45045002813",3815,45,93,57,413,12,167,0,4602
"45045002814",4858,255,364,31,598,0,138,0,6244
"45045002815",5134,83,484,0,453,0,145,0,6299
"45045002816",7927,63,547,0,583,112,295,97,9624
"45045002901",2621,347,1647,234,423,28,200,171,5671
"45045002903",4128,501,1258,704,517,109,644,158,8019
"45045002904",2841,47,1702,47,162,197,299,186,5481
"45045002905",3152,94,1088,0,193,0,332,11,4870
"45045003005",1448,234,523,62,51,58,22,66,2464
"45045003008",6052,83,429,0,309,0,117,0,6990
"45045003009",4925,217,425,30,55,0,503,80,6235
"45045003010",4200,442,973,116,218,16,288,259,6512
"45045003011",4293,194,397,194,195,72,716,51,6112
"45045003012",3710,376,1025,64,143,24,413,194,5949
"45045003013",3967,428,1651,0,241,16,340,48,6691
"45045003014",3153,423,643,139,102,8,333,8,4809
"45045003015",6794,221,790,125,86,0,405,78,8499
"45045003101",4293,458,1464,338,110,61,176,0,6900
"45045003103",2313,293,59,105,75,94,85,244,3268
"45045003104",1754,201,22,8,20,0,73,0,2078
"45045003201",3072,230,250,177,159,0,123,0,4011
"45045003202",3040,379,148,0,82,31,26,23,3729
"45045003301",3593,729,624,574,52,0,195,0,5767
"45045003303",2895,492,1328,80,127,91,219,44,5276
"45045003304",3496,757,1548,161,313,30,1174,30,7509
"45045003401",356,170,324,189,0,0,60,20,1119
"45045003500",1019,507,576,238,53,23,37,184,2637
"45045003601",2793,704,1121,415,167,97,516,397,6210
"45045003602",567,492,854,745,96,29,241,367,3391
"45045003701",3270,838,573,164,290,41,522,122,5820
"45045003704",1352,1121,351,525,27,104,396,804,4680
"45045003705",1096,211,195,56,66,71,275,133,2103
"45045003706",1259,892,301,149,641,201,451,300,4194
"45045003707",2192,489,553,281,23,47,368,306,4259
"45045003801",3824,777,233,0,69,0,271,479,5653
"45045003802",3388,346,341,512,229,18,260,11,5105
"45045003902",2993,264,110,41,75,24,59,0,3566
"45045003903",3294,535,133,3,68,0,101,12,4146
"45045003904",4379,1096,664,278,347,0,83,233,7080
"45045004001",2716,193,85,60,17,17,17,0,3105
"45045004002",3029,516,0,0,21,0,28,28,3622
"45045004101",2504,660,198,49,136,116,752,90,4505
"45045004102",1108,66,14,0,7,0,18,0,1213
"45045004200",1878,331,244,58,62,12,17,0,2602
"45045004300",296,14,1707,1596,189,9,160,8,3979
"45045004400",870,234,513,191,80,13,79,92,2072
"45047970101",2054,404,1104,131,96,0,68,0,3857
"45047970102",2226,776,501,659,110,157,14,266,4709
"45047970201",2275,348,409,170,18,54,16,0,3290
"45047970202",5212,467,1859,534,243,36,84,0,8435
"45047970301",2510,203,498,127,68,100,68,91,3665
"45047970302",4220,391,467,177,275,0,13,131,5674
"45047970400",3864,772,983,245,76,22,52,21,6035
"45047970500",412,666,1472,1791,456,151,522,769,6239
"45047970600",3554,731,1563,470,124,206,59,324,7031
"45047970701",1590,199,277,11,2,0,3,33,2115
"45047970702",3017,284,852,972,83,69,129,0,5406
"45047970800",2737,942,2176,2615,445,262,415,493,10085
"45047970900",953,360,302,81,156,148,1,205,2206
"45047971000",1236,636,129,24,5,0,0,0,2030
"45049920100",1631,466,500,134,87,0,20,0,2838
"45049920200",2532,330,2902,1273,29,0,45,0,7111
"45049920300",486,314,939,323,46,10,15,18,2151
"45049920400",2056,122,1939,841,320,62,309,64,5713
"45049920500",408,42,870,521,12,2,0,0,1855
"45051010100",1707,834,396,537,0,0,57,146,3677
"45051020100",2051,486,295,597,35,24,19,28,3535
"45051020200",2581,631,1298,548,50,80,192,25,5405
"45051020300",4362,874,664,693,344,32,226,21,7216
"45051030101",212,226,493,195,106,0,25,0,1257
"45051030102",1583,141,390,206,178,0,140,0,2638
"45051030103",1853,130,465,439,67,0,26,0,2980
"45051040101",2992,653,863,218,60,0,164,0,4950
"45051040102",3161,497,736,416,43,115,237,0,5205
"45051040103",4166,437,458,83,375,0,135,66,5720
"45051040104",1950,589,104,0,37,0,61,0,2741
"45051040105",1922,201,7,0,140,0,127,0,2397
"45051040200",2881,340,437,54,0,20,44,19,3795
"45051040300",3231,544,76,74,119,49,50,239,4382
"45051040400",3501,400,138,8,62,11,262,115,4497
"45051040500",2593,543,130,44,179,16,33,100,3638
"45051050102",3344,403,70,0,68,31,19,0,3935
"45051050200",1524,109,13,0,24,0,25,0,1695
"45051050303",2016,132,49,0,36,0,22,0,2255
"45051050401",1672,281,107,55,169,0,231,134,2649
"45051050402",1699,106,0,6,26,0,17,0,1854
"45051050500",3396,442,85,138,100,273,394,249,5077
"45051050600",1299,565,953,914,195,301,401,347,4975
"45051050700",793,428,89,106,148,99,275,127,2065
"45051050900",3288,1607,591,310,714,488,486,761,8245
"45051051000",2527,205,85,0,215,26,140,48,3246
"45051051201",1426,161,9,0,21,0,20,25,1662
"45051051202",1910,211,18,0,99,133,132,140,2643
"45051051301",980,48,22,0,7,0,0,0,1057
"45051051302",2777,215,0,0,105,0,60,0,3157
"45051051403",3690,378,248,17,135,0,33,0,4501
"45051051404",2753,490,0,101,227,29,42,44,3686
"45051051405",2562,331,0,0,23,53,0,44,3013
"45051051406",2327,275,11,16,0,0,10,0,2639
"45051051501",2418,270,277,29,861,23,390,0,4268
"45051051502",5457,1096,473,200,306,38,261,24,7855
"45051051503",1740,842,278,61,657,292,899,711,5480
"45051051601",6038,1044,750,38,585,690,621,415,10181
"45051051603",2881,443,477,129,144,62,81,0,4217
"45051051604",7328,502,199,0,180,15,48,0,8272
"45051051605",4479,389,330,44,215,171,195,0,5823
"45051051700",1622,293,92,182,99,39,86,0,2413
"45051060101",1556,832,67,273,91,122,10,34,2985
"45051060102",1639,599,88,257,98,215,82,213,3191
"45051060203",4020,864,461,164,860,0,910,53,7332
"45051060204",5665,1078,490,213,111,252,82,484,8375
"45051060206",4525,594,408,128,197,78,355,27,6312
"45051060207",4400,432,123,32,106,103,145,16,5357
"45051060208",2090,310,147,0,107,54,5,25,2738
"45051060209",4313,716,436,123,431,139,241,169,6568
"45051060301",2765,370,411,321,56,0,33,2,3958
"45051060303",1689,170,15,0,32,0,42,0,1948
"45051060308",3467,429,1423,166,336,0,325,0,6146
"45051060403",1621,399,133,67,153,185,260,185,3003
"45051060404",1145,442,13,88,16,20,32,0,1756
"45051060405",2808,1092,715,491,153,92,538,92,5981
"45051060406",4896,660,106,2,174,116,142,39,6135
"45051070101",3471,585,179,57,234,160,466,214,5366
"45051070102",2407,315,165,8,16,0,0,2,2913
"45051070200",2471,271,136,382,121,95,110,130,3716
"45051070300",1510,354,650,1129,128,59,14,66,3910
"45051070400",1212,249,1521,1845,66,38,39,47,5017
"45051070500",1723,250,944,466,26,0,9,0,3418
"45051070601",3341,734,271,207,146,146,198,81,5124
"45051070602",2383,390,1193,236,88,0,64,0,4354
"45051070701",3259,402,661,100,51,82,9,0,4564
"45051070702",2728,974,1109,155,207,87,429,69,5758
"45051080101",2545,668,129,72,47,74,57,0,3592
"45051080102",1698,332,284,82,71,0,2,0,2469
"45051080200",3267,723,65,91,95,2,151,0,4394
"45051980100",31,11,0,0,0,0,0,0,42
"45051990100",0,0,0,0,0,0,0,0,0
"45053950100",2226,305,1858,431,92,115,155,115,5297
"45053950201",2082,420,912,474,189,19,117,0,4213
"45053950202",2535,576,2795,1321,714,171,928,196,9236
"45053950300",2901,1078,2393,977,644,69,1425,740,10227
"45053990100",0,0,0,0,0,0,0,0,0
"45055970100",1225,307,524,392,19,20,64,10,2561
"45055970200",2112,470,262,180,19,0,0,50,3093
"45055970300",1218,365,367,59,65,66,0,21,2161
"45055970401",2993,887,440,91,189,13,132,137,4882
"45055970402",1827,125,341,302,0,0,122,13,2730
"45055970403",1847,56,359,123,254,4,192,4,2839
"45055970500",3288,283,1086,375,348,77,290,130,5877
"45055970601",3264,397,1101,478,77,72,83,57,5529
"45055970602",2729,634,640,614,83,0,47,0,4747
"45055970700",1424,218,783,157,25,0,9,66,2682
"45055970800",2942,410,1696,1377,194,39,176,48,6882
"45055970902",1736,436,462,60,155,31,127,0,3007
"45055970903",4458,747,626,54,28,65,110,47,6135
"45055970904",4831,299,1586,557,457,101,509,21,8361
"45055970905",2522,69,301,5,6,0,0,0,2903
"45057010100",2718,832,150,116,40,0,62,0,3918
"45057010200",4897,1276,651,510,55,33,31,20,7473
"45057010300",3218,976,1101,555,41,31,78,15,6015
"45057010400",1265,126,775,377,131,10,100,0,2784
"45057010500",2207,1168,800,1156,105,0,404,261,6101
"45057010600",3057,894,625,537,94,42,374,102,5725
"45057010700",481,72,1627,1585,1,11,32,8,3817
"45057010800",1105,401,751,674,0,8,120,12,3071
"45057010900",2328,322,584,131,201,59,3,59,3687
"45057011001",3787,365,732,55,32,18,7,0,4996
"45057011002",2869,777,467,274,22,0,0,194,4603
"45057011100",2933,594,1252,546,244,42,46,23,5680
"45057011201",8036,880,713,100,645,198,783,165,11520
"45057011202",10011,434,497,168,123,0,805,27,12065
"45059920101",3828,660,1404,341,120,402,48,380,7183
"45059920102",1099,437,105,0,94,0,81,12,1828
"45059920103",2617,511,901,65,225,13,171,121,4624
"45059920104",2503,551,506,0,140,0,103,13,3816
"45059920201",2371,265,380,50,20,0,65,0,3151
"45059920202",2755,615,0,0,13,25,0,0,3408
"45059920301",2653,430,651,126,88,133,12,166,4259
"45059920302",1839,532,1132,465,44,0,149,0,4161
"45059920400",2986,254,1030,391,29,4,328,0,5022
"45059920501",1079,130,397,20,4,0,25,0,1655
"45059920502",2628,974,1355,303,231,377,317,444,6629
"45059920600",2342,384,550,723,57,43,19,43,4161
"45059920700",1342,565,1704,923,37,21,19,0,4611
"45059920800",3004,448,194,646,27,47,64,166,4596
"45059920900",1315,354,350,77,98,14,0,7,2215
"45059921001",1266,359,794,215,67,0,3,5,2709
"45059921002",1790,477,467,70,45,2,11,10,2872
"45061920100",924,326,448,172,0,0,0,0,1870
"45061920200",1681,318,1142,968,29,76,0,40,4254
"45061920301",0,0,0,0,0,0,0,0,0
"45061920302",586,24,2010,1020,89,69,141,0,3939
"45061920400",1199,147,1867,578,186,40,177,3,4197
"45061920500",382,24,863,304,22,5,0,0,1600
"45061920600",132,4,999,412,0,0,0,0,1547
"45063020100",1191,370,439,523,82,0,39,0,2644
"45063020201",1609,716,157,209,149,115,94,242,3291
"45063020202",1345,139,367,157,169,0,78,0,2255
"45063020300",1938,603,365,288,634,7,692,7,4534
"45063020505",2024,744,474,289,16,164,682,308,4701
"45063020506",2760,362,334,150,69,228,611,320,4834
"45063020507",4974,459,807,167,129,24,375,0,6935
"45063020508",1891,74,20,0,70,0,5,0,2060
"45063020509",2047,133,384,362,180,176,252,59,3593
"45063020510",2513,55,1646,442,398,61,372,46,5533
"45063020511",1416,185,927,172,334,60,46,0,3140
"45063020601",2568,308,479,450,187,232,296,10,4530
"45063020602",3164,295,408,47,40,27,176,114,4271
"45063020604",2331,400,337,106,83,0,150,198,3605
"45063020605",1417,77,221,22,97,24,88,16,1962
"45063020703",2846,699,152,124,182,0,82,47,4132
"45063020705",1807,667,1178,71,140,26,218,62,4169
"45063020706",1017,371,1562,191,67,0,502,0,3710
"45063020707",2413,75,536,326,328,0,282,0,3960
"45063020708",1744,479,26,25,13,91,0,0,2378
"45063020801",1036,179,206,254,0,0,16,0,1691
"45063020802",1783,219,423,133,138,0,102,0,2798
"45063020803",1695,443,757,260,37,147,89,18,3446
"45063020804",1488,665,325,194,31,89,269,46,3107
"45063020805",2912,1211,371,226,71,237,136,487,5651
"45063020903",3801,1126,136,46,112,0,343,565,6129
"45063020904",2366,371,312,87,120,18,136,85,3495
"45063020905",2342,530,416,172,66,0,12,54,3592
"45063020906",3531,493,13,11,0,23,0,0,4071
"45063020907",4277,303,902,268,449,0,287,0,6486
"45063020908",2362,475,159,64,273,20,274,20,3647
"45063021009",6381,1271,869,58,331,172,107,211,9400
"45063021014",4445,379,345,0,659,124,301,119,6372
"45063021017",6339,573,440,286,143,0,210,0,7991
"45063021018",3652,1127,166,50,39,0,202,103,5339
"45063021019",1317,40,44,0,0,125,82,0,1608
"45063021020",2735,221,606,1,211,7,109,38,3928
"45063021021",1492,43,0,0,0,0,53,0,1588
"45063021022",3846,21,176,11,38,214,225,114,4645
"45063021023",2496,41,217,0,36,0,150,0,2940
"45063021024",3534,97,179,2,140,182,89,184,4407
"45063021025",3195,186,10,0,16,0,0,0,3407
"45063021026",4359,0,93,0,57,0,140,0,4649
"45063021027",3352,66,41,0,390,0,55,0,3904
"45063021028",2563,213,325,174,228,0,138,12,3653
"45063021029",1636,90,395,196,225,49,46,0,2637
"45063021030",3456,446,451,1,341,33,63,0,4791
"45063021031",2873,230,263,351,60,0,294,0,4071
"45063021032",2994,321,23,12,202,7,4,0,3563
"45063021033",2998,300,636,13,275,59,24,86,4391
"45063021034",3359,206,724,22,125,42,93,45,4616
"45063021106",2413,215,443,0,82,0,15,19,3187
"45063021109",2100,107,259,513,167,90,16,0,3252
"45063021110",2440,202,440,12,172,0,41,14,3321
"45063021111",1318,206,616,30,361,0,29,32,2592
"45063021112",2432,261,409,29,53,0,37,0,3221
"45063021113",1957,185,716,181,66,33,0,0,3138
"45063021114",2988,79,243,188,267,0,145,0,3910
"45063021115",1887,143,100,0,53,0,42,0,2225
"45063021116",2245,46,282,356,302,154,30,19,3434
"45063021203",4678,179,62,0,39,114,132,103,5307
"45063021204",3137,105,175,46,121,35,167,12,3798
"45063021205",2747,167,0,6,5,65,58,0,3048
"45063021206",2226,102,300,267,46,11,8,0,2960
"45063021303",2785,210,0,0,48,0,0,0,3043
"45063021304",3719,237,89,8,233,13,225,0,4524
"45063021305",2238,357,41,17,102,14,148,109,3026
"45063021306",2990,421,51,12,114,240,154,305,4287
"45063021307",1547,96,224,57,108,62,61,69,2224
"45063021308",3009,529,798,14,64,0,67,13,4494
"45063021402",1488,273,845,1073,100,53,65,0,3897
"45063021403",1165,617,128,281,100,117,100,262,2770
"45063021404",1733,169,325,243,11,0,62,72,2615
"45063980100",0,0,0,0,0,0,0,0,0
"45065920100",1488,43,432,247,47,0,17,0,2274
"45065920200",1604,238,1580,966,10,0,20,1,4419
"45065920300",1042,148,581,221,28,18,10,0,2048
"45067950100",1590,277,1406,1146,4,0,0,0,4423
"45067950200",2015,222,2552,1058,356,88,0,20,6311
"45067950300",577,107,1076,913,8,45,0,45,2771
"45067950400",1860,372,1019,812,76,50,7,12,4208
"45067950500",2314,282,1587,221,0,0,0,0,4404
"45067950600",1296,237,1786,2483,135,53,150,0,6140
"45067950700",626,187,662,212,0,0,29,93,1809
"45067950800",893,270,629,488,130,23,291,154,2878
"45069960100",1137,497,772,304,130,69,62,0,2971
"45069960200",1016,398,2248,1495,0,94,43,0,5294
"45069960301",1852,301,1712,1268,89,0,0,0,5222
"45069960302",777,129,728,373,88,35,3,0,2133
"45069960400",1795,846,758,773,456,337,118,55,5138
"45069960500",509,134,679,564,178,38,3,12,2117
"45069960600",1119,319,707,62,283,27,0,21,2538
"45071950100",2691,139,580,114,103,33,0,33,3693
"45071950201",958,212,712,8,691,159,646,216,3602
"45071950202",3462,493,1260,581,339,516,240,516,7407
"45071950300",2000,315,521,203,110,38,16,5,3208
"45071950502",1491,220,1985,947,226,255,204,219,5547
"45071950601",2887,471,550,404,11,9,22,32,4386
"45071950602",4592,281,718,460,163,0,151,45,6410
"45071950700",2069,125,1540,359,327,0,261,0,4681
"45073030100",3462,617,0,3,55,25,22,8,4192
"45073030200",5204,511,0,0,32,0,13,79,5839
"45073030300",6171,736,80,0,112,22,227,22,7370
"45073030401",3748,1596,293,70,344,293,503,845,7692
"45073030402",1340,190,25,0,21,19,113,40,1748
"45073030500",3611,680,108,9,250,14,121,81,4874
"45073030601",3387,787,206,29,110,0,131,70,4720
"45073030602",2929,1046,329,131,61,39,30,79,4644
"45073030701",1764,512,901,346,173,0,114,0,3810
"45073030702",3439,1416,709,234,347,0,91,53,6289
"45073030800",4091,540,1054,440,341,80,451,59,7056
"45073030901",2112,479,0,0,67,0,44,0,2702
"45073030902",6350,1078,0,13,80,142,89,0,7752
"45073031000",3604,769,375,80,64,28,52,0,4972
"45073031100",2562,830,64,9,44,89,28,109,3735
"45075010100",1269,338,2504,1062,92,1,95,1,5362
"45075010200",955,470,2292,1012,191,347,65,327,5659
"45075010300",1533,141,2852,1215,411,30,27,1,6210
"45075010400",1255,123,1350,743,164,16,77,3,3731
"45075010500",1486,44,1669,402,134,0,111,0,3846
"45075010600",815,144,2190,1321,68,56,37,40,4671
"45075010700",988,48,1651,306,8,2,0,15,3018
"45075010800",546,72,2486,1377,63,0,16,0,4560
"45075010900",3386,192,3478,929,317,204,100,204,8810
"45075011000",1311,14,2849,935,133,144,33,0,5419
"45075011100",186,0,1685,1168,29,0,0,0,3068
"45075011200",18,0,387,191,0,0,0,0,596
"45075011300",59,155,1195,1419,85,6,100,18,3037
"45075011400",664,122,1820,1075,79,48,19,0,3827
"45075011500",957,535,1545,970,17,0,0,172,4196
"45075011600",2324,473,2468,737,0,162,192,0,6356
"45075011700",3074,608,1114,291,24,6,94,0,5211
"45075011800",2037,129,2054,695,40,21,0,0,4976
"45075011900",2179,466,937,110,55,21,16,0,3784
"45075012000",1692,191,1127,493,71,36,23,0,3633
"45077010100",2424,204,27,43,81,37,12,0,2828
"45077010200",3291,829,65,0,21,43,1,38,4288
"45077010300",4914,236,60,38,163,6,112,0,5529
"45077010401",1429,563,0,0,3,16,52,20,2083
"45077010402",3977,958,116,20,2,0,2,2,5077
"45077010403",1669,185,24,0,52,0,16,4,1950
"45077010501",2367,427,0,0,61,9,61,9,2934
"45077010502",2319,299,170,175,0,0,0,0,2963
"45077010601",2968,563,0,0,55,0,157,0,3743
"45077010602",5667,433,23,45,132,23,81,13,6417
"45077010700",3243,988,0,49,267,47,90,0,4684
"45077010801",3552,506,633,120,70,122,51,36,5090
"45077010802",2328,395,188,113,109,0,107,82,3322
"45077010803",2798,754,520,104,303,267,199,315,5260
"45077010804",2439,455,235,61,157,7,207,64,3625
"45077010901",3876,556,201,91,112,0,137,49,5022
"45077010902",5235,262,556,107,219,0,121,0,6500
"45077010903",3956,537,349,48,190,37,118,16,5251
"45077011001",2182,930,106,0,54,54,281,0,3607
"45077011002",5439,839,427,122,133,0,250,0,7210
"45077011003",1876,545,25,30,17,40,47,0,2580
"45077011101",2028,183,72,12,111,104,116,93,2719
"45077011102",3138,2608,565,226,342,218,15,423,7535
"45077011103",890,350,24,0,0,0,0,0,1264
"45077011202",64,175,4,43,0,5,0,0,291
"45077011203",4673,561,494,167,302,22,62,48,6329
"45077011204",1792,1072,94,162,381,301,69,65,3936
"45077011205",1122,1654,114,107,157,429,68,11,3662
"45079000100",203,55,1055,577,0,50,52,80,2072
"45079000200",155,52,854,570,46,0,0,0,1677
"45079000300",202,111,2139,699,53,8,27,0,3239
"45079000400",574,86,889,270,135,15,82,0,2051
"45079000500",41,40,903,918,74,161,68,126,2331
"45079000600",1726,144,178,310,177,0,19,0,2554
"45079000700",1113,89,305,71,130,0,0,0,1708
"45079000900",61,65,1218,1011,20,6,0,3,2384
"45079001000",10,0,937,816,28,7,5,7,1810
"45079001100",1808,323,1389,576,46,15,20,2,4179
"45079001200",1526,206,86,5,4,0,18,0,1845
"45079001300",171,68,698,1386,42,14,0,5,2384
"45079001600",774,219,157,135,72,3,48,4,1412
"45079002100",1632,633,350,64,25,26,71,13,2814
"45079002200",1041,209,100,68,6,33,63,28,1548
"45079002300",1975,178,46,0,12,5,5,0,2221
"45079002400",3782,181,81,52,424,11,380,113,5024
"45079002500",2959,437,98,21,95,21,199,121,3951
"45079002602",1779,341,515,73,50,22,69,0,2849
"45079002603",2039,485,319,1413,296,384,296,287,5519
"45079002604",464,141,510,496,113,70,92,74,1960
"45079002700",2280,625,114,61,177,18,74,30,3379
"45079002800",1345,1687,428,231,334,100,327,186,4638
"45079002900",388,275,37,0,103,35,5,0,843
"45079003000",1059,555,93,45,93,221,85,47,2198
"45079003100",309,123,199,181,23,40,1,0,876
"45079010102",2946,92,2405,523,231,9,97,0,6303
"45079010103",6443,106,8815,518,1472,2,831,0,18187
"45079010104",2225,162,1323,302,59,11,42,45,4169
"45079010200",2780,64,1994,318,140,0,52,0,5348
"45079010304",2166,242,2636,557,339,202,383,0,6525
"45079010305",3564,1072,1592,490,257,71,281,530,7857
"45079010306",7077,297,507,0,517,0,256,0,8654
"45079010307",7847,33,741,0,519,0,361,0,9501
"45079010308",3701,125,1014,180,467,0,251,0,5738
"45079010309",5902,517,3249,0,101,0,119,0,9888
"45079010403",1316,244,1484,572,204,33,26,17,3896
"45079010407",740,35,2895,715,161,0,77,0,4623
"45079010408",3,45,0,40,0,3,0,0,91
"45079010409",285,34,1013,368,71,39,87,27,1924
"45079010410",686,90,1754,483,389,168,41,64,3675
"45079010411",488,186,1333,1223,97,7,19,44,3397
"45079010412",1066,221,1569,493,112,86,71,18,3636
"45079010413",773,87,716,248,58,0,34,0,1916
"45079010501",577,153,388,407,172,51,61,0,1809
"45079010502",0,0,376,208,4,21,0,0,609
"45079010600",265,172,2730,1209,53,19,50,126,4624
"45079010701",36,2,2052,911,0,33,0,0,3034
"45079010702",137,4,2240,1023,23,62,11,43,3543
"45079010703",22,5,2346,551,14,101,0,101,3140
"45079010803",290,76,1235,343,162,63,144,14,2327
"45079010804",166,45,1717,357,17,0,13,0,2315
"45079010805",279,7,1018,403,101,13,100,14,1935
"45079010806",18,48,6,59,0,0,0,0,131
"45079010900",12,39,828,1778,87,22,0,40,2806
"45079011000",80,4,948,712,3,0,0,0,1747
"45079011101",1818,114,1182,228,77,2,38,0,3459
"45079011102",2661,40,276,417,298,108,159,108,4067
"45079011201",1643,63,103,21,26,10,25,0,1891
"45079011202",2649,258,356,137,50,27,41,11,3529
"45079011301",3308,60,877,829,350,11,65,0,5500
"45079011303",955,101,2634,417,547,117,284,107,5162
"45079011304",1010,277,2777,318,584,202,457,319,5944
"45079011305",1635,309,1874,737,500,217,608,465,6345
"45079011404",2278,220,4654,1021,769,150,423,276,9791
"45079011407",2097,97,702,227,296,14,144,84,3661
"45079011411",1912,77,1028,45,388,9,78,0,3537
"45079011412",2122,176,1477,183,541,425,315,384,5623
"45079011413",4461,349,2434,210,736,32,189,0,8411
"45079011414",2554,259,1970,345,722,40,553,0,6443
"45079011415",4313,206,4750,315,876,23,239,17,10739
"45079011416",5405,581,3802,384,1097,99,784,25,12177
"45079011417",2711,144,5061,385,451,8,312,0,9072
"45079011418",2183,39,1521,144,272,70,35,65,4329
"45079011419",1443,51,2293,318,200,21,62,0,4388
"45079011501",56,0,10,0,0,0,27,0,93
"45079011502",913,47,844,0,342,0,180,0,2326
"45079011603",3336,228,950,136,362,0,95,0,5107
"45079011604",4027,203,439,16,347,69,166,0,5267
"45079011606",1960,33,2650,390,119,7,83,24,5266
"45079011607",984,117,2291,380,195,55,301,84,4407
"45079011608",2792,272,2307,1190,514,86,402,1,7564
"45079011701",952,2960,621,889,29,200,18,50,5719
"45079011702",222,0,1747,895,0,0,25,12,2901
"45079011800",541,434,4468,1097,343,2,267,0,7152
"45079011901",1280,182,5790,820,466,266,374,45,9223
"45079011902",2877,111,1541,284,92,21,103,0,5029
"45079012000",1588,137,2337,587,370,18,227,9,5273
"45079980100",13,0,34,0,5,0,5,0,57
"45081960100",1627,304,196,101,167,280,277,280,3232
"45081960201",2332,444,1388,590,596,421,795,550,7116
"45081960202",1253,201,642,820,318,183,487,331,4235
"45081960300",3902,343,309,157,21,6,22,0,4760
"45081960400",1732,277,713,276,95,48,88,73,3302
"45083020301",158,137,354,421,5,27,69,10,1181
"45083020400",223,43,340,433,0,16,127,0,1182
"45083020500",41,45,743,536,0,56,24,0,1445
"45083020601",716,330,1379,170,132,73,78,0,2878
"45083020602",826,74,633,104,215,64,90,17,2023
"45083020603",1178,22,589,357,88,44,70,0,2348
"45083020701",310,187,1314,1344,0,288,0,74,3517
"45083020702",689,120,413,387,102,35,0,0,1746
"45083020800",8,28,379,875,0,36,0,18,1344
"45083020900",368,134,677,176,3,0,4,51,1413
"45083021001",251,142,1595,725,24,13,12,11,2773
"45083021100",1544,128,1272,335,144,10,28,14,3475
"45083021200",2294,194,133,137,27,12,55,0,2852
"45083021301",1204,184,820,178,104,3,118,28,2639
"45083021302",2165,138,125,6,15,0,7,0,2456
"45083021303",4169,246,642,329,36,78,59,0,5559
"45083021401",1140,104,280,5,0,0,10,0,1539
"45083021402",2516,438,260,15,278,0,21,0,3528
"45083021403",1562,469,665,506,449,133,670,53,4507
"45083021500",1721,570,530,369,74,26,52,0,3342
"45083021600",1026,99,730,430,83,29,45,22,2464
"45083021700",1253,318,1178,846,32,113,220,115,4075
"45083021802",1626,1615,673,258,376,311,935,1039,6833
"45083021803",4093,436,1262,36,678,77,160,35,6777
"45083021804",929,637,322,226,201,213,427,577,3532
"45083021901",3368,1473,249,264,525,128,1024,1036,8067
"45083021902",4703,491,1282,1,669,32,174,89,7441
"45083022003",1894,661,685,266,107,47,43,45,3748
"45083022004",1247,127,548,386,196,135,0,9,2648
"45083022005",3657,231,952,267,592,0,640,0,6339
"45083022006",1275,25,1715,1094,19,0,247,0,4375
"45083022007",1713,188,920,79,166,0,323,0,3389
"45083022101",2274,120,943,197,150,16,17,0,3717
"45083022102",1644,332,50,33,18,67,36,82,2262
"45083022201",3713,465,345,189,32,0,166,0,4910
"45083022202",2502,610,243,222,14,18,97,8,3714
"45083022302",3774,1099,235,118,112,0,40,0,5378
"45083022303",991,486,122,129,136,8,152,188,2212
"45083022304",2631,1366,196,37,57,19,54,190,4550
"45083022401",4266,474,347,445,199,11,123,99,5964
"45083022403",6286,881,718,95,196,60,293,0,8529
"45083022404",4120,683,513,0,145,0,32,0,5493
"45083022405",3532,245,118,10,144,6,144,7,4206
"45083022406",4981,223,307,364,265,0,136,0,6276
"45083022500",3077,533,85,6,121,16,1,12,3851
"45083022600",2458,495,152,145,102,4,149,4,3509
"45083022700",5263,957,178,37,171,9,190,54,6859
"45083022801",4792,117,747,0,487,143,511,0,6797
"45083022802",4376,921,638,228,578,64,47,111,6963
"45083022900",3669,1443,781,394,317,99,88,321,7112
"45083023001",5588,658,502,58,632,30,423,41,7932
"45083023002",1728,204,235,55,334,351,20,111,3038
"45083023101",2659,677,972,354,548,288,308,246,6052
"45083023102",3562,708,911,346,316,71,623,150,6687
"45083023201",3210,85,287,0,64,12,47,0,3705
"45083023202",2155,677,410,84,163,24,53,133,3699
"45083023301",1320,164,149,0,108,65,19,65,1890
"45083023302",1599,543,1201,546,534,472,1103,846,6844
"45083023401",1489,119,525,99,112,0,18,0,2362
"45083023402",3532,235,310,0,125,0,59,0,4261
"45083023403",4428,198,956,149,448,313,66,72,6630
"45083023404",4537,739,846,16,87,39,41,0,6305
"45083023405",3972,245,123,11,216,0,95,28,4690
"45083023500",3513,550,207,35,73,171,65,0,4614
"45083023600",3777,899,802,221,172,101,109,0,6081
"45083023700",3359,684,165,200,19,55,9,7,4498
"45083023801",4405,333,855,0,147,0,103,0,5843
"45083023802",3940,375,32,27,33,9,20,30,4466
"45083023900",3394,452,571,197,115,159,56,58,5002
"45085000100",268,79,1368,406,42,22,22,25,2232
"45085000201",2203,132,1502,307,65,17,63,0,4289
"45085000202",2677,158,2142,997,573,29,114,0,6690
"45085000300",1878,177,631,110,139,49,45,49,3078
"45085000400",4055,247,3151,815,415,76,547,0,9306
"45085000500",653,82,1114,420,4,33,8,38,2352
"45085000600",1711,430,1234,323,81,86,45,65,3975
"45085000700",1504,194,1696,860,36,51,91,119,4551
"45085000800",110,172,1767,1244,65,90,66,85,3599
"45085000901",1473,426,1181,191,387,118,88,208,4072
"45085000902",3957,155,428,0,64,0,57,17,4678
"45085001100",861,285,1797,816,411,70,438,170,4848
"45085001300",241,67,1168,686,0,40,16,0,2218
"45085001500",0,0,984,926,26,50,0,0,1986
"45085001600",101,5,2154,1444,96,92,31,0,3923
"45085001701",4603,583,1461,80,64,0,64,0,6855
"45085001703",2952,201,1355,33,379,57,269,0,5246
"45085001704",2488,49,2295,670,311,50,126,100,6089
"45085001801",2275,280,983,482,111,0,27,0,4158
"45085001802",3544,603,2616,865,139,78,493,39,8377
"45085001901",3913,559,1207,221,274,8,8,27,6217
"45085001902",2935,368,2170,322,11,0,0,0,5806
"45085002000",1951,226,1100,734,45,48,144,18,4266
"45087030100",1169,123,420,275,14,5,15,0,2021
"45087030200",771,203,821,622,0,72,0,0,2489
"45087030300",2529,228,766,348,198,0,142,0,4211
"45087030400",3395,520,1175,594,70,68,0,0,5822
"45087030500",1319,257,430,69,85,5,32,52,2249
"45087030600",517,53,1100,282,2,1,0,0,1955
"45087030700",2574,304,422,99,66,33,39,0,3537
"45087030800",2013,531,371,289,33,78,24,0,3339
"45087030900",1920,193,346,58,57,2,0,0,2576
"45089970100",923,144,494,150,0,5,0,0,1716
"45089970200",384,18,778,275,0,0,0,0,1455
"45089970300",1805,208,1850,1111,38,0,56,0,5068
"45089970400",860,159,1054,531,7,35,0,0,2646
"45089970501",608,83,1741,999,67,0,84,11,3593
"45089970502",269,26,2518,1393,0,0,0,0,4206
"45089970600",2150,428,1718,1068,72,89,40,114,5679
"45089970700",313,154,1288,815,0,15,0,8,2593
"45089970801",192,66,1262,868,22,0,0,0,2410
"45089970802",0,0,0,0,0,0,0,0,0
"45089970900",1297,134,773,335,38,0,38,14,2629
"45091060102",1634,494,254,90,22,10,65,15,2584
"45091060200",1671,464,727,435,316,112,346,66,4137
"45091060300",854,553,1700,744,227,15,44,14,4151
"45091060401",94,132,1301,534,0,16,0,16,2093
"45091060402",206,4,876,693,43,0,56,22,1900
"45091060501",532,469,1298,808,39,39,26,71,3282
"45091060502",193,25,1873,140,0,120,0,0,2351
"45091060600",0,6,0,1,0,0,0,0,7
"45091060700",3197,246,403,351,137,73,26,0,4433
"45091060802",1510,211,97,6,135,0,22,0,1981
"45091060803",2843,343,1238,116,125,95,218,204,5182
"45091060804",2472,552,850,68,364,48,265,101,4720
"45091060901",1864,489,1299,668,514,53,252,63,5202
"45091060904",4873,381,945,0,235,0,144,93,6671
"45091060905",5368,1004,1265,755,438,222,142,159,9353
"45091060906",6266,1052,497,32,556,0,316,213,8932
"45091060907",6004,549,1389,420,830,26,848,52,10118
"45091061003",8737,323,454,13,310,0,310,0,10147
"45091061004",6184,209,578,0,180,0,534,48,7733
"45091061005",8077,456,317,445,519,48,698,0,10560
"45091061006",2665,25,107,0,296,0,275,0,3368
"45091061007",4790,589,968,30,618,24,812,287,8118
"45091061008",3259,96,429,0,368,0,167,18,4337
"45091061101",2384,461,601,115,79,23,37,45,3745
"45091061103",4279,383,107,293,231,6,83,0,5382
"45091061104",3635,51,242,0,186,0,208,0,4322
"45091061201",4397,1049,1221,535,434,107,181,153,8077
"45091061202",3002,630,57,0,798,200,37,6,4730
"45091061203",4422,953,494,226,144,54,93,88,6474
"45091061301",1590,93,2476,399,171,0,15,45,4789
"45091061302",3463,185,685,435,303,0,140,9,5220
"45091061401",3073,422,324,12,48,237,18,74,4208
"45091061403",3844,331,533,0,67,21,0,11,4807
"45091061404",2256,170,827,78,57,21,112,41,3562
"45091061501",5152,1047,642,0,751,108,500,153,8353
"45091061502",5914,1438,677,70,0,0,273,163,8535
"45091061601",1144,154,720,600,131,0,6,0,2755
"45091061602",2793,476,1119,790,225,169,180,128,5880
"45091061701",3246,681,104,8,99,84,43,92,4357
"45091061705",4110,771,0,18,224,6,44,0,5173
"45091061706",3689,248,165,65,65,21,52,0,4305
"45091061707",7264,363,318,277,334,29,305,17,8907
"45091061708",4007,149,269,0,137,30,359,30,4981
"45091061801",1524,427,723,99,250,0,122,0,3145
"45091061802",3359,605,190,248,25,49,0,0,4476
"45091061900",3427,413,385,43,31,38,118,0,4455
"46003973600",2307,191,37,0,64,7,109,22,2737
"46005956600",1574,186,0,16,17,31,32,0,1856
"46005956700",1673,315,0,0,0,4,13,4,2009
"46005956800",1386,133,28,0,148,10,29,17,1751
"46005956900",1880,931,58,0,225,24,169,487,3774
"46005957000",4065,1185,0,10,377,292,151,527,6607
"46005957100",2329,136,0,0,198,300,95,26,3084
"46007941000",368,33,7,0,488,414,12,0,1322
"46007941200",563,36,0,29,617,817,86,32,2180
"46009967600",2738,414,0,6,124,10,140,0,3432
"46009967700",2044,290,5,0,38,8,4,0,2389
"46011958600",3306,186,4,0,109,117,81,56,3859
"46011958700",4652,295,15,39,100,20,75,31,5227
"46011958802",3415,1256,0,0,200,70,105,0,5046
"46011958803",4122,479,13,0,285,0,130,24,5053
"46011958900",3008,1617,55,13,128,351,72,97,5341
"46011959000",4158,549,227,0,317,46,7,0,5304
"46013951300",4654,388,0,0,79,52,101,0,5274
"46013951400",5384,523,315,0,428,0,83,0,6733
"46013951500",1620,500,0,0,317,181,90,47,2755
"46013951600",2990,255,0,0,447,95,0,0,3787
"46013951700",3762,613,27,0,159,103,95,145,4904
"46013951800",4532,491,90,0,38,17,0,0,5168
"46013951900",3293,181,56,0,64,2,103,28,3727
"46013952000",4204,234,24,0,101,0,10,3,4576
"46015973100",1725,524,0,0,121,9,42,6,2427
"46015973200",2158,149,0,0,303,139,59,0,2808
"46017940200",301,38,11,0,1013,646,24,0,2033
"46019967600",2735,355,0,0,231,26,114,12,3473
"46019967700",5825,666,1,5,230,78,192,28,7025
"46021964100",1193,156,0,0,60,29,1,0,1439
"46023940200",1183,63,1,0,721,1115,21,31,3135
"46023940300",1681,327,9,0,815,553,91,38,3514
"46023970100",2266,128,1,0,35,1,16,3,2450
"46025955800",2911,487,3,31,80,50,51,30,3643
"46027965700",3304,1053,59,17,345,211,81,57,5127
"46027965800",2616,134,1,0,34,0,9,0,2794
"46027965900",1857,1695,17,53,141,129,67,70,4029
"46029954100",3084,180,11,9,76,24,58,25,3467
"46029954301",3550,421,0,15,378,10,17,24,4415
"46029954302",4598,200,0,0,0,0,30,0,4828
"46029954400",3492,936,0,7,211,116,196,35,4993
"46029954501",1872,196,8,0,166,5,63,0,2310
"46029954502",4417,461,0,0,88,177,33,0,5176
"46029954600",2295,128,0,0,48,14,2,0,2487
"46031941000",759,76,0,0,291,547,2,11,1686
"46031941100",390,33,7,4,820,1145,12,11,2422
"46033965100",4872,365,3,0,224,105,116,73,5758
"46033965200",2033,309,0,0,81,22,33,0,2478
"46035962600",2705,215,0,0,24,43,5,31,3023
"46035962700",5208,557,80,0,84,2,8,0,5939
"46035962800",4221,893,0,0,324,38,37,0,5513
"46035962900",3623,509,20,0,330,25,270,10,4787
"46037952700",1300,299,0,0,14,14,0,28,1655
"46037952800",1551,383,0,0,7,12,0,0,1953
"46037952900",1121,177,0,0,245,344,0,8,1895
"46039953600",2604,171,36,0,6,0,91,7,2915
"46039953700",1373,54,0,0,18,5,0,5,1455
"46041941500",132,10,20,0,1432,947,4,44,2589
"46041941700",970,60,0,0,1135,695,0,96,2956
"46043969600",2406,363,0,0,100,25,25,0,2919
"46045962100",1918,283,2,0,17,33,0,0,2253
"46045962200",1509,142,0,0,9,2,11,0,1673
"46047964100",2201,403,0,0,98,35,23,0,2760
"46047964200",2678,538,49,22,424,188,167,0,4066
"46049961100",1945,316,0,0,27,12,13,73,2386
"46051953100",4558,455,5,18,62,48,158,8,5312
"46051953300",1849,172,0,0,21,2,19,0,2063
"46053971100",1641,286,3,0,45,98,6,0,2079
"46053971200",1555,253,0,4,136,166,1,43,2158
"46055960100",1672,229,4,0,60,82,12,0,2059
"46057955100",2445,184,4,1,79,36,100,20,2869
"46057955200",2878,133,1,4,12,17,48,7,3100
"46059975600",1270,176,0,0,3,0,19,0,1468
"46059975700",1667,154,0,0,20,0,4,0,1845
"46061964100",2762,426,83,20,38,53,18,18,3418
"46063968700",998,188,3,5,16,15,0,0,1225
"46065977700",4636,251,0,0,190,236,40,99,5452
"46065977800",4183,201,0,0,335,340,54,0,5113
"46065977900",1722,199,0,83,374,205,76,74,2733
"46065978000",2861,73,39,0,297,90,21,6,3387
"46067968600",2425,425,15,0,29,46,87,14,3041
"46067968700",2029,227,0,0,37,0,0,0,2293
"46067968800",1470,230,0,0,13,12,25,6,1756
"46069976700",1160,78,0,0,147,39,26,0,1450
"46071941200",301,40,5,0,764,727,45,3,1885
"46071961100",1066,96,0,0,133,0,0,0,1295
"46073974100",1734,211,0,0,44,0,24,36,2049
"46075091600",716,58,10,0,7,14,4,0,809
"46077958100",2680,252,0,22,43,19,40,52,3108
"46077958200",1778,172,0,0,71,4,13,0,2038
"46079960100",2139,92,0,0,21,6,32,8,2298
"46079960200",5128,1239,50,0,268,46,69,89,6889
"46079960300",1926,219,0,0,14,4,5,19,2187
"46081966100",5705,412,9,5,106,27,151,8,6423
"46081966200",2590,758,0,0,232,71,44,62,3757
"46081966301",3149,568,0,0,230,161,216,60,4384
"46081966302",3494,633,0,0,301,67,0,0,4495
"46081966600",4150,649,11,30,125,120,133,21,5239
"46083010101",4196,318,82,0,318,0,31,0,4945
"46083010102",7426,273,0,0,118,0,189,0,8006
"46083010103",5017,252,0,0,288,0,19,0,5576
"46083010104",9049,283,83,0,395,3,115,54,9982
"46083010105",600,23,48,0,17,0,0,0,688
"46083010106",1124,23,0,0,6,0,30,0,1183
"46083010107",4381,256,57,79,111,41,90,13,5028
"46083010108",2088,19,0,0,10,0,6,0,2123
"46083010200",3123,236,71,0,126,40,82,28,3706
"46083010300",4406,207,37,17,91,7,30,0,4795
"46083010400",2418,90,0,0,52,0,41,0,2601
"46085940100",98,17,0,0,863,564,8,5,1555
"46085972600",2000,94,0,0,121,42,0,4,2261
"46087964600",2971,218,0,9,55,21,12,15,3301
"46087964700",1949,175,8,2,35,8,88,26,2291
"46089963100",1777,385,2,0,38,109,27,25,2363
"46091950800",3555,375,0,2,328,318,126,184,4888
"46093020200",500,61,130,0,26,22,0,0,739
"46093020301",6499,786,73,0,647,78,218,102,8403
"46093020302",4994,207,0,0,360,31,158,0,5750
"46093020400",5512,787,0,0,121,204,69,0,6693
"46093020500",3370,262,167,0,400,8,368,0,4575
"46095940300",656,163,0,0,608,607,62,14,2110
"46097961600",1933,249,11,0,74,2,50,0,2319
"46099000100",1858,265,50,210,426,189,128,112,3238
"46099000201",2239,419,422,63,157,987,340,141,4768
"46099000202",1741,280,129,0,283,33,16,0,2482
"46099000300",2595,428,186,171,230,140,303,68,4121
"46099000401",2075,171,224,0,123,258,135,233,3219
"46099000405",3127,366,676,137,748,430,35,37,5556
"46099000406",2427,236,140,259,277,3,220,12,3574
"46099000407",2260,347,43,124,53,29,85,0,2941
"46099000408",2410,202,263,464,732,200,835,224,5330
"46099000500",2035,241,47,146,398,316,359,97,3639
"46099000600",1827,294,175,15,275,104,96,8,2794
"46099000700",2532,711,301,116,449,294,393,35,4831
"46099000900",2009,688,298,23,266,79,246,182,3791
"46099001001",2732,486,10,0,159,56,148,74,3665
"46099001002",3350,459,97,17,590,220,533,6,5272
"46099001101",3049,803,71,20,248,124,55,140,4510
"46099001105",5567,379,106,0,218,66,65,22,6423
"46099001106",9841,361,0,0,233,65,469,0,10969
"46099001107",3138,170,9,0,235,41,17,0,3610
"46099001108",3822,405,29,71,351,198,266,30,5172
"46099001200",3458,243,282,0,384,0,36,0,4403
"46099001500",3681,512,175,311,227,176,29,4,5115
"46099001600",3020,135,12,0,34,32,43,0,3276
"46099001700",1853,114,74,0,6,19,5,4,2075
"46099001801",5634,179,197,176,359,122,223,28,6918
"46099001803",6911,217,59,182,327,0,52,0,7748
"46099001804",3845,191,0,0,246,25,255,0,4562
"46099001901",1783,94,0,0,108,78,34,0,2097
"46099001902",4939,154,0,0,24,0,24,0,5141
"46099010101",4118,229,16,0,230,54,88,25,4760
"46099010102",3607,362,10,0,96,10,132,0,4217
"46099010200",2459,141,0,0,15,11,62,2,2690
"46099010300",5761,171,7,0,37,10,25,10,6021
"46099010401",1535,60,0,0,3,0,48,0,1646
"46099010402",2364,72,3,0,39,0,12,0,2490
"46099010403",1536,0,23,0,75,0,24,0,1658
"46099010404",4249,162,8,138,189,11,40,6,4803
"46099010405",2926,376,157,57,262,12,207,11,4008
"46099010406",1755,38,9,0,112,11,29,0,1954
"46099010501",4568,432,0,0,71,0,10,24,5105
"46099010502",3345,489,20,0,41,19,8,0,3922
"46099010600",3614,359,43,55,117,355,6,0,4549
"46101959600",2983,298,47,0,83,75,27,0,3513
"46101959700",1599,269,0,0,749,272,87,52,3028
"46103010200",2470,473,0,3,409,946,179,6,4486
"46103010300",1455,515,24,60,450,384,205,20,3113
"46103010400",2270,396,57,56,667,698,209,0,4353
"46103010500",1176,496,0,43,940,329,285,156,3425
"46103010600",2536,399,13,0,458,272,73,12,3763
"46103010700",2908,255,42,51,515,342,150,127,4390
"46103010800",3121,511,0,9,425,72,121,11,4270
"46103010903",6976,369,97,0,771,29,157,44,8443
"46103010904",3851,441,132,0,281,43,210,68,5026
"46103010905",3616,431,157,21,499,303,40,0,5067
"46103010906",4769,269,103,0,213,81,65,19,5519
"46103010907",1421,161,0,0,438,100,166,0,2286
"46103011001",2145,246,0,0,222,10,128,60,2811
"46103011002",5048,310,72,0,356,173,567,0,6526
"46103011004",6037,257,0,0,462,65,285,38,7144
"46103011005",2158,113,9,0,120,42,28,33,2503
"46103011100",2618,163,27,0,448,159,8,19,3442
"46103011200",2439,139,18,4,92,62,29,18,2801
"46103011300",5108,412,97,0,350,170,87,0,6224
"46103011400",5818,567,7,0,855,256,328,59,7890
"46103011500",215,216,43,0,22,184,11,157,848
"46103011600",5767,354,169,3,723,173,148,0,7337
"46103011700",3505,200,13,0,434,124,201,123,4600
"46105968300",2494,379,2,0,57,34,39,4,3009
"46107000100",1877,259,0,0,68,16,5,8,2233
"46109940400",1060,104,0,0,1014,686,30,2,2896
"46109940700",1811,164,10,22,298,197,53,11,2566
"46109940800",1126,129,6,5,1042,688,27,40,3063
"46109950400",1523,139,0,0,19,3,29,0,1713
"46111962100",1990,288,0,0,18,0,33,0,2329
"46113940500",179,34,0,0,2314,2055,43,0,4625
"46113940800",87,50,18,0,1476,2899,43,0,4573
"46113940900",160,48,0,0,2311,2185,15,45,4764
"46115000100",1742,89,0,0,5,0,5,0,1841
"46115000200",2336,349,4,0,2,36,27,0,2754
"46115000300",1429,259,12,0,56,22,78,0,1856
"46117960100",2430,182,0,0,223,116,49,7,3007
"46119979100",1371,60,0,0,14,0,39,0,1484
"46121940100",369,29,25,0,1758,2088,134,55,4458
"46121940200",627,25,0,9,2311,2316,35,86,5409
"46123971600",1837,214,0,0,39,103,0,0,2193
"46123971700",2017,398,0,0,249,524,39,0,3227
"46125965100",3554,304,31,0,62,41,45,15,4052
"46125965200",3645,439,10,3,38,32,32,61,4260
"46127020100",3947,168,7,0,115,15,132,0,4384
"46127020200",2445,139,47,0,13,15,15,0,2674
"46127020300",6816,308,66,0,444,0,234,28,7896
"46129965100",1491,168,0,17,54,34,13,17,1794
"46129965200",2446,253,0,0,698,122,39,0,3558
"46135966100",2215,396,0,18,155,184,98,0,3066
"46135966200",4964,600,22,143,198,29,156,0,6112
"46135966301",2606,209,0,0,10,14,2,9,2850
"46135966302",4043,843,0,0,172,115,108,12,5293
"46135966400",3574,265,22,0,42,49,23,13,3988
"46137941600",630,53,9,4,1034,1071,39,46,2886
"47001020100",1257,629,352,235,371,45,0,0,2889
"47001020201",3065,185,328,0,480,0,102,0,4160
"47001020202",3160,387,246,0,217,0,331,69,4410
"47001020300",2861,343,256,36,257,27,196,156,4132
"47001020400",3089,1083,78,81,121,146,357,21,4976
"47001020500",2153,995,477,192,151,43,38,97,4146
"47001020600",1995,313,126,4,145,24,34,35,2676
"47001020700",1321,420,0,0,13,0,0,0,1754
"47001020800",3616,802,14,0,19,19,6,3,4479
"47001020901",4976,1143,3,0,97,0,29,0,6248
"47001020902",5102,585,0,0,32,38,41,0,5798
"47001021000",3809,1930,101,0,49,16,0,0,5905
"47001021100",3189,232,45,12,97,0,9,6,3590
"47001021201",3931,570,66,22,93,52,0,0,4734
"47001021202",4099,863,56,0,61,156,24,108,5367
"47001021301",2919,325,0,17,8,0,51,0,3320
"47001021302",6364,689,118,0,130,0,100,0,7401
"47001980100",0,0,0,0,0,0,0,0,0
"47003950100",3213,288,195,8,150,0,54,4,3912
"47003950200",5804,1012,132,16,190,7,128,0,7289
"47003950300",3236,442,29,0,141,61,83,0,3992
"47003950401",3408,751,290,83,104,394,496,410,5936
"47003950402",3947,814,300,58,547,417,801,458,7342
"47003950500",3016,1401,242,199,327,445,509,245,6384
"47003950600",3947,1805,972,63,505,306,1211,594,9403
"47003950700",2113,641,45,7,118,2,71,147,3144
"47003950800",2425,226,45,62,11,0,0,0,2769
"47005963000",2498,736,0,0,21,10,9,7,3281
"47005963100",2547,356,256,12,34,0,23,0,3228
"47005963200",1571,724,0,21,18,0,57,46,2437
"47005963300",2441,920,70,96,10,47,84,35,3703
"47005963400",3044,587,106,5,6,7,7,60,3822
"47007953000",2551,621,0,0,157,0,27,0,3356
"47007953100",4140,1115,169,15,42,23,161,40,5705
"47007953200",2352,811,0,0,11,10,8,0,3192
"47009010100",1450,669,616,523,0,81,134,279,3752
"47009010200",4327,894,324,60,86,1,269,0,5961
"47009010301",4074,881,172,42,39,13,18,23,5262
"47009010302",2229,621,110,0,93,18,15,25,3111
"47009010400",2226,294,94,0,19,29,71,2,2735
"47009010500",1849,338,109,20,82,7,33,53,2491
"47009010600",2279,623,0,0,100,33,0,0,3035
"47009010700",3745,503,92,0,127,167,70,106,4810
"47009010800",1818,477,274,43,10,133,40,71,2866
"47009010900",5218,397,67,2,85,0,303,15,6087
"47009011001",4596,868,13,0,117,32,58,298,5982
"47009011002",3807,185,0,0,98,91,35,31,4247
"47009011101",3483,1087,241,0,105,0,83,0,4999
"47009011102",7995,412,32,0,139,44,56,0,8678
"47009011200",5999,1250,133,0,462,0,292,49,8185
"47009011301",5356,537,191,1,29,0,178,0,6292
"47009011302",4435,755,0,0,111,71,24,0,5396
"47009011401",1285,269,0,0,133,0,44,3,1734
"47009011402",3578,849,0,0,9,28,0,0,4464
"47009011501",1564,265,0,0,43,16,10,0,1898
"47009011502",3608,1160,0,0,30,75,13,0,4886
"47009011503",5656,850,16,0,51,0,292,0,6865
"47009011602",8017,1063,0,0,98,0,208,87,9473
"47009011603",4396,343,144,0,100,0,119,22,5124
"47009011604",3554,242,25,0,279,56,43,0,4199
"47009011605",2772,201,0,7,48,0,89,0,3117
"47009980100",0,0,0,0,0,0,0,0,0
"47009980200",4,0,0,0,5,0,5,0,14
"47011010100",3274,701,442,13,230,109,427,25,5221
"47011010200",4443,746,0,68,129,0,524,158,6068
"47011010300",1486,1034,99,0,100,15,36,102,2872
"47011010400",616,917,385,195,219,14,19,254,2619
"47011010500",1372,765,51,58,62,12,91,92,2503
"47011010600",2243,398,123,25,57,110,159,277,3392
"47011010700",2276,1559,217,228,134,151,158,243,4966
"47011010800",1469,1173,280,69,16,118,47,203,3375
"47011010900",2820,408,0,0,0,12,41,19,3300
"47011011000",4431,734,84,0,88,0,129,24,5490
"47011011100",8030,1480,264,0,215,43,94,272,10398
"47011011201",4366,1223,161,84,172,104,160,115,6385
"47011011202",6674,1195,231,110,127,143,347,337,9164
"47011011300",6426,803,0,0,338,18,137,7,7729
"47011011401",6427,1360,535,0,235,0,29,0,8586
"47011011402",1750,562,47,32,130,0,248,34,2803
"47011011500",5901,1004,0,250,235,0,80,0,7470
"47011011601",4206,553,15,1,54,0,8,110,4947
"47011011602",4416,608,31,0,34,58,49,27,5223
"47013950100",2126,904,0,0,127,0,0,16,3173
"47013950200",1597,616,64,70,42,13,31,0,2433
"47013950300",1199,428,0,0,52,0,0,0,1679
"47013950400",3933,799,0,0,112,30,36,17,4927
"47013950500",4281,834,9,0,110,11,145,0,5390
"47013950600",2920,1283,16,0,14,0,0,51,4284
"47013950700",2788,1573,0,0,32,0,0,0,4393
"47013950800",1732,427,0,0,37,0,0,0,2196
"47013950900",2424,647,0,0,13,16,13,0,3113
"47013951000",2257,407,0,0,0,0,0,1,2665
"47013951100",4733,875,42,0,87,46,116,58,5957
"47015960100",3064,655,8,2,2,10,15,1,3757
"47015960200",4655,1188,60,17,122,59,3,47,6151
"47015960300",3057,487,75,21,93,23,142,23,3921
"47017962000",2909,870,203,44,83,196,9,196,4510
"47017962100",4719,950,549,336,84,69,140,110,6957
"47017962201",2248,356,61,231,120,156,0,0,3172
"47017962202",3335,515,51,84,20,32,66,0,4103
"47017962300",3276,613,407,104,30,6,53,1,4490
"47017962400",2031,244,190,83,50,0,0,16,2614
"47017962500",1721,271,108,134,26,52,17,23,2352
"47017980100",0,0,0,0,0,0,0,0,0
"47019070100",1495,373,16,9,16,0,0,0,1909
"47019070200",3544,541,31,0,43,0,55,0,4214
"47019070300",3435,1272,118,178,170,167,41,60,5441
"47019070400",1382,764,5,3,16,0,0,3,2173
"47019070500",3290,665,0,0,27,0,11,41,4034
"47019070600",2179,629,12,0,167,0,42,0,3029
"47019070700",2817,399,0,0,44,10,118,0,3388
"47019070800",2071,559,9,9,84,50,14,42,2838
"47019070900",2259,662,85,59,35,25,168,30,3323
"47019071000",2059,805,0,21,26,0,7,6,2924
"47019071100",1244,325,0,0,58,2,42,0,1671
"47019071200",2663,992,0,17,17,8,82,0,3779
"47019071300",5371,1621,0,0,83,0,0,26,7101
"47019071400",2169,945,0,0,34,18,7,0,3173
"47019071500",1541,476,13,0,13,20,0,4,2067
"47019071600",918,424,0,0,17,7,0,7,1373
"47019071700",2791,1004,0,1,119,0,91,0,4006
"47021070102",3578,295,2,0,88,39,146,0,4148
"47021070103",3272,319,0,0,183,41,243,0,4058
"47021070104",3872,817,72,50,260,23,80,74,5248
"47021070201",3607,451,51,1,73,0,133,0,4316
"47021070202",3661,740,51,0,178,43,20,0,4693
"47021070203",3201,371,0,0,33,0,0,0,3605
"47021070300",2154,1192,223,55,64,0,36,133,3857
"47021070401",1955,364,25,25,0,0,0,0,2369
"47021070402",6268,1007,0,21,149,28,102,8,7583
"47023970100",4480,929,435,61,257,19,203,66,6450
"47023970200",2296,838,577,556,90,83,58,54,4552
"47023970300",4642,743,127,0,0,0,0,19,5531
"47025970100",2085,455,6,0,13,9,0,16,2584
"47025970200",2311,268,1,3,19,29,10,2,2643
"47025970300",2683,831,0,0,49,117,0,0,3680
"47025970400",457,210,0,0,7,43,0,0,717
"47025970500",2055,697,0,0,93,0,8,0,2853
"47025970600",3580,735,0,0,0,10,51,10,4386
"47025970700",3799,1522,13,0,233,0,74,0,5641
"47025970800",2564,1208,10,27,14,5,0,35,3863
"47025970900",3247,1039,10,21,11,113,0,75,4516
"47027955000",3550,1065,69,77,38,11,77,28,4915
"47027955100",2347,502,0,0,23,29,31,0,2932
"47029920100",2876,802,0,0,51,0,111,0,3840
"47029920200",3176,1893,101,2,195,85,61,9,5522
"47029920300",2846,697,60,41,52,53,81,4,3834
"47029920400",1183,493,0,0,0,35,0,0,1711
"47029920501",4101,2110,44,19,203,17,113,137,6744
"47029920502",4389,1313,0,1,22,0,43,11,5779
"47029920600",2913,898,153,52,60,36,69,1,4182
"47029920700",2490,1176,0,0,361,24,16,54,4121
"47029980100",0,0,0,0,0,0,0,0,0
"47031970100",2929,976,0,5,14,4,4,48,3980
"47031970200",4645,1186,0,0,71,349,27,319,6597
"47031970300",1506,234,0,0,39,4,4,3,1790
"47031970400",3974,1191,56,0,323,189,335,275,6343
"47031970500",3909,1391,189,5,375,79,131,65,6144
"47031970600",3046,643,53,0,217,40,100,19,4118
"47031970700",3287,653,5,0,97,51,29,12,4134
"47031970801",3425,657,26,50,224,142,99,24,4647
"47031970802",5232,547,83,46,107,167,0,26,6208
"47031970900",1956,1346,103,247,314,230,129,110,4435
"47031971000",4496,668,125,42,481,31,275,0,6118
"47031980100",0,0,0,0,0,0,0,0,0
"47033961000",1396,164,322,52,40,22,121,24,2141
"47033961100",2541,600,433,77,161,126,140,151,4229
"47033961200",1521,236,11,17,138,88,123,81,2215
"47033961300",1644,281,119,93,44,76,58,65,2380
"47033961400",2652,467,566,161,139,89,419,161,4654
"47035970101",3076,211,142,0,46,0,10,0,3485
"47035970102",4982,779,54,0,144,18,64,29,6070
"47035970200",5633,445,0,1,166,30,56,55,6386
"47035970301",2722,549,0,0,0,0,43,0,3314
"47035970302",3543,845,23,0,133,11,76,0,4631
"47035970400",3765,1940,0,0,65,116,107,226,6219
"47035970501",2078,220,0,0,32,15,32,92,2469
"47035970502",2591,1135,34,0,84,73,87,163,4167
"47035970601",4258,391,0,0,26,104,126,93,4998
"47035970602",2953,447,0,0,49,0,106,0,3555
"47035970603",1966,112,15,0,12,0,21,0,2126
"47035970701",1736,427,0,0,7,0,20,0,2190
"47035970702",3412,744,0,0,52,14,22,0,4244
"47035970800",3154,544,0,0,61,35,5,19,3818
"47037010103",2281,83,250,0,29,0,34,0,2677
"47037010104",2745,140,169,10,57,21,19,21,3182
"47037010105",627,55,2826,569,69,38,26,0,4210
"47037010106",653,86,1966,175,81,76,84,0,3121
"47037010201",2356,247,1469,221,303,0,646,0,5242
"47037010202",3151,204,18,45,62,0,33,0,3513
"47037010301",2467,278,732,220,204,21,188,23,4133
"47037010302",1020,307,283,219,73,22,46,16,1986
"47037010303",2593,279,1003,271,521,15,180,0,4862
"47037010401",2649,364,1048,197,83,172,209,247,4969
"47037010402",2210,901,630,704,334,631,604,640,6654
"47037010501",3622,1237,232,68,213,10,146,223,5751
"47037010502",3752,280,498,225,267,8,197,26,5253
"47037010601",2748,175,1472,246,113,229,681,208,5872
"47037010602",1077,396,1253,406,355,96,251,135,3969
"47037010701",1431,809,755,440,500,262,470,288,4955
"47037010702",1253,468,644,494,357,85,457,90,3848
"47037010801",2257,182,2036,549,80,0,317,17,5438
"47037010802",2011,194,706,51,220,110,189,127,3608
"47037010901",1478,134,860,231,188,11,174,18,3094
"47037010903",378,146,2559,1930,110,168,102,197,5590
"47037010904",426,60,1645,645,0,0,0,0,2776
"47037011001",1021,668,2459,778,337,255,234,422,6174
"47037011002",1042,186,1058,207,159,77,114,60,2903
"47037011100",2618,351,312,84,697,254,498,257,5071
"47037011200",2315,487,723,144,220,6,80,15,3990
"47037011300",1483,638,1194,628,411,349,747,437,5887
"47037011400",1422,377,2074,994,183,33,90,11,5184
"47037011500",2469,324,626,90,123,13,24,0,3669
"47037011600",2834,367,1422,178,35,0,23,16,4875
"47037011700",3520,595,932,888,72,94,31,71,6203
"47037011800",667,38,859,850,121,92,102,0,2729
"47037011900",431,76,700,755,125,92,52,20,2251
"47037012100",1912,196,99,35,111,19,192,0,2564
"47037012200",1749,103,90,35,108,103,60,103,2351
"47037012600",319,171,888,594,133,78,101,65,2349
"47037012701",144,8,3074,1757,17,223,0,0,5223
"47037012702",94,84,1644,366,81,19,5,0,2293
"47037012801",388,232,2657,1771,13,0,176,0,5237
"47037012802",379,108,1875,550,70,0,61,0,3043
"47037013000",12,2,3,6,0,0,0,0,23
"47037013100",1274,281,559,67,98,13,0,0,2292
"47037013201",1676,128,154,68,874,211,18,47,3176
"47037013202",2404,283,155,9,394,6,564,0,3815
"47037013300",1789,714,440,342,390,196,378,206,4455
"47037013400",3353,246,111,0,232,0,81,0,4023
"47037013500",1069,160,243,189,38,122,49,89,1959
"47037013601",131,83,1709,1554,30,69,30,69,3675
"47037013602",13,0,205,72,27,4,19,0,340
"47037013700",252,255,2648,2787,110,110,26,0,6188
"47037013800",67,20,902,977,34,25,22,0,2047
"47037013900",48,12,767,689,35,14,0,14,1579
"47037014200",28,21,822,932,25,0,0,9,1837
"47037014300",75,36,1137,529,15,21,0,5,1818
"47037014400",125,30,449,439,98,69,14,20,1244
"47037014800",94,76,512,1938,0,109,26,30,2785
"47037015100",3062,286,227,54,489,142,217,120,4597
"47037015200",2171,234,44,2,39,140,206,189,3025
"47037015300",4668,321,553,70,297,24,313,70,6316
"47037015401",4320,374,373,40,383,0,431,11,5932
"47037015402",3549,143,596,144,65,19,335,2,4853
"47037015404",2156,550,129,27,76,154,242,225,3559
"47037015405",3203,381,540,0,531,91,352,114,5212
"47037015501",2352,284,143,6,150,0,124,23,3082
"47037015502",2498,365,558,102,151,7,95,121,3897
"47037015609",2627,131,364,9,312,13,188,0,3644
"47037015610",5898,303,1135,548,623,71,333,0,8911
"47037015612",3069,442,1686,146,560,50,618,39,6610
"47037015613",1529,506,911,100,452,261,677,464,4900
"47037015614",1889,605,1252,77,494,186,533,255,5291
"47037015615",1065,774,1050,50,1184,455,1093,749,6420
"47037015617",1521,116,647,27,128,20,69,0,2528
"47037015618",1781,591,2526,104,614,0,460,200,6276
"47037015619",2340,188,1737,56,450,0,257,98,5126
"47037015620",2498,562,3071,242,452,0,560,0,7385
"47037015622",2526,210,601,74,127,70,80,29,3717
"47037015623",3185,91,1425,1293,401,129,643,0,7167
"47037015624",2983,547,842,388,377,0,213,212,5562
"47037015625",3467,546,681,140,190,0,122,163,5309
"47037015626",1906,261,2622,447,931,250,636,155,7208
"47037015627",852,141,1303,117,412,36,391,36,3288
"47037015628",1021,307,991,522,606,298,708,420,4873
"47037015629",1963,243,2012,420,530,55,553,55,5831
"47037015630",1423,186,1758,118,359,26,272,0,4142
"47037015631",3969,457,2550,519,1504,0,712,257,9968
"47037015700",1144,190,206,27,80,29,446,49,2171
"47037015802",2499,972,1033,469,814,275,1150,287,7499
"47037015803",976,967,363,420,274,150,632,561,4343
"47037015804",1605,481,948,237,621,503,563,424,5382
"47037015900",925,518,79,290,63,12,17,115,2019
"47037016000",79,9,404,351,19,18,3,0,883
"47037016100",535,149,678,371,22,5,12,9,1781
"47037016200",699,408,1015,1002,7,132,49,100,3412
"47037016300",667,327,500,756,47,40,28,19,2384
"47037016400",855,328,104,20,85,28,36,22,1478
"47037016500",104,120,0,13,22,16,7,6,288
"47037016600",1293,298,100,114,512,62,54,17,2450
"47037016700",3903,437,211,16,276,38,57,15,4953
"47037016800",2859,708,158,14,464,178,16,31,4428
"47037016900",3902,290,154,0,264,85,138,0,4833
"47037017000",1449,289,776,116,15,0,9,12,2666
"47037017100",1364,111,365,15,39,11,30,0,1935
"47037017200",720,259,110,10,102,2,93,129,1425
"47037017300",1223,673,384,60,531,270,504,638,4283
"47037017401",1245,162,392,66,309,245,552,297,3268
"47037017402",3696,871,377,107,581,540,867,792,7831
"47037017500",1910,497,199,54,315,14,680,211,3880
"47037017701",1847,5,127,0,129,0,54,0,2162
"47037017702",2911,156,59,0,91,16,60,21,3314
"47037017800",4220,550,170,15,206,70,47,22,5300
"47037017901",4025,161,59,0,167,13,83,0,4508
"47037017902",4042,173,225,0,99,27,56,15,4637
"47037018000",4226,265,0,18,231,62,0,17,4819
"47037018101",2330,427,412,506,616,408,530,315,5544
"47037018102",3355,284,42,0,154,0,106,0,3941
"47037018201",2682,61,57,41,59,0,40,0,2940
"47037018202",5148,824,1024,344,403,239,414,202,8598
"47037018203",1481,30,5,0,32,5,54,5,1612
"47037018301",5366,583,328,136,995,41,317,0,7766
"47037018302",2393,49,147,0,109,0,9,0,2707
"47037018401",4596,382,593,346,573,15,546,15,7066
"47037018404",3444,161,384,105,147,21,161,21,4444
"47037018405",4069,153,183,9,306,9,124,32,4885
"47037018407",3698,87,123,52,418,7,202,0,4587
"47037018408",2808,31,105,0,318,0,19,0,3281
"47037018409",3909,187,25,0,134,0,17,0,4272
"47037018410",2098,386,236,0,64,185,0,212,3181
"47037018500",4797,73,30,14,69,0,55,0,5038
"47037018601",2030,98,34,0,52,12,0,0,2226
"47037018602",4045,45,0,0,212,13,53,0,4368
"47037018700",3295,25,16,0,41,0,28,0,3405
"47037018801",4400,224,116,0,545,0,30,21,5336
"47037018803",2948,134,73,0,68,0,21,0,3244
"47037018804",4095,378,634,0,320,4,348,69,5848
"47037018901",1477,411,166,40,131,237,52,60,2574
"47037018902",2043,332,170,29,157,23,353,188,3295
"47037018904",1417,817,199,354,842,817,448,659,5553
"47037018905",1494,378,392,56,494,304,341,410,3869
"47037019003",1930,619,650,122,692,782,1224,1131,7150
"47037019004",1737,374,640,53,672,1083,1149,477,6185
"47037019005",1234,211,782,634,452,197,695,307,4512
"47037019006",1833,967,1114,216,549,768,749,1035,7231
"47037019105",2244,1309,446,304,981,261,333,377,6255
"47037019106",2843,314,439,80,262,21,95,58,4112
"47037019108",1050,490,432,188,741,403,981,704,4989
"47037019109",2237,386,1156,55,1144,278,972,414,6642
"47037019110",2117,541,793,62,502,383,1134,507,6039
"47037019111",1471,403,1554,170,368,262,310,428,4966
"47037019112",1793,524,1157,24,631,425,515,657,5726
"47037019114",7617,387,2314,25,1001,250,1088,215,12897
"47037019115",3000,0,741,61,272,0,214,0,4288
"47037019116",3874,688,909,291,470,112,501,70,6915
"47037019117",1999,149,2076,182,308,43,129,0,4886
"47037019118",1723,450,2266,158,596,21,208,18,5440
"47037019200",1920,309,414,505,238,27,210,0,3623
"47037019300",353,350,301,1991,71,202,13,28,3309
"47037019400",1637,235,698,999,72,13,38,2,3694
"47037019500",2910,605,317,311,307,133,237,86,4906
"47037019600",2112,600,529,259,109,48,223,218,4098
"47037980100",0,0,0,0,0,0,0,0,0
"47037980200",0,0,0,1,0,0,0,0,1
"47039955001",1330,450,20,6,95,7,90,0,1998
"47039955002",3361,1046,144,40,44,65,67,160,4927
"47039955101",1211,434,67,25,3,10,16,2,1768
"47039955102",2561,411,0,0,107,2,0,0,3081
"47041920101",1644,420,0,8,36,28,0,43,2179
"47041920102",3657,805,1,1,26,12,62,38,4602
"47041920200",4461,1454,67,90,169,0,297,66,6604
"47041920300",4780,586,46,15,62,254,569,258,6570
"47043060100",3140,970,0,22,19,22,146,11,4330
"47043060200",5268,916,151,0,103,52,64,0,6554
"47043060300",5739,821,0,0,73,0,98,0,6731
"47043060401",2719,199,12,2,76,4,58,0,3070
"47043060402",5010,624,157,1,215,14,45,162,6228
"47043060501",4777,503,245,49,122,31,13,0,5740
"47043060502",2534,215,49,4,82,26,10,82,3002
"47043060601",2479,670,339,0,80,19,35,107,3729
"47043060602",3649,953,529,219,690,216,523,96,6875
"47043060700",3847,520,91,12,56,104,109,0,4739
"47045964000",6027,368,159,46,285,20,86,17,7008
"47045964200",4399,577,623,102,215,19,227,102,6264
"47045964300",2897,824,965,385,185,91,26,14,5387
"47045964400",2496,972,1477,725,240,1,205,1,6117
"47045964500",1899,269,76,9,35,0,4,7,2299
"47045964600",1867,437,114,83,334,28,167,85,3115
"47045964800",2462,431,66,36,112,0,60,0,3167
"47045964900",4344,549,177,16,76,0,87,7,5256
"47047060300",1085,244,951,504,43,2,26,0,2855
"47047060401",2009,129,497,105,129,349,25,360,3603
"47047060402",2658,122,740,50,43,0,80,0,3693
"47047060403",3317,386,587,79,48,15,27,0,4459
"47047060404",4128,465,656,26,104,0,171,29,5579
"47047060501",1676,396,1104,692,31,4,30,0,3933
"47047060502",2568,191,692,300,65,0,18,0,3834
"47047060600",1998,304,1297,330,26,0,11,0,3966
"47047060701",1485,147,524,132,2,0,61,0,2351
"47047060702",1638,125,450,219,71,2,81,13,2599
"47047060800",1406,101,523,118,111,8,0,0,2267
"47049965000",2176,662,0,0,35,43,12,0,2928
"47049965100",2352,1551,0,0,58,36,92,72,4161
"47049965200",5077,952,0,0,44,4,27,0,6104
"47049965300",3508,1094,12,0,70,24,0,11,4719
"47051960100",2464,538,83,35,87,114,72,70,3463
"47051960201",5809,483,41,0,222,41,0,69,6665
"47051960202",4803,456,57,0,152,108,62,0,5638
"47051960300",2171,409,34,11,20,19,0,0,2664
"47051960400",4967,1037,259,16,579,148,312,109,7427
"47051960500",2372,683,199,54,128,112,42,19,3609
"47051960600",3329,862,111,54,232,100,52,12,4752
"47051960700",2061,529,10,16,38,20,28,8,2710
"47051960800",2243,322,66,8,216,26,121,52,3054
"47053966100",1646,346,293,49,42,14,0,6,2396
"47053966200",2462,471,304,210,99,68,59,0,3673
"47053966300",1565,451,384,10,0,0,0,0,2410
"47053966400",3517,1017,260,152,98,46,176,38,5304
"47053966500",2656,595,702,710,142,39,145,27,5016
"47053966600",1370,68,159,18,24,9,21,9,1678
"47053966700",3301,761,757,750,104,0,174,54,5901
"47053966800",854,245,33,0,21,0,14,0,1167
"47053966900",494,72,1488,697,4,0,0,0,2755
"47053967000",4649,956,1209,389,92,99,41,205,7640
"47053967100",5291,325,326,90,126,2,95,0,6255
"47053967300",870,193,0,0,29,6,6,6,1110
"47053967400",3652,489,67,31,92,15,42,0,4388
"47053980100",18,0,0,0,0,0,0,0,18
"47055920100",2781,482,101,27,16,37,19,0,3463
"47055920200",2367,699,172,373,87,114,101,10,3923
"47055920300",4952,512,476,277,303,0,112,13,6645
"47055920400",1657,410,309,47,12,23,28,0,2486
"47055920500",3419,643,454,142,88,0,104,28,4878
"47055920600",2250,217,58,89,4,10,48,1,2677
"47055920700",1317,402,82,19,30,17,9,0,1876
"47055920800",2015,426,249,42,61,41,18,18,2870
"47057500100",2645,998,0,0,52,0,65,49,3809
"47057500200",3844,665,12,0,27,0,7,3,4558
"47057500300",4856,1434,86,24,71,5,248,27,6751
"47057500401",2101,708,1,16,0,1,59,12,2898
"47057500402",3968,695,0,18,21,195,31,78,5006
"47059090100",2938,2686,342,167,108,292,98,702,7333
"47059090200",1910,158,0,2,41,13,0,0,2124
"47059090300",3843,804,94,31,178,0,154,8,5112
"47059090400",4133,676,87,6,14,53,32,74,5075
"47059090500",5732,1027,102,59,82,13,95,43,7153
"47059090600",3292,355,0,13,79,38,34,103,3914
"47059090700",2266,439,13,83,12,15,12,0,2840
"47059090800",3370,1110,88,19,13,35,40,0,4675
"47059090900",4059,687,35,3,0,0,61,2,4847
"47059091000",5587,1948,93,0,35,0,41,167,7871
"47059091100",3082,658,0,0,11,52,0,14,3817
"47059091200",2366,510,18,38,55,183,22,0,3192
"47059091300",3298,961,6,38,32,38,53,23,4449
"47059091400",2124,631,3,14,38,64,1,11,2886
"47059091500",2406,839,0,0,11,22,0,9,3287
"47061955000",1630,803,0,2,317,229,0,22,3003
"47061955100",1224,114,5,0,83,74,5,0,1505
"47061955200",2056,844,0,0,402,200,1,37,3540
"47061955300",3080,1228,0,3,620,361,48,4,5344
"47063100100",3761,1774,131,53,264,337,662,762,7744
"47063100200",2931,1089,279,275,597,327,469,593,6560
"47063100300",1330,1406,72,10,233,150,426,769,4396
"47063100400",3202,1119,488,247,148,181,434,382,6201
"47063100500",2019,492,27,29,41,32,0,0,2640
"47063100600",5402,1122,67,4,99,11,63,48,6816
"47063100700",4522,1140,92,0,96,149,278,105,6382
"47063100800",2020,910,216,0,185,88,150,298,3867
"47063100900",4060,524,31,62,525,211,861,233,6507
"47063101000",4297,794,132,23,111,0,15,11,5383
"47063101100",4393,358,0,0,199,0,259,0,5209
"47063101200",6129,653,10,1,147,23,0,0,6963
"47065000400",277,101,1902,863,57,99,0,0,3299
"47065000600",2633,345,2,22,47,1,56,0,3106
"47065000700",2855,584,190,0,179,0,47,0,3855
"47065000800",999,143,218,211,43,5,16,0,1635
"47065001100",443,51,572,587,7,61,30,54,1805
"47065001200",118,124,1446,1457,22,65,0,0,3232
"47065001300",288,217,596,511,0,154,8,293,2067
"47065001400",581,306,444,320,19,13,136,125,1944
"47065001600",95,304,377,1450,41,9,0,31,2307
"47065001800",1598,417,441,98,95,2,73,0,2724
"47065001900",89,27,1666,2534,65,88,31,5,4505
"47065002000",432,81,230,282,66,11,17,11,1130
"47065002300",602,182,203,135,182,110,247,207,1868
"47065002400",1643,1213,639,798,324,449,426,667,6159
"47065002500",1071,531,1036,1761,304,15,327,48,5093
"47065002600",571,323,462,580,216,240,288,297,2977
"47065002800",2569,244,686,82,59,0,29,17,3686
"47065002900",1014,81,753,597,36,0,175,0,2656
"47065003000",1026,249,552,199,332,36,269,97,2760
"47065003100",626,175,90,161,39,0,9,0,1100
"47065003200",583,59,2115,398,298,207,122,34,3816
"47065003300",1173,56,4393,740,348,212,251,63,7236
"47065003400",2586,623,1175,237,30,146,595,194,5586
"47065010101",4553,1108,135,45,28,51,12,69,6001
"47065010103",3179,251,88,2,64,13,31,13,3641
"47065010104",4046,346,32,42,94,0,28,0,4588
"47065010201",3229,77,0,0,44,0,0,0,3350
"47065010202",3423,625,31,11,10,0,29,0,4129
"47065010303",2758,179,175,0,0,0,0,0,3112
"47065010304",4729,456,34,0,136,0,48,0,5403
"47065010305",2938,83,0,0,9,0,0,0,3030
"47065010306",3350,477,40,0,39,0,0,119,4025
"47065010307",4712,750,0,0,34,37,0,0,5533
"47065010411",5523,618,282,0,258,13,78,123,6895
"47065010412",4751,357,38,0,247,0,15,0,5408
"47065010413",3686,205,0,6,117,0,18,0,4032
"47065010431",6035,445,392,6,244,153,182,67,7524
"47065010432",6048,166,25,3,150,8,43,0,6443
"47065010433",3643,648,254,155,18,0,230,16,4964
"47065010434",1777,335,79,0,38,0,0,0,2229
"47065010435",4674,742,132,0,0,0,0,2,5550
"47065010501",4936,565,582,29,138,47,9,22,6328
"47065010502",2519,397,106,54,504,95,392,133,4200
"47065010600",2179,516,31,0,184,19,106,0,3035
"47065010700",1789,503,151,64,25,21,0,109,2662
"47065010800",2902,662,208,178,109,109,273,162,4603
"47065010901",1497,240,11,3,47,16,30,0,1844
"47065010902",590,180,0,0,0,0,0,0,770
"47065010903",3834,849,239,92,318,0,59,0,5391
"47065011001",1359,271,0,0,89,0,0,0,1719
"47065011002",6819,319,0,10,152,38,58,30,7426
"47065011100",6365,53,11,21,68,0,0,0,6518
"47065011201",8029,651,124,226,323,16,283,120,9772
"47065011203",3701,326,464,45,281,0,346,18,5181
"47065011204",4492,311,94,12,527,0,556,30,6022
"47065011311",4423,654,988,80,95,0,621,30,6891
"47065011314",3857,453,691,82,178,26,183,60,5530
"47065011321",4082,844,946,85,995,48,82,264,7346
"47065011323",3502,518,466,136,485,0,35,25,5167
"47065011324",3131,103,295,0,391,21,52,0,3993
"47065011325",4793,157,783,21,208,16,261,38,6277
"47065011326",3121,670,596,276,382,146,241,454,5886
"47065011402",1609,299,3159,391,432,110,251,96,6347
"47065011411",1813,431,1661,76,201,52,24,116,4374
"47065011413",5572,308,1524,28,167,118,297,0,8014
"47065011442",1845,364,233,150,226,9,124,71,3022
"47065011443",3249,590,1349,282,509,51,352,11,6393
"47065011444",435,27,1952,888,118,18,114,18,3570
"47065011445",2261,198,746,144,143,71,118,74,3755
"47065011446",3024,117,181,17,59,0,247,0,3645
"47065011447",6967,222,458,50,363,0,282,0,8342
"47065011600",3461,606,684,13,393,39,97,0,5293
"47065011700",3296,419,309,70,222,10,698,126,5150
"47065011800",4792,500,556,118,103,292,240,294,6895
"47065011900",1121,115,368,121,100,150,52,0,2027
"47065012000",1748,30,28,16,45,7,43,0,1917
"47065012100",4807,837,16,2,16,0,275,193,6146
"47065012200",33,33,1220,1203,0,17,0,0,2506
"47065012300",981,340,2342,749,135,66,0,0,4613
"47065012400",916,614,411,231,0,20,42,10,2244
"47065980100",0,0,0,0,0,0,0,0,0
"47065980200",0,0,0,0,0,0,0,0,0
"47067960500",2191,394,0,0,60,11,0,0,2656
"47067960600",2442,1378,0,2,23,31,0,0,3876
"47069950100",2286,440,338,119,27,13,89,18,3330
"47069950200",1086,401,1270,634,37,0,57,54,3539
"47069950300",1514,191,1137,824,0,0,0,0,3666
"47069950400",2128,409,1453,1202,153,76,0,0,5421
"47069950500",3319,751,147,74,121,28,11,72,4523
"47069950600",861,112,1231,709,14,2,0,0,2929
"47071920100",2773,896,0,95,96,41,46,0,3947
"47071920200",3319,887,92,16,95,25,33,0,4467
"47071920300",3007,437,190,301,64,7,35,0,4041
"47071920400",3110,1047,329,56,43,13,70,0,4668
"47071920500",4046,1253,0,1,187,28,45,0,5560
"47071920600",2388,540,57,15,55,15,0,3,3073
"47073050100",3364,647,0,0,30,0,6,0,4047
"47073050200",3601,1010,0,0,0,9,0,0,4620
"47073050301",3202,1006,0,0,162,34,135,0,4539
"47073050302",3094,391,44,83,233,0,108,0,3953
"47073050400",4677,1175,0,0,81,3,63,0,5999
"47073050501",3698,566,15,0,13,0,18,0,4310
"47073050502",2417,460,7,9,42,66,18,0,3019
"47073050503",3728,342,125,0,43,47,32,85,4402
"47073050601",4548,653,199,0,147,168,28,26,5769
"47073050602",3654,411,25,0,41,0,75,29,4235
"47073050700",2750,601,9,0,69,19,0,0,3448
"47073050800",3690,1278,137,31,33,0,17,69,5255
"47073050900",2526,502,0,0,24,0,0,0,3052
"47075930100",1402,380,527,41,132,0,204,11,2697
"47075930200",854,158,331,146,17,0,11,0,1517
"47075930301",1354,264,1854,842,219,104,90,42,4769
"47075930302",948,93,1270,812,21,12,20,12,3188
"47075930400",1215,309,1508,604,201,19,207,19,4082
"47075930500",1173,212,802,284,32,17,56,70,2646
"47077975000",2242,546,75,10,29,0,0,90,2992
"47077975100",2718,498,161,32,30,0,25,0,3464
"47077975200",4153,1143,194,24,27,0,52,0,5593
"47077975300",5613,790,521,302,127,230,50,34,7667
"47077975400",2446,735,372,355,223,176,201,97,4605
"47077975500",2850,852,9,2,37,7,11,32,3800
"47079969000",3724,684,30,0,15,14,77,23,4567
"47079969100",2481,368,37,0,19,24,57,4,2990
"47079969200",1532,332,5,7,7,0,71,0,1954
"47079969300",1398,855,588,653,166,49,4,102,3815
"47079969400",944,384,195,432,53,79,0,0,2087
"47079969500",3713,658,73,120,123,0,32,0,4719
"47079969600",6481,748,199,7,41,0,52,22,7550
"47079969700",1704,288,76,50,0,0,0,0,2118
"47079969800",1673,493,84,15,28,0,205,0,2498
"47081950100",4569,767,38,0,111,0,34,0,5519
"47081950200",4893,1295,91,17,115,55,26,55,6547
"47081950301",2060,496,174,74,0,108,0,0,2912
"47081950302",3529,834,0,11,134,43,346,0,4897
"47081950400",1723,344,0,0,49,0,0,0,2116
"47081950500",950,148,0,24,26,65,0,0,1213
"47083120100",2712,573,0,37,37,0,17,76,3452
"47083120200",1351,407,88,25,57,71,20,0,2019
"47083120300",2003,647,0,1,100,10,24,29,2814
"47085130100",4570,988,3,27,41,0,22,39,5690
"47085130200",1539,536,9,0,0,0,16,11,2111
"47085130300",4003,726,229,251,0,0,158,9,5376
"47085130400",1970,206,138,11,34,0,34,0,2393
"47085130500",2508,211,4,0,58,13,44,0,2838
"47087960100",1100,486,0,0,23,17,0,0,1626
"47087960200",1868,381,47,0,70,0,15,0,2381
"47087960300",4066,1003,0,0,57,64,30,60,5280
"47087960400",1394,784,0,0,0,0,39,49,2266
"47089070100",5232,1258,112,0,338,81,464,145,7630
"47089070200",4203,554,0,0,182,0,67,11,5017
"47089070300",4715,865,405,182,130,0,104,27,6428
"47089070400",2802,627,43,0,50,13,66,0,3601
"47089070500",4193,1093,115,86,0,12,41,26,5566
"47089070600",3760,1129,22,8,60,0,117,181,5277
"47089070700",5660,679,46,63,190,7,200,27,6872
"47089070800",6308,974,2,0,81,0,0,99,7464
"47089070900",3173,724,73,2,27,0,133,24,4156
"47091956000",820,137,0,0,3,1,3,0,964
"47091956100",2341,502,3,0,5,0,31,10,2892
"47091956200",1667,557,0,0,3,0,0,0,2227
"47091956300",4051,1331,1,30,15,107,19,97,5651
"47091956400",3503,1119,28,0,16,1,35,15,4717
"47093000100",1079,428,95,110,82,47,13,46,1900
"47093000800",1492,1074,355,381,157,0,139,37,3635
"47093000901",0,0,0,0,0,0,0,0,0
"47093000902",50,126,0,0,26,17,0,0,219
"47093001400",551,727,162,1192,104,166,129,381,3412
"47093001500",2251,494,275,231,83,23,191,44,3592
"47093001600",1803,561,358,80,53,0,0,0,2855
"47093001700",1529,529,146,48,28,43,12,22,2357
"47093001800",1579,230,439,41,30,0,30,0,2349
"47093001900",307,249,616,616,68,80,0,100,2036
"47093002000",290,157,1772,990,21,54,26,29,3339
"47093002100",698,648,944,330,87,92,23,361,3183
"47093002200",2527,676,258,115,35,25,23,27,3686
"47093002300",1977,766,77,173,112,78,83,71,3337
"47093002400",2346,856,245,393,163,167,162,9,4341
"47093002600",932,509,333,446,117,109,117,276,2839
"47093002700",1711,344,124,137,338,248,306,40,3248
"47093002800",1923,493,961,856,24,190,82,0,4529
"47093002900",1448,973,535,500,67,71,77,11,3682
"47093003000",2943,718,247,190,139,144,44,0,4425
"47093003100",1978,209,409,66,138,0,20,1,2821
"47093003200",785,305,1274,518,54,131,0,29,3096
"47093003300",1308,87,457,117,93,5,35,0,2102
"47093003400",3041,365,127,24,86,8,44,0,3695
"47093003500",3157,601,0,497,97,14,30,34,4430
"47093003700",1613,641,146,81,89,89,139,92,2890
"47093003801",3207,653,546,23,246,95,297,0,5067
"47093003802",2376,260,254,83,253,40,346,28,3640
"47093003901",2955,253,380,79,378,29,48,98,4220
"47093003902",2112,457,108,124,49,44,145,55,3094
"47093004000",3224,292,160,143,98,22,143,22,4104
"47093004100",3442,411,306,27,100,27,10,0,4323
"47093004200",2884,254,39,63,186,48,144,0,3618
"47093004300",2102,422,95,54,18,41,159,0,2891
"47093004401",4817,251,0,0,50,0,0,0,5118
"47093004403",3904,670,191,43,390,0,0,307,5505
"47093004404",2785,238,66,78,142,0,21,0,3330
"47093004500",4265,567,165,82,820,170,600,236,6905
"47093004606",5652,484,466,0,484,0,256,0,7342
"47093004607",4738,148,367,14,181,37,208,0,5693
"47093004608",2801,118,151,18,45,0,26,0,3159
"47093004609",3557,577,755,23,409,59,150,0,5530
"47093004610",2604,981,550,0,616,136,820,278,5985
"47093004611",3231,194,485,0,119,0,130,0,4159
"47093004612",2233,77,47,78,72,0,21,64,2592
"47093004613",4069,993,222,0,28,9,46,383,5750
"47093004614",2380,101,132,0,390,225,43,269,3540
"47093004615",2501,725,304,137,260,139,62,16,4144
"47093004700",3403,277,175,169,114,19,97,0,4254
"47093004800",4086,466,230,0,317,36,175,225,5535
"47093004900",4545,529,81,28,331,0,97,0,5611
"47093005000",3024,392,118,81,118,34,93,0,3860
"47093005100",4733,365,81,0,103,143,82,0,5507
"47093005201",3905,489,502,14,0,24,31,0,4965
"47093005202",2689,354,296,20,114,21,27,15,3536
"47093005301",3695,185,109,0,95,0,0,0,4084
"47093005302",2973,224,0,0,47,0,0,0,3244
"47093005401",2815,362,146,5,156,43,155,0,3682
"47093005402",2457,782,0,8,8,20,0,20,3295
"47093005501",2229,271,0,0,19,14,19,0,2552
"47093005502",2323,201,65,20,0,0,0,0,2609
"47093005602",3708,299,0,0,73,64,117,0,4261
"47093005603",3074,438,38,0,54,0,115,0,3719
"47093005604",2274,128,46,0,41,0,35,0,2524
"47093005701",3831,292,39,0,256,0,106,172,4696
"47093005704",4767,312,409,0,385,36,188,0,6097
"47093005706",3289,201,100,34,435,17,147,0,4223
"47093005707",2939,83,127,0,103,0,21,0,3273
"47093005708",2598,7,119,0,89,0,194,0,3007
"47093005709",1663,101,62,0,121,23,32,0,2002
"47093005710",2007,37,23,0,110,0,60,0,2237
"47093005711",4660,164,325,0,567,0,105,0,5821
"47093005712",6784,705,33,0,749,0,89,396,8756
"47093005803",2238,147,6,0,71,32,70,16,2580
"47093005807",2224,154,97,0,175,37,99,0,2786
"47093005808",4446,432,379,51,427,0,193,0,5928
"47093005809",4619,183,83,0,314,62,198,0,5459
"47093005810",3303,41,14,0,365,0,43,0,3766
"47093005811",2380,20,52,0,196,0,49,0,2697
"47093005812",4462,95,76,0,366,0,30,0,5029
"47093005813",4971,149,211,0,466,28,135,0,5960
"47093005903",3184,167,38,120,207,0,64,14,3794
"47093005904",4434,353,24,0,100,12,136,0,5059
"47093005905",1756,133,5,0,90,0,9,28,2021
"47093005906",1614,104,0,0,23,0,0,0,1741
"47093005907",2929,43,132,0,115,0,51,0,3270
"47093005908",4228,479,116,5,107,0,36,27,4998
"47093006001",1998,67,231,0,108,36,111,0,2551
"47093006002",4887,691,116,102,34,0,11,0,5841
"47093006003",3520,509,18,0,272,0,108,0,4427
"47093006102",4662,535,170,0,16,0,0,0,5383
"47093006103",4799,802,9,0,65,42,182,66,5965
"47093006104",4507,917,0,0,92,89,0,314,5919
"47093006202",4631,467,0,10,19,0,95,69,5291
"47093006203",4634,384,41,0,84,0,198,0,5341
"47093006205",3839,284,65,0,55,52,19,63,4377
"47093006206",4661,171,0,0,127,0,22,0,4981
"47093006207",2948,259,57,0,7,0,25,0,3296
"47093006208",4654,669,0,0,365,81,588,0,6357
"47093006301",3076,416,0,0,15,0,6,0,3513
"47093006302",2238,349,7,40,55,0,42,0,2731
"47093006401",3299,498,163,0,182,0,35,0,4177
"47093006402",4276,207,0,0,0,0,70,0,4553
"47093006403",2401,262,58,0,40,0,9,0,2770
"47093006501",2739,257,38,0,94,0,28,0,3156
"47093006502",2120,882,125,0,8,0,0,0,3135
"47093006600",1718,932,235,265,115,10,57,0,3332
"47093006700",661,355,753,865,283,47,152,30,3146
"47093006800",631,683,1441,2240,219,47,275,148,5684
"47093006900",1261,3904,207,100,200,254,63,118,6107
"47093007000",730,420,622,595,0,123,17,65,2572
"47093007100",3178,318,35,0,74,0,78,28,3711
"47095960100",1591,594,286,189,0,30,0,29,2719
"47095960200",1469,457,142,121,46,104,66,45,2450
"47097050100",813,367,161,10,0,0,9,15,1375
"47097050200",2455,444,415,408,40,55,42,0,3859
"47097050300",2133,273,238,289,0,0,17,21,2971
"47097050400",2479,335,189,22,182,0,132,0,3339
"47097050503",1528,187,215,62,15,0,17,0,2024
"47097050504",988,482,789,471,156,17,62,0,2965
"47097050505",629,471,1216,1411,24,83,0,0,3834
"47097050506",1155,211,675,250,34,4,41,21,2391
"47097050600",671,229,889,333,83,57,76,14,2352
"47099960100",4102,478,0,1,26,12,7,0,4626
"47099960200",1936,455,10,0,11,0,17,13,2442
"47099960300",3691,2293,0,0,26,25,5,63,6103
"47099960401",3648,692,296,0,141,201,32,214,5224
"47099960402",3503,211,5,0,182,0,59,0,3960
"47099960501",2363,1116,143,178,300,118,219,86,4523
"47099960502",3107,663,40,0,55,18,0,18,3901
"47099960600",1733,351,13,0,75,0,0,0,2172
"47099960700",3240,417,0,27,45,67,12,0,3808
"47099960800",3104,485,0,0,1,0,1,0,3591
"47099960900",1589,232,0,0,0,10,0,0,1831
"47101970100",3981,687,94,0,31,0,43,0,4836
"47101970200",5156,1384,53,19,147,243,184,11,7197
"47103975000",1377,181,55,0,57,26,0,0,1696
"47103975100",1980,251,6,7,46,8,22,8,2328
"47103975200",1599,469,48,0,39,19,10,8,2192
"47103975300",4163,884,586,297,313,347,155,177,6922
"47103975400",2565,467,230,39,133,23,0,21,3478
"47103975500",3607,662,0,0,226,30,2,5,4532
"47103975601",3616,568,138,8,216,264,138,185,5133
"47103975602",3246,555,23,0,191,53,163,3,4234
"47103975700",2983,214,13,0,113,0,76,0,3399
"47105060100",4182,607,21,19,160,0,44,85,5118
"47105060201",3205,356,60,0,41,0,227,0,3889
"47105060202",4706,2693,120,10,386,17,866,780,9578
"47105060301",2699,231,0,42,182,44,76,44,3318
"47105060302",5443,405,24,0,69,0,157,0,6098
"47105060400",3802,537,28,0,93,0,0,0,4460
"47105060501",8196,676,0,0,38,4,38,0,8952
"47105060502",1911,440,17,0,13,20,48,0,2449
"47105060600",3252,921,179,36,228,56,668,581,5921
"47105060700",2423,589,32,5,9,0,25,25,3108
"47107970101",4685,801,242,30,149,18,110,40,6075
"47107970102",4210,459,51,24,112,33,168,0,5057
"47107970200",3525,1784,297,185,241,249,164,275,6720
"47107970300",2080,413,215,49,251,32,158,0,3198
"47107970401",2938,657,0,0,70,0,29,100,3794
"47107970402",4261,710,105,32,127,0,0,274,5509
"47107970500",2777,1077,82,0,109,9,9,27,4090
"47107970600",5103,1360,262,13,182,0,22,25,6967
"47107970700",3406,462,123,66,21,42,14,46,4180
"47107970800",5927,908,138,37,123,22,40,57,7252
"47109930100",2901,795,0,18,28,2,0,0,3744
"47109930200",1530,580,4,28,32,0,25,47,2246
"47109930300",2265,766,103,28,69,8,14,0,3253
"47109930400",1811,320,5,2,23,33,51,14,2259
"47109930500",5078,1297,659,280,0,192,138,0,7644
"47109930600",3083,577,223,40,46,73,44,92,4178
"47109930700",1978,707,67,51,35,48,0,40,2926
"47111970100",2809,920,3,53,92,63,180,99,4219
"47111970200",4859,455,0,0,169,0,229,0,5712
"47111970300",6293,1853,0,0,160,193,225,178,8902
"47111970400",2968,1112,34,0,60,48,54,82,4358
"47113000100",1362,428,1333,465,79,0,149,258,4074
"47113000200",1706,724,2172,1496,64,0,114,393,6669
"47113000300",2478,353,1373,344,66,34,44,5,4697
"47113000400",677,239,1908,974,19,0,0,21,3838
"47113000500",175,137,1594,2159,0,31,0,0,4096
"47113000600",586,100,762,449,0,0,41,0,1938
"47113000700",534,253,616,597,0,57,2,14,2073
"47113000800",109,131,175,458,0,36,6,6,921
"47113000900",51,9,1293,753,0,28,0,0,2134
"47113001000",92,114,1393,524,0,0,0,0,2123
"47113001100",0,0,565,333,0,0,0,0,898
"47113001300",4116,607,626,221,78,87,34,90,5859
"47113001401",890,279,377,91,46,38,0,63,1784
"47113001402",1523,155,465,103,38,0,21,0,2305
"47113001501",2790,121,1438,327,141,36,53,0,4906
"47113001502",5026,779,361,70,17,0,88,0,6341
"47113001603",1700,61,546,169,65,0,68,0,2609
"47113001604",1888,255,436,83,97,0,17,232,3008
"47113001605",995,359,306,40,101,10,7,9,1827
"47113001606",5225,864,2500,458,474,431,439,68,10459
"47113001607",3942,577,943,33,403,0,509,393,6800
"47113001608",1708,115,228,0,8,0,4,0,2063
"47113001609",1393,76,67,152,51,0,0,0,1739
"47113001610",5216,80,429,0,139,0,74,0,5938
"47113001700",669,79,745,113,0,0,0,0,1606
"47113001800",1779,79,779,332,14,6,44,42,3075
"47113001900",3280,520,242,14,23,0,0,0,4079
"47115050101",2821,721,2,0,139,7,42,0,3732
"47115050102",4519,1432,28,0,223,125,60,90,6477
"47115050201",3370,692,9,5,218,8,19,0,4321
"47115050202",4303,964,53,0,194,106,0,0,5620
"47115050301",3522,976,191,102,157,112,74,127,5261
"47115050302",2382,413,0,0,63,0,2,0,2860
"47117955000",5841,1152,67,4,21,21,54,2,7162
"47117955100",4778,328,88,20,115,0,347,0,5676
"47117955200",4127,752,395,50,61,0,20,54,5459
"47117955300",1950,1009,921,178,236,39,319,115,4767
"47117955400",2920,362,115,132,275,67,317,125,4313
"47117955500",3667,612,196,9,99,14,66,52,4715
"47119010100",2410,527,28,0,154,0,0,0,3119
"47119010201",4733,477,126,0,138,0,556,0,6030
"47119010202",7153,173,469,182,362,16,230,16,8601
"47119010301",5737,205,577,0,178,44,184,30,6955
"47119010302",2437,178,116,0,28,16,4,108,2887
"47119010400",3877,831,652,257,176,88,118,239,6238
"47119010500",1817,747,1428,829,69,41,128,20,5079
"47119010600",2395,644,803,294,147,370,341,488,5482
"47119010700",2953,1140,267,323,34,0,156,52,4925
"47119010801",2658,198,136,14,36,20,41,0,3103
"47119010802",3421,1329,625,428,245,78,453,290,6869
"47119010900",2342,459,310,83,109,9,42,0,3354
"47119011001",2166,172,240,45,66,0,0,0,2689
"47119011002",4439,1158,588,289,116,331,107,216,7244
"47119011101",3769,117,210,32,251,103,54,0,4536
"47119011102",2145,383,43,32,8,11,9,139,2770
"47119011200",4880,392,170,3,97,35,84,0,5661
"47121960100",2308,862,18,0,0,0,97,0,3285
"47121960200",3316,718,14,0,3,0,15,6,4072
"47121960300",3069,721,74,0,104,190,26,0,4184
"47123925000",5952,851,59,34,170,41,38,246,7391
"47123925100",6763,1350,0,0,280,11,660,0,9064
"47123925200",2969,807,523,95,113,0,11,0,4518
"47123925300",6329,1336,125,39,11,76,256,144,8316
"47123925400",5759,1982,63,0,68,105,10,204,8191
"47123925501",2286,451,0,0,24,6,0,0,2767
"47123925502",4255,1210,0,0,180,19,41,10,5715
"47125100100",347,354,60,17,61,52,157,13,1061
"47125100200",1039,458,142,35,99,32,40,46,1891
"47125100300",3097,1186,934,269,81,61,193,0,5821
"47125100400",741,431,884,842,413,17,166,117,3611
"47125100500",3352,938,393,69,377,74,758,179,6140
"47125100601",1720,150,27,38,67,0,78,22,2102
"47125100602",2142,305,60,34,96,0,100,11,2748
"47125100700",677,120,389,123,17,19,7,0,1352
"47125100800",302,233,525,829,44,25,7,17,1982
"47125100900",598,611,302,424,245,110,178,139,2607
"47125101001",2292,579,606,441,343,108,310,146,4825
"47125101002",1621,161,926,221,390,84,232,28,3663
"47125101101",1464,247,462,197,84,35,147,62,2698
"47125101102",4403,956,1087,573,623,35,619,145,8441
"47125101103",1819,527,133,23,105,31,231,13,2882
"47125101201",833,110,881,227,248,74,366,49,2788
"47125101202",1878,458,598,58,273,55,344,34,3698
"47125101303",4065,616,3388,295,1281,159,844,65,10713
"47125101304",2364,454,1417,461,717,27,568,74,6082
"47125101305",1888,369,1001,180,271,39,363,16,4127
"47125101306",2353,713,1107,516,402,0,491,0,5582
"47125101307",863,210,439,765,262,39,153,27,2758
"47125101400",3505,559,456,137,724,193,919,171,6664
"47125101500",5674,317,728,0,605,131,531,29,8015
"47125101600",3872,1276,186,139,66,21,86,23,5669
"47125101700",6884,603,170,3,130,15,55,31,7891
"47125101802",8215,586,429,47,278,91,430,0,10076
"47125101803",5460,1061,292,71,393,45,273,12,7607
"47125101804",5202,384,105,0,705,51,275,71,6793
"47125101902",2144,288,130,5,160,44,89,16,2876
"47125101903",5113,658,984,277,718,281,458,227,8716
"47125101904",2035,104,301,14,85,73,239,73,2924
"47125102001",3593,394,356,103,394,190,267,232,5529
"47125102002",5022,435,990,40,1107,79,957,68,8698
"47125102003",2917,338,1805,36,629,109,863,55,6752
"47125102004",2593,547,1290,104,338,0,481,112,5465
"47125102005",3308,317,632,240,619,105,459,46,5726
"47125102006",4109,491,1134,33,507,27,744,61,7106
"47125980100",0,0,0,0,0,0,0,0,0
"47127930100",3194,365,40,8,42,26,0,0,3675
"47127930200",1961,264,103,25,42,67,6,0,2468
"47129110100",1886,597,0,1,46,20,18,1,2569
"47129110200",2480,580,0,2,56,0,10,0,3128
"47129110300",2777,687,0,0,71,1,34,79,3649
"47129110400",3568,749,6,0,0,70,0,8,4401
"47129110500",3597,1410,12,0,87,0,38,0,5144
"47131965000",3323,393,392,78,42,40,0,13,4281
"47131965100",2135,300,129,58,23,0,29,37,2711
"47131965200",1966,207,23,2,49,0,34,0,2281
"47131965300",2768,882,20,4,43,11,0,112,3840
"47131965400",3513,692,28,11,81,20,59,16,4420
"47131965500",1449,531,68,98,7,51,6,23,2233
"47131965600",1488,500,947,631,132,80,131,229,4138
"47131965700",3364,459,391,391,26,28,196,0,4855
"47131965800",1463,221,15,0,8,0,133,5,1845
"47131965900",996,195,13,0,51,20,49,0,1324
"47133950100",1343,471,0,0,0,0,0,0,1814
"47133950200",1338,292,0,0,10,17,33,0,1690
"47133950301",3469,731,62,34,9,105,0,0,4410
"47133950302",2340,760,0,1,36,10,0,173,3320
"47133950400",1526,482,0,0,44,5,0,10,2067
"47133950500",4621,1456,0,0,100,0,0,31,6208
"47133950600",1984,523,0,0,16,0,0,0,2523
"47135930100",2102,705,0,0,46,65,4,28,2950
"47135930200",3561,977,95,75,56,12,74,46,4896
"47137925100",4120,781,4,20,43,36,6,4,5014
"47139950100",1080,387,0,0,26,11,0,0,1504
"47139950201",1737,175,4,8,7,2,27,12,1972
"47139950202",4822,814,0,0,94,19,7,74,5830
"47139950300",2665,786,0,0,23,0,114,0,3588
"47139950400",2817,765,0,0,75,137,2,31,3827
"47141000100",3582,1385,9,15,0,43,376,505,5915
"47141000200",7156,1214,107,140,64,22,160,0,8863
"47141000301",2361,443,0,1,157,0,29,0,2991
"47141000302",3073,3206,54,232,63,53,118,668,7467
"47141000303",1679,822,16,9,187,0,226,203,3142
"47141000400",2769,665,100,0,343,17,85,0,3979
"47141000500",1358,712,25,9,0,105,123,210,2542
"47141000600",2301,605,0,100,208,23,13,0,3250
"47141000700",1649,1553,1,69,121,10,32,59,3494
"47141000800",1991,1406,112,161,69,173,439,77,4428
"47141000900",4963,1111,179,1,128,1,47,72,6502
"47141001000",2681,507,0,0,75,0,31,7,3301
"47141001100",5351,1022,0,0,110,29,171,0,6683
"47141001200",7350,1380,11,12,201,0,219,0,9173
"47141001300",1803,260,25,0,31,171,3,158,2451
"47143975000",3655,938,50,3,47,137,13,40,4883
"47143975100",3574,494,36,0,13,0,99,0,4216
"47143975200",4790,757,0,0,137,228,183,51,6146
"47143975300",3946,1780,166,11,37,146,11,209,6306
"47143975401",4174,2226,198,85,197,4,207,306,7397
"47143975402",2805,339,29,0,109,0,129,47,3458
"47145030100",2815,169,182,0,87,0,44,0,3297
"47145030201",5217,702,85,0,68,0,144,0,6216
"47145030202",5650,691,131,40,238,0,209,0,6959
"47145030300",4965,1273,55,0,48,50,0,60,6451
"47145030400",5692,699,50,32,115,12,74,0,6674
"47145030500",2232,1345,121,128,94,17,0,0,3937
"47145030600",2716,665,46,10,53,117,36,0,3643
"47145030700",3578,624,51,1,20,294,20,155,4743
"47145030800",3828,1060,300,59,93,0,51,0,5391
"47145030900",4837,988,66,0,155,88,0,0,6134
"47145980100",0,0,0,0,0,0,0,0,0
"47147080101",3171,389,151,2,99,60,33,16,3921
"47147080103",5526,333,54,0,85,163,315,111,6587
"47147080104",6469,603,78,68,48,0,338,0,7604
"47147080200",4442,1021,215,16,293,159,232,203,6581
"47147080301",1529,218,493,278,114,238,376,230,3476
"47147080302",1157,319,473,593,86,45,252,201,3126
"47147080401",2067,614,1022,356,429,173,524,334,5519
"47147080402",3276,288,554,118,251,8,436,87,5018
"47147080500",3441,218,228,6,119,26,11,0,4049
"47147080603",3771,377,24,0,70,0,42,57,4341
"47147080604",3439,454,0,6,77,0,0,0,3976
"47147080605",2663,165,0,9,162,0,71,0,3070
"47147080606",4927,321,157,0,125,37,60,35,5662
"47147080700",6613,419,112,9,114,40,18,0,7325
"47149040101",2407,591,424,0,52,154,478,612,4718
"47149040102",2278,475,764,19,158,52,606,430,4782
"47149040103",4727,432,2288,400,304,257,2566,513,11487
"47149040104",2868,362,960,43,224,0,640,29,5126
"47149040105",3320,296,317,0,267,25,78,141,4444
"47149040200",2649,331,280,105,264,7,266,9,3911
"47149040302",6646,851,447,0,431,260,845,159,9639
"47149040303",1436,466,63,0,31,65,26,67,2154
"47149040304",1464,206,285,100,57,0,193,0,2305
"47149040305",1493,508,245,32,88,0,58,17,2441
"47149040306",3189,164,564,142,201,35,682,0,4977
"47149040307",2470,78,290,0,132,0,16,19,3005
"47149040308",4601,275,915,0,491,0,450,0,6732
"47149040403",5222,1219,137,329,668,118,479,439,8611
"47149040501",6460,198,242,0,206,0,72,0,7178
"47149040502",5875,368,388,49,73,5,15,0,6773
"47149040600",3979,487,133,10,33,17,0,0,4659
"47149040701",6715,424,689,94,501,212,251,0,8886
"47149040702",4274,166,331,29,74,0,81,7,4962
"47149040805",6121,471,1392,293,676,15,160,52,9180
"47149040806",6626,680,194,0,317,18,403,22,8260
"47149040807",4126,270,356,0,541,16,168,119,5596
"47149040808",5469,616,430,31,416,57,399,0,7418
"47149040809",3418,189,94,0,67,0,176,0,3944
"47149040810",2039,232,42,1,7,14,0,2,2337
"47149040901",1972,125,438,0,145,0,23,0,2703
"47149040902",7478,646,1043,54,403,54,533,27,10238
"47149040903",8435,1015,1877,14,322,0,374,103,12140
"47149040904",3333,299,480,0,547,146,5,120,4930
"47149040905",6330,263,971,10,574,167,127,27,8469
"47149041000",5982,441,467,199,54,83,98,190,7514
"47149041101",5675,366,561,47,227,93,149,39,7157
"47149041102",2091,450,346,51,96,6,13,6,3059
"47149041201",4104,540,390,32,241,55,41,0,5403
"47149041202",2765,233,548,123,349,77,154,0,4249
"47149041301",4513,120,159,0,246,0,20,8,5066
"47149041302",4822,153,350,271,196,0,79,56,5927
"47149041401",2847,674,475,323,386,107,83,177,5072
"47149041402",3436,908,599,570,456,201,764,144,7078
"47149041403",4049,1407,1070,851,415,56,138,29,8015
"47149041500",3,18,16,0,0,0,0,0,37
"47149041600",2837,1194,756,777,254,544,270,176,6808
"47149041700",3181,917,367,46,349,17,62,79,5018
"47149041800",1639,647,408,410,134,204,85,213,3740
"47149041900",1198,642,1091,490,223,142,325,186,4297
"47149042000",3221,365,516,215,144,113,165,0,4739
"47149042100",3358,1746,1344,498,558,355,306,403,8568
"47149042200",3391,800,309,196,340,177,424,401,6038
"47149042300",5131,556,1498,0,530,52,402,85,8254
"47151975000",2805,1165,0,0,39,62,4,5,4080
"47151975100",5005,1636,0,0,54,0,0,0,6695
"47151975200",3638,1881,6,0,99,12,88,0,5724
"47151975300",1699,557,0,0,7,23,0,20,2306
"47151975400",2254,624,1,1,0,20,0,32,2932
"47153060101",6065,1197,13,0,601,397,247,156,8676
"47153060102",1508,558,0,0,126,37,0,37,2266
"47153060200",2988,358,0,0,239,89,37,0,3711
"47155080101",2794,753,17,0,39,0,75,0,3678
"47155080102",5084,1129,92,0,248,138,59,51,6801
"47155080201",7420,197,63,0,332,0,440,0,8452
"47155080202",4818,484,0,87,71,27,113,139,5739
"47155080300",4043,708,15,0,99,0,0,0,4865
"47155080400",6737,812,0,0,61,85,218,0,7913
"47155080500",3040,1333,0,0,145,391,151,535,5595
"47155080601",3197,658,0,67,228,6,425,215,4796
"47155080602",8180,1387,1,1,91,23,29,1,9713
"47155080700",6018,920,0,0,358,108,190,71,7665
"47155080801",1541,671,82,8,178,237,457,397,3571
"47155080802",5445,744,11,0,621,0,772,224,7817
"47155080901",3168,233,0,0,8,0,0,0,3409
"47155080902",3698,1128,16,0,164,10,257,0,5273
"47155081000",4012,1030,167,2,209,0,153,0,5573
"47155081101",1321,152,6,0,24,12,14,25,1554
"47155081102",3375,492,0,0,101,0,30,0,3998
"47155980100",0,0,0,0,0,0,0,0,0
"47157000100",3390,760,936,145,883,172,240,0,6526
"47157000200",4,0,653,315,0,28,0,0,1000
"47157000300",0,0,608,300,6,0,0,0,914
"47157000400",5,37,911,796,14,12,0,0,1775
"47157000600",1,0,1009,850,0,0,0,0,1860
"47157000700",69,18,2718,1943,139,0,0,0,4887
"47157000800",8,19,965,1148,0,0,0,0,2140
"47157000900",41,0,1550,1424,30,0,0,0,3045
"47157001100",708,596,806,739,551,61,573,322,4356
"47157001200",1641,730,649,182,71,158,106,217,3754
"47157001300",263,259,1296,1307,148,322,82,315,3992
"47157001400",79,49,933,443,9,10,33,33,1589
"47157001500",136,45,608,462,48,21,28,0,1348
"47157001600",1540,179,327,20,57,4,24,0,2151
"47157001700",1310,45,1780,515,100,13,11,0,3774
"47157001900",0,3,739,623,0,0,0,0,1365
"47157002000",59,84,825,799,99,0,0,13,1879
"47157002100",67,39,712,489,5,0,4,0,1316
"47157002400",70,97,1002,927,124,72,101,126,2519
"47157002500",1036,395,773,618,371,167,43,277,3680
"47157002600",1889,165,200,1,179,39,66,7,2546
"47157002700",713,341,281,774,61,8,28,181,2387
"47157002800",406,28,1751,1501,0,8,0,0,3694
"47157002900",3793,426,100,42,48,175,173,0,4757
"47157003000",1475,115,1013,399,82,27,0,27,3138
"47157003100",2314,279,196,138,130,48,121,48,3274
"47157003200",1634,470,335,157,42,48,55,54,2795
"47157003300",2275,209,0,9,84,0,53,0,2630
"47157003400",1209,348,340,177,77,7,164,0,2322
"47157003500",2433,156,569,98,116,22,42,0,3436
"47157003600",648,517,282,179,149,38,189,97,2099
"47157003700",252,132,447,407,5,23,9,15,1290
"47157003800",147,138,259,208,301,60,0,8,1121
"47157003900",59,128,420,656,64,0,16,33,1376
"47157004200",1545,194,388,97,120,87,105,60,2596
"47157004300",869,85,331,19,90,27,10,0,1431
"47157004500",22,8,270,223,6,4,0,0,533
"47157004600",106,79,694,425,19,18,0,0,1341
"47157005000",5,6,340,734,18,0,0,0,1103
"47157005300",15,18,2068,1481,0,0,0,12,3594
"47157005500",26,27,1133,956,9,17,0,0,2168
"47157005600",0,0,2660,1038,48,0,0,0,3746
"47157005700",29,0,1493,524,10,6,0,0,2062
"47157005800",0,0,401,735,0,0,0,0,1136
"47157005900",0,19,1523,856,80,11,32,0,2521
"47157006000",6,13,1315,784,17,28,6,12,2181
"47157006200",64,46,1458,659,10,0,0,13,2250
"47157006300",1590,230,294,174,21,0,37,0,2346
"47157006400",48,48,946,525,76,36,0,0,1679
"47157006500",80,7,1878,956,0,6,0,0,2927
"47157006600",1030,154,514,350,99,11,31,22,2211
"47157006700",19,28,1365,1763,0,0,0,0,3175
"47157006800",10,48,882,1625,62,5,50,0,2682
"47157006900",82,39,1702,1243,14,20,0,0,3100
"47157007000",753,187,1300,1046,123,109,93,80,3691
"47157007100",1620,127,404,92,78,0,17,0,2338
"47157007200",2032,199,105,21,169,0,53,0,2579
"47157007300",1250,496,190,306,58,163,17,0,2480
"47157007400",1493,429,318,73,204,310,135,8,2970
"47157007500",25,0,830,344,0,0,0,0,1199
"47157007810",21,98,1430,1024,73,0,73,11,2730
"47157007821",8,41,3212,2706,1,18,8,0,5994
"47157007822",63,0,795,588,196,114,213,114,2083
"47157007900",109,0,3780,2018,0,44,0,0,5951
"47157008000",1208,66,2539,1430,114,83,38,22,5500
"47157008110",154,157,1188,1052,146,286,137,293,3413
"47157008120",68,160,2869,1465,10,18,0,50,4640
"47157008200",169,341,1426,2136,653,806,622,769,6922
"47157008500",4392,81,47,27,120,19,5,0,4691
"47157008600",4404,318,404,242,351,29,287,47,6082
"47157008700",2579,260,249,65,284,514,382,371,4704
"47157008800",2715,2031,541,378,913,213,1531,1639,9961
"47157008900",1043,830,720,503,605,271,787,859,5618
"47157009100",1486,699,32,0,182,197,611,582,3789
"47157009200",6371,325,75,64,614,49,0,97,7595
"47157009300",2925,496,161,752,82,190,8,218,4832
"47157009400",2841,325,252,1,46,0,77,0,3542
"47157009500",5161,194,601,0,95,0,126,0,6177
"47157009600",4693,174,26,9,49,20,108,11,5090
"47157009700",910,95,1117,284,205,311,136,29,3087
"47157009800",2165,498,472,104,173,127,374,194,4107
"47157009901",887,565,755,1033,438,248,422,452,4800
"47157009902",145,151,1138,1189,81,66,87,0,2857
"47157010000",409,320,4373,2320,83,157,0,85,7747
"47157010110",498,26,2721,4237,204,0,0,0,7686
"47157010120",480,156,2157,1681,0,56,77,81,4688
"47157010210",182,113,2698,2161,151,52,0,0,5357
"47157010220",609,113,3850,2143,12,61,0,95,6883
"47157010300",10,5,784,665,31,5,0,0,1500
"47157010500",229,7,605,610,88,97,169,82,1887
"47157010610",538,26,4188,1811,512,171,514,215,7975
"47157010620",138,55,1674,931,195,191,247,229,3660
"47157010630",320,113,1997,1303,314,700,658,813,6218
"47157010710",854,137,3046,705,175,365,316,293,5891
"47157010720",265,62,1791,1281,166,14,149,52,3780
"47157010810",304,33,3721,1146,503,501,226,401,6835
"47157010820",559,7,2924,685,255,353,140,229,5152
"47157011010",985,549,2182,585,73,303,217,564,5458
"47157011020",34,10,720,385,68,74,13,33,1337
"47157011100",0,9,1060,671,0,0,0,0,1740
"47157011200",0,0,637,848,3,8,0,0,1496
"47157011300",181,49,519,525,84,0,31,0,1389
"47157011400",223,243,841,1790,4,109,24,0,3234
"47157011500",166,0,1228,935,4,0,0,0,2333
"47157011600",0,28,1348,1084,5,46,0,57,2568
"47157011700",0,0,926,591,0,0,0,0,1517
"47157011800",1874,498,1448,1002,386,334,754,810,7106
"47157020101",1251,227,1211,1499,175,82,4,27,4476
"47157020102",2288,148,264,24,59,0,33,0,2816
"47157020210",3718,418,1110,409,153,44,105,4,5961
"47157020221",1753,157,838,51,94,149,251,189,3482
"47157020222",1319,214,984,455,219,81,186,196,3654
"47157020300",3191,773,400,621,139,115,36,300,5575
"47157020400",687,9,361,4,141,7,148,0,1357
"47157020511",317,103,1439,271,136,29,52,21,2368
"47157020512",610,310,2278,1892,0,15,0,109,5214
"47157020521",175,106,1905,1519,50,104,0,107,3966
"47157020523",179,78,1639,1265,67,200,68,89,3585
"47157020524",463,124,2734,811,89,0,98,144,4463
"47157020531",1041,839,3303,672,302,226,422,799,7604
"47157020532",908,157,3680,523,177,23,138,79,5685
"47157020541",1065,93,2976,999,75,0,82,0,5290
"47157020542",596,61,2527,1631,463,0,128,0,5406
"47157020610",879,157,1983,283,257,45,178,21,3803
"47157020621",2164,283,3307,670,450,39,392,0,7305
"47157020622",2973,264,485,32,126,12,0,0,3892
"47157020632",4150,121,625,21,298,0,131,0,5346
"47157020633",2629,65,185,11,347,11,30,3,3281
"47157020634",2565,29,40,0,242,72,74,0,3022
"47157020635",2388,231,144,0,116,0,101,3,2983
"47157020642",5491,214,2414,14,538,0,85,0,8756
"47157020643",5721,295,1933,40,379,0,322,33,8723
"47157020644",3128,207,3960,411,868,72,888,57,9591
"47157020651",4137,202,2089,349,633,20,482,0,7912
"47157020652",4238,359,581,152,87,0,36,115,5568
"47157020700",1963,132,404,10,25,0,4,0,2538
"47157020810",2458,56,503,310,0,5,0,0,3332
"47157020820",6497,438,827,0,812,58,181,0,8813
"47157020831",3450,130,416,24,262,0,41,0,4323
"47157020832",6533,37,1485,49,551,0,295,0,8950
"47157020900",7921,54,770,35,642,0,130,0,9552
"47157021010",7284,152,5893,1075,2144,144,1548,104,18344
"47157021020",4154,157,1183,211,506,18,328,38,6595
"47157021111",1944,233,1083,422,453,108,616,165,5024
"47157021112",3483,313,1121,365,1221,112,1281,52,7948
"47157021113",1933,215,1060,163,328,58,246,0,4003
"47157021121",2319,181,1843,338,42,12,24,23,4782
"47157021122",2001,310,2073,597,528,15,43,160,5727
"47157021124",3222,421,2935,602,1241,0,1217,0,9638
"47157021125",3208,78,441,336,337,11,218,0,4629
"47157021126",2505,147,1173,0,378,30,145,30,4408
"47157021135",3521,226,1957,612,354,38,16,62,6786
"47157021136",2649,21,1686,276,391,0,165,0,5188
"47157021137",4299,522,1378,43,1072,15,380,0,7709
"47157021138",1940,109,1001,0,202,22,32,41,3347
"47157021139",2963,202,612,9,325,159,225,0,4495
"47157021140",3446,104,802,0,364,157,128,44,5045
"47157021141",3669,137,2525,204,694,26,393,3,7651
"47157021142",1725,169,1865,4,114,63,76,78,4094
"47157021200",0,0,0,0,0,0,0,0,0
"47157021311",4013,85,455,0,83,0,135,0,4771
"47157021312",1814,144,142,0,116,14,40,0,2270
"47157021320",3934,106,1409,58,132,33,109,0,5781
"47157021331",2055,155,616,264,265,15,305,0,3675
"47157021333",1758,42,1163,284,336,13,284,47,3927
"47157021334",1136,62,2033,274,117,0,166,0,3788
"47157021341",4443,237,352,13,296,13,138,0,5492
"47157021342",4785,154,3178,468,704,117,329,201,9936
"47157021351",3384,126,190,19,660,0,151,0,4530
"47157021352",6189,163,122,0,317,0,36,0,6827
"47157021353",7656,492,670,0,950,25,225,322,10340
"47157021410",2394,66,59,0,273,0,8,17,2817
"47157021420",2847,85,51,0,230,14,208,0,3435
"47157021430",3619,58,163,47,119,0,67,0,4073
"47157021510",1785,80,5108,663,502,94,132,29,8393
"47157021520",5714,468,3484,59,1671,171,305,32,11904
"47157021530",4447,176,221,0,352,0,27,0,5223
"47157021540",9921,121,579,18,1317,0,482,0,12438
"47157021611",5416,369,237,0,283,44,48,0,6397
"47157021612",4482,50,147,16,147,0,92,0,4934
"47157021613",4102,34,226,0,272,12,37,0,4683
"47157021620",966,67,1232,328,180,0,301,0,3074
"47157021710",156,125,1540,752,20,0,35,103,2731
"47157021721",155,131,2574,1750,276,494,193,414,5987
"47157021724",147,44,1266,417,280,13,305,30,2502
"47157021725",264,18,3271,443,512,274,613,274,5669
"47157021726",765,198,2442,1225,13,274,64,121,5102
"47157021731",152,91,1318,692,311,658,256,679,4157
"47157021732",324,12,3702,2057,391,311,379,311,7487
"47157021741",682,18,5096,1966,259,123,546,73,8763
"47157021744",594,42,4777,323,299,208,251,208,6702
"47157021745",1135,57,5957,298,614,0,490,57,8608
"47157021746",396,15,3076,472,210,0,104,0,4273
"47157021747",423,44,2380,520,132,125,47,125,3796
"47157021751",300,0,5920,765,102,32,0,32,7151
"47157021752",286,214,3494,341,252,0,205,20,4812
"47157021753",149,136,2414,94,432,0,390,0,3615
"47157021754",644,5,3265,326,168,87,118,87,4700
"47157021900",87,65,3804,1339,0,0,7,35,5337
"47157022022",50,196,2655,1136,0,22,4,191,4254
"47157022023",0,0,1674,470,8,0,0,0,2152
"47157022024",104,15,2602,668,0,0,0,0,3389
"47157022111",102,11,3215,1930,58,0,72,0,5388
"47157022112",64,115,3874,2273,0,0,0,0,6326
"47157022121",233,8,3467,1058,7,0,6,0,4779
"47157022122",89,26,3100,882,25,0,0,0,4122
"47157022130",157,16,3407,1864,144,17,0,0,5605
"47157022210",27,6,2825,1410,67,7,0,0,4342
"47157022220",100,6,2438,926,23,57,39,20,3609
"47157022310",32,0,2927,2681,19,0,0,0,5659
"47157022321",0,17,2709,906,0,0,0,17,3649
"47157022322",22,0,3101,915,0,0,0,0,4038
"47157022330",79,153,3482,1140,94,87,174,240,5449
"47157022410",167,200,5127,1070,93,77,24,257,7015
"47157022500",265,716,3351,478,242,171,340,858,6421
"47157022600",320,76,2333,838,416,414,498,452,5347
"47157022700",71,21,4863,2363,72,141,0,0,7531
"47157980100",14,13,0,41,0,0,0,0,68
"47157980200",0,0,0,0,0,0,0,0,0
"47157980300",0,0,0,0,0,0,0,0,0
"47157980400",0,0,0,0,0,0,0,0,0
"47159975000",3117,617,15,0,9,1,32,86,3877
"47159975100",1765,493,93,55,19,21,11,0,2457
"47159975200",4810,686,152,11,304,75,244,56,6338
"47159975300",1517,274,0,0,8,0,0,0,1799
"47159975400",3940,716,26,0,34,35,32,0,4783
"47161110200",4289,968,111,1,117,58,15,46,5605
"47161110600",2178,521,69,36,82,21,48,0,2955
"47161110700",3651,783,0,28,168,104,77,110,4921
"47161980100",0,0,0,0,0,0,0,0,0
"47161980200",0,0,0,0,0,0,0,0,0
"47163040200",1255,728,374,153,45,166,19,24,2764
"47163040300",1908,457,35,56,48,5,48,0,2557
"47163040500",2336,1596,73,85,75,300,28,193,4686
"47163040600",1717,1381,164,46,67,0,82,70,3527
"47163040700",2080,217,65,23,16,21,8,20,2450
"47163040800",1852,778,32,10,252,34,164,83,3205
"47163040900",2655,513,34,6,87,78,9,52,3434
"47163041000",3692,276,0,0,60,67,0,76,4171
"47163041100",1924,253,12,30,57,20,10,0,2306
"47163041200",5418,799,115,0,237,81,162,21,6833
"47163041300",3490,501,10,14,65,50,26,0,4156
"47163041400",4305,537,0,1,53,0,32,0,4928
"47163041500",2524,68,17,0,69,0,16,23,2717
"47163041600",2137,153,62,20,67,12,62,0,2513
"47163041700",2497,898,80,0,148,0,0,29,3652
"47163041800",3061,1098,1,110,364,488,139,37,5298
"47163041900",2925,313,0,0,47,0,0,0,3285
"47163042000",2670,622,0,0,4,0,0,0,3296
"47163042100",4413,861,4,1,229,98,29,0,5635
"47163042200",2899,594,31,0,75,6,50,160,3815
"47163042300",6135,214,26,0,133,0,0,0,6508
"47163042400",2245,641,0,0,131,29,0,0,3046
"47163042500",2837,355,14,14,59,0,33,0,3312
"47163042600",3106,526,75,43,250,79,221,72,4372
"47163042701",3363,1395,37,9,33,89,11,81,5018
"47163042702",1793,372,20,0,32,18,18,18,2271
"47163042801",2203,244,86,0,38,0,66,0,2637
"47163042802",2681,908,176,97,7,39,0,32,3940
"47163042900",3698,249,44,2,38,0,9,1,4041
"47163043000",3721,793,51,0,115,19,0,0,4699
"47163043100",2393,460,25,5,37,23,2,21,2966
"47163043201",4085,239,14,0,57,0,0,0,4395
"47163043202",4298,599,0,0,15,0,44,0,4956
"47163043301",4527,407,14,0,58,0,14,0,5020
"47163043302",4508,1390,42,3,115,82,16,0,6156
"47163043401",3660,1442,0,2,43,14,0,0,5161
"47163043402",3038,1020,41,1,29,0,0,0,4129
"47163043500",3239,454,13,0,40,5,74,5,3830
"47163043600",3737,699,32,14,120,98,40,3,4743
"47165020101",2810,484,0,0,0,3,0,0,3297
"47165020102",4214,512,0,0,31,31,38,0,4826
"47165020203",2201,191,0,0,0,23,114,0,2529
"47165020204",2689,196,3,0,55,29,10,0,2982
"47165020205",2378,249,305,11,271,0,148,55,3417
"47165020206",919,102,9,0,40,12,93,2,1177
"47165020207",1344,133,4,0,24,3,17,0,1525
"47165020208",1690,375,86,0,25,14,2,25,2217
"47165020209",1772,213,0,0,81,4,0,0,2070
"47165020300",3530,982,29,75,95,185,62,125,5083
"47165020403",1508,196,0,87,0,0,0,0,1791
"47165020404",1732,256,0,0,0,0,0,57,2045
"47165020405",1605,311,9,5,45,0,21,0,1996
"47165020406",3012,469,0,0,25,0,31,135,3672
"47165020407",3910,165,35,0,236,11,130,0,4487
"47165020501",4493,294,149,0,230,0,111,0,5277
"47165020502",3391,73,203,0,16,0,16,0,3699
"47165020503",1729,268,0,0,6,0,32,121,2156
"47165020601",2728,424,54,0,9,21,11,0,3247
"47165020602",3934,117,31,0,88,73,0,44,4287
"47165020603",3216,418,56,0,80,0,69,0,3839
"47165020700",2551,492,205,180,23,175,165,199,3990
"47165020800",2651,1039,2160,781,144,128,701,543,8147
"47165020901",1302,136,3,4,15,17,92,24,1593
"47165020902",5039,712,610,42,430,164,715,56,7768
"47165020903",2854,352,90,134,243,0,117,32,3822
"47165021002",6311,65,602,405,133,137,120,0,7773
"47165021004",3172,323,161,0,132,62,91,205,4146
"47165021005",5418,319,400,39,429,17,224,17,6863
"47165021006",2807,80,99,0,11,0,26,0,3023
"47165021007",1912,196,210,0,167,0,72,0,2557
"47165021008",3005,196,125,0,309,0,65,43,3743
"47165021009",3999,502,125,176,195,5,176,0,5178
"47165021103",4721,250,432,18,92,10,355,0,5878
"47165021104",1794,55,142,0,196,0,118,0,2305
"47165021105",5459,348,545,90,346,137,326,300,7551
"47165021106",2882,226,640,26,46,93,105,1,4019
"47165021107",3658,232,189,1,103,30,176,1,4390
"47165021201",6213,131,540,0,141,0,0,0,7025
"47165021203",4886,175,111,0,62,0,144,0,5378
"47165021204",6336,678,588,97,319,199,116,0,8333
"47165021205",2207,129,41,0,77,0,5,0,2459
"47167040100",3811,786,473,115,44,15,0,168,5412
"47167040200",1602,355,53,0,36,10,30,0,2086
"47167040302",7572,274,1092,86,785,142,407,0,10358
"47167040303",5555,123,521,86,135,0,0,0,6420
"47167040304",4689,669,293,40,351,27,137,0,6206
"47167040400",2626,456,0,0,11,0,42,14,3149
"47167040500",5273,554,641,90,229,0,244,0,7031
"47167040601",2089,472,1534,596,66,0,30,0,4787
"47167040602",2356,295,365,74,93,13,136,62,3394
"47167040700",1669,340,1473,1274,11,29,24,22,4842
"47167040800",3534,214,261,27,78,49,31,0,4194
"47167040900",1090,114,290,116,8,0,8,0,1626
"47167041000",915,158,918,323,18,4,23,25,2384
"47169090100",3869,660,339,0,117,56,0,0,5041
"47169090200",1804,332,338,185,57,0,0,0,2716
"47171080100",2042,657,6,0,28,6,22,6,2767
"47171080200",4741,1309,67,0,89,26,162,111,6505
"47171080300",4170,906,13,0,100,37,98,112,5436
"47171080400",2836,702,1,5,10,35,0,212,3801
"47173040100",5528,1203,2,38,81,5,57,16,6930
"47173040201",2824,991,0,0,30,10,89,4,3948
"47173040202",4178,1604,0,0,36,23,57,0,5898
"47173040300",1804,394,0,0,111,11,28,11,2359
"47175925000",1848,512,0,0,3,4,15,11,2393
"47175925200",2341,612,11,0,95,53,13,0,3125
"47177930100",2700,752,18,10,104,63,90,202,3939
"47177930200",5004,1035,48,6,132,57,123,390,6795
"47177930300",2022,472,95,2,28,1,21,3,2644
"47177930400",4539,693,14,0,533,301,686,185,6951
"47177930500",2994,948,112,66,288,208,152,405,5173
"47177930600",2202,1031,79,18,68,154,120,180,3852
"47177930700",3511,985,12,10,138,92,239,119,5106
"47177930800",4671,1133,38,60,260,65,111,173,6511
"47177930900",1125,268,0,1,78,24,41,28,1565
"47179060100",1450,1009,454,166,63,25,107,279,3553
"47179060400",5083,315,168,16,399,0,105,28,6114
"47179060501",3268,1097,174,1,79,0,38,9,4666
"47179060502",4393,1024,125,0,113,29,142,101,5927
"47179060600",3999,1836,262,384,106,113,200,35,6935
"47179060700",0,0,0,0,0,0,0,0,0
"47179060800",1564,980,16,24,287,86,52,61,3070
"47179060900",3672,1869,301,355,123,110,0,34,6464
"47179061000",948,907,151,136,39,142,94,148,2565
"47179061100",3551,719,120,0,113,0,96,0,4599
"47179061200",2507,521,53,90,90,17,4,0,3282
"47179061300",5953,754,300,273,589,129,214,0,8212
"47179061401",4058,1148,13,0,121,20,115,0,5475
"47179061402",5402,595,3,13,277,19,20,0,6329
"47179061500",6567,651,23,0,85,28,0,1,7355
"47179061601",3733,183,2,12,13,0,231,0,4174
"47179061602",8976,350,0,1,148,0,90,91,9656
"47179061701",5270,460,64,3,226,64,258,101,6446
"47179061702",5841,829,22,0,93,28,231,0,7044
"47179061800",5227,1255,19,0,112,0,52,0,6665
"47179061901",5329,947,33,0,118,177,83,220,6907
"47179061902",4066,354,0,0,6,0,13,6,4445
"47179062000",2099,1065,351,158,70,118,222,176,4259
"47181950100",2248,380,12,63,3,21,3,0,2730
"47181950200",3971,1301,20,24,66,8,5,63,5458
"47181950300",3243,650,2,0,58,19,27,19,4018
"47181950400",1981,667,21,0,16,25,37,0,2747
"47183968000",897,213,0,0,4,0,3,0,1117
"47183968101",1950,502,500,426,78,31,3,27,3517
"47183968102",1674,57,19,74,24,38,83,0,1969
"47183968201",3616,314,322,28,84,0,66,0,4430
"47183968202",96,369,0,75,24,0,20,0,584
"47183968203",1261,1152,125,333,7,46,55,33,3012
"47183968300",1867,424,117,25,34,8,0,2,2477
"47183968400",4086,1054,284,0,57,96,76,137,5790
"47183968500",3792,721,23,106,74,17,80,46,4859
"47183968600",2725,577,108,72,22,24,41,9,3578
"47183968700",1316,118,0,0,7,0,14,12,1467
"47185935000",3103,608,0,0,0,0,10,0,3721
"47185935100",4588,1106,0,3,0,0,218,77,5992
"47185935200",2873,974,0,8,34,0,38,0,3927
"47185935300",4011,642,15,105,314,0,98,0,5185
"47185935400",2307,987,85,166,14,73,8,0,3640
"47185935500",2393,955,0,0,156,13,23,25,3565
"47187050101",6350,183,691,144,1037,0,418,0,8823
"47187050102",3175,107,190,0,427,0,20,0,3919
"47187050103",3584,325,104,11,61,0,39,0,4124
"47187050203",4686,211,87,0,263,69,114,0,5430
"47187050204",4663,44,205,0,383,23,96,0,5414
"47187050205",3321,87,34,0,149,0,115,25,3731
"47187050206",2798,20,33,0,105,0,12,0,2968
"47187050207",2925,63,210,82,409,17,62,0,3768
"47187050208",5615,70,135,0,1039,13,171,0,7043
"47187050303",2545,29,129,0,98,0,12,0,2813
"47187050304",1551,82,0,0,168,0,0,0,1801
"47187050305",2206,17,91,0,245,0,124,0,2683
"47187050306",1543,50,108,0,189,0,45,0,1935
"47187050307",2883,240,43,0,244,0,364,0,3774
"47187050403",1653,76,16,0,72,0,0,0,1817
"47187050404",5724,358,431,0,276,0,44,0,6833
"47187050405",2641,102,0,0,83,0,0,0,2826
"47187050406",4978,113,133,9,135,0,81,0,5449
"47187050502",3370,425,0,0,72,9,98,0,3974
"47187050503",4200,414,24,0,175,0,94,9,4916
"47187050504",3220,364,0,0,239,0,89,34,3946
"47187050601",4558,564,570,53,124,0,413,359,6641
"47187050602",8082,294,571,36,324,105,140,92,9644
"47187050701",4235,139,42,0,329,0,93,0,4838
"47187050702",3719,330,85,0,46,48,124,35,4387
"47187050800",3411,1158,359,291,223,275,469,675,6861
"47187050904",3089,487,688,47,300,249,322,546,5728
"47187050905",4609,186,402,0,589,0,72,0,5858
"47187050906",5089,50,300,56,59,0,31,0,5585
"47187050907",4459,204,36,0,577,0,346,0,5622
"47187050908",3429,0,0,0,71,0,145,0,3645
"47187050909",3470,0,62,0,120,0,121,0,3773
"47187051001",5603,72,229,0,562,6,170,0,6642
"47187051002",5261,371,91,0,319,0,521,0,6563
"47187051100",5563,349,292,13,146,0,22,125,6510
"47187051201",5041,703,18,0,76,0,140,0,5978
"47187051202",20907,648,1036,0,783,251,1255,451,25331
"47189030101",6846,536,271,0,166,116,150,116,8201
"47189030102",5882,439,232,20,20,42,178,0,6813
"47189030202",6114,147,173,1,282,0,17,0,6734
"47189030203",4096,158,597,73,77,0,24,0,5025
"47189030204",5828,316,127,2,189,0,56,0,6518
"47189030303",4135,128,80,4,182,1,30,1,4561
"47189030304",5699,286,156,249,127,24,98,16,6655
"47189030305",4994,148,255,32,93,0,186,0,5708
"47189030307",5964,498,264,54,336,23,423,0,7562
"47189030308",3918,84,362,93,263,8,145,0,4873
"47189030309",4048,350,325,32,342,64,74,17,5252
"47189030401",1456,486,83,178,79,2,101,4,2389
"47189030402",1980,623,326,353,1175,142,989,254,5842
"47189030500",4003,716,498,335,156,87,125,87,6007
"47189030600",2692,492,156,27,41,133,34,131,3706
"47189030700",1170,345,765,597,32,13,154,104,3180
"47189030800",4536,795,170,47,49,54,173,0,5824
"47189030901",8145,899,320,208,435,0,226,0,10233
"47189030903",6111,362,208,0,224,29,86,0,7020
"47189030904",3127,256,77,0,156,17,17,0,3650
"47189031000",4614,1013,60,82,251,89,62,85,6256
"48001950100",3435,727,530,119,231,40,177,298,5557
"48001950401",215,17,10,67,0,24,21,24,378
"48001950402",136,22,52,0,0,11,0,11,232
"48001950500",2631,849,271,634,118,70,1068,334,5975
"48001950600",3317,577,1574,509,284,75,699,339,7374
"48001950700",999,193,526,463,135,57,663,166,3202
"48001950800",3231,210,599,404,435,58,403,20,5360
"48001950901",3516,627,262,126,211,14,515,303,5574
"48001950902",3789,728,235,113,136,0,176,193,5370
"48001951000",6122,631,135,103,175,56,447,214,7883
"48001951100",3515,732,424,17,48,15,182,249,5182
"48003950100",1779,70,72,0,73,0,385,51,2430
"48003950200",5768,409,164,64,245,157,2932,402,10141
"48003950300",3276,687,23,0,186,71,2230,483,6956
"48003950400",2356,185,93,0,61,179,1496,239,4609
"48005000101",4284,977,45,185,419,0,643,33,6586
"48005000102",3969,455,64,42,355,78,835,238,6036
"48005000200",4177,1512,449,119,287,271,801,676,8292
"48005000301",3515,487,259,102,102,8,357,205,5035
"48005000302",3383,465,336,163,145,171,453,345,5461
"48005000400",2273,717,827,1310,105,34,506,369,6141
"48005000500",761,264,1737,700,127,16,508,121,4234
"48005000600",2826,961,1268,451,398,168,2057,944,9073
"48005000700",1691,709,577,509,288,211,1474,848,6307
"48005000800",3916,889,931,212,164,154,375,397,7038
"48005000901",4840,438,908,65,159,119,390,288,7207
"48005000902",1926,160,132,64,387,0,246,0,2915
"48005001001",2751,944,467,143,459,78,1932,516,7290
"48005001002",3845,340,203,38,279,16,971,281,5973
"48005001100",4944,645,225,37,22,31,92,157,6153
"48005001200",2202,347,17,8,169,57,170,0,2970
"48005001300",4057,867,52,0,30,172,171,172,5521
"48007950100",3908,1240,41,0,361,31,458,74,6113
"48007950200",1064,29,0,0,53,0,95,0,1241
"48007950300",5042,983,199,0,714,98,1166,784,8986
"48007950400",2042,825,32,25,160,251,595,586,4516
"48007950500",4307,1409,30,0,464,33,1526,634,8403
"48007990000",0,0,0,0,0,0,0,0,0
"48009020100",2544,169,4,4,77,11,99,2,2910
"48009020200",2372,251,12,15,34,12,191,51,2938
"48009020300",2555,415,28,12,162,64,312,48,3596
"48011950100",1570,194,10,0,103,0,139,66,2082
"48013960100",5443,740,28,27,705,67,2759,723,10492
"48013960201",5325,464,23,7,711,554,3672,898,11654
"48013960202",6427,1125,102,12,1729,299,5653,976,16323
"48013960300",2316,753,0,0,510,137,2617,833,7166
"48013960401",1327,526,0,0,172,111,1080,560,3776
"48013960402",5563,817,94,0,707,450,2942,991,11564
"48013960500",2169,531,12,0,125,61,1649,547,5094
"48013960600",4716,450,11,0,440,31,2379,356,8383
"48015760100",1684,161,301,4,165,52,486,73,2926
"48015760200",3939,447,762,210,537,188,1772,394,8249
"48015760300",6008,138,223,182,499,42,2053,42,9187
"48015760400",3050,196,39,193,19,76,59,117,3749
"48015760501",3879,229,125,6,128,40,709,105,5221
"48015760502",3747,378,355,117,91,248,886,386,6208
"48017950100",4730,1385,107,0,677,70,3084,1078,11131
"48019000101",3708,370,0,1,83,15,492,70,4739
"48019000102",4021,487,0,0,163,0,497,241,5409
"48019000200",1994,542,0,8,19,32,238,274,3107
"48019000300",5099,874,4,0,283,174,1058,254,7746
"48019000400",1653,513,0,0,134,33,315,49,2697
"48021950100",7130,1274,145,0,706,325,1775,1129,12484
"48021950200",3942,1317,528,595,1345,15,2415,1328,11485
"48021950300",9963,955,1723,235,575,153,2014,368,15986
"48021950400",5935,522,579,143,319,20,1194,414,9126
"48021950501",4928,1148,134,83,344,6,1980,881,9504
"48021950502",4379,605,218,0,103,14,634,298,6251
"48021950600",3771,592,34,48,472,77,870,305,6169
"48021950700",2530,319,485,307,316,32,513,179,4681
"48021950801",4853,1189,79,0,607,170,3365,1295,11558
"48021950802",5258,1047,97,0,98,447,2363,1337,10647
"48023950300",2811,549,44,8,101,40,321,84,3958
"48025950100",1427,262,9,0,115,29,549,73,2464
"48025950201",822,134,16,1,117,9,397,113,1609
"48025950202",3528,749,58,2,529,300,1906,820,7892
"48025950300",3537,824,45,49,283,136,2067,696,7637
"48025950400",1556,273,74,44,98,143,1096,252,3536
"48025950500",3686,1617,12,49,928,542,3566,1961,12361
"48025950600",1596,421,73,0,310,121,1132,283,3936
"48027020100",5463,364,51,6,319,13,1092,26,7334
"48027020201",6329,389,204,0,205,15,548,88,7778
"48027020202",4877,538,65,13,146,50,713,174,6576
"48027020300",6992,408,626,266,812,135,1772,60,11071
"48027020401",1631,209,651,139,223,53,295,144,3345
"48027020402",1623,89,432,29,96,21,648,68,3006
"48027020500",2400,845,546,36,147,132,728,588,5422
"48027020600",1949,343,402,18,123,44,320,175,3374
"48027020701",540,282,61,128,33,17,235,148,1444
"48027020702",995,472,239,307,136,68,762,371,3350
"48027020800",868,625,1272,746,147,83,647,529,4917
"48027020900",991,378,443,233,62,125,605,231,3068
"48027021000",2444,716,437,159,250,153,1117,567,5843
"48027021100",3708,824,301,92,325,39,1288,474,7051
"48027021201",1643,203,399,85,485,31,459,19,3324
"48027021202",2881,417,232,159,414,52,688,289,5132
"48027021203",2987,312,347,14,209,31,671,116,4687
"48027021301",3741,190,451,128,235,14,641,25,5425
"48027021302",2625,71,257,0,216,0,127,26,3322
"48027021303",4073,516,746,347,525,369,785,141,7502
"48027021400",3172,408,18,0,158,0,449,42,4247
"48027021500",4609,1015,443,213,332,214,1925,622,9373
"48027021601",3083,1019,208,223,360,59,1454,802,7208
"48027021602",776,224,129,24,57,20,344,86,1660
"48027021700",5782,1051,130,0,833,86,898,96,8876
"48027021800",4214,951,593,228,997,243,1239,368,8833
"48027021901",2041,301,318,291,468,80,499,41,4039
"48027021903",5508,515,1583,31,2039,40,1722,321,11759
"48027021904",5917,1013,645,211,818,150,986,582,10322
"48027022000",4588,1033,1267,591,498,148,994,707,9826
"48027022101",1931,391,907,203,496,591,744,151,5414
"48027022103",2429,184,1485,172,816,71,1250,123,6530
"48027022104",1154,303,805,394,716,488,539,185,4584
"48027022105",951,242,356,104,248,55,338,51,2345
"48027022200",889,380,1318,190,298,69,404,265,3813
"48027022300",1472,438,1175,256,370,397,524,443,5075
"48027022401",2068,481,2447,558,578,368,867,522,7889
"48027022402",2191,290,1738,0,1197,314,1021,323,7074
"48027022403",2130,8,1003,161,605,92,725,149,4873
"48027022404",3496,295,3342,30,1556,77,1814,258,10868
"48027022405",1042,161,259,36,291,60,301,147,2297
"48027022501",1650,239,431,0,464,25,532,52,3393
"48027022502",3688,428,3405,113,2100,175,1577,136,11622
"48027022600",1277,611,656,217,546,155,766,347,4575
"48027022801",964,102,379,425,311,155,621,150,3107
"48027022900",1347,638,535,365,767,247,948,429,5276
"48027023000",3919,399,1817,145,1294,120,2082,64,9840
"48027023103",1811,234,1080,550,803,22,784,104,5388
"48027023104",1859,271,1090,170,520,154,668,175,4907
"48027023105",5262,420,4048,148,1047,271,1972,186,13354
"48027023106",5084,515,2429,374,1736,37,2345,299,12819
"48027023107",2864,239,2436,1063,628,65,1653,46,8994
"48027023108",4128,538,3220,1902,3669,303,4009,522,18291
"48027023201",1637,89,314,12,221,45,469,11,2798
"48027023202",2846,399,1049,258,327,122,1263,253,6517
"48027023203",1772,126,554,0,430,31,832,64,3809
"48027023204",1187,260,501,0,77,51,345,89,2510
"48027023300",5386,576,885,0,902,170,877,137,8933
"48027023402",3692,382,93,30,151,5,873,67,5293
"48027023403",4712,223,126,2,162,32,636,83,5976
"48027023404",2531,169,9,0,123,13,583,13,3441
"48027023500",544,355,304,347,287,153,530,305,2825
"48027980001",0,0,0,0,0,0,0,0,0
"48027980002",0,0,0,0,0,0,0,0,0
"48027980003",0,0,0,0,0,0,0,0,0
"48029110100",1580,524,33,54,502,70,1188,440,4391
"48029110300",1041,705,192,165,593,194,1350,835,5075
"48029110500",441,985,7,26,55,291,493,1177,3475
"48029110600",1117,1371,22,18,177,143,1233,1487,5568
"48029110700",1183,426,26,56,109,19,1156,416,3391
"48029110800",832,328,70,0,230,73,870,307,2710
"48029110900",497,150,14,14,170,4,345,102,1296
"48029111000",1039,355,56,71,195,186,1038,491,3431
"48029120100",2297,154,626,15,568,108,722,91,4581
"48029120300",5922,363,107,3,638,292,1324,290,8939
"48029120400",5306,367,75,0,183,1,935,166,7033
"48029120501",4671,512,1125,678,896,197,3782,565,12426
"48029120502",3101,838,277,429,485,276,2517,830,8753
"48029120600",4396,650,150,1,592,119,1702,109,7719
"48029120701",3490,635,85,111,374,213,2142,630,7680
"48029120702",3518,483,137,0,376,107,608,175,5404
"48029120800",6093,167,29,4,248,22,1368,37,7968
"48029120901",1261,436,86,184,102,76,327,451,2923
"48029120902",4332,259,934,103,782,316,2612,391,9729
"48029121000",5366,957,362,108,518,92,2257,681,10341
"48029121108",5234,694,135,76,641,160,1774,306,9020
"48029121110",4211,192,98,126,501,9,1612,16,6765
"48029121111",4943,483,270,262,437,73,2592,434,9494
"48029121112",3048,422,172,9,415,17,1258,266,5607
"48029121115",4656,201,153,33,227,43,1505,137,6955
"48029121116",3559,798,96,0,525,118,1107,478,6681
"48029121117",3388,225,228,44,481,11,1362,73,5812
"48029121118",4621,260,411,6,646,0,1872,137,7953
"48029121119",4162,491,144,67,582,1,1700,102,7249
"48029121120",4409,377,83,0,633,23,1722,206,7453
"48029121121",2595,92,141,0,409,0,997,3,4237
"48029121122",4280,69,224,52,633,16,1925,11,7210
"48029121203",2591,673,290,142,410,134,1923,702,6865
"48029121204",4343,893,1254,203,434,45,1943,757,9872
"48029121205",2096,936,315,348,239,198,1360,991,6483
"48029121206",6785,490,271,118,379,101,4126,467,12737
"48029121300",4255,450,823,46,393,0,1598,372,7937
"48029121402",3054,595,1004,88,951,165,2901,749,9507
"48029121403",2370,535,779,596,804,198,1767,339,7388
"48029121404",2085,520,696,519,646,107,2102,363,7038
"48029121501",5107,299,1480,9,1004,8,2601,125,10633
"48029121504",4988,538,1035,67,1017,115,2933,487,11180
"48029121505",2934,255,718,27,765,104,1612,67,6482
"48029121506",3101,419,450,238,409,153,2035,430,7235
"48029121507",2741,230,721,116,555,65,1384,105,5917
"48029121508",1956,697,837,567,406,436,1417,701,7017
"48029121601",3384,531,356,68,461,99,1662,345,6906
"48029121604",5259,331,949,207,1350,0,2882,184,11162
"48029121605",1431,249,15,18,272,34,491,274,2784
"48029121606",3142,354,708,245,388,292,1288,203,6620
"48029121701",3034,293,145,97,219,148,1144,230,5310
"48029121702",5002,746,303,44,906,81,2008,160,9250
"48029121802",5758,747,496,233,1140,170,3226,746,12516
"48029121803",3455,194,322,110,653,15,2265,148,7162
"48029121804",4464,831,492,452,808,191,2767,826,10831
"48029121808",2412,288,239,7,419,5,1373,118,4861
"48029121809",3944,396,258,1,317,75,1848,207,7046
"48029121810",3813,129,392,62,398,84,1993,104,6975
"48029121811",4109,102,266,0,359,15,1876,107,6834
"48029121812",5125,144,243,1,651,2,2451,28,8645
"48029121813",1162,143,140,0,67,17,450,96,2075
"48029121903",4477,89,81,0,480,0,1003,30,6160
"48029121904",2562,61,65,324,570,0,817,0,4399
"48029121905",4125,77,242,0,1188,31,1562,12,7237
"48029121906",4386,354,127,0,388,0,1485,37,6777
"48029121907",8459,217,673,31,1306,0,4106,159,14951
"48029121908",1870,124,111,0,309,41,588,74,3117
"48029121909",3785,225,647,9,689,181,2031,231,7798
"48029121910",3124,100,580,38,560,0,1167,138,5707
"48029130200",524,249,177,188,457,563,917,783,3858
"48029130300",1182,974,223,64,650,263,1813,1076,6245
"48029130401",1536,747,455,55,617,373,2016,1050,6849
"48029130402",1344,1008,403,787,497,269,1820,1136,7264
"48029130500",856,958,559,585,934,440,1685,1256,7273
"48029130600",727,924,1025,726,560,573,1213,1334,7082
"48029130700",776,237,422,23,307,222,1022,386,3395
"48029130800",791,927,2214,940,487,337,1154,1188,8038
"48029130900",1585,509,973,638,490,208,1563,724,6690
"48029131000",1101,704,1849,553,481,140,1293,794,6915
"48029131100",384,426,914,145,502,313,890,738,4312
"48029131200",1086,255,853,406,135,37,935,127,3834
"48029131300",2675,2095,1042,248,460,1,1731,2112,10364
"48029131401",3623,942,947,33,1271,609,3681,1119,12225
"48029131402",1423,260,576,34,321,136,1289,335,4374
"48029131503",1858,131,279,144,915,420,1317,417,5481
"48029131504",1671,266,624,74,732,24,1364,216,4971
"48029131505",1657,382,892,105,657,100,1591,369,5753
"48029131506",1308,305,626,157,598,197,1328,443,4962
"48029131507",2135,709,788,594,1356,1332,2524,1664,11102
"48029131601",1434,583,304,4,359,52,658,305,3699
"48029131606",2350,180,944,114,1290,179,1820,179,7056
"48029131608",2584,338,957,371,1102,86,2002,385,7825
"48029131609",3734,628,2442,158,1568,448,3401,727,13106
"48029131610",2349,96,1466,431,1146,67,1892,42,7489
"48029131611",559,91,434,11,210,19,326,89,1739
"48029131612",517,196,649,44,457,11,659,144,2677
"48029131613",1938,257,1153,72,773,579,1274,725,6771
"48029131614",1939,137,1194,114,727,0,1184,145,5440
"48029131615",3732,470,1563,42,1202,341,2714,523,10587
"48029131700",776,20,134,2,103,11,96,8,1150
"48029131801",2170,93,2,0,238,2,462,47,3014
"48029131802",3866,173,330,46,1048,13,1957,161,7594
"48029140100",698,260,11,21,614,95,1167,316,3182
"48029140200",1617,456,71,0,343,25,1692,369,4573
"48029140300",1342,805,101,0,727,481,1981,1229,6666
"48029140400",2439,559,0,0,368,256,2582,705,6909
"48029140500",2432,470,117,2,785,192,2842,636,7476
"48029140600",1278,667,112,33,440,79,1629,716,4954
"48029140700",2444,878,60,54,966,281,2882,860,8425
"48029140800",3044,1347,57,8,862,252,3482,1539,10591
"48029140900",1048,442,6,0,319,108,1199,525,3647
"48029141000",1453,1211,60,0,467,402,1754,1500,6847
"48029141101",2120,812,217,214,453,127,2104,856,6903
"48029141102",1474,859,139,119,619,254,1494,876,5834
"48029141200",3441,1670,293,195,646,288,3333,1827,11693
"48029141300",3662,436,528,97,832,95,3367,446,9463
"48029141402",2022,422,202,0,1121,214,2715,576,7272
"48029141403",2200,603,119,8,1098,27,2467,570,7092
"48029141404",3128,727,102,263,859,128,3112,748,9067
"48029141600",3427,173,24,0,1047,288,3991,356,9306
"48029141700",3440,544,19,6,794,146,2827,378,8154
"48029141800",2556,587,45,1,568,875,1827,1237,7696
"48029141900",4697,322,150,0,1011,18,2125,177,8500
"48029150100",2560,1297,0,0,1132,435,3388,1693,10505
"48029150300",1973,1218,19,27,528,974,2268,2011,9018
"48029150400",1831,1126,0,0,496,142,2246,1061,6902
"48029150501",2587,1595,14,0,603,251,3164,1823,10037
"48029150502",2294,825,10,2,891,198,3137,1020,8377
"48029150600",2483,883,0,0,883,434,3154,1240,9077
"48029150700",3145,1735,0,0,920,293,3620,1869,11582
"48029150800",907,1488,11,243,242,492,986,1884,6253
"48029150900",3151,849,8,18,1082,577,3887,1271,10843
"48029151000",1270,906,0,0,518,582,1705,1357,6338
"48029151100",5191,524,0,17,753,542,5711,1026,13764
"48029151200",5942,2018,97,0,1607,386,7358,2226,19634
"48029151301",3858,1049,33,0,732,214,4320,1196,11402
"48029151302",1985,384,28,0,861,128,2609,448,6443
"48029151400",2418,1222,0,43,654,364,2902,1435,9038
"48029151500",1697,608,0,4,289,68,1745,636,5047
"48029151600",3949,1277,48,11,1340,705,4255,1876,13461
"48029151700",4799,651,16,27,1140,448,5507,1016,13604
"48029151900",3499,816,39,1,1256,623,4510,1388,12132
"48029152000",986,347,119,21,383,278,1232,495,3861
"48029152100",3111,783,23,11,852,92,2843,671,8386
"48029152201",4808,1838,147,0,1301,119,4832,1634,14679
"48029152202",3297,467,231,53,246,287,2823,494,7898
"48029160100",3403,2113,11,0,673,391,4043,2486,13120
"48029160200",1473,201,0,0,355,265,1736,453,4483
"48029160300",3780,593,0,0,609,434,4135,992,10543
"48029160400",3044,510,43,63,410,315,3407,819,8611
"48029160501",1343,2045,7,210,76,367,1342,2408,7798
"48029160502",2694,707,0,1,558,132,3222,837,8151
"48029160600",2618,1959,0,0,365,170,2938,2109,10159
"48029160701",2151,610,0,3,333,188,2424,737,6446
"48029160702",2410,1315,13,48,706,307,2876,1566,9241
"48029160901",1696,706,0,5,284,194,1840,849,5574
"48029160902",3091,1305,0,0,487,219,3518,1509,10129
"48029161000",1741,1357,71,0,336,262,2037,1507,7311
"48029161100",6690,658,11,3,1856,412,8349,1043,19022
"48029161200",1717,779,34,0,177,172,1577,886,5342
"48029161302",3514,1793,69,0,538,193,3724,1965,11796
"48029161303",2386,1949,0,23,634,264,2819,2213,10288
"48029161304",2464,1450,33,0,87,406,2468,1736,8644
"48029161400",907,168,78,15,203,4,420,0,1795
"48029161501",4886,1372,169,60,1116,304,4770,1577,14254
"48029161503",1837,1146,176,0,731,82,2102,1176,7250
"48029161504",3208,678,149,44,332,274,3192,906,8783
"48029161600",2751,1148,85,97,589,146,2645,1187,8648
"48029161801",2860,559,165,0,142,12,2249,404,6391
"48029161802",4789,1946,282,68,567,20,4397,1903,13972
"48029161901",988,32,0,0,128,0,792,0,1940
"48029161902",5790,779,124,0,639,45,5215,464,13056
"48029162001",1230,452,0,2,430,150,1150,554,3968
"48029162003",3549,898,47,12,492,216,2899,970,9083
"48029162004",1775,1272,12,16,525,113,1842,1257,6812
"48029170101",1932,1250,39,26,257,370,2140,1620,7634
"48029170102",2377,805,26,2,536,407,2923,1187,8263
"48029170200",2423,1612,0,9,864,491,3223,2047,10669
"48029170300",2365,2288,0,1,840,626,3198,2841,12159
"48029170401",1479,1985,109,86,421,198,1829,2123,8230
"48029170402",2394,1051,22,0,730,161,3030,1210,8598
"48029170500",2511,465,16,20,999,441,3198,823,8473
"48029170600",2818,1364,40,24,288,63,2771,1351,8719
"48029170700",2813,1532,1,2,292,206,2903,1676,9425
"48029170800",679,478,0,5,36,46,686,529,2459
"48029170900",1901,1046,0,0,210,312,2024,1258,6751
"48029171000",3295,1892,9,0,858,242,3813,2117,12226
"48029171100",2116,1258,9,0,418,64,2283,1244,7392
"48029171200",2318,1138,53,0,526,195,2703,1328,8261
"48029171301",1615,952,0,0,132,118,1657,990,5464
"48029171302",2262,719,6,11,155,114,2268,733,6268
"48029171401",2562,1955,59,57,277,162,2702,2103,9877
"48029171402",3138,1312,0,4,621,265,3562,1512,10414
"48029171501",1361,609,146,51,182,143,1432,716,4640
"48029171502",3025,1450,197,47,348,26,3085,1448,9626
"48029171601",3062,907,71,154,197,161,2971,980,8503
"48029171602",2100,842,306,64,128,84,2197,863,6584
"48029171700",4397,1628,431,123,533,298,3763,1791,12964
"48029171801",3635,1213,61,72,560,194,3511,1286,10532
"48029171802",3334,2124,280,395,386,97,3216,2104,11936
"48029171902",6708,1416,1099,772,1224,399,6711,1587,19916
"48029171903",4788,1058,302,206,544,42,4488,720,12148
"48029171912",4526,101,648,0,839,11,3478,75,9678
"48029171913",3244,1216,393,58,253,271,2927,1454,9816
"48029171914",3933,690,288,154,552,31,3211,576,9435
"48029171915",1754,128,164,11,172,0,1144,102,3475
"48029171916",4915,533,785,88,1183,446,3917,743,12610
"48029171917",5615,506,1754,183,1285,34,4041,352,13770
"48029171918",4437,336,461,0,496,32,3006,296,9064
"48029171919",2285,587,538,40,287,0,1975,578,6290
"48029171920",6297,1412,610,0,787,28,5417,1025,15576
"48029171921",3763,596,248,77,756,122,3425,571,9558
"48029171922",2594,177,72,0,388,97,2519,274,6121
"48029171923",6835,272,760,20,1144,1,5102,198,14332
"48029171924",3554,316,653,59,593,9,2228,144,7556
"48029171925",5975,335,837,2,1934,102,4673,333,14191
"48029172002",6896,763,621,467,951,112,4492,800,15102
"48029172003",4058,167,753,0,1223,61,2353,199,8814
"48029172004",2886,204,175,0,553,22,1198,174,5212
"48029172005",3511,160,369,20,1013,0,1767,119,6959
"48029172006",5641,164,724,38,901,40,3048,46,10602
"48029172007",7497,274,1001,0,981,54,4028,273,14108
"48029180101",3640,593,0,71,601,26,3591,523,9045
"48029180102",1421,367,0,11,148,30,1053,342,3372
"48029180201",2106,782,107,73,998,538,2490,1167,8261
"48029180202",3242,863,151,97,514,129,3169,546,8711
"48029180300",2304,1315,0,27,339,33,2317,1329,7664
"48029180400",2523,1343,27,142,248,167,2468,1410,8328
"48029180501",2715,1242,232,198,250,68,2744,1147,8596
"48029180503",3372,819,84,9,223,29,3342,785,8663
"48029180504",2490,1425,11,335,239,123,2582,1505,8710
"48029180602",2127,238,0,7,28,392,1635,514,4941
"48029180603",946,629,37,0,93,21,627,633,2986
"48029180604",3611,1039,113,18,1043,304,3498,990,10616
"48029180701",2551,455,309,88,236,131,1462,227,5459
"48029180702",4654,988,705,331,180,78,3376,592,10904
"48029180800",919,481,130,36,564,162,1195,394,3881
"48029180901",3139,973,42,90,1409,34,3518,805,10010
"48029180902",4062,1101,40,0,1831,440,4876,1419,13769
"48029181001",2528,738,175,92,277,62,1904,753,6529
"48029181003",3250,1031,560,298,421,269,2160,576,8565
"48029181004",3620,635,261,148,561,58,2226,453,7962
"48029181005",1845,967,246,245,167,264,1270,816,5820
"48029181100",4555,699,41,123,483,262,2701,777,9641
"48029181200",3655,468,114,0,206,49,1456,338,6286
"48029181301",3135,243,274,63,879,59,2149,240,7042
"48029181302",4007,804,296,14,605,296,2388,828,9238
"48029181303",1045,820,265,62,482,854,784,503,4815
"48029181402",982,542,90,212,44,161,609,279,2919
"48029181403",4147,597,703,188,957,96,2961,361,10010
"48029181404",1791,498,309,116,2198,110,868,113,6003
"48029181503",4598,988,538,96,341,237,2401,516,9715
"48029181504",4154,607,450,144,535,55,2668,301,8914
"48029181505",4088,233,24,23,325,15,2562,127,7397
"48029181506",3460,275,171,26,285,148,2437,262,7064
"48029181601",2257,419,52,48,340,39,2045,332,5532
"48029181602",4315,1225,148,167,251,189,3996,1134,11425
"48029181703",5099,830,402,15,640,86,2575,580,10227
"48029181704",4245,671,100,20,693,44,3311,556,9640
"48029181705",3632,276,372,88,835,100,2858,153,8314
"48029181711",5406,646,221,2,1630,20,3812,359,12096
"48029181712",2900,225,195,0,381,76,1941,201,5919
"48029181713",4691,861,546,3,1390,196,4185,598,12470
"48029181715",4713,544,309,38,678,127,3800,388,10597
"48029181716",4307,400,368,0,1945,200,4818,416,12454
"48029181718",4313,198,56,14,548,159,2048,175,7511
"48029181720",3743,41,214,0,718,32,2174,43,6965
"48029181721",2966,299,164,27,402,60,1945,263,6126
"48029181722",3755,262,185,21,479,66,2351,277,7396
"48029181723",2979,321,767,46,830,34,2650,217,7844
"48029181724",4287,66,271,0,818,47,2284,79,7852
"48029181725",3113,582,841,241,541,172,2960,457,8907
"48029181726",7106,171,554,0,1450,63,4828,184,14356
"48029181727",2428,466,269,69,301,96,2204,469,6302
"48029181728",8274,112,572,83,1916,287,7013,358,18615
"48029181729",3525,310,320,9,742,0,2185,319,7410
"48029181730",2956,95,356,0,658,32,2539,111,6747
"48029181731",5537,239,359,25,1007,142,3910,305,11524
"48029181808",676,447,94,68,101,9,178,330,1903
"48029181809",3611,1015,371,72,952,278,2907,984,10190
"48029181811",2893,241,36,0,730,43,1664,158,5765
"48029181813",3576,1054,435,0,1256,229,2531,788,9869
"48029181814",2564,619,158,43,415,0,1668,365,5832
"48029181815",2554,339,98,0,776,21,1348,61,5197
"48029181816",3827,304,131,24,343,0,2183,253,7065
"48029181817",2614,318,242,0,268,0,1914,232,5588
"48029181818",3652,767,337,26,122,0,1985,663,7552
"48029181819",3624,568,138,102,1709,25,3038,306,9510
"48029181820",1359,944,200,373,208,912,669,782,5447
"48029181821",2498,122,61,78,635,50,1529,45,5018
"48029181822",3930,325,276,1,427,54,2267,266,7546
"48029181823",1476,402,111,95,500,368,942,483,4377
"48029181824",3844,432,148,154,577,276,2196,569,8196
"48029181825",2377,290,132,0,478,46,1215,209,4747
"48029181826",4614,485,229,2,1338,3,2834,305,9810
"48029181901",1551,1012,70,174,576,310,682,674,5049
"48029181902",5045,388,86,19,701,65,1463,174,7941
"48029182001",3702,139,109,125,1072,76,1709,93,7025
"48029182002",7819,142,369,0,966,2,3370,2,12670
"48029182003",2645,94,119,0,878,9,1051,46,4842
"48029182101",6554,153,25,38,560,0,1672,50,9052
"48029182102",6455,228,239,43,543,9,2139,84,9740
"48029182103",2235,46,18,0,105,0,771,21,3196
"48029182105",2162,31,30,0,233,7,939,31,3433
"48029182106",4866,208,243,0,1021,18,2285,153,8794
"48029190100",1636,662,57,23,625,210,1945,730,5888
"48029190200",3126,844,2,0,267,63,1370,694,6366
"48029190400",1736,140,9,0,138,79,577,30,2709
"48029190501",1529,220,16,0,772,108,1930,290,4865
"48029190503",2514,720,23,37,245,42,2163,440,6184
"48029190504",1435,433,12,16,626,92,1765,436,4815
"48029190601",2296,465,0,2,702,429,2866,856,7616
"48029190603",1569,663,49,0,541,0,1789,573,5184
"48029190604",1740,702,88,0,1248,607,2729,1289,8403
"48029190700",1804,471,34,48,330,63,1352,409,4511
"48029190800",1881,19,28,61,34,0,319,0,2342
"48029190901",3823,1240,313,17,388,146,2786,953,9666
"48029190902",3171,330,166,37,119,133,2347,271,6574
"48029191003",3734,1234,132,127,2127,400,4487,1343,13584
"48029191004",1870,1009,12,76,690,239,2038,1115,7049
"48029191005",1524,405,0,0,320,92,1598,456,4395
"48029191006",3128,945,198,0,1512,500,4165,1359,11807
"48029191101",1381,88,0,0,85,6,443,67,2070
"48029191102",2299,158,102,0,108,0,1014,46,3727
"48029191201",2442,476,0,7,43,24,1160,280,4432
"48029191202",4138,538,21,89,454,0,2530,344,8114
"48029191303",1321,124,14,0,36,7,623,20,2145
"48029191304",1863,267,158,21,431,114,1564,328,4746
"48029191405",6192,489,247,1,701,81,2663,247,10621
"48029191406",5968,331,90,0,950,34,1490,188,9051
"48029191408",1829,378,141,13,572,207,1533,401,5074
"48029191409",3704,868,234,50,1433,405,3644,1182,11520
"48029191410",4133,533,376,65,452,356,2358,548,8821
"48029191411",3613,248,153,0,375,0,1328,49,5766
"48029191412",2012,5,5,0,145,0,425,5,2597
"48029191413",4640,624,170,0,566,28,1717,560,8305
"48029191503",4103,224,126,36,566,49,1581,105,6790
"48029191504",2070,111,0,0,381,27,720,0,3309
"48029191505",2094,63,0,0,47,0,534,58,2796
"48029191506",3837,795,35,3,609,45,2205,557,8086
"48029191701",1287,21,0,0,193,0,288,5,1794
"48029191702",6568,263,61,0,343,18,1359,118,8730
"48029191804",5769,60,137,0,383,0,1587,0,7936
"48029191806",6708,191,421,0,1029,38,1780,155,10322
"48029191807",3324,379,125,31,237,90,1228,292,5706
"48029191808",2898,23,140,0,609,10,1060,10,4750
"48029191809",5070,741,234,47,389,0,1803,675,8959
"48029191810",3962,152,242,0,939,30,1344,99,6768
"48029191811",3177,71,255,0,795,41,839,54,5232
"48029191812",3850,191,117,0,617,0,1015,86,5876
"48029191813",5189,407,329,0,538,0,1866,317,8646
"48029191814",3397,287,41,0,588,8,1204,264,5789
"48029191815",3723,150,211,58,1186,31,1625,151,7135
"48029191816",2394,0,38,0,271,148,1054,0,3905
"48029191817",8979,406,442,0,1450,11,3205,284,14777
"48029191900",2202,1384,588,201,703,429,2502,1680,9689
"48029192000",2141,1137,146,189,287,149,1196,714,5959
"48029192100",1913,325,73,0,284,70,1148,308,4121
"48029192200",768,138,32,0,215,206,785,218,2362
"48029192300",4016,51,66,1,74,15,1480,33,5736
"48029980001",0,0,0,0,0,0,0,0,0
"48029980002",20,0,0,0,0,0,20,0,40
"48029980003",686,13,97,6,116,0,211,19,1148
"48029980004",0,0,0,0,0,0,0,0,0
"48029980005",13,0,0,0,10,0,5,0,28
"48029980100",111,0,0,0,40,0,46,0,197
"48031950100",4110,462,61,0,154,0,721,138,5646
"48031950200",4789,427,3,67,284,95,1020,121,6806
"48033950100",648,7,0,0,18,0,64,0,737
"48035950100",3084,714,0,0,134,62,542,181,4717
"48035950200",1162,244,64,18,40,47,264,135,1974
"48035950300",1363,381,0,0,47,0,44,101,1936
"48035950400",3256,145,1,0,52,0,304,30,3788
"48035950500",1791,413,91,2,219,79,593,271,3459
"48035950600",1552,119,0,0,43,0,170,6,1890
"48035950700",2149,209,18,63,39,32,298,23,2831
"48037010100",2240,402,992,1213,289,0,310,0,5446
"48037010400",1070,386,1374,1087,57,214,82,77,4347
"48037010500",202,208,909,646,71,0,126,42,2204
"48037010600",223,17,1191,704,20,10,89,0,2254
"48037010700",2184,256,909,771,332,115,533,118,5218
"48037010800",1469,340,1688,887,507,96,519,282,5788
"48037010901",6034,554,433,34,252,0,61,3,7371
"48037010902",4431,566,1036,356,460,56,532,179,7616
"48037011000",4615,882,1267,761,356,8,280,108,8277
"48037011100",3112,566,915,153,159,0,181,5,5091
"48037011200",5423,341,234,39,191,18,232,16,6494
"48037011300",3849,635,418,286,349,79,304,246,6166
"48037011401",6366,826,451,226,314,4,223,0,8410
"48037011402",1771,386,43,12,84,0,13,6,2315
"48037011501",3839,475,334,117,240,16,92,8,5121
"48037011502",1354,862,429,222,93,0,5,65,3030
"48037011600",3423,581,722,215,167,34,176,98,5416
"48037011700",1846,357,0,0,120,5,65,41,2434
"48039660100",4221,67,65,23,251,23,776,7,5433
"48039660200",4609,280,193,20,387,0,1000,12,6501
"48039660300",7628,220,1412,71,706,158,2375,134,12704
"48039660400",7282,519,850,70,1113,171,2209,417,12631
"48039660500",6416,1057,681,11,1138,34,2614,576,12527
"48039660601",6353,73,2322,205,2980,83,1753,0,13769
"48039660602",12869,1279,8076,440,8296,238,6305,898,38401
"48039660701",8122,175,3651,405,3227,0,1970,0,17550
"48039660702",7050,1044,2205,450,2935,148,1837,725,16394
"48039660801",6123,43,920,0,1295,430,2435,386,11632
"48039660802",4990,19,1011,410,1203,80,1828,310,9851
"48039660900",4410,1234,132,20,767,158,2451,1000,10172
"48039661000",5465,946,25,0,154,12,1969,727,9298
"48039661100",2321,488,125,44,154,0,932,312,4376
"48039661200",3080,536,33,0,319,19,1089,190,5266
"48039661300",1836,553,60,7,72,23,889,262,3702
"48039661400",5129,730,115,83,196,52,1775,455,8535
"48039661501",4290,424,80,2,93,38,1541,234,6702
"48039661502",3606,482,177,0,184,75,777,214,5515
"48039661601",4504,1044,120,194,485,13,1955,304,8619
"48039661602",2519,422,57,0,100,62,881,331,4372
"48039661700",2275,226,51,0,32,3,794,11,3392
"48039661800",4080,407,259,22,1487,278,2092,228,8853
"48039661900",4757,657,1158,290,603,81,2874,567,10987
"48039662000",4600,681,251,386,124,0,746,382,7170
"48039662100",3789,693,869,204,185,77,1639,366,7822
"48039662200",4095,421,352,31,332,12,1206,393,6842
"48039662300",3712,259,278,246,139,160,818,223,5835
"48039662400",4664,422,166,13,386,9,1057,141,6858
"48039662500",2010,110,287,0,125,71,599,89,3291
"48039662600",2596,246,444,49,52,99,394,101,3981
"48039662700",1856,347,199,24,197,0,319,75,3017
"48039662800",4074,528,552,392,219,10,442,226,6443
"48039662900",3826,447,371,130,351,128,1018,239,6510
"48039663000",2216,471,365,121,21,0,371,213,3778
"48039663100",4201,263,74,12,266,48,806,55,5725
"48039663200",3848,133,125,12,404,17,974,52,5565
"48039663300",1736,119,22,0,231,13,730,7,2858
"48039663400",4562,386,657,255,717,495,1107,588,8767
"48039663500",4468,405,459,135,720,22,1608,22,7839
"48039663600",4759,96,157,0,329,0,783,35,6159
"48039663700",2540,320,294,181,128,15,1043,214,4735
"48039663800",4234,545,632,91,155,189,2034,500,8380
"48039663900",1328,255,108,79,125,138,911,328,3272
"48039664000",2701,839,257,140,145,15,1410,657,6164
"48039664100",3644,752,465,29,429,394,1806,687,8206
"48039664200",1448,351,39,0,71,13,244,112,2278
"48039664300",2832,1485,456,519,234,264,2283,1311,9384
"48039664400",4161,624,529,62,533,104,2953,430,9396
"48039664501",4003,630,242,202,160,36,1012,240,6525
"48039990000",0,0,0,0,0,0,0,0,0
"48041000101",4898,838,733,234,684,128,1461,54,9030
"48041000102",5188,307,113,4,546,17,342,27,6544
"48041000103",1523,14,87,0,63,20,86,20,1813
"48041000201",3130,1067,291,1033,518,420,943,603,8005
"48041000202",3938,812,472,231,612,340,1933,582,8920
"48041000300",4223,657,912,74,1427,314,3831,736,12174
"48041000400",1752,592,1115,565,315,73,809,365,5586
"48041000500",1503,1055,949,998,555,467,1808,1371,8706
"48041000603",1565,724,534,413,898,522,2148,987,7791
"48041000604",1753,1165,500,490,971,868,2259,1995,10001
"48041000700",1610,265,238,81,574,75,1397,196,4436
"48041000800",3282,698,231,90,303,30,1123,445,6202
"48041000900",1047,390,213,146,494,159,1021,429,3899
"48041001000",2505,2647,447,925,984,918,1364,1133,10923
"48041001100",2876,554,271,1,561,218,986,261,5728
"48041001301",1453,1005,121,73,135,52,223,259,3321
"48041001302",2141,1390,174,9,281,263,364,311,4933
"48041001303",1675,1808,553,112,535,524,579,258,6044
"48041001400",373,725,11,127,433,666,73,191,2599
"48041001601",1584,1782,138,402,514,420,344,102,5286
"48041001604",2108,1847,172,22,640,546,298,320,5953
"48041001605",866,1071,621,309,356,273,250,402,4148
"48041001606",1439,1012,86,43,140,321,456,60,3557
"48041001701",1618,2136,135,47,690,430,440,495,5991
"48041001702",759,1136,209,985,84,122,180,485,3960
"48041001801",3451,216,492,30,39,51,575,23,4877
"48041001803",3319,1549,289,24,891,403,571,358,7404
"48041001804",599,216,132,0,125,15,164,25,1276
"48041001900",4042,398,446,141,283,270,467,260,6307
"48041002001",4091,213,85,10,275,0,432,55,5161
"48041002002",4937,543,528,0,590,73,451,96,7218
"48041002006",968,127,0,8,476,0,210,65,1854
"48041002007",4948,1006,381,0,568,69,801,56,7829
"48041002008",5642,181,260,3,658,5,579,29,7357
"48041002009",3625,56,168,1,501,0,295,5,4651
"48041002010",2399,91,34,0,263,0,445,22,3254
"48041002011",2893,155,40,29,44,0,412,28,3601
"48041002012",1356,4651,0,197,141,460,98,972,7875
"48041002013",3855,1447,41,72,128,26,940,167,6676
"48041002014",755,653,30,122,30,38,69,151,1848
"48041002015",20,0,0,0,0,0,0,0,20
"48041980000",0,0,0,0,0,0,0,0,0
"48043950300",3683,235,58,78,99,63,1337,170,5723
"48043950400",1475,385,0,0,103,8,1282,337,3590
"48043950500",2387,398,0,0,171,15,653,192,3816
"48045950200",1154,286,30,37,86,3,258,222,2076
"48047950100",1065,456,0,0,224,15,1199,444,3403
"48047950200",2737,1849,0,5,417,173,2749,1924,9854
"48049950100",1739,195,0,0,57,30,98,30,2149
"48049950200",3035,749,36,39,46,46,428,113,4492
"48049950300",2779,534,1,10,32,9,225,82,3672
"48049950500",2368,280,92,23,27,0,430,38,3258
"48049950600",1509,882,7,32,111,44,586,357,3528
"48049950700",311,301,59,102,55,58,109,272,1267
"48049950800",1837,451,147,0,196,15,947,243,3836
"48049950900",3044,740,269,147,37,54,731,183,5205
"48049951000",1463,532,38,2,274,41,358,68,2776
"48049951100",2881,861,64,25,101,56,337,251,4576
"48049951200",3705,409,16,11,87,0,584,24,4836
"48049951300",2459,190,0,0,81,0,741,22,3493
"48051970100",823,143,88,12,128,0,62,16,1272
"48051970200",3247,299,106,19,341,141,763,49,4965
"48051970300",2733,408,319,372,223,0,924,26,5005
"48051970400",2218,335,499,75,65,0,693,31,3916
"48051970500",2858,731,383,141,155,30,471,266,5035
"48053960100",5139,667,52,73,303,26,663,220,7143
"48053960200",2704,343,17,0,8,0,269,245,3586
"48053960300",4640,1116,82,123,361,14,640,679,7655
"48053960400",4223,915,0,4,96,22,553,673,6486
"48053960500",3910,1686,0,0,185,226,1244,1023,8274
"48053960600",3592,295,19,0,112,0,306,21,4345
"48053960700",5278,830,245,78,163,41,1430,572,8637
"48053960800",4713,752,196,11,117,16,496,123,6424
"48055960101",3729,873,82,9,602,81,2354,615,8345
"48055960102",2545,298,23,23,443,274,930,361,4897
"48055960200",1762,136,325,97,967,124,1939,164,5514
"48055960300",2945,443,207,110,537,161,1490,437,6330
"48055960400",2077,479,66,46,869,136,1964,518,6155
"48055960500",3760,1406,198,424,1897,398,3355,1085,12523
"48055960600",1682,118,98,59,194,0,271,0,2422
"48055960700",3642,827,343,97,859,0,1976,606,8350
"48057000100",3825,1173,101,0,639,83,1900,837,8558
"48057000200",2534,697,343,60,384,28,1996,655,6697
"48057000300",1121,54,22,0,238,3,422,0,1860
"48057000400",4544,1375,0,0,289,63,1961,1332,9564
"48057000500",2802,618,0,13,242,36,642,337,4690
"48057990000",0,0,0,0,0,0,0,0,0
"48059030101",3635,741,20,42,135,42,310,14,4939
"48059030102",3241,681,77,12,135,62,188,78,4474
"48059030200",3497,844,38,0,153,43,433,140,5148
"48061010100",5237,2455,12,0,247,63,4023,2292,14329
"48061010201",1370,748,0,0,177,0,1339,631,4265
"48061010203",5116,1783,254,22,152,173,4002,1833,13335
"48061010301",3138,2343,0,0,72,144,2688,2467,10852
"48061010302",7223,1608,0,0,170,0,5225,1575,15801
"48061010401",3924,1253,12,0,181,153,3705,1347,10575
"48061010402",4391,1549,97,0,214,20,3046,1475,10792
"48061010500",1127,1062,29,0,13,53,1058,1114,4456
"48061010601",5237,2473,14,0,267,161,4299,2338,14789
"48061010602",1327,261,7,0,86,0,934,174,2789
"48061010700",1959,915,0,0,51,74,1529,876,5404
"48061010800",4071,2580,90,10,110,67,2794,2403,12125
"48061010900",708,704,4,0,60,11,706,688,2881
"48061011000",1384,1249,0,0,254,119,1622,1360,5988
"48061011100",1361,1110,0,3,35,65,1379,1131,5084
"48061011200",931,927,26,0,92,0,930,927,3833
"48061011301",1084,461,38,0,56,0,763,383,2785
"48061011302",3488,127,22,0,273,52,2184,77,6223
"48061011400",4611,1880,0,0,725,59,4732,1925,13932
"48061011500",2972,2284,0,19,175,496,2968,2688,11602
"48061011600",3686,2222,0,0,130,305,3748,2467,12558
"48061011700",3517,1728,0,1,472,487,3888,2101,12194
"48061011801",3154,1528,186,89,470,97,2967,1569,10060
"48061011802",1640,2092,75,60,357,137,1600,2211,8172
"48061011901",3039,2170,14,0,388,405,2615,2464,11095
"48061011902",2643,1395,32,0,260,151,2170,1455,8106
"48061011903",1638,932,0,0,122,66,1686,986,5430
"48061012001",4416,1659,78,3,158,17,2914,1459,10704
"48061012002",4846,932,3,1,172,125,3560,982,10621
"48061012101",2871,1046,0,5,479,70,2302,886,7659
"48061012102",2927,2642,11,0,541,251,3267,2890,12529
"48061012200",6434,3675,18,0,1330,540,6760,3766,22523
"48061012301",2959,896,0,0,198,0,1363,537,5953
"48061012304",2601,1051,34,0,215,331,1983,1209,7424
"48061012305",2383,582,125,0,76,118,433,346,4063
"48061012401",4051,1934,61,0,671,606,4450,2441,14214
"48061012402",3436,1370,0,12,207,163,3311,1312,9811
"48061012504",11612,4356,66,0,590,194,11612,4434,32864
"48061012505",4899,3863,1,0,626,344,5205,4177,19115
"48061012506",2976,668,0,0,194,51,2228,640,6757
"48061012507",3377,2506,14,8,387,125,3594,2639,12650
"48061012508",2284,1194,0,0,69,0,1897,1173,6617
"48061012607",1497,1123,0,0,135,19,1619,1142,5535
"48061012608",2993,1006,14,0,107,40,2665,906,7731
"48061012609",3928,4218,9,0,187,168,3903,4386,16799
"48061012612",5287,427,0,0,286,36,5045,390,11471
"48061012613",3313,810,0,0,565,41,3270,800,8799
"48061012700",2996,2126,0,0,268,138,3116,2012,10656
"48061012800",2714,1849,83,18,161,123,2811,1990,9749
"48061012900",2966,787,10,20,310,183,2741,927,7944
"48061013002",2954,984,8,0,249,88,2815,1016,8114
"48061013003",1049,651,0,0,45,45,1027,696,3513
"48061013004",2037,805,0,0,231,58,1970,799,5900
"48061013102",2139,1819,0,0,286,47,2088,1843,8222
"48061013104",2776,899,0,1,226,28,2709,855,7494
"48061013106",1844,2280,0,0,264,132,2041,2402,8963
"48061013203",865,1247,5,0,48,56,814,1303,4338
"48061013204",1358,792,0,36,204,26,1493,826,4735
"48061013205",2194,1380,28,0,247,69,2409,1449,7776
"48061013206",1119,2081,6,0,151,54,1202,2111,6724
"48061013207",2206,1929,0,0,350,128,2294,2049,8956
"48061013303",2147,1410,0,22,216,0,2219,1323,7337
"48061013305",2590,1674,0,0,105,130,2632,1757,8888
"48061013306",1173,1297,0,0,44,107,1217,1404,5242
"48061013307",786,1043,0,0,3,7,758,1050,3647
"48061013308",1860,1159,0,6,122,28,1920,1193,6288
"48061013309",1465,1385,0,0,160,61,1591,1446,6108
"48061013401",760,1040,6,1,177,197,816,1221,4218
"48061013402",936,759,0,0,58,76,988,835,3652
"48061013500",1627,461,0,0,116,38,1500,484,4226
"48061013600",1505,1308,0,0,78,50,1450,1331,5722
"48061013700",1308,2492,0,0,247,133,1505,2625,8310
"48061013801",1008,1470,12,0,93,52,1065,1460,5160
"48061013802",1323,2330,0,0,272,43,1492,2373,7833
"48061013901",1567,1233,22,0,34,27,1606,1260,5749
"48061013902",1613,1737,31,0,141,149,1785,1868,7324
"48061013903",2435,1073,0,0,121,355,2518,1428,7930
"48061014001",851,892,0,7,43,131,664,1018,3606
"48061014002",808,1536,29,0,41,44,814,1580,4852
"48061014100",7230,4043,0,0,469,260,7448,4198,23648
"48061014200",2919,1653,10,0,223,453,2798,1977,10033
"48061014300",2492,1816,16,0,225,166,2478,1961,9154
"48061014400",12086,3008,93,0,1197,0,11815,2842,31041
"48061014500",6269,2029,88,0,537,49,5872,1973,16817
"48061980001",0,0,0,0,0,0,0,0,0
"48061980100",0,0,0,0,0,0,0,0,0
"48061990000",0,0,0,0,0,0,0,0,0
"48063950101",2072,400,289,103,190,23,324,160,3561
"48063950102",3456,377,250,197,81,102,283,136,4882
"48063950200",2099,784,990,331,251,339,891,974,6659
"48065950100",2041,188,0,2,98,0,124,5,2458
"48065950200",3353,201,46,0,87,7,424,6,4124
"48067950100",4791,649,708,48,141,104,106,133,6680
"48067950200",1803,321,496,98,4,24,30,0,2776
"48067950300",1366,276,152,239,15,38,12,9,2107
"48067950400",2935,552,801,684,68,23,131,9,5203
"48067950500",1813,531,135,16,39,102,40,122,2798
"48067950600",3661,885,309,229,159,158,276,49,5726
"48067950700",3354,725,679,412,156,104,60,113,5603
"48069950100",1040,141,0,0,58,0,179,86,1504
"48069950200",2926,918,0,4,384,94,2253,850,7429
"48069950300",1761,219,7,14,193,148,1197,319,3858
"48071710100",6126,685,511,44,224,186,776,171,8723
"48071710200",12769,1198,1238,0,1262,294,3366,567,20694
"48071710300",1288,189,288,223,141,38,82,26,2275
"48071710401",4572,430,400,11,430,175,1149,194,7361
"48071710500",2586,320,198,16,189,138,798,147,4392
"48071710600",0,0,0,0,0,0,0,0,0
"48071990000",0,0,0,0,0,0,0,0,0
"48073950100",3338,751,224,62,195,43,1343,436,6392
"48073950200",4919,625,54,33,173,0,547,0,6351
"48073950300",5174,1024,531,75,206,20,761,632,8423
"48073950400",439,254,598,190,64,22,251,252,2070
"48073950500",1646,990,434,713,187,37,1289,576,5872
"48073950600",3841,778,84,341,480,0,1075,441,7040
"48073950700",1658,1021,182,395,357,22,800,793,5228
"48073950801",2731,1033,195,79,90,23,141,23,4315
"48073950802",2963,493,385,0,115,29,242,204,4431
"48073950900",1497,306,164,351,88,59,214,212,2891
"48073951000",1874,434,650,326,188,81,101,161,3815
"48073951100",1140,389,89,154,31,24,79,32,1938
"48075950100",656,95,27,17,20,18,20,28,881
"48075950200",3300,935,211,6,382,55,591,368,5848
"48077030200",2506,614,22,0,80,13,24,0,3259
"48077030301",3978,377,0,4,133,14,259,26,4791
"48077030302",2223,266,4,15,66,125,94,102,2895
"48079950100",2094,353,82,32,324,88,1315,347,4635
"48081950100",1371,102,3,0,16,17,158,39,1706
"48081950200",1268,249,0,0,72,1,349,52,1991
"48083950300",3359,940,106,5,108,6,772,144,5440
"48083950600",1167,105,0,0,99,11,159,12,1553
"48083950700",1859,580,28,60,62,86,182,176,3033
"48085030100",5806,379,0,68,82,11,275,85,6706
"48085030201",2534,51,58,1,25,0,369,22,3060
"48085030202",1716,159,3,0,187,0,231,42,2338
"48085030203",11712,1131,1509,0,657,85,2325,788,18207
"48085030301",3179,85,303,0,224,0,516,0,4307
"48085030302",1906,145,182,0,133,0,45,13,2424
"48085030303",5099,420,361,0,234,43,609,0,6766
"48085030304",2046,552,167,0,86,14,210,48,3123
"48085030305",7171,469,86,185,460,540,895,674,10480
"48085030403",3994,394,131,58,869,157,802,310,6715
"48085030404",4000,144,522,20,850,277,585,264,6662
"48085030405",3363,166,511,39,745,87,624,33,5568
"48085030406",2021,147,126,0,564,83,968,175,4084
"48085030407",3291,38,279,10,314,16,573,0,4521
"48085030408",4581,839,433,19,997,150,2041,453,9513
"48085030504",1773,94,188,18,354,177,249,0,2853
"48085030505",2234,57,116,41,1048,0,262,0,3758
"48085030506",2203,55,203,0,432,0,96,0,2989
"48085030507",1503,18,17,0,356,0,170,0,2064
"48085030508",4923,259,55,21,550,14,706,43,6571
"48085030509",1600,11,223,0,682,0,340,0,2856
"48085030510",1895,133,389,0,557,24,416,0,3414
"48085030511",3659,124,204,0,1102,58,640,0,5787
"48085030512",3186,9,65,18,1001,9,455,0,4743
"48085030513",4061,347,983,0,1031,38,1209,0,7669
"48085030514",5182,39,734,0,903,32,1086,0,7976
"48085030515",4734,298,903,63,670,0,723,94,7485
"48085030516",3464,916,728,0,693,119,549,883,7352
"48085030517",4663,85,364,0,829,71,648,0,6660
"48085030518",1621,0,153,6,828,0,286,0,2894
"48085030519",1446,6,372,0,250,7,271,0,2352
"48085030520",3084,93,990,83,1019,130,567,127,6093
"48085030521",2091,18,527,0,958,13,600,0,4207
"48085030522",3688,140,689,0,1240,0,1064,90,6911
"48085030523",6541,650,647,0,1366,183,890,503,10780
"48085030524",1740,21,542,0,129,0,436,0,2868
"48085030525",5355,229,458,0,192,57,477,0,6768
"48085030526",6839,318,1034,36,661,29,867,54,9838
"48085030527",3398,124,527,0,403,12,644,49,5157
"48085030528",6460,160,391,31,578,269,681,48,8618
"48085030529",2101,57,728,30,212,0,293,0,3421
"48085030530",5452,259,200,0,214,0,245,0,6370
"48085030531",4608,223,302,0,424,60,284,31,5932
"48085030601",8759,572,393,0,370,30,561,318,11003
"48085030603",5513,243,1160,49,215,22,1674,0,8876
"48085030604",1543,66,214,0,88,0,127,15,2053
"48085030605",4473,68,1295,78,792,0,1125,21,7852
"48085030701",1788,804,107,336,254,51,892,505,4737
"48085030702",3216,1083,219,44,188,0,1037,824,6611
"48085030801",2772,405,486,14,233,27,886,343,5166
"48085030802",3285,765,500,508,557,73,1587,657,7932
"48085030900",6091,1153,935,505,622,33,4494,839,14672
"48085031001",5868,1139,49,69,386,7,1912,299,9729
"48085031003",3056,760,299,68,68,15,897,215,5378
"48085031004",4404,672,370,57,261,53,1189,256,7262
"48085031100",7446,1296,48,274,639,55,1444,403,11605
"48085031201",4343,473,176,0,367,9,719,175,6262
"48085031202",3137,330,480,6,322,0,366,241,4882
"48085031308",4520,405,606,46,659,0,700,121,7057
"48085031309",6479,123,1226,74,1220,86,1599,0,10807
"48085031310",7775,362,485,171,957,0,1373,141,11264
"48085031311",7579,448,599,71,1325,39,1413,109,11583
"48085031312",5058,114,449,0,1049,61,649,0,7380
"48085031313",8262,378,1007,7,3006,296,1002,78,14036
"48085031314",2182,101,28,0,126,0,172,0,2609
"48085031315",10168,1269,3602,0,3123,196,1734,764,20856
"48085031316",2723,9,470,0,3211,27,571,0,7011
"48085031317",5030,109,1525,0,1736,181,705,0,9286
"48085031405",13972,71,515,15,4958,44,1163,25,20763
"48085031406",12079,964,1380,270,2414,94,1471,325,18997
"48085031407",6902,416,0,0,240,3,393,3,7957
"48085031408",2154,327,405,0,415,0,268,0,3569
"48085031409",7270,145,676,162,2283,225,954,92,11807
"48085031410",6752,107,708,327,1152,43,768,43,9900
"48085031411",3040,43,569,42,1572,66,691,0,6023
"48085031504",5584,147,454,0,568,0,586,15,7354
"48085031505",5659,131,343,0,2105,327,314,18,8897
"48085031506",5064,1142,856,280,528,373,1524,807,10574
"48085031507",3597,86,95,0,841,71,442,0,5132
"48085031508",4214,291,631,144,794,47,838,58,7017
"48085031611",2705,127,428,111,237,8,667,0,4283
"48085031612",4855,197,92,0,1028,17,337,100,6626
"48085031613",4542,64,93,6,415,0,974,0,6094
"48085031621",3974,419,277,100,867,118,379,28,6162
"48085031622",3771,97,442,0,1067,195,500,0,6072
"48085031623",1946,116,137,64,300,6,468,75,3112
"48085031624",1962,539,513,102,565,181,1095,475,5432
"48085031625",3870,81,114,19,365,25,220,2,4696
"48085031626",1884,43,122,14,367,40,141,0,2611
"48085031627",4426,138,243,43,202,102,662,54,5870
"48085031628",2617,132,191,0,399,10,570,0,3919
"48085031629",2569,375,175,65,476,78,434,227,4399
"48085031630",3208,245,157,0,657,28,253,0,4548
"48085031631",2658,417,981,21,663,250,244,232,5466
"48085031632",3511,440,191,114,1474,27,351,0,6108
"48085031633",2787,63,535,62,431,0,414,0,4292
"48085031634",2195,392,78,32,506,60,661,97,4021
"48085031635",2150,239,646,14,1091,25,529,118,4812
"48085031636",4683,187,155,54,1474,22,563,102,7240
"48085031637",4627,16,370,0,1612,33,392,0,7050
"48085031638",3392,32,0,138,3741,36,373,0,7712
"48085031639",4049,112,655,25,1562,0,710,16,7129
"48085031640",4321,638,1115,320,1557,54,576,32,8613
"48085031641",2555,77,320,0,3609,76,276,9,6922
"48085031642",3088,101,169,0,1221,43,301,17,4940
"48085031643",2785,276,206,152,967,51,438,206,5081
"48085031645",1611,33,47,0,365,6,32,0,2094
"48085031646",4004,11,180,0,1336,95,349,16,5991
"48085031647",2263,19,142,0,670,0,414,0,3508
"48085031648",4940,235,348,305,1812,70,499,95,8304
"48085031649",3317,256,209,46,670,0,85,0,4583
"48085031652",3737,157,577,29,2841,56,347,17,7761
"48085031653",4411,193,313,28,1957,125,782,90,7899
"48085031654",2497,145,102,0,1203,34,228,0,4209
"48085031655",2815,473,471,0,919,195,401,75,5349
"48085031656",1617,6,198,0,645,0,298,0,2764
"48085031657",1198,116,274,0,319,50,94,28,2079
"48085031658",2889,375,335,0,806,74,311,298,5088
"48085031659",971,67,98,0,897,146,246,8,2433
"48085031660",1755,30,409,29,1777,161,279,42,4482
"48085031661",1152,4,21,0,1619,42,128,0,2966
"48085031662",2241,147,489,0,2300,0,229,40,5446
"48085031663",1989,29,26,0,1390,67,215,9,3725
"48085031664",2552,6,229,0,1332,9,360,0,4488
"48085031704",2623,75,391,25,427,100,585,94,4320
"48085031706",1820,26,0,0,370,5,150,0,2371
"48085031708",2391,75,512,91,348,288,261,180,4146
"48085031709",2658,256,306,121,1008,229,461,68,5107
"48085031711",2037,50,333,44,443,55,104,0,3066
"48085031712",2570,339,790,48,1396,131,654,0,5928
"48085031713",1481,70,866,130,1209,407,437,294,4894
"48085031714",2661,155,1291,380,851,358,621,148,6465
"48085031715",1743,60,179,0,443,63,58,7,2553
"48085031716",1441,119,238,0,179,55,197,30,2259
"48085031717",764,477,391,19,888,101,305,8,2953
"48085031718",2127,36,86,0,271,59,167,0,2746
"48085031719",998,76,87,7,525,60,81,0,1834
"48085031720",579,325,481,232,1620,1425,996,1179,6837
"48085031802",4108,310,476,1,817,100,848,116,6776
"48085031804",2154,885,28,11,290,303,118,102,3891
"48085031805",4349,266,56,0,584,65,244,103,5667
"48085031806",651,74,105,49,954,143,346,52,2374
"48085031807",4253,301,69,0,323,51,475,29,5501
"48085031900",2152,761,440,278,425,331,1655,978,7020
"48085032003",3000,1345,503,111,455,81,1779,1246,8520
"48085032004",5240,913,627,110,1250,13,2771,617,11541
"48085032008",3001,322,252,20,409,40,796,227,5067
"48085032009",3637,246,665,2,2350,98,512,79,7589
"48085032010",3223,540,429,47,567,86,1713,464,7069
"48085032011",3488,84,564,0,2074,172,468,0,6850
"48085032012",3019,571,270,89,307,44,2106,423,6829
"48085032013",2431,591,711,111,1784,361,1009,664,7662
"48087950300",2069,463,48,56,199,135,613,362,3945
"48089750100",2617,906,746,462,136,46,1424,766,7103
"48089750200",1548,220,52,15,129,38,243,180,2425
"48089750300",3675,392,419,178,21,27,651,254,5617
"48089750400",3708,629,181,13,382,1,571,378,5863
"48089750500",2683,320,413,265,129,38,845,234,4927
"48091310100",2781,415,82,15,175,0,1108,197,4773
"48091310200",2015,479,0,4,289,0,1094,449,4330
"48091310300",5842,394,143,56,152,82,1128,96,7893
"48091310401",3413,1017,40,37,465,41,2842,1025,8880
"48091310403",4376,649,235,42,417,0,1803,231,7753
"48091310404",3224,648,56,0,183,201,1077,605,5994
"48091310501",2594,528,50,29,254,67,1170,415,5107
"48091310502",3842,924,76,46,187,290,1144,929,7438
"48091310503",3509,106,0,0,68,2,981,25,4691
"48091310603",2505,464,66,0,229,12,541,165,3982
"48091310604",2211,112,13,0,105,23,222,24,2710
"48091310605",4346,687,47,0,278,16,857,231,6462
"48091310606",3588,348,35,0,297,0,347,86,4701
"48091310607",4036,251,61,0,214,0,622,0,5184
"48091310608",2697,531,5,0,145,9,469,218,4074
"48091310701",5640,547,0,0,371,56,722,50,7386
"48091310702",4881,236,108,0,44,0,681,29,5979
"48091310703",4634,547,57,0,225,234,831,505,7033
"48091310704",4087,590,77,1,1130,0,1526,26,7437
"48091310801",4662,104,324,11,284,0,812,19,6216
"48091310802",5228,801,242,0,251,33,1046,636,8237
"48091310901",4268,201,63,0,13,2,509,30,5086
"48091310902",5838,168,95,0,210,0,912,0,7223
"48091310903",3931,136,96,0,194,0,984,0,5341
"48093950100",3056,767,25,0,213,61,446,290,4858
"48093950200",2564,654,13,0,40,12,93,228,3604
"48093950300",2685,1258,0,10,98,79,857,956,5943
"48093950400",1311,644,0,1,59,0,245,519,2779
"48095950300",2234,339,16,0,33,6,650,209,3487
"48097000100",4227,720,8,0,252,0,209,238,5654
"48097000200",4469,317,6,8,186,5,157,39,5187
"48097000400",1083,340,58,108,132,45,317,97,2180
"48097000500",2180,752,79,23,181,191,1065,429,4900
"48097000600",3603,558,271,53,528,29,1329,241,6612
"48097000700",6345,318,0,0,170,21,377,0,7231
"48097000900",4247,411,1,0,132,14,270,62,5137
"48097001100",3830,1523,191,44,185,0,486,876,7135
"48099010101",2605,496,39,0,166,2,379,39,3726
"48099010102",2605,345,25,3,87,16,272,68,3421
"48099010201",183,68,0,0,22,0,63,54,390
"48099010202",4096,816,210,96,102,79,926,176,6501
"48099010300",1577,312,13,62,214,162,335,293,2968
"48099010400",3002,342,62,26,273,117,365,97,4284
"48099010501",2554,389,1017,107,818,207,1106,95,6293
"48099010502",1217,460,502,10,464,170,281,15,3119
"48099010503",0,0,0,0,0,0,0,0,0
"48099010504",1314,191,963,49,125,27,396,10,3075
"48099010601",1747,366,1069,118,612,485,640,295,5332
"48099010603",3764,150,713,97,474,87,502,94,5881
"48099010604",3390,332,948,42,417,57,629,52,5867
"48099010701",3020,94,357,19,457,30,798,0,4775
"48099010702",2453,136,215,106,142,33,331,28,3444
"48099010802",3521,493,891,4,411,20,375,120,5835
"48099010803",2185,13,489,67,225,0,519,0,3498
"48099010804",2310,435,687,75,657,183,586,216,5149
"48099980000",18,0,0,0,0,0,0,0,18
"48101950100",1070,211,126,58,66,55,202,159,1947
"48103950100",2414,363,160,0,1449,102,2304,316,7108
"48105950100",2355,441,0,0,793,193,1897,511,6190
"48107950100",1411,473,100,53,43,35,764,312,3191
"48107950200",1719,464,38,35,96,86,919,466,3823
"48107950300",995,214,9,16,110,29,512,231,2116
"48109950300",1575,665,0,5,57,0,1241,605,4148
"48111950100",1147,313,0,0,56,1,226,64,1807
"48111950300",3721,654,60,27,648,267,1857,735,7969
"48113000100",3295,223,239,43,123,0,291,148,4362
"48113000201",2717,112,10,0,52,36,385,36,3348
"48113000202",3039,60,72,13,255,26,488,32,3985
"48113000300",3798,290,20,29,74,32,450,0,4693
"48113000401",1274,852,285,584,2165,640,1929,800,8529
"48113000404",1862,303,101,0,1123,241,1408,375,5413
"48113000405",452,196,188,309,836,241,671,240,3133
"48113000406",3607,806,251,0,2162,998,4228,1456,13508
"48113000500",2264,248,160,155,1196,385,1277,582,6267
"48113000601",3091,405,202,253,1324,1133,2152,1271,9831
"48113000603",3039,162,58,0,682,78,658,58,4735
"48113000605",1404,131,115,18,463,119,309,95,2654
"48113000606",2568,75,58,16,283,24,182,28,3234
"48113000701",3550,178,253,27,421,130,370,80,5009
"48113000702",2014,155,0,0,595,26,375,11,3176
"48113000800",3423,751,689,251,1039,469,2723,1004,10349
"48113000900",2004,1403,81,62,468,207,963,1191,6379
"48113001001",1517,76,12,0,57,0,249,42,1953
"48113001002",1603,126,86,0,228,63,770,101,2977
"48113001101",2705,408,18,2,230,86,749,282,4480
"48113001102",2391,20,35,0,95,0,231,0,2772
"48113001202",1936,320,433,295,330,90,847,285,4536
"48113001203",1242,268,24,0,59,1,800,245,2639
"48113001204",2027,685,0,0,182,154,2037,839,5924
"48113001301",1702,219,70,15,177,99,291,90,2663
"48113001302",1571,193,157,157,138,33,958,157,3364
"48113001400",2254,803,187,89,328,110,1063,583,5417
"48113001502",1633,510,335,303,202,71,1363,436,4853
"48113001503",774,1255,203,141,446,472,639,1569,5499
"48113001504",1030,369,318,255,420,178,506,400,3476
"48113001600",1922,434,433,785,438,175,540,319,5046
"48113001701",282,0,12,0,68,0,40,0,402
"48113001703",2816,113,68,39,162,73,237,0,3508
"48113001704",1106,64,18,0,139,0,172,10,1509
"48113001800",2731,121,253,37,460,52,437,0,4091
"48113001900",3410,192,132,160,650,329,316,64,5253
"48113002000",2584,835,749,133,476,308,2355,1027,8467
"48113002100",873,68,350,84,233,98,120,47,1873
"48113002200",915,174,369,180,211,57,146,20,2072
"48113002400",1924,631,135,29,383,206,1990,744,6042
"48113002500",2254,747,754,489,286,62,2432,677,7701
"48113002701",167,317,870,1302,0,16,167,320,3159
"48113002702",62,48,922,564,20,0,66,35,1717
"48113003101",1893,175,274,18,499,96,375,68,3398
"48113003400",199,77,590,381,21,80,71,129,1548
"48113003700",0,102,2078,958,19,7,0,140,3304
"48113003800",65,31,1134,678,0,0,14,31,1953
"48113003901",20,0,1107,858,0,0,0,0,1985
"48113003902",167,177,888,620,40,0,143,79,2114
"48113004000",0,186,513,285,0,0,0,94,1078
"48113004100",241,199,220,255,36,28,236,229,1444
"48113004201",2957,773,42,74,442,56,1940,656,6940
"48113004202",1483,740,22,0,226,74,1023,733,4301
"48113004300",937,435,148,38,262,65,1103,457,3445
"48113004400",2712,209,165,11,329,0,838,92,4356
"48113004500",4035,725,120,48,774,182,3760,620,10264
"48113004600",1207,105,115,31,87,6,626,68,2245
"48113004700",2179,983,60,127,241,359,2142,1175,7266
"48113004800",1421,844,23,12,223,93,1545,930,5091
"48113004900",665,845,1470,989,182,145,777,939,6012
"48113005000",2694,929,171,150,271,262,2795,1089,8361
"48113005100",2141,770,0,0,122,35,1945,742,5755
"48113005200",3289,686,57,9,481,108,3138,720,8488
"48113005300",4387,1694,31,0,901,319,4637,1975,13944
"48113005400",1909,912,1024,1279,141,167,1901,1020,8353
"48113005500",376,929,1601,529,208,63,635,914,5255
"48113005600",3184,2044,933,653,881,418,4073,2087,14273
"48113005700",814,558,1480,1026,319,80,1051,601,5929
"48113005901",674,419,2779,905,80,20,745,433,6055
"48113005902",503,442,1634,1099,82,98,549,518,4925
"48113006001",1674,1226,539,161,191,243,1820,1431,7285
"48113006002",858,366,1751,1384,140,389,594,315,5797
"48113006100",1828,853,1415,360,147,27,1573,850,7053
"48113006200",2304,1080,1025,420,594,311,2198,1364,9296
"48113006301",3294,976,466,68,905,328,3904,1090,11031
"48113006302",2809,681,99,27,618,151,2913,721,8019
"48113006401",1639,219,38,8,642,78,2098,285,5007
"48113006402",3562,1306,114,13,990,32,4293,1199,11509
"48113006501",3282,1328,81,18,1083,322,4146,1640,11900
"48113006502",2499,733,117,0,689,251,2934,969,8192
"48113006700",4413,1721,76,0,1211,547,4902,2062,14932
"48113006800",2337,1140,394,345,826,296,2802,1338,9478
"48113006900",1546,1241,161,232,350,58,1497,1214,6299
"48113007101",1777,83,6,0,240,0,139,0,2245
"48113007102",2479,136,1353,402,1036,645,1742,627,8420
"48113007201",4201,1365,206,46,2081,833,5354,1792,15878
"48113007202",3510,1623,73,139,1947,863,4300,1675,14130
"48113007301",1926,43,1,2,77,0,113,0,2162
"48113007302",3626,232,78,0,475,388,1058,440,6297
"48113007601",1774,43,38,0,72,0,120,0,2047
"48113007604",2759,68,314,0,122,0,91,0,3354
"48113007605",1667,48,0,40,147,4,90,7,2003
"48113007700",4142,187,0,0,366,17,295,17,5024
"48113007801",1948,129,9,0,102,11,134,0,2333
"48113007804",1259,717,2666,399,282,52,717,542,6634
"48113007805",1859,94,633,115,167,32,461,10,3371
"48113007809",1692,119,131,97,14,112,313,52,2530
"48113007810",2505,186,485,199,183,20,513,187,4278
"48113007811",1618,184,1826,1270,227,512,819,391,6847
"48113007812",2805,8,63,0,155,10,160,0,3201
"48113007815",1007,1763,507,282,440,814,794,1579,7186
"48113007818",2302,1098,818,532,561,326,2065,1172,8874
"48113007819",865,389,370,156,182,65,457,363,2847
"48113007820",1400,1605,1096,865,385,657,861,1813,8682
"48113007821",1353,638,645,118,601,148,1390,585,5478
"48113007822",776,169,137,0,129,22,191,55,1479
"48113007823",210,166,42,69,27,103,184,269,1070
"48113007824",1499,10,154,0,82,0,79,0,1824
"48113007825",2634,603,1143,729,252,143,810,644,6958
"48113007826",70,12,174,6,3,7,4,0,276
"48113007827",799,226,668,470,176,34,394,53,2820
"48113007902",3740,576,322,13,109,0,266,346,5372
"48113007903",1662,118,17,34,89,27,85,36,2068
"48113007906",2195,118,28,0,115,13,90,27,2586
"48113007909",1129,126,305,14,469,53,195,17,2308
"48113007910",1784,322,186,15,681,178,442,23,3631
"48113007911",2184,363,127,34,300,63,305,167,3543
"48113007912",1399,100,25,43,199,7,244,11,2028
"48113007913",1954,86,205,150,116,18,513,12,3054
"48113007914",1251,750,315,21,288,108,265,111,3109
"48113008000",6308,52,0,0,305,0,415,0,7080
"48113008100",5645,498,232,0,140,0,852,70,7437
"48113008200",2957,447,302,242,105,107,772,223,5155
"48113008400",4874,1950,418,121,1082,492,5094,2245,16276
"48113008500",2558,835,234,182,869,468,2982,1152,9280
"48113008603",388,139,276,381,27,12,415,142,1780
"48113008604",435,242,890,1358,25,55,420,235,3660
"48113008701",67,64,1733,2036,61,0,145,94,4200
"48113008703",461,484,1099,623,112,28,524,451,3782
"48113008704",71,143,1970,899,0,0,55,110,3248
"48113008705",283,67,613,172,200,0,478,53,1866
"48113008801",257,135,1293,588,92,0,338,138,2841
"48113008802",904,872,2229,1593,104,145,1062,1015,7924
"48113008900",237,503,1155,1031,126,20,320,451,3843
"48113009000",3215,992,1648,1110,1029,443,3405,1203,13045
"48113009101",1653,948,770,535,1457,260,2649,1052,9324
"48113009103",1983,596,922,182,215,179,1992,752,6821
"48113009104",1680,1082,468,349,284,85,1859,1208,7015
"48113009105",1665,446,205,107,888,540,2102,964,6917
"48113009201",3521,1330,721,442,587,110,3453,1389,11553
"48113009202",2983,801,420,321,990,272,3579,937,10303
"48113009301",3533,1321,155,53,633,223,3891,1443,11252
"48113009303",1658,1072,454,74,478,269,2025,1328,7358
"48113009304",396,767,1517,2899,169,319,482,970,7519
"48113009401",2556,419,110,0,612,34,1628,404,5763
"48113009402",2120,103,0,0,177,0,324,35,2759
"48113009500",2035,60,65,37,108,0,203,0,2508
"48113009603",3747,104,340,98,426,60,514,10,5299
"48113009604",3154,333,342,33,309,159,881,301,5512
"48113009605",1992,438,244,0,603,177,1756,449,5659
"48113009607",2703,120,243,5,782,15,1225,74,5167
"48113009608",2879,216,178,115,513,141,1233,197,5472
"48113009609",2611,51,47,13,96,0,174,0,2992
"48113009610",2348,1257,159,71,493,965,2119,1672,9084
"48113009611",2150,241,115,79,794,32,1627,207,5245
"48113009701",3259,581,133,98,807,423,2381,738,8420
"48113009702",2662,301,20,0,46,0,575,0,3604
"48113009802",2745,1042,89,0,1481,729,3552,1453,11091
"48113009803",1199,373,191,11,351,51,983,300,3459
"48113009804",3221,2364,75,253,1419,1276,3942,2691,15241
"48113009900",1305,196,334,8,533,220,862,211,3669
"48113010000",1580,201,858,430,239,290,305,81,3984
"48113010101",1013,908,1048,733,946,40,1657,737,7082
"48113010102",1717,669,139,52,531,130,1887,755,5880
"48113010500",1115,230,1252,197,142,294,899,524,4653
"48113010601",3537,1106,54,14,959,338,3886,1402,11296
"48113010602",1588,414,65,231,164,423,1307,595,4787
"48113010701",1922,1472,400,37,935,91,2585,1417,8859
"48113010703",1465,423,113,168,491,106,1570,490,4826
"48113010704",2311,555,504,371,588,432,2360,980,8101
"48113010801",5165,2054,742,552,1111,466,5719,2416,18225
"48113010803",2659,417,2323,510,418,25,1959,232,8543
"48113010804",1330,793,511,767,697,149,1912,818,6977
"48113010805",2596,1011,849,721,695,430,3036,1271,10609
"48113010902",551,82,4551,1314,100,11,522,140,7271
"48113010903",891,391,1279,374,736,41,1507,414,5633
"48113010904",336,235,1763,928,90,74,369,252,4047
"48113011001",525,43,4677,1380,179,139,387,160,7490
"48113011002",638,110,2042,449,55,55,547,154,4050
"48113011101",248,2,3080,355,82,12,155,13,3947
"48113011103",1004,439,1203,241,131,496,973,878,5365
"48113011104",234,345,1786,794,36,47,230,379,3851
"48113011105",496,508,1390,1052,117,0,502,465,4530
"48113011200",635,362,4438,1046,288,184,942,343,8238
"48113011300",32,217,3199,829,43,0,32,215,4567
"48113011401",333,189,2242,1870,100,19,399,150,5302
"48113011500",695,840,423,385,13,140,686,970,4152
"48113011601",1276,341,1756,707,51,131,1186,387,5835
"48113011602",3475,1329,727,200,849,243,3816,1302,11941
"48113011701",3723,818,1393,683,404,269,4017,1039,12346
"48113011702",2653,1343,229,200,909,131,2956,1352,9773
"48113011800",2910,1432,2519,838,794,681,3270,2082,14526
"48113011900",4292,1577,2381,291,438,469,4206,1926,15580
"48113012000",2576,780,2321,1097,566,170,2902,917,11329
"48113012100",1760,398,1650,1049,811,125,2181,513,8487
"48113012204",3143,404,987,710,503,380,1540,507,8174
"48113012206",1979,199,1146,559,561,103,1422,262,6231
"48113012207",980,1529,3681,624,725,380,1261,1722,10902
"48113012208",524,301,446,483,661,536,924,794,4669
"48113012209",1617,232,250,208,770,209,1091,444,4821
"48113012210",937,334,730,835,635,341,815,509,5136
"48113012211",726,377,1268,700,837,272,1213,591,5984
"48113012301",1915,979,248,200,1341,646,2580,1462,9371
"48113012302",1015,868,597,1790,2286,624,2577,985,10742
"48113012400",3651,282,609,0,719,84,1806,53,7204
"48113012500",3919,633,310,225,1699,848,3624,709,11967
"48113012601",1288,85,869,157,2542,1563,2385,1387,10276
"48113012603",938,307,100,8,643,172,849,391,3408
"48113012604",1869,305,1474,628,1772,438,2079,478,9043
"48113012701",2389,497,273,87,2036,1393,3356,1506,11537
"48113012702",1330,386,128,94,1235,226,1885,479,5763
"48113012800",6521,604,293,87,343,122,2455,422,10847
"48113012900",3530,221,356,152,27,49,571,97,5003
"48113013004",5325,111,201,58,349,23,270,3,6340
"48113013005",2874,150,0,0,154,16,207,113,3514
"48113013007",1844,355,182,123,534,100,366,309,3813
"48113013008",2402,143,375,84,333,122,248,133,3840
"48113013009",2470,143,1145,433,310,20,810,56,5387
"48113013010",2458,852,858,298,239,119,1955,778,7557
"48113013011",1953,997,794,397,403,265,1855,1221,7885
"48113013101",2154,90,10,0,182,0,95,8,2539
"48113013102",1470,38,24,0,103,6,116,6,1763
"48113013104",847,22,35,0,69,34,90,0,1097
"48113013105",2785,619,947,546,984,272,1836,407,8396
"48113013200",4915,309,237,2,925,165,494,167,7214
"48113013300",1822,12,66,0,280,6,225,0,2411
"48113013400",1921,21,0,0,127,0,101,0,2170
"48113013500",2233,15,28,0,95,0,117,0,2488
"48113013605",4326,137,79,0,760,0,463,20,5785
"48113013606",2747,319,809,108,1938,302,1847,338,8408
"48113013607",2828,103,73,74,460,138,453,179,4308
"48113013608",2267,28,52,0,76,0,111,0,2534
"48113013609",2431,131,289,24,622,681,832,565,5575
"48113013610",2298,68,219,19,1333,454,1387,429,6207
"48113013611",1982,64,25,43,208,11,72,0,2405
"48113013615",1127,247,701,406,1718,952,2014,1074,8239
"48113013616",3016,362,523,149,1569,196,1141,273,7229
"48113013617",2229,120,0,60,332,167,336,80,3324
"48113013618",1806,46,19,20,334,66,184,38,2513
"48113013619",3993,24,65,38,687,91,542,71,5511
"48113013620",2550,154,965,0,510,10,399,0,4588
"48113013621",1634,129,928,1,847,193,895,119,4746
"48113013622",1220,106,373,25,781,329,499,388,3721
"48113013623",1806,503,1834,157,2134,416,2255,604,9709
"48113013624",1463,122,600,91,895,102,569,27,3869
"48113013625",495,154,548,180,1346,478,1290,515,5006
"48113013626",1360,186,346,9,767,321,902,317,4208
"48113013711",1576,691,230,37,613,140,1580,705,5572
"48113013712",1641,344,0,30,316,36,1025,272,3664
"48113013713",761,584,0,0,111,248,758,764,3226
"48113013714",4312,1001,40,0,1010,201,3993,1141,11698
"48113013715",1929,126,35,0,410,0,1885,93,4478
"48113013716",3041,612,180,81,835,188,1359,743,7039
"48113013717",1864,384,23,0,387,69,1678,419,4824
"48113013718",2779,1051,423,110,654,284,2756,1225,9282
"48113013719",1968,102,243,9,1158,217,691,22,4410
"48113013720",3787,548,430,26,574,366,2231,760,8722
"48113013721",4387,52,463,2,1199,19,1059,36,7217
"48113013722",1748,298,788,43,579,0,565,139,4160
"48113013725",2386,508,610,53,344,107,1255,454,5717
"48113013726",2253,301,166,0,592,4,949,280,4545
"48113013727",1979,120,531,0,319,128,404,82,3563
"48113013803",4979,190,58,0,396,17,1256,121,7017
"48113013804",2775,71,92,25,245,0,1247,33,4488
"48113013805",1705,564,284,172,415,204,939,430,4713
"48113013806",1874,99,278,103,851,39,437,0,3681
"48113013901",2156,439,66,0,570,30,1893,388,5542
"48113013902",2892,885,12,0,332,39,1226,631,6017
"48113014001",2832,588,66,0,559,152,1110,309,5616
"48113014002",87,0,0,0,0,16,0,16,119
"48113014103",1010,321,923,272,578,202,911,418,4635
"48113014113",1875,103,1436,276,1208,111,1206,61,6276
"48113014114",1191,290,544,98,874,287,1068,381,4733
"48113014115",4117,424,892,233,1842,102,3457,210,11277
"48113014116",1328,419,1148,104,1355,68,784,220,5426
"48113014119",2986,139,164,31,654,56,445,28,4503
"48113014120",3876,107,139,13,965,11,272,0,5383
"48113014121",3082,198,663,90,714,295,473,66,5581
"48113014123",4207,56,142,0,1635,58,603,32,6733
"48113014124",2553,86,210,19,1425,17,611,11,4932
"48113014126",4684,308,194,20,1175,15,836,224,7456
"48113014127",2119,152,782,246,4746,100,482,84,8711
"48113014128",1588,6,594,121,1075,170,358,14,3926
"48113014129",1494,44,459,12,3210,135,252,13,5619
"48113014130",1653,58,417,63,1744,179,484,23,4621
"48113014131",1627,155,1263,267,785,67,359,0,4523
"48113014132",960,67,380,158,541,154,195,0,2455
"48113014133",1538,306,1000,483,849,148,468,262,5054
"48113014134",2647,40,103,0,1256,0,394,0,4440
"48113014135",3021,147,239,0,998,63,429,117,5014
"48113014136",1884,300,1283,35,2101,150,587,233,6573
"48113014137",1732,119,291,84,1953,0,363,31,4573
"48113014138",1527,210,167,8,1726,94,304,0,4036
"48113014203",1723,485,253,228,756,0,1016,248,4709
"48113014204",397,404,172,169,404,57,132,81,1816
"48113014205",1067,48,87,0,328,4,79,4,1617
"48113014206",2221,380,584,37,1020,27,762,50,5081
"48113014302",5194,521,273,3,661,37,3137,259,10085
"48113014306",3565,680,365,92,784,244,2958,873,9561
"48113014307",2757,217,393,0,543,94,765,131,4900
"48113014308",1748,961,341,215,751,48,1601,900,6565
"48113014309",1401,914,792,357,1051,621,1667,1104,7907
"48113014310",1881,276,767,476,810,295,1461,270,6236
"48113014311",658,24,271,198,3405,276,328,103,5263
"48113014312",2446,160,844,74,1974,30,866,0,6394
"48113014403",1730,291,1125,113,762,258,1567,261,6107
"48113014405",1968,489,162,0,789,0,1857,393,5658
"48113014406",2702,464,177,0,584,222,1870,630,6649
"48113014407",2289,283,843,148,1222,249,2418,329,7781
"48113014408",1813,195,962,108,1071,150,1563,205,6067
"48113014501",2260,174,179,0,956,7,1906,70,5552
"48113014502",2302,760,21,59,1213,210,2507,501,7573
"48113014601",1356,196,8,7,402,17,982,196,3164
"48113014602",2477,553,253,80,1106,283,2629,721,8102
"48113014603",654,423,55,0,441,97,766,435,2871
"48113014701",1886,802,197,254,811,466,2153,1232,7801
"48113014702",1850,946,60,3,497,724,1484,1613,7177
"48113014703",1009,112,15,21,422,105,1036,153,2873
"48113014901",914,150,0,6,436,133,1105,280,3024
"48113014902",1146,394,79,45,558,18,1225,311,3776
"48113015000",4055,2242,230,95,1130,250,3566,2165,13733
"48113015100",3507,938,387,38,1557,295,3096,838,10656
"48113015202",2030,1150,77,0,553,312,2038,1370,7530
"48113015204",5411,984,0,0,1116,145,3091,681,11428
"48113015205",2567,741,26,0,671,343,2452,1001,7801
"48113015206",2645,276,150,59,594,146,1895,251,6016
"48113015303",1311,437,154,0,191,31,1032,367,3523
"48113015304",2210,595,12,0,741,101,1317,503,5479
"48113015305",2847,524,429,45,466,73,1932,337,6653
"48113015306",3036,213,264,166,1490,36,1823,135,7163
"48113015401",4139,443,1290,69,510,64,1273,115,7903
"48113015403",1706,688,334,248,373,17,922,620,4908
"48113015404",1723,1177,325,301,283,246,1360,1203,6618
"48113015500",2088,609,121,176,430,178,1593,694,5889
"48113015600",3211,796,36,30,859,110,3501,840,9383
"48113015700",1563,822,107,7,327,76,1471,805,5178
"48113015800",1503,514,0,0,61,229,1102,734,4143
"48113015900",1962,748,592,263,510,110,1602,745,6532
"48113016001",3173,863,69,68,491,173,2632,876,8345
"48113016002",1365,712,180,82,205,184,1063,824,4615
"48113016100",1462,283,1054,457,225,127,894,282,4784
"48113016201",2859,727,425,330,548,172,2466,517,8044
"48113016202",4561,1327,413,364,956,17,3086,1224,11948
"48113016301",3437,996,441,104,1458,226,3962,1063,11687
"48113016302",1379,340,67,84,273,60,949,371,3523
"48113016401",5089,422,2225,104,1646,195,4013,418,14112
"48113016406",2927,501,379,473,620,52,2405,656,8013
"48113016407",3401,1315,666,368,995,352,2762,1549,11408
"48113016408",4013,529,1263,1,1049,65,3265,399,10584
"48113016409",2014,209,699,0,611,25,993,192,4743
"48113016410",3104,346,941,50,892,19,1437,154,6943
"48113016411",5358,425,2007,155,1009,27,3000,263,12244
"48113016412",2432,81,1067,11,888,0,1009,8,5496
"48113016413",3687,236,1702,102,744,46,1944,74,8535
"48113016502",3968,451,1258,354,775,105,2788,276,9975
"48113016509",3355,340,1480,337,492,30,1730,211,7975
"48113016510",4240,665,5223,482,1041,583,3306,1113,16653
"48113016511",1089,31,1358,421,510,196,796,203,4604
"48113016513",2664,156,1664,137,617,5,894,11,6148
"48113016514",2794,22,3527,331,652,69,1551,0,8946
"48113016516",2770,518,829,179,1272,207,2817,639,9231
"48113016517",2078,334,1183,248,233,64,1117,290,5547
"48113016518",2453,118,1423,452,433,34,1505,22,6440
"48113016519",1788,108,452,0,154,6,853,68,3429
"48113016520",2487,700,1736,764,1528,220,2929,768,11132
"48113016521",1161,704,1700,506,352,103,940,335,5801
"48113016522",2089,303,575,75,136,0,728,234,4140
"48113016523",2673,53,1286,17,498,22,679,0,5228
"48113016605",1668,1248,2445,1860,220,14,1216,1209,9880
"48113016606",2657,305,3226,620,164,59,1650,127,8808
"48113016607",209,87,1850,785,274,85,222,136,3648
"48113016610",462,144,2718,690,214,84,249,76,4637
"48113016611",1238,475,3718,686,54,188,447,382,7188
"48113016612",2665,2,10007,288,275,76,1437,67,14817
"48113016615",1120,187,2183,267,154,56,508,82,4557
"48113016616",2137,274,2695,408,340,19,1111,254,7238
"48113016617",1354,20,2863,177,175,0,425,0,5014
"48113016618",1185,92,2102,570,223,64,382,13,4631
"48113016619",1038,93,1968,409,154,128,603,77,4470
"48113016620",1525,178,3035,340,147,0,304,67,5596
"48113016621",996,465,2795,295,194,68,568,483,5864
"48113016622",946,103,2793,212,78,14,512,14,4672
"48113016623",1726,179,3248,605,513,60,1469,212,8012
"48113016624",940,64,1802,78,102,69,615,64,3734
"48113016625",1815,296,6247,506,736,0,1049,263,10912
"48113016626",1179,384,1943,337,326,485,706,638,5998
"48113016701",208,86,4763,1450,27,30,195,105,6864
"48113016703",2397,851,5442,1206,454,124,1911,1056,13441
"48113016704",818,298,2304,434,287,0,761,273,5175
"48113016705",1497,399,3889,931,320,0,1168,209,8413
"48113016802",1281,219,1565,67,133,6,588,191,4050
"48113016803",2000,280,2440,659,298,62,1055,124,6918
"48113016804",1239,14,5823,778,255,122,1105,0,9336
"48113016902",1734,608,1459,254,266,170,1155,668,6314
"48113016903",2082,1044,678,241,146,176,1275,1024,6666
"48113017001",4731,1061,889,119,221,125,1430,447,9023
"48113017003",7095,1122,935,188,403,218,3663,931,14555
"48113017004",4989,1767,722,0,429,650,3745,1908,14210
"48113017101",3019,491,1099,126,321,21,2026,348,7451
"48113017102",2330,544,684,152,531,302,2109,613,7265
"48113017201",2309,1581,867,396,409,114,1788,1462,8926
"48113017202",4187,1434,2009,582,446,122,2973,1034,12787
"48113017301",3745,642,745,171,628,135,2788,668,9522
"48113017303",3995,893,1548,85,765,25,1604,703,9618
"48113017304",5299,972,2322,242,1368,0,2424,922,13549
"48113017305",4486,205,3207,987,1082,0,2054,0,12021
"48113017306",3678,1181,2592,162,296,123,2030,1084,11146
"48113017400",3948,571,648,181,89,0,1547,201,7185
"48113017500",2643,428,533,109,42,175,586,90,4606
"48113017602",2530,675,718,215,76,36,1358,440,6048
"48113017604",2369,75,433,243,115,118,1647,165,5165
"48113017605",1279,265,864,450,690,524,1825,789,6686
"48113017606",2528,553,1015,323,306,0,1825,420,6970
"48113017702",3731,543,1927,896,828,0,1113,173,9211
"48113017703",2413,851,455,656,123,19,1301,508,6326
"48113017704",3114,769,697,300,498,36,2019,545,7978
"48113017804",3683,1102,698,484,665,190,1926,1109,9857
"48113017805",3558,613,1653,446,91,9,2031,531,8932
"48113017806",2535,862,339,174,760,39,1692,742,7143
"48113017807",4728,691,433,112,467,52,2919,327,9729
"48113017808",2805,235,841,35,663,50,813,77,5519
"48113017811",3122,328,376,36,455,23,1381,54,5775
"48113017812",1444,204,324,14,314,54,573,180,3107
"48113017813",2555,279,1838,184,686,192,1134,267,7135
"48113017814",3418,123,645,161,1260,63,1257,6,6933
"48113017900",3407,421,173,306,603,231,2372,532,8045
"48113018001",3592,233,939,354,600,283,1884,71,7956
"48113018002",2164,733,246,17,249,45,1189,388,5031
"48113018104",4793,149,707,0,1310,258,960,13,8190
"48113018105",2082,260,566,319,2300,740,3023,795,10085
"48113018110",3505,275,400,20,592,68,365,114,5339
"48113018111",3092,249,872,712,1301,708,2164,809,9907
"48113018118",3285,273,2125,166,1926,50,1126,135,9086
"48113018120",1761,367,559,28,2465,73,1967,321,7541
"48113018121",2116,188,817,401,2103,196,2223,139,8183
"48113018122",9187,192,1855,60,1877,321,2496,109,16097
"48113018123",4130,334,881,5,1858,288,1786,57,9339
"48113018124",10961,44,3403,0,2215,175,2848,45,19691
"48113018126",3245,168,1267,32,1817,149,2605,114,9397
"48113018127",1526,143,362,29,1162,143,1559,200,5124
"48113018128",2023,296,1053,436,1575,267,2014,440,8104
"48113018129",2176,68,1030,10,748,145,798,151,5126
"48113018130",1906,284,971,303,297,74,823,195,4853
"48113018132",2922,204,687,595,1217,62,1219,56,6962
"48113018133",3087,129,108,0,299,57,1089,110,4879
"48113018134",3850,186,991,0,408,9,683,111,6238
"48113018135",2972,63,757,114,242,0,1001,0,5149
"48113018136",6055,183,577,0,1333,147,1204,37,9536
"48113018137",1635,136,683,97,1168,27,902,10,4658
"48113018138",1631,99,1254,197,1102,327,988,143,5741
"48113018139",4340,818,1067,56,666,261,1306,583,9097
"48113018140",3283,43,916,0,504,533,1076,422,6777
"48113018141",1724,321,745,167,369,110,717,282,4435
"48113018142",1775,53,272,31,981,191,805,203,4311
"48113018203",1876,329,1332,200,2180,538,2774,636,9865
"48113018204",984,231,532,156,1961,734,2732,815,8145
"48113018205",1758,81,431,99,1450,888,2204,787,7698
"48113018206",2174,472,127,31,1564,712,2809,982,8871
"48113018300",2375,418,378,19,3351,593,3835,642,11611
"48113018401",1793,310,300,77,1451,1261,1579,1370,8141
"48113018402",2538,211,186,32,942,0,1487,144,5540
"48113018403",271,78,221,0,223,61,302,107,1263
"48113018501",1590,370,118,165,1145,608,1468,895,6359
"48113018503",1118,586,2114,1404,182,0,833,384,6621
"48113018505",1539,434,1127,237,338,125,1493,279,5572
"48113018506",766,482,1477,310,211,51,694,501,4492
"48113018600",2318,263,104,43,297,484,899,600,5008
"48113018700",2651,381,99,34,2145,1332,3302,1548,11492
"48113018801",1643,262,363,6,1371,937,1652,661,6895
"48113018802",444,124,61,107,209,17,203,58,1223
"48113018900",2393,257,359,160,2478,708,2731,388,9474
"48113019004",3273,311,625,328,1564,165,1561,128,7955
"48113019013",611,482,269,463,1955,1933,2179,2055,9947
"48113019014",1786,699,362,73,2852,2416,2685,1997,12870
"48113019016",757,728,523,351,573,297,373,549,4151
"48113019018",2210,346,611,613,1116,170,797,159,6022
"48113019019",2148,978,2131,809,818,545,1341,894,9664
"48113019020",2166,160,283,43,2207,456,591,101,6007
"48113019021",3266,376,302,240,2277,924,1971,783,10139
"48113019023",3253,126,424,10,916,29,431,0,5189
"48113019024",1977,467,578,16,1350,99,607,266,5360
"48113019025",2667,161,406,72,1778,0,771,163,6018
"48113019026",2566,383,476,27,1593,283,1214,201,6743
"48113019027",1962,149,833,21,2020,173,943,25,6126
"48113019028",1691,197,370,23,1130,185,1128,97,4821
"48113019029",2588,116,476,113,1559,703,1188,179,6922
"48113019031",3633,91,506,42,1402,212,558,159,6603
"48113019032",1243,41,228,43,1891,748,2068,502,6764
"48113019033",1671,212,267,28,1103,1186,1614,1120,7201
"48113019034",1324,255,1615,509,504,226,599,119,5151
"48113019035",1954,792,990,314,395,178,1293,821,6737
"48113019036",2451,77,52,0,353,0,268,0,3201
"48113019037",2534,48,212,0,534,231,749,3,4311
"48113019038",528,17,125,0,109,36,39,0,854
"48113019039",3293,250,533,375,1320,94,491,103,6459
"48113019040",1634,49,1393,139,2308,276,380,16,6195
"48113019041",1703,58,411,0,542,37,293,1,3045
"48113019042",2691,117,771,0,1488,116,815,21,6019
"48113019043",5508,147,322,0,1403,0,410,0,7790
"48113019100",3293,405,514,83,1344,135,1104,52,6930
"48113019202",2721,627,197,130,581,719,1191,932,7098
"48113019203",3138,310,22,0,332,131,275,157,4365
"48113019204",4764,693,637,215,2829,178,4466,739,14521
"48113019205",3177,47,9,0,222,9,117,0,3581
"48113019206",3357,980,69,77,658,733,726,0,6600
"48113019208",1375,374,1031,109,1915,2216,2432,2249,11701
"48113019210",3723,109,0,0,167,0,122,0,4121
"48113019211",3682,394,199,0,634,74,848,230,6061
"48113019212",247,846,44,35,1658,1465,1865,2239,8399
"48113019213",639,377,369,252,871,785,1090,885,5268
"48113019301",2922,0,0,0,38,0,66,0,3026
"48113019302",2117,306,0,0,132,0,243,10,2808
"48113019400",3236,394,0,0,203,125,139,0,4097
"48113019501",7008,111,0,0,199,0,163,59,7540
"48113019502",3931,130,0,0,247,36,87,36,4467
"48113019600",2155,63,0,0,181,10,98,10,2517
"48113019700",1506,68,0,0,63,0,77,9,1723
"48113019800",4249,290,0,0,202,0,345,40,5126
"48113019900",1663,942,157,0,1169,336,2578,1061,7906
"48113020000",2753,53,238,58,1303,3,475,45,4928
"48113020100",1480,243,50,23,417,183,1279,310,3985
"48113020200",200,45,2183,1428,3,112,186,99,4256
"48113020300",147,79,1233,702,12,0,103,25,2301
"48113020400",2272,712,1088,858,666,85,821,151,6653
"48113020500",618,573,1257,1970,373,307,618,637,6353
"48113020600",2273,26,1,0,143,6,218,0,2667
"48113020700",3472,45,304,7,505,0,764,0,5097
"48113980000",0,0,0,0,0,0,0,0,0
"48113980100",0,0,0,0,0,0,0,0,0
"48115950401",3313,328,21,51,553,247,1933,443,6889
"48115950402",1015,462,4,13,233,23,832,442,3024
"48115950500",2521,540,123,33,302,117,1565,593,5794
"48115950600",1185,279,1,65,104,34,396,167,2231
"48117950300",4680,886,90,0,379,98,3100,873,10106
"48117950400",3978,759,0,0,454,328,3105,1087,9711
"48117950500",2032,976,23,22,298,289,2101,1095,6836
"48117950600",3205,251,33,10,218,24,1587,236,5564
"48119950100",2266,388,95,33,178,45,92,73,3170
"48119950200",1403,322,101,217,71,40,109,62,2325
"48121020103",8765,633,34,1,969,126,2066,317,12911
"48121020104",2883,83,204,0,101,0,486,0,3757
"48121020105",6237,161,311,83,1003,0,1277,0,9072
"48121020106",5536,147,438,20,138,0,991,0,7270
"48121020107",4326,252,396,13,319,0,694,29,6029
"48121020108",7597,492,3319,63,1277,0,1828,173,14749
"48121020109",2010,16,318,0,753,4,349,5,3455
"48121020110",3645,105,807,0,914,0,617,0,6088
"48121020111",3670,46,171,0,237,0,662,4,4790
"48121020112",2305,31,365,0,404,52,399,34,3590
"48121020113",6310,101,2024,224,1633,0,2444,32,12768
"48121020114",6278,691,864,115,367,761,2948,448,12472
"48121020115",3565,541,351,0,548,227,923,512,6667
"48121020202",8758,381,77,69,610,38,1727,245,11905
"48121020203",3895,669,369,37,273,0,507,193,5943
"48121020204",3361,241,50,0,146,19,297,14,4128
"48121020205",1557,104,8,0,125,70,303,51,2218
"48121020303",9518,557,20,27,342,13,1068,221,11766
"48121020305",6432,166,228,0,360,0,346,0,7532
"48121020306",5340,244,107,0,858,88,1000,108,7745
"48121020307",8053,284,169,0,668,0,902,35,10111
"48121020308",8611,338,427,0,638,0,1962,18,11994
"48121020309",7340,923,107,8,485,4,755,457,10079
"48121020310",2492,86,56,0,34,0,141,0,2809
"48121020401",5155,789,312,29,638,171,1229,427,8750
"48121020402",3525,403,252,63,509,29,522,29,5332
"48121020403",2296,826,15,43,217,59,265,195,3916
"48121020503",4068,972,612,117,350,315,1223,285,7942
"48121020504",1724,378,274,188,260,69,702,234,3829
"48121020505",6210,201,161,3,93,13,931,0,7612
"48121020506",1762,72,0,0,10,0,398,34,2276
"48121020601",1985,810,166,199,193,498,758,648,5257
"48121020602",5455,1011,608,120,1041,44,2475,695,11449
"48121020700",1269,899,47,134,369,398,118,207,3441
"48121020800",2390,1011,362,666,399,84,471,280,5663
"48121020900",1003,916,19,92,371,388,527,586,3902
"48121021000",1211,1117,57,56,104,273,323,211,3352
"48121021100",903,925,135,132,194,316,178,179,2962
"48121021201",2741,1138,851,587,435,495,883,368,7498
"48121021202",1642,373,706,612,156,50,1072,172,4783
"48121021301",1227,1408,362,203,306,291,381,151,4329
"48121021303",4634,200,584,3,434,605,689,162,7311
"48121021304",4121,400,425,62,391,56,969,256,6680
"48121021305",2852,441,177,40,272,13,369,99,4263
"48121021403",9118,338,270,6,769,28,1596,113,12238
"48121021404",7466,230,421,0,325,36,847,36,9361
"48121021405",6303,1813,446,41,938,0,1980,1210,12731
"48121021406",5754,89,657,0,930,0,1561,0,8991
"48121021407",4507,868,756,24,419,84,1238,574,8470
"48121021408",5260,222,292,50,429,72,575,0,6900
"48121021409",6753,399,131,370,439,173,811,91,9167
"48121021502",3140,709,178,25,389,50,1383,590,6464
"48121021505",4501,393,345,80,798,0,878,279,7274
"48121021512",4238,192,157,0,217,22,301,0,5127
"48121021513",3495,18,0,0,38,0,221,0,3772
"48121021514",4232,9,0,0,54,0,322,0,4617
"48121021515",6080,177,396,0,1573,219,1761,272,10478
"48121021516",4748,223,349,81,1015,53,958,113,7540
"48121021517",977,34,298,0,1295,141,278,80,3103
"48121021518",2397,16,128,0,524,12,126,0,3203
"48121021519",8816,506,1091,433,1954,272,2363,103,15538
"48121021520",3003,183,162,19,356,0,566,11,4300
"48121021521",3075,277,198,0,798,0,884,0,5232
"48121021522",868,15,101,0,383,107,196,5,1675
"48121021523",2568,298,80,0,673,0,1224,164,5007
"48121021524",1434,0,57,0,209,0,124,0,1824
"48121021525",5878,121,600,1,1844,0,845,0,9289
"48121021526",5058,29,550,57,856,16,363,0,6929
"48121021527",4493,229,187,104,798,0,310,159,6280
"48121021611",2960,264,449,9,578,111,811,249,5431
"48121021612",2676,88,186,9,1029,22,835,58,4903
"48121021613",3041,609,517,175,970,185,1877,438,7812
"48121021614",2761,135,259,42,578,17,1714,50,5556
"48121021615",3555,81,87,197,480,45,1890,45,6380
"48121021616",1918,247,631,265,724,50,681,148,4664
"48121021618",3072,773,174,6,508,3,1741,613,6890
"48121021619",1939,394,184,0,287,84,1276,322,4486
"48121021620",1041,58,241,118,291,71,323,0,2143
"48121021621",2643,82,193,0,937,10,314,0,4179
"48121021622",2901,72,391,237,1483,133,464,0,5681
"48121021623",2255,70,611,0,2923,342,443,68,6712
"48121021624",3324,105,1021,0,2189,319,1594,94,8646
"48121021625",3558,13,209,10,1683,7,395,0,5875
"48121021626",1909,150,8,0,38,0,67,0,2172
"48121021627",5294,283,570,0,838,71,457,60,7573
"48121021628",3918,183,576,14,2277,1,1824,2,8795
"48121021629",4139,116,468,16,1386,71,545,10,6751
"48121021630",3074,14,1057,100,713,7,874,0,5839
"48121021631",3705,192,237,45,1309,46,782,58,6374
"48121021632",2571,182,176,168,381,9,275,86,3848
"48121021633",3588,93,199,0,510,71,654,45,5160
"48121021634",2421,458,1494,471,302,165,969,265,6545
"48121021635",1666,470,1101,127,593,105,463,261,4786
"48121021636",3464,431,1815,640,796,98,1124,123,8491
"48121021637",2218,443,791,222,640,77,1164,442,5997
"48121021638",2523,200,554,72,538,47,1321,109,5364
"48121021715",3520,75,312,9,510,68,715,9,5218
"48121021716",3840,522,655,27,158,20,887,344,6453
"48121021717",5200,46,258,0,464,0,1140,0,7108
"48121021718",7727,110,370,0,575,0,936,0,9718
"48121021719",3775,109,179,0,384,22,161,12,4642
"48121021720",2285,9,205,14,759,0,254,0,3526
"48121021721",3616,88,24,0,52,0,380,0,4160
"48121021722",3149,181,132,0,278,96,341,79,4256
"48121021723",989,139,120,0,481,0,317,100,2146
"48121021724",3359,123,237,0,427,0,265,0,4411
"48121021725",3663,15,93,0,109,23,317,23,4243
"48121021726",2822,0,44,18,449,25,387,0,3745
"48121021727",3402,89,132,167,959,13,342,0,5104
"48121021728",1362,295,202,0,98,299,507,438,3201
"48121021729",2425,106,439,9,231,33,321,15,3579
"48121021730",2858,39,172,2,490,6,441,0,4008
"48121021731",2931,101,293,38,403,55,858,8,4687
"48121021732",1228,109,226,0,451,38,468,49,2569
"48121021733",2304,533,326,0,581,34,1130,540,5448
"48121021734",1535,332,448,80,234,198,409,467,3703
"48121021735",2155,105,981,79,407,35,644,51,4457
"48121021736",1326,59,231,8,795,48,348,10,2825
"48121021737",2406,111,344,210,1313,53,633,37,5107
"48121021738",1638,121,167,0,747,17,645,34,3369
"48121021739",1837,456,554,137,476,142,1070,408,5080
"48121021740",3443,275,345,45,415,44,1015,127,5709
"48121021741",1307,63,21,153,266,65,322,76,2273
"48121021742",3949,351,215,37,933,63,955,222,6725
"48121021743",2173,140,317,0,570,39,1515,64,4818
"48121021744",2341,801,112,0,491,50,1440,735,5970
"48121021745",3936,165,62,0,553,412,2039,229,7396
"48121021746",2997,242,60,0,263,4,291,1,3858
"48121021747",3190,107,229,0,695,38,66,18,4343
"48121021748",3561,27,261,0,286,0,274,0,4409
"48121021749",3086,79,6,0,137,17,202,17,3544
"48121021750",3108,0,127,0,428,151,390,0,4204
"48121021751",3645,36,10,0,1357,63,280,0,5391
"48121021752",4315,41,93,0,695,0,569,0,5713
"48121021753",4714,8,141,0,468,25,281,0,5637
"48121021800",3257,48,299,0,552,0,107,0,4263
"48121021900",4062,0,324,0,494,0,227,0,5107
"48123970100",2336,168,157,46,609,166,941,254,4677
"48123970200",1338,370,787,180,1111,356,1394,538,6074
"48123970300",2800,197,90,56,551,137,853,218,4902
"48123970400",3168,349,27,0,243,170,822,236,5015
"48123970500",2113,236,185,22,510,82,763,137,4048
"48125950300",1659,279,29,11,81,41,286,196,2582
"48127950200",6236,1394,29,0,441,57,5743,1418,15318
"48127950400",1508,721,0,1,33,11,1338,493,4105
"48129950200",1430,199,45,107,9,5,91,12,1898
"48129950300",1307,181,40,0,19,8,144,44,1743
"48131950100",2766,847,22,0,405,313,2811,1123,8287
"48131950200",2030,490,0,37,315,49,1960,498,5379
"48131950500",2663,712,0,1,223,161,2604,866,7230
"48133950100",2532,398,79,51,70,17,763,174,4084
"48133950200",4293,1033,17,15,172,44,210,251,6035
"48133950300",3008,958,181,126,178,123,351,209,5134
"48133950400",1441,399,0,0,12,0,224,9,2085
"48133950500",1768,422,0,0,3,0,297,86,2576
"48135000100",2405,423,0,0,353,8,1227,331,4747
"48135000300",1352,375,11,80,211,0,513,72,2614
"48135000400",3583,163,59,41,220,24,1529,82,5701
"48135000500",3074,904,287,68,356,6,1789,592,7076
"48135000600",3791,928,196,0,796,40,2742,744,9237
"48135000700",3364,458,233,72,382,198,2681,330,7718
"48135000800",2844,593,178,7,300,41,2105,455,6523
"48135001000",3824,310,63,1,544,38,2677,159,7616
"48135001100",5163,1127,129,0,520,180,4538,1186,12843
"48135001300",4004,405,0,9,638,98,2782,394,8330
"48135001500",3221,775,72,74,514,185,2885,718,8444
"48135001600",4217,406,48,0,661,192,2400,335,8259
"48135001700",5501,289,449,329,428,235,2219,297,9747
"48135001800",724,711,822,141,479,222,1177,917,5193
"48135001900",2891,1329,327,32,613,684,3409,2028,11313
"48135002000",2198,467,166,365,102,131,2203,543,6175
"48135002200",2657,549,5,0,192,144,2091,653,6291
"48135002300",3036,121,240,19,208,0,986,8,4618
"48135002400",4183,233,68,60,253,16,1254,132,6199
"48135002501",3627,148,72,8,467,0,1768,40,6130
"48135002502",4897,486,210,0,516,22,1599,408,8138
"48135002503",4422,443,77,79,606,371,1669,634,8301
"48135002700",7290,1146,8,15,581,297,3722,782,13841
"48135002801",3196,570,45,0,281,90,2655,567,7404
"48135002802",7025,1179,0,31,697,227,5100,1054,15313
"48135002900",3534,37,49,0,179,0,1181,15,4995
"48135003000",6628,744,655,0,888,32,3512,478,12937
"48135003100",2430,470,65,16,263,71,2335,367,6017
"48137950300",1687,302,0,0,9,19,708,286,3011
"48139060101",4820,667,787,116,596,275,1717,590,9568
"48139060102",5335,723,149,6,953,347,2495,711,10719
"48139060204",7353,305,1149,105,373,46,1752,184,11267
"48139060206",4195,747,906,0,341,176,1865,533,8763
"48139060207",4458,392,301,74,640,103,1044,137,7149
"48139060208",3026,113,554,0,278,0,365,37,4373
"48139060209",3003,176,342,0,167,0,383,0,4071
"48139060210",1375,9,33,0,27,6,222,6,1678
"48139060211",2802,102,66,22,132,10,464,8,3606
"48139060212",3795,120,359,0,606,25,918,31,5854
"48139060213",5233,379,55,3,549,59,850,265,7393
"48139060214",6908,42,314,0,347,32,801,56,8500
"48139060300",2780,282,318,119,547,174,838,275,5333
"48139060400",1441,366,1279,867,255,85,566,288,5147
"48139060500",2411,606,120,33,225,65,926,410,4796
"48139060600",5313,760,832,207,360,13,1165,455,9105
"48139060701",1777,100,55,0,95,22,698,41,2788
"48139060702",3035,200,347,13,335,0,438,0,4368
"48139060703",1500,146,200,9,78,35,175,61,2204
"48139060801",6071,161,24,6,75,2,561,0,6900
"48139060802",5499,329,120,134,72,92,227,260,6733
"48139060803",956,201,347,0,23,0,178,121,1826
"48139060900",4701,563,62,2,483,15,1105,264,7195
"48139061000",3016,439,357,77,255,11,535,198,4888
"48139061100",3492,554,91,1,433,321,983,687,6562
"48139061200",1418,213,122,13,138,50,527,164,2645
"48139061300",1675,575,34,0,112,24,308,495,3223
"48139061400",6721,637,129,11,444,115,1554,331,9942
"48139061500",1721,1223,555,362,748,465,1426,1455,7955
"48139061600",2499,1054,820,353,745,320,1680,854,8325
"48139061700",4132,689,76,0,125,0,803,454,6279
"48141000101",5175,1076,471,12,398,44,3625,1039,11840
"48141000106",4177,402,889,31,669,48,3102,325,9643
"48141000107",3970,688,413,73,518,43,3598,561,9864
"48141000108",1391,705,280,14,213,76,927,741,4347
"48141000109",2228,1319,78,7,167,88,2021,1367,7275
"48141000110",2523,946,254,85,209,110,2095,847,7069
"48141000111",1851,227,379,30,278,15,947,200,3927
"48141000112",3037,869,115,21,217,71,2225,685,7240
"48141000204",3260,862,268,8,343,247,2469,788,8245
"48141000205",2059,1019,177,112,175,104,1665,1074,6385
"48141000206",3577,767,118,0,240,92,3058,799,8651
"48141000207",3103,1095,240,52,200,41,2378,1020,8129
"48141000208",2019,1097,80,8,178,13,1637,985,6017
"48141000301",3474,2428,305,83,458,76,3234,2322,12380
"48141000302",3136,1860,132,11,343,207,3059,1945,10693
"48141000401",4760,312,430,34,665,135,3329,357,10022
"48141000403",1827,503,141,62,240,77,1636,568,5054
"48141000404",1618,2038,70,69,85,56,1466,2080,7482
"48141000600",2670,977,147,35,469,80,2752,987,8117
"48141000800",3142,2122,26,69,122,242,3098,2243,11064
"48141000900",5722,1867,242,58,808,571,5114,2382,16764
"48141001001",2088,886,59,0,116,122,2107,990,6368
"48141001002",2281,1203,0,0,519,72,2713,1237,8025
"48141001104",4905,547,86,46,1588,447,4189,791,12599
"48141001107",5732,431,157,0,629,254,4143,647,11993
"48141001109",3690,182,126,1,464,214,2052,349,7078
"48141001110",3368,586,56,14,917,246,2615,730,8532
"48141001111",2724,559,180,47,688,446,2090,910,7644
"48141001112",3901,279,52,9,520,100,2601,376,7838
"48141001113",5316,436,100,0,1128,458,4555,744,12737
"48141001114",2594,1097,36,9,676,579,2378,1535,8904
"48141001115",1341,497,59,21,541,1255,1643,1747,7104
"48141001201",2292,1051,66,52,607,1098,2734,2093,9993
"48141001202",2988,574,81,0,1087,365,3215,713,9023
"48141001203",451,196,0,0,23,78,454,267,1469
"48141001301",2646,211,13,15,706,79,1803,232,5705
"48141001302",5880,400,0,0,1036,1,4129,244,11690
"48141001400",934,571,8,9,269,212,879,625,3507
"48141001501",3946,527,38,0,746,339,3299,576,9471
"48141001502",1737,182,22,0,348,165,924,248,3626
"48141001600",1724,1184,39,35,349,777,1672,1795,7575
"48141001700",164,203,4,0,55,38,198,229,891
"48141001800",468,565,0,0,38,116,506,644,2337
"48141001900",939,1262,0,15,55,257,985,1526,5039
"48141002000",849,1276,22,4,60,112,859,1384,4566
"48141002100",675,1384,21,46,101,272,736,1557,4792
"48141002201",1636,729,62,59,318,185,1606,883,5478
"48141002202",1800,1178,52,39,392,381,2096,1521,7459
"48141002300",3048,1237,4,0,164,126,2682,1299,8560
"48141002400",2347,790,0,48,169,87,2147,865,6453
"48141002500",4146,1156,74,35,481,199,4096,1271,11458
"48141002600",1976,1371,29,23,127,13,2068,1384,6991
"48141002800",1506,2896,66,8,245,546,1700,3413,10380
"48141002900",495,489,1,1,99,64,588,551,2288
"48141003000",2049,1733,158,2,111,218,2148,1918,8337
"48141003100",2438,1134,34,0,85,155,2544,1167,7557
"48141003200",1466,765,0,6,197,98,1639,824,4995
"48141003300",3473,939,52,0,436,55,3572,929,9456
"48141003402",3844,2018,413,35,388,391,3750,2337,13176
"48141003403",4331,277,282,38,634,65,3798,302,9727
"48141003404",4714,596,148,15,918,56,4115,448,11010
"48141003501",1832,496,25,1,75,15,1722,511,4677
"48141003502",2451,1217,0,77,324,812,2571,1975,9427
"48141003601",2109,1349,173,0,237,194,2309,1522,7893
"48141003602",1602,739,0,42,132,86,1709,832,5142
"48141003701",2556,891,73,7,350,641,2877,1539,8934
"48141003702",2739,984,0,8,328,405,3004,1343,8811
"48141003801",3715,969,13,0,820,88,4473,1022,11100
"48141003803",1644,700,31,0,395,75,1999,716,5560
"48141003804",2576,1076,0,0,128,229,2556,1295,7860
"48141003901",2456,731,0,6,543,22,2915,752,7425
"48141003902",1304,612,0,3,554,141,1632,730,4976
"48141003903",2844,2907,0,0,412,982,3116,3862,14123
"48141004002",6234,1247,0,0,1334,60,7535,1218,17628
"48141004003",5348,1480,0,35,816,144,5999,1633,15455
"48141004004",3799,1703,25,0,528,107,4199,1681,12042
"48141004103",4057,1866,70,33,394,198,4128,2039,12785
"48141004104",4011,1428,17,1,689,297,4506,1669,12618
"48141004105",2475,647,0,52,232,281,2638,951,7276
"48141004106",2782,1610,39,27,538,269,3092,1881,10238
"48141004107",1046,207,0,0,242,33,1159,235,2922
"48141004201",3529,1364,91,30,298,467,3734,1814,11327
"48141004202",3563,1366,98,80,417,198,3795,1349,10866
"48141004303",4822,278,60,20,749,225,4093,395,10642
"48141004307",4073,917,106,2,308,20,3121,840,9387
"48141004309",4265,853,123,15,610,238,4156,970,11230
"48141004310",3158,1260,61,28,560,265,3152,1453,9937
"48141004311",3307,364,45,31,438,219,2934,489,7827
"48141004312",3977,1081,34,46,446,50,3651,1098,10383
"48141004313",1707,652,299,1,356,308,1775,843,5941
"48141004314",4156,234,18,0,618,32,4161,232,9451
"48141004316",5082,868,56,0,402,0,4962,868,12238
"48141004317",2782,300,153,104,295,517,1869,805,6825
"48141004318",3708,117,42,78,290,179,3244,295,7953
"48141004319",4253,692,177,0,695,90,4165,760,10832
"48141004320",2561,332,39,0,264,37,2651,357,6241
"48141010101",1133,24,512,20,187,14,291,0,2181
"48141010102",1476,267,281,217,183,0,571,86,3081
"48141010103",869,132,263,0,104,67,279,38,1752
"48141010203",1424,440,15,0,685,544,2058,933,6099
"48141010207",4761,562,641,67,419,100,3000,480,10030
"48141010210",5115,352,1011,191,786,109,2954,328,10846
"48141010211",2477,50,258,92,238,0,1582,38,4735
"48141010212",4560,245,807,100,736,18,3599,189,10254
"48141010213",5187,285,366,0,1460,13,3800,289,11400
"48141010214",4706,341,21,0,1398,32,3284,172,9954
"48141010215",4937,389,16,17,1547,17,4713,252,11888
"48141010216",3765,1500,78,51,1321,833,4460,2260,14268
"48141010217",4494,170,110,97,731,28,3886,267,9783
"48141010218",2359,193,49,0,699,0,2267,143,5710
"48141010219",5912,420,127,0,1483,219,5437,559,14157
"48141010220",1410,860,4,0,1115,925,2441,1746,8501
"48141010221",2962,1023,373,12,1098,1021,3785,1949,12223
"48141010222",1473,220,0,0,198,195,1428,285,3799
"48141010303",2302,394,145,1,477,83,2128,417,5947
"48141010307",3456,1660,243,28,532,232,3325,1669,11145
"48141010311",5668,712,237,1,681,136,5204,807,13446
"48141010312",2993,764,96,0,439,87,2840,636,7855
"48141010316",3102,1023,89,0,177,60,2791,1032,8274
"48141010317",3203,501,83,8,504,70,3278,494,8141
"48141010319",407,119,71,0,29,0,350,119,1095
"48141010322",3468,1169,14,0,308,223,3110,1324,9616
"48141010323",3805,488,27,0,119,22,3373,257,8091
"48141010324",6786,632,407,16,1227,211,7696,767,17742
"48141010325",5801,1269,86,12,902,122,6181,1301,15674
"48141010326",3718,725,16,0,294,0,2838,708,8299
"48141010327",3016,272,87,0,218,165,2804,437,6999
"48141010328",2810,135,221,0,193,49,2495,184,6087
"48141010329",4137,788,28,0,210,144,3815,924,10046
"48141010330",7529,1704,776,53,996,239,7083,1996,20376
"48141010331",8022,1810,646,0,865,270,7563,1648,20824
"48141010332",4648,2892,120,81,494,147,4252,3006,15640
"48141010333",3095,1454,0,0,268,14,3324,1425,9580
"48141010334",2744,993,0,0,149,55,2855,1026,7822
"48141010335",1828,1721,0,0,267,0,1997,1710,7523
"48141010336",4884,766,0,0,928,96,5363,850,12887
"48141010337",5295,1058,71,0,340,65,5326,1123,13278
"48141010338",5839,628,45,0,482,18,4943,609,12564
"48141010339",4029,1747,49,0,291,151,3925,1818,12010
"48141010340",1027,900,0,0,117,101,1006,1001,4152
"48141010341",17266,3101,1118,495,2199,109,17364,3241,44893
"48141010342",10438,1003,564,14,1193,424,10517,1241,25394
"48141010343",5617,330,131,14,732,177,4802,397,12200
"48141010344",1947,757,0,0,392,103,2322,853,6374
"48141010345",4723,1456,9,0,1066,320,5225,1750,14549
"48141010346",2320,1601,0,7,516,539,2651,2127,9761
"48141010347",1870,873,0,73,484,1368,2248,2300,9216
"48141010401",3403,1540,0,5,878,237,3979,1744,11786
"48141010404",2330,969,9,5,809,340,2986,1277,8725
"48141010405",2824,1448,0,0,1510,492,4247,1842,12363
"48141010406",1367,899,0,0,816,892,2183,1791,7948
"48141010407",2908,2208,0,0,1223,1445,4131,3648,15563
"48141010408",2314,796,0,0,427,359,2616,1145,7657
"48141010409",3234,1900,24,0,969,194,4150,2086,12557
"48141010501",1605,1554,0,39,615,407,2105,1993,8318
"48141010502",1140,890,0,64,0,43,967,997,4101
"48141010504",877,611,0,0,141,102,1013,713,3457
"48141010505",1059,1166,0,0,844,327,1875,1408,6679
"48141010506",1831,1538,0,7,40,356,1871,1901,7544
"48141010600",3626,343,1390,111,1056,132,986,238,7882
"48141980000",0,0,0,0,0,0,0,0,0
"48143950100",2927,217,0,0,84,0,260,25,3513
"48143950201",2068,574,0,0,278,383,659,451,4413
"48143950202",5105,1243,0,0,355,100,439,463,7705
"48143950300",4405,943,0,1,342,24,1636,453,7804
"48143950400",3027,1634,28,93,386,39,402,341,5950
"48143950500",5035,1800,66,40,294,59,886,374,8554
"48143950600",1624,1335,108,55,172,131,329,210,3964
"48143950700",2008,311,0,0,255,0,489,152,3215
"48145000200",1997,326,138,112,129,7,621,180,3510
"48145000300",1233,757,592,463,189,58,642,536,4470
"48145000400",251,60,896,409,30,23,187,23,1879
"48145000500",1953,374,100,146,102,8,300,121,3104
"48145000700",1932,274,274,175,88,23,324,135,3225
"48145000800",1980,175,402,56,16,0,210,33,2872
"48147950100",2223,399,112,215,43,50,346,107,3495
"48147950300",2201,341,23,2,268,18,113,25,2991
"48147950401",1465,527,66,113,111,23,244,119,2668
"48147950402",4463,1041,79,247,33,81,440,10,6394
"48147950500",1783,252,166,125,87,50,46,7,2516
"48147950600",2089,219,34,12,130,32,85,35,2636
"48147950701",3409,452,120,33,141,168,159,242,4724
"48147950702",2684,460,152,28,142,34,293,190,3983
"48147950800",3150,540,127,0,163,17,165,105,4267
"48149970100",1495,128,145,6,21,0,81,6,1882
"48149970200",1834,217,382,39,41,0,205,15,2733
"48149970300",4154,833,216,131,68,76,1178,469,7125
"48149970400",3092,330,137,14,0,31,505,28,4137
"48149970500",3029,379,158,41,185,36,983,172,4983
"48149970600",4163,314,274,80,37,8,820,128,5824
"48149970700",1903,119,90,5,0,0,108,10,2235
"48151950300",1439,152,24,0,21,15,189,115,1955
"48151950400",1593,277,47,39,173,57,615,139,2940
"48153950500",1848,463,42,2,71,41,924,395,3786
"48153950600",2574,813,66,64,165,31,1386,710,5809
"48155950100",931,78,11,0,103,0,130,35,1288
"48157670101",2138,1165,2435,504,1178,892,3102,2057,13471
"48157670102",315,156,1878,112,712,176,1018,306,4673
"48157670200",1482,325,4339,436,1410,224,2603,534,11353
"48157670300",449,48,2682,199,103,275,478,268,4502
"48157670400",450,106,4154,483,151,0,359,104,5807
"48157670500",656,2,2416,349,536,128,687,151,4925
"48157670601",552,133,7386,476,731,18,896,133,10325
"48157670602",100,79,1061,267,298,18,346,73,2242
"48157670700",897,39,1774,98,907,127,745,13,4600
"48157670800",1987,645,9878,487,1954,268,2882,814,18915
"48157670901",3121,32,4297,42,3725,48,1208,0,12473
"48157670902",791,71,3376,200,769,231,1154,285,6877
"48157671001",3679,338,893,70,465,14,675,120,6254
"48157671002",2630,411,2904,252,545,12,1285,263,8302
"48157671100",2580,1104,3032,180,1288,402,2233,1395,12214
"48157671200",1860,469,2704,595,556,198,1574,576,8532
"48157671300",1485,148,803,326,782,28,1067,134,4773
"48157671400",2165,642,1559,50,3665,506,1352,322,10261
"48157671501",2472,16,1606,225,2916,126,822,14,8197
"48157671502",426,21,389,28,743,9,268,0,1884
"48157671601",3296,82,446,61,2422,34,685,0,7026
"48157671602",1896,113,74,0,1056,112,160,0,3411
"48157671700",3282,178,523,37,946,32,306,5,5309
"48157671800",1521,38,704,0,714,16,469,0,3462
"48157671900",2558,163,151,16,738,82,736,84,4528
"48157672001",1935,714,762,250,4205,321,881,167,9235
"48157672002",1905,386,1317,235,1445,553,550,377,6768
"48157672100",2233,56,54,0,876,92,142,0,3453
"48157672200",2501,183,246,109,384,0,819,97,4339
"48157672301",2613,2,1427,73,3628,466,2274,154,10637
"48157672302",4954,411,351,0,2880,77,1546,151,10370
"48157672400",3796,1208,783,208,2873,751,3084,1572,14275
"48157672500",2162,342,1766,241,2705,270,2055,519,10060
"48157672601",3849,798,1904,448,2650,414,5042,1023,16128
"48157672602",2120,69,2138,307,1910,269,2339,60,9212
"48157672701",3301,696,3163,270,6759,1486,3117,1748,20540
"48157672702",3325,89,1373,297,1740,283,1082,0,8189
"48157672800",2179,156,1228,320,3121,294,816,102,8216
"48157672900",13867,779,8768,996,9244,1244,8219,453,43570
"48157673001",5783,165,352,0,1451,16,574,73,8414
"48157673002",4840,213,587,179,3160,16,1654,87,10736
"48157673003",8692,312,367,0,3413,153,1970,147,15054
"48157673101",32436,614,3263,78,9278,476,7292,257,53694
"48157673102",12785,147,850,0,3347,0,2931,73,20133
"48157673200",6367,210,532,249,737,31,1251,47,9424
"48157673300",4009,77,230,12,202,75,485,117,5207
"48157673400",12685,265,2056,0,1690,160,2794,78,19728
"48157673500",6632,128,757,114,685,0,1097,0,9413
"48157673600",6653,174,26,12,85,149,1122,150,8371
"48157673700",7,3,0,2,0,1,0,0,13
"48157673800",3787,261,908,91,4252,88,1789,220,11396
"48157673901",4608,291,293,14,3752,0,469,0,9427
"48157673902",1811,37,608,0,6605,154,385,6,9606
"48157674000",4518,88,170,0,2925,272,939,1,8913
"48157674100",4542,97,482,1,1808,0,948,0,7878
"48157674200",3053,165,58,0,2369,7,270,12,5934
"48157674300",3455,0,1217,0,4172,166,1116,0,10126
"48157674400",4377,143,400,0,7675,60,1017,0,13672
"48157674501",3124,60,2561,2,2405,11,651,1,8815
"48157674502",9958,374,4578,705,2401,574,1340,729,20659
"48157674601",3003,31,142,0,500,0,283,7,3966
"48157674602",6216,36,257,40,1155,83,1207,62,9056
"48157674603",4429,429,602,29,381,56,1994,169,8089
"48157674604",2244,92,1071,203,1443,42,1238,82,6415
"48157674700",4829,264,2501,19,2568,708,1701,447,13037
"48157674800",3318,940,431,422,130,58,2244,826,8369
"48157674900",2778,1211,516,226,448,180,3046,1343,9748
"48157675000",2011,521,305,131,100,141,1831,594,5634
"48157675100",6571,1357,876,421,1047,151,3940,1204,15567
"48157675200",4454,1129,161,232,218,24,3490,967,10675
"48157675300",4414,782,184,399,830,212,3510,740,11071
"48157675400",4808,1236,466,51,57,101,2597,929,10245
"48157675500",7718,622,2424,22,2236,155,4678,567,18422
"48157675600",5062,694,0,7,162,33,1772,552,8282
"48157675700",4962,569,562,38,122,0,876,357,7486
"48157675800",2424,185,390,213,14,58,1313,141,4738
"48159950100",4763,283,17,0,114,0,291,0,5468
"48159950200",1681,383,174,269,177,34,367,84,3169
"48159950300",2090,448,0,0,8,25,313,287,3171
"48161000100",3728,940,456,60,148,85,392,689,6498
"48161000200",994,72,110,6,28,16,142,56,1424
"48161000300",511,75,329,86,4,0,174,35,1214
"48161000400",1771,192,303,132,51,12,81,20,2562
"48161000600",2792,171,103,4,111,1,167,48,3397
"48161000700",2072,431,367,136,50,40,293,95,3484
"48161000900",744,273,338,347,13,6,47,225,1993
"48163950100",4478,560,181,1,398,500,3635,921,10674
"48163950200",3354,1034,0,0,1025,216,3772,1084,10485
"48163950300",1850,851,0,0,416,97,1714,911,5839
"48165950100",2576,683,82,1,217,123,1833,746,6261
"48165950200",7360,1063,108,0,253,261,1179,443,10667
"48165950300",4556,474,90,0,391,122,2561,296,8490
"48167720100",4652,375,187,0,237,79,663,19,6212
"48167720200",3900,182,26,0,456,0,520,0,5084
"48167720301",1813,79,69,0,86,51,278,22,2398
"48167720302",6902,318,78,0,274,0,863,210,8645
"48167720400",5387,131,149,0,569,23,716,2,6977
"48167720501",2950,110,276,42,380,8,436,0,4202
"48167720502",8422,765,569,53,1154,175,2255,17,13410
"48167720503",11060,294,942,0,1423,166,2256,17,16158
"48167720600",9945,690,1458,200,1023,171,3327,498,17312
"48167720700",7425,118,609,88,1624,27,2114,20,12025
"48167720800",2126,481,624,21,278,91,251,462,4334
"48167720900",3227,770,697,137,308,13,971,655,6778
"48167721000",1263,257,8,0,136,15,328,161,2168
"48167721100",7541,1408,1198,221,503,351,3629,1327,16178
"48167721201",13800,273,1638,176,1611,848,2816,844,22006
"48167721202",3098,35,394,30,437,132,213,9,4348
"48167721300",3916,198,201,53,317,67,1060,133,5945
"48167721400",6439,177,279,67,353,81,610,20,8026
"48167721500",5984,191,71,37,402,24,833,3,7545
"48167721600",1323,285,0,0,200,12,512,156,2488
"48167721700",5197,1668,163,14,633,467,1357,1389,10888
"48167721800",2891,783,12,81,490,114,650,323,5344
"48167721900",4322,759,1847,576,587,18,1830,280,10219
"48167722001",4192,452,124,250,257,38,1191,378,6882
"48167722002",2601,635,457,162,142,29,1295,386,5707
"48167722100",5525,349,414,38,367,168,1601,364,8826
"48167722200",1231,551,566,394,88,188,560,415,3993
"48167722300",3758,1201,539,664,400,209,1733,842,9346
"48167722600",615,199,687,202,180,13,376,84,2356
"48167722700",969,56,2210,1011,0,0,395,0,4641
"48167722800",1179,324,555,145,195,53,645,252,3348
"48167722900",1599,401,237,165,141,121,740,433,3837
"48167723000",801,321,1450,383,109,68,454,78,3664
"48167723100",1498,347,1147,200,181,0,401,210,3984
"48167723200",1842,266,1547,367,69,51,424,16,4582
"48167723300",4803,332,221,0,184,1,724,58,6323
"48167723400",6447,355,0,0,279,0,1036,33,8150
"48167723501",785,174,0,0,68,0,71,92,1190
"48167723502",7828,621,0,0,503,31,1289,116,10388
"48167723600",3477,532,471,216,107,0,1021,292,6116
"48167723700",817,210,361,630,31,0,346,165,2560
"48167723800",3583,258,219,84,98,0,393,0,4635
"48167723900",1807,116,0,0,0,2,75,21,2021
"48167724000",284,239,11,23,31,3,140,100,831
"48167724101",538,249,109,53,63,10,86,205,1313
"48167724200",1340,526,198,154,643,204,189,122,3376
"48167724300",1185,461,432,78,239,114,175,227,2911
"48167724400",1390,804,503,203,206,41,573,305,4025
"48167724500",404,109,78,54,70,21,76,41,853
"48167724600",304,146,379,961,20,9,164,169,2152
"48167724700",460,192,534,404,100,27,371,154,2242
"48167724800",843,174,127,222,22,43,290,101,1822
"48167724900",1308,304,222,76,18,4,533,146,2611
"48167725000",1603,186,183,129,90,0,852,138,3181
"48167725100",613,287,435,164,66,42,367,219,2193
"48167725200",750,404,323,224,74,14,629,345,2763
"48167725300",1501,248,420,47,64,7,897,117,3301
"48167725400",2707,154,218,263,256,48,2033,143,5822
"48167725500",912,4,68,0,140,5,253,0,1382
"48167725600",1845,648,539,103,343,84,699,265,4526
"48167725700",1911,138,20,42,160,0,537,115,2923
"48167725800",2141,667,288,206,318,29,921,364,4934
"48167725900",1451,341,145,9,126,59,327,116,2574
"48167726000",1296,36,43,0,84,5,250,5,1719
"48167726100",2129,205,9,0,37,0,212,9,2601
"48167726200",1515,315,792,199,60,37,750,185,3853
"48167990000",0,0,0,0,0,0,0,0,0
"48169950100",3193,372,185,4,197,115,1140,279,5485
"48171950100",3362,218,0,0,91,0,426,65,4162
"48171950200",3525,392,0,0,116,25,359,42,4459
"48171950300",5570,1235,45,1,240,1,1034,350,8476
"48171950400",5482,898,0,0,179,41,1286,619,8505
"48171950500",2727,453,0,0,129,6,655,327,4297
"48173950100",1101,46,0,0,43,0,346,0,1536
"48175960100",2832,275,192,21,529,307,813,376,5345
"48175960200",1893,435,46,62,570,65,1110,227,4408
"48177000100",1352,231,107,221,1324,167,1410,188,5000
"48177000200",3012,220,241,37,799,281,1309,335,6234
"48177000300",1076,220,361,198,781,833,1053,931,5453
"48177000400",1312,370,51,7,192,262,779,419,3392
"48177000500",1807,485,50,22,1118,282,1688,610,6062
"48177000600",1243,153,8,23,522,270,553,276,3048
"48179950100",2547,211,9,5,143,28,286,19,3248
"48179950300",3617,446,45,0,196,6,361,254,4925
"48179950400",4067,362,44,0,267,6,734,132,5612
"48179950500",2264,384,67,0,173,101,838,362,4189
"48179950600",1222,332,11,34,244,107,657,234,2841
"48179950700",1305,465,30,0,280,67,541,203,2891
"48179950800",1009,253,201,31,378,28,621,84,2605
"48181000101",3795,382,16,115,204,71,155,6,4744
"48181000102",2353,295,191,103,91,6,38,8,3085
"48181000200",1380,534,73,134,141,89,175,22,2548
"48181000302",3662,420,6,0,274,73,170,17,4622
"48181000303",3806,395,17,45,155,45,163,0,4626
"48181000304",2883,338,0,0,37,0,70,88,3416
"48181000400",1734,926,161,12,418,82,233,126,3692
"48181000501",1420,577,561,86,100,107,173,220,3244
"48181000502",776,162,55,24,174,52,207,61,1511
"48181000600",2793,400,14,23,205,92,106,45,3678
"48181000700",2466,742,527,108,270,168,304,137,4722
"48181000800",5103,557,67,12,80,28,229,63,6139
"48181000901",2547,406,64,0,212,45,94,26,3394
"48181000902",4191,850,522,378,199,265,290,270,6965
"48181001101",3090,323,26,26,174,42,184,178,4043
"48181001102",5178,956,49,0,182,74,478,112,7029
"48181001200",4250,665,264,93,907,18,963,51,7211
"48181001300",2424,433,240,111,445,0,433,24,4110
"48181001400",2598,630,500,114,148,100,769,196,5055
"48181001500",3707,1208,501,647,611,450,1340,970,9434
"48181001700",3207,394,329,28,545,74,908,84,5569
"48181001801",5396,533,10,0,393,246,473,29,7080
"48181001802",4483,372,26,47,126,0,122,75,5251
"48181001803",4854,375,12,11,241,0,342,15,5850
"48181001900",8873,774,62,0,438,109,1198,305,11759
"48181002000",1407,447,280,126,525,198,1233,340,4556
"48183000200",3827,855,586,204,166,77,945,428,7088
"48183000300",3606,480,756,31,212,22,501,31,5639
"48183000401",2184,338,129,98,283,24,216,23,3295
"48183000402",2295,225,173,418,57,8,213,21,3410
"48183000501",4622,68,236,38,313,0,260,0,5537
"48183000502",2665,367,805,346,243,91,204,137,4858
"48183000600",6440,215,501,102,290,26,405,0,7979
"48183000700",3392,556,332,184,528,11,526,165,5694
"48183000800",4494,1239,675,318,525,131,1367,940,9689
"48183000900",1992,279,287,317,114,20,880,62,3951
"48183001000",1471,477,250,210,57,28,761,270,3524
"48183001100",1220,403,588,605,134,26,495,96,3567
"48183001200",924,536,892,474,110,67,954,566,4523
"48183001300",1265,714,1224,914,165,41,1250,542,6115
"48183001400",980,317,1753,713,315,37,671,282,5068
"48183001500",1264,617,1847,456,34,12,763,427,5420
"48183010100",5505,348,827,88,169,0,772,166,7875
"48183010200",4470,1397,562,507,240,73,265,280,7794
"48183010301",3671,589,290,487,146,44,368,218,5813
"48183010302",4231,623,98,199,51,139,302,366,6009
"48183010400",5544,924,557,335,232,76,808,543,9019
"48183010500",2558,669,1357,557,96,3,498,138,5876
"48183010600",4371,436,313,509,540,19,336,16,6540
"48183010700",2198,718,495,260,320,106,1014,328,5439
"48183980000",0,0,0,0,0,0,0,0,0
"48185180101",1598,535,779,617,641,56,1427,398,6051
"48185180102",2834,926,129,27,438,78,424,124,4980
"48185180200",3547,724,714,201,383,46,1471,413,7499
"48185180301",4357,250,117,319,521,23,592,18,6197
"48185180302",2550,440,174,138,131,10,267,53,3763
"48185180400",172,29,18,15,6,0,2,16,258
"48187210100",2623,551,166,65,920,256,2509,726,7816
"48187210200",2544,1334,326,172,220,163,2486,1287,8532
"48187210300",2630,1206,498,254,338,222,1780,1161,8089
"48187210400",3321,400,314,162,162,91,1371,272,6093
"48187210504",4368,507,84,61,713,2,1738,291,7764
"48187210505",2753,696,154,11,1097,147,3532,705,9095
"48187210506",2264,370,100,36,289,3,963,45,4070
"48187210507",4300,288,95,0,244,82,1455,205,6669
"48187210508",2059,105,4,0,226,22,892,98,3406
"48187210603",1586,108,80,4,108,11,570,86,2553
"48187210604",7440,455,761,0,789,68,2278,213,12004
"48187210606",2730,292,47,14,248,41,817,260,4449
"48187210607",7144,206,287,8,593,202,2745,236,11421
"48187210608",3159,251,165,0,260,95,1813,223,5966
"48187210705",2065,235,307,20,360,0,666,19,3672
"48187210706",4150,465,124,32,467,70,1427,128,6863
"48187210707",3746,70,484,3,190,188,1217,154,6052
"48187210708",4634,118,456,0,883,0,1578,69,7738
"48187210709",3498,168,238,25,674,25,1089,147,5864
"48187210710",2924,179,321,2,325,31,840,0,4622
"48187210711",2143,22,391,50,618,0,810,5,4039
"48187210712",4055,134,475,22,287,22,1156,1,6152
"48187210713",3349,62,670,47,712,0,1399,47,6286
"48187210714",5629,375,978,153,485,75,2580,172,10447
"48187210801",4458,303,133,27,89,0,1498,38,6546
"48187210803",3100,162,185,28,420,44,995,47,4981
"48187210804",3463,158,37,0,521,0,986,16,5181
"48187210901",4744,551,94,75,170,138,1191,264,7227
"48187210902",2790,213,58,0,212,113,792,143,4321
"48189950100",2476,1521,110,80,588,197,2271,1616,8859
"48189950200",1905,1138,112,167,439,334,2108,1315,7518
"48189950300",4477,768,20,8,382,262,1756,579,8252
"48189950400",3019,518,128,44,545,71,2081,498,6904
"48189950500",2075,791,7,55,303,15,1310,548,5104
"48189950600",1992,229,0,0,298,17,862,171,3569
"48189950700",2411,843,20,40,125,28,1434,612,5513
"48189950800",1105,300,2,27,63,29,629,231,2386
"48189950900",2246,321,3,2,187,171,1086,385,4401
"48191950500",2079,596,137,93,217,84,707,371,4284
"48193950100",2551,310,11,3,5,14,279,38,3211
"48193950200",1790,193,0,8,26,0,128,8,2153
"48193950300",2675,423,0,0,16,17,254,143,3528
"48195950100",1304,263,0,0,93,0,433,215,2308
"48195950300",2732,711,0,0,302,56,1212,606,5619
"48197950100",2686,688,176,193,196,74,465,380,4858
"48199030100",3040,423,0,2,211,0,221,2,3899
"48199030200",4546,221,121,16,255,5,190,0,5354
"48199030300",7796,1236,446,0,344,0,265,80,10167
"48199030400",1564,327,259,125,71,9,242,7,2604
"48199030501",3789,428,80,32,110,30,83,0,4552
"48199030502",7940,656,0,0,160,12,405,12,9185
"48199030600",3371,209,0,0,23,19,185,9,3816
"48199030700",2042,570,681,204,98,68,184,195,4042
"48199030800",2783,259,396,817,421,12,352,38,5078
"48199030900",3901,486,0,0,65,0,107,26,4585
"48199031000",3497,450,8,0,68,0,83,0,4106
"48201100000",2102,313,120,203,227,18,236,78,3297
"48201210100",73,0,44,0,0,0,0,0,117
"48201210400",2609,1414,192,752,186,117,2603,1457,9330
"48201210500",2371,1233,344,727,559,218,2812,1341,9605
"48201210600",4256,781,28,13,606,20,3986,683,10373
"48201210700",735,714,345,100,270,60,817,762,3803
"48201210800",858,658,394,316,147,140,841,805,4159
"48201210900",57,152,906,168,62,136,0,287,1768
"48201211000",269,146,875,439,179,0,443,133,2484
"48201211100",1293,1472,1362,1540,211,93,1448,1464,8883
"48201211200",389,429,1011,784,48,26,436,455,3578
"48201211300",877,561,1592,1819,170,59,1176,522,6776
"48201211400",1053,157,1085,1171,312,10,1066,177,5031
"48201211500",3560,2019,513,100,1037,265,4548,2283,14325
"48201211600",1751,595,215,135,274,48,1778,638,5434
"48201211700",520,488,1260,1148,189,74,606,591,4876
"48201211900",3407,1407,0,91,404,135,3578,1477,10499
"48201212300",2441,2799,42,92,420,148,2635,2860,11437
"48201212400",1815,806,112,60,284,102,1972,869,6020
"48201212500",713,472,1825,497,207,0,902,472,5088
"48201220100",877,274,766,340,75,45,958,346,3681
"48201220200",1761,596,33,0,178,85,1844,672,5169
"48201220300",2397,835,80,10,372,431,2444,1148,7717
"48201220400",2421,1007,125,14,341,272,2608,1266,8054
"48201220500",1978,1142,330,251,299,112,1937,1099,7148
"48201220600",2150,593,110,427,315,59,2274,605,6533
"48201220700",1953,963,778,577,655,602,2535,1513,9576
"48201220800",980,397,460,803,73,293,1038,669,4713
"48201220900",948,203,20,115,172,41,1102,226,2827
"48201221000",1485,562,223,221,602,169,1927,648,5837
"48201221100",1924,726,1,2,774,265,2283,805,6780
"48201221200",4325,1072,185,0,601,105,4504,1083,11875
"48201221300",5823,2462,241,0,396,349,5877,2673,17821
"48201221400",2209,3590,92,32,485,87,2374,3489,12358
"48201221500",4289,2646,457,880,487,228,4422,2781,16190
"48201221600",6236,2483,245,99,466,113,5564,2494,17700
"48201221700",5402,3056,0,26,384,80,4979,2941,16868
"48201221800",2179,876,50,0,104,430,2152,1089,6880
"48201221900",1633,920,38,27,898,417,2344,1285,7562
"48201222000",1471,633,73,50,318,47,1548,568,4708
"48201222100",2529,878,73,4,1123,546,2853,1309,9315
"48201222200",1471,1248,245,41,435,310,1802,1486,7038
"48201222300",2173,1389,75,91,540,149,2241,1456,8114
"48201222401",1509,1410,6,9,153,28,1454,1402,5971
"48201222402",3835,1791,395,206,321,42,3675,1790,12055
"48201222501",1828,1519,80,136,104,32,1878,1551,7128
"48201222502",2418,668,191,90,285,80,2314,673,6719
"48201222503",3378,3637,409,0,163,0,3275,3486,14348
"48201222600",1419,2043,347,373,230,187,1556,2188,8343
"48201222700",1245,123,1494,2301,79,125,1022,297,6686
"48201222800",2332,536,0,0,376,57,2263,490,6054
"48201222900",4467,2071,597,65,1370,281,5247,2313,16411
"48201223001",1883,1201,326,33,143,215,1836,1393,7030
"48201223002",2050,1363,322,122,131,33,2060,1363,7444
"48201223100",1099,391,66,50,114,157,984,485,3346
"48201230100",10,295,736,422,0,7,1,294,1765
"48201230200",141,289,2925,1321,122,244,162,421,5625
"48201230300",195,497,682,546,65,71,181,391,2628
"48201230400",946,261,1051,429,455,32,1351,269,4794
"48201230500",1696,705,364,117,472,193,1982,830,6359
"48201230600",675,249,1240,669,47,129,707,378,4094
"48201230700",488,66,1085,747,208,50,691,112,3447
"48201230800",607,137,1695,281,45,4,670,116,3555
"48201230900",740,14,1921,902,6,38,691,52,4364
"48201231000",1059,282,1627,782,80,9,1120,234,5193
"48201231100",1717,761,835,698,525,136,2021,796,7489
"48201231200",761,388,3419,1906,228,444,826,774,8746
"48201231300",396,191,2350,1134,67,196,426,348,5108
"48201231400",78,5,2114,218,113,0,154,0,2682
"48201231500",82,81,1838,474,98,19,166,95,2853
"48201231600",480,33,1892,370,39,10,512,30,3366
"48201231700",1695,695,94,0,811,293,2278,957,6823
"48201231800",711,561,784,64,287,66,935,557,3965
"48201231900",1166,338,3492,835,0,27,963,320,7141
"48201232000",1007,470,1488,74,643,366,1581,781,6410
"48201232100",1332,527,575,288,237,34,1322,530,4845
"48201232200",6760,1127,2609,476,1632,530,3703,1204,18041
"48201232301",4158,1204,1784,672,990,426,4264,1276,14774
"48201232302",4873,811,3356,590,956,0,4772,740,16098
"48201232401",4133,1236,1660,386,1093,240,3705,1271,13724
"48201232402",1209,204,819,535,925,43,1634,379,5748
"48201232403",2064,393,821,300,423,0,2391,334,6726
"48201232500",1576,383,90,134,468,54,1673,285,4663
"48201232600",2317,175,149,4,509,51,2465,213,5883
"48201232701",3913,1913,1020,720,938,239,4639,1912,15294
"48201232702",2346,1233,1007,234,641,667,2583,1819,10530
"48201232800",2252,300,1690,163,515,520,2387,454,8281
"48201232900",2675,113,2258,840,1174,187,2409,206,9862
"48201233001",1236,143,937,432,372,162,1015,135,4432
"48201233002",1758,319,1372,28,543,197,1411,435,6063
"48201233003",1487,69,325,11,323,31,1061,59,3366
"48201233101",2147,746,41,57,688,439,2197,1069,7384
"48201233102",2819,2117,0,5,1342,704,3620,2592,13199
"48201233103",2926,1454,25,0,469,553,3068,1934,10429
"48201233200",3271,722,144,36,1407,146,3334,667,9727
"48201233300",3193,933,0,0,877,329,3715,1025,10072
"48201233400",1489,633,220,166,209,164,1505,716,5102
"48201233500",4018,2803,14,0,657,226,4114,2927,14759
"48201233600",218,138,749,511,54,95,254,132,2151
"48201233701",3344,765,568,128,502,84,3090,848,9329
"48201233702",2279,558,0,0,150,189,2011,718,5905
"48201233703",1514,511,0,0,400,10,1665,457,4557
"48201240100",1210,1051,567,391,551,35,1304,1040,6149
"48201240400",3473,998,1081,533,492,305,2587,823,10292
"48201240501",1869,1848,1589,690,210,163,1964,1873,10206
"48201240502",1212,386,1262,1555,438,112,1520,360,6845
"48201240600",668,690,676,421,81,96,720,736,4088
"48201240701",5010,475,6180,382,3259,347,6920,755,23328
"48201240702",3517,604,2792,913,4172,593,6230,1096,19917
"48201240801",2150,1058,1469,373,1028,759,1877,1623,10337
"48201240802",1585,185,1324,254,511,190,1211,252,5512
"48201240901",3056,285,3223,364,1590,567,2345,591,12021
"48201240902",4388,628,3853,545,2469,474,4255,622,17234
"48201241000",4967,634,1230,127,1368,56,2984,96,11462
"48201241101",2948,89,719,294,401,134,1268,137,5990
"48201241102",5430,1050,3178,693,1515,183,2964,489,15502
"48201241103",1683,184,924,188,650,71,684,205,4589
"48201241200",3801,200,1210,352,1123,228,2190,309,9413
"48201241300",6824,314,2232,164,1892,78,2373,195,14072
"48201241400",5489,537,472,16,1477,22,1993,325,10331
"48201241500",2679,820,2626,1042,1727,309,3047,898,13148
"48201250100",3370,304,2189,546,1862,113,3548,319,12251
"48201250200",3564,1289,3055,196,1224,36,4214,1205,14783
"48201250301",1793,163,2643,127,1065,0,1585,134,7510
"48201250302",6015,132,2537,157,783,398,3197,420,13639
"48201250401",8422,373,1193,14,1745,28,3728,36,15539
"48201250402",11230,454,2807,221,1225,89,2128,188,18342
"48201250500",3296,256,1051,35,803,75,1019,221,6756
"48201250600",2938,643,1254,470,1745,823,2101,1232,11206
"48201250701",3887,525,861,365,496,106,1284,235,7759
"48201250702",3733,203,520,0,235,10,769,0,5470
"48201250800",6334,262,361,0,1075,30,1038,30,9130
"48201250900",9079,357,163,0,574,31,634,0,10838
"48201251000",2118,89,232,30,326,168,166,164,3293
"48201251100",6297,170,402,6,228,119,640,121,7983
"48201251200",4789,809,156,18,593,0,923,200,7488
"48201251300",6688,228,214,1,261,259,581,55,8287
"48201251401",2465,44,125,0,61,0,397,0,3092
"48201251402",5192,444,98,0,518,48,846,95,7241
"48201251501",4736,64,47,0,458,183,652,32,6172
"48201251502",8701,310,407,0,459,46,828,25,10776
"48201251503",1961,64,19,0,173,0,121,37,2375
"48201251600",5347,284,68,23,222,0,461,17,6422
"48201251700",6278,737,345,22,171,59,776,74,8462
"48201251800",1971,50,9,0,66,0,526,0,2622
"48201251901",7521,548,405,326,902,67,1911,355,12035
"48201251902",3545,380,564,49,714,12,950,25,6239
"48201252000",8129,1038,2636,67,1948,0,3475,600,17893
"48201252100",1576,95,241,0,134,0,768,7,2821
"48201252200",4124,869,1106,27,1567,96,4013,687,12489
"48201252301",3791,1212,2898,117,893,440,3814,1238,14403
"48201252302",6716,577,2515,172,1880,411,6819,902,19992
"48201252400",3826,1313,83,91,1164,45,3282,1091,10895
"48201252500",1652,1778,114,0,549,214,1052,1694,7053
"48201252600",3449,1662,9,37,1337,899,2658,2135,12186
"48201252700",2644,616,326,2,274,148,838,419,5267
"48201252800",2236,411,2465,824,504,252,1144,522,8358
"48201252900",6187,1185,345,3,336,99,1840,333,10328
"48201253000",2255,170,1151,126,59,0,1117,57,4935
"48201253100",5921,350,1883,101,1210,45,3337,129,12976
"48201253200",6400,2089,1181,125,95,140,2137,1523,13690
"48201253300",3070,46,37,24,446,148,1346,148,5265
"48201253400",283,50,9,0,242,0,346,16,946
"48201253500",3604,952,2382,644,855,110,2553,678,11778
"48201253600",2477,762,833,949,180,8,783,353,6345
"48201253700",3005,972,1223,113,411,103,1591,908,8326
"48201253800",4483,1443,828,222,404,262,2072,1061,10775
"48201253900",2448,541,260,109,630,111,983,352,5434
"48201254000",1888,361,857,71,772,187,1254,339,5729
"48201254100",2686,642,440,447,994,199,2176,609,8193
"48201254200",1627,302,117,0,628,68,1762,266,4770
"48201254300",2640,666,265,382,427,378,1911,899,7568
"48201254400",1028,683,196,203,842,111,1713,771,5547
"48201254500",1038,274,195,102,682,179,1560,377,4407
"48201254600",1779,403,293,420,1172,233,2534,635,7469
"48201254700",1875,208,229,12,348,5,823,32,3532
"48201310100",2538,1148,304,1214,520,185,1891,901,8701
"48201310200",773,69,441,60,302,22,301,35,2003
"48201310300",2934,854,116,29,809,103,2770,720,8335
"48201310400",1815,1157,0,65,363,291,2042,1376,7109
"48201310500",2984,1155,10,60,528,98,3219,1113,9167
"48201310600",3700,778,124,17,883,229,4182,954,10867
"48201310700",2251,978,105,11,411,175,2255,1043,7229
"48201310800",1445,699,36,51,185,156,1500,850,4922
"48201310900",2913,1450,6,78,532,198,3273,1545,9995
"48201311000",4170,2515,16,29,676,101,4664,2553,14724
"48201311100",2857,715,165,0,2073,230,4876,924,11840
"48201311200",2796,1465,14,61,653,361,3067,1758,10175
"48201311300",2450,1060,118,0,1069,105,3390,1127,9319
"48201311400",464,534,338,128,273,114,702,643,3196
"48201311500",3214,1766,156,0,1801,327,4681,1900,13845
"48201311600",1534,882,61,46,1123,405,2545,1230,7826
"48201311700",2766,1290,357,400,385,404,2832,1585,10019
"48201311800",2165,1178,40,59,685,801,2662,1958,9548
"48201311900",1470,379,0,27,247,184,1617,533,4457
"48201312000",356,270,827,112,191,127,59,58,2000
"48201312100",0,0,0,0,0,0,0,0,0
"48201312200",82,278,892,729,55,57,125,275,2493
"48201312300",135,206,778,590,140,23,157,167,2196
"48201312400",262,115,1036,548,31,36,224,150,2402
"48201312500",1827,528,426,349,519,9,399,213,4270
"48201312600",3834,418,903,140,1282,228,1130,104,8039
"48201312700",90,5,1388,545,11,11,18,13,2081
"48201312800",33,66,450,777,0,5,0,73,1404
"48201312900",306,84,1534,879,169,124,125,43,3264
"48201313000",201,20,1780,393,41,5,14,0,2454
"48201313100",1279,291,472,70,584,18,298,31,3043
"48201313200",439,24,2284,844,113,13,297,0,4014
"48201313300",187,34,1525,622,209,12,149,22,2760
"48201313400",418,72,1668,664,161,42,615,61,3701
"48201313500",161,102,1156,944,139,58,265,173,2998
"48201313600",607,692,1790,1146,278,25,825,752,6115
"48201313700",161,36,1853,357,52,1,148,6,2614
"48201313800",339,291,2199,1782,72,59,355,307,5404
"48201313900",1272,488,1425,207,1257,180,523,31,5383
"48201314001",1152,301,298,66,880,157,400,8,3262
"48201314002",1226,698,1608,767,1630,808,234,183,7154
"48201314300",228,118,2554,940,271,47,168,60,4386
"48201314400",1058,434,215,20,1476,248,223,75,3749
"48201320100",1036,467,99,36,774,190,1669,641,4912
"48201320200",3463,989,124,79,1709,1049,4049,1821,13283
"48201320500",2706,289,2,4,1767,294,4048,550,9660
"48201320601",1477,803,28,6,311,17,1604,764,5010
"48201320602",2170,673,39,79,1389,443,3270,1076,9139
"48201320700",1948,529,410,41,837,57,2190,474,6486
"48201320800",3014,843,0,35,1113,710,3719,1526,10960
"48201320900",4520,866,512,169,943,410,4484,1166,13070
"48201321000",4917,1245,304,227,1608,840,5208,1916,16265
"48201321100",4839,619,632,202,1712,359,5043,856,14262
"48201321200",1452,1027,242,58,567,467,1890,1355,7058
"48201321300",3309,832,221,130,913,546,3563,1324,10838
"48201321401",2398,526,20,0,989,495,3027,941,8396
"48201321402",2177,629,60,14,1185,488,3093,1102,8748
"48201321500",874,426,47,109,727,437,1504,811,4935
"48201321600",5297,1307,0,1,393,317,4181,1393,12889
"48201321700",2345,500,0,1,476,29,2300,455,6106
"48201321800",2524,889,0,0,831,50,2830,879,8003
"48201321900",3439,840,31,10,1107,435,3786,1213,10861
"48201322000",2399,1377,15,17,966,461,3095,1572,9902
"48201322100",2231,1115,11,20,633,203,2323,1210,7746
"48201322200",889,223,1,0,283,38,913,234,2581
"48201322600",4047,534,49,18,884,221,3379,665,9797
"48201322700",4079,1098,131,0,1963,337,4848,1309,13765
"48201322800",3483,1176,53,0,1002,257,3540,1258,10769
"48201322900",2267,700,0,0,782,335,2672,986,7742
"48201323000",2498,1846,77,84,1101,902,2982,2263,11753
"48201323100",1228,1090,138,88,654,451,1521,1365,6535
"48201323200",3630,391,199,128,699,53,2920,511,8531
"48201323300",2142,723,125,110,382,114,2064,742,6402
"48201323400",3689,2289,56,5,1257,574,3726,2034,13630
"48201323500",2181,1386,221,338,634,331,2208,1514,8813
"48201323600",5575,420,63,32,1041,563,3288,739,11721
"48201323701",2861,388,153,86,182,72,922,326,4990
"48201323702",2124,436,111,17,414,264,1219,630,5215
"48201323801",2648,37,29,0,771,0,2200,19,5704
"48201323802",3421,1029,35,5,326,185,2534,917,8452
"48201323900",2563,689,24,89,220,246,1251,621,5703
"48201324000",4440,350,27,0,556,31,2066,313,7783
"48201324100",1912,1636,100,30,1316,387,2873,1744,9998
"48201324200",563,287,0,0,439,335,986,591,3201
"48201330100",3519,680,2361,1708,711,558,3628,1237,14402
"48201330200",1118,588,1230,552,456,135,1414,692,6185
"48201330301",3597,756,1633,166,1459,146,4752,857,13366
"48201330302",2037,465,1675,337,926,65,2742,528,8775
"48201330303",1303,262,1873,186,313,0,1400,231,5568
"48201330400",1705,914,1655,426,457,27,1880,914,7978
"48201330500",2053,628,967,358,183,84,2065,712,7050
"48201330600",1924,505,2663,1065,616,68,2374,553,9768
"48201330700",3082,654,1988,385,1405,703,3804,1357,13378
"48201330800",3044,221,4278,966,1783,52,3306,138,13788
"48201330900",2629,522,3154,848,1314,261,2806,783,12317
"48201331100",47,278,2027,621,164,0,152,274,3563
"48201331200",99,53,2210,840,39,29,76,45,3391
"48201331300",80,34,3112,1921,143,0,187,42,5519
"48201331400",0,12,836,1719,40,50,40,12,2709
"48201331500",416,1,5910,950,585,65,549,121,8597
"48201331601",200,0,4928,1235,196,56,232,41,6888
"48201331602",300,81,859,696,262,0,453,85,2736
"48201331700",506,117,2226,955,100,11,700,82,4697
"48201331800",413,285,2025,857,146,0,478,251,4455
"48201331900",139,11,1987,513,23,0,154,0,2827
"48201332000",325,354,2394,1666,281,235,548,392,6195
"48201332100",696,534,737,445,242,315,912,842,4723
"48201332200",1127,573,1964,887,478,278,1583,698,7588
"48201332300",359,200,1958,401,34,31,354,230,3567
"48201332400",406,110,2410,1069,40,91,337,195,4658
"48201332500",662,266,1697,308,144,5,740,245,4067
"48201332600",2330,795,1817,616,728,1142,2918,1764,12110
"48201332700",1281,617,52,0,831,308,1996,882,5967
"48201332800",2224,590,189,545,656,298,2381,849,7732
"48201332900",2728,1373,32,108,571,72,2678,1398,8960
"48201333000",2510,256,0,2,677,265,2913,463,7086
"48201333100",1126,529,258,248,1333,377,1419,700,5990
"48201333201",2065,685,489,400,769,582,2520,1189,8699
"48201333202",2092,518,1820,795,582,260,2143,711,8921
"48201333300",4657,1658,1325,831,1574,543,5649,2129,18366
"48201333500",2909,1045,935,351,627,718,3363,1746,11694
"48201333600",2365,305,169,16,533,0,1982,258,5628
"48201333700",1676,359,281,30,649,94,2037,427,5553
"48201333800",3388,1627,1408,216,2356,787,5136,2066,16984
"48201333901",4960,310,1706,70,1765,199,5160,377,14547
"48201333902",4669,498,1499,397,1312,0,4477,483,13335
"48201334001",1282,353,955,105,470,41,1282,327,4815
"48201334002",1362,103,463,126,516,38,889,28,3525
"48201334003",3846,649,968,16,1077,246,2662,270,9734
"48201334100",2172,727,4804,1815,1515,145,2180,631,13989
"48201340100",2662,448,942,140,1057,463,1810,501,8023
"48201340201",1125,6,29,0,531,7,256,0,1954
"48201340202",3139,23,181,0,1745,12,589,23,5712
"48201340203",3882,80,35,0,729,6,519,0,5251
"48201340301",2607,92,45,0,1380,0,263,0,4387
"48201340302",6022,72,232,0,998,96,734,72,8226
"48201340400",1140,45,13,0,199,0,101,39,1537
"48201340500",3884,889,75,283,1170,335,1319,490,8445
"48201340600",2227,61,119,7,132,0,170,41,2757
"48201340700",3743,572,714,164,2526,133,1928,227,10007
"48201340800",4038,212,72,23,1254,4,546,0,6149
"48201340900",2928,420,621,141,724,246,1770,305,7155
"48201341000",3984,362,1266,44,703,336,1317,279,8291
"48201341100",2363,537,213,30,396,305,1299,661,5804
"48201341201",2569,293,459,334,583,62,1019,57,5376
"48201341202",4078,418,77,85,238,14,663,70,5643
"48201341301",2610,516,302,151,765,583,469,146,5542
"48201341302",1789,215,281,12,408,279,902,125,4011
"48201341400",4142,131,162,14,552,67,567,98,5733
"48201341501",5706,467,174,3,443,0,701,162,7656
"48201341502",3201,407,63,17,615,28,436,110,4877
"48201341600",4152,360,276,0,811,49,811,0,6459
"48201341700",2095,212,48,41,172,0,517,102,3187
"48201341800",1480,175,9,12,42,38,235,24,2015
"48201342001",5660,71,35,0,1129,0,1482,0,8377
"48201342002",2851,160,163,0,402,109,1253,109,5047
"48201342100",2989,582,42,0,188,93,1122,541,5557
"48201342200",1945,493,155,0,834,112,1923,435,5897
"48201342300",5390,654,330,21,505,251,3188,405,10744
"48201342400",2378,383,19,0,511,127,1531,320,5269
"48201342500",5000,279,0,3,273,18,861,116,6550
"48201342700",4175,531,52,3,435,28,1041,209,6474
"48201342800",7251,283,132,18,1133,0,2415,192,11424
"48201342900",5070,692,59,3,234,16,685,366,7125
"48201343000",5024,1010,222,66,1458,96,2289,681,10846
"48201343100",3547,406,232,70,341,15,854,155,5620
"48201343200",4176,181,385,0,403,0,1456,0,6601
"48201343301",3628,337,140,0,415,15,1560,142,6237
"48201343302",4484,158,158,3,493,10,1641,88,7035
"48201343600",2310,434,97,51,349,85,970,111,4407
"48201343700",1746,261,349,133,321,139,657,354,3960
"48201350100",7797,225,2242,667,4360,421,4840,86,20638
"48201350200",5994,118,983,65,1667,126,4960,51,13964
"48201350300",4332,192,655,28,1030,89,1748,144,8218
"48201350400",2707,493,856,459,1340,296,2437,680,9268
"48201350500",3436,945,1635,274,1168,238,3155,962,11813
"48201350601",3254,69,310,21,704,0,1339,25,5722
"48201350602",5908,147,1331,0,1354,69,1412,16,10237
"48201350700",2135,110,55,7,84,0,610,14,3015
"48201350801",3862,352,233,43,420,63,1264,217,6454
"48201350802",4950,131,560,385,1694,38,1728,20,9506
"48201410100",1656,78,891,491,576,136,549,45,4422
"48201410200",4002,422,175,27,227,26,551,70,5500
"48201410300",1606,238,86,55,405,21,302,14,2727
"48201410401",3235,274,168,0,281,28,667,73,4726
"48201410402",1987,277,20,0,694,19,862,114,3973
"48201410500",3681,153,37,8,331,57,646,48,4961
"48201410600",2771,161,218,97,194,1,265,30,3737
"48201410701",2933,368,233,121,429,0,607,37,4728
"48201410702",1332,372,114,75,328,139,253,78,2691
"48201410800",2811,490,80,17,115,107,212,255,4087
"48201410900",2087,372,21,2,100,26,432,181,3221
"48201411000",4194,253,86,57,364,33,331,13,5331
"48201411100",3109,182,48,14,517,20,368,97,4355
"48201411200",1689,52,6,0,116,0,83,0,1946
"48201411300",2288,263,282,3,430,112,632,137,4147
"48201411400",2515,38,102,0,115,0,28,0,2798
"48201411501",4833,189,47,0,521,61,910,31,6592
"48201411502",3071,131,240,0,451,18,518,0,4429
"48201411600",2172,72,7,0,205,15,355,22,2848
"48201411700",1793,225,161,43,492,39,534,25,3312
"48201411800",3083,151,537,0,725,73,524,51,5144
"48201411900",3032,111,96,0,289,94,281,0,3903
"48201412000",2626,95,24,1,269,31,139,13,3198
"48201412100",0,0,0,0,0,0,0,0,0
"48201412200",4111,203,111,0,1002,125,448,51,6051
"48201412300",5996,230,0,0,821,0,304,0,7351
"48201412400",3819,39,31,0,442,0,131,0,4462
"48201412500",1410,69,7,17,283,30,156,3,1975
"48201412600",3351,68,32,0,431,0,434,0,4316
"48201412700",2409,131,25,0,634,8,467,0,3674
"48201412800",4244,56,0,0,1187,179,516,166,6348
"48201412900",2344,219,419,64,1064,271,279,14,4674
"48201413000",3024,133,127,0,713,11,576,9,4593
"48201413100",2896,173,0,8,418,5,328,51,3879
"48201413201",1531,303,239,36,513,45,295,54,3016
"48201413202",1522,269,278,97,721,46,342,44,3319
"48201413300",4420,304,892,79,1253,77,704,108,7837
"48201420100",476,441,824,381,770,209,595,563,4259
"48201420200",1249,109,361,20,823,53,753,57,3425
"48201420300",2381,113,474,99,404,15,524,9,4019
"48201420400",2570,264,39,51,378,38,547,148,4035
"48201420500",940,860,369,260,664,231,1358,1016,5698
"48201420600",1574,81,36,0,357,137,407,166,2758
"48201420700",2781,54,77,0,422,0,245,15,3594
"48201420800",1928,49,24,0,631,0,92,0,2724
"48201420900",4529,59,73,0,1440,0,326,33,6460
"48201421000",1836,36,20,0,623,4,250,9,2778
"48201421101",1375,910,314,30,361,420,1013,1030,5453
"48201421102",1578,1263,637,47,978,141,2325,1263,8232
"48201421201",1647,792,408,184,495,174,1674,890,6264
"48201421202",1504,1448,14,30,327,308,1602,1509,6742
"48201421300",1730,1584,627,1010,1229,517,1630,1624,9951
"48201421401",1548,1056,205,143,265,239,1715,1172,6343
"48201421402",972,2018,321,194,177,408,1149,2426,7665
"48201421403",1900,995,70,185,358,278,2029,1246,7061
"48201421500",2075,774,545,831,1430,240,2233,767,8895
"48201421600",1579,2759,295,48,1406,556,1915,3076,11634
"48201421700",2566,262,229,92,1340,110,1377,188,6164
"48201421800",2296,403,1024,270,1295,110,877,367,6642
"48201421900",2128,165,51,0,134,84,111,44,2717
"48201422000",2065,218,135,0,433,0,317,197,3365
"48201422100",3398,375,663,72,533,0,1859,273,7173
"48201422200",578,574,2124,1062,426,207,758,730,6459
"48201422301",1108,744,2112,1626,375,1625,1143,1107,9840
"48201422302",603,94,1224,376,237,63,307,112,3016
"48201422401",817,215,1623,668,651,249,1023,155,5401
"48201422402",2833,927,447,110,754,653,2319,1417,9460
"48201422500",2225,640,499,1238,1779,644,2306,1062,10393
"48201422600",3827,848,678,277,702,62,1755,569,8718
"48201422701",2556,1335,236,114,165,253,2138,1465,8262
"48201422702",1732,187,86,227,1135,80,2023,144,5614
"48201422800",1608,819,87,113,863,108,1197,856,5651
"48201422900",2005,837,658,258,378,242,1769,967,7114
"48201423000",2006,1447,361,588,529,209,1775,1490,8405
"48201423100",750,843,450,337,170,116,860,946,4472
"48201423201",1572,276,826,157,313,240,942,400,4726
"48201423202",1449,1729,2204,1381,1223,578,2284,2340,13188
"48201423301",1621,260,1085,853,644,90,659,262,5474
"48201423302",1242,47,2226,881,406,173,889,52,5916
"48201423401",1068,42,2524,927,836,291,790,299,6777
"48201423402",734,16,2298,180,981,116,847,117,5289
"48201423500",945,54,561,0,358,55,420,0,2393
"48201423600",2098,319,2848,595,906,125,1559,478,8928
"48201430100",5183,159,128,55,627,0,675,0,6827
"48201430200",1183,110,6,0,168,35,198,18,1718
"48201430300",4013,10,94,0,392,36,214,0,4759
"48201430400",2683,73,0,0,459,0,191,14,3420
"48201430500",1893,72,41,0,450,171,318,0,2945
"48201430600",3033,74,2,14,628,14,215,1,3981
"48201430700",2339,148,18,9,687,63,425,20,3709
"48201430800",3645,30,34,0,969,10,178,0,4866
"48201430900",5005,195,71,0,1016,33,456,15,6791
"48201431000",4153,34,739,2,747,0,919,3,6597
"48201431101",2052,255,285,326,165,184,609,83,3959
"48201431102",1660,659,438,173,380,456,376,392,4534
"48201431201",1928,532,597,146,788,383,640,478,5492
"48201431202",2845,206,524,13,983,73,718,79,5441
"48201431301",2643,295,739,0,1036,569,1395,419,7096
"48201431302",3254,205,134,35,137,25,202,50,4042
"48201431401",1233,299,145,0,461,71,382,111,2702
"48201431402",2362,149,69,0,731,118,487,85,4001
"48201431501",2802,181,52,0,463,34,161,46,3739
"48201431502",2843,89,58,29,523,10,479,45,4076
"48201431600",3013,64,15,21,155,0,310,0,3578
"48201431700",3832,301,38,0,234,0,213,106,4724
"48201431801",1913,33,173,30,944,82,373,0,3548
"48201431802",2198,257,187,0,779,0,954,64,4439
"48201431900",2279,34,336,0,508,24,448,9,3638
"48201432001",2057,190,361,54,770,88,793,18,4331
"48201432002",2160,929,396,372,551,89,1822,594,6913
"48201432100",2258,320,707,106,1324,469,1334,363,6881
"48201432200",2081,423,824,49,473,399,912,559,5720
"48201432300",2279,576,1976,579,1357,228,2141,480,9616
"48201432400",1351,450,1603,499,776,438,1037,341,6495
"48201432500",1515,1226,1469,455,714,353,1230,1220,8182
"48201432600",1209,28,206,213,538,37,604,29,2864
"48201432701",1852,1962,46,121,1578,1420,3141,3155,13275
"48201432702",2137,331,339,32,153,39,1070,340,4441
"48201432801",1566,552,1043,273,1034,522,1716,1023,7729
"48201432802",1895,1521,815,176,818,615,1997,1789,9626
"48201432901",1468,504,197,145,657,136,1751,603,5461
"48201432902",2486,990,720,150,1388,529,2751,1289,10303
"48201433001",1243,1322,84,0,1436,1321,1818,1581,8805
"48201433002",1356,946,315,108,1050,561,1771,1151,7258
"48201433003",1608,891,395,102,1353,873,1656,733,7611
"48201433100",1061,790,676,434,52,140,1048,882,5083
"48201433201",1527,473,1104,157,1473,557,1381,561,7233
"48201433202",1824,670,332,79,1186,515,1671,1038,7315
"48201433300",2955,304,132,18,1234,213,2051,269,7176
"48201433400",1918,588,835,162,904,273,1866,751,7297
"48201433501",1462,2686,601,545,327,705,1781,3218,11325
"48201433502",1651,1612,846,786,963,891,2228,2681,11658
"48201433600",383,1155,982,934,448,207,681,1072,5862
"48201440100",3052,677,1798,58,1141,26,2615,500,9867
"48201450100",1418,40,14,0,301,0,50,0,1823
"48201450200",4018,125,10,0,551,2,360,0,5066
"48201450300",3768,554,742,390,927,156,1359,315,8211
"48201450400",3377,194,296,123,666,56,1187,63,5962
"48201450500",2569,21,0,0,136,35,208,0,2969
"48201450600",3401,159,123,22,386,43,1014,50,5198
"48201450700",6186,37,0,0,708,109,482,0,7522
"48201450801",1243,88,121,21,172,28,427,12,2112
"48201450802",4047,881,1264,524,1337,786,2805,1408,13052
"48201450900",2116,85,268,25,235,19,439,1,3188
"48201451001",1612,472,1517,532,486,330,722,518,6189
"48201451002",1342,436,2221,547,665,56,1043,450,6760
"48201451100",2398,172,418,27,907,312,697,86,5017
"48201451200",2559,71,20,0,250,0,191,0,3091
"48201451300",4200,373,833,28,1145,74,1050,183,7886
"48201451401",1915,293,462,25,620,0,446,59,3820
"48201451402",1433,401,1584,578,573,61,852,99,5581
"48201451403",2631,250,934,216,951,48,983,290,6303
"48201451500",2608,226,343,0,1370,39,710,27,5323
"48201451601",4204,199,172,0,1438,199,608,124,6944
"48201451602",3805,438,370,23,2023,212,1502,226,8599
"48201451700",1998,21,819,62,503,98,1185,69,4755
"48201451800",1704,124,1552,25,1503,471,1635,327,7341
"48201451901",2439,178,2444,1029,1023,233,1631,306,9283
"48201451902",1156,22,77,33,1103,136,161,15,2703
"48201452000",3021,440,2284,447,1713,0,2168,362,10435
"48201452100",3887,814,1637,300,1782,307,1327,742,10796
"48201452201",978,412,1751,199,519,270,686,409,5224
"48201452202",700,30,477,198,708,103,429,9,2654
"48201452300",666,98,326,35,1114,330,1070,197,3836
"48201452400",2617,368,856,39,3089,820,3221,678,11688
"48201452500",1450,718,1516,721,2498,2313,2034,1879,13129
"48201452600",1220,964,1979,1286,2255,463,1673,1038,10878
"48201452700",2509,373,2307,711,4279,556,2405,404,13544
"48201452801",1595,223,1370,391,1684,480,1973,407,8123
"48201452802",880,391,1000,668,1298,1021,1246,966,7470
"48201452900",1498,371,482,112,1317,584,1875,504,6743
"48201453000",3226,650,265,165,3467,890,5530,1399,15592
"48201453100",1122,584,625,368,1161,513,1611,901,6885
"48201453200",1658,1087,1000,569,2085,746,2366,1626,11137
"48201453300",354,206,782,399,484,254,383,298,3160
"48201453401",1159,55,525,96,1219,142,1613,31,4840
"48201453402",2675,429,906,412,2693,1305,2967,910,12297
"48201453403",294,266,836,681,774,659,553,721,4784
"48201453501",1847,715,1151,220,2142,432,2149,889,9545
"48201453502",1746,43,907,75,640,35,1399,45,4890
"48201453601",555,198,459,62,605,136,852,194,3061
"48201453602",1842,562,1251,1173,2426,830,2912,471,11467
"48201453700",1821,408,2367,61,2685,852,3177,682,12053
"48201453800",1494,287,570,178,811,276,950,310,4876
"48201453900",2352,377,1442,682,3799,1147,2603,602,13004
"48201454000",1714,93,1433,243,1302,249,1471,260,6765
"48201454100",1325,150,1264,101,975,18,1140,105,5078
"48201454200",1792,430,929,8,760,59,1771,472,6221
"48201454301",4575,287,3356,616,1721,768,3866,474,15663
"48201454302",3165,199,1227,0,1718,295,2387,393,9384
"48201454400",324,3,0,0,169,45,126,31,698
"48201454501",6205,255,161,0,1800,0,1136,0,9557
"48201454502",1532,35,15,0,880,0,235,17,2714
"48201454600",3896,117,76,39,791,64,1298,64,6345
"48201454700",5640,160,448,28,496,17,731,71,7591
"48201454800",5689,368,471,94,759,158,1532,110,9181
"48201454900",7741,250,858,0,2651,142,2046,64,13752
"48201455000",1858,45,288,0,506,0,541,36,3274
"48201455101",4865,919,284,0,395,0,1074,642,8179
"48201455102",2948,239,54,0,197,85,471,0,3994
"48201455200",3439,346,362,3,263,0,1084,212,5709
"48201455300",2365,139,574,123,449,0,754,48,4452
"48201510100",1282,123,79,26,442,126,822,220,3120
"48201510200",4147,474,192,133,662,79,1067,280,7034
"48201510300",4521,205,43,24,508,53,999,211,6564
"48201510400",3274,201,31,39,384,0,663,13,4605
"48201510500",2140,369,169,19,347,19,587,306,3956
"48201510600",3166,352,209,27,538,47,866,218,5423
"48201510700",2442,88,99,0,527,49,450,33,3688
"48201510800",5831,104,46,12,1147,80,931,0,8151
"48201510900",4046,1164,138,25,1581,48,2282,823,10107
"48201511001",2234,98,82,0,117,25,639,25,3220
"48201511002",3055,278,212,0,700,0,1505,0,5750
"48201511100",2034,85,146,125,449,80,780,107,3806
"48201511200",3594,69,322,44,572,291,1829,306,7027
"48201511301",3140,276,0,0,429,21,697,188,4751
"48201511302",3113,329,74,1,206,4,792,62,4581
"48201511400",2505,481,34,89,126,1,714,349,4299
"48201511500",4912,667,134,15,601,125,2320,421,9195
"48201511600",2821,858,12,14,346,6,2388,814,7259
"48201520100",1630,279,39,14,351,103,721,332,3469
"48201520200",2440,491,187,96,450,148,833,384,5029
"48201520300",2617,691,381,61,843,413,2250,866,8122
"48201520400",1309,1001,29,29,712,439,1316,1379,6214
"48201520500",4339,2003,667,111,992,204,4098,2127,14541
"48201520601",1019,574,0,0,323,415,1064,922,4317
"48201520602",2122,1759,140,0,999,1065,2576,2701,11362
"48201520700",2274,486,65,92,639,366,833,718,5473
"48201521000",982,573,81,46,182,126,628,661,3279
"48201521100",900,569,5,0,372,404,999,905,4154
"48201521200",1322,1427,612,2,2350,814,2819,2126,11472
"48201521300",2801,555,189,132,1395,780,2775,1221,9848
"48201521400",1685,1144,0,33,2582,1582,3893,2707,13626
"48201521500",2713,521,158,101,1772,501,2751,893,9410
"48201521600",2328,277,410,9,229,318,2125,571,6267
"48201521700",2511,1139,1185,613,796,780,2303,1673,11000
"48201521800",2702,635,286,158,1402,195,2163,592,8133
"48201521900",5306,489,373,28,689,287,2877,587,10636
"48201522000",2137,753,267,74,986,414,1778,957,7366
"48201522100",3382,905,518,164,2373,1228,3224,1981,13775
"48201522201",1512,859,247,0,1438,166,1842,955,7019
"48201522202",2166,394,22,155,267,993,1313,1368,6678
"48201522301",2137,758,49,23,1074,249,2093,762,7145
"48201522302",1730,489,175,36,1383,210,1768,649,6440
"48201522401",3559,694,74,0,616,505,1516,877,7841
"48201522402",2034,932,90,66,316,278,828,1182,5726
"48201522500",4011,65,0,0,457,11,241,15,4800
"48201530100",3033,1315,526,317,791,352,2903,1605,10842
"48201530200",3106,317,89,49,308,8,1196,121,5194
"48201530300",590,120,988,642,37,3,677,111,3168
"48201530400",633,350,857,357,98,301,689,564,3849
"48201530500",1491,770,1257,292,243,281,1625,1020,6979
"48201530600",904,1024,552,315,189,192,849,1052,5077
"48201530700",2414,1140,780,1249,34,23,2081,1151,8872
"48201530800",424,265,1858,699,437,211,587,344,4825
"48201530900",3309,128,234,141,335,238,1410,242,6037
"48201531000",2960,399,7,37,332,10,1009,380,5134
"48201531100",2352,132,9,0,174,8,709,54,3438
"48201531200",1992,532,123,61,162,0,501,426,3797
"48201531300",3162,794,644,69,915,346,3110,864,9904
"48201531400",1592,217,46,1,106,17,600,148,2727
"48201531500",2004,88,260,16,434,76,1018,110,4006
"48201531600",2348,331,46,9,303,0,899,312,4248
"48201531700",2857,80,0,17,55,32,472,0,3513
"48201531800",256,133,1065,292,145,52,373,147,2463
"48201531900",532,180,2561,976,199,0,878,180,5506
"48201532001",2043,526,1344,1228,252,187,1640,541,7761
"48201532002",771,27,228,0,9,0,205,27,1267
"48201532100",2274,1387,1199,751,710,588,1990,1791,10690
"48201532200",910,686,674,233,278,56,807,666,4310
"48201532300",2918,524,1324,234,789,111,2688,419,9007
"48201532400",3758,401,915,0,978,90,2813,354,9309
"48201532501",4405,388,437,433,3171,220,5601,506,15161
"48201532502",2827,1373,434,43,1179,93,3444,1379,10772
"48201532600",2192,246,1179,1212,1085,290,2372,290,8866
"48201532700",2013,126,1787,731,587,100,1241,78,6663
"48201532800",750,56,356,93,321,47,629,77,2329
"48201532900",1767,198,2015,386,653,195,1429,354,6997
"48201533000",331,418,1021,587,252,36,513,469,3627
"48201533100",1882,54,2885,1290,294,211,1751,234,8601
"48201533200",766,142,1771,521,131,0,549,115,3995
"48201533300",531,140,2901,2878,146,40,677,113,7426
"48201533400",4397,1187,2690,1550,1116,131,5159,1234,17464
"48201533500",2181,953,679,24,785,32,2296,982,7932
"48201533600",2284,530,1354,332,586,280,2416,604,8386
"48201533701",2838,1601,500,94,441,456,2881,1962,10773
"48201533702",1533,825,634,0,626,77,1568,870,6133
"48201533801",3780,1442,1501,448,1659,178,4388,1563,14959
"48201533802",2735,1778,722,74,908,481,2861,1989,11548
"48201533901",3354,1543,2669,399,1817,519,4089,1810,16200
"48201533902",1326,730,1059,836,464,196,1618,807,7036
"48201534001",977,791,112,9,729,208,1216,792,4834
"48201534002",3669,456,632,314,594,57,3479,443,9644
"48201534003",784,200,1017,21,527,34,997,83,3663
"48201534100",3277,1248,853,95,2024,627,2581,1593,12298
"48201534201",796,420,137,0,514,148,701,351,3067
"48201534202",6213,276,733,0,1466,66,1791,231,10776
"48201534203",627,106,463,10,425,16,617,67,2331
"48201540100",6955,456,527,17,3922,310,2909,290,15386
"48201540200",1654,315,188,79,645,87,1462,331,4761
"48201540501",3550,734,501,32,1135,226,2757,878,9813
"48201540502",4188,348,91,0,233,0,1213,269,6342
"48201540601",2711,220,725,23,660,40,1476,185,6040
"48201540602",3925,536,1116,35,982,509,2659,726,10488
"48201540700",4322,699,401,6,1992,350,2496,661,10927
"48201540800",3562,784,774,130,2875,50,4494,710,13379
"48201540901",1751,156,171,63,488,0,299,95,3023
"48201540902",4057,477,1567,139,1087,99,886,436,8748
"48201541001",5464,726,1630,485,2112,59,2124,601,13201
"48201541002",4969,107,1009,248,1996,130,1917,29,10405
"48201541003",7959,151,2246,608,3076,372,3314,143,17869
"48201541100",4955,235,537,309,768,143,1138,51,8136
"48201541201",6159,218,512,0,1512,92,2014,59,10566
"48201541202",5123,570,362,362,2096,698,2655,534,12400
"48201541203",2353,9,93,0,152,18,202,18,2845
"48201541300",5837,1585,2175,463,2098,393,5101,1379,19031
"48201541400",6615,691,3277,351,3979,450,5177,808,21348
"48201541500",3252,221,415,0,1118,203,2258,137,7604
"48201541601",3603,397,491,2,609,0,844,161,6107
"48201541602",6375,762,917,62,1678,573,4602,1100,16069
"48201541700",5614,599,2866,346,1550,417,3060,696,15148
"48201541800",3275,599,747,138,409,433,1376,456,7433
"48201541900",4722,467,998,0,841,66,2348,465,9907
"48201542000",9618,463,2186,172,2135,168,5509,407,20658
"48201542101",8182,2785,3561,819,2443,31,6161,2456,26438
"48201542102",6735,2192,3007,191,1892,451,4588,2399,21455
"48201542200",9639,1061,3727,599,2449,397,8003,1127,27002
"48201542301",7949,1048,1436,211,2540,595,5682,1468,20929
"48201542302",4111,295,1588,26,1298,52,3095,269,10734
"48201542400",5544,545,727,372,2070,555,4258,771,14842
"48201542500",2326,114,38,0,103,20,181,94,2876
"48201542600",2898,121,437,0,1010,42,1417,42,5967
"48201542700",3355,336,115,65,272,264,997,356,5760
"48201542800",6045,446,73,0,596,144,1743,518,9565
"48201542900",7483,733,1347,17,2865,466,4683,656,18250
"48201543001",5604,335,2038,117,1353,20,1960,147,11574
"48201543002",8386,557,1718,0,2547,44,2625,296,16173
"48201543003",9458,1311,4023,62,2770,842,6992,1580,27038
"48201543100",1765,558,132,0,247,0,656,494,3852
"48201543200",3564,586,197,449,1208,94,1558,518,8174
"48201550100",710,990,1099,1136,725,262,1158,1169,7249
"48201550200",744,470,1347,1014,212,124,835,567,5313
"48201550301",2109,344,3570,826,323,204,1638,519,9533
"48201550302",1947,909,3493,1352,1639,304,2137,845,12626
"48201550401",3729,2354,2582,1173,1163,362,3613,2424,17400
"48201550402",1538,349,6051,1256,1099,160,1558,410,12421
"48201550500",1662,544,1736,508,966,108,1901,563,7988
"48201550601",2341,694,2859,540,753,133,2401,788,10509
"48201550602",1037,263,1034,258,265,13,1124,269,4263
"48201550603",2091,453,1563,61,892,203,2430,627,8320
"48201550700",1067,319,897,56,705,18,1023,288,4373
"48201550800",962,400,1490,688,530,25,1091,383,5569
"48201550900",3779,1556,1335,102,1905,493,3587,1489,14246
"48201551000",1494,371,806,124,343,49,1717,387,5291
"48201551100",2588,1431,2971,462,2296,535,2532,1679,14494
"48201551200",3554,435,903,116,1426,163,1556,383,8536
"48201551300",2021,94,733,119,863,95,1036,76,5037
"48201551400",2620,187,1084,41,1086,120,1191,234,6563
"48201551500",3503,225,2128,284,1896,334,2664,290,11324
"48201551600",5114,855,982,10,1362,60,3664,657,12704
"48201551701",5304,104,1356,0,1673,29,2263,20,10749
"48201551702",2630,29,117,0,1191,59,550,7,4583
"48201551703",4595,502,455,29,1651,15,1485,453,9185
"48201551800",4107,88,97,3,393,21,431,1,5141
"48201551900",2543,566,1592,276,709,424,1796,482,8388
"48201552001",4321,263,1918,535,2305,54,2580,75,12051
"48201552002",1181,88,487,7,144,19,344,44,2314
"48201552101",1784,263,722,53,1020,0,807,222,4871
"48201552102",4360,43,571,0,1083,0,1071,0,7128
"48201552103",2138,97,308,40,183,316,694,316,4092
"48201552200",3294,418,500,550,1135,332,1180,465,7874
"48201552301",3323,106,190,0,180,0,474,9,4282
"48201552302",3400,288,224,193,1251,0,1076,0,6432
"48201552400",4243,286,821,340,1222,236,2150,105,9403
"48201552500",6643,575,1226,95,1476,349,3079,176,13619
"48201552601",2330,368,975,676,575,248,1060,212,6444
"48201552602",4221,314,959,0,1088,46,1207,173,8008
"48201552700",5564,600,999,62,868,0,1550,323,9966
"48201552800",6990,633,466,153,832,131,889,396,10490
"48201552900",4639,274,1003,314,485,27,589,56,7387
"48201553001",3445,199,1253,0,710,56,1399,186,7248
"48201553002",2071,473,1067,10,1011,26,711,450,5819
"48201553100",2983,397,1681,99,764,99,1467,317,7807
"48201553200",2445,404,1705,708,726,153,1262,426,7829
"48201553300",992,241,1888,1060,823,51,1080,255,6390
"48201553401",3312,41,231,0,373,0,919,0,4876
"48201553402",4941,114,288,81,1400,74,816,114,7828
"48201553403",4388,185,513,83,1141,41,1344,121,7816
"48201553500",4713,295,293,4,690,5,891,214,7105
"48201553600",4743,161,626,47,1143,235,1453,56,8464
"48201553700",2671,395,576,3,292,65,665,268,4935
"48201553801",2302,211,30,1,85,0,287,176,3092
"48201553802",5786,529,289,73,886,0,810,121,8494
"48201553900",5770,131,830,0,1151,37,794,0,8713
"48201554001",2336,265,506,25,368,116,533,207,4356
"48201554002",3425,80,36,0,669,77,438,0,4725
"48201554101",1257,9,23,0,8,5,141,14,1457
"48201554102",6434,288,849,156,2523,54,1845,41,12190
"48201554200",5216,256,833,98,1063,442,2009,366,10283
"48201554301",6359,43,265,23,236,13,717,13,7669
"48201554302",2932,128,273,163,1046,35,645,12,5234
"48201554401",13474,217,195,0,1027,20,2642,47,17622
"48201554402",9848,190,1105,113,1272,240,1453,2,14223
"48201554403",7477,522,951,55,578,46,1772,345,11746
"48201554501",4965,65,462,2,482,20,1153,0,7149
"48201554502",5696,60,102,0,513,0,693,0,7064
"48201554600",4179,39,164,0,304,11,504,0,5201
"48201554700",5709,85,512,69,1310,36,992,22,8735
"48201554801",9992,1073,1733,46,1897,620,3508,569,19438
"48201554802",11371,779,758,0,1658,301,2648,135,17650
"48201554901",5537,379,1009,0,1983,102,2198,199,11407
"48201554902",6483,29,125,45,465,0,1161,13,8321
"48201554903",8752,38,706,0,1546,77,1785,0,12904
"48201555000",5704,263,765,0,720,54,1612,25,9143
"48201555100",6142,402,562,371,922,6,1751,325,10481
"48201555200",5445,552,449,42,319,118,1938,420,9283
"48201555301",686,56,0,6,20,0,128,0,896
"48201555302",12168,479,251,0,934,72,2850,239,16993
"48201555303",4303,65,267,62,347,40,1067,0,6151
"48201555401",1847,434,34,48,213,0,691,310,3577
"48201555402",4662,1889,174,515,560,12,801,806,9419
"48201555501",3474,821,52,2,78,1,673,633,5734
"48201555502",13946,1141,889,142,2240,953,3948,1404,24663
"48201555600",3681,870,281,57,351,2,624,652,6518
"48201555701",6126,55,1062,0,487,20,1153,0,8903
"48201555702",9008,79,330,123,780,65,1188,65,11638
"48201556000",5120,1087,810,103,269,0,1934,495,9818
"48201980000",4,4,0,0,0,0,0,0,8
"48201980100",218,62,250,109,148,0,366,33,1186
"48203020102",3704,438,417,511,85,43,263,101,5562
"48203020103",2976,601,394,251,112,38,157,196,4725
"48203020104",2753,84,427,261,115,113,366,48,4167
"48203020200",5624,452,669,439,161,40,162,41,7588
"48203020301",3139,138,666,97,177,0,305,0,4522
"48203020302",2444,547,783,601,0,0,1001,324,5700
"48203020401",1311,207,1278,591,219,135,630,233,4604
"48203020402",750,356,2286,939,142,143,318,393,5327
"48203020501",1018,588,409,395,195,15,604,298,3522
"48203020502",2445,446,985,240,262,29,465,8,4880
"48203020603",4618,352,214,0,383,118,525,118,6328
"48203020604",2658,644,610,0,176,82,248,14,4432
"48203020605",4626,198,352,10,162,27,67,37,5479
"48203020606",4216,313,492,0,128,136,466,137,5888
"48205950200",3946,187,15,0,219,223,679,350,5619
"48207950300",1958,608,95,1,273,121,325,196,3577
"48207950400",1492,295,30,29,135,18,180,109,2288
"48209010100",1313,929,124,70,69,69,322,322,3218
"48209010200",409,280,29,0,60,23,22,12,835
"48209010302",2260,666,115,23,756,603,2120,903,7446
"48209010303",3486,2458,234,294,485,231,1742,831,9761
"48209010304",2509,2191,92,166,498,595,1759,1471,9281
"48209010400",5343,1938,239,0,1185,279,3584,1290,13858
"48209010500",1994,1210,135,30,521,206,1493,936,6525
"48209010600",8211,450,65,56,933,157,2625,164,12661
"48209010701",3676,3240,0,0,348,369,851,1355,9839
"48209010702",1721,1171,0,83,81,42,295,241,3634
"48209010803",3443,653,0,0,156,22,434,30,4738
"48209010804",7893,315,137,1,276,0,439,37,9098
"48209010805",5901,199,94,0,617,0,480,79,7370
"48209010806",3367,290,36,3,77,3,134,94,4004
"48209010807",1530,237,0,1,144,38,254,83,2287
"48209010808",4593,617,0,2,359,15,427,103,6116
"48209010809",4373,272,0,0,836,5,1239,105,6830
"48209010901",6896,277,196,0,554,20,1422,13,9378
"48209010902",9040,871,129,0,1050,70,2874,328,14362
"48209010905",4806,239,171,66,407,164,2066,230,8149
"48209010906",7632,1013,583,30,2228,614,5593,1320,19013
"48209010907",7192,892,472,34,1735,959,6038,1560,18882
"48209010908",5917,1280,364,24,1506,693,4651,1626,16061
"48209010909",4790,43,165,0,339,46,1439,0,6822
"48209010910",6515,272,884,0,868,130,4396,212,13277
"48211950300",3162,274,0,0,295,249,976,386,5342
"48213950100",5015,733,374,21,134,59,272,85,6693
"48213950200",3977,589,31,10,221,24,486,32,5370
"48213950300",5840,1001,113,0,196,75,797,114,8136
"48213950400",3292,763,170,81,127,0,237,176,4846
"48213950500",2096,371,3,1,22,0,73,11,2577
"48213950601",1908,1013,18,28,146,9,122,143,3387
"48213950602",3866,1054,15,87,185,23,127,282,5639
"48213950700",3430,1226,0,0,51,94,464,338,5603
"48213950800",3937,497,21,0,202,0,244,0,4901
"48213950901",4300,887,49,13,176,10,116,129,5680
"48213950902",1594,186,124,116,48,14,46,21,2149
"48213950903",1690,314,58,18,107,0,0,0,2187
"48213951000",1310,281,282,295,95,16,364,32,2675
"48213951100",3069,643,32,0,121,19,78,181,4143
"48213951200",2557,1732,951,355,359,17,1045,1295,8311
"48213951300",3684,729,250,439,81,272,649,592,6696
"48213951400",4809,1072,835,96,178,28,296,63,7377
"48215020101",2523,3449,4,1,141,198,2486,3553,12355
"48215020102",5125,3056,0,0,20,80,4023,2986,15290
"48215020201",5017,2057,6,0,408,138,5331,2174,15131
"48215020202",4893,2433,0,0,292,223,5082,2628,15551
"48215020204",5571,2874,51,0,437,96,5584,2713,17326
"48215020205",3948,1053,29,0,235,120,3891,1173,10449
"48215020301",8626,1249,128,0,420,105,6959,1243,18730
"48215020302",7765,601,65,0,490,62,7180,464,16627
"48215020402",6017,1150,144,0,1567,0,5456,1017,15351
"48215020403",2359,1984,0,0,173,288,2256,2254,9314
"48215020404",3749,889,26,0,256,96,2399,844,8259
"48215020501",3431,1204,0,3,113,151,3289,1266,9457
"48215020503",6984,3367,0,0,581,136,7179,3488,21735
"48215020504",4914,1995,154,0,630,223,5336,2208,15460
"48215020600",1456,784,12,0,47,80,1484,845,4708
"48215020701",7083,1417,69,33,813,89,6560,1538,17602
"48215020721",4807,1926,11,0,797,29,4742,1900,14212
"48215020723",1922,3163,0,31,165,244,2058,3306,10889
"48215020724",3188,807,0,0,112,74,2561,806,7548
"48215020725",3380,913,0,125,159,215,3124,1149,9065
"48215020726",3189,2140,0,0,348,285,2855,2394,11211
"48215020802",4737,1981,0,0,643,554,4194,2521,14630
"48215020803",4279,725,170,0,384,86,3489,811,9944
"48215020804",2385,793,54,33,229,55,1881,787,6217
"48215020901",3497,849,0,0,646,41,2866,865,8764
"48215020903",3857,795,8,0,805,68,3864,709,10106
"48215020904",2731,873,0,0,530,110,2261,922,7427
"48215021000",2712,2592,0,34,94,641,2470,3224,11767
"48215021100",1165,1108,83,0,139,292,1214,1393,5394
"48215021201",1853,470,0,13,450,48,1579,448,4861
"48215021202",4067,730,0,1,568,8,3699,721,9794
"48215021302",8284,7675,28,0,193,407,8415,7927,32929
"48215021303",4776,3058,0,0,563,171,5154,3208,16930
"48215021304",3864,2228,0,0,53,170,3789,2397,12501
"48215021305",5239,1575,0,0,211,35,5375,1610,14045
"48215021401",2212,3177,0,2,185,127,2155,3176,11034
"48215021403",3002,1149,0,40,449,187,2772,1360,8959
"48215021404",6359,1540,0,0,254,13,5122,1530,14818
"48215021500",2092,1333,0,0,143,109,2235,1441,7353
"48215021600",2404,1725,6,0,81,98,2431,1707,8452
"48215021701",5899,2298,0,0,584,89,5916,2105,16891
"48215021702",9505,2779,0,0,484,63,9442,2693,24966
"48215021803",3358,1629,0,0,183,39,3397,1659,10265
"48215021804",1687,2789,47,19,144,65,1875,2854,9480
"48215021805",6437,2457,0,0,359,65,6678,2423,18419
"48215021806",6406,2032,0,41,95,0,6424,2073,17071
"48215021901",6061,3742,0,12,100,721,4785,4178,19599
"48215021903",2857,957,0,2,115,12,2823,956,7722
"48215021904",3391,1348,20,0,117,20,2787,1347,9030
"48215022001",7787,2818,0,1,361,121,7783,2901,21772
"48215022003",3495,3399,0,0,169,309,2852,3669,13893
"48215022004",5787,4333,64,0,222,398,5587,4646,21037
"48215022103",3705,1396,0,122,186,221,3197,1618,10445
"48215022104",4187,5903,24,8,639,905,4708,6735,23109
"48215022105",1935,1968,0,1,49,0,1902,1736,7591
"48215022106",3394,1693,55,0,330,89,3223,1739,10523
"48215022201",3050,2910,0,0,694,125,3361,2942,13082
"48215022203",2383,1365,0,1,251,163,2417,1475,8055
"48215022204",2889,1737,27,0,453,154,3281,1891,10432
"48215022300",7385,1778,11,0,575,188,5682,1899,17518
"48215022401",2631,1189,44,1,248,305,2595,1480,8493
"48215022402",3579,1491,8,0,508,144,3850,1621,11201
"48215022501",3430,2475,9,0,111,329,3401,2804,12559
"48215022502",3568,1359,72,0,340,276,3774,1608,10997
"48215022600",1129,528,0,0,339,173,1445,701,4315
"48215022701",3526,1113,0,0,375,95,2317,1057,8483
"48215022702",3351,1952,0,0,110,78,2459,1867,9817
"48215022800",4953,3332,0,0,451,456,5038,3774,18004
"48215022900",2711,1153,7,0,220,594,2345,1617,8647
"48215023000",2646,1433,84,0,245,100,2787,1526,8821
"48215023102",3822,3299,14,19,334,658,4048,3947,16141
"48215023103",3204,2861,45,0,196,143,3263,2977,12689
"48215023104",3044,1851,55,8,277,222,3257,2070,10784
"48215023503",5592,1789,0,0,317,217,5714,1991,15620
"48215023504",6385,2896,133,0,347,167,6035,3012,18975
"48215023507",5368,3180,0,0,313,257,5451,3437,18006
"48215023509",8353,1285,107,181,894,86,7056,1310,19272
"48215023510",6939,990,17,0,1458,61,5697,909,16071
"48215023511",4794,4100,0,0,422,717,5088,4817,19938
"48215023512",207,207,10,58,0,35,194,203,914
"48215023513",4480,3417,35,1,574,259,4676,3654,17096
"48215023514",3504,4131,0,0,391,367,3740,4136,16269
"48215023515",5841,4026,0,0,151,89,5558,4115,19780
"48215023600",5404,2663,0,10,418,198,5599,2731,17023
"48215023700",2071,2119,16,0,358,299,2399,2310,9572
"48215023801",6160,1680,0,0,512,42,6186,1687,16267
"48215023802",6892,1076,157,1,926,38,6464,1112,16666
"48215023902",8770,828,438,0,1263,595,7856,942,20692
"48215023903",2296,1085,95,0,350,273,2476,1303,7878
"48215023904",6306,1762,0,0,715,233,6008,1963,16987
"48215024000",9306,5031,130,39,1251,406,9672,5006,30841
"48215024105",5372,3720,0,0,547,274,5286,3865,19064
"48215024106",7571,3203,60,0,1076,126,7262,3219,22517
"48215024107",2885,1420,0,1,248,86,2666,1459,8765
"48215024108",2136,2828,0,105,739,153,2814,2981,11756
"48215024109",3499,2673,0,0,226,115,3542,2788,12843
"48215024110",6713,2876,0,0,482,122,6900,2998,20091
"48215024111",2883,1624,0,0,181,101,2815,1699,9303
"48215024112",3747,9770,0,0,340,518,3973,10257,28605
"48215024113",2320,3738,0,0,245,317,2503,3928,13051
"48215024114",3329,5002,0,0,352,365,3637,5330,18015
"48215024201",7338,6775,15,13,469,451,7639,7184,29884
"48215024203",4898,1529,0,0,240,55,3066,1455,11243
"48215024204",2176,1984,0,0,112,121,1978,2082,8453
"48215024205",4243,2418,0,0,332,326,4516,2668,14503
"48215024301",921,191,0,0,181,5,880,183,2361
"48215024302",348,479,0,0,0,52,272,519,1670
"48215024402",5392,3483,0,0,251,346,5526,3721,18719
"48215024403",2481,2448,16,0,585,302,3074,2738,11644
"48215024404",2842,1002,0,15,186,0,2903,1017,7965
"48215024500",3500,3834,0,111,499,551,3904,4429,16828
"48215024600",3519,2378,12,0,382,540,3815,2893,13539
"48215980000",0,0,0,0,0,0,0,0,0
"48217960100",2612,523,254,102,209,30,414,241,4385
"48217960200",3419,552,0,0,52,0,181,56,4260
"48217960400",1421,382,0,5,40,1,84,78,2011
"48217960500",4782,941,12,69,157,17,524,88,6590
"48217960600",794,255,0,10,39,18,92,34,1242
"48217960700",1605,334,2,0,49,0,241,95,2326
"48217960800",2417,784,152,103,95,16,713,425,4705
"48217960900",1017,645,133,257,56,8,799,538,3453
"48217961000",741,282,537,37,45,29,535,278,2484
"48217961100",2839,474,45,33,101,58,510,197,4257
"48217961400",3046,513,489,120,82,2,299,78,4629
"48219950100",1029,256,36,16,227,9,523,200,2296
"48219950200",3476,387,0,7,461,41,940,266,5578
"48219950300",3355,193,103,1,511,112,1985,242,6502
"48219950400",3036,1016,209,83,493,275,2615,1018,8745
"48219950500",3181,462,63,105,309,104,1122,240,5586
"48219950600",1099,119,12,3,156,23,400,88,1900
"48219950700",1099,165,14,0,207,19,587,94,2185
"48221160100",3058,488,8,5,251,0,455,43,4308
"48221160204",2418,194,6,58,17,0,262,0,2955
"48221160205",4662,1015,61,31,423,205,360,454,7211
"48221160206",3331,384,10,0,78,0,244,30,4077
"48221160207",5247,850,0,1,99,1,205,75,6478
"48221160208",3626,1027,0,0,1007,98,1428,221,7407
"48221160209",7024,461,0,15,97,15,547,55,8214
"48221160210",4950,264,0,0,97,0,341,50,5702
"48221160301",5303,331,48,0,176,30,514,58,6460
"48221160302",3354,450,2,0,188,130,168,157,4449
"48223950100",2668,359,9,17,78,35,277,55,3498
"48223950200",3728,719,11,9,126,3,253,93,4942
"48223950300",4053,709,65,13,375,88,698,284,6285
"48223950401",2324,693,337,279,282,55,843,119,4932
"48223950402",2475,591,176,0,127,163,365,251,4148
"48223950500",1463,716,336,30,178,15,241,181,3160
"48223950600",2090,700,696,228,189,417,87,332,4739
"48223950700",3062,658,94,27,380,154,534,372,5281
"48223950800",2168,501,50,8,127,0,431,54,3339
"48225950100",3690,549,461,241,41,315,41,298,5636
"48225950200",889,158,203,76,96,7,95,81,1605
"48225950300",1001,101,388,650,83,54,101,54,2432
"48225950400",769,348,981,865,291,120,363,242,3979
"48225950500",2866,304,437,82,190,31,342,12,4264
"48225950600",1037,260,247,58,75,8,56,8,1749
"48225950700",1640,262,220,50,65,13,37,15,2302
"48227950100",1609,215,75,0,203,118,464,178,2862
"48227950200",1564,266,2,0,122,28,361,101,2444
"48227950300",589,358,36,11,279,92,644,336,2345
"48227950400",2435,568,210,78,183,112,966,321,4873
"48227950500",1937,701,93,72,476,152,1173,440,5044
"48227950600",3494,243,172,1,328,0,774,120,5132
"48227950700",2251,457,175,31,382,150,1454,308,5208
"48227950801",2916,259,135,51,582,152,574,261,4930
"48227950802",1085,249,181,21,267,78,666,258,2805
"48227950900",3219,244,6,10,322,7,781,72,4661
"48229950300",1641,1295,0,0,73,8,1260,1103,5380
"48231960100",1900,305,82,118,84,245,247,9,2990
"48231960200",1731,235,148,163,366,37,306,52,3038
"48231960300",2894,463,10,39,155,254,147,398,4360
"48231960400",3105,361,587,123,900,217,1128,232,6653
"48231960500",1513,1043,422,278,222,150,276,227,4131
"48231960600",830,712,490,186,195,135,158,288,2994
"48231960700",4385,384,229,0,360,9,403,18,5788
"48231960800",910,598,616,181,559,777,811,1147,5599
"48231960900",1777,684,492,400,777,487,1125,524,6266
"48231961000",1741,929,275,245,648,36,560,60,4494
"48231961100",5785,511,357,7,238,0,203,6,7107
"48231961200",3337,309,525,21,529,26,427,41,5215
"48231961300",4716,465,134,208,250,199,366,231,6569
"48231961400",5742,732,275,60,580,258,846,258,8751
"48231961501",2564,240,0,0,97,8,111,0,3020
"48231961502",3782,711,57,0,204,194,427,194,5569
"48231961503",3464,487,19,56,277,83,264,64,4714
"48231961600",3510,1784,15,3,267,77,193,164,6013
"48231961700",2604,258,23,11,122,0,51,10,3079
"48233950200",1987,162,0,0,151,18,290,22,2630
"48233950500",4477,521,9,8,104,39,196,34,5388
"48233950600",2495,810,137,103,266,229,1292,488,5820
"48233950700",948,580,38,5,50,56,259,212,2148
"48233950800",325,191,28,0,91,48,107,173,963
"48233950900",3353,261,23,36,353,91,608,91,4816
"48233951000",3042,235,39,81,238,69,736,76,4516
"48235950100",1353,154,2,0,115,2,371,66,2063
"48237950100",1351,146,0,0,18,16,167,0,1698
"48237950300",2517,551,51,0,19,42,429,364,3973
"48237950500",2252,652,2,0,108,0,177,0,3191
"48239950100",4399,552,74,31,219,106,1087,261,6729
"48239950200",2360,415,648,202,119,53,1000,366,5163
"48239950300",4054,412,94,23,198,101,1358,186,6426
"48241950100",4501,423,418,206,79,51,21,48,5747
"48241950200",1187,241,774,611,211,0,293,137,3454
"48241950300",649,760,1381,690,102,0,132,425,4139
"48241950400",3797,429,388,166,307,36,208,117,5448
"48241950500",2932,676,559,0,114,0,120,0,4401
"48241950600",1247,306,265,183,46,26,228,27,2328
"48241950700",7359,722,0,14,31,43,46,57,8272
"48241950800",2100,480,17,58,120,92,12,0,2879
"48243950100",1903,160,0,0,155,2,742,98,3060
"48245000101",2758,343,1738,633,98,105,580,108,6363
"48245000102",615,186,1038,141,59,29,109,81,2258
"48245000103",242,109,1343,1237,11,5,68,57,3072
"48245000200",1113,110,2655,421,324,138,325,221,5307
"48245000302",5125,29,905,107,666,0,538,0,7370
"48245000304",3707,970,1640,325,357,129,762,458,8348
"48245000306",2649,407,231,212,350,256,266,230,4601
"48245000307",1246,170,916,66,718,119,190,18,3443
"48245000308",2518,383,1601,481,474,284,218,116,6075
"48245000309",1558,67,605,135,220,17,139,17,2758
"48245000310",3723,120,1123,39,234,0,494,1,5734
"48245000400",2520,197,716,493,141,16,177,2,4262
"48245000500",1163,102,662,162,102,14,608,0,2813
"48245000600",810,104,2561,1496,538,385,1167,365,7426
"48245000700",249,79,2068,998,26,7,267,21,3715
"48245000900",106,198,655,865,0,118,74,227,2243
"48245001100",926,338,517,348,99,73,152,139,2592
"48245001200",1131,139,730,331,277,130,729,133,3600
"48245001301",2024,400,1809,61,257,22,637,49,5259
"48245001302",1407,113,929,449,289,51,441,16,3695
"48245001303",1774,198,668,229,404,32,316,92,3713
"48245001700",151,58,1047,513,25,18,27,15,1854
"48245001900",831,544,788,231,378,158,720,414,4064
"48245002000",572,328,762,219,363,75,497,230,3046
"48245002100",223,242,1828,987,57,0,180,177,3694
"48245002200",200,66,1506,1038,17,24,44,39,2934
"48245002300",143,125,2070,762,9,0,151,91,3351
"48245002400",750,278,1199,571,27,51,377,269,3522
"48245002500",838,237,1559,980,411,40,741,133,4939
"48245002600",574,345,1261,1653,303,406,294,63,4899
"48245005100",83,0,558,308,0,9,0,9,967
"48245005400",203,58,722,282,20,48,48,65,1446
"48245005500",842,239,749,306,594,211,704,100,3745
"48245005600",1751,1062,430,296,327,121,1653,649,6289
"48245005900",11,90,665,906,0,0,11,0,1683
"48245006100",32,77,686,266,5,5,32,17,1120
"48245006300",98,122,768,361,34,6,43,20,1452
"48245006400",479,127,768,152,70,11,430,86,2123
"48245006500",1154,588,766,332,359,251,977,772,5199
"48245006600",1175,824,549,556,324,456,667,655,5206
"48245006700",1459,448,521,45,379,78,1437,466,4833
"48245006800",778,243,331,110,252,19,415,191,2339
"48245006900",899,108,1182,655,69,7,64,0,2984
"48245007001",1322,1095,1327,1216,642,107,220,722,6651
"48245007002",1842,185,764,216,1259,209,599,226,5300
"48245007100",2636,601,265,1,116,236,828,497,5180
"48245010100",1256,575,289,55,319,183,1201,604,4482
"48245010200",821,412,599,179,98,30,312,387,2838
"48245010300",1706,184,240,229,276,228,1203,329,4395
"48245010400",2338,270,42,64,68,146,173,116,3217
"48245010500",2521,538,389,303,352,12,1142,414,5671
"48245010600",4371,685,1,0,240,116,942,117,6472
"48245010700",3024,84,12,63,62,0,306,11,3562
"48245010800",3618,895,84,0,152,20,263,35,5067
"48245010901",2669,241,214,0,170,51,42,36,3423
"48245010902",3969,180,160,0,416,0,678,37,5440
"48245011001",3991,743,121,38,212,126,604,105,5940
"48245011002",3323,142,51,9,64,0,292,57,3938
"48245011101",4054,312,32,11,198,26,541,10,5184
"48245011102",2339,200,52,0,126,0,431,9,3157
"48245011201",6028,325,12,17,311,9,651,9,7362
"48245011202",0,0,0,0,0,0,0,0,0
"48245011203",0,0,0,0,0,0,0,0,0
"48245011302",0,0,0,0,0,0,0,0,0
"48245011303",2124,156,0,0,57,50,180,50,2617
"48245011304",2660,148,337,86,173,8,73,17,3502
"48245011400",5531,762,1189,104,137,190,499,643,9055
"48245011500",2089,302,59,5,26,40,134,109,2764
"48245011600",1437,206,19,1,84,0,149,77,1973
"48245011700",519,141,436,351,80,0,452,128,2107
"48245011800",86,101,1041,433,22,0,45,53,1781
"48245980000",36,0,0,0,86,24,17,0,163
"48245990000",0,0,0,0,0,0,0,0,0
"48247950200",2562,204,0,0,92,8,2545,189,5600
"48247950400",1573,607,106,1,78,8,1551,591,4515
"48249950100",7665,1210,60,53,246,124,4627,766,14751
"48249950200",5562,1131,106,0,439,320,5202,1281,14041
"48249950300",5358,727,0,0,467,10,4467,716,11745
"48249950400",2639,902,0,0,38,9,2244,767,6599
"48249950500",3994,1362,0,3,221,346,3823,1463,11212
"48249950600",2950,1247,27,0,151,50,2993,1255,8673
"48249950700",2268,829,0,0,231,31,2063,851,6273
"48251130100",3642,326,0,0,110,0,485,84,4647
"48251130204",9171,1064,403,3,367,16,1469,218,12711
"48251130205",3194,525,73,0,185,0,392,33,4402
"48251130207",6093,302,194,0,231,0,661,17,7498
"48251130208",5050,488,0,0,80,87,408,114,6227
"48251130210",4128,239,38,2,282,9,375,45,5118
"48251130211",4711,942,0,0,97,65,553,573,6941
"48251130212",3793,864,136,0,124,54,641,488,6100
"48251130213",3574,427,70,1,226,7,688,116,5109
"48251130214",4211,329,67,10,91,26,440,53,5227
"48251130215",3596,131,270,0,50,20,326,20,4413
"48251130302",3196,766,87,0,266,210,406,228,5159
"48251130303",2532,949,8,170,201,33,902,587,5382
"48251130304",3287,930,186,101,206,151,1126,562,6549
"48251130405",5356,246,0,1,143,1,641,1,6389
"48251130406",5653,105,16,19,160,0,628,24,6605
"48251130407",6292,1232,63,7,634,389,2867,1247,12731
"48251130408",5143,442,108,9,652,163,1463,119,8099
"48251130409",5637,360,19,2,163,36,458,25,6700
"48251130410",5760,778,118,95,385,20,1258,326,8740
"48251130500",5812,588,49,51,146,0,290,160,7096
"48251130601",5595,822,1,2,241,72,360,225,7318
"48251130602",1570,205,0,0,124,0,136,146,2181
"48251130700",3430,595,10,0,269,24,1008,203,5539
"48251130800",2183,1222,77,27,80,252,903,793,5537
"48251130900",1840,748,257,209,207,12,1002,488,4763
"48251131000",3795,423,116,29,590,9,447,216,5625
"48251131100",4605,341,0,63,141,0,1231,1,6382
"48253020101",905,179,3,0,82,0,125,6,1300
"48253020102",0,0,0,0,0,0,0,0,0
"48253020200",1634,314,55,9,82,12,671,160,2937
"48253020300",1555,445,61,63,68,33,318,133,2676
"48253020400",2051,452,53,295,249,101,634,216,4051
"48253020500",3583,345,1,45,208,96,273,65,4616
"48255970100",1980,161,0,0,86,39,147,96,2509
"48255970200",1584,464,136,14,797,385,1451,638,5469
"48255970300",2340,328,95,31,862,1063,1860,1198,7777
"48255970400",756,35,9,0,424,207,676,239,2346
"48257050201",4624,663,346,0,666,9,1183,477,7968
"48257050203",6720,138,1305,99,406,10,786,3,9467
"48257050204",3813,430,862,7,454,0,1491,175,7232
"48257050205",5077,281,387,7,466,52,820,12,7102
"48257050206",8401,498,644,161,731,11,1747,125,12318
"48257050300",2260,534,256,354,318,45,760,312,4839
"48257050400",4660,1397,327,34,649,302,1578,1281,10228
"48257050500",1316,358,2289,520,284,33,712,191,5703
"48257050600",4901,1022,494,0,302,0,861,521,8101
"48257050701",3625,522,238,17,311,101,358,400,5572
"48257050703",2052,314,18,36,250,54,344,108,3176
"48257050704",4089,966,133,118,181,276,436,697,6896
"48257050800",8162,802,217,72,231,10,587,48,10129
"48257051000",715,472,92,97,53,110,266,471,2276
"48257051100",3014,597,192,148,161,156,752,391,5411
"48257051201",1923,765,36,0,87,30,224,195,3260
"48257051202",4251,489,0,41,113,72,365,16,5347
"48257051300",7256,1268,306,60,207,70,592,72,9831
"48259970100",4879,1356,0,0,62,154,712,1365,8528
"48259970301",4819,432,2,2,75,0,798,28,6156
"48259970302",4236,54,67,0,31,0,706,26,5120
"48259970401",7038,195,0,3,492,117,1493,8,9346
"48259970402",5915,297,0,0,91,0,597,217,7117
"48259970500",3977,487,144,0,431,226,1238,457,6960
"48261950100",370,138,9,0,11,0,252,133,913
"48261990000",0,0,0,0,0,0,0,0,0
"48263950100",697,84,0,0,23,0,69,51,924
"48265960100",4402,779,0,0,258,149,695,172,6455
"48265960200",3223,116,7,0,87,0,286,1,3720
"48265960301",3154,1216,0,0,84,0,753,557,5764
"48265960302",5928,654,8,29,229,14,1169,82,8113
"48265960401",1520,219,0,0,332,38,724,22,2855
"48265960402",4280,418,179,0,238,0,1009,48,6172
"48265960500",3177,767,85,145,476,156,1449,383,6638
"48265960600",5017,1989,99,9,202,0,2278,809,10403
"48265960700",4546,156,25,97,292,0,558,0,5674
"48265960800",2496,836,11,20,66,11,570,392,4402
"48267950100",1837,247,0,0,163,23,352,108,2730
"48267950200",1495,595,0,0,33,52,270,308,2753
"48269950100",260,21,0,0,9,0,56,8,354
"48271950100",2431,791,35,17,4,31,1282,644,5235
"48273020100",4082,613,0,31,115,229,2606,632,8308
"48273020200",3277,1438,0,23,274,117,3086,1461,9676
"48273020300",3056,1788,246,122,331,536,2358,1826,10263
"48273020400",4746,1285,187,69,449,80,3731,1170,11717
"48273020500",4875,988,326,88,528,307,3786,944,11842
"48273990000",0,0,0,0,0,0,0,0,0
"48275950100",1337,248,18,36,82,11,344,112,2188
"48275950200",1291,261,114,91,126,18,557,174,2632
"48277000101",3956,464,72,0,447,23,518,7,5487
"48277000102",4079,568,82,29,117,5,103,143,5126
"48277000200",2520,475,129,85,87,30,86,223,3635
"48277000300",4289,695,207,58,384,70,489,72,6264
"48277000401",2136,477,609,90,216,60,24,95,3707
"48277000402",5822,283,169,5,313,0,558,7,7157
"48277000500",687,516,970,770,58,227,0,134,3362
"48277000600",795,510,289,182,152,88,19,0,2035
"48277000700",2009,278,353,367,101,39,98,62,3307
"48277000800",1383,707,413,406,88,209,43,102,3351
"48277000900",3432,483,104,101,414,79,123,105,4841
"48277001000",2255,522,263,238,90,79,138,145,3730
"48279950100",1619,488,6,0,88,28,1043,450,3722
"48279950200",1240,212,29,6,42,3,556,205,2293
"48279950300",1697,460,43,23,184,130,878,406,3821
"48279950500",2157,749,249,25,242,123,1584,739,5868
"48279950600",2738,720,63,184,62,8,1020,393,5188
"48281950100",2116,423,8,51,44,5,312,299,3258
"48281950301",5569,472,451,0,507,0,729,31,7759
"48281950302",2385,258,49,0,126,0,328,0,3146
"48281950400",2006,793,19,229,335,216,713,491,4802
"48281950500",3091,401,48,6,106,16,709,18,4395
"48283950300",3859,974,0,0,1314,47,4325,957,11476
"48285000100",3283,250,110,37,76,51,138,30,3975
"48285000200",2499,253,247,173,120,105,258,130,3785
"48285000300",2085,157,33,3,237,108,290,127,3040
"48285000400",2607,178,178,88,195,28,202,63,3539
"48285000500",2262,202,58,9,532,20,645,26,3754
"48285000600",1192,160,310,112,1006,41,1189,98,4108
"48287000100",4286,276,102,163,167,0,428,26,5448
"48287000200",1974,107,430,191,278,18,473,27,3498
"48287000300",2349,207,48,47,18,0,185,20,2874
"48287000400",2973,1174,696,188,352,29,1565,875,7852
"48289950100",5343,807,441,222,533,99,1304,336,9085
"48289950200",3321,540,109,34,117,59,146,201,4527
"48289950300",3962,386,410,102,148,0,249,64,5321
"48291700100",2828,943,127,102,428,262,841,742,6273
"48291700200",661,419,968,217,33,59,49,200,2606
"48291700300",7270,1603,81,52,651,634,1688,1497,13476
"48291700400",5418,920,0,53,232,36,465,151,7275
"48291700500",1757,344,86,16,18,16,118,4,2359
"48291700600",1854,624,44,52,104,244,134,209,3265
"48291700700",2294,259,37,9,178,0,312,0,3089
"48291700800",6819,817,330,247,710,35,910,60,9928
"48291700900",1332,255,190,21,91,9,272,83,2253
"48291701000",3829,429,416,80,1256,171,2070,430,8681
"48291701100",4006,786,254,15,204,73,301,246,5885
"48291701200",3717,641,195,895,458,13,575,370,6864
"48291701300",2478,258,59,58,24,13,15,22,2927
"48291701400",4412,656,1282,416,547,182,1099,579,9173
"48293970100",1305,428,254,49,29,23,285,267,2640
"48293970200",2529,367,724,349,91,24,180,213,4477
"48293970300",1013,563,657,160,74,81,305,580,3433
"48293970400",430,195,560,13,127,74,268,199,1866
"48293970500",1137,419,436,56,4,0,491,327,2870
"48293970600",3332,1021,330,319,139,84,447,287,5959
"48293970700",1370,216,0,4,60,0,148,0,1798
"48293970800",2592,490,75,35,66,18,115,70,3461
"48295950200",1496,204,13,0,305,30,605,170,2823
"48295950300",1125,110,0,0,76,8,123,19,1461
"48297950100",2503,637,10,12,121,0,983,282,4548
"48297950200",1432,379,0,0,180,25,798,337,3151
"48297950300",2251,250,0,3,93,0,492,125,3214
"48297950400",1776,249,0,0,168,0,335,86,2614
"48299970100",2026,140,0,0,42,0,118,13,2339
"48299970200",2626,790,0,0,13,22,346,121,3918
"48299970300",1544,188,0,7,18,0,57,5,1819
"48299970400",3374,96,127,0,41,0,82,0,3720
"48299970500",4815,1187,235,0,33,223,347,572,7412
"48299970600",1228,205,70,0,4,0,40,17,1564
"48301950100",37,0,0,0,32,16,21,5,111
"48303000100",1226,374,81,46,711,25,1290,392,4145
"48303000201",954,319,22,71,324,24,708,232,2654
"48303000202",770,426,18,42,393,401,1064,746,3860
"48303000301",1223,1132,133,102,557,629,977,535,5288
"48303000302",3062,1069,121,213,1603,634,3727,1148,11577
"48303000402",3084,686,193,30,489,127,1075,246,5930
"48303000403",2903,587,168,4,221,11,724,111,4729
"48303000404",4805,1018,284,42,1531,106,1775,212,9773
"48303000405",5553,2431,605,337,1665,280,3125,1002,14998
"48303000500",581,226,0,0,38,26,94,30,995
"48303000603",293,2239,69,178,172,159,65,210,3385
"48303000605",77,666,0,0,5,145,2,183,1078
"48303000607",782,727,296,286,173,88,227,91,2670
"48303000700",683,92,40,25,244,49,718,124,1975
"48303000900",761,829,1509,595,571,94,1343,726,6428
"48303001000",473,894,905,385,378,164,723,880,4802
"48303001200",273,178,1340,732,93,38,345,214,3213
"48303001300",1119,1323,0,73,640,274,1406,1464,6299
"48303001400",2472,1962,134,89,671,300,1465,1155,8248
"48303001501",1454,504,23,0,106,89,286,101,2563
"48303001502",1145,567,0,4,97,47,181,100,2141
"48303001601",1501,256,60,11,211,47,280,12,2378
"48303001602",1635,816,47,187,510,154,861,261,4471
"48303001702",3473,522,206,293,202,7,707,288,5698
"48303001705",4960,532,139,19,451,92,653,123,6969
"48303001706",3411,811,130,218,788,83,1626,161,7228
"48303001707",3469,285,116,3,391,98,768,71,5201
"48303001708",1138,972,175,50,266,32,348,412,3393
"48303001709",2627,668,276,226,444,273,1209,692,6415
"48303001801",3519,1104,347,199,707,106,1726,479,8187
"48303001803",3417,504,418,56,961,257,1318,301,7232
"48303001804",3277,219,55,58,273,54,485,85,4506
"48303001901",3076,754,644,14,336,19,1152,291,6286
"48303001903",4355,318,276,130,92,23,656,140,5990
"48303001904",1300,96,11,0,67,9,175,24,1682
"48303002001",1572,377,49,1,188,6,494,115,2802
"48303002002",1568,625,199,90,308,308,920,357,4375
"48303002101",4631,917,30,0,220,158,1881,183,8020
"48303002102",2504,117,110,8,211,24,735,45,3754
"48303002202",3217,518,449,29,823,200,1902,504,7642
"48303002203",1879,528,170,15,286,13,664,465,4020
"48303002204",2271,1492,344,286,347,385,1349,1616,8090
"48303002300",3026,561,257,293,620,104,2700,560,8121
"48303002400",2803,1678,404,360,1174,263,3206,1661,11549
"48303002500",1229,500,214,85,227,163,802,492,3712
"48303010101",1593,71,0,19,29,0,261,9,1982
"48303010102",1814,238,30,6,313,40,803,125,3369
"48303010200",5172,1052,70,116,762,182,2878,788,11020
"48303010301",2895,440,0,0,56,60,379,73,3903
"48303010302",2131,265,0,0,279,7,791,117,3590
"48303010402",1227,337,96,57,207,102,563,262,2851
"48303010403",5029,162,89,0,477,57,1084,40,6938
"48303010404",2249,220,41,104,287,115,851,217,4084
"48303010405",3592,305,0,23,493,52,1286,82,5833
"48303010406",3561,560,0,1,406,0,492,82,5102
"48303010407",6433,128,172,0,887,0,667,23,8310
"48303010408",7490,342,130,0,765,365,1523,341,10956
"48303010502",2798,58,27,0,250,11,161,11,3316
"48303010504",3446,46,32,0,371,0,509,11,4415
"48303010505",3706,240,233,12,497,115,1230,111,6144
"48303010506",3463,359,39,0,393,53,992,122,5421
"48303010508",5615,572,118,75,753,170,2362,265,9930
"48303010509",2399,45,33,0,119,4,118,0,2718
"48303010510",2440,102,24,0,22,0,173,39,2800
"48303010511",3328,476,141,0,496,47,853,368,5709
"48303010600",3667,544,539,221,510,516,1792,961,8750
"48303010700",3261,412,146,24,123,1,549,242,4758
"48303980000",0,0,0,0,0,0,0,0,0
"48305950400",1437,227,0,0,214,45,505,198,2626
"48305950500",1819,371,33,0,185,75,818,388,3689
"48305950600",896,310,0,0,125,7,538,258,2134
"48307950300",3770,887,85,7,247,327,1341,530,7194
"48307950400",1336,179,0,0,24,0,330,91,1960
"48307950500",1042,95,0,4,82,22,142,62,1449
"48309000100",753,757,14,93,253,48,430,173,2521
"48309000200",452,2081,64,303,207,154,80,332,3673
"48309000300",12,0,0,0,0,0,0,0,12
"48309000400",1379,2193,257,806,600,582,1072,595,7484
"48309000598",2231,1716,147,188,812,255,2668,1744,9761
"48309000700",2064,687,391,96,117,23,1344,329,5051
"48309000800",1436,432,347,213,295,126,1042,382,4273
"48309000900",2485,899,641,190,608,223,1717,674,7437
"48309001000",1136,606,303,438,339,127,1180,603,4732
"48309001100",2838,1146,840,611,299,302,2359,1108,9503
"48309001200",817,407,764,564,226,133,877,476,4264
"48309001300",1307,156,303,290,120,10,952,136,3274
"48309001400",1390,519,3192,2040,174,423,422,470,8630
"48309001500",232,138,1185,548,6,81,138,65,2393
"48309001600",2249,1727,619,333,724,60,1140,1190,8042
"48309001700",2773,904,995,349,354,50,1153,512,7090
"48309001800",935,3,209,71,157,0,313,7,1695
"48309001900",540,1971,635,654,187,315,431,430,5163
"48309002000",3201,268,18,0,34,31,325,119,3996
"48309002100",2172,838,664,644,323,575,1347,970,7533
"48309002302",1935,935,1077,619,159,80,674,487,5966
"48309002498",2966,629,329,220,164,0,1012,394,5714
"48309002501",2775,394,500,318,481,119,924,282,5793
"48309002503",4557,230,384,53,30,0,462,20,5736
"48309002504",3160,162,19,18,33,0,386,0,3778
"48309002600",4695,418,364,78,241,0,729,353,6878
"48309002700",2213,391,680,188,376,290,1491,521,6150
"48309002800",2758,479,229,113,255,0,243,106,4183
"48309002900",3644,79,33,2,311,5,484,0,4558
"48309003000",2404,491,254,225,248,21,570,277,4490
"48309003200",2426,837,947,538,361,76,803,676,6664
"48309003300",414,446,120,104,58,126,77,69,1414
"48309003400",5113,488,122,16,78,106,593,82,6598
"48309003500",3214,490,12,0,93,7,303,8,4127
"48309003601",1735,264,501,196,81,13,167,89,3046
"48309003602",1787,461,51,24,62,29,151,85,2650
"48309003701",2406,229,248,0,150,43,482,113,3671
"48309003703",4845,340,101,0,128,15,681,55,6165
"48309003706",8098,182,818,68,919,79,1439,0,11603
"48309003707",6299,420,779,5,696,266,1379,17,9861
"48309003708",5509,280,482,0,924,67,829,116,8207
"48309003801",6447,237,57,0,363,12,647,34,7797
"48309003802",4471,948,239,29,99,118,973,287,7164
"48309003900",6196,1186,570,0,251,36,1080,612,9931
"48309004000",4589,271,16,20,64,11,249,12,5232
"48309004102",4613,825,8,0,86,0,314,132,5978
"48309004103",6869,588,298,80,281,0,1055,4,9175
"48309004201",3231,460,106,71,63,9,189,87,4216
"48309004202",2653,368,45,20,98,0,217,41,3442
"48309004300",3343,1849,653,117,458,183,2358,1632,10593
"48309980000",0,0,0,0,0,0,0,0,0
"48311950100",506,108,0,0,32,0,294,73,1013
"48313000100",902,118,59,27,39,32,5,55,1237
"48313000200",1241,333,20,14,54,2,97,98,1859
"48313000300",1888,284,11,0,25,21,42,32,2303
"48313000400",2615,940,454,460,242,96,687,416,5910
"48315950100",1666,85,192,326,34,0,94,0,2397
"48315950200",1686,430,629,143,32,129,0,26,3075
"48315950300",1752,721,59,32,58,10,159,0,2791
"48315950400",1076,108,508,425,20,7,38,0,2182
"48317950100",1150,117,0,0,177,20,235,69,1768
"48317950200",2678,337,34,54,269,184,1700,322,5578
"48319950100",1406,379,0,0,206,0,550,168,2709
"48319950200",1931,70,0,0,49,5,246,12,2313
"48321730100",1628,536,206,173,218,66,1193,559,4579
"48321730201",4465,1752,271,38,272,189,1985,977,9949
"48321730202",1091,33,187,0,0,0,309,14,1634
"48321730301",3031,823,25,17,127,26,1228,451,5728
"48321730302",2374,448,949,131,275,226,1334,325,6062
"48321730303",449,89,47,120,111,0,142,0,958
"48321730400",1219,71,489,372,283,60,520,17,3031
"48321730501",2147,467,413,56,104,3,291,183,3664
"48321730600",3687,636,29,0,529,626,2042,813,8362
"48321730700",3538,767,104,32,52,0,1297,602,6392
"48321990000",0,0,0,0,0,0,0,0,0
"48323950201",3669,2023,0,0,529,398,4002,2095,12716
"48323950204",3180,999,0,0,164,0,3234,999,8576
"48323950205",6392,2647,0,0,75,243,6372,2890,18619
"48323950300",6093,860,0,0,503,41,6045,871,14413
"48323950400",2460,817,0,7,168,88,2574,853,6967
"48323950500",2864,3082,0,0,254,90,2890,3143,12323
"48323950601",1526,926,5,6,144,28,1655,924,5214
"48323950602",3636,1403,7,1,229,77,3824,1480,10657
"48323950700",6209,2627,14,0,512,86,6058,2613,18119
"48325000101",5811,859,8,0,326,55,3309,422,10790
"48325000102",6585,680,102,14,774,71,1961,638,10825
"48325000200",1591,196,0,0,26,7,529,155,2504
"48325000300",4750,984,48,0,509,0,2424,834,9549
"48325000401",4220,721,0,0,160,13,3113,716,8943
"48325000402",3004,638,0,18,148,134,1220,431,5593
"48325000500",3466,1332,17,12,269,0,1964,1134,8194
"48325000800",5054,1098,0,0,477,83,2879,791,10382
"48327950300",1633,307,3,14,154,28,618,191,2948
"48329000100",2683,285,1917,330,582,532,2591,813,9733
"48329000200",3690,566,9,24,122,26,1043,244,5724
"48329000302",4369,207,629,1,433,75,999,175,6888
"48329000303",3926,162,0,1,96,0,627,73,4885
"48329000304",2868,104,92,68,690,89,721,73,4705
"48329000305",4018,101,339,0,341,87,589,12,5487
"48329000401",2592,71,75,1,462,0,1173,30,4404
"48329000402",3676,572,198,0,497,0,1803,241,6987
"48329000500",3867,789,26,158,120,167,1142,648,6917
"48329000600",3024,156,307,2,600,15,1443,47,5594
"48329001100",3754,739,234,22,862,69,3042,505,9227
"48329001200",5726,329,292,0,1476,0,4603,209,12635
"48329001300",4567,591,257,0,717,88,2837,292,9349
"48329001400",2849,702,251,22,483,299,2967,874,8447
"48329001500",2120,563,675,127,712,106,2534,662,7499
"48329001700",2442,730,524,437,464,237,2839,928,8601
"48329010104",5884,112,799,45,586,25,1523,26,9000
"48329010105",2502,477,167,76,375,29,829,316,4771
"48329010106",4157,866,100,14,308,0,985,481,6911
"48329010107",4258,228,15,2,609,14,1534,25,6685
"48329010108",2827,172,212,9,267,0,625,92,4204
"48329010109",6214,583,213,15,820,51,4105,382,12383
"48329010112",10062,594,104,0,505,0,2295,299,13859
"48329010113",9233,216,38,0,706,39,2720,74,13026
"48329010114",5695,533,32,0,375,56,2180,196,9067
"48329010200",1711,547,278,79,561,52,2167,563,5958
"48329980000",0,0,0,0,0,0,0,0,0
"48331950100",1730,447,13,113,95,48,455,160,3061
"48331950300",2864,663,62,29,181,82,584,358,4823
"48331950401",1947,316,189,94,479,17,751,131,3924
"48331950402",1890,168,348,391,122,46,706,60,3731
"48331950500",2287,435,120,55,72,1,271,51,3292
"48331950700",3525,1169,202,293,417,117,1076,741,7540
"48331950800",2503,151,64,16,169,16,507,25,3451
"48333950100",1457,239,0,3,8,1,147,70,1925
"48333950200",2600,327,0,0,61,2,429,57,3476
"48335950200",4043,419,191,0,259,81,1597,352,6942
"48335950400",1340,189,50,7,167,48,365,108,2274
"48337950100",2359,364,0,0,29,0,110,16,2878
"48337950200",1558,172,8,7,33,0,71,36,1885
"48337950300",1909,680,0,1,167,60,361,168,3346
"48337950400",4382,136,0,19,122,62,359,73,5153
"48337950500",4000,974,0,0,141,147,323,300,5885
"48337950600",1706,206,0,0,35,7,53,54,2061
"48339690100",7807,1360,61,0,476,647,1063,1305,12719
"48339690201",9214,675,60,0,333,43,1036,51,11412
"48339690202",4988,1044,104,0,419,13,809,602,7979
"48339690300",3283,1053,196,33,305,0,1021,686,6577
"48339690401",4670,613,287,0,782,26,736,15,7129
"48339690402",13439,1634,163,3,1196,993,2965,2001,22394
"48339690500",7603,173,12,0,391,46,406,100,8731
"48339690601",17979,707,0,234,1718,1,1827,90,22556
"48339690602",17284,476,877,0,2207,23,3531,370,24768
"48339690700",8546,314,198,2,557,42,947,22,10628
"48339690800",3542,86,0,0,412,0,332,32,4404
"48339690900",4147,78,21,17,367,0,411,0,5041
"48339691000",4065,87,82,0,284,0,369,0,4887
"48339691100",4096,115,0,0,143,0,470,34,4858
"48339691200",6001,324,213,25,612,25,708,98,8006
"48339691301",3631,143,133,0,601,0,271,7,4786
"48339691302",3968,540,280,254,429,67,816,155,6509
"48339691400",6660,1035,817,0,1112,111,1548,87,11370
"48339691500",3066,377,34,231,479,29,730,265,5211
"48339691601",3395,175,0,0,404,76,453,101,4604
"48339691602",4140,867,77,0,509,93,1065,451,7202
"48339691700",1597,49,36,2,174,0,272,4,2134
"48339691800",6105,277,651,16,666,123,1316,289,9443
"48339691900",4770,552,299,0,182,308,981,357,7449
"48339692001",24339,1025,2822,6,3132,316,5073,302,37015
"48339692002",6559,132,439,36,1060,0,1321,54,9601
"48339692100",9603,796,657,51,982,274,2598,339,15300
"48339692200",6804,1252,19,0,323,217,1843,723,11181
"48339692300",10928,1606,760,54,1446,339,3106,1210,19449
"48339692400",6323,1446,408,66,880,571,1318,821,11833
"48339692500",6500,1522,29,118,600,48,1806,610,11233
"48339692601",3048,981,11,40,171,41,1364,513,6169
"48339692602",6198,2041,139,0,849,655,1696,1583,13161
"48339692700",4731,1346,79,0,403,146,936,361,8002
"48339692801",6749,1220,105,0,457,229,927,475,10162
"48339692802",3017,870,126,5,127,297,796,857,6095
"48339692900",3660,763,20,13,152,24,1051,135,5818
"48339693000",6137,2608,372,0,861,249,2798,2102,15127
"48339693101",2433,1625,864,385,418,24,1833,1391,8973
"48339693102",3489,983,486,85,286,108,2497,878,8812
"48339693200",7074,495,140,55,405,18,777,267,9231
"48339693300",4932,566,441,280,406,26,1386,13,8050
"48339693400",1718,1471,546,651,49,20,1253,1111,6819
"48339693500",4396,875,250,306,123,78,1275,499,7802
"48339693600",2601,311,385,105,185,51,520,261,4419
"48339693700",7183,524,258,68,384,8,934,146,9505
"48339693800",2914,758,442,119,432,36,1499,461,6661
"48339693900",6537,2480,162,35,303,13,3925,2167,15622
"48339694000",8029,1042,129,0,408,635,1789,684,12716
"48339694101",7682,1160,604,270,853,396,2279,926,14170
"48339694102",4185,725,105,0,397,30,1245,309,6996
"48339694201",4923,679,128,169,51,79,320,313,6662
"48339694202",9730,179,254,6,543,15,868,8,11603
"48339694301",10981,501,243,5,524,7,768,0,13029
"48339694302",7096,355,20,0,354,0,518,30,8373
"48339694400",5524,887,347,1,411,404,897,594,9065
"48339694500",5771,338,148,0,446,12,421,0,7136
"48339694600",4454,474,243,114,648,149,792,324,7198
"48339694700",2468,446,294,25,101,0,114,64,3512
"48341950100",1851,321,3,0,189,42,697,234,3337
"48341950200",4164,694,235,0,982,223,2572,598,9468
"48341950300",4750,1482,42,13,565,320,2339,1222,10733
"48341950400",3690,666,159,110,1225,250,3323,624,10047
"48343950100",3062,340,639,317,152,19,183,17,4729
"48343950200",3474,393,754,496,406,215,374,203,6315
"48343950300",1356,130,451,267,100,36,185,69,2594
"48345950100",956,150,8,4,36,15,149,52,1370
"48347950100",1781,168,146,47,173,19,144,65,2543
"48347950200",4184,464,38,8,126,120,234,187,5361
"48347950301",4885,1306,187,183,82,135,709,905,8392
"48347950302",4237,1382,573,279,621,59,1587,1314,10052
"48347950400",6118,746,750,156,395,0,398,167,8730
"48347950501",1233,419,188,280,147,20,121,0,2408
"48347950502",3800,581,273,243,45,0,617,0,5559
"48347950600",870,631,493,182,30,126,42,43,2417
"48347950700",1659,731,962,799,95,35,989,468,5738
"48347950800",1835,558,504,359,272,108,1068,381,5085
"48347950900",224,483,918,797,31,69,80,391,2993
"48347951000",2165,1172,761,458,276,257,469,496,6054
"48347951100",3904,987,144,42,91,71,220,85,5544
"48349970100",2356,839,77,25,417,192,621,683,5210
"48349970200",3333,421,669,749,349,74,899,213,6707
"48349970300",4955,996,678,309,336,0,1061,581,8916
"48349970400",3181,787,110,0,128,15,336,271,4828
"48349970500",2796,588,274,400,152,93,720,386,5409
"48349970600",1988,373,691,154,98,23,104,56,3487
"48349970700",3381,388,801,729,120,113,257,93,5882
"48349970800",735,384,107,30,183,0,485,276,2200
"48349970900",4366,1524,686,40,1109,320,2619,1224,11888
"48349971000",2460,613,93,48,83,20,483,152,3952
"48351950100",1600,117,805,133,51,0,11,0,2717
"48351950200",2809,619,887,434,48,12,45,44,4898
"48351950300",1423,232,613,76,24,0,45,20,2433
"48351950400",3457,444,0,0,160,12,199,0,4272
"48353950100",1664,124,0,0,72,46,235,100,2241
"48353950200",3176,576,179,0,219,37,815,270,5272
"48353950300",1071,510,123,48,96,26,434,336,2644
"48353950400",2621,777,126,71,391,63,1734,481,6264
"48353950500",2042,418,0,0,150,20,530,281,3441
"48355000500",352,261,397,186,45,133,358,361,2093
"48355000600",4678,786,351,170,827,222,4729,929,12692
"48355000700",3184,961,116,46,521,316,2901,1105,9150
"48355000800",2443,577,81,72,208,45,2171,343,5940
"48355000900",2103,1512,53,19,466,65,2514,1555,8287
"48355001000",1657,1098,10,57,279,481,1834,1459,6875
"48355001100",947,646,61,181,13,27,922,633,3430
"48355001200",1720,1339,62,135,261,90,1192,1143,5942
"48355001300",2738,996,149,5,339,482,3174,1408,9291
"48355001400",3972,321,40,40,306,155,1820,239,6893
"48355001500",2028,1480,128,145,204,215,2104,1670,7974
"48355001601",2598,731,353,11,350,84,2897,793,7817
"48355001602",1953,1008,18,0,333,381,2213,1377,7283
"48355001701",3873,1197,892,104,492,1,4195,1156,11910
"48355001702",1417,160,94,0,167,63,1471,170,3542
"48355001801",3372,1363,186,223,434,221,3669,1537,11005
"48355001802",2058,157,117,0,320,35,2231,154,5072
"48355001902",5453,1754,322,0,521,59,5147,1524,14780
"48355001903",2572,564,74,39,447,32,2750,516,6994
"48355001904",2450,1191,110,0,384,202,2669,1350,8356
"48355002001",2598,1238,28,14,348,0,2477,1120,7823
"48355002002",3054,530,10,0,250,70,3015,459,7388
"48355002101",2535,795,173,166,269,48,1852,724,6562
"48355002102",2728,210,12,0,168,31,943,180,4272
"48355002200",3079,1580,28,0,1385,0,3569,1326,10967
"48355002301",3183,502,34,0,242,109,2854,559,7483
"48355002303",3295,621,307,9,209,123,2958,592,8114
"48355002304",4295,763,251,96,313,23,3694,629,10064
"48355002400",4635,547,134,47,526,55,3518,542,10004
"48355002500",3701,835,113,0,95,144,1498,621,7007
"48355002601",1531,456,23,30,176,11,542,390,3159
"48355002602",1516,479,16,0,42,6,1092,304,3455
"48355002603",2570,609,19,0,106,11,1434,398,5147
"48355002703",3911,521,50,23,401,261,2371,531,8069
"48355002704",3735,945,337,46,233,315,1414,809,7834
"48355002705",4217,413,78,274,359,176,1752,306,7575
"48355002706",0,0,0,0,0,0,0,0,0
"48355002900",784,24,112,0,35,23,207,27,1212
"48355003001",2970,1217,180,91,428,143,1102,892,7023
"48355003002",3568,696,28,7,560,167,1437,184,6647
"48355003101",4301,677,187,0,751,74,657,115,6762
"48355003102",3652,840,21,198,254,138,1308,429,6840
"48355003202",4694,191,179,32,517,60,2550,58,8281
"48355003203",4107,1030,231,0,423,0,2644,813,9248
"48355003204",3641,288,75,0,578,62,2110,215,6969
"48355003303",1207,270,28,10,108,0,1005,234,2862
"48355003304",4154,645,308,27,608,73,2580,586,8981
"48355003305",2423,1623,291,90,164,379,1862,1815,8647
"48355003306",3273,718,85,24,394,103,2194,651,7442
"48355003401",3081,348,318,134,265,133,2223,350,6852
"48355003402",4546,978,62,21,271,0,3071,860,9809
"48355003500",1799,253,28,15,157,86,1474,301,4113
"48355003601",4740,832,0,37,615,29,2572,675,9500
"48355003602",4869,930,182,30,524,22,2520,595,9672
"48355003603",3169,335,49,133,252,9,2187,309,6443
"48355003700",2975,160,7,0,281,40,1875,136,5474
"48355005102",3000,443,0,0,43,0,82,9,3577
"48355005404",2310,26,277,0,298,0,1128,18,4057
"48355005406",2283,226,128,0,218,41,1192,149,4237
"48355005407",1684,39,31,4,333,21,1375,38,3525
"48355005408",3647,184,95,32,127,0,2883,130,7098
"48355005409",2740,76,34,0,478,106,1763,48,5245
"48355005410",2923,364,154,0,110,1,1890,289,5731
"48355005411",2981,379,188,90,231,32,1613,258,5772
"48355005412",3589,113,440,0,712,0,2200,13,7067
"48355005413",2560,81,108,0,356,0,1820,44,4969
"48355005414",1593,8,64,139,235,7,1009,8,3063
"48355005415",3818,80,205,0,810,61,2646,99,7719
"48355005416",2953,0,181,0,453,0,1254,0,4841
"48355005417",3662,45,411,51,665,26,2280,36,7176
"48355005601",4872,1272,41,8,290,132,4799,1327,12741
"48355005602",3444,2257,22,0,412,74,3637,2288,12134
"48355005801",5825,165,39,1,94,119,1454,235,7932
"48355005802",5298,731,31,23,250,0,3118,493,9944
"48355005900",2386,450,0,0,272,32,2130,467,5737
"48355006000",2237,207,0,0,246,18,1921,146,4775
"48355006100",2606,391,4,0,291,28,2066,378,5764
"48355006200",8864,290,37,0,373,11,930,23,10528
"48355006300",1588,565,46,22,132,49,777,395,3574
"48355006400",1012,464,204,87,21,102,552,321,2763
"48355980000",21,0,0,0,0,0,15,0,36
"48355990000",0,0,0,0,0,0,0,0,0
"48357950100",1089,123,9,0,302,7,337,33,1900
"48357950300",2333,861,53,13,637,52,1852,751,6552
"48357950400",3671,521,0,0,783,29,2059,254,7317
"48359950100",1310,237,6,14,76,28,103,54,1828
"48361020200",848,94,1625,661,127,7,0,41,3403
"48361020300",1309,438,136,185,104,35,79,58,2344
"48361020500",2527,369,201,0,31,26,499,64,3717
"48361020700",3056,514,709,314,168,150,151,124,5186
"48361020800",1075,207,315,107,13,44,67,0,1828
"48361020900",1534,491,932,425,116,96,247,170,4011
"48361021000",1784,132,32,1,172,6,66,6,2199
"48361021100",1771,52,0,0,51,6,56,6,1942
"48361021200",4117,487,25,0,131,0,130,70,4960
"48361021300",4410,700,638,169,174,133,136,47,6407
"48361021400",3117,554,34,0,76,0,57,99,3937
"48361021501",1746,213,0,0,144,75,321,13,2512
"48361021502",6113,671,0,19,214,0,295,0,7312
"48361021600",3315,501,2,3,39,1,435,1,4297
"48361021700",1833,537,0,0,50,3,263,57,2743
"48361021800",2225,299,26,8,26,0,170,21,2775
"48361021900",5472,731,0,0,317,39,238,4,6801
"48361022000",3347,567,2,0,47,2,164,2,4131
"48361022200",2997,517,22,0,145,0,131,0,3812
"48361022300",5768,576,78,8,321,204,436,108,7499
"48361022400",3909,542,0,0,112,135,194,282,5174
"48363000100",2164,361,4,0,103,70,175,88,2965
"48363000200",1577,183,0,40,60,72,207,84,2223
"48363000300",3392,215,0,0,36,0,180,73,3896
"48363000400",4746,665,96,71,137,16,464,90,6285
"48363000500",1025,232,4,1,121,47,162,71,1663
"48363000600",2186,592,92,12,243,106,689,95,4015
"48363000700",2455,555,135,28,292,54,924,223,4666
"48363000800",1718,681,40,54,337,15,939,113,3897
"48363000900",1330,762,58,0,295,76,449,190,3160
"48365950100",2851,244,732,99,31,0,68,0,4025
"48365950200",2087,424,266,74,57,11,93,254,3266
"48365950300",3730,293,543,244,248,31,957,25,6071
"48365950400",4160,335,869,893,151,0,472,12,6892
"48365950500",2198,187,165,42,7,0,7,3,2609
"48365950600",1818,322,120,25,24,0,75,0,2384
"48367140101",3614,621,91,62,455,316,922,186,6267
"48367140102",3091,906,0,26,72,47,281,381,4804
"48367140200",5091,465,0,14,233,0,576,118,6497
"48367140300",5027,359,205,19,75,23,1251,82,7041
"48367140403",5422,736,100,0,113,28,339,135,6873
"48367140405",5178,655,23,1,232,26,524,52,6691
"48367140407",9109,535,51,0,191,65,605,0,10556
"48367140408",3529,285,22,19,114,14,362,4,4349
"48367140409",2406,1236,0,0,131,17,365,658,4813
"48367140410",2894,470,0,0,49,0,91,38,3542
"48367140411",3661,547,0,50,69,0,29,154,4510
"48367140501",6420,292,228,0,59,96,518,99,7712
"48367140502",3619,735,0,1,281,15,294,94,5039
"48367140601",6162,375,61,26,254,17,355,175,7425
"48367140602",8048,1203,130,0,713,76,1149,57,11376
"48367140703",5635,479,0,0,330,7,306,233,6990
"48367140704",6982,482,49,0,354,33,536,104,8540
"48367140705",6295,1178,62,0,277,9,424,667,8912
"48367140706",6143,298,94,0,134,10,278,0,6957
"48369950200",3243,726,21,0,279,193,2418,821,7701
"48369950300",4304,748,80,32,278,48,2240,634,8364
"48371950100",1616,194,150,0,432,6,1140,148,3686
"48371950300",2464,654,0,0,105,42,2344,656,6265
"48371950400",3567,408,0,0,190,22,2481,376,7044
"48371950500",2758,599,6,0,119,108,1929,658,6177
"48373210101",3589,777,31,39,140,0,137,49,4762
"48373210102",4926,1085,0,9,243,82,599,88,7032
"48373210203",1810,572,116,148,76,9,534,69,3334
"48373210204",2264,609,1074,51,44,287,262,515,5106
"48373210205",2017,201,22,59,42,0,60,45,2446
"48373210206",2773,440,7,71,57,71,86,56,3561
"48373210301",2745,631,105,2,47,8,96,0,3634
"48373210302",2954,473,650,208,131,87,326,164,4993
"48373210400",3099,684,675,290,297,20,994,299,6358
"48373210500",2983,258,436,98,569,179,496,121,5140
"48375010100",1513,384,41,33,106,1,303,23,2404
"48375010200",1816,10,0,0,45,0,95,0,1966
"48375010300",636,224,143,147,76,64,339,112,1741
"48375010400",2964,270,0,0,151,0,424,49,3858
"48375010600",1095,767,58,109,138,196,970,973,4306
"48375010700",2680,381,127,0,391,11,1933,227,5750
"48375011000",1098,542,14,60,82,69,744,531,3140
"48375011500",2853,492,45,12,182,15,564,205,4368
"48375011600",2745,372,222,25,878,323,777,192,5534
"48375011700",2318,472,434,302,308,100,606,416,4956
"48375011800",3144,306,50,100,195,80,584,43,4502
"48375011900",2006,535,245,84,345,115,751,298,4379
"48375012000",839,552,101,82,153,100,306,421,2554
"48375012200",2611,1037,222,0,172,158,2009,939,7148
"48375012600",1490,1154,204,29,453,240,1414,913,5897
"48375012800",2050,930,418,343,468,73,1699,827,6808
"48375013000",409,126,648,404,30,30,285,112,2044
"48375013200",1248,24,139,34,12,49,130,59,1695
"48375013300",4151,75,60,0,774,12,429,0,5501
"48375013400",2680,446,0,0,95,12,290,22,3545
"48375013900",1268,327,946,633,204,77,592,252,4299
"48375014100",1671,795,342,0,176,90,991,625,4690
"48375014300",4881,442,75,0,287,49,412,50,6196
"48375014401",1460,261,72,14,135,0,408,29,2379
"48375014500",3669,1790,77,22,320,46,2514,1643,10081
"48375014700",3914,658,21,26,392,86,980,448,6525
"48375014800",749,489,711,327,103,93,583,540,3595
"48375014900",1868,568,167,134,2264,796,1440,473,7710
"48375015000",4530,1654,189,529,626,137,3550,1557,12772
"48375015100",2777,349,10,0,212,54,516,84,4002
"48375015200",2163,126,48,38,91,35,410,35,2946
"48375015300",2806,1258,344,416,348,271,1097,858,7398
"48375015400",1039,710,86,61,433,69,1163,582,4143
"48375980000",0,0,0,0,0,0,0,0,0
"48377950100",1952,446,18,0,134,13,1341,253,4157
"48377950200",3300,1138,0,0,453,0,3319,1138,9348
"48379950100",5343,432,62,0,297,93,431,94,6752
"48379950200",3580,504,119,33,267,154,175,176,5008
"48381020100",1834,91,22,18,110,12,171,34,2292
"48381020200",1631,259,0,44,136,124,254,25,2473
"48381020300",1418,279,98,13,36,6,243,109,2202
"48381020400",1379,217,32,7,108,7,51,92,1893
"48381020500",2523,626,290,22,276,17,849,301,4904
"48381020600",3167,324,74,28,390,37,1439,147,5606
"48381020800",4921,1191,19,0,574,247,1300,323,8575
"48381020900",2252,355,92,59,215,53,532,105,3663
"48381021000",1967,141,52,3,93,35,550,91,2932
"48381021101",3264,294,94,76,269,38,507,210,4752
"48381021102",1214,425,40,56,86,55,358,238,2472
"48381021200",4718,268,0,81,214,154,474,253,6162
"48381021300",4329,273,331,83,226,10,896,44,6192
"48381021500",4287,130,121,0,53,3,390,6,4990
"48381021602",4539,164,51,0,350,20,647,0,5771
"48381021603",1651,44,67,2,104,0,210,2,2080
"48381021604",4337,257,0,0,107,5,808,1,5515
"48381021605",1745,83,45,1,104,25,272,56,2331
"48381021606",4356,152,54,24,359,0,473,0,5418
"48381021608",6428,580,60,4,281,37,850,206,8446
"48381021609",3130,57,67,0,425,0,480,39,4198
"48381021702",2822,357,31,0,229,45,446,50,3980
"48381021703",4460,871,43,0,448,56,963,214,7055
"48381021704",7022,252,27,3,107,0,500,0,7911
"48381021801",5048,1146,39,2,299,210,880,373,7997
"48381021802",2649,777,63,117,467,172,573,143,4961
"48381021900",4299,313,0,0,56,0,370,37,5075
"48381022001",4172,307,215,0,415,0,949,211,6269
"48381022002",4465,713,172,83,535,99,1552,388,8007
"48383950100",2141,270,89,11,628,333,1798,568,5838
"48385950100",2605,621,0,1,39,8,446,160,3880
"48387950100",1997,237,104,88,100,14,92,53,2685
"48387950500",2228,475,1223,507,22,57,371,231,5114
"48387950600",2167,361,29,25,56,2,68,0,2708
"48387950700",2042,327,128,70,104,18,40,0,2729
"48389950100",1091,349,4,35,179,55,951,334,2998
"48389950200",1708,476,78,99,151,72,1674,496,4754
"48389950300",1478,283,119,75,97,55,1370,337,3814
"48389950400",3078,411,9,0,403,0,2174,369,6444
"48389950500",923,160,0,51,15,7,544,184,1884
"48391950200",2340,528,214,101,186,87,1300,396,5152
"48391950400",2833,398,74,7,217,101,1488,292,5410
"48393950100",891,19,0,0,9,0,10,0,929
"48395960100",1465,111,167,144,24,12,57,7,1987
"48395960200",387,171,385,364,73,88,87,69,1624
"48395960300",3356,550,184,50,170,0,305,0,4615
"48395960400",2554,155,154,4,33,0,519,0,3419
"48395960500",2820,698,1262,717,207,35,1606,425,7770
"48397040101",5336,153,230,0,696,52,632,0,7099
"48397040102",6066,249,119,0,648,0,865,54,8001
"48397040200",4112,89,55,15,571,44,652,0,5538
"48397040301",3715,229,262,160,635,0,863,46,5910
"48397040302",5893,375,261,33,482,58,492,214,7808
"48397040401",7214,920,482,157,711,146,1775,335,11740
"48397040402",8544,350,804,0,984,94,1990,264,13030
"48397040503",4793,828,314,29,600,74,2508,540,9686
"48397040504",6603,135,21,0,28,16,626,0,7429
"48397040505",8922,220,1022,221,350,199,1585,29,12548
"48397040506",6454,268,13,35,333,7,134,14,7258
"48399950100",1064,96,0,0,83,13,186,32,1474
"48399950200",1539,513,12,0,62,16,828,324,3294
"48399950500",1888,424,0,0,27,9,450,218,3016
"48399950600",2797,1233,0,32,291,79,866,498,5796
"48401950100",3881,229,815,56,52,0,756,24,5813
"48401950200",2475,339,548,131,37,101,234,172,4037
"48401950300",5086,611,620,415,129,48,835,49,7793
"48401950400",4021,757,329,158,78,35,691,183,6252
"48401950501",3422,1106,71,516,0,25,432,660,6232
"48401950502",2110,495,49,26,91,48,138,131,3088
"48401950600",1784,181,112,9,91,0,72,0,2249
"48401950700",1825,235,827,209,21,28,261,24,3430
"48401950800",1896,239,858,197,51,35,210,95,3581
"48401950900",2214,309,473,142,106,60,511,196,4011
"48401951000",1952,416,255,25,62,19,655,174,3558
"48401951100",2158,421,494,95,28,89,246,247,3778
"48401951200",1270,261,478,269,92,10,6,33,2419
"48403950100",1498,570,119,67,6,0,6,0,2266
"48403950200",2430,769,94,76,30,0,259,32,3690
"48403950300",3454,726,130,444,36,0,50,37,4877
"48405950100",1678,330,511,145,125,0,27,0,2816
"48405950200",1211,276,608,603,87,39,176,127,3127
"48405950300",2256,614,47,11,0,13,110,98,3149
"48407200101",4316,1600,422,292,141,125,569,0,7465
"48407200102",7773,1599,687,348,213,126,1247,790,12783
"48407200200",3277,594,669,171,0,0,192,78,4981
"48407200300",3440,312,341,175,8,34,157,34,4501
"48409010201",2888,645,0,17,108,114,887,500,5159
"48409010202",3609,898,8,73,289,34,1420,399,6730
"48409010301",3354,478,89,0,284,17,1435,281,5938
"48409010302",3502,680,56,0,336,0,1728,299,6601
"48409010500",1344,587,5,0,161,9,1349,564,4019
"48409010601",5105,438,29,67,402,0,2312,315,8668
"48409010602",3155,415,65,117,81,29,1628,300,5790
"48409010603",2132,136,16,0,239,0,543,23,3089
"48409010604",2490,60,7,32,204,0,637,25,3455
"48409010700",2752,421,77,1,95,10,1111,368,4835
"48409010800",3077,952,38,0,226,123,2456,1028,7900
"48409010900",4047,450,0,0,197,64,2416,402,7576
"48409011000",4623,971,341,46,402,149,3963,1078,11573
"48409011100",1923,561,8,0,37,1,1330,535,4395
"48409011200",2826,438,5,0,67,0,1576,214,5126
"48409011300",3045,1488,74,0,291,4,3206,1451,9559
"48411950100",1780,357,0,0,146,41,844,208,3376
"48411950200",2577,367,1,7,28,16,381,135,3512
"48413950300",2006,694,3,1,526,37,1254,334,4855
"48415950100",2652,400,44,0,286,39,1683,367,5471
"48415950200",1146,82,0,1,4,1,423,23,1680
"48415950300",4876,609,228,24,226,57,1121,259,7400
"48415950600",3255,424,96,17,599,299,1501,538,6729
"48417950300",2516,569,42,0,194,0,193,152,3666
"48419950100",3643,669,497,487,81,5,619,293,6294
"48419950200",2527,578,447,296,41,82,277,92,4340
"48419950300",3133,1342,192,1,70,0,558,541,5837
"48419950400",2468,811,1043,736,363,27,1082,649,7179
"48419950500",2577,253,40,71,3,48,193,0,3185
"48419950600",1877,285,438,126,24,43,15,93,2901
"48421950200",2313,439,0,0,220,45,888,377,4282
"48423000100",1896,1000,1658,857,443,119,1997,911,8881
"48423000201",452,201,1941,848,88,0,491,160,4181
"48423000202",394,147,514,388,177,12,565,146,2343
"48423000300",3468,919,879,267,386,109,3136,957,10121
"48423000400",766,416,903,263,161,44,909,386,3848
"48423000500",667,673,322,432,94,18,400,524,3130
"48423000600",1170,607,222,76,234,50,1120,522,4001
"48423000700",649,701,1887,1090,26,0,360,535,5248
"48423000800",3316,721,637,713,236,109,1542,387,7661
"48423000900",2323,302,286,335,228,42,1523,140,5179
"48423001000",3743,286,637,336,252,0,927,93,6274
"48423001101",2849,329,301,51,159,5,478,10,4182
"48423001102",2270,150,58,23,71,0,245,28,2845
"48423001200",2102,129,464,0,300,30,402,0,3427
"48423001300",1549,404,152,37,204,0,135,132,2613
"48423001401",7478,509,204,49,257,0,207,0,8704
"48423001403",5611,981,447,46,162,22,327,210,7806
"48423001404",4050,802,144,278,254,22,138,102,5790
"48423001500",3540,625,361,371,318,4,169,197,5585
"48423001601",2826,1130,1388,488,418,0,1007,887,8144
"48423001602",2619,322,735,318,161,10,526,10,4701
"48423001604",3357,1304,1161,364,69,64,1437,623,8379
"48423001700",4460,1241,1182,117,1011,164,2923,1302,12400
"48423001801",3109,895,1841,288,103,0,904,308,7448
"48423001802",6210,2076,407,300,329,2,1367,1208,11899
"48423001803",3465,313,121,351,376,323,505,39,5493
"48423001901",3872,596,664,46,610,80,311,70,6249
"48423001905",6736,454,1093,19,511,83,280,84,9260
"48423001906",5204,108,469,63,108,0,260,0,6212
"48423001907",5003,788,309,0,19,126,243,109,6597
"48423001908",8134,220,581,325,320,29,399,12,10020
"48423002003",1809,456,849,180,219,67,180,91,3851
"48423002004",2186,178,94,47,8,0,106,42,2661
"48423002006",2981,59,130,61,76,9,285,29,3630
"48423002007",4773,884,969,206,547,330,398,105,8212
"48423002008",4466,306,373,18,315,21,427,0,5926
"48423002009",6743,629,113,0,93,42,477,68,8165
"48423002101",2362,539,852,284,65,0,164,90,4356
"48423002102",4696,657,134,56,169,0,264,26,6002
"48423002200",5033,148,935,251,93,64,191,0,6715
"48423980000",0,0,0,0,0,0,0,0,0
"48425000100",5372,757,103,14,326,96,952,263,7883
"48425000200",1394,89,0,0,130,22,392,0,2027
"48427950101",872,263,0,0,58,22,842,238,2295
"48427950104",2831,821,0,8,156,9,2951,812,7588
"48427950105",2926,1119,0,0,147,0,2981,951,8124
"48427950106",1713,1376,0,0,212,38,1906,1261,6506
"48427950107",2045,2448,0,0,115,192,2160,2640,9600
"48427950108",2429,1013,0,0,186,73,2008,954,6663
"48427950202",1236,973,0,0,135,19,1208,973,4544
"48427950203",1568,2116,0,0,259,34,1794,2150,7921
"48427950204",2342,2636,0,7,129,130,2390,2676,10310
"48427950401",3285,3190,0,0,107,8,3239,3198,13027
"48427950402",2995,1324,0,0,241,258,3159,1582,9559
"48427950500",2304,1003,0,2,146,44,2363,1047,6909
"48427950600",4522,2038,0,0,220,26,4444,2064,13314
"48427950701",2264,1443,0,0,90,38,2315,1481,7631
"48427950702",1887,1111,0,9,57,119,1748,1218,6149
"48429950200",3023,373,54,0,311,338,710,462,5271
"48429950300",1156,846,34,36,145,30,258,418,2923
"48429950500",2225,129,0,0,88,0,48,5,2495
"48431950100",1013,255,0,0,32,12,389,89,1790
"48433950300",1083,109,0,63,21,80,168,95,1619
"48435950300",3188,242,26,0,484,7,2096,208,6251
"48437950200",1141,340,3,1,49,8,96,254,1892
"48437950300",2844,891,203,85,249,125,1351,713,6461
"48437950400",944,60,41,4,88,56,450,60,1703
"48439100101",3185,1374,26,0,1784,91,3251,1160,10871
"48439100102",3037,1032,31,17,1079,108,2758,945,9007
"48439100201",1648,1516,246,7,1058,288,2610,1788,9161
"48439100202",2948,1082,0,0,1122,52,3659,1023,9886
"48439100300",2046,1087,227,281,558,467,2522,1466,8654
"48439100400",4143,1008,36,26,1922,535,5660,1438,14768
"48439100501",5409,1250,596,350,2226,649,5772,1419,17671
"48439100502",3006,2044,103,2,1924,536,3857,2132,13604
"48439100601",1673,315,9,15,89,9,95,15,2220
"48439100602",1356,199,121,3,277,12,807,142,2917
"48439100700",2681,1074,42,42,274,510,1597,1068,7288
"48439100800",3024,747,19,113,1516,731,4104,1402,11656
"48439100900",694,476,0,0,716,203,1369,616,4074
"48439101201",930,252,23,22,551,63,845,155,2841
"48439101202",2174,1203,135,25,367,229,1803,1246,7182
"48439101301",2517,480,1032,310,392,176,1368,271,6546
"48439101302",1041,517,713,433,188,170,401,551,4014
"48439101401",2699,110,1226,331,494,352,1470,201,6883
"48439101402",1276,786,231,429,440,568,1267,1284,6281
"48439101403",870,815,993,410,628,657,746,1286,6405
"48439101500",1781,531,620,10,630,333,1235,443,5583
"48439101700",263,653,273,1165,86,509,218,488,3655
"48439102000",1358,245,10,0,281,206,405,335,2840
"48439102100",3821,258,62,135,417,133,874,94,5794
"48439102201",2656,329,129,0,279,68,655,9,4125
"48439102202",2160,288,42,10,146,5,185,33,2869
"48439102301",1411,474,204,182,390,22,940,283,3906
"48439102302",2544,1158,26,263,934,277,1765,834,7801
"48439102401",2569,434,462,106,371,58,448,183,4631
"48439102402",3780,141,69,0,344,0,422,8,4764
"48439102500",276,377,1263,1352,145,137,449,409,4408
"48439102601",1791,306,256,67,682,140,1209,164,4615
"48439102602",2251,454,83,0,879,153,1349,438,5607
"48439102700",2999,228,22,0,235,34,414,36,3968
"48439102800",1268,7,18,3,42,0,95,0,1433
"48439103500",1318,1115,525,304,1077,490,2119,1463,8411
"48439103601",191,221,573,1093,137,262,315,344,3136
"48439103602",308,161,967,410,338,7,499,163,2853
"48439103701",1468,1425,551,465,345,95,1568,1477,7394
"48439103702",711,404,730,528,356,113,1062,420,4324
"48439103800",286,319,905,1041,206,219,487,334,3797
"48439104100",2424,340,50,3,319,36,1071,207,4450
"48439104201",2406,180,0,0,60,0,158,0,2804
"48439104202",2307,733,0,124,216,112,321,193,4006
"48439104300",3375,1351,96,21,248,474,590,355,6510
"48439104400",3113,571,60,94,691,281,2081,622,7513
"48439104502",1030,473,173,42,488,436,1415,871,4928
"48439104503",1311,444,4,0,452,277,1700,721,4909
"48439104504",1653,490,264,25,585,93,1987,517,5614
"48439104505",471,250,1687,1343,247,123,421,367,4909
"48439104601",1046,384,1136,482,634,20,1577,387,5666
"48439104602",1087,1382,827,706,297,877,1255,2112,8543
"48439104603",1514,825,388,317,298,390,1562,1134,6428
"48439104604",551,231,986,787,348,116,878,291,4188
"48439104605",655,988,1625,509,145,104,620,899,5545
"48439104701",1982,1573,35,0,820,234,2600,1751,8995
"48439104702",1533,1174,39,53,689,133,1937,1121,6679
"48439104802",2826,1241,125,160,502,431,2337,1518,9140
"48439104803",3753,1746,62,9,462,734,3776,2091,12633
"48439104804",1015,1269,3,0,518,344,1276,1157,5582
"48439104900",1172,447,69,14,1050,74,1542,396,4764
"48439105001",2495,1835,28,0,1042,712,3180,2440,11732
"48439105006",447,84,12,0,237,46,586,130,1542
"48439105007",3457,306,579,43,437,52,880,36,5790
"48439105008",4878,374,1194,112,1439,97,1604,200,9898
"48439105201",2146,1180,449,714,403,493,1166,1374,7925
"48439105203",1812,136,186,25,59,27,495,0,2740
"48439105204",1613,494,315,182,268,246,793,414,4325
"48439105205",1579,729,980,455,407,280,460,330,5220
"48439105403",5192,354,126,110,241,164,681,33,6901
"48439105404",3293,517,11,31,173,27,249,0,4301
"48439105405",2480,513,477,127,176,19,468,136,4396
"48439105406",4446,230,329,12,297,163,553,25,6055
"48439105502",3933,400,331,744,155,19,727,313,6622
"48439105503",4055,337,875,55,208,0,1175,37,6742
"48439105505",2614,524,295,188,606,601,668,260,5756
"48439105507",5202,134,347,13,660,1,391,1,6749
"48439105508",4130,474,1290,184,629,63,1038,106,7914
"48439105510",3603,455,2092,1206,560,304,1314,404,9938
"48439105511",2969,451,1551,642,317,15,1270,439,7654
"48439105512",2830,85,819,0,194,41,580,15,4564
"48439105513",1081,199,853,266,252,182,537,49,3419
"48439105514",1544,233,513,138,170,37,745,117,3497
"48439105600",4322,395,96,78,237,11,2539,243,7921
"48439105701",2696,294,309,15,282,48,1289,289,5222
"48439105703",1981,367,445,282,245,0,883,227,4430
"48439105704",4491,1610,2584,541,687,90,3645,1397,15045
"48439105800",3021,383,21,30,409,265,2518,484,7131
"48439105901",1342,1044,99,374,629,437,1751,1418,7094
"48439105902",803,353,655,802,1211,833,890,319,5866
"48439106001",4362,911,2429,455,258,0,2563,885,11863
"48439106002",1060,240,1739,468,203,98,1093,314,5215
"48439106004",2067,649,2005,589,366,196,1219,608,7699
"48439106101",446,121,720,143,164,7,581,119,2301
"48439106102",1465,321,626,724,299,132,1011,312,4890
"48439106201",636,68,1630,1326,79,153,551,134,4577
"48439106202",551,118,2542,1329,27,342,554,388,5851
"48439106300",541,437,1525,802,43,13,534,417,4312
"48439106400",1006,685,348,143,191,112,567,479,3531
"48439106502",1280,136,793,251,265,102,489,113,3429
"48439106503",1624,242,2165,496,329,82,575,128,5641
"48439106507",1055,123,276,51,94,0,125,0,1724
"48439106509",1878,299,1423,460,443,0,341,166,5010
"48439106510",5311,115,1095,78,1829,101,1349,79,9957
"48439106511",3517,533,2220,894,1022,111,1855,466,10618
"48439106512",934,519,2088,881,489,49,394,341,5695
"48439106513",629,152,1389,464,350,158,494,132,3768
"48439106514",1970,430,1298,1233,582,73,969,87,6642
"48439106515",1163,65,1222,529,369,52,466,24,3890
"48439106516",931,585,1127,1090,719,413,1212,827,6904
"48439106517",2740,145,2541,849,2137,94,1237,29,9772
"48439106518",1373,165,1250,138,535,320,452,110,4343
"48439106600",1300,655,18,165,30,117,457,344,3086
"48439106700",1550,265,264,19,215,44,490,171,3018
"48439110101",3833,515,631,190,989,840,1486,628,9112
"48439110102",2957,355,47,38,473,192,1158,441,5661
"48439110202",3272,161,0,0,724,321,2028,333,6839
"48439110203",4800,599,1194,0,1234,181,2047,500,10555
"48439110204",4481,396,243,36,1200,125,2351,273,9105
"48439110301",2145,854,0,0,822,404,1651,784,6660
"48439110302",3235,1166,0,113,532,347,2282,817,8492
"48439110401",3773,286,0,22,392,16,1232,45,5766
"48439110402",2549,1095,0,0,690,329,1739,864,7266
"48439110500",4911,1083,162,20,1660,230,3143,1041,12250
"48439110600",2008,168,35,4,240,60,637,67,3219
"48439110701",4604,1062,197,224,581,124,1525,286,8603
"48439110703",3078,717,291,52,800,118,1366,383,6805
"48439110704",2757,935,162,149,144,78,829,311,5365
"48439110805",4902,311,533,0,470,4,1168,35,7423
"48439110806",4019,92,280,13,271,12,734,21,5442
"48439110807",4513,479,576,261,609,76,1719,260,8493
"48439110808",1927,52,0,0,106,118,123,0,2326
"48439110809",1430,194,206,0,82,2,120,21,2055
"48439110901",3794,87,54,0,370,52,555,27,4939
"48439110903",1334,108,173,0,19,0,145,20,1799
"48439110905",3785,180,166,28,391,0,553,61,5164
"48439110906",3855,274,49,1,209,41,391,95,4915
"48439110907",2739,48,110,0,193,0,126,0,3216
"48439111003",2111,240,356,55,106,15,789,184,3856
"48439111005",3611,820,3033,1528,381,509,2317,715,12914
"48439111008",5086,454,909,316,288,280,1355,85,8773
"48439111010",2645,219,39,19,5,0,456,0,3383
"48439111011",4094,544,3245,434,935,77,1899,253,11481
"48439111012",3066,393,3700,275,434,264,1771,179,10082
"48439111013",4829,517,2123,391,680,0,1827,142,10509
"48439111015",1709,212,417,7,66,37,205,36,2689
"48439111016",8066,888,628,26,208,0,1275,27,11118
"48439111017",6336,292,2266,119,1726,39,1621,112,12511
"48439111018",1553,69,404,0,48,55,150,0,2279
"48439111102",1701,260,2320,967,518,340,1840,567,8513
"48439111103",1443,210,1065,177,639,378,1464,509,5885
"48439111104",589,277,1324,143,181,0,398,266,3178
"48439111202",3004,853,508,657,967,223,2257,905,9374
"48439111203",4295,181,426,380,500,0,875,1,6658
"48439111204",4638,390,94,5,42,0,606,66,5841
"48439111301",6859,614,836,18,582,563,996,731,11199
"48439111304",6042,418,203,0,748,14,574,0,7999
"48439111306",3295,671,525,122,264,125,941,608,6551
"48439111307",1701,230,948,30,180,182,356,240,3867
"48439111308",1224,85,90,55,63,2,89,4,1612
"48439111309",2720,173,277,111,619,27,1167,0,5094
"48439111310",4033,288,2245,253,1222,0,1474,252,9767
"48439111311",4311,108,905,451,737,23,688,55,7278
"48439111312",2969,112,69,0,105,0,227,0,3482
"48439111313",4659,186,1204,25,655,22,546,65,7362
"48439111314",3543,83,1387,0,718,14,676,0,6421
"48439111402",4918,176,660,120,356,294,1009,364,7897
"48439111404",5148,297,842,716,842,88,735,50,8718
"48439111405",1639,467,46,0,109,0,280,121,2662
"48439111406",2788,28,608,0,375,9,453,0,4261
"48439111407",2726,67,263,0,286,3,222,19,3586
"48439111408",1899,510,344,0,226,49,155,425,3608
"48439111409",3903,84,474,0,527,0,590,0,5578
"48439111505",3320,193,143,136,64,65,513,30,4464
"48439111506",4288,483,609,166,333,128,707,0,6714
"48439111513",2336,163,855,35,786,83,1275,92,5625
"48439111514",3604,18,1337,162,1627,43,2479,0,9270
"48439111516",2938,325,1766,224,822,86,1403,2,7566
"48439111521",3054,837,1825,260,1854,142,2780,519,11271
"48439111522",6054,204,605,375,881,414,4879,448,13860
"48439111523",3403,817,2046,1117,1337,360,2321,565,11966
"48439111524",2880,802,1690,50,1249,454,2142,659,9926
"48439111525",3156,871,779,389,976,450,2397,624,9642
"48439111526",2765,289,492,328,318,0,629,285,5106
"48439111529",3405,108,76,0,385,0,517,0,4491
"48439111530",4403,236,578,12,557,9,464,26,6285
"48439111531",3318,472,250,6,549,88,304,85,5072
"48439111532",5303,533,1010,0,589,0,908,35,8378
"48439111533",3764,178,392,82,447,21,712,38,5634
"48439111534",4563,271,843,40,458,19,708,43,6945
"48439111536",1051,221,1158,302,315,254,851,208,4360
"48439111537",2931,221,2013,179,1095,130,1446,49,8064
"48439111538",3185,89,1434,299,743,91,1514,46,7401
"48439111539",4179,113,2567,513,1678,90,1861,0,11001
"48439111540",2900,561,1642,88,1255,117,1651,69,8283
"48439111541",2052,201,1017,141,669,0,942,110,5132
"48439111542",3214,315,1717,0,1043,129,1532,270,8220
"48439111543",2338,607,2215,230,1027,445,1053,524,8439
"48439111544",3996,340,1509,186,1058,127,1748,82,9046
"48439111545",2024,166,55,5,124,75,66,1,2516
"48439111546",5591,298,453,60,507,0,1297,239,8445
"48439111547",6072,721,5457,971,4170,140,3656,684,21871
"48439111548",3003,285,2818,45,1672,176,1370,54,9423
"48439111549",4074,191,2092,183,1388,134,1103,222,9387
"48439111550",6215,419,4460,52,2400,48,2955,162,16711
"48439111551",4452,41,1182,272,1091,143,624,0,7805
"48439111552",2594,362,394,64,284,46,223,36,4003
"48439111553",2229,484,465,123,375,80,540,206,4502
"48439113001",2506,54,294,11,594,0,700,11,4170
"48439113002",2634,373,1704,739,875,250,2405,385,9365
"48439113102",2653,267,1079,267,130,30,332,29,4787
"48439113104",1692,345,1019,126,397,7,433,67,4086
"48439113107",1906,85,156,0,162,14,96,3,2422
"48439113108",3898,404,112,0,497,0,379,61,5351
"48439113109",1998,242,1001,220,457,7,852,77,4854
"48439113110",2218,545,828,495,251,113,536,350,5336
"48439113111",1444,807,674,751,91,165,797,854,5583
"48439113112",1461,586,543,124,223,0,469,460,3866
"48439113113",1637,142,1580,70,545,100,442,63,4579
"48439113114",1823,228,1443,211,173,58,368,162,4466
"48439113115",1975,406,678,143,359,62,1295,117,5035
"48439113116",1594,581,1043,471,582,22,697,292,5282
"48439113206",4988,349,293,0,577,0,1894,39,8140
"48439113207",3942,101,30,0,239,32,365,18,4727
"48439113210",5663,228,388,0,813,0,745,78,7915
"48439113212",3305,190,240,0,353,0,735,0,4823
"48439113213",2131,498,76,0,354,8,440,179,3686
"48439113214",3551,254,127,8,901,9,946,29,5825
"48439113215",4099,205,8,0,219,224,504,291,5550
"48439113216",3746,680,164,0,320,161,357,270,5698
"48439113217",3652,162,219,40,393,61,788,0,5315
"48439113218",2310,154,0,0,55,0,188,88,2795
"48439113220",3959,788,321,251,1286,112,2256,401,9374
"48439113221",4178,311,158,0,557,13,387,173,5777
"48439113301",3432,278,0,19,178,53,580,16,4556
"48439113302",3088,673,143,129,232,103,686,421,5475
"48439113403",2115,101,12,8,205,10,385,34,2870
"48439113404",4319,482,444,89,370,0,687,238,6629
"48439113405",4523,453,112,227,461,152,692,194,6814
"48439113407",3206,1513,253,119,488,673,1718,1709,9679
"48439113408",3827,727,106,0,574,0,748,50,6032
"48439113509",2837,233,257,0,910,331,1094,294,5956
"48439113510",2319,44,503,28,1172,151,696,0,4913
"48439113511",2183,366,217,26,1200,164,522,212,4890
"48439113512",3945,529,415,36,657,14,437,270,6303
"48439113513",2993,771,389,25,1115,343,498,251,6385
"48439113514",1858,835,325,314,1291,416,1025,649,6713
"48439113516",3167,68,325,176,654,176,1022,77,5665
"48439113517",2378,266,271,19,529,38,555,23,4079
"48439113518",2885,307,709,163,755,526,683,96,6124
"48439113519",4180,123,690,26,741,112,644,31,6547
"48439113520",3258,237,417,47,1053,122,719,152,6005
"48439113607",3281,200,196,88,347,154,660,112,5038
"48439113610",8936,182,187,0,1691,0,873,12,11881
"48439113611",3683,106,222,112,312,0,383,0,4818
"48439113612",3851,87,39,0,268,0,332,0,4577
"48439113613",3710,107,101,19,119,31,451,1,4539
"48439113618",4236,639,94,1,703,18,699,37,6427
"48439113619",2230,785,1011,161,428,113,1080,489,6297
"48439113622",5276,95,0,16,557,0,335,0,6279
"48439113623",3338,67,51,0,92,0,385,0,3933
"48439113624",3764,79,16,0,404,93,650,6,5012
"48439113625",3029,46,110,0,199,19,268,0,3671
"48439113626",3274,157,109,0,367,17,470,0,4394
"48439113627",3805,458,447,125,643,107,693,147,6425
"48439113628",2722,321,823,89,909,204,644,165,5877
"48439113629",3430,86,231,29,484,17,253,0,4530
"48439113630",2509,331,326,0,293,87,239,110,3895
"48439113631",4313,1219,136,14,1002,815,1328,1680,10507
"48439113632",4722,46,10,15,353,0,322,14,5482
"48439113633",3750,62,73,19,394,0,376,13,4687
"48439113634",4337,169,97,1,570,1,383,19,5577
"48439113703",6812,774,222,17,850,961,780,1381,11797
"48439113705",3683,822,92,18,667,433,1628,628,7971
"48439113707",4558,306,42,0,297,0,405,2,5610
"48439113709",4041,54,71,0,635,152,301,152,5406
"48439113710",2637,480,194,0,487,93,522,269,4682
"48439113711",3188,203,43,0,346,24,176,9,3989
"48439113803",4333,257,352,9,719,0,944,15,6629
"48439113808",5338,171,24,0,772,50,1031,109,7495
"48439113809",3573,187,275,134,657,40,1164,72,6102
"48439113810",3081,285,176,0,822,166,957,53,5540
"48439113811",2706,260,191,0,356,0,749,16,4278
"48439113812",4875,147,281,99,393,19,505,19,6338
"48439113813",4355,56,80,0,509,22,292,10,5324
"48439113814",3689,33,197,0,276,31,155,31,4412
"48439113815",5270,76,111,0,378,0,299,0,6134
"48439113816",4504,92,125,0,496,0,420,0,5637
"48439113906",5342,60,275,0,640,0,499,0,6816
"48439113907",5951,215,214,0,715,0,535,0,7630
"48439113908",4729,28,30,0,556,62,144,0,5549
"48439113909",5826,284,167,0,537,54,384,0,7252
"48439113910",8101,302,64,18,616,4,398,88,9591
"48439113911",5967,600,42,50,923,106,689,166,8543
"48439113912",5039,341,95,0,600,0,326,10,6411
"48439113916",2697,363,546,289,598,48,893,168,5602
"48439113917",3514,396,616,118,1680,461,1084,650,8519
"48439113918",3787,145,259,0,792,49,492,0,5524
"48439113919",6368,182,418,0,516,285,802,172,8743
"48439113920",4381,6,306,0,802,20,808,0,6323
"48439113921",17717,859,1409,60,3017,0,3384,412,26858
"48439113922",12943,616,1549,32,3376,761,2725,562,22564
"48439113923",2293,73,266,0,762,39,803,0,4236
"48439113924",3307,272,549,0,709,308,836,422,6403
"48439113925",2702,146,174,258,579,160,1026,21,5066
"48439113926",9391,220,1482,0,2464,391,3137,96,17181
"48439113927",10204,431,915,0,967,125,1314,107,14063
"48439113928",6644,2,321,1,1626,70,1564,10,10238
"48439113929",7552,127,398,0,1159,0,989,0,10225
"48439114003",5778,449,362,57,1328,80,2772,190,11016
"48439114005",6503,622,270,98,592,206,1188,544,10023
"48439114006",5726,382,19,0,538,68,1297,129,8159
"48439114007",9655,557,1093,92,2668,45,4035,0,18145
"48439114008",8702,421,982,350,2402,132,3935,320,17244
"48439114102",6842,240,258,0,386,13,603,69,8411
"48439114103",18258,743,1017,83,1611,115,3000,285,25112
"48439114104",6072,231,335,0,497,0,498,0,7633
"48439114203",3360,1087,139,0,128,56,293,176,5239
"48439114204",5509,695,13,0,99,16,377,58,6767
"48439114205",2363,568,0,26,94,139,425,2,3617
"48439114206",3636,564,3,0,179,29,356,314,5081
"48439114207",5297,251,213,2,569,13,865,10,7220
"48439121601",4517,2083,697,65,417,20,850,1233,9882
"48439121604",3386,977,1040,237,195,146,1128,600,7709
"48439121605",2108,284,158,13,171,17,390,39,3180
"48439121606",2617,76,237,164,299,0,366,0,3759
"48439121608",4291,315,165,0,474,137,402,182,5966
"48439121609",4438,159,269,1,996,0,97,1,5961
"48439121610",1936,71,125,11,95,14,317,20,2589
"48439121611",3124,115,408,277,491,0,524,0,4939
"48439121702",1027,365,233,149,62,121,374,243,2574
"48439121703",1990,1106,736,519,536,267,1677,1208,8039
"48439121704",2172,511,394,0,376,21,1637,317,5428
"48439121903",2430,1692,807,338,533,637,2250,2112,10799
"48439121904",2070,793,783,194,346,23,1720,719,6648
"48439121905",1407,1084,770,925,1061,517,1334,1237,8335
"48439121906",1892,1030,327,111,630,102,1767,932,6791
"48439122001",2530,1636,24,87,193,31,1596,1401,7498
"48439122002",2330,1108,378,187,579,220,2453,1201,8456
"48439122100",3479,1320,329,385,371,235,1777,1053,8949
"48439122200",882,618,170,164,111,178,764,570,3457
"48439122300",684,427,142,123,400,897,329,148,3150
"48439122400",2435,1257,326,173,416,629,827,1035,7098
"48439122500",3256,405,138,59,211,8,413,96,4586
"48439122600",2489,220,369,135,69,229,179,6,3696
"48439122700",3030,500,318,551,276,107,533,222,5537
"48439122801",1646,763,354,580,243,233,1107,748,5674
"48439122802",2505,768,587,296,410,65,1532,710,6873
"48439122900",3654,1929,421,267,842,281,2694,1779,11867
"48439123000",3579,800,383,40,592,100,874,404,6772
"48439123100",500,638,508,703,69,139,399,707,3663
"48439123200",1382,298,142,51,140,234,599,377,3223
"48439123300",2217,173,101,63,152,0,175,0,2881
"48439123400",827,233,124,197,246,58,454,148,2287
"48439123500",305,342,641,704,315,419,557,735,4018
"48439123600",1390,452,50,312,256,124,1323,296,4203
"48439980000",0,0,0,0,0,0,0,0,0
"48441010100",2605,1638,91,78,290,239,266,206,5413
"48441010200",885,595,222,23,137,155,439,394,2850
"48441010300",1084,209,208,348,141,100,556,209,2855
"48441010400",924,231,34,117,502,165,1086,325,3384
"48441010500",2122,588,144,124,185,146,936,548,4793
"48441010600",3047,434,259,63,202,19,979,242,5245
"48441010700",1862,381,92,46,448,310,1362,529,5030
"48441010800",565,389,143,66,173,169,355,426,2286
"48441010900",3117,1212,549,554,401,86,736,298,6953
"48441011000",607,464,176,33,65,10,241,203,1799
"48441011200",1889,510,117,49,404,75,1153,305,4502
"48441011300",2038,599,434,456,244,117,769,374,5031
"48441011400",3098,589,172,219,245,0,685,135,5143
"48441011500",2369,250,11,79,78,0,384,149,3320
"48441011600",1951,439,154,33,175,10,455,241,3458
"48441011700",1168,224,116,204,291,34,541,95,2673
"48441011900",965,694,122,47,178,173,570,580,3329
"48441012000",1785,55,38,0,51,23,127,23,2102
"48441012100",66,383,7,36,9,5,26,54,586
"48441012200",1557,219,5,30,150,21,510,79,2571
"48441012300",2511,306,248,107,295,68,687,183,4405
"48441012400",1969,143,69,23,158,25,468,50,2905
"48441012500",2395,157,177,3,233,37,462,101,3565
"48441012600",2320,236,92,0,433,20,197,20,3318
"48441012700",6128,432,292,3,487,27,498,15,7882
"48441012801",2695,344,110,0,327,98,625,81,4280
"48441012802",2524,459,709,66,556,225,666,248,5453
"48441012900",1449,197,212,21,285,121,415,0,2700
"48441013000",8,5,0,0,0,0,8,0,21
"48441013100",3408,1260,449,305,709,363,1834,557,8885
"48441013200",1285,294,11,3,78,60,255,90,2076
"48441013300",2459,313,34,6,358,65,537,52,3824
"48441013401",3012,225,263,19,120,41,911,18,4609
"48441013402",4757,576,324,1,476,15,548,45,6742
"48441013404",6466,535,8,121,602,143,1063,12,8950
"48441013500",7192,318,67,0,210,10,426,43,8266
"48441013600",4073,603,0,6,383,65,835,45,6010
"48441980000",0,0,0,0,0,0,0,0,0
"48443950100",661,111,0,13,12,12,378,112,1299
"48445950100",1800,336,41,0,307,36,841,224,3585
"48445950300",1281,258,0,6,214,47,1011,294,3111
"48445950400",5687,521,214,115,528,133,3087,525,10810
"48447950300",1376,144,0,3,29,7,134,26,1719
"48449950100",1338,366,264,79,123,0,255,163,2588
"48449950200",1864,328,63,0,203,116,497,314,3385
"48449950300",6332,1348,100,151,351,171,1776,1317,11546
"48449950400",3929,765,242,38,340,356,401,644,6715
"48449950500",1333,363,209,222,330,122,1256,467,4302
"48449950600",1567,888,574,408,582,84,1712,786,6601
"48449950700",702,161,275,78,20,176,437,326,2175
"48449950800",3395,494,417,3,282,395,1895,765,7646
"48451000100",2179,343,79,0,96,0,753,242,3692
"48451000200",2970,947,65,9,382,222,1866,658,7119
"48451000300",3841,1623,206,39,646,68,1821,1148,9392
"48451000400",4075,1337,151,93,532,5,3775,1085,11053
"48451000700",1920,1380,61,139,515,281,1716,1359,7371
"48451000801",2959,502,54,0,617,15,1382,321,5850
"48451000802",3375,756,267,74,282,0,2204,510,7468
"48451000900",1486,294,1,11,471,68,1454,250,4035
"48451001000",4127,639,0,27,275,67,1055,144,6334
"48451001101",4211,512,87,101,266,226,1473,224,7100
"48451001102",3278,424,94,0,310,40,1650,141,5937
"48451001200",4956,651,426,86,1057,272,2984,580,11012
"48451001301",4329,510,150,330,201,60,785,122,6487
"48451001303",3127,297,292,19,280,22,788,66,4891
"48451001304",2303,262,106,0,248,9,401,69,3398
"48451001400",3243,1315,137,0,254,56,1868,937,7810
"48451001500",237,5,0,0,12,0,96,3,353
"48451001600",3967,375,7,4,454,25,903,105,5840
"48451001702",2519,139,0,0,212,0,633,23,3526
"48451001704",6623,750,95,14,235,37,971,135,8860
"48451001706",3030,271,17,0,288,70,685,182,4543
"48451001707",4267,260,92,26,227,52,666,193,5783
"48451001708",5167,273,0,0,211,0,521,162,6334
"48451001800",883,460,451,288,135,84,687,399,3387
"48451980000",0,0,0,0,0,0,0,0,0
"48453000101",3381,264,15,15,137,28,389,26,4255
"48453000102",2392,91,60,2,39,0,116,5,2705
"48453000203",831,333,26,9,175,107,182,64,1727
"48453000204",2255,555,29,17,169,70,271,98,3464
"48453000205",2581,383,137,36,516,158,345,124,4280
"48453000206",2616,251,130,61,216,57,354,41,3726
"48453000302",3105,1100,28,0,530,189,702,374,6028
"48453000304",1999,871,7,18,371,51,261,355,3933
"48453000305",2248,461,0,0,149,263,219,227,3567
"48453000306",2157,399,236,133,333,31,700,263,4252
"48453000307",1380,185,59,50,29,268,347,249,2567
"48453000401",2062,514,85,30,182,237,293,217,3620
"48453000402",1452,244,271,160,381,103,430,52,3093
"48453000500",2572,1555,24,20,314,272,400,358,5515
"48453000601",140,590,13,0,71,52,14,246,1126
"48453000603",775,3480,106,136,139,1934,320,1139,8029
"48453000604",596,2416,42,34,167,1093,78,286,4712
"48453000700",872,200,19,0,45,4,160,71,1371
"48453000801",886,212,175,11,240,89,871,239,2723
"48453000802",928,747,822,533,50,413,425,1075,4993
"48453000803",1229,227,327,94,344,40,584,116,2961
"48453000804",1089,583,201,298,137,204,502,622,3636
"48453000901",1080,277,187,40,175,46,562,233,2600
"48453000902",2913,871,0,167,652,506,2517,873,8499
"48453001000",2058,696,33,75,886,91,1853,530,6222
"48453001100",3342,477,89,125,604,32,419,94,5182
"48453001200",3587,410,127,0,574,0,478,24,5200
"48453001303",2298,231,16,40,170,38,196,31,3020
"48453001304",3196,276,21,1,272,51,467,102,4386
"48453001305",4298,1107,81,130,98,121,884,762,7481
"48453001307",2358,731,118,159,163,30,676,377,4612
"48453001308",2168,470,41,11,148,45,1202,287,4372
"48453001401",2441,291,40,0,190,65,236,0,3263
"48453001402",2290,316,57,25,75,0,505,6,3274
"48453001403",1065,169,5,43,146,6,360,91,1885
"48453001501",4752,270,33,29,180,0,636,27,5927
"48453001503",2632,705,245,16,378,32,925,392,5325
"48453001504",3904,318,13,2,617,19,441,234,5548
"48453001505",3127,780,13,0,321,22,520,172,4955
"48453001602",1920,193,81,0,735,223,334,71,3557
"48453001603",4277,127,32,0,249,0,237,0,4922
"48453001604",3595,136,0,0,193,6,244,11,4185
"48453001605",2939,401,34,1,210,16,258,99,3958
"48453001606",34,48,0,32,0,0,0,14,128
"48453001705",4329,103,0,0,146,24,384,0,4986
"48453001706",3082,142,43,1,272,26,398,0,3964
"48453001707",3851,214,48,3,399,233,620,114,5482
"48453001712",3464,583,159,22,224,7,1280,345,6084
"48453001713",3269,449,114,77,329,174,976,181,5569
"48453001714",8762,886,536,21,2541,53,1005,367,14171
"48453001716",4229,256,133,10,540,0,526,0,5694
"48453001718",4411,390,75,1,773,46,671,56,6423
"48453001719",3520,140,19,0,423,0,475,0,4577
"48453001722",2659,123,261,14,579,80,406,45,4167
"48453001728",5850,430,299,55,485,28,1666,244,9057
"48453001729",3913,272,74,1,437,0,806,75,5578
"48453001733",3412,187,47,1,27,3,627,28,4332
"48453001737",9067,182,318,0,1214,79,1996,0,12856
"48453001738",5873,208,63,0,463,112,1278,31,8028
"48453001740",3489,257,83,0,683,64,1123,12,5711
"48453001741",2772,195,11,0,331,19,481,115,3924
"48453001742",4934,844,0,0,422,364,1345,914,8823
"48453001745",1878,181,97,0,311,39,213,129,2848
"48453001746",2858,249,82,26,501,0,903,121,4740
"48453001747",4007,844,437,0,390,113,1360,535,7686
"48453001748",5048,586,93,6,766,43,1589,443,8574
"48453001749",3907,342,139,14,1213,86,733,40,6474
"48453001750",3699,466,16,31,399,169,993,266,6039
"48453001751",1826,22,205,0,57,54,105,0,2269
"48453001752",1551,674,164,64,908,467,475,55,4358
"48453001753",647,99,75,0,195,12,203,29,1260
"48453001754",3820,311,205,0,255,31,634,78,5334
"48453001755",3660,75,9,0,2239,42,383,0,6408
"48453001756",3022,111,151,6,722,7,343,7,4369
"48453001757",1770,106,57,0,212,0,288,6,2439
"48453001760",12837,369,496,0,2147,0,899,95,16843
"48453001761",5930,360,0,0,668,79,696,0,7733
"48453001764",5400,303,0,0,154,20,552,35,6464
"48453001765",11601,566,131,0,1165,39,1571,39,15112
"48453001766",6201,794,0,2,138,16,895,258,8304
"48453001768",5220,199,49,29,356,16,535,0,6404
"48453001769",4522,174,0,4,510,132,1237,0,6579
"48453001770",9915,178,76,0,1913,0,1677,0,13759
"48453001771",3581,164,88,0,344,0,554,0,4731
"48453001772",2263,132,176,41,617,67,1144,117,4557
"48453001773",5709,227,146,0,583,92,531,0,7288
"48453001774",6809,201,234,21,913,30,2167,98,10473
"48453001775",4286,25,61,0,833,34,735,5,5979
"48453001776",1934,161,240,8,375,53,554,114,3439
"48453001777",4940,300,265,123,479,0,1669,51,7827
"48453001778",3436,343,0,0,92,8,210,27,4116
"48453001779",5528,377,81,0,221,0,551,148,6906
"48453001780",3627,303,12,26,207,15,293,66,4549
"48453001781",2021,118,6,0,248,13,193,0,2599
"48453001782",2915,331,37,33,1628,281,470,178,5873
"48453001783",4918,167,0,0,493,58,545,35,6216
"48453001784",4794,135,25,0,986,45,651,0,6636
"48453001785",3155,135,200,51,737,100,849,3,5230
"48453001786",3085,192,53,22,1839,189,479,60,5919
"48453001804",2430,1629,315,108,1619,647,2020,1907,10675
"48453001805",1713,776,295,227,966,528,1832,1130,7467
"48453001806",3093,1157,340,247,1054,772,3048,1643,11354
"48453001811",1034,904,470,157,520,614,1032,1399,6130
"48453001812",3159,1672,679,537,1037,659,3542,2040,13325
"48453001813",3372,915,188,383,746,745,3149,1417,10915
"48453001817",2830,291,140,0,387,113,457,111,4329
"48453001818",2943,1268,35,171,598,781,919,1829,8544
"48453001819",1124,1243,182,131,1427,766,1849,1839,8561
"48453001820",2645,1023,446,254,1023,1148,2439,1727,10705
"48453001821",3447,556,331,391,912,542,2618,875,9672
"48453001822",3249,1474,616,137,1385,345,3489,1716,12411
"48453001823",2345,1103,519,398,1656,994,3485,1637,12137
"48453001824",1207,128,40,0,188,73,233,89,1958
"48453001826",1045,142,194,6,877,43,542,45,2894
"48453001828",3445,82,136,0,399,0,428,10,4500
"48453001829",1977,79,44,0,369,73,554,37,3133
"48453001832",1973,414,317,256,132,10,890,312,4304
"48453001833",3090,1525,679,433,1558,294,3089,1642,12310
"48453001834",3193,510,1887,37,2214,334,1665,441,10281
"48453001835",2453,867,518,57,1045,866,1986,1569,9361
"48453001839",3236,607,932,22,1909,64,1168,370,8308
"48453001840",5501,953,1288,313,1704,316,3770,1060,14905
"48453001841",9900,1923,2202,66,3235,183,3942,1709,23160
"48453001842",5268,916,1427,154,1506,319,3850,959,14399
"48453001843",1356,315,64,0,551,48,483,276,3093
"48453001844",1876,319,585,162,516,16,900,153,4527
"48453001845",2084,531,150,5,327,107,467,446,4117
"48453001846",1843,274,27,4,258,19,277,1,2703
"48453001847",3571,531,543,398,2061,255,1217,429,9005
"48453001848",2848,253,409,187,1177,137,969,234,6214
"48453001849",2725,212,661,58,1590,178,950,79,6453
"48453001850",2088,287,138,54,1389,127,1443,131,5657
"48453001851",5468,877,1263,49,1161,299,1852,478,11447
"48453001853",2176,40,257,16,619,68,691,24,3891
"48453001854",2090,195,1585,151,452,247,906,380,6006
"48453001855",8644,1081,2643,822,1523,63,2936,631,18343
"48453001856",4344,308,1226,182,952,59,1887,245,9203
"48453001857",4167,113,605,213,892,356,1887,38,8271
"48453001858",13414,235,2072,1,2215,99,3730,94,21860
"48453001859",1043,106,48,6,151,6,448,66,1874
"48453001860",2714,419,475,235,378,0,1380,288,5889
"48453001861",3790,327,582,54,273,0,1439,93,6558
"48453001862",3241,325,1128,192,998,153,1327,101,7465
"48453001863",1653,431,659,279,531,376,1098,441,5468
"48453001864",1666,227,434,52,305,64,657,47,3452
"48453001901",4633,435,42,3,227,0,503,69,5912
"48453001908",6759,1103,100,24,1146,0,1119,819,11070
"48453001910",3557,148,30,12,490,97,343,0,4677
"48453001911",2616,161,20,0,349,17,750,5,3918
"48453001912",2985,254,0,28,541,31,213,55,4107
"48453001913",3875,127,50,0,777,0,414,0,5243
"48453001914",5522,143,19,24,400,19,729,50,6906
"48453001915",1292,92,0,0,220,0,288,36,1928
"48453001916",2796,75,0,0,427,0,214,41,3553
"48453001917",4001,258,0,0,547,78,387,0,5271
"48453001918",2010,195,0,0,422,4,452,0,3083
"48453001919",3375,88,36,0,285,0,227,19,4030
"48453002002",2614,195,30,8,117,60,911,131,4066
"48453002003",2358,867,107,186,269,164,1288,599,5838
"48453002004",1650,193,0,27,157,83,447,102,2659
"48453002005",2764,1361,41,22,208,81,893,1137,6507
"48453002104",2041,374,89,429,231,195,670,488,4517
"48453002105",2546,1020,323,347,622,342,1797,1054,8051
"48453002106",1816,675,218,90,216,16,928,617,4576
"48453002107",1587,560,684,433,354,160,1084,664,5526
"48453002108",764,1099,1451,265,79,79,434,1089,5260
"48453002109",1071,428,1577,339,176,141,474,506,4712
"48453002110",1213,643,606,542,869,424,1639,865,6801
"48453002111",2071,1093,493,323,635,391,1906,1485,8397
"48453002112",2137,1182,740,491,406,124,1605,952,7637
"48453002113",1631,799,847,93,372,0,736,605,5083
"48453002201",600,233,650,121,143,73,730,303,2853
"48453002202",3589,1490,1793,959,428,832,3644,2238,14973
"48453002207",4078,1172,2578,389,664,135,3459,1152,13627
"48453002208",3058,1777,1203,616,595,327,3099,2030,12705
"48453002209",4928,1319,1460,189,1019,111,3436,1020,13482
"48453002210",2324,494,146,0,91,144,1073,450,4722
"48453002211",1274,337,382,19,326,62,1068,359,3827
"48453002212",166,0,216,0,305,0,365,0,1052
"48453002304",1450,952,121,30,520,326,1070,1162,5631
"48453002307",3516,1150,231,126,634,239,2397,937,9230
"48453002308",3131,1188,48,50,178,234,1173,875,6877
"48453002310",1205,1050,182,85,399,218,1360,1145,5644
"48453002312",2904,1924,238,319,1127,601,3593,2328,13034
"48453002313",1976,674,717,102,995,323,1622,536,6945
"48453002314",1873,929,243,272,534,623,1282,1190,6946
"48453002315",1468,765,132,43,240,551,1010,1033,5242
"48453002316",2517,1590,187,239,867,664,2609,2005,10678
"48453002317",993,1956,310,523,328,773,716,1436,7035
"48453002318",2454,4242,454,502,956,1139,2090,3522,15359
"48453002319",4,6,0,4,0,0,1,1,16
"48453002402",4610,1304,402,1,942,246,2574,1294,11373
"48453002403",1993,276,150,101,65,75,956,181,3797
"48453002407",4348,197,156,10,806,66,1994,173,7750
"48453002409",2537,459,71,89,211,31,1616,309,5323
"48453002410",2375,644,198,34,165,254,1311,464,5445
"48453002411",1963,1750,443,234,1344,679,2997,2309,11719
"48453002412",3452,889,364,14,650,625,3618,1479,11091
"48453002413",1476,1683,311,163,927,246,2007,1755,8568
"48453002419",2016,991,343,182,545,221,1676,1067,7041
"48453002421",6060,718,648,179,1068,161,2714,515,12063
"48453002422",3643,941,194,57,722,204,2752,361,8874
"48453002423",4412,554,361,18,520,28,2701,210,8804
"48453002424",2449,694,189,11,207,0,1251,456,5257
"48453002425",2621,63,55,0,382,0,1669,39,4829
"48453002426",5612,589,796,24,1271,207,5069,620,14188
"48453002427",4325,1914,226,41,1611,565,5125,2226,16033
"48453002428",4730,210,307,0,736,214,1961,265,8423
"48453002429",490,56,60,0,109,43,196,39,993
"48453002430",1701,408,185,0,960,221,2117,497,6089
"48453002431",4218,1509,505,24,1312,178,4113,1464,13323
"48453002432",756,396,115,91,599,168,1075,463,3663
"48453002433",3456,842,1150,176,487,118,2665,685,9579
"48453002434",1087,435,58,0,248,60,828,337,3053
"48453002435",3791,570,723,109,1118,1201,3124,1617,12253
"48453002436",1522,564,5,0,223,10,1272,547,4143
"48453002500",4105,293,100,5,772,114,808,43,6240
"48453980000",0,0,0,0,0,0,0,0,0
"48455950100",2543,390,482,0,36,0,162,0,3613
"48455950200",2518,663,131,111,17,0,158,168,3766
"48455950300",1354,227,0,5,58,0,72,21,1737
"48455950400",2516,421,14,0,137,67,85,79,3319
"48455950500",1694,224,526,191,5,0,333,132,3105
"48457950100",2252,331,31,20,43,0,61,20,2758
"48457950200",4427,755,502,56,128,126,515,11,6520
"48457950300",1583,284,223,261,46,44,52,9,2502
"48457950400",4036,700,117,0,58,20,191,20,5142
"48457950500",2447,259,105,8,25,153,7,153,3157
"48459950100",6258,888,214,327,410,71,342,36,8546
"48459950200",2433,303,396,38,337,0,319,14,3840
"48459950300",6255,905,468,38,272,231,431,92,8692
"48459950400",2329,418,581,61,443,176,681,136,4825
"48459950500",4413,678,423,94,311,82,226,46,6273
"48459950600",3041,398,186,137,132,47,31,19,3991
"48459950700",4401,449,165,100,240,62,369,39,5825
"48461950100",795,70,12,0,192,14,265,31,1379
"48461950200",1101,153,59,24,499,346,828,418,3428
"48463950100",2252,547,38,0,42,40,987,404,4310
"48463950200",5587,1920,0,0,329,40,3119,1581,12576
"48463950300",4236,688,0,2,801,61,3723,735,10246
"48463950400",2704,640,8,12,186,13,1800,592,5955
"48463950500",3258,2143,0,0,457,60,3262,2135,11315
"48465950201",6705,981,189,3,526,0,4486,563,13453
"48465950301",3549,899,0,0,315,16,3377,851,9007
"48465950302",2881,691,0,69,267,38,3012,690,7648
"48465950400",2684,822,156,0,236,42,2574,818,7332
"48465950500",4039,1784,116,0,352,106,2823,1744,10964
"48465950601",3380,1049,0,0,215,37,3388,1086,9155
"48465950602",2796,1198,0,0,186,201,2923,1388,8692
"48465950700",4344,1381,17,0,211,113,3794,1494,11354
"48465950800",3609,1189,0,0,103,0,2198,1078,8177
"48465980000",0,0,0,0,0,0,0,0,0
"48467950100",3811,635,66,0,80,4,133,42,4771
"48467950200",2276,872,0,0,167,56,528,345,4244
"48467950300",3581,510,184,12,70,9,377,0,4743
"48467950400",3838,653,20,0,96,13,383,44,5047
"48467950500",2886,673,212,201,86,5,175,172,4410
"48467950600",5708,941,21,0,378,182,237,113,7580
"48467950700",3028,499,104,21,51,104,123,103,4033
"48467950800",4495,1031,0,0,185,32,645,345,6733
"48467950900",5207,1009,124,117,192,94,251,122,7116
"48467951000",5604,1109,178,32,214,49,506,411,8103
"48469000100",1242,443,103,50,88,0,1029,315,3270
"48469000201",1608,903,234,97,527,169,1949,982,6469
"48469000202",3258,955,796,32,403,76,2827,955,9302
"48469000301",682,573,121,59,209,113,675,637,3069
"48469000302",1190,623,234,97,62,17,1149,599,3971
"48469000400",1386,253,35,0,73,39,609,229,2624
"48469000501",2840,188,104,99,503,75,1643,135,5587
"48469000502",2259,860,93,31,201,248,1264,935,5891
"48469000601",1402,669,183,250,276,218,972,862,4832
"48469000602",2349,1027,337,13,201,173,1324,708,6132
"48469000700",2406,564,97,14,137,116,1462,438,5234
"48469000800",1516,210,0,94,134,35,644,147,2780
"48469001300",1653,199,75,0,187,37,448,163,2762
"48469001400",6584,688,123,95,427,43,1711,635,10306
"48469001501",3015,123,89,3,150,0,764,32,4176
"48469001503",1772,32,44,0,99,58,177,9,2191
"48469001504",5677,435,63,0,490,247,1378,266,8556
"48469001601",4088,925,380,95,354,486,1514,941,8783
"48469001604",4682,855,476,0,357,154,2299,774,9597
"48469001605",2583,282,141,49,185,0,1042,197,4479
"48469001606",6827,266,306,19,560,47,1722,106,9853
"48469001700",3097,780,281,87,70,7,1669,693,6684
"48469980000",0,0,0,0,0,0,0,0,0
"48471790101",1605,227,12,63,3,0,34,0,1944
"48471790102",2413,612,411,194,62,27,537,337,4593
"48471790103",3387,597,611,217,54,275,206,532,5879
"48471790200",4625,262,437,301,184,2,446,24,6281
"48471790300",5995,237,549,132,230,0,252,20,7415
"48471790400",4039,660,470,44,189,249,695,182,6528
"48471790500",2355,1318,620,1008,251,74,223,198,6047
"48471790600",958,792,698,192,336,64,921,665,4626
"48471790700",1834,1589,945,840,203,48,499,291,6249
"48471790800",1864,1295,322,803,212,64,30,179,4769
"48473680100",2428,200,15,0,145,22,665,196,3671
"48473680200",5400,1597,1510,757,439,331,3593,1088,14715
"48473680300",7182,461,1939,1310,402,105,2866,343,14608
"48473680400",0,0,18,0,0,0,0,0,18
"48473680500",4449,998,1670,1077,409,74,1221,866,10764
"48473680600",6563,914,58,0,468,70,1248,503,9824
"48475950100",3156,601,151,0,139,33,1522,357,5959
"48475950200",3034,684,193,29,211,161,1616,634,6562
"48475950300",1387,501,233,36,146,115,776,471,3665
"48477170100",1820,243,601,352,136,37,672,158,4019
"48477170200",3956,649,401,431,325,18,615,256,6651
"48477170300",4381,653,622,268,385,22,409,273,7013
"48477170400",4350,744,308,0,45,1,736,539,6723
"48477170500",4771,442,821,351,363,0,531,42,7321
"48477170600",3085,318,1244,105,21,1,194,222,5190
"48479000101",2257,2228,9,0,106,135,2253,2347,9335
"48479000105",1530,1202,0,0,175,0,1693,1202,5802
"48479000106",1771,2054,0,0,163,169,1934,2211,8302
"48479000107",1709,1619,0,0,29,59,1703,1678,6797
"48479000108",2748,1172,0,1,41,21,2788,1193,7964
"48479000109",1094,922,0,14,188,76,1282,998,4574
"48479000200",1766,2302,40,0,106,119,1860,2421,8614
"48479000300",1264,1546,0,4,61,155,1305,1699,6034
"48479000601",1131,1469,0,0,130,97,1238,1566,5631
"48479000602",1942,912,67,3,27,28,2029,937,5945
"48479000700",1396,1331,0,0,161,0,1503,1331,5722
"48479000800",1061,1399,0,1,11,5,1072,1366,4915
"48479000901",2334,1702,0,0,129,128,2463,1780,8536
"48479000903",1190,1536,6,0,3,68,1188,1604,5595
"48479000904",1746,1285,0,0,123,111,1849,1355,6469
"48479001001",3524,1559,0,0,109,89,3460,1550,10291
"48479001003",1168,1123,0,0,53,181,1191,1281,4997
"48479001004",723,740,4,0,52,64,760,804,3147
"48479001101",2414,1233,17,0,195,35,2498,1268,7660
"48479001103",799,498,0,0,107,6,897,504,2811
"48479001104",2191,1289,0,2,26,0,2044,1273,6825
"48479001105",1708,1026,0,0,97,194,1721,1132,5878
"48479001201",1320,947,0,0,97,113,1417,1055,4949
"48479001202",900,1669,0,0,76,90,953,1728,5416
"48479001300",1871,1886,14,4,116,17,2000,1875,7783
"48479001401",1795,2524,0,0,106,93,1825,2568,8911
"48479001402",1905,1241,0,0,49,362,1954,1603,7114
"48479001501",1529,1171,4,0,77,78,1594,1210,5663
"48479001502",2664,1743,0,0,90,144,2696,1879,9216
"48479001601",3070,706,37,11,50,99,3048,797,7818
"48479001602",4021,280,0,11,202,28,3637,240,8419
"48479001706",2760,2050,0,14,160,9,2826,2073,9892
"48479001709",4637,1063,0,0,317,104,4340,901,11362
"48479001710",1134,589,2,0,12,0,1029,589,3355
"48479001711",4627,995,0,0,328,0,4390,980,11320
"48479001712",5634,326,15,0,750,8,5685,334,12752
"48479001713",13351,907,370,1,684,18,12882,905,29118
"48479001714",2487,332,31,1,72,0,2313,332,5568
"48479001715",5698,913,0,0,460,8,5717,677,13473
"48479001716",4910,1229,0,0,91,45,4933,1233,12441
"48479001717",1485,1522,0,45,136,29,1508,1508,6233
"48479001718",1692,210,12,0,146,34,1643,244,3981
"48479001719",2412,621,0,1,212,30,2310,637,6223
"48479001720",4366,707,12,0,308,67,4252,617,10329
"48479001721",2231,473,2,0,138,0,2082,469,5395
"48479001722",5899,321,0,1,383,16,5753,261,12634
"48479001806",2195,2057,0,0,233,273,2338,2330,9426
"48479001807",4934,2657,32,33,368,86,5275,2775,16160
"48479001808",4158,2350,0,0,288,207,4439,2557,13999
"48479001809",4326,1923,0,0,326,147,4544,2070,13336
"48479001810",3386,1931,0,0,72,77,3306,1904,10676
"48479001811",3715,589,0,0,190,22,3830,610,8956
"48479001812",6160,1251,9,9,709,132,6769,1240,16279
"48479001813",554,364,0,0,0,0,503,351,1772
"48479001814",4437,2698,0,0,169,47,4256,2725,14332
"48479001815",804,714,0,0,0,178,775,892,3363
"48479001816",3055,761,69,0,70,128,3030,889,8002
"48479001817",2725,2007,0,0,71,96,2692,2082,9673
"48479001818",1598,1364,0,10,31,290,1626,1654,6573
"48479001900",1385,1516,0,2,46,39,1286,1536,5810
"48479980000",0,0,0,0,0,0,0,0,0
"48481740100",4252,504,520,193,7,8,653,318,6455
"48481740200",742,360,213,179,51,0,344,317,2206
"48481740300",762,147,632,294,7,4,602,75,2523
"48481740400",3628,412,659,350,161,77,1889,300,7476
"48481740500",1778,293,767,273,33,21,1054,227,4446
"48481740600",2995,478,101,116,217,97,1354,412,5770
"48481740700",791,487,67,520,16,42,338,431,2692
"48481740800",2227,808,342,24,10,89,1069,756,5325
"48481740900",6226,490,24,13,57,0,2183,326,9319
"48481741000",3122,804,411,99,189,6,1937,704,7272
"48481741100",2138,153,0,34,6,3,294,16,2644
"48483950100",2524,261,26,0,179,117,627,312,4046
"48483950300",1731,317,66,0,188,63,353,145,2863
"48485010100",421,334,200,152,60,33,214,182,1596
"48485010200",428,375,7,53,105,88,76,322,1454
"48485010400",615,88,858,475,157,41,538,51,2823
"48485010600",1489,187,18,167,236,55,401,81,2634
"48485010700",1662,431,107,65,215,221,848,395,3944
"48485010800",1258,618,64,182,537,82,793,387,3921
"48485010900",1382,236,50,40,40,6,115,27,1896
"48485011000",1662,256,68,98,195,107,600,84,3070
"48485011100",541,323,29,16,228,215,510,344,2206
"48485011200",1039,574,128,132,52,80,74,234,2313
"48485011300",497,193,418,48,71,80,108,16,1431
"48485011400",990,1074,208,48,201,216,388,1034,4159
"48485011500",1603,134,121,109,164,0,247,52,2430
"48485011600",2135,1275,166,160,472,58,622,722,5610
"48485011700",1914,79,104,0,182,15,230,17,2541
"48485011800",1747,116,12,0,82,61,230,5,2253
"48485011900",2784,559,142,31,270,37,391,85,4299
"48485012000",4189,435,230,626,267,89,381,65,6282
"48485012100",2234,323,50,0,153,0,309,57,3126
"48485012200",4583,746,290,80,293,12,745,38,6787
"48485012300",5771,627,294,355,585,74,872,36,8614
"48485012400",6171,384,228,30,436,114,710,118,8191
"48485012600",3105,300,106,0,230,0,392,120,4253
"48485012700",2005,546,116,33,145,123,760,497,4225
"48485012800",3298,413,125,215,240,0,553,115,4959
"48485012900",2067,150,7,0,37,0,191,10,2462
"48485013000",1290,645,146,41,279,65,204,240,2910
"48485013100",3330,291,442,292,157,204,458,109,5283
"48485013200",3399,526,1104,131,670,41,847,27,6745
"48485013300",1011,7,251,0,186,0,302,0,1757
"48485013401",429,19,184,0,8,0,29,0,669
"48485013501",4371,458,179,1,74,291,364,303,6041
"48485013502",4532,161,147,0,336,0,249,17,5442
"48485013600",5039,477,0,2,304,0,264,0,6086
"48485013700",2202,293,95,11,147,29,185,13,2975
"48485013800",3067,132,0,1,115,16,92,6,3429
"48485980000",0,0,0,0,0,0,0,0,0
"48487950300",1624,147,0,0,45,1,123,49,1989
"48487950500",1227,459,266,324,169,53,400,73,2971
"48487950600",4618,559,267,78,313,179,1333,411,7758
"48487950700",1662,632,65,78,111,52,816,352,3768
"48489950300",3292,2573,1,6,168,117,3010,2660,11827
"48489950400",3448,1727,44,9,178,61,3040,1713,10220
"48489950500",2291,939,0,0,120,19,1992,958,6319
"48489950600",1310,930,39,0,24,0,1107,930,4340
"48489950700",1172,1039,0,3,79,24,1008,933,4258
"48489990000",0,0,0,0,0,0,0,0,0
"48491020105",4449,90,0,0,47,0,313,0,4899
"48491020106",3085,183,86,0,283,0,360,0,3997
"48491020107",4638,279,33,0,100,0,118,0,5168
"48491020108",2570,58,251,0,7,2,106,2,2996
"48491020109",2672,80,50,4,252,0,224,0,3282
"48491020110",3344,126,0,0,44,0,218,17,3749
"48491020111",2577,137,147,33,143,15,315,19,3386
"48491020112",2793,47,0,0,83,0,324,0,3247
"48491020113",2100,259,28,0,122,19,651,161,3340
"48491020114",4294,642,185,120,139,78,1287,414,7159
"48491020115",2633,255,85,0,40,27,183,49,3272
"48491020201",1297,154,0,0,78,0,378,15,1922
"48491020202",4746,506,18,0,162,11,500,210,6153
"48491020203",2886,40,11,0,39,0,73,8,3057
"48491020204",3760,196,0,0,163,0,592,49,4760
"48491020301",5903,434,26,8,497,25,847,173,7913
"48491020302",3034,61,0,0,227,40,671,66,4099
"48491020310",2331,89,48,2,189,0,282,1,2942
"48491020311",2590,129,91,0,927,0,679,78,4494
"48491020312",6632,360,246,0,826,101,3618,260,12043
"48491020313",7260,418,57,64,1456,101,1856,56,11268
"48491020314",4320,263,98,0,994,10,1838,93,7616
"48491020315",4008,124,169,74,1155,0,597,8,6135
"48491020316",2340,242,481,0,496,45,359,69,4032
"48491020317",2365,138,289,40,561,84,452,30,3959
"48491020318",6442,272,475,33,1196,0,1105,22,9545
"48491020319",5072,155,100,0,392,62,997,11,6789
"48491020320",7022,405,135,0,510,0,1435,46,9553
"48491020321",1447,120,45,0,140,4,454,115,2325
"48491020322",7597,496,264,0,624,0,1109,260,10350
"48491020323",2480,213,301,0,182,99,576,168,4019
"48491020324",6072,277,251,9,478,37,1329,0,8453
"48491020325",2004,202,859,57,107,22,1072,50,4373
"48491020326",5591,201,19,0,432,79,640,44,7006
"48491020327",1951,51,50,24,66,301,400,16,2859
"48491020328",5476,285,534,72,695,7,1163,77,8309
"48491020403",1454,163,25,19,242,100,242,59,2304
"48491020404",2917,83,78,0,446,103,403,20,4050
"48491020405",4596,465,243,0,850,75,1553,154,7936
"48491020406",3863,331,782,87,897,70,1477,118,7625
"48491020408",3634,491,466,23,373,113,760,75,5935
"48491020409",3309,137,439,49,617,32,1235,45,5863
"48491020410",4270,285,482,145,899,22,880,79,7062
"48491020411",3914,268,677,0,745,76,742,102,6524
"48491020503",4037,163,25,76,563,81,515,44,5504
"48491020504",4743,2089,509,95,1279,337,2499,1332,12883
"48491020505",1998,41,102,0,386,0,412,0,2939
"48491020506",6591,173,488,0,1112,108,1051,150,9673
"48491020507",2283,28,191,0,852,0,448,0,3802
"48491020508",3479,186,207,0,687,42,858,0,5459
"48491020509",5068,81,64,0,1653,0,584,0,7450
"48491020510",7247,202,408,0,2415,55,961,0,11288
"48491020602",3793,350,223,105,475,78,1475,347,6846
"48491020603",7670,331,224,0,1651,0,1065,55,10996
"48491020604",4906,195,148,0,517,187,679,187,6819
"48491020605",5175,255,366,0,859,0,1114,146,7915
"48491020701",1456,327,118,17,195,61,947,288,3409
"48491020703",7383,780,1789,320,938,13,3606,372,15201
"48491020704",4866,800,439,0,258,135,2809,638,9945
"48491020706",2804,195,379,13,227,0,747,0,4365
"48491020707",3644,55,393,249,358,84,1739,54,6576
"48491020708",5263,332,432,0,1226,0,1107,144,8504
"48491020803",2914,331,102,0,453,0,1147,81,5028
"48491020804",7874,168,487,0,1113,47,856,99,10644
"48491020805",6465,321,643,0,229,0,2422,272,10352
"48491020806",2347,47,278,260,178,12,1156,42,4320
"48491020807",5709,300,890,126,372,0,2565,34,9996
"48491020808",1189,36,127,26,165,14,251,20,1828
"48491020809",4521,143,819,50,608,103,1454,132,7830
"48491020900",3365,464,55,38,98,3,527,141,4691
"48491021000",1366,710,398,229,92,53,969,700,4517
"48491021100",1801,294,163,119,284,61,1174,285,4181
"48491021201",2487,108,128,1,255,0,824,10,3813
"48491021202",2632,57,316,66,288,0,670,13,4042
"48491021203",1790,358,187,70,480,46,788,202,3921
"48491021300",2489,438,82,67,90,92,672,320,4250
"48491021401",7570,533,178,50,516,48,3729,148,12772
"48491021402",2573,1104,318,33,144,208,1258,1041,6679
"48491021403",2758,336,156,424,197,43,1410,362,5686
"48491021502",3143,589,511,247,687,169,2248,680,8274
"48491021503",3461,630,252,79,198,130,1429,445,6624
"48491021504",4911,151,440,34,1296,190,1391,21,8434
"48491021505",5218,320,634,15,1010,93,3313,195,10798
"48491021506",2414,46,296,0,474,32,890,42,4194
"48491021507",6249,498,772,417,1388,42,2697,300,12363
"48491021508",6219,194,556,24,454,15,1085,81,8628
"48491021601",2782,331,103,0,176,19,629,114,4154
"48491021602",2507,322,0,0,42,13,828,158,3870
"48491021603",1295,71,21,0,84,43,325,55,1894
"48493000102",2612,353,75,0,226,0,691,105,4062
"48493000103",2668,145,62,5,46,18,601,17,3562
"48493000104",3705,463,42,0,206,33,798,252,5499
"48493000201",1860,442,0,0,135,15,881,388,3721
"48493000202",1598,233,10,0,189,0,786,206,3022
"48493000300",3760,732,87,1,404,47,2531,572,8134
"48493000402",2033,199,0,46,213,33,1033,164,3721
"48493000403",6085,209,28,0,435,228,2545,364,9894
"48493000404",4775,302,141,38,376,20,1648,237,7537
"48493000500",3112,1088,71,4,65,36,691,499,5566
"48493000600",3431,242,0,0,310,56,1588,251,5878
"48495950200",1756,160,28,6,175,10,1173,67,3375
"48495950300",2854,418,103,0,289,102,1882,380,6028
"48495950400",1084,153,36,0,83,18,433,141,1948
"48497150101",3209,275,0,0,68,15,822,3,4392
"48497150102",5633,714,0,0,219,0,995,97,7658
"48497150200",5210,468,223,0,74,134,1013,323,7445
"48497150300",2485,457,0,0,45,0,150,4,3141
"48497150401",4706,625,0,0,51,6,763,30,6181
"48497150402",4652,338,0,0,286,6,456,5,5743
"48497150403",3351,260,0,0,117,7,203,37,3975
"48497150500",4331,1013,57,6,467,48,1989,638,8549
"48497150601",6576,671,0,0,289,8,373,15,7932
"48497150602",5741,516,101,15,382,41,1309,272,8377
"48497150603",4502,424,0,4,329,7,837,157,6260
"48499950100",3573,546,12,0,0,24,273,175,4603
"48499950200",1890,444,140,0,180,3,327,67,3051
"48499950301",2928,458,6,21,109,95,128,0,3745
"48499950302",4555,563,208,21,255,23,356,27,6008
"48499950400",3383,1193,0,0,75,34,197,144,5026
"48499950500",1790,258,53,9,110,6,131,8,2365
"48499950601",2799,504,386,110,46,72,85,73,4075
"48499950602",3776,279,0,0,51,0,227,0,4333
"48499950700",4688,358,0,0,48,47,584,48,5773
"48499950800",2964,575,561,174,326,131,439,230,5400
"48501950100",1927,210,20,0,85,85,1012,225,3564
"48501950200",4502,447,83,7,539,123,3396,250,9347
"48503950200",3259,718,8,8,124,153,722,172,5164
"48503950400",4996,633,0,0,30,85,128,20,5892
"48503950500",1908,816,55,23,149,0,601,389,3941
"48503950600",4250,584,17,29,289,0,817,254,6240
"48505950301",2192,2353,0,0,16,0,2184,2353,9098
"48505950302",3031,775,131,15,0,0,2828,778,7558
"48505950400",3636,1945,0,15,0,70,3133,1999,10798
"48507950100",833,269,0,0,61,10,844,243,2260
"48507950200",1387,565,0,0,22,43,1081,578,3676
"48507950301",934,939,0,0,136,98,889,1024,4020
"48507950302",4144,1768,0,0,407,91,4472,1805,12687
"49001100100",2809,417,0,0,112,101,145,128,3712
"49001100200",2546,180,0,0,67,126,242,146,3307
"49003960100",2470,389,6,0,35,8,79,15,3002
"49003960200",5880,611,0,0,297,13,419,47,7267
"49003960300",6106,992,0,0,884,215,858,353,9408
"49003960400",4469,180,0,0,344,22,290,25,5330
"49003960500",4350,236,30,15,198,19,628,28,5504
"49003960601",3392,156,51,0,22,0,100,0,3721
"49003960602",2129,249,0,0,72,27,53,17,2547
"49003960701",4126,578,0,0,169,39,512,0,5424
"49003960702",1968,284,0,0,75,61,81,96,2565
"49003960801",3776,415,21,0,268,13,385,215,5093
"49003960802",3748,231,11,0,426,50,165,6,4637
"49005000101",4154,379,18,0,132,75,193,112,5063
"49005000102",1477,221,1,0,61,15,115,88,1978
"49005000201",2934,409,0,0,95,62,139,140,3779
"49005000202",6173,326,0,0,576,11,361,0,7447
"49005000300",5183,1171,30,0,477,17,955,199,8032
"49005000401",2524,593,17,0,420,8,183,38,3783
"49005000402",3050,150,0,0,178,0,38,0,3416
"49005000403",5579,320,0,9,224,76,129,60,6397
"49005000501",3668,943,62,22,584,11,918,89,6297
"49005000502",3350,1124,167,0,828,486,834,383,7172
"49005000600",2802,2693,25,9,166,220,347,210,6472
"49005000701",3365,304,131,0,88,29,37,27,3981
"49005000702",588,479,33,17,100,206,18,61,1502
"49005000800",2531,1916,0,63,145,269,317,146,5387
"49005000900",2337,661,0,0,153,35,223,29,3438
"49005001001",1977,114,14,0,692,59,416,21,3293
"49005001002",2357,1087,10,0,1144,184,725,720,6227
"49005001101",4713,454,0,0,269,0,484,8,5928
"49005001102",3876,182,18,22,267,0,84,0,4449
"49005001201",4548,139,18,0,208,0,106,49,5068
"49005001202",5187,323,0,61,399,0,637,27,6634
"49005001300",5481,412,4,0,119,22,155,0,6193
"49005001401",3346,807,9,0,124,11,189,457,4943
"49005001402",2845,297,0,0,229,27,679,177,4254
"49005001500",1876,138,5,0,36,2,75,0,2132
"49005980100",75,0,0,0,0,0,0,0,75
"49007000100",3508,338,0,0,147,16,436,24,4469
"49007000200",3597,564,0,0,401,92,605,114,5373
"49007000300",2668,732,35,15,317,175,350,260,4552
"49007000500",3372,317,0,9,162,34,397,36,4327
"49007000600",3217,519,0,1,105,73,311,101,4327
"49009960100",539,56,0,0,2,2,11,0,610
"49011125102",4171,122,0,0,160,0,84,0,4537
"49011125103",4192,262,157,15,495,57,518,0,5696
"49011125104",5592,286,0,9,243,92,390,31,6643
"49011125200",2221,441,99,0,421,32,574,46,3834
"49011125301",3443,566,142,35,532,380,880,359,6337
"49011125303",9775,75,140,20,704,50,1080,39,11883
"49011125304",4233,273,38,7,722,8,638,0,5919
"49011125305",5000,154,160,0,901,210,745,184,7354
"49011125401",10914,648,49,0,628,0,553,111,12903
"49011125403",10807,260,259,0,548,0,812,16,12702
"49011125405",8369,908,127,0,688,97,857,478,11524
"49011125406",5699,196,200,0,947,112,739,90,7983
"49011125501",4559,137,0,0,835,288,590,286,6695
"49011125502",4428,297,84,64,602,10,919,6,6410
"49011125503",4021,352,46,0,243,0,437,0,5099
"49011125600",153,11,25,0,0,20,25,9,243
"49011125701",2131,746,27,36,424,160,117,309,3950
"49011125702",2902,214,49,97,148,0,309,21,3740
"49011125801",4710,559,142,28,589,469,1100,560,8157
"49011125804",5913,283,147,0,653,0,349,0,7345
"49011125805",5461,369,56,23,558,32,706,43,7248
"49011125807",1969,232,122,21,206,444,290,456,3740
"49011125808",3465,1208,255,0,898,63,485,242,6616
"49011125905",4531,776,90,16,353,201,303,153,6423
"49011125906",5752,307,66,0,954,0,558,20,7657
"49011125907",1917,70,15,0,27,9,26,41,2105
"49011125908",4171,95,44,0,353,0,326,32,5021
"49011126001",3590,503,43,23,562,30,503,158,5412
"49011126002",5164,305,18,0,127,105,254,119,6092
"49011126101",5292,336,36,0,300,78,300,66,6408
"49011126104",10353,1150,51,0,418,12,208,188,12380
"49011126105",6555,48,61,0,75,0,138,0,6877
"49011126202",9012,169,197,0,348,13,259,0,9998
"49011126203",3915,74,67,0,135,34,67,0,4292
"49011126204",4301,409,0,0,166,7,135,0,5018
"49011126303",4153,234,8,0,204,4,135,0,4738
"49011126304",5704,103,70,0,227,0,198,15,6317
"49011126305",2119,75,0,0,81,0,55,0,2330
"49011126306",6529,478,26,0,369,35,217,37,7691
"49011126402",2995,240,0,0,303,0,396,0,3934
"49011126404",5611,391,0,0,416,0,527,149,7094
"49011126405",3582,87,0,0,191,30,245,0,4135
"49011126406",3434,395,0,0,554,41,582,50,5056
"49011126500",5202,557,0,0,497,6,206,0,6468
"49011126600",4125,262,121,0,252,84,221,0,5065
"49011126700",3478,323,12,6,330,151,262,64,4626
"49011126801",2791,190,50,0,149,0,66,0,3246
"49011126802",4340,202,0,32,103,0,101,62,4840
"49011126901",4571,689,0,0,560,22,588,373,6803
"49011126902",4886,586,27,0,228,380,186,87,6380
"49011127002",4573,728,50,0,1366,629,1256,246,8848
"49011127003",5250,210,0,0,249,0,155,9,5873
"49011127004",6787,506,61,0,484,0,301,58,8197
"49011127100",6146,386,24,98,267,275,210,132,7538
"49013940300",3971,307,0,0,89,4,223,4,4598
"49013940500",5998,798,12,0,786,252,622,190,8658
"49013940600",5794,440,4,0,415,117,221,110,7101
"49015976200",3471,302,0,0,57,0,122,19,3971
"49015976300",3148,294,27,0,73,22,41,41,3646
"49015976500",2709,549,0,49,51,3,172,255,3788
"49017000300",1934,315,0,0,101,19,109,0,2478
"49017000400",2132,326,28,0,52,8,83,62,2691
"49019000200",3703,595,7,0,72,86,300,211,4974
"49019000300",3547,762,1,7,405,57,133,280,5192
"49021110100",3298,277,0,20,125,103,77,71,3971
"49021110200",6063,1724,107,65,160,153,64,560,8896
"49021110300",2726,612,18,3,94,97,161,92,3803
"49021110400",3092,993,0,0,64,16,29,39,4233
"49021110500",5321,2271,52,1,773,633,640,706,10397
"49021110600",3659,1620,25,0,454,243,352,156,6509
"49021110701",5059,662,0,0,461,24,126,117,6449
"49021110702",3475,882,0,0,210,23,331,67,4988
"49023010100",4576,557,0,0,264,18,325,22,5762
"49023010200",3735,819,20,0,158,48,53,24,4857
"49025130100",1746,345,0,0,223,13,128,20,2475
"49025130200",4375,250,43,0,127,0,119,0,4914
"49027974100",3882,580,0,0,302,216,272,284,5536
"49027974200",2344,199,18,0,229,4,290,21,3105
"49027974300",3722,306,24,0,359,243,468,242,5364
"49029970100",7904,328,0,0,155,134,169,93,8783
"49029970200",1415,11,0,0,4,0,0,0,1430
"49031960100",1308,526,0,0,44,0,45,112,2035
"49033950100",1981,217,2,0,22,48,46,28,2344
"49035100100",951,190,16,0,249,22,295,92,1815
"49035100200",1030,69,103,0,101,0,101,16,1420
"49035100306",2121,806,10,71,1460,691,1335,909,7403
"49035100307",1890,282,351,206,1871,768,1486,797,7651
"49035100308",1475,589,494,7,956,666,1071,964,6222
"49035100500",2889,647,288,105,1296,669,1643,757,8294
"49035100600",3485,1114,104,7,2128,655,3245,967,11705
"49035100700",1914,344,58,33,203,106,136,65,2859
"49035100800",1441,501,83,0,210,97,152,160,2644
"49035101000",2754,103,20,0,191,61,103,0,3232
"49035101101",1584,267,85,0,101,15,69,18,2139
"49035101102",2638,299,85,19,534,27,481,59,4142
"49035101200",2912,503,0,0,381,75,202,85,4158
"49035101400",1226,797,0,0,554,504,100,115,3296
"49035101500",1540,849,67,23,473,285,125,135,3497
"49035101600",2472,739,0,7,312,229,200,82,4041
"49035101700",1856,342,55,53,424,195,165,28,3118
"49035101800",2259,590,13,0,248,168,187,91,3556
"49035101900",1283,533,43,52,178,196,105,92,2482
"49035102000",1536,341,77,0,468,289,282,316,3309
"49035102100",710,362,0,27,163,43,62,26,1393
"49035102300",1297,521,50,0,562,440,520,185,3575
"49035102500",1509,674,64,48,427,233,154,177,3286
"49035102600",1546,483,230,0,805,684,1176,883,5807
"49035102701",1990,276,129,69,1287,1394,1157,1217,7519
"49035102702",1336,309,133,0,1219,936,1490,904,6327
"49035102801",2222,959,60,0,1949,1074,2038,1060,9362
"49035102802",2004,325,167,49,1069,1350,1264,844,7072
"49035102900",2225,1122,197,178,475,382,599,555,5733
"49035103000",1678,267,49,71,726,39,673,111,3614
"49035103100",3012,842,18,36,368,218,725,245,5464
"49035103200",2948,806,0,30,547,190,306,128,4955
"49035103300",2740,393,131,10,346,50,166,51,3887
"49035103400",2946,482,39,394,291,110,152,129,4543
"49035103500",3484,271,123,2,131,0,62,34,4107
"49035103600",2456,109,0,0,59,18,54,20,2716
"49035103700",2330,274,0,0,66,0,70,8,2748
"49035103800",1867,337,0,7,192,41,77,0,2521
"49035103900",3070,286,13,0,313,41,297,0,4020
"49035104000",2942,235,45,0,63,0,99,12,3396
"49035104100",2609,200,0,0,188,50,111,0,3158
"49035104200",4882,425,0,0,903,0,149,0,6359
"49035104300",2026,420,17,0,253,110,208,0,3034
"49035104400",1818,52,0,0,200,15,40,0,2125
"49035104700",4475,535,0,0,158,158,375,35,5736
"49035104800",4370,366,0,0,381,31,174,0,5322
"49035104900",2422,254,144,0,297,169,264,101,3651
"49035110102",3902,251,27,0,154,42,130,0,4506
"49035110103",3460,186,0,0,118,0,228,61,4053
"49035110104",4615,116,0,0,344,29,184,0,5288
"49035110200",5162,160,0,4,204,2,200,12,5744
"49035110300",4796,324,0,0,399,0,138,41,5698
"49035110401",2663,101,224,0,264,66,60,0,3378
"49035110402",3025,257,70,32,295,36,117,5,3837
"49035110500",5274,372,0,0,348,20,149,26,6189
"49035110600",4892,143,18,0,201,0,67,0,5321
"49035110701",2628,499,28,0,508,34,173,37,3907
"49035110702",4439,194,40,0,282,107,285,53,5400
"49035110800",4158,704,40,0,287,72,337,71,5669
"49035110900",3783,358,23,0,207,0,58,0,4429
"49035111001",4409,99,0,0,167,23,73,2,4773
"49035111002",4556,439,0,0,585,29,98,172,5879
"49035111101",5493,640,204,0,409,54,763,135,7698
"49035111102",5152,364,368,1,106,0,324,111,6426
"49035111103",5281,364,0,0,143,0,216,0,6004
"49035111201",2361,195,0,0,287,15,75,64,2997
"49035111202",4012,128,60,0,526,41,206,41,5014
"49035111302",4972,224,44,0,170,143,30,0,5583
"49035111304",3166,133,7,0,133,59,36,0,3534
"49035111305",3622,105,82,0,363,0,365,1,4538
"49035111306",2429,55,0,0,337,0,323,0,3144
"49035111400",3501,1105,19,205,543,1460,564,919,8316
"49035111500",832,164,38,10,282,71,338,83,1818
"49035111600",2851,1058,81,281,1099,777,686,912,7745
"49035111701",2909,987,34,0,1283,250,1423,652,7538
"49035111702",2960,373,315,0,543,144,993,182,5510
"49035111801",3675,593,60,373,615,221,233,245,6015
"49035111802",1485,695,6,19,188,157,175,203,2928
"49035111903",3555,268,11,12,324,0,611,0,4781
"49035111904",2849,380,30,6,127,62,168,0,3622
"49035111905",2926,316,81,18,209,10,458,87,4105
"49035111906",2511,715,203,35,506,221,688,144,5023
"49035112001",2657,454,0,0,180,134,288,315,4028
"49035112002",3172,648,81,0,86,27,172,77,4263
"49035112100",5203,1232,138,27,617,388,506,89,8200
"49035112201",4525,147,90,128,428,133,550,133,6134
"49035112202",3125,583,12,24,144,27,381,218,4514
"49035112301",2989,532,20,0,486,21,561,205,4814
"49035112302",3160,256,0,0,128,177,223,196,4140
"49035112402",3740,1065,57,0,940,405,1312,992,8511
"49035112403",3508,854,108,30,526,259,1136,697,7118
"49035112404",2608,869,33,24,688,382,1111,888,6603
"49035112501",3295,388,0,29,232,15,558,7,4524
"49035112502",4756,732,104,14,819,72,437,239,7173
"49035112503",3758,177,97,15,473,111,592,80,5303
"49035112604",4042,269,33,0,294,47,210,0,4895
"49035112605",6459,414,77,0,597,30,603,30,8210
"49035112608",4593,86,0,0,352,20,195,15,5261
"49035112609",4947,286,108,0,244,10,191,0,5786
"49035112610",3195,739,84,42,323,62,260,221,4926
"49035112611",5428,257,0,0,446,89,567,0,6787
"49035112612",2934,690,10,0,310,85,363,249,4641
"49035112613",4214,188,0,0,179,0,210,8,4799
"49035112614",2823,67,26,0,335,0,34,0,3285
"49035112615",2093,141,0,0,91,0,43,14,2382
"49035112616",3556,543,0,20,338,120,173,71,4821
"49035112617",3368,33,8,0,44,54,89,54,3650
"49035112618",2640,295,6,0,271,15,127,2,3356
"49035112619",2737,86,0,0,512,61,346,22,3764
"49035112700",4138,447,45,0,556,44,674,32,5936
"49035112804",4680,301,0,0,517,52,535,0,6085
"49035112805",4846,199,39,0,349,0,283,0,5716
"49035112810",6771,640,51,0,196,17,518,12,8205
"49035112812",4027,685,37,0,443,18,379,0,5589
"49035112813",4610,302,9,0,586,46,278,79,5910
"49035112814",4042,225,21,6,354,10,110,0,4768
"49035112815",5245,60,29,0,354,0,322,0,6010
"49035112816",4775,35,0,0,211,159,196,0,5376
"49035112817",5877,892,17,0,647,109,414,84,8040
"49035112818",0,0,0,0,0,0,0,0,0
"49035112819",6360,338,0,0,538,40,358,0,7634
"49035112820",7146,476,52,0,560,165,462,185,9046
"49035112821",6532,187,31,0,256,0,252,27,7285
"49035112822",4070,549,26,0,253,66,489,335,5788
"49035112823",4148,358,97,6,425,27,512,12,5585
"49035112904",5008,184,13,31,1007,168,1385,153,7949
"49035112905",4838,139,57,0,588,125,562,0,6309
"49035112907",3006,936,28,53,276,58,429,685,5471
"49035112912",2105,135,41,5,261,31,339,13,2930
"49035112913",4530,150,0,0,301,0,577,0,5558
"49035112914",4631,654,99,0,756,123,1009,348,7620
"49035112916",3770,309,18,0,857,77,1150,120,6301
"49035112917",3154,159,0,0,600,53,457,67,4490
"49035112918",3920,534,117,0,807,169,959,399,6905
"49035112920",3616,192,40,0,461,64,681,18,5072
"49035112921",2973,100,20,0,539,48,458,48,4186
"49035113007",5089,190,0,0,282,12,443,12,6028
"49035113008",5882,165,37,0,385,0,373,54,6896
"49035113010",6012,297,18,0,283,0,345,50,7005
"49035113011",5481,166,0,0,169,11,254,11,6092
"49035113012",4458,386,0,0,341,0,154,24,5363
"49035113013",5072,172,36,0,344,35,240,46,5945
"49035113014",4266,113,0,15,6,0,189,14,4603
"49035113016",5910,54,26,0,720,0,352,0,7062
"49035113017",6501,123,0,0,346,223,256,223,7672
"49035113019",6428,26,0,10,627,12,202,0,7305
"49035113020",11751,275,126,0,1335,0,696,0,14183
"49035113101",5660,620,222,0,938,28,1440,378,9286
"49035113102",3294,109,47,0,262,0,603,0,4315
"49035113105",3985,76,0,0,334,0,403,24,4822
"49035113107",20615,1097,417,64,429,394,1646,13,24675
"49035113108",3508,268,70,0,462,23,391,104,4826
"49035113305",3309,667,153,412,2381,1594,2487,1206,12209
"49035113306",3146,689,90,28,1090,281,1483,592,7399
"49035113307",2815,918,230,127,1823,1848,2106,2083,11950
"49035113308",1849,585,65,292,2285,432,1633,746,7887
"49035113309",3167,573,195,0,657,816,905,903,7216
"49035113310",1570,257,0,0,535,406,431,491,3690
"49035113406",3444,1196,20,0,1273,660,1964,1203,9760
"49035113407",6698,761,274,131,2507,638,2973,948,14930
"49035113408",4235,823,0,0,875,344,1397,337,8011
"49035113409",4819,146,67,11,616,133,1638,102,7532
"49035113410",4029,649,130,20,1148,427,1352,329,8084
"49035113411",1887,236,8,0,528,110,425,160,3354
"49035113412",1432,170,0,0,949,129,645,132,3457
"49035113413",4449,374,134,0,931,44,1465,100,7497
"49035113505",4733,1133,39,84,740,393,1211,1134,9467
"49035113509",2477,606,72,0,2469,1096,1887,1226,9833
"49035113510",2413,135,45,0,663,15,710,39,4020
"49035113511",2905,408,48,155,494,408,458,336,5212
"49035113512",1738,600,50,41,910,167,397,279,4182
"49035113513",3690,875,231,22,1125,199,1359,604,8105
"49035113514",3095,871,37,10,1136,759,814,572,7294
"49035113515",4409,301,0,122,927,16,317,0,6092
"49035113520",2873,356,50,10,666,79,499,253,4786
"49035113521",4697,516,225,0,489,34,1007,209,7177
"49035113522",3046,101,0,0,286,40,629,0,4102
"49035113523",4982,762,72,0,434,52,1705,623,8630
"49035113525",4914,430,172,8,1345,250,1343,171,8633
"49035113526",3855,311,124,0,456,144,1032,20,5942
"49035113527",3277,51,0,0,524,434,966,434,5686
"49035113528",4611,61,47,11,323,121,742,0,5916
"49035113532",3025,198,0,0,193,24,455,60,3955
"49035113533",4101,158,0,0,234,7,344,20,4864
"49035113534",6189,323,54,0,1040,0,1547,213,9366
"49035113535",6080,531,0,0,283,326,603,74,7897
"49035113536",2052,780,0,0,526,592,1080,908,5938
"49035113537",2723,164,0,0,534,73,1046,20,4560
"49035113538",2018,575,62,0,872,185,1058,482,5252
"49035113539",2700,688,40,0,478,52,939,370,5267
"49035113600",3238,1025,25,51,632,193,1123,428,6715
"49035113701",2912,848,9,0,448,10,1160,574,5961
"49035113702",2093,321,53,0,271,43,883,133,3797
"49035113801",4344,216,41,0,500,260,1621,52,7034
"49035113802",2389,513,0,0,373,456,641,642,5014
"49035113803",6345,526,85,0,1541,421,2258,585,11761
"49035113903",4080,390,16,0,469,333,1047,415,6750
"49035113904",4036,681,0,0,485,13,773,164,6152
"49035113905",5639,651,7,13,1523,225,1844,565,10467
"49035113906",2533,1200,23,0,443,29,560,317,5105
"49035113907",6523,838,19,0,664,0,1988,385,10417
"49035114000",1082,312,0,26,443,217,385,188,2653
"49035114100",2038,181,14,12,132,9,158,19,2563
"49035114200",3478,244,0,0,408,34,376,47,4587
"49035114300",14548,1825,342,46,1564,195,3015,445,21980
"49035114500",3622,610,45,0,1626,203,2177,413,8696
"49035114600",6822,699,0,0,181,0,441,15,8158
"49035114700",2699,879,124,54,879,256,1079,684,6654
"49035114800",2781,66,0,0,286,140,36,0,3309
"49035115106",7469,134,0,0,376,93,464,93,8629
"49035115209",5486,504,61,0,371,253,1012,170,7857
"49035980000",0,0,0,0,0,0,0,0,0
"49037942000",118,13,0,0,1787,1227,2,7,3154
"49037942100",107,3,0,0,1613,1497,14,0,3234
"49037978100",2687,474,0,0,165,45,267,136,3774
"49037978200",3308,394,10,0,710,444,205,54,5125
"49039972100",6561,944,5,3,348,25,352,99,8337
"49039972200",3226,383,5,0,209,179,325,165,4492
"49039972300",2512,243,5,0,387,142,383,183,3855
"49039972400",3695,1744,21,42,350,39,349,113,6353
"49039972500",3658,306,7,0,108,11,43,13,4146
"49041975100",3642,409,2,0,171,117,193,89,4623
"49041975200",2341,193,0,2,33,60,74,62,2765
"49041975300",3745,661,0,33,125,46,162,40,4812
"49041975400",2664,496,6,0,127,28,84,63,3468
"49041975500",4280,898,0,0,144,46,92,89,5549
"49043964101",1885,138,0,0,50,4,77,33,2187
"49043964102",3100,425,0,0,102,13,481,165,4286
"49043964201",3475,224,1,11,74,78,343,156,4362
"49043964202",2895,98,0,0,11,1,209,50,3264
"49043964203",82,0,0,0,88,0,103,0,273
"49043964303",2479,65,23,0,88,0,115,0,2770
"49043964304",4449,253,0,0,467,0,438,148,5755
"49043964305",1702,144,67,0,262,0,165,57,2397
"49043964306",2116,54,34,0,107,0,240,0,2551
"49043964307",4316,154,9,0,46,0,60,14,4599
"49043964308",2220,630,11,0,73,43,12,470,3459
"49043964401",1459,145,0,0,35,135,14,14,1802
"49043964402",2770,504,16,0,61,56,564,400,4371
"49045130600",1316,361,19,6,349,50,770,331,3202
"49045130701",2987,451,0,80,18,9,232,8,3785
"49045130702",12608,648,53,0,216,186,1105,0,14816
"49045130703",7263,157,0,0,142,20,360,58,8000
"49045130800",4540,625,0,0,138,108,174,164,5749
"49045130900",3043,738,40,0,569,18,537,214,5159
"49045131001",2215,175,146,0,398,0,313,0,3247
"49045131002",6808,423,12,39,892,99,1114,0,9387
"49045131100",7009,547,50,0,426,20,855,170,9077
"49045131200",2457,409,13,0,285,0,450,77,3691
"49045980000",0,0,0,0,0,0,0,0,0
"49047940201",3068,140,0,0,1612,920,232,102,6074
"49047968200",6716,576,0,0,314,17,205,0,7828
"49047968301",4618,937,77,0,305,22,103,392,6454
"49047968302",3950,217,0,0,91,43,402,43,4746
"49047968401",2992,316,31,0,340,116,427,96,4318
"49047968402",5704,599,0,0,337,77,457,147,7321
"49049000102",4019,473,0,0,110,127,448,182,5359
"49049000103",3563,156,29,0,128,47,142,10,4075
"49049000104",2765,263,0,0,71,0,202,0,3301
"49049000105",4136,74,0,0,46,0,179,0,4435
"49049000203",3368,767,0,0,307,26,337,96,4901
"49049000204",4721,498,11,0,266,221,249,273,6239
"49049000205",3126,310,0,0,340,52,163,0,3991
"49049000206",3210,89,59,0,120,0,229,39,3746
"49049000400",2817,775,0,0,81,109,227,118,4127
"49049000504",3477,581,0,34,234,6,110,0,4442
"49049000505",2964,91,12,0,52,0,329,0,3448
"49049000506",3209,419,6,0,197,42,283,31,4187
"49049000507",1795,74,16,0,0,5,102,0,1992
"49049000508",4173,459,28,0,203,0,300,148,5311
"49049000509",5322,1183,0,22,182,0,778,438,7925
"49049000601",2661,291,11,0,176,73,178,138,3528
"49049000603",3514,415,0,0,356,40,234,71,4630
"49049000604",2641,87,0,0,174,0,462,0,3364
"49049000703",4033,910,15,0,299,305,597,528,6687
"49049000706",4761,627,146,0,277,136,663,231,6841
"49049000707",3077,614,16,0,245,27,399,261,4639
"49049000708",2206,368,0,0,529,0,315,0,3418
"49049000709",2512,198,78,0,69,72,396,72,3397
"49049000710",2549,50,9,0,177,63,109,9,2966
"49049000711",1971,72,14,0,194,0,123,0,2374
"49049000801",3496,835,56,0,744,343,835,562,6871
"49049000802",3807,1357,0,0,382,122,1197,618,7483
"49049000901",3152,1329,7,32,453,252,941,594,6760
"49049000903",2664,382,3,0,276,0,183,65,3573
"49049000904",2526,208,24,8,108,17,102,0,2993
"49049001001",3258,210,0,0,254,7,224,110,4063
"49049001002",2167,304,0,0,35,0,146,0,2652
"49049001103",1680,394,8,74,228,49,183,137,2753
"49049001105",2650,597,10,0,212,39,472,117,4097
"49049001106",2158,322,0,0,319,13,418,13,3243
"49049001107",3206,303,0,14,44,208,177,0,3952
"49049001108",2236,541,166,0,187,17,510,79,3736
"49049001201",2797,915,40,0,357,212,222,54,4597
"49049001202",3346,678,30,0,755,281,889,277,6256
"49049001300",2610,666,42,0,67,88,244,176,3893
"49049001401",2018,657,0,39,283,0,51,143,3191
"49049001402",2667,1699,54,46,453,137,686,361,6103
"49049001501",4072,168,0,43,96,44,133,39,4595
"49049001503",3426,279,0,0,132,0,182,0,4019
"49049001504",3608,699,0,19,482,96,391,62,5357
"49049001601",349,1379,0,30,102,329,17,143,2349
"49049001602",94,599,0,0,20,72,39,42,866
"49049001603",1050,1200,2,0,125,283,58,41,2759
"49049001701",3446,790,15,13,92,191,73,49,4669
"49049001702",2181,1706,0,0,477,93,764,153,5374
"49049001801",1931,4101,6,77,151,289,180,187,6922
"49049001802",2188,2808,0,0,148,262,197,110,5713
"49049001803",1062,1029,0,0,83,131,114,256,2675
"49049001900",2093,1329,84,12,248,274,395,229,4664
"49049002000",5050,792,15,0,493,388,1493,417,8648
"49049002101",3294,615,14,0,240,223,207,11,4604
"49049002102",2149,316,18,65,184,52,241,100,3125
"49049002201",3426,923,8,99,274,42,416,176,5364
"49049002204",3465,172,0,0,172,147,863,97,4916
"49049002205",3055,200,0,0,588,115,824,84,4866
"49049002206",2597,533,42,0,454,103,694,347,4770
"49049002207",2888,130,0,0,238,319,791,348,4714
"49049002300",2232,1066,46,20,874,90,707,568,5603
"49049002400",509,338,6,0,165,0,244,25,1287
"49049002500",2661,1355,25,0,315,153,550,612,5671
"49049002701",2516,398,0,0,101,4,689,19,3727
"49049002702",3105,1099,0,0,841,77,774,268,6164
"49049002801",1700,1489,0,0,538,496,925,1145,6293
"49049002802",902,434,0,0,126,162,284,190,2098
"49049002901",4452,118,56,0,744,52,766,0,6188
"49049002902",2747,249,0,0,173,10,807,67,4053
"49049003001",3576,284,0,0,178,122,288,158,4606
"49049003002",1909,223,0,0,52,18,38,0,2240
"49049003103",2544,25,11,0,227,0,62,0,2869
"49049003104",3794,187,0,0,287,0,120,41,4429
"49049003105",3253,364,0,0,54,119,144,12,3946
"49049003106",2174,210,0,0,266,0,297,18,2965
"49049003201",2090,194,0,0,300,0,409,63,3056
"49049003203",3679,139,7,0,72,0,109,0,4006
"49049003204",2472,196,0,0,86,26,203,58,3041
"49049003205",4078,198,0,0,105,2,220,126,4729
"49049003300",5844,309,25,18,380,23,840,56,7495
"49049003401",3058,395,0,0,51,15,88,0,3607
"49049003402",5181,619,13,30,401,143,795,398,7580
"49049003403",3992,408,55,0,159,178,473,299,5564
"49049010103",6215,496,83,0,232,51,581,137,7795
"49049010104",6853,514,17,0,272,21,337,21,8035
"49049010105",7543,708,154,0,491,0,434,0,9330
"49049010106",4251,63,109,100,239,0,305,0,5067
"49049010107",2121,116,0,0,185,0,31,0,2453
"49049010108",6216,734,0,0,237,280,404,293,8164
"49049010109",7397,166,0,38,555,64,467,0,8687
"49049010110",1650,0,0,0,60,0,19,0,1729
"49049010111",6950,177,0,0,928,0,593,23,8671
"49049010112",5109,229,51,0,191,0,217,0,5797
"49049010113",5251,71,0,0,136,17,193,0,5668
"49049010208",3608,76,0,0,197,12,94,0,3987
"49049010209",4637,367,0,0,330,0,88,0,5422
"49049010210",5527,294,47,9,489,0,105,0,6471
"49049010211",3257,231,6,0,68,9,105,6,3682
"49049010212",3948,78,0,0,390,0,439,0,4855
"49049010213",2162,149,0,0,160,95,0,59,2625
"49049010214",5331,195,0,0,529,116,728,0,6899
"49049010215",6273,617,0,0,189,21,176,220,7496
"49049010216",2811,27,0,0,44,23,36,0,2941
"49049010217",4681,105,36,0,104,53,69,41,5089
"49049010218",5618,439,62,0,12,0,105,0,6236
"49049010219",3967,439,0,0,236,0,108,41,4791
"49049010220",6273,194,0,0,415,0,299,0,7181
"49049010303",3857,260,27,2,534,51,177,53,4961
"49049010304",6784,436,31,0,261,5,569,58,8144
"49049010305",2509,75,14,0,93,0,61,14,2766
"49049010404",3914,330,0,0,349,0,536,35,5164
"49049010405",3927,95,19,0,91,0,152,0,4284
"49049010406",1663,219,0,0,47,0,13,0,1942
"49049010407",1964,176,39,0,82,45,24,45,2375
"49049010408",2892,284,22,9,210,23,192,23,3655
"49049010409",2413,146,8,0,91,0,120,0,2778
"49049010410",2935,381,0,0,124,100,616,267,4423
"49049010411",4671,202,8,0,176,26,183,24,5290
"49049010503",2022,119,0,0,32,0,6,0,2179
"49049010504",2802,255,0,7,113,43,231,40,3491
"49049010505",3516,498,6,0,212,0,445,0,4677
"49049010506",1450,145,0,0,110,132,285,222,2344
"49049010600",3384,298,3,0,77,28,323,114,4227
"49049010700",3781,506,15,18,210,73,124,19,4746
"49049010900",1243,32,0,0,70,0,62,1,1408
"49049980100",0,0,0,0,0,0,0,0,0
"49051940500",8518,854,19,0,282,0,1132,364,11169
"49051960100",3364,356,14,0,252,28,771,34,4819
"49051960200",5331,536,0,0,147,47,180,365,6606
"49051960400",5331,266,0,0,35,0,425,18,6075
"49053270100",7829,1558,0,0,85,48,84,46,9650
"49053270200",2745,260,0,0,54,16,117,10,3202
"49053270300",5238,1500,63,0,952,83,721,813,9370
"49053270400",5524,912,0,24,225,75,293,86,7139
"49053270500",6681,450,23,0,520,0,267,17,7958
"49053270600",5725,1527,19,0,322,237,564,586,8980
"49053270700",7463,833,128,13,846,438,1274,337,11332
"49053270801",11470,2144,33,52,745,0,539,323,15306
"49053270802",4464,897,16,0,108,739,690,371,7285
"49053270901",2816,909,0,0,79,0,191,0,3995
"49053270902",8594,929,0,0,288,144,611,106,10672
"49053271000",3101,918,30,0,95,45,331,131,4651
"49053271100",7497,1307,33,0,767,53,1329,160,11146
"49053271200",1858,1024,8,58,155,111,86,315,3615
"49053271300",2041,1145,78,23,92,173,487,417,4456
"49053271400",2726,1015,0,0,9,35,401,137,4323
"49053271500",5494,865,48,0,358,27,730,47,7569
"49053271600",6041,281,0,0,156,0,183,31,6692
"49053271701",8474,339,0,0,285,24,507,0,9629
"49053271702",4750,445,6,0,451,162,268,69,6151
"49053271800",2769,229,0,0,434,64,257,21,3774
"49055979100",2184,441,16,0,28,36,102,28,2835
"49057200100",3015,341,38,0,754,177,1129,245,5699
"49057200202",2002,677,76,30,265,279,496,394,4219
"49057200203",3464,447,42,0,294,974,781,934,6936
"49057200204",3445,239,47,0,840,10,1138,88,5807
"49057200300",3984,1351,54,0,693,621,1504,1107,9314
"49057200400",900,321,17,0,336,219,690,207,2690
"49057200500",4872,713,30,0,401,411,1263,581,8271
"49057200600",3472,537,139,0,352,87,597,35,5219
"49057200700",2549,195,68,0,98,100,226,94,3330
"49057200800",2646,1096,6,70,558,334,1086,794,6590
"49057200900",1782,1031,0,85,614,211,1094,617,5434
"49057201100",602,600,42,70,100,134,100,98,1746
"49057201200",580,726,97,88,474,314,605,597,3481
"49057201301",1708,503,51,19,305,140,1036,224,3986
"49057201302",1740,1105,46,0,555,290,909,791,5436
"49057201400",2078,469,0,0,380,50,201,95,3273
"49057201500",3166,322,14,0,340,0,245,0,4087
"49057201600",3087,757,37,0,390,141,461,231,5104
"49057201700",1992,535,0,0,509,304,1038,575,4953
"49057201800",784,310,0,0,334,465,547,624,3064
"49057201900",525,260,54,23,106,315,265,371,1919
"49057202000",4625,535,0,155,348,172,328,52,6215
"49057210100",6836,393,96,0,136,5,134,32,7632
"49057210201",4270,149,97,0,151,0,350,26,5043
"49057210203",2470,89,23,0,41,0,44,0,2667
"49057210204",3977,292,0,3,95,21,133,136,4657
"49057210302",7467,164,15,0,826,10,917,0,9399
"49057210303",6520,107,28,0,93,0,252,56,7056
"49057210304",3567,267,0,0,51,0,248,0,4133
"49057210402",5174,326,69,0,586,74,491,125,6845
"49057210403",7749,43,0,0,169,9,234,0,8204
"49057210404",1713,119,0,4,36,4,20,17,1913
"49057210504",7994,270,107,0,449,0,436,0,9256
"49057210505",6637,319,0,23,419,127,461,76,8062
"49057210506",9382,787,106,0,1015,187,1528,686,13691
"49057210508",1854,19,6,0,346,45,395,45,2710
"49057210509",3417,850,0,0,359,7,956,381,5970
"49057210510",3125,27,0,0,480,22,402,12,4068
"49057210511",3138,284,35,0,444,56,577,0,4534
"49057210512",3766,317,0,0,259,233,609,227,5411
"49057210600",5284,766,62,0,387,113,358,0,6970
"49057210701",4487,437,44,43,460,48,731,119,6369
"49057210703",1977,220,28,0,44,82,225,74,2650
"49057210704",4615,457,131,0,497,37,659,105,6501
"49057210800",1837,483,21,0,314,355,515,224,3749
"49057210900",5521,700,153,0,493,37,671,65,7640
"49057211000",2824,188,0,0,226,82,260,73,3653
"49057211100",4123,452,13,0,180,407,340,380,5895
"49057211201",3539,321,51,0,345,0,338,0,4594
"49057211202",5965,245,40,1,500,40,358,11,7160
"50001960100",3383,301,16,3,97,5,21,0,3826
"50001960200",2559,145,30,10,32,0,39,0,2815
"50001960300",2138,179,21,72,84,37,49,10,2590
"50001960400",4632,321,35,1,105,11,128,29,5262
"50001960500",3425,382,0,0,40,26,55,0,3928
"50001960600",2314,301,0,0,77,3,5,34,2734
"50001960700",3039,568,13,0,252,11,8,0,3891
"50001960800",1672,354,0,0,32,41,30,0,2129
"50001960900",4503,448,33,16,90,0,103,0,5193
"50001961000",2034,238,9,0,52,8,39,2,2382
"50003970200",2059,43,0,0,7,9,22,0,2140
"50003970300",966,118,2,6,17,10,18,21,1158
"50003970400",3997,254,10,12,18,35,31,20,4377
"50003970500",1039,72,3,0,6,0,20,0,1140
"50003970600",2716,261,1,0,23,6,20,0,3027
"50003970700",2063,205,19,1,66,0,16,0,2370
"50003970800",3120,368,0,0,50,12,99,0,3649
"50003970900",1569,536,3,0,40,27,51,0,2226
"50003971000",2271,336,2,0,63,106,67,0,2845
"50003971100",3533,771,3,0,138,47,55,0,4547
"50003971200",3087,1356,61,25,147,43,64,30,4813
"50003971300",3018,338,0,0,121,13,0,0,3490
"50005957000",3495,591,10,4,39,44,21,4,4208
"50005957100",1898,177,1,8,24,0,11,6,2125
"50005957200",2101,484,0,0,27,5,12,16,2645
"50005957300",2035,590,0,30,9,64,22,0,2750
"50005957400",2777,530,10,0,180,49,28,15,3589
"50005957500",3053,465,0,0,102,14,171,0,3805
"50005957600",2042,166,0,0,33,0,26,0,2267
"50005957700",2378,475,0,0,76,47,0,0,2976
"50005957800",2523,264,10,0,18,11,14,0,2840
"50005957900",2785,185,19,0,102,8,17,8,3124
"50007000100",3615,344,96,6,200,201,179,85,4726
"50007000200",4496,311,151,30,287,13,80,13,5381
"50007000300",1896,566,217,19,601,206,0,0,3505
"50007000400",1579,717,102,110,540,110,13,0,3171
"50007000500",1709,2184,47,57,125,109,21,31,4283
"50007000600",2549,1140,189,54,246,15,77,64,4334
"50007000800",2082,448,24,65,114,26,74,14,2847
"50007000900",1481,689,14,52,66,20,22,10,2354
"50007001000",1335,519,74,80,172,93,90,18,2381
"50007001100",1658,310,23,0,97,105,100,2,2295
"50007002101",2518,194,10,0,207,7,45,0,2981
"50007002102",7060,289,24,0,203,0,52,0,7628
"50007002200",5038,801,0,40,289,196,111,25,6500
"50007002301",1988,170,3,3,102,0,14,0,2280
"50007002302",6029,366,38,24,126,15,56,35,6689
"50007002400",2019,518,149,231,124,62,36,7,3146
"50007002500",2740,931,116,0,113,63,47,31,4041
"50007002601",4724,208,79,0,276,0,33,0,5320
"50007002602",3362,401,72,0,312,28,0,0,4175
"50007002701",4983,194,141,0,190,0,183,0,5691
"50007002702",4517,281,78,4,118,0,94,0,5092
"50007002800",4693,143,17,11,141,7,17,0,5029
"50007002900",5881,121,25,0,193,4,30,0,6254
"50007003000",3746,123,0,55,166,0,17,0,4107
"50007003100",7952,333,83,0,459,32,183,13,9055
"50007003301",3207,40,32,7,442,0,100,0,3828
"50007003304",5230,233,190,0,87,119,72,27,5958
"50007003400",6821,301,0,0,224,10,138,0,7494
"50007003501",3483,106,0,0,193,6,135,0,3923
"50007003502",4701,256,15,1,124,126,4,1,5228
"50007003503",1808,87,9,0,23,14,44,11,1996
"50007003600",3186,378,39,0,314,12,113,0,4042
"50007003900",1047,332,0,30,46,20,25,22,1522
"50007004002",3939,155,170,0,188,136,242,11,4841
"50007980000",0,0,0,0,0,0,0,0,0
"50009950100",1649,321,22,1,10,15,29,2,2049
"50009950200",715,188,0,10,16,8,0,0,937
"50009950500",2655,480,9,4,73,17,36,5,3279
"50011010100",5998,754,22,0,321,47,114,2,7258
"50011010200",3716,582,4,0,104,73,98,16,4593
"50011010300",2732,531,14,5,81,0,49,6,3418
"50011010400",3091,254,4,0,42,7,39,12,3449
"50011010500",5218,906,0,9,270,9,28,74,6514
"50011010600",5290,225,100,0,207,17,30,8,5877
"50011010700",2426,582,16,1,285,85,5,22,3422
"50011010800",2876,418,23,0,97,22,8,1,3445
"50011010900",4269,117,0,0,213,0,52,0,4651
"50011011000",5379,144,0,0,113,2,46,12,5696
"50013020100",2714,263,0,0,152,8,42,3,3182
"50013020200",3401,261,7,0,151,20,49,9,3898
"50015953000",1962,360,4,10,62,27,5,10,2440
"50015953100",3282,329,0,0,78,0,42,0,3731
"50015953200",2222,635,25,8,114,0,84,0,3088
"50015953300",2486,350,0,0,141,10,82,11,3080
"50015953400",2252,192,6,0,46,0,10,0,2506
"50015953500",4175,766,34,0,131,100,45,0,5251
"50015953600",3914,348,9,0,81,16,58,0,4426
"50017959000",1751,336,2,0,49,7,14,0,2159
"50017959101",1808,251,8,6,12,26,14,41,2166
"50017959102",2056,376,8,0,72,12,14,4,2542
"50017959200",2991,356,0,0,7,0,96,0,3450
"50017959300",2205,264,0,0,45,12,2,13,2541
"50017959400",3492,710,0,0,52,19,24,43,4340
"50017959500",3652,379,28,45,199,27,32,0,4362
"50017959600",2159,309,0,0,89,0,23,0,2580
"50017959700",1394,217,2,3,38,15,3,0,1672
"50017959800",2058,587,0,0,88,0,0,0,2733
"50019951100",1871,422,0,0,26,10,20,10,2359
"50019951200",2330,261,27,0,131,5,24,0,2778
"50019951300",1471,264,4,0,15,29,3,0,1786
"50019951400",1476,154,0,0,9,0,4,0,1643
"50019951500",1437,915,0,0,21,7,10,0,2390
"50019951600",3774,632,9,0,97,11,67,5,4595
"50019951700",3389,515,2,1,100,6,134,11,4158
"50019951800",2079,381,30,40,62,62,7,9,2670
"50019951900",1983,439,0,0,30,12,11,0,2475
"50019952000",1435,220,2,0,33,2,11,2,1705
"50021962100",1609,144,0,0,55,2,27,0,1837
"50021962200",3530,283,18,0,42,26,0,0,3899
"50021962300",2102,325,0,0,24,4,16,0,2471
"50021962400",2490,422,1,0,5,0,8,0,2926
"50021962500",1524,94,7,0,5,0,31,0,1661
"50021962600",1978,285,0,0,30,8,97,0,2398
"50021962700",3681,226,49,1,53,0,14,0,4024
"50021962800",2498,284,4,0,100,0,84,0,2970
"50021963000",3303,459,3,0,180,0,37,14,3996
"50021963100",2844,560,7,20,16,29,14,0,3490
"50021963200",2421,562,0,0,49,25,14,0,3071
"50021963300",3820,1144,4,0,110,0,90,0,5168
"50021963400",2223,205,24,0,76,7,40,0,2575
"50021963500",1554,124,4,0,42,0,10,0,1734
"50021963600",2963,758,30,0,18,75,16,0,3860
"50021963700",2270,326,0,0,89,3,56,0,2744
"50021963800",3432,499,8,0,77,2,16,4,4038
"50021964000",2782,369,0,0,96,18,38,0,3303
"50021964200",1456,153,0,0,26,2,35,5,1677
"50021964300",1200,181,0,2,23,28,5,10,1449
"50023954000",3536,581,42,0,144,30,47,18,4398
"50023954100",2146,164,0,0,127,5,68,0,2510
"50023954200",2514,163,11,0,66,32,13,0,2799
"50023954300",4476,447,0,0,148,5,0,46,5122
"50023954400",2843,103,0,0,110,3,123,7,3189
"50023954500",2203,250,9,49,108,0,15,0,2634
"50023954600",1897,194,25,0,57,28,40,0,2241
"50023954700",1165,167,0,0,30,9,9,0,1380
"50023954800",2031,230,22,17,64,34,0,0,2398
"50023954900",1494,137,0,0,74,3,39,0,1747
"50023955000",2370,135,22,0,66,0,92,29,2714
"50023955100",3174,846,0,0,50,35,0,0,4105
"50023955200",3446,794,232,21,121,5,0,108,4727
"50023955300",3691,156,9,0,68,19,54,0,3997
"50023955400",3715,194,0,0,41,0,123,0,4073
"50023955500",4504,658,0,0,84,6,124,4,5380
"50023955600",1491,135,0,0,25,0,9,0,1660
"50023955700",1400,143,4,0,49,0,13,0,1609
"50023955800",1209,65,0,0,21,5,0,0,1300
"50025967000",2190,464,56,0,105,25,54,17,2911
"50025967100",1810,322,0,0,134,6,28,4,2304
"50025967200",2523,464,12,0,98,7,34,13,3151
"50025967300",1417,94,27,0,58,0,0,0,1596
"50025967400",772,99,0,0,28,0,0,0,899
"50025967500",687,117,0,12,53,3,6,0,878
"50025967600",2404,459,10,8,76,45,122,27,3151
"50025967700",1933,303,0,0,11,0,49,0,2296
"50025967800",1610,201,0,0,8,0,8,6,1833
"50025967900",1180,95,0,6,54,0,36,0,1371
"50025968000",2018,132,0,0,102,0,0,0,2252
"50025968100",1087,136,0,0,7,0,11,0,1241
"50025968200",1362,171,5,0,20,0,8,0,1566
"50025968300",1845,75,7,0,6,0,7,0,1940
"50025968400",3270,364,126,0,292,42,153,0,4247
"50025968500",3947,898,50,1,228,36,150,2,5312
"50025968600",1942,212,61,2,31,28,33,0,2309
"50025968700",3636,334,27,4,101,17,39,9,4167
"50027965000",2979,225,28,0,146,22,78,0,3478
"50027965100",2141,503,19,33,42,32,0,38,2808
"50027965200",2335,347,3,0,33,0,10,0,2728
"50027965300",218,52,0,3,2,9,0,0,284
"50027965400",3583,355,7,0,85,5,45,0,4080
"50027965501",2888,103,8,0,236,11,0,0,3246
"50027965502",2082,332,52,0,92,7,0,0,2565
"50027965600",3410,401,7,18,144,8,42,0,4030
"50027965700",3187,128,0,0,82,0,0,0,3397
"50027965800",2822,129,2,0,40,0,60,0,3053
"50027965900",2710,266,0,0,14,16,0,0,3006
"50027966000",2558,608,76,0,44,2,0,0,3288
"50027966100",2567,193,20,1,30,2,7,0,2820
"50027966200",1595,171,2,5,48,0,79,4,1904
"50027966300",1671,295,3,0,91,7,51,0,2118
"50027966500",3529,367,0,0,218,16,180,2,4312
"50027966600",3641,691,0,0,158,95,25,121,4731
"50027966700",3669,435,0,19,69,20,0,0,4212
"51001090100",2492,199,5,96,77,35,32,0,2936
"51001090200",3757,724,1186,532,0,9,100,287,6595
"51001090300",1308,443,478,33,85,22,12,66,2447
"51001090400",3357,234,1657,583,173,229,1307,267,7807
"51001090500",1543,465,470,125,28,0,159,30,2820
"51001090600",2392,523,403,312,41,33,4,4,3712
"51001090700",2649,174,1129,920,90,0,333,0,5295
"51001090800",1834,293,792,653,3,57,121,87,3840
"51001980100",0,0,0,2,0,0,0,0,2
"51001980200",0,0,0,1,0,0,0,0,1
"51001990100",0,0,0,0,0,0,0,0,0
"51001990200",0,0,0,0,0,0,0,0,0
"51003010100",4414,142,79,35,243,35,26,2,4976
"51003010201",3382,131,424,77,529,23,535,23,5124
"51003010202",2928,125,10,0,31,0,44,79,3217
"51003010300",7125,169,315,93,1374,0,417,0,9493
"51003010401",3556,70,416,137,127,0,0,0,4306
"51003010402",2892,99,6,131,68,0,77,0,3273
"51003010500",3470,283,809,0,312,4,18,0,4896
"51003010601",3879,386,592,303,188,84,76,159,5667
"51003010602",2445,98,375,0,316,27,36,5,3302
"51003010700",3283,350,1079,234,448,100,764,113,6371
"51003010800",3226,200,359,323,478,24,195,2,4807
"51003010901",477,338,28,0,276,84,24,53,1280
"51003010902",376,248,37,19,258,145,31,72,1186
"51003010903",4,49,0,0,0,0,0,0,53
"51003011000",5146,264,292,0,178,95,34,19,6028
"51003011100",6884,213,296,25,693,48,401,17,8577
"51003011201",3491,323,57,62,81,19,39,19,4091
"51003011202",2310,241,472,9,450,0,260,0,3742
"51003011301",4715,664,181,49,174,0,119,20,5922
"51003011302",2062,962,235,350,385,260,629,627,5510
"51003011303",2703,188,137,0,97,40,198,10,3373
"51003011400",2768,705,728,65,135,14,170,24,4609
"51005070100",2753,826,219,117,28,63,81,16,4103
"51005080100",2325,506,208,4,62,0,0,0,3105
"51005080201",2242,271,106,0,19,0,29,46,2713
"51005080202",2255,177,42,26,0,0,11,0,2511
"51005080301",1957,132,30,0,47,0,0,3,2169
"51005080302",1266,119,0,5,27,4,4,4,1429
"51007930100",4328,438,1462,286,172,0,47,48,6781
"51007930200",4194,239,1149,246,143,1,13,7,5992
"51009010100",3821,372,545,89,151,41,115,41,5175
"51009010200",4919,440,997,373,164,24,81,36,7034
"51009010300",2993,109,339,1,182,0,12,0,3636
"51009010401",2385,451,620,123,81,129,18,118,3925
"51009010402",2329,196,360,66,126,22,98,0,3197
"51009010502",223,44,42,9,10,0,0,0,328
"51009010503",1290,258,493,134,30,8,87,0,2300
"51009010504",2348,138,765,55,203,1,18,0,3528
"51009010600",1495,330,799,96,118,0,15,0,2853
"51011040100",4181,770,1007,292,150,66,34,0,6500
"51011040200",3044,329,736,239,45,41,48,0,4482
"51011040300",2505,724,454,261,129,10,62,33,4178
"51013100100",4332,120,80,0,564,15,112,0,5223
"51013100200",6052,1,41,1,615,85,317,0,7112
"51013100300",5446,23,12,2,445,0,275,0,6203
"51013100400",3501,88,10,0,210,11,307,9,4136
"51013100500",3593,173,79,7,825,0,545,32,5254
"51013100600",2303,94,156,42,531,13,458,22,3619
"51013100700",3811,187,165,12,1303,11,556,65,6110
"51013100800",909,6,308,23,453,9,447,9,2164
"51013100900",3666,125,112,49,801,52,615,59,5479
"51013101000",2637,69,138,11,346,25,151,0,3377
"51013101100",5112,133,11,2,512,0,352,0,6122
"51013101200",2739,197,138,6,1028,13,765,13,4899
"51013101300",5348,200,46,29,1009,109,307,2,7050
"51013101401",1014,18,134,22,111,3,55,0,1357
"51013101402",2373,70,76,0,480,0,193,20,3212
"51013101403",3813,439,103,16,886,188,317,19,5781
"51013101404",3201,133,155,21,760,49,330,0,4649
"51013101500",5847,420,209,28,934,37,735,29,8239
"51013101601",992,76,5,0,250,26,98,0,1447
"51013101602",1221,96,54,0,251,56,111,120,1909
"51013101603",2245,214,37,242,646,50,255,37,3726
"51013101701",2010,499,39,30,457,26,332,324,3717
"51013101702",2870,78,139,40,921,420,545,42,5055
"51013101703",1446,72,113,20,285,20,19,0,1975
"51013101801",1858,56,57,0,418,10,91,0,2490
"51013101802",4169,198,184,25,1182,651,691,482,7582
"51013101803",3150,75,194,20,531,61,459,20,4510
"51013101900",2684,89,63,52,229,6,206,19,3348
"51013102001",1480,192,69,9,913,500,1138,598,4899
"51013102002",1186,12,111,28,394,17,464,0,2212
"51013102003",2296,205,312,250,664,219,639,201,4786
"51013102100",1466,130,58,28,457,164,388,37,2728
"51013102200",1821,363,1139,494,2709,910,3255,813,11504
"51013102301",1208,45,141,5,187,16,241,0,1843
"51013102302",2574,229,125,13,1014,347,1332,349,5983
"51013102400",2321,129,299,43,516,86,381,29,3804
"51013102500",3541,122,668,168,661,21,351,49,5581
"51013102600",2121,140,243,9,943,74,1094,66,4690
"51013102701",968,295,666,204,1237,290,1171,422,5253
"51013102702",1299,107,252,25,413,0,677,95,2868
"51013102801",3586,300,1239,169,1278,1000,1482,993,10047
"51013102802",1076,24,23,25,38,15,84,0,1285
"51013102901",2232,59,84,0,302,11,124,11,2823
"51013102902",3151,116,200,14,697,150,579,124,5031
"51013103000",2953,98,121,0,263,0,356,0,3791
"51013103100",2267,585,2111,673,940,391,1018,612,8597
"51013103200",3124,482,577,24,1010,359,800,378,6754
"51013103300",1069,45,874,212,276,22,121,6,2625
"51013103401",148,20,4,4,5,0,0,0,181
"51013103402",3287,94,447,0,1150,327,172,0,5477
"51013103501",1970,101,108,0,608,253,197,18,3255
"51013103502",2093,158,390,38,377,166,379,10,3611
"51013103503",2404,21,433,14,524,11,296,0,3703
"51013103601",2142,55,0,0,197,41,147,1,2583
"51013103602",924,46,31,4,289,115,67,0,1476
"51013103700",2164,65,30,0,140,0,230,29,2658
"51013103800",2953,151,733,155,553,18,537,53,5153
"51013980100",14,0,0,0,0,0,0,0,14
"51013980200",3,0,0,0,0,0,0,0,3
"51015070100",2512,387,0,0,28,0,39,3,2969
"51015070200",2885,449,28,3,300,1,270,75,4011
"51015070300",5780,481,39,18,175,0,247,0,6740
"51015070400",4533,732,76,0,56,60,89,60,5606
"51015070500",4695,553,36,17,52,74,12,73,5512
"51015070600",7429,364,265,30,431,0,208,0,8727
"51015070700",4728,531,40,50,83,158,90,0,5680
"51015070800",5224,378,59,92,72,0,19,0,5844
"51015070900",4171,388,141,18,11,70,39,33,4871
"51015071000",5057,215,0,37,42,0,51,0,5402
"51015071101",3187,715,116,13,80,49,61,0,4221
"51015071102",5557,228,122,0,27,0,118,0,6052
"51015071200",5201,290,158,66,56,69,23,0,5863
"51017920100",3781,406,244,19,108,1,35,36,4630
"51019030101",5851,272,203,37,128,0,0,15,6506
"51019030103",5380,188,200,19,389,0,51,0,6227
"51019030104",3537,307,250,8,115,39,73,0,4329
"51019030201",7946,403,315,59,179,0,250,0,9152
"51019030202",4644,469,184,137,86,144,119,0,5783
"51019030300",3005,270,128,42,45,22,0,1,3513
"51019030401",2423,199,334,49,52,21,21,0,3099
"51019030402",5048,624,904,79,184,15,64,0,6918
"51019030501",3022,689,171,55,43,81,0,190,4251
"51019030503",1894,178,21,0,26,0,18,10,2147
"51019030504",2244,76,64,14,11,0,74,0,2483
"51019030601",3074,291,70,19,36,9,99,0,3598
"51019030602",3114,391,0,0,67,0,78,0,3650
"51019030603",2118,343,30,0,208,0,93,0,2792
"51019030604",2426,389,0,0,144,0,72,0,3031
"51019030605",2535,254,53,1,0,1,13,23,2880
"51019050100",3414,662,965,772,128,10,67,10,6028
"51021040100",2630,613,19,0,4,0,3,5,3274
"51021040200",2346,168,0,0,7,3,7,0,2531
"51023040100",2472,549,323,19,39,0,52,0,3454
"51023040200",3551,330,93,38,75,0,21,0,4108
"51023040301",2369,145,130,10,82,0,6,1,2743
"51023040302",7028,55,199,29,40,0,52,0,7403
"51023040401",1969,107,57,1,60,7,36,5,2242
"51023040402",4430,266,88,68,82,75,143,81,5233
"51023040501",5982,374,37,34,139,72,10,0,6648
"51023040502",1156,133,15,38,18,0,16,0,1376
"51025930100",1240,294,1524,298,140,0,0,0,3496
"51025930201",354,56,1166,344,3,0,0,0,1923
"51025930202",0,0,0,0,0,0,0,0,0
"51025930203",1027,406,1928,771,40,40,44,189,4445
"51025930300",2717,425,1204,854,14,3,16,3,5236
"51027010100",2820,1857,1,20,62,0,0,1,4761
"51027010200",2325,924,0,0,13,0,0,0,3262
"51027010300",2523,527,0,0,28,0,64,0,3142
"51027010400",1895,541,54,0,15,0,0,0,2505
"51027010500",1036,336,0,0,43,10,0,0,1425
"51027010600",2954,574,0,0,94,0,0,0,3622
"51027010700",3267,638,0,0,55,0,0,0,3960
"51029930101",2017,836,893,277,161,0,141,93,4418
"51029930102",1170,300,1052,138,0,1,0,3,2664
"51029930201",1892,131,663,537,61,14,3,0,3301
"51029930202",2533,508,631,374,120,73,25,0,4264
"51031020101",3721,428,1320,26,233,0,236,85,6049
"51031020102",3311,472,182,104,103,104,0,0,4276
"51031020200",3236,766,310,140,107,46,0,0,4605
"51031020300",3215,308,125,38,314,57,82,0,4139
"51031020401",3799,839,527,6,266,74,194,0,5705
"51031020402",2393,131,71,62,13,65,0,0,2735
"51031020403",4777,170,427,126,109,42,97,0,5748
"51031020500",5418,861,738,452,74,30,56,29,7658
"51031020600",2672,811,243,39,105,49,18,90,4027
"51031020700",1724,489,755,113,180,84,113,16,3474
"51031020800",2100,328,355,53,100,13,0,0,2949
"51031020900",2272,410,855,299,102,0,9,9,3956
"51033030100",2152,322,794,78,89,38,86,0,3559
"51033030201",1562,108,671,91,71,43,40,43,2629
"51033030202",1208,122,254,118,40,10,0,0,1752
"51033030300",1585,260,783,167,201,0,40,11,3047
"51033030400",1082,305,230,14,53,2,30,0,1716
"51033030500",7358,1041,2735,421,385,46,518,100,12604
"51033030600",1245,71,1288,147,84,7,41,1,2884
"51035080100",2898,659,0,0,0,0,61,0,3618
"51035080200",3533,956,2,3,7,0,8,0,4509
"51035080300",4042,831,0,44,0,44,142,0,5103
"51035080400",4263,805,52,36,95,0,245,0,5496
"51035080500",3541,693,0,15,153,27,205,89,4723
"51035080601",1880,417,0,0,21,0,6,0,2324
"51035080602",3573,972,70,0,71,0,84,0,4770
"51036600100",1290,110,969,315,193,5,56,0,2938
"51036600200",575,83,1105,148,396,29,22,3,2361
"51036600300",811,108,760,174,59,0,31,0,1943
"51037930100",3146,417,1191,552,154,6,98,41,5605
"51037930200",1640,322,478,236,15,51,2,85,2829
"51037930300",2433,274,744,491,57,10,60,4,4073
"51041100106",2456,62,24,3,126,0,42,36,2749
"51041100107",887,320,730,80,117,44,380,127,2685
"51041100205",2157,726,3438,256,1161,124,1402,681,9945
"51041100206",2333,880,1648,197,290,18,222,580,6168
"51041100208",2003,130,188,104,246,0,166,23,2860
"51041100209",3320,229,2033,0,197,0,121,0,5900
"51041100210",680,58,513,27,279,7,186,0,1750
"51041100300",932,133,445,166,195,78,237,126,2312
"51041100403",3456,382,807,17,713,56,438,0,5869
"51041100404",1245,622,372,57,232,67,964,464,4023
"51041100405",1243,283,294,157,350,158,717,412,3614
"51041100406",439,72,495,178,100,43,141,43,1511
"51041100407",1693,163,583,86,414,33,559,0,3531
"51041100409",5006,458,796,0,185,1,377,38,6861
"51041100410",1051,37,676,222,63,18,21,0,2088
"51041100505",3549,278,1150,98,137,57,153,0,5422
"51041100506",4107,216,1504,489,322,95,1095,104,7932
"51041100507",4533,189,1501,30,249,42,419,0,6963
"51041100508",3021,210,1261,326,355,25,101,49,5348
"51041100509",4619,174,1483,0,474,0,367,0,7117
"51041100510",2416,71,690,50,199,14,151,0,3591
"51041100600",202,48,1077,111,19,0,0,6,1463
"51041100701",2144,125,2039,260,82,6,250,6,4912
"51041100702",1242,102,539,99,47,7,35,20,2091
"51041100703",5833,428,1338,10,125,2,159,21,7916
"51041100804",1508,241,1731,117,764,0,88,65,4514
"51041100805",2209,291,2633,274,711,8,936,148,7210
"51041100806",1256,111,1484,421,224,101,560,127,4284
"51041100807",1002,68,463,40,138,0,235,19,1965
"51041100812",3588,538,1011,50,384,245,123,441,6380
"51041100814",1549,380,865,8,478,41,464,49,3834
"51041100815",2553,70,798,153,255,115,146,0,4090
"51041100816",3192,92,1065,1,452,51,272,0,5125
"51041100817",1549,322,772,43,333,19,158,206,3402
"51041100818",1636,108,2117,93,252,101,500,0,4807
"51041100819",1535,265,4017,227,397,4,477,90,7012
"51041100820",746,21,1478,161,241,122,172,151,3092
"51041100821",3728,122,477,12,107,0,73,0,4519
"51041100822",3665,83,622,41,218,12,72,0,4713
"51041100823",3672,104,945,53,184,28,286,0,5272
"51041100902",3451,147,56,18,164,23,149,23,4031
"51041100907",1889,336,126,5,144,81,362,132,3075
"51041100910",3357,148,1341,76,323,59,269,0,5573
"51041100912",5104,118,915,18,219,0,100,0,6474
"51041100915",2758,183,558,44,310,120,143,9,4125
"51041100919",4177,578,798,23,623,249,434,160,7042
"51041100920",673,72,92,24,91,0,39,0,991
"51041100921",4184,262,1129,303,831,0,609,0,7318
"51041100922",2869,219,1588,4,714,21,462,1,5878
"51041100923",1362,94,585,241,95,11,217,0,2605
"51041100924",3555,127,174,32,424,0,104,24,4440
"51041100926",5226,157,181,0,499,0,55,0,6118
"51041100927",5946,132,584,72,940,49,298,0,8021
"51041100928",4155,279,737,33,377,17,114,134,5846
"51041100929",5387,349,405,25,749,1,275,1,7192
"51041100930",2684,174,267,34,97,0,57,0,3313
"51041100931",4720,104,468,78,286,9,95,19,5779
"51041100932",2775,71,405,14,474,0,248,0,3987
"51041100933",1862,201,582,12,92,20,225,61,3055
"51041100934",4040,132,1946,451,1177,0,526,35,8307
"51041100935",3260,67,271,0,139,0,21,0,3758
"51041100936",3594,99,94,0,96,0,70,0,3953
"51041101003",4615,48,347,0,207,0,156,0,5373
"51041101004",4030,122,475,15,256,0,30,0,4928
"51041101007",5397,69,584,0,342,0,123,0,6515
"51041101008",3774,48,339,0,309,0,66,0,4536
"51041101009",4732,209,526,0,457,41,377,9,6351
"51041101010",6091,219,994,0,120,180,139,0,7743
"51041101011",2531,99,292,7,404,18,181,18,3550
"51041101012",3956,0,758,105,420,12,438,0,5689
"51041101013",2792,0,346,0,33,0,19,0,3190
"51043010100",6727,545,256,232,358,25,215,43,8401
"51043010200",2358,257,91,25,139,3,228,3,3104
"51043010300",2590,249,22,0,124,0,53,0,3038
"51045050100",4546,483,0,2,99,56,0,0,5186
"51047930101",3740,247,298,52,388,20,611,43,5399
"51047930102",6497,535,372,1,509,0,115,0,8029
"51047930201",5486,286,627,268,146,2,622,0,7437
"51047930202",4932,276,349,79,452,20,524,0,6632
"51047930300",3367,447,1370,222,649,266,879,216,7416
"51047930400",3671,179,223,252,199,175,99,67,4865
"51047930501",2808,196,576,100,189,27,271,8,4175
"51047930502",3190,402,875,326,884,87,710,18,6492
"51049930100",3787,301,1511,619,74,69,0,0,6361
"51049930200",1793,315,862,420,0,103,0,10,3503
"51051040100",3279,1093,17,1,15,3,0,5,4413
"51051040200",2155,246,17,2,62,9,72,5,2568
"51051040300",4072,816,11,9,17,0,26,0,4951
"51051040400",2545,901,0,0,0,0,0,0,3446
"51053840100",3531,375,898,579,60,2,15,0,5460
"51053840200",3665,325,368,102,95,6,243,0,4804
"51053840300",2710,510,2609,240,315,0,288,0,6672
"51053840400",503,116,162,97,16,18,153,0,1065
"51053840500",1503,318,725,240,49,0,0,0,2835
"51053840600",3885,319,2452,451,52,57,8,20,7244
"51053980100",0,0,0,0,0,0,0,0,0
"51057950600",1629,62,1466,314,137,14,0,0,3622
"51057950700",1713,400,1221,347,109,23,97,6,3916
"51057950800",2578,120,693,86,147,0,262,14,3900
"51059415100",2936,272,114,0,294,9,423,155,4203
"51059415200",2734,80,153,10,159,35,202,0,3373
"51059415300",2206,53,619,0,771,5,827,12,4493
"51059415401",2788,239,1279,330,784,165,1309,240,7134
"51059415402",2029,52,550,52,304,0,281,12,3280
"51059415500",4204,155,574,338,584,58,633,0,6546
"51059415600",2699,11,53,0,98,1,113,1,2976
"51059415700",3398,3,123,0,215,0,84,0,3823
"51059415800",4196,42,24,0,605,0,324,0,5191
"51059415900",2414,34,169,0,614,65,398,65,3759
"51059416000",3272,343,807,268,903,307,1031,187,7118
"51059416100",2880,123,291,0,394,0,206,0,3894
"51059416200",2793,135,1071,34,1116,4,860,4,6017
"51059416300",1742,69,141,3,49,0,43,0,2047
"51059420100",2238,234,401,170,798,105,1104,241,5291
"51059420201",1803,141,682,0,1080,59,425,105,4295
"51059420202",1385,77,442,8,228,0,334,0,2474
"51059420203",1658,47,236,70,454,91,160,1,2717
"51059420300",3525,124,722,0,1423,0,892,0,6686
"51059420400",1752,60,625,0,768,47,686,21,3959
"51059420501",1103,154,296,13,91,20,76,15,1768
"51059420502",910,31,369,9,449,12,249,12,2041
"51059420503",1472,82,719,66,418,7,573,0,3337
"51059420600",2101,169,752,47,987,186,831,123,5196
"51059420700",2913,105,321,0,570,57,608,76,4650
"51059420800",2246,25,579,25,767,168,796,160,4766
"51059421001",1489,88,506,22,819,43,707,0,3674
"51059421002",2351,113,1239,46,1288,193,616,42,5888
"51059421101",3335,47,1443,50,1398,95,797,0,7165
"51059421102",2369,74,419,22,776,75,478,48,4261
"51059421103",3153,7,973,0,837,61,220,0,5251
"51059421200",1713,24,103,0,241,0,170,0,2251
"51059421300",2643,88,318,0,746,19,384,0,4198
"51059421400",1945,618,1074,474,3205,603,2047,640,10606
"51059421500",2274,262,1311,502,1922,720,2189,704,9884
"51059421600",2065,358,1745,325,1570,174,2308,508,9053
"51059421701",1354,171,1497,47,1704,153,1574,218,6718
"51059421702",1639,195,1007,49,911,0,1002,170,4973
"51059421800",2374,153,1531,144,1370,245,1739,60,7616
"51059421900",1520,101,723,46,314,61,514,28,3307
"51059422000",1809,42,793,83,1044,65,449,65,4350
"51059422101",3181,57,1895,60,1457,14,1229,0,7893
"51059422102",1729,111,2575,71,2448,16,1083,68,8101
"51059422201",1459,3,483,0,1608,64,352,0,3969
"51059422202",1774,104,1783,0,2125,115,455,0,6356
"51059422301",1756,0,468,0,597,20,276,0,3117
"51059422302",3161,86,965,0,1095,39,485,22,5853
"51059422401",1359,62,440,0,446,0,101,54,2462
"51059422402",3058,22,1025,61,867,42,494,0,5569
"51059422403",2118,71,219,6,147,36,163,0,2760
"51059430101",3792,102,118,1,683,30,376,0,5102
"51059430102",1188,59,501,0,1117,0,372,25,3262
"51059430201",2828,152,120,0,999,75,639,150,4963
"51059430202",3216,538,59,35,1279,13,364,0,5504
"51059430203",1647,74,79,9,838,99,121,1,2868
"51059430400",4857,101,140,3,1822,250,1369,40,8582
"51059430500",1242,15,103,0,300,39,147,0,1846
"51059430600",3549,315,318,26,2655,290,2977,332,10462
"51059430700",1670,10,249,0,958,61,629,0,3577
"51059430801",3554,40,175,0,798,0,604,21,5192
"51059430802",2920,33,557,6,565,18,632,0,4731
"51059430901",2542,20,348,62,1402,133,504,20,5031
"51059430902",2230,23,200,0,1108,23,412,0,3996
"51059431001",3197,168,143,2,1437,40,750,26,5763
"51059431002",1070,36,445,0,536,0,206,0,2293
"51059431300",3190,31,186,10,883,0,248,0,4548
"51059431400",2977,169,463,13,978,45,302,96,5043
"51059431500",3798,134,364,12,733,69,384,16,5510
"51059431600",4633,161,283,17,2378,272,926,22,8692
"51059431801",2677,69,192,4,1197,66,898,60,5163
"51059431802",2730,13,46,46,809,0,727,0,4371
"51059431900",2346,0,118,0,780,20,299,12,3575
"51059432000",2504,50,128,8,612,83,737,35,4157
"51059432100",2591,273,73,0,655,118,507,9,4226
"51059432201",1373,46,215,0,822,0,396,0,2852
"51059432202",2871,90,395,40,774,401,349,384,5304
"51059432300",3742,0,98,0,1424,48,724,0,6036
"51059432401",2507,36,236,0,779,11,252,0,3821
"51059432402",4211,35,240,52,714,54,763,0,6069
"51059432500",4110,234,337,38,809,0,325,0,5853
"51059432600",3375,82,433,0,867,0,464,0,5221
"51059432701",2313,46,496,19,588,0,390,0,3852
"51059432702",2262,88,943,50,1069,51,796,0,5259
"51059432800",1242,34,346,161,493,53,215,8,2552
"51059440100",5069,258,105,161,1782,77,667,0,8119
"51059440201",1246,80,193,0,928,71,576,58,3152
"51059440202",3033,193,549,149,1843,115,681,7,6570
"51059440300",2196,65,30,2,463,2,81,1,2840
"51059440501",3490,10,0,0,1354,135,434,0,5423
"51059440502",1383,80,426,0,451,23,169,0,2532
"51059440600",1967,98,52,18,1109,8,825,90,4167
"51059440701",2386,38,76,0,610,0,436,0,3546
"51059440702",4103,104,10,1,1313,42,284,23,5880
"51059440800",4737,66,312,0,1085,175,846,16,7237
"51059450100",2746,170,562,37,1705,208,1129,214,6771
"51059450200",1882,195,153,212,1604,275,1223,433,5977
"51059450300",2409,162,167,19,1562,184,1382,51,5936
"51059450400",2055,50,38,0,644,0,684,14,3485
"51059450500",1648,50,104,0,1212,93,1218,78,4403
"51059450601",2434,45,25,1,1460,42,743,1,4751
"51059450602",1758,20,194,1,1666,212,1199,0,5050
"51059450701",1665,83,285,0,866,90,351,4,3344
"51059450702",1968,840,427,0,972,346,1617,951,7121
"51059450800",2357,121,229,0,1118,6,877,53,4761
"51059450900",1401,0,7,0,343,42,373,0,2166
"51059451000",1603,206,48,7,672,34,332,27,2929
"51059451100",1740,60,4,0,330,74,402,90,2700
"51059451200",1531,20,29,10,193,19,138,9,1949
"51059451300",1877,27,40,0,431,8,459,2,2844
"51059451400",1130,417,245,21,977,468,1324,411,4993
"51059451501",2270,370,639,179,1253,374,1021,370,6476
"51059451502",2078,517,879,100,981,40,945,523,6063
"51059451601",1599,585,122,0,3014,1050,3643,1617,11630
"51059451602",1330,33,453,9,747,80,432,6,3090
"51059451800",2408,71,43,1,729,271,949,113,4585
"51059451900",3104,46,829,12,1308,211,1404,211,7125
"51059452000",1563,41,200,76,657,212,401,30,3180
"51059452101",2430,80,585,18,2413,61,1004,16,6607
"51059452102",1510,218,39,95,1394,196,806,218,4476
"51059452200",3429,332,544,47,2338,445,2376,466,9977
"51059452301",1511,315,185,0,1334,407,731,545,5028
"51059452302",2585,203,496,0,1435,174,2010,138,7041
"51059452400",4062,260,542,38,2229,74,1785,233,9223
"51059452501",2393,75,253,12,830,408,812,337,5120
"51059452502",1242,525,1361,391,1169,259,1027,482,6456
"51059452600",2837,82,1034,138,1977,325,1470,251,8114
"51059452700",2085,237,1305,260,1293,250,1450,321,7201
"51059452801",2623,819,1110,214,919,78,644,73,6480
"51059452802",1577,481,435,193,204,65,240,55,3250
"51059460100",3157,48,137,0,1140,53,184,0,4719
"51059460200",3564,64,11,0,472,17,104,37,4269
"51059460300",2484,22,6,0,357,10,72,0,2951
"51059460400",3302,94,144,0,1112,113,285,7,5057
"51059460501",1906,58,15,13,626,41,185,21,2865
"51059460502",3963,286,475,53,2859,3,567,1,8207
"51059460600",3150,57,0,0,808,11,278,1,4305
"51059460701",2635,75,35,116,637,42,887,68,4495
"51059460702",3659,150,170,0,680,1,291,7,4958
"51059460800",2691,24,7,0,460,0,273,0,3455
"51059460900",2093,5,12,0,387,0,139,0,2636
"51059461000",1718,33,116,20,371,27,106,8,2399
"51059461100",5876,443,44,26,1224,144,920,401,9078
"51059461201",3664,83,26,116,595,0,171,8,4663
"51059461202",2621,203,597,59,1850,168,348,0,5846
"51059461500",4223,145,375,0,1721,34,630,36,7164
"51059461601",3424,204,268,16,2231,191,433,0,6767
"51059461602",1474,59,154,0,2666,179,547,147,5226
"51059461700",3528,194,212,17,2837,81,562,49,7480
"51059461801",717,32,135,103,337,95,93,0,1512
"51059461802",3339,72,360,18,2129,0,985,0,6903
"51059461901",1917,31,677,181,1190,155,844,18,5013
"51059461902",772,209,251,13,545,134,600,186,2710
"51059470100",2402,32,43,6,450,31,240,8,3212
"51059470300",2493,15,17,1,542,90,196,0,3354
"51059470400",3710,64,9,1,763,19,237,1,4804
"51059470500",4297,74,6,0,1303,156,415,0,6251
"51059470600",1906,44,10,1,636,54,90,0,2741
"51059470700",4215,19,69,0,1223,37,516,5,6084
"51059470800",2255,58,167,0,737,15,169,0,3401
"51059470900",5586,104,156,0,1114,0,421,0,7381
"51059471000",1613,14,10,0,476,9,57,0,2179
"51059471100",4388,250,143,0,2913,78,996,88,8856
"51059471201",1951,38,232,0,943,29,239,18,3450
"51059471202",3459,205,55,80,1197,97,1005,183,6281
"51059471301",1979,172,75,41,1745,262,697,302,5273
"51059471303",2376,66,123,0,1349,138,487,5,4544
"51059471304",1509,58,14,0,257,0,80,0,1918
"51059471401",2062,54,285,64,1135,41,564,0,4205
"51059471402",1727,47,44,278,1282,13,1217,58,4666
"51059480100",3497,167,108,0,599,0,159,7,4537
"51059480201",3308,33,139,16,846,75,62,17,4496
"51059480202",2183,52,76,23,1024,88,188,0,3634
"51059480203",1278,87,263,9,833,89,207,0,2766
"51059480300",5486,44,72,0,1468,40,386,25,7521
"51059480401",2951,45,85,0,1245,16,234,0,4576
"51059480402",4403,7,70,7,1960,0,651,0,7098
"51059480501",2589,16,84,0,782,108,273,0,3852
"51059480502",4425,117,149,185,798,283,924,47,6928
"51059480503",2641,80,76,0,635,16,429,0,3877
"51059480504",1780,36,52,0,179,6,75,10,2138
"51059480505",2290,38,59,0,508,31,139,8,3073
"51059480801",2815,121,587,0,1582,263,1733,268,7369
"51059480802",2403,15,232,0,969,32,668,0,4319
"51059480901",3458,88,855,228,2169,278,2666,183,9925
"51059480902",2301,302,166,41,1136,33,1159,212,5350
"51059480903",1819,82,197,51,1453,400,1315,56,5373
"51059481000",2441,134,717,98,2679,68,1978,172,8287
"51059481101",699,41,242,0,1484,0,290,0,2756
"51059481102",1223,18,386,0,1681,34,171,9,3522
"51059481103",1540,6,478,19,1187,134,409,19,3792
"51059481104",688,62,203,0,1785,0,94,32,2864
"51059481105",3022,0,280,8,2111,0,577,0,5998
"51059481106",4001,50,199,0,1076,230,324,0,5880
"51059481201",825,9,31,0,364,29,67,0,1325
"51059481202",3224,473,1170,43,1695,58,2021,296,8980
"51059481400",4617,145,358,128,799,187,526,0,6760
"51059481500",1864,53,169,0,263,0,92,6,2447
"51059481600",2920,51,29,0,422,0,178,0,3600
"51059481701",5024,76,99,0,910,33,150,0,6292
"51059481702",3605,42,115,0,930,62,644,23,5421
"51059481900",3675,323,616,126,936,59,257,192,6184
"51059482001",3828,116,278,0,671,62,268,11,5234
"51059482002",2925,66,137,7,457,0,326,8,3926
"51059482100",2398,181,350,200,538,5,636,64,4372
"51059482201",1191,589,242,101,324,65,242,473,3227
"51059482202",2303,142,99,1,569,99,251,11,3475
"51059482203",2988,86,78,50,530,8,182,3,3925
"51059482301",3889,30,242,0,534,0,404,0,5099
"51059482302",2202,136,580,390,852,115,1156,451,5882
"51059482303",2778,63,34,0,549,0,304,9,3737
"51059482400",1938,38,37,0,342,29,54,8,2446
"51059482501",2517,241,1803,117,3754,67,1273,34,9806
"51059482502",2201,36,125,0,928,0,287,13,3590
"51059482503",2839,119,245,28,1834,73,114,0,5252
"51059482504",4108,71,93,0,1396,0,411,0,6079
"51059482601",4604,124,271,0,1994,142,824,0,7959
"51059482602",4108,69,498,0,2403,60,436,0,7574
"51059490101",3388,66,297,387,1170,134,286,6,5734
"51059490103",4081,142,224,0,1364,0,1337,0,7148
"51059490501",1538,88,39,0,852,380,310,287,3494
"51059490502",4096,106,329,22,1648,0,254,0,6455
"51059491000",1609,11,31,0,309,0,72,0,2032
"51059491101",2952,27,131,0,771,0,157,0,4038
"51059491102",2283,54,164,0,1085,0,638,54,4278
"51059491103",2992,396,366,71,2572,412,1056,346,8211
"51059491201",3246,204,382,0,1917,0,733,0,6482
"51059491202",683,67,124,0,593,207,257,0,1931
"51059491301",3394,13,843,0,2328,202,1598,0,8378
"51059491302",1987,76,212,0,1384,87,528,62,4336
"51059491303",1535,32,584,84,2174,319,1176,207,6111
"51059491401",2250,16,363,10,2259,74,583,9,5564
"51059491402",2142,163,248,186,1753,33,809,97,5431
"51059491403",3261,160,123,0,561,39,299,0,4443
"51059491404",2477,39,245,29,1142,50,528,0,4510
"51059491405",2589,2,113,2,220,0,146,1,3073
"51059491501",1973,82,325,38,4433,153,308,0,7312
"51059491502",4295,183,264,0,1853,0,309,180,7084
"51059491601",2047,414,537,165,1497,184,755,163,5762
"51059491602",2658,177,341,0,1947,679,921,475,7198
"51059491701",2308,28,163,72,1069,30,411,0,4081
"51059491702",3598,690,772,156,2432,82,732,479,8941
"51059491703",2260,19,835,0,1192,262,486,0,5054
"51059491704",2516,250,459,0,1705,179,292,0,5401
"51059491705",1471,9,111,16,1632,89,218,7,3553
"51059491801",781,50,255,0,796,260,142,0,2284
"51059491802",2081,9,94,0,655,0,383,9,3231
"51059491803",4409,189,164,145,1621,0,653,0,7181
"51059492000",5080,54,302,0,472,51,58,16,6033
"51059492100",5497,13,227,0,864,0,130,0,6731
"51059492201",2375,38,107,0,408,0,214,0,3142
"51059492202",5337,0,234,77,1339,0,357,0,7344
"51059492203",3337,27,250,0,566,39,211,0,4430
"51059492300",2259,27,187,32,835,0,630,0,3970
"51059492400",2671,68,438,92,1010,197,812,32,5320
"51059492500",3647,49,90,0,458,44,59,0,4347
"51059980100",0,0,0,0,0,0,0,0,0
"51059980200",0,0,0,0,0,0,0,0,0
"51059980300",0,0,0,0,0,0,0,0,0
"51061930100",3777,568,286,14,322,0,495,275,5737
"51061930203",2233,107,129,0,183,17,30,0,2699
"51061930204",2943,214,217,0,44,0,113,26,3557
"51061930205",1437,15,173,50,21,0,43,0,1739
"51061930206",1995,55,101,13,126,16,177,0,2483
"51061930207",1312,273,149,15,129,1,81,1,1961
"51061930302",5451,552,536,125,468,46,369,190,7737
"51061930303",3049,35,123,21,101,0,116,0,3445
"51061930304",2345,68,54,0,62,18,74,0,2621
"51061930401",4596,139,162,14,221,17,158,0,5307
"51061930402",5270,204,107,50,190,43,143,0,6007
"51061930403",5637,136,618,16,198,0,487,0,7092
"51061930703",2252,156,114,0,321,0,201,4,3048
"51061930704",3567,63,287,35,172,0,89,5,4218
"51061930705",2853,169,238,21,82,45,106,45,3559
"51061930706",4469,251,994,66,318,19,953,30,7100
"51061930707",1731,163,224,5,46,0,228,52,2449
"51063920101",5566,423,34,9,199,0,16,7,6254
"51063920102",3081,277,87,182,0,3,42,7,3679
"51063920200",4667,729,0,0,118,0,308,33,5855
"51065020101",3843,111,466,285,292,79,262,79,5417
"51065020102",8436,24,218,0,499,93,173,35,9478
"51065020200",3384,434,1163,235,201,46,129,1,5593
"51065020300",3762,247,692,28,137,12,103,0,4981
"51067020101",4531,200,82,24,204,0,51,23,5115
"51067020102",2313,117,62,55,0,10,0,0,2557
"51067020200",3678,1339,171,189,156,14,35,442,6024
"51067020300",6063,351,177,92,137,74,40,0,6934
"51067020400",4613,648,53,12,34,0,218,19,5597
"51067020500",6755,785,271,70,96,0,107,0,8084
"51067020600",2324,353,0,0,62,15,0,8,2762
"51067020700",3968,807,317,0,110,28,25,100,5355
"51067020800",3842,652,1031,410,21,189,21,85,6251
"51067020900",4632,1417,1115,67,51,25,106,137,7550
"51069050100",3607,307,191,0,124,0,167,0,4396
"51069050200",3595,215,98,0,19,0,66,0,3993
"51069050300",5307,396,196,29,176,58,48,74,6284
"51069050400",6078,345,0,0,98,11,96,0,6628
"51069050500",4546,201,138,2,183,4,213,10,5297
"51069050600",3957,170,191,5,115,22,197,0,4657
"51069050700",2510,246,140,12,77,0,157,41,3183
"51069050801",3537,166,86,0,239,0,495,0,4523
"51069050802",6642,299,259,0,265,0,898,0,8363
"51069050803",5120,286,787,0,252,0,114,0,6559
"51069050900",3021,407,489,0,141,83,308,204,4653
"51069051000",8521,490,441,8,663,28,732,55,10938
"51069051101",6459,262,251,3,425,24,561,5,7990
"51069051102",5096,549,36,6,444,7,1002,68,7208
"51071930100",1768,246,0,0,100,52,38,0,2204
"51071930200",3021,529,122,3,0,15,37,86,3813
"51071930300",4433,744,0,4,42,55,76,0,5354
"51071930400",5028,506,53,13,41,69,0,0,5710
"51073100100",6016,406,594,46,456,0,65,0,7583
"51073100201",4658,131,477,58,204,0,117,0,5645
"51073100202",2977,134,419,8,58,33,86,33,3748
"51073100203",2902,179,318,99,170,4,75,0,3747
"51073100301",4519,264,318,66,156,0,59,0,5382
"51073100302",4385,929,412,89,90,18,218,74,6215
"51073100400",804,297,110,22,40,0,33,0,1306
"51073100500",3156,353,149,6,104,15,196,93,4072
"51075400100",5704,253,342,32,136,25,85,25,6602
"51075400200",3192,106,443,6,85,0,128,5,3965
"51075400300",121,72,47,0,6,1,0,1,248
"51075400400",4050,61,1186,278,0,0,35,0,5610
"51075400500",2718,102,617,282,115,17,187,0,4038
"51077060101",2137,570,4,31,43,0,49,0,2834
"51077060102",3258,820,0,36,0,78,39,0,4231
"51077060201",2196,677,99,34,38,102,87,208,3441
"51077060202",2383,317,43,21,5,0,19,5,2793
"51077060300",1695,319,0,6,6,8,7,8,2049
"51079030101",3384,349,138,148,22,8,32,8,4089
"51079030102",4232,632,103,76,118,1,82,103,5347
"51079030200",7594,443,605,181,296,273,447,191,10030
"51081880101",1514,176,1613,530,7,0,20,0,3860
"51081880102",0,0,0,0,0,0,0,0,0
"51081880200",1533,119,1856,819,59,5,0,0,4391
"51083930100",993,363,836,232,21,2,8,4,2459
"51083930201",2795,482,1345,561,47,0,18,0,5248
"51083930202",779,194,1123,195,7,0,49,0,2347
"51083930301",1258,417,696,83,12,0,28,25,2519
"51083930302",2682,418,952,241,146,70,0,5,4514
"51083930400",2541,478,430,117,126,54,116,92,3954
"51083930500",2547,273,762,198,37,4,58,4,3883
"51083930600",2351,180,1880,1346,239,0,217,0,6213
"51083930800",2312,147,895,997,50,0,4,0,4405
"51085320100",4539,579,468,32,59,0,45,0,5722
"51085320200",4954,109,667,63,122,51,178,0,6144
"51085320300",3389,199,432,2,123,11,39,0,4195
"51085320400",3410,473,349,0,348,40,95,0,4715
"51085320500",2828,67,124,16,106,0,20,0,3161
"51085320601",1426,149,739,133,175,154,46,44,2866
"51085320602",2292,261,382,69,102,99,59,129,3393
"51085320701",2685,48,54,29,151,0,46,0,3013
"51085320702",2316,26,209,36,38,0,1,0,2626
"51085320801",2050,81,248,73,11,0,4,0,2467
"51085320803",4685,119,490,0,100,2,93,7,5496
"51085320804",4383,25,391,0,300,0,78,0,5177
"51085320805",2660,120,41,20,99,0,40,0,2980
"51085320900",6673,193,629,74,293,39,252,0,8153
"51085321001",2728,145,379,0,170,12,28,39,3501
"51085321002",6366,127,589,0,506,0,306,25,7919
"51085321100",4935,217,106,84,138,10,206,20,5716
"51085321201",3930,382,153,55,99,0,82,0,4701
"51085321202",2715,73,506,214,324,58,86,16,3992
"51085321300",5003,245,545,25,337,0,204,0,6359
"51085321401",1864,111,65,18,65,0,7,0,2130
"51085321402",2896,176,211,56,53,11,61,26,3490
"51085321403",2803,7,104,0,14,0,31,0,2959
"51087200104",3508,262,876,138,388,31,291,61,5555
"51087200105",3841,816,427,171,1020,378,644,245,7542
"51087200106",2729,824,580,154,431,63,242,417,5440
"51087200107",6131,298,608,128,810,0,474,76,8525
"51087200108",2512,59,10,41,92,8,33,1,2756
"51087200109",3665,19,24,0,69,0,13,10,3800
"51087200112",3770,245,558,132,148,30,30,0,4913
"51087200116",4685,119,346,21,195,33,329,0,5728
"51087200119",5701,258,830,74,2272,22,357,0,9514
"51087200120",5811,75,216,8,1061,10,117,0,7298
"51087200121",6200,90,84,31,949,37,285,41,7717
"51087200122",3512,8,222,60,609,2,95,0,4508
"51087200123",1806,128,861,228,271,77,169,49,3589
"51087200124",3771,95,308,1,252,0,106,0,4533
"51087200125",1340,214,688,274,1501,28,131,8,4184
"51087200126",1387,82,666,36,1230,10,123,0,3534
"51087200127",4259,364,132,213,687,340,15,87,6097
"51087200128",2985,162,473,8,1225,168,82,7,5110
"51087200129",9206,113,725,0,3340,123,296,0,13803
"51087200130",6201,44,62,0,741,0,300,0,7348
"51087200201",2295,42,85,0,201,13,73,6,2715
"51087200202",3705,254,0,0,73,8,25,13,4078
"51087200301",933,55,22,0,57,7,38,0,1112
"51087200302",2274,76,228,0,245,7,212,15,3057
"51087200303",2224,202,455,39,504,80,215,55,3774
"51087200305",2390,155,301,71,852,204,162,69,4204
"51087200404",1705,362,499,36,285,196,283,285,3651
"51087200406",6432,148,1032,206,1134,0,396,23,9371
"51087200407",3296,334,704,43,720,186,182,65,5530
"51087200409",685,87,503,99,305,155,118,195,2147
"51087200410",2028,781,1614,118,237,202,863,585,6428
"51087200411",2556,443,1439,316,459,141,156,119,5629
"51087200412",670,186,730,81,118,106,73,135,2099
"51087200413",3782,76,392,34,775,29,40,0,5128
"51087200414",3853,112,878,0,1257,120,458,0,6678
"51087200501",1060,86,322,99,485,19,470,5,2546
"51087200502",1477,100,169,7,169,63,91,13,2089
"51087200503",2966,341,447,36,140,66,211,117,4324
"51087200600",3064,594,954,91,287,0,646,91,5727
"51087200700",2258,394,395,654,30,24,49,180,3984
"51087200801",1706,144,801,198,119,0,228,0,3196
"51087200802",1112,178,698,0,154,0,38,24,2204
"51087200804",554,141,2971,1027,397,83,423,15,5611
"51087200805",151,24,2420,1959,0,22,0,0,4576
"51087200903",3920,370,1929,119,848,25,380,0,7591
"51087200904",2485,48,3367,242,348,181,211,0,6882
"51087200905",1592,309,2057,434,507,39,224,30,5192
"51087200906",3334,120,845,99,283,0,80,0,4761
"51087201001",550,137,4686,661,308,45,197,0,6584
"51087201002",326,55,1821,312,378,84,25,30,3031
"51087201003",168,0,4046,445,62,0,26,0,4747
"51087201101",620,258,3714,1198,76,120,66,106,6158
"51087201102",944,138,2644,400,223,45,17,74,4485
"51087201201",2308,448,3370,735,214,42,305,12,7434
"51087201202",851,341,3870,863,120,0,61,174,6280
"51087201401",917,163,2722,723,236,84,300,77,5222
"51087201403",2198,352,2655,498,29,48,121,48,5949
"51087201404",3285,200,375,117,48,23,55,0,4103
"51087201501",1762,167,6386,1568,357,152,220,193,10805
"51087201502",2746,142,1924,126,62,0,50,0,5050
"51087201601",1973,78,641,35,104,11,0,0,2842
"51087201602",2559,242,1776,102,198,12,45,9,4943
"51087201701",2525,613,756,95,93,59,74,372,4587
"51087980100",0,0,0,0,0,0,0,0,0
"51089010100",2551,545,498,150,191,114,68,339,4456
"51089010200",3305,484,1373,215,94,46,27,0,5544
"51089010300",3411,183,1357,415,34,7,402,62,5871
"51089010400",1687,413,1225,65,416,13,422,141,4382
"51089010500",2383,380,631,91,199,70,179,78,4011
"51089010601",2162,179,276,51,117,9,0,0,2794
"51089010602",2567,510,510,130,108,7,105,33,3970
"51089010700",2180,245,575,182,53,14,9,0,3258
"51089010800",814,199,815,159,15,34,63,0,2099
"51089010900",1419,445,407,85,64,6,58,0,2484
"51089011000",3000,1280,539,377,93,208,0,170,5667
"51089011100",2001,336,208,72,0,0,9,145,2771
"51089011200",2217,695,111,57,136,146,97,157,3616
"51089011300",2841,359,452,352,12,0,49,0,4065
"51091970100",1962,281,0,0,4,0,0,0,2247
"51093280101",2204,238,1180,162,35,87,5,26,3937
"51093280103",4480,175,936,32,798,0,461,104,6986
"51093280104",3338,66,749,15,196,9,97,27,4497
"51093280105",1992,179,1474,512,104,12,23,0,4296
"51093280106",2005,294,365,117,14,1,51,1,2848
"51093280200",2419,409,1111,70,27,60,0,0,4096
"51093280300",3693,526,649,293,259,226,0,0,5646
"51093280400",2907,271,333,223,6,0,17,0,3757
"51095080101",4286,184,359,0,603,24,87,0,5543
"51095080102",1657,412,749,283,291,36,349,15,3792
"51095080202",4107,188,606,201,351,0,147,0,5600
"51095080203",2650,263,285,73,206,7,120,0,3604
"51095080205",1752,782,652,139,284,23,148,520,4300
"51095080206",8720,347,1015,0,605,122,219,265,11293
"51095080301",6228,413,1728,253,340,64,412,55,9493
"51095080303",6712,395,311,144,205,107,257,66,8197
"51095080304",5069,187,138,0,173,0,127,0,5694
"51095080401",5522,767,930,34,230,11,179,313,7986
"51095080402",4947,177,1165,164,261,35,221,35,7005
"51097950400",2290,237,977,320,219,7,193,0,4243
"51097950500",2152,181,635,55,0,0,31,0,3054
"51099040100",3292,166,1180,38,614,14,593,12,5909
"51099040200",2998,326,370,150,157,4,0,59,4064
"51099040300",6454,292,1299,123,154,0,257,0,8579
"51099040400",2876,85,798,20,244,0,0,0,4023
"51099040500",1985,165,420,17,55,0,41,0,2683
"51101950101",2641,424,639,289,34,151,52,0,4230
"51101950102",4640,245,873,128,154,7,0,0,6047
"51101950200",1339,119,740,71,148,13,7,0,2437
"51101950300",2533,320,277,28,82,74,57,13,3384
"51103030100",2436,101,1130,171,96,7,99,0,4040
"51103030200",2095,214,981,435,31,13,15,8,3792
"51103030300",2733,178,308,81,72,9,23,6,3410
"51103990100",0,0,0,0,0,0,0,0,0
"51105950100",2420,882,0,0,0,0,0,9,3311
"51105950200",3269,912,6,0,63,0,10,0,4260
"51105950300",2188,1185,65,0,0,0,5,2,3445
"51105950400",2496,849,0,0,0,0,0,0,3345
"51105950500",3975,942,187,0,142,0,19,6,5271
"51105950600",2760,1444,0,12,129,0,3,0,4348
"51107610101",3687,213,53,0,164,0,64,0,4181
"51107610102",3364,33,73,0,73,0,131,0,3674
"51107610201",3866,281,20,31,343,21,154,0,4716
"51107610202",4019,105,48,2,346,10,313,12,4855
"51107610300",6290,244,173,0,603,0,459,94,7863
"51107610400",3809,10,190,3,556,42,535,42,5187
"51107610503",5010,0,828,97,1744,20,585,0,8284
"51107610504",5497,146,681,99,691,100,800,36,8050
"51107610505",3580,322,343,43,1559,41,3227,226,9341
"51107610506",3136,70,442,112,1243,706,857,666,7232
"51107610507",4822,107,461,0,945,14,230,12,6591
"51107610601",6491,57,516,0,398,39,583,61,8145
"51107610602",1851,19,74,0,466,0,280,0,2690
"51107610603",2153,225,266,0,291,49,548,40,3572
"51107610604",5326,222,304,19,1256,21,842,75,8065
"51107610701",4551,165,83,0,149,57,325,120,5450
"51107610702",5201,220,313,7,321,62,410,93,6627
"51107610703",3699,26,123,0,577,21,517,7,4970
"51107610800",4644,100,244,14,219,27,301,27,5576
"51107610900",1923,97,315,61,118,5,93,10,2622
"51107611002",2523,154,454,16,1209,336,765,274,5731
"51107611004",5573,291,663,0,1384,0,565,139,8615
"51107611005",4031,103,399,92,888,32,493,0,6038
"51107611006",3431,38,334,28,1444,63,543,48,5929
"51107611009",3696,22,381,0,1108,0,572,0,5779
"51107611010",1191,9,142,0,60,0,11,0,1413
"51107611011",2196,60,399,72,763,95,361,63,4009
"51107611012",2824,7,176,0,1140,61,27,0,4235
"51107611013",2585,59,157,6,1043,11,325,14,4200
"51107611014",3814,111,506,24,1005,4,1010,85,6559
"51107611015",1111,5,277,0,869,0,426,0,2688
"51107611016",2203,14,265,7,375,16,243,0,3123
"51107611017",2186,27,217,0,569,36,119,13,3167
"51107611018",1384,64,508,0,608,3,274,10,2851
"51107611019",3832,76,272,59,1931,0,533,0,6703
"51107611020",3000,201,456,188,1384,22,409,91,5751
"51107611021",3193,0,358,0,2945,0,367,0,6863
"51107611022",3375,17,685,52,2261,26,272,0,6688
"51107611023",4581,101,225,0,957,12,326,35,6237
"51107611024",4726,86,383,25,855,0,267,0,6342
"51107611025",4210,212,569,38,2260,29,435,69,7822
"51107611101",2791,90,361,0,954,8,505,8,4717
"51107611102",5027,32,266,0,796,0,749,0,6870
"51107611202",3716,87,434,2,562,0,267,0,5068
"51107611204",3347,197,623,13,1583,96,1742,92,7693
"51107611205",2693,399,540,140,2158,248,1004,341,7523
"51107611206",2692,39,284,0,1015,85,584,13,4712
"51107611207",2763,23,319,0,1175,65,335,0,4680
"51107611208",2695,30,367,0,1372,90,314,65,4933
"51107611209",5230,74,71,56,1250,24,485,36,7226
"51107611300",3170,125,439,111,2023,114,2054,95,8131
"51107611400",3224,135,601,48,1075,179,1891,189,7342
"51107611501",1190,176,421,17,1136,259,634,259,4092
"51107611502",3471,235,367,0,1565,64,1164,124,6990
"51107611601",2426,158,514,39,1234,27,602,121,5121
"51107611602",2375,187,111,17,1289,182,1998,336,6495
"51107611700",2767,420,448,41,2828,106,2007,389,9006
"51107611801",3570,52,478,2,2128,40,515,14,6799
"51107611802",4552,24,640,0,4575,115,903,0,10809
"51107611803",3630,367,407,0,2286,3,431,150,7274
"51107611804",3078,96,256,0,1781,74,158,83,5526
"51107611805",3507,65,306,27,765,113,212,0,4995
"51107611806",4040,32,717,1,2963,47,549,7,8356
"51107611900",3047,41,560,10,4123,0,288,0,8069
"51107980100",0,0,0,0,0,0,0,0,0
"51109950100",5463,201,1109,35,154,11,0,10,6983
"51109950201",3148,537,878,220,379,30,253,96,5541
"51109950202",2632,384,489,43,297,42,108,19,4014
"51109950300",6734,496,877,94,358,0,242,0,8801
"51109950400",1443,228,814,77,11,27,0,58,2658
"51109950500",4475,667,821,148,280,0,37,0,6428
"51111930100",2775,362,909,407,81,105,121,90,4850
"51111930200",2262,454,734,314,93,0,43,13,3913
"51111930300",1302,158,815,353,38,81,22,151,2920
"51113930100",5583,713,591,231,269,165,77,55,7684
"51113930200",4355,579,295,109,139,8,0,6,5491
"51115951300",4185,493,350,87,87,9,61,88,5360
"51115951400",2891,203,426,13,94,0,3,0,3630
"51115990100",0,0,0,0,0,0,0,0,0
"51117930101",1658,248,434,321,84,160,92,193,3190
"51117930102",2137,321,243,58,12,1,20,1,2793
"51117930200",3139,180,1743,785,180,97,71,17,6212
"51117930300",1234,151,730,288,163,41,154,10,2771
"51117930400",2167,664,1945,818,159,60,0,1,5814
"51117930500",1290,164,268,72,5,2,5,2,1808
"51117930600",1110,240,728,230,20,46,2,0,2376
"51117930700",1276,101,821,275,28,136,37,15,2689
"51117930800",2286,203,423,412,95,1,134,8,3562
"51119950900",1175,203,381,52,0,5,51,0,1867
"51119951000",2106,168,701,138,24,36,47,28,3248
"51119951100",2124,78,438,188,0,0,0,0,2828
"51119951200",2397,153,84,7,45,2,65,2,2755
"51119990100",0,0,0,0,0,0,0,0,0
"51121020100",0,0,0,0,0,0,0,0,0
"51121020201",2267,1916,11,113,512,604,18,193,5634
"51121020202",1318,468,15,30,21,42,14,0,1908
"51121020300",3284,1562,196,109,966,415,115,43,6690
"51121020400",1645,3770,9,379,568,716,94,244,7425
"51121020500",3594,1706,72,147,484,513,59,156,6731
"51121020600",3267,1362,20,89,542,258,58,184,5780
"51121020700",2988,1811,216,192,447,258,141,63,6116
"51121020800",5275,928,309,237,44,0,282,0,7075
"51121020900",3992,448,61,0,221,6,5,0,4733
"51121021000",4021,276,115,15,14,0,13,0,4454
"51121021100",5857,397,261,468,178,0,74,129,7364
"51121021200",5984,821,188,34,124,0,177,0,7328
"51121021300",3157,188,33,12,122,0,88,0,3600
"51121021400",4203,858,48,36,29,0,29,0,5203
"51121021500",7439,862,14,0,62,0,134,0,8511
"51125950100",3367,963,932,97,64,18,26,47,5514
"51125950200",4134,343,357,0,131,0,138,0,5103
"51125950300",3127,376,347,272,189,0,266,0,4577
"51127700100",4615,179,594,0,267,34,0,0,5689
"51127700200",3493,223,536,32,154,0,93,0,4531
"51127700300",6500,477,913,41,519,23,297,37,8807
"51131930100",2237,378,1253,548,66,18,140,42,4682
"51131930200",1977,391,923,283,93,9,387,182,4245
"51131930300",2060,330,520,896,8,0,154,30,3998
"51131990100",0,0,0,0,0,0,0,0,0
"51133020100",2755,95,544,323,0,0,26,0,3743
"51133020200",1584,180,1330,90,8,0,6,21,3219
"51133020300",3887,169,694,643,0,0,0,0,5393
"51133990100",0,0,0,0,0,0,0,0,0
"51135000100",2504,582,1873,610,345,47,275,101,6337
"51135000200",1654,302,516,201,6,52,0,26,2757
"51135000300",3013,434,1476,684,64,117,126,77,5991
"51135980100",0,0,10,0,0,0,0,0,10
"51137110102",6764,596,1118,184,146,101,374,0,9283
"51137110103",8148,797,770,51,491,24,440,49,10770
"51137110104",2151,158,406,17,298,19,66,0,3115
"51137110200",2987,861,659,354,173,71,330,36,5471
"51137110300",4799,698,396,227,168,76,10,0,6374
"51139030100",2375,437,0,0,19,0,14,11,2856
"51139030200",3206,436,74,89,130,58,64,15,4072
"51139030300",3972,841,163,0,50,5,66,69,5166
"51139030400",5030,1400,0,1,49,106,32,2,6620
"51139030500",4385,667,30,0,126,25,84,34,5351
"51141030100",3800,963,85,169,67,75,30,0,5189
"51141030200",4594,1274,266,38,0,16,300,97,6585
"51141030301",1993,296,362,43,2,0,22,13,2731
"51141030302",3084,783,215,0,15,0,0,11,4108
"51143010100",2588,438,1151,100,34,2,0,2,4315
"51143010200",3119,350,748,43,100,3,103,6,4472
"51143010300",2574,658,554,244,69,38,95,0,4232
"51143010400",2723,387,610,100,84,35,71,24,4034
"51143010500",2420,212,813,419,66,9,54,0,3993
"51143010600",1837,244,678,166,64,14,23,14,3040
"51143010700",869,56,585,145,122,0,256,4,2037
"51143010801",1250,156,934,209,4,7,0,2,2562
"51143010802",4427,466,494,149,218,43,76,27,5900
"51143010900",2232,387,240,0,26,19,0,19,2923
"51143011001",3402,528,693,129,0,84,44,60,4940
"51143011002",3761,402,522,93,64,0,0,0,4842
"51143011100",1376,325,894,164,16,105,12,105,2997
"51143011200",1434,180,163,132,232,39,0,19,2199
"51143011300",4833,436,570,232,72,337,75,208,6763
"51143011400",2400,351,664,346,206,19,131,0,4117
"51145500101",5427,228,180,10,118,0,52,0,6015
"51145500102",4672,192,208,36,187,0,34,0,5329
"51145500200",7689,429,541,91,118,129,230,8,9235
"51145500300",398,3,36,4,11,0,79,2,533
"51145500400",3769,152,477,91,120,0,54,0,4663
"51147930100",2624,674,1434,1582,150,113,12,33,6622
"51147930201",1560,346,419,81,0,28,0,0,2434
"51147930202",1801,199,1221,120,24,21,36,0,3422
"51147930203",0,0,24,0,0,0,0,0,24
"51147930300",3660,257,1510,730,45,13,267,18,6500
"51149850100",296,75,57,51,52,14,30,14,589
"51149850200",1639,14,1544,210,473,107,498,108,4593
"51149850301",2810,160,2236,385,751,162,561,142,7207
"51149850302",3162,177,905,100,207,0,159,41,4751
"51149850400",3878,334,715,232,398,0,124,0,5681
"51149850501",4007,211,898,546,194,60,43,252,6211
"51149850502",3367,212,1467,226,117,5,74,0,5468
"51153900100",2111,177,447,16,709,27,322,23,3832
"51153900201",1275,191,203,153,312,1,865,159,3159
"51153900202",2602,462,530,44,1008,45,1988,286,6965
"51153900203",1332,645,1922,246,590,135,1090,464,6424
"51153900300",3768,285,2195,139,1904,33,1299,110,9733
"51153900403",2124,169,1283,169,1335,26,1302,9,6417
"51153900404",3308,251,1303,132,800,88,1949,144,7975
"51153900407",2549,211,1971,218,899,112,1554,107,7621
"51153900408",2070,175,1106,27,1122,103,1011,174,5788
"51153900409",2285,201,1217,45,685,217,1311,308,6269
"51153900410",1716,324,1682,412,839,0,960,328,6261
"51153900501",4941,491,825,10,2350,48,4456,417,13538
"51153900502",1099,9,767,0,694,0,377,0,2946
"51153900600",3664,938,997,154,1025,502,2812,1391,11483
"51153900701",1757,61,2057,196,1407,181,998,21,6678
"51153900702",4139,38,1655,201,1726,119,2050,96,10024
"51153900801",2621,21,1952,10,1507,0,715,0,6826
"51153900802",2094,340,2767,319,1281,130,1202,224,8357
"51153900901",1909,215,2119,651,550,246,805,301,6796
"51153900904",2320,214,1785,8,930,22,1039,89,6407
"51153900905",2145,171,2067,59,933,18,440,0,5833
"51153901001",3632,172,1976,165,768,100,1323,0,8136
"51153901005",2981,0,1024,9,840,0,556,0,5410
"51153901008",2287,180,2847,168,1799,149,1801,93,9324
"51153901009",4651,185,1316,16,851,135,462,0,7616
"51153901010",2733,130,775,21,566,0,341,0,4566
"51153901011",3066,0,1427,39,963,22,742,22,6281
"51153901012",1987,10,518,1,459,16,240,0,3231
"51153901100",3082,102,171,55,1134,119,1002,14,5679
"51153901203",2200,59,895,188,589,304,911,133,5279
"51153901208",2018,56,869,33,172,15,416,5,3584
"51153901209",3792,199,1178,21,920,110,1234,71,7525
"51153901211",2022,196,900,294,836,4,1121,170,5543
"51153901212",1835,54,2237,140,3720,251,2640,106,10983
"51153901219",4489,61,389,38,461,0,310,0,5748
"51153901221",2585,258,1235,108,1189,0,977,222,6574
"51153901222",1786,34,314,0,455,9,363,0,2961
"51153901223",4386,52,825,246,803,116,1183,65,7676
"51153901224",3084,79,339,85,386,10,678,10,4671
"51153901225",2431,257,1272,0,616,64,894,23,5557
"51153901226",2735,0,1895,16,1287,131,1035,0,7099
"51153901227",2738,15,1224,135,980,216,1486,126,6920
"51153901228",3203,194,2126,25,661,18,947,57,7231
"51153901229",1943,16,711,171,1301,0,1141,0,5283
"51153901230",2297,155,1044,57,647,86,807,19,5112
"51153901231",4755,101,315,18,681,63,684,0,6617
"51153901232",2694,44,59,54,515,0,349,0,3715
"51153901233",5787,91,386,0,650,0,835,0,7749
"51153901234",1994,85,73,59,127,238,86,0,2662
"51153901235",1910,0,577,0,964,0,466,0,3917
"51153901236",3145,31,987,15,660,61,476,0,5375
"51153901237",1802,13,1252,251,187,85,124,85,3799
"51153901303",3616,347,571,21,628,0,1173,347,6703
"51153901304",2186,94,33,4,128,71,348,38,2902
"51153901305",2438,120,57,0,408,9,569,68,3669
"51153901306",4617,77,617,0,210,0,336,0,5857
"51153901403",3420,354,806,165,1128,78,1553,286,7790
"51153901407",2530,403,417,0,353,19,1591,357,5670
"51153901408",3826,1013,1086,167,1020,61,2534,533,10240
"51153901409",4459,191,634,7,885,0,1485,16,7677
"51153901410",5741,34,937,31,1455,0,1251,5,9454
"51153901411",3866,155,648,0,1241,29,414,0,6353
"51153901412",4921,130,861,10,1493,33,858,0,8306
"51153901413",3167,77,496,31,407,46,614,0,4838
"51153901414",3462,11,735,183,641,0,165,0,5197
"51153901415",3048,0,378,0,500,85,499,72,4582
"51153901416",3662,78,923,0,756,0,320,78,5817
"51153901417",2227,21,18,0,81,6,72,6,2431
"51153901503",5295,95,57,0,529,0,304,0,6280
"51153901504",2845,32,99,128,382,0,33,0,3519
"51153901505",5047,99,1098,0,1137,82,413,89,7965
"51153901506",3173,81,776,12,1229,34,785,45,6135
"51153901507",1905,28,316,0,204,26,125,10,2614
"51153901508",2780,31,463,159,738,96,313,167,4747
"51153901509",4399,124,51,25,389,59,406,0,5453
"51153901510",3789,0,424,0,732,40,295,0,5280
"51153901511",2246,5,138,0,172,0,109,0,2670
"51153901601",2605,126,204,0,560,97,1165,0,4757
"51153901602",5020,291,1284,166,980,207,2218,166,10332
"51153901701",4408,585,662,287,1255,372,3010,438,11017
"51153901702",2733,807,132,7,281,43,1235,808,6046
"51153901900",3242,628,787,91,1001,139,1809,273,7970
"51153980100",0,0,0,0,0,0,0,0,0
"51155210100",5772,821,247,20,138,21,77,0,7096
"51155210201",2731,635,154,94,17,38,16,12,3697
"51155210202",3375,138,79,0,139,0,54,0,3785
"51155210300",3314,608,202,30,51,11,59,0,4275
"51155210400",3803,849,313,271,62,0,53,0,5351
"51155210500",2349,283,104,0,10,0,0,0,2746
"51155210600",2780,240,347,10,22,0,66,0,3465
"51155210700",2758,498,119,0,112,0,120,0,3607
"51155980100",0,0,0,0,0,0,0,0,0
"51155980200",0,0,0,0,0,0,0,0,0
"51157950100",2389,288,106,6,40,0,146,0,2975
"51157950200",3701,444,149,11,224,39,97,0,4665
"51159040100",3175,424,741,202,84,9,145,94,4874
"51159040200",1515,258,372,29,342,0,138,38,2692
"51161030100",3124,359,0,42,26,0,63,0,3614
"51161030201",3556,94,461,73,188,0,111,11,4494
"51161030203",3072,351,189,0,53,18,32,119,3834
"51161030204",4955,318,384,90,211,180,130,21,6289
"51161030205",3089,70,409,28,239,38,192,0,4065
"51161030300",5306,263,361,12,272,0,294,0,6508
"51161030500",3099,248,67,0,110,0,15,0,3539
"51161030600",6265,790,39,17,240,257,182,96,7886
"51161030701",5896,117,40,10,546,3,15,3,6630
"51161030702",4634,444,372,218,242,73,18,16,6017
"51161030801",4099,292,425,117,610,127,127,2,5799
"51161030802",4272,120,23,6,173,11,151,0,4756
"51161030900",4923,405,86,46,340,3,68,5,5876
"51161031000",3520,261,210,0,0,20,18,0,4029
"51161031101",3405,591,208,185,143,26,30,291,4879
"51161031102",2702,194,245,153,6,75,0,40,3415
"51161031201",4449,327,81,31,131,6,11,0,5036
"51161031202",6013,66,77,0,261,0,177,0,6594
"51163930100",6609,963,37,123,184,73,65,6,8060
"51163930200",3341,611,8,11,116,0,74,0,4161
"51163930300",5249,637,85,0,190,12,45,0,6218
"51163930400",3164,302,190,75,43,108,33,97,4012
"51165010100",2547,226,5,0,8,2,8,0,2796
"51165010200",2770,646,79,0,0,9,29,65,3598
"51165010300",4158,373,67,4,11,0,38,43,4694
"51165010400",2090,212,0,20,0,42,34,4,2402
"51165010500",1729,687,23,0,194,280,337,567,3817
"51165010600",3488,207,34,0,77,64,189,64,4123
"51165010700",3144,236,1,0,25,0,0,0,3406
"51165010800",5071,1064,209,11,126,0,157,178,6816
"51165010900",2043,352,12,50,71,0,107,0,2635
"51165011000",2694,346,0,0,27,0,16,0,3083
"51165011100",3212,113,9,0,36,0,32,0,3402
"51165011200",4758,232,0,0,35,0,110,0,5135
"51165011400",4561,658,11,33,388,0,538,291,6480
"51165011500",4042,332,59,21,265,0,209,20,4948
"51165011600",1930,139,12,2,88,0,37,0,2208
"51165011700",2435,584,56,0,105,9,338,249,3776
"51165011800",6936,179,30,0,373,91,366,3,7978
"51165011900",3055,221,164,0,69,6,52,0,3567
"51165012000",3796,645,24,31,250,103,149,88,5086
"51167030100",3295,1212,26,0,165,33,25,7,4763
"51167030200",4076,958,94,1,16,1,0,0,5146
"51167030300",3053,731,17,0,70,0,0,0,3871
"51167030401",4937,975,26,18,30,12,9,10,6017
"51167030402",2367,296,1,1,0,0,0,0,2665
"51167030500",1771,470,1,3,0,1,0,0,2246
"51167030600",2764,500,91,0,75,37,66,0,3533
"51169030100",2999,579,49,35,34,10,17,0,3723
"51169030200",2857,650,49,6,18,16,0,0,3596
"51169030300",2823,854,0,0,53,4,0,34,3768
"51169030400",2891,651,0,0,1,0,1,85,3629
"51169030500",3284,578,0,0,21,0,22,0,3905
"51169030600",2830,841,0,12,65,0,115,0,3863
"51171040100",7068,838,302,1,398,72,293,197,9169
"51171040201",2059,216,32,0,0,0,0,0,2307
"51171040202",2865,274,0,0,33,0,36,0,3208
"51171040300",3860,465,16,9,99,5,259,178,4891
"51171040400",2021,125,0,0,153,0,22,0,2321
"51171040500",6360,1537,164,170,91,79,334,225,8960
"51171040600",3299,243,26,1,122,28,131,143,3993
"51171040700",3399,581,111,10,184,51,464,177,4977
"51171040800",3799,643,8,13,208,21,241,65,4998
"51173030100",2839,404,0,0,0,24,0,0,3267
"51173030200",3154,1158,14,0,41,107,43,18,4535
"51173030301",2115,414,90,15,0,0,23,0,2657
"51173030302",3366,565,205,71,34,0,23,58,4322
"51173030400",1732,324,0,0,44,0,20,79,2199
"51173030500",1728,459,0,2,25,7,18,2,2241
"51173030600",1982,807,70,11,51,76,62,0,3059
"51173030701",3777,911,6,28,29,50,57,160,5018
"51173030702",3905,611,0,0,26,0,0,0,4542
"51175200100",3035,234,797,160,84,0,28,40,4378
"51175200200",1359,237,978,160,56,0,6,28,2824
"51175200300",68,69,17,142,0,0,0,0,296
"51175200400",3501,249,1558,666,67,88,22,38,6189
"51175200500",1669,197,1249,251,128,18,10,0,3522
"51177020104",3695,453,470,78,313,14,305,14,5342
"51177020105",2016,87,99,0,88,0,29,0,2319
"51177020106",4254,106,316,38,773,0,645,0,6132
"51177020107",1307,129,435,0,46,0,35,0,1952
"51177020108",2584,339,415,310,318,55,462,37,4520
"51177020109",2425,159,185,281,227,9,41,0,3327
"51177020110",2469,172,446,8,490,71,387,71,4114
"51177020111",1341,60,555,4,246,0,236,0,2442
"51177020112",1952,106,485,6,292,19,497,29,3386
"51177020113",3368,40,738,48,134,28,274,26,4656
"51177020114",3628,76,868,377,664,53,711,0,6377
"51177020201",3471,250,733,61,1032,283,563,218,6611
"51177020202",3256,273,824,44,648,89,306,40,5480
"51177020203",2953,181,1169,136,479,54,373,85,5430
"51177020204",3270,72,555,0,284,10,261,0,4452
"51177020205",2901,217,734,165,326,60,421,69,4893
"51177020304",2853,152,511,86,643,10,444,54,4753
"51177020305",2136,252,690,12,211,89,110,89,3589
"51177020306",3332,41,1599,19,876,260,513,260,6900
"51177020307",1984,88,673,78,848,111,781,5,4568
"51177020308",2704,63,614,0,462,0,255,0,4098
"51177020309",4211,322,871,130,260,185,267,101,6347
"51177020310",3382,102,565,16,318,10,104,0,4497
"51177020311",3658,254,680,608,430,24,182,166,6002
"51177020403",3084,412,380,92,56,18,94,0,4136
"51177020404",2973,473,440,30,56,11,19,28,4030
"51177020405",2840,418,433,0,30,66,85,0,3872
"51177020406",2794,207,193,9,14,0,156,0,3373
"51177020407",4212,228,402,66,213,40,138,18,5317
"51177020408",1984,108,84,2,133,8,156,14,2489
"51179010103",2541,19,472,151,270,132,286,57,3928
"51179010105",4607,80,1411,155,991,67,754,20,8085
"51179010106",2768,163,103,7,90,0,26,0,3157
"51179010107",2478,74,407,0,140,14,220,27,3360
"51179010108",3180,36,1441,70,1071,70,806,5,6679
"51179010201",19,15,16,0,0,0,0,0,50
"51179010202",5038,147,316,0,514,0,306,20,6341
"51179010204",5309,260,823,81,772,6,367,13,7631
"51179010205",4714,233,1464,7,597,39,592,0,7646
"51179010206",3271,139,1184,0,678,43,667,43,6025
"51179010207",2631,365,1865,317,2174,243,2030,172,9797
"51179010210",3596,204,2005,0,1246,183,864,164,8262
"51179010211",2535,10,860,0,521,446,448,402,5222
"51179010212",3068,185,647,20,467,10,688,24,5109
"51179010213",1890,12,439,0,192,17,185,0,2735
"51179010214",2952,137,718,33,322,58,348,41,4609
"51179010301",2974,100,493,18,486,0,271,0,4342
"51179010303",6248,301,1581,85,961,180,533,136,10025
"51179010304",3493,294,830,12,542,25,430,0,5626
"51179010305",3502,367,1277,34,635,200,255,269,6539
"51179010403",2365,101,287,15,216,2,155,5,3146
"51179010404",4356,264,863,17,576,20,500,0,6596
"51179010405",5198,155,772,8,532,0,405,0,7070
"51179010406",2005,174,363,20,383,57,166,6,3174
"51179010502",3676,101,469,0,237,28,231,18,4760
"51179010503",1866,141,10,27,92,0,28,0,2164
"51179010504",1475,126,93,0,41,5,42,0,1782
"51181860100",1634,238,1012,315,39,39,2,38,3317
"51181860200",1571,113,1786,81,57,0,4,0,3612
"51183870100",707,173,975,211,4,2,20,4,2096
"51183870201",941,138,476,213,0,10,0,10,1788
"51183870202",0,0,0,0,0,0,0,0,0
"51183870300",769,79,586,367,47,32,46,52,1978
"51183870400",684,143,284,220,13,1,4,3,1352
"51185020100",2188,279,7,12,13,17,0,0,2516
"51185020200",3655,641,149,128,42,56,0,0,4671
"51185020300",4955,1597,0,32,17,0,12,68,6681
"51185020400",3176,624,0,0,12,0,0,0,3812
"51185020500",2109,998,0,0,72,0,0,0,3179
"51185020600",3652,809,80,0,53,20,0,11,4625
"51185020700",2111,479,39,18,201,110,0,0,2958
"51185020800",1845,351,46,37,62,0,40,17,2398
"51185020900",1582,541,0,0,55,0,0,0,2178
"51185021000",3437,626,0,15,81,0,15,0,4174
"51185021100",4510,943,208,42,190,0,126,0,6019
"51187020100",7140,690,189,0,247,17,275,0,8558
"51187020200",2573,263,56,0,14,0,4,195,3105
"51187020300",5956,391,79,19,239,0,19,0,6703
"51187020400",3026,567,183,189,264,0,183,0,4412
"51187020500",2736,399,439,34,522,13,300,0,4443
"51187020601",4794,190,14,50,211,20,225,0,5504
"51187020602",1826,521,69,0,143,106,95,0,2760
"51187020700",2960,213,0,0,13,0,110,0,3296
"51191010100",6253,694,0,0,147,0,59,0,7153
"51191010200",5700,275,0,0,45,5,0,99,6124
"51191010300",5398,747,0,10,30,17,38,0,6240
"51191010401",1873,93,21,0,116,0,31,0,2134
"51191010402",2542,402,15,30,23,2,75,1,3090
"51191010501",3264,367,193,6,26,31,56,19,3962
"51191010502",2056,806,173,24,75,129,75,40,3378
"51191010601",3500,550,155,0,95,12,123,12,4447
"51191010602",1700,383,22,0,50,48,0,20,2223
"51191010700",3749,847,29,12,9,0,28,33,4707
"51191010800",2353,515,0,0,60,0,0,0,2928
"51191010900",3885,338,5,0,18,2,4,0,4252
"51191011000",3282,229,3,2,44,0,38,0,3598
"51193010100",1711,485,2116,390,21,0,81,0,4804
"51193010200",2104,271,1071,135,120,8,80,14,3803
"51193010300",2004,249,667,208,124,0,775,0,4027
"51193010400",4699,365,453,70,95,34,98,0,5814
"51195930700",2384,663,0,0,36,0,0,0,3083
"51195930800",1637,581,0,0,0,0,0,0,2218
"51195930900",3019,735,41,0,91,11,0,2,3899
"51195931000",2518,391,0,11,4,0,0,0,2924
"51195931100",1836,669,0,57,57,19,15,0,2653
"51195931200",3607,1318,185,73,59,81,37,105,5465
"51195931300",2816,762,0,67,32,0,0,0,3677
"51195931400",3454,547,0,0,77,0,0,0,4078
"51195931500",3699,1204,69,58,76,17,37,72,5232
"51195931600",2012,742,44,22,32,31,22,49,2954
"51195931700",1424,534,29,0,9,0,6,3,2005
"51197050100",4218,464,510,175,52,0,62,0,5481
"51197050200",5048,1066,208,69,195,0,121,0,6707
"51197050301",3614,701,52,0,18,17,71,0,4473
"51197050302",3263,407,0,0,11,7,0,0,3688
"51197050401",2968,515,8,15,50,5,22,7,3590
"51197050402",4337,937,20,1,8,0,0,23,5326
"51199050203",4705,52,633,67,1183,62,179,22,6903
"51199050204",3790,210,914,48,619,17,664,0,6262
"51199050205",3822,63,322,10,451,0,212,0,4880
"51199050206",5688,111,673,0,617,0,337,0,7426
"51199050303",4724,273,253,0,430,133,128,29,5970
"51199050304",4697,254,99,0,121,26,89,16,5302
"51199050305",1851,112,252,0,602,0,121,49,2987
"51199050306",3438,220,491,75,404,51,88,0,4767
"51199050401",2695,51,425,0,243,0,17,0,3431
"51199050402",3174,134,97,0,91,0,34,0,3530
"51199050500",1104,45,1164,375,95,87,464,67,3401
"51199050900",944,140,585,173,73,60,100,9,2084
"51199051000",2686,275,168,126,54,11,12,42,3374
"51199051100",4493,421,1480,308,461,49,350,296,7858
"51199990100",0,0,0,0,0,0,0,0,0
"51510200102",1808,574,490,191,1071,20,1016,305,5475
"51510200103",2808,155,2963,232,1313,283,1873,150,9777
"51510200104",1513,145,947,76,768,273,907,198,4827
"51510200105",836,99,2297,648,447,22,188,62,4599
"51510200106",1746,70,484,8,895,0,610,63,3876
"51510200107",3619,245,908,172,990,246,744,52,6976
"51510200201",2400,46,371,144,243,0,233,18,3455
"51510200202",1552,44,63,0,154,10,148,0,1971
"51510200301",1540,189,740,37,692,62,497,105,3862
"51510200302",2180,109,1652,47,880,85,774,0,5727
"51510200303",2264,326,1351,119,702,203,734,101,5800
"51510200403",782,15,210,0,203,40,79,0,1329
"51510200404",2863,16,537,0,420,0,255,0,4091
"51510200405",2808,248,2060,219,1342,104,1799,252,8832
"51510200406",1514,187,1729,327,1280,75,1216,55,6383
"51510200407",2185,37,1227,150,677,0,361,0,4637
"51510200500",1884,93,1220,263,591,63,865,0,4979
"51510200600",2683,187,808,315,1012,18,1192,141,6356
"51510200701",630,45,71,0,31,0,41,0,818
"51510200702",3534,124,261,7,305,0,452,0,4683
"51510200703",1772,28,480,461,190,16,98,0,3045
"51510200801",2203,30,375,4,182,13,91,0,2898
"51510200802",2251,36,299,196,321,20,450,36,3609
"51510200900",4095,106,139,48,421,0,183,0,4992
"51510201000",2340,56,61,0,184,33,167,13,2854
"51510201100",2509,69,118,8,550,14,214,28,3510
"51510201202",2514,124,350,1,183,25,412,9,3618
"51510201203",3440,1291,487,416,829,97,2613,1143,10316
"51510201204",1927,132,828,69,555,0,1027,120,4658
"51510201300",2550,50,272,256,157,0,185,0,3470
"51510201400",3671,85,160,83,231,0,555,0,4785
"51510201500",3228,60,14,0,221,0,147,0,3670
"51510201600",2870,118,692,598,232,9,89,0,4608
"51510201801",4445,44,545,92,577,109,567,0,6379
"51510201802",1421,51,310,194,107,0,99,0,2182
"51510201900",1337,73,67,12,96,5,92,0,1682
"51510202001",1875,77,10,0,159,0,75,0,2196
"51510202002",1859,39,91,0,114,0,62,0,2165
"51520020100",3164,422,133,2,0,35,5,21,3782
"51520020200",2941,1191,414,210,0,190,0,57,5003
"51520020300",1599,722,136,143,113,57,0,0,2770
"51520020400",5140,340,35,0,161,57,36,0,5769
"51530930600",4287,1374,83,50,427,0,0,47,6268
"51540000201",1411,395,481,170,96,106,72,21,2752
"51540000202",637,2090,645,418,227,262,18,79,4376
"51540000302",1709,161,368,37,121,13,57,1,2467
"51540000401",1403,433,871,548,177,23,224,22,3701
"51540000402",2767,652,463,134,98,28,36,11,4189
"51540000501",926,188,1873,399,116,203,4,72,3781
"51540000502",3167,475,871,131,425,97,12,21,5199
"51540000600",814,1741,88,113,308,634,99,114,3911
"51540000700",2215,717,55,29,155,106,87,52,3416
"51540000800",2838,443,324,80,159,207,739,36,4826
"51540000900",1898,110,30,48,54,0,135,0,2275
"51540001000",2262,238,158,88,102,0,96,0,2944
"51550020001",1145,87,76,0,96,0,51,19,1474
"51550020002",2185,346,1202,459,220,62,280,49,4803
"51550020003",3618,200,704,745,303,34,236,0,5840
"51550020100",486,48,2540,1088,108,22,191,0,4483
"51550020200",587,10,2393,1215,82,0,0,10,4297
"51550020300",512,56,431,397,106,48,22,21,1593
"51550020400",1767,261,1035,227,90,16,81,0,3477
"51550020500",612,47,338,51,333,0,356,52,1789
"51550020600",3164,306,632,5,125,0,301,0,4533
"51550020700",861,321,3504,482,116,21,165,137,5607
"51550020804",5050,257,1447,172,694,0,599,0,8219
"51550020805",2954,106,1563,117,724,80,155,43,5742
"51550020806",4390,240,1672,56,896,0,106,21,7381
"51550020807",4972,73,1840,54,794,37,425,14,8209
"51550020808",801,15,2443,187,434,0,446,0,4326
"51550020809",2564,181,1594,154,326,20,242,20,5101
"51550020903",546,120,1690,135,89,0,121,0,2701
"51550020904",5017,125,2062,671,639,83,254,0,8851
"51550020905",1981,186,426,25,114,0,299,25,3056
"51550020906",3827,443,1907,241,538,214,417,0,7587
"51550021004",4414,146,474,49,618,0,398,21,6120
"51550021005",3165,460,603,15,291,52,391,0,4977
"51550021006",6087,311,422,97,536,0,190,122,7765
"51550021009",3583,52,176,27,252,0,102,10,4202
"51550021010",4560,105,591,49,255,75,175,24,5834
"51550021011",2957,84,173,45,172,0,88,0,3519
"51550021012",5416,114,158,0,395,0,378,0,6461
"51550021013",3691,103,312,95,572,0,288,26,5087
"51550021101",4326,293,229,6,141,0,242,0,5237
"51550021102",4688,314,601,22,462,0,127,1,6215
"51550021200",4140,186,329,27,442,40,36,27,5227
"51550021301",3408,268,1353,136,210,15,188,0,5578
"51550021302",5575,183,2834,383,696,69,450,114,10304
"51550021401",1141,84,461,57,97,12,34,10,1896
"51550021402",4359,557,1263,23,261,71,56,0,6590
"51550021403",2475,179,1114,245,316,149,275,107,4860
"51550021404",1218,451,4968,635,199,33,225,287,8016
"51550021501",5239,239,3388,750,968,141,647,85,11457
"51550021502",5397,559,1371,41,776,0,134,0,8278
"51550021601",6083,118,825,66,971,19,224,0,8306
"51550021602",2621,36,2719,1174,437,29,227,0,7243
"51570830100",4017,289,170,105,157,40,88,0,4866
"51570830200",1890,414,430,136,138,20,159,11,3198
"51570830300",1901,95,464,22,281,6,101,13,2883
"51570830400",1543,252,357,111,100,25,112,0,2500
"51570830500",3325,223,550,58,163,40,319,16,4694
"51580060100",1846,607,615,63,65,18,0,14,3228
"51580060200",1785,555,70,10,123,11,51,0,2605
"51590000100",2406,177,2475,338,96,87,10,0,5589
"51590000200",1397,357,1205,480,117,27,107,25,3715
"51590000300",705,134,1462,665,12,26,0,6,3010
"51590000400",588,253,1304,1033,0,45,0,85,3308
"51590000500",160,92,591,596,15,28,0,0,1482
"51590000600",361,116,1075,916,68,18,32,9,2595
"51590000700",2101,223,330,261,36,35,39,0,3025
"51590000800",1180,184,844,400,95,0,0,0,2703
"51590000900",2042,560,1015,262,70,183,9,227,4368
"51590001000",667,286,1348,1048,67,133,67,23,3639
"51590001100",327,45,528,298,18,26,9,9,1260
"51590001200",839,314,239,161,173,55,123,49,1953
"51590001301",638,64,430,73,129,14,102,0,1450
"51590001302",246,299,214,10,22,14,52,26,883
"51590001400",1912,283,394,59,333,6,277,0,3264
"51590980100",13,0,0,0,0,0,0,0,13
"51595890100",271,77,1424,909,72,45,50,0,2848
"51595890200",1039,247,678,607,86,2,9,0,2668
"51600300100",2865,189,128,126,1146,315,404,0,5173
"51600300200",3566,136,20,57,1318,83,1142,68,6390
"51600300300",3715,235,278,0,1569,121,964,0,6882
"51600300400",2160,124,75,200,778,173,750,13,4273
"51600300500",2498,238,185,0,577,8,402,8,3916
"51610500100",2843,62,77,2,200,20,106,1,3311
"51610500200",3884,88,355,216,1185,112,909,46,6795
"51610500300",3218,41,70,0,632,61,168,8,4198
"51620090100",2648,172,1477,189,225,0,25,25,4761
"51620090200",291,99,1554,1688,36,16,0,0,3684
"51630000100",2316,243,119,29,126,18,60,14,2925
"51630000200",3116,1177,837,307,623,138,602,196,6996
"51630000301",63,386,0,0,0,0,0,0,449
"51630000302",2999,411,682,136,187,118,458,42,5033
"51630000400",1129,216,1038,326,296,131,71,112,3319
"51630000500",3345,284,1827,449,759,265,822,295,8046
"51640070101",2984,1265,129,28,65,71,400,440,5382
"51640070102",1683,266,94,47,34,55,320,130,2629
"51650010103",4533,380,1482,89,707,121,449,106,7867
"51650010104",1843,145,2598,1228,489,158,341,42,6844
"51650010200",567,0,21,0,46,29,46,0,709
"51650010304",2669,99,3194,423,836,51,410,14,7696
"51650010306",2814,124,2403,359,699,38,632,216,7285
"51650010307",2031,58,2427,95,567,41,263,0,5482
"51650010309",1444,367,2190,230,209,0,159,0,4599
"51650010310",2375,179,1541,56,459,7,218,0,4835
"51650010311",1296,148,2044,462,416,19,288,0,4673
"51650010312",2386,180,472,64,182,11,34,53,3382
"51650010313",2338,318,2557,507,366,39,296,178,6599
"51650010314",530,143,905,8,114,4,87,0,1791
"51650010400",1103,57,4006,1438,135,40,6,0,6785
"51650010501",1367,77,3529,941,179,141,169,0,6403
"51650010502",222,88,1764,858,319,9,110,0,3370
"51650010601",360,10,870,759,0,0,103,0,2102
"51650010602",342,22,1317,1226,76,14,23,52,3072
"51650010701",1214,227,973,891,79,11,83,0,3478
"51650010702",2385,295,959,22,133,0,94,0,3888
"51650010703",2114,33,690,17,100,30,130,0,3114
"51650010800",2927,94,1824,256,505,0,442,19,6067
"51650010900",272,78,1283,577,57,31,190,0,2488
"51650011000",2745,368,1930,621,188,0,7,6,5865
"51650011100",376,11,24,0,83,0,13,0,507
"51650011200",1290,435,717,51,157,26,92,0,2768
"51650011300",691,76,788,363,63,0,41,0,2022
"51650011400",40,22,66,285,6,0,34,22,475
"51650011500",2929,196,642,274,186,0,370,21,4618
"51650011600",583,53,1396,631,166,10,160,0,2999
"51650011800",1176,145,2409,777,241,39,135,0,4922
"51650011900",192,146,2069,558,37,93,50,144,3289
"51650012000",528,165,1441,416,59,23,34,17,2683
"51650012100",4525,180,694,24,287,0,292,0,6002
"51650990100",0,0,0,0,0,0,0,0,0
"51660000101",2555,804,629,236,315,22,954,149,5664
"51660000102",2889,704,386,214,207,136,829,136,5501
"51660000203",1100,419,52,0,12,29,27,48,1687
"51660000204",1952,1118,72,146,262,255,730,241,4776
"51660000205",3355,2101,51,53,177,224,817,0,6778
"51660000206",144,0,0,0,0,0,24,0,168
"51660000207",724,3230,85,204,62,303,148,247,5003
"51660000301",2507,448,30,0,219,39,429,43,3715
"51660000302",3105,927,178,70,440,227,1083,260,6290
"51660000401",1993,179,99,9,339,133,173,50,2975
"51660000402",4734,1683,294,174,274,0,1479,587,9225
"51670820100",559,232,483,113,19,89,19,107,1621
"51670820300",1026,245,561,386,428,24,282,0,2952
"51670820400",3518,192,1157,195,261,0,202,0,5525
"51670820500",3285,426,370,414,203,39,15,0,4752
"51670820600",1508,458,1826,648,709,21,772,50,5992
"51670820700",209,30,1824,373,82,0,40,0,2558
"51670980100",0,0,0,0,0,0,0,0,0
"51678930500",2385,655,376,0,155,44,91,64,3770
"51680000100",3357,117,202,99,90,0,113,0,3978
"51680000201",5546,469,226,141,279,0,83,0,6744
"51680000202",3226,539,1298,692,302,28,54,71,6210
"51680000203",72,177,20,47,60,0,0,0,376
"51680000300",1773,324,721,344,63,70,76,0,3371
"51680000400",858,180,1078,534,43,13,1,0,2707
"51680000500",238,83,45,43,18,21,0,0,448
"51680000600",415,25,1418,803,215,6,204,6,3092
"51680000700",754,505,1198,739,226,241,22,20,3705
"51680000801",1076,401,320,182,20,24,47,0,2070
"51680000802",1930,449,602,85,215,45,53,26,3405
"51680000900",3164,650,1131,754,291,33,497,0,6520
"51680001000",2207,195,484,169,39,0,63,40,3197
"51680001100",254,72,769,254,38,76,7,13,1483
"51680001400",83,157,24,92,0,0,0,0,356
"51680001600",3588,2321,974,717,805,648,404,33,9490
"51680001700",3151,697,505,27,427,103,167,0,5077
"51680001800",1562,207,228,29,33,10,34,10,2113
"51680001900",1165,602,1883,1308,239,44,0,55,5296
"51683910100",2760,342,451,243,377,4,704,206,5087
"51683910201",3794,207,291,2,386,57,1040,72,5849
"51683910202",4965,616,1072,56,1076,52,2296,411,10544
"51683910301",2788,545,945,100,407,13,909,463,6170
"51683910302",4057,624,677,126,722,188,1937,310,8641
"51683910401",3780,1352,1136,19,551,197,2496,1488,11019
"51683910402",3680,134,687,45,811,31,769,26,6183
"51685920100",5167,293,311,0,829,232,2990,337,10159
"51685920200",4339,378,1280,342,1619,151,1590,187,9886
"51690000100",1232,219,1215,389,54,10,256,0,3375
"51690000200",107,37,1156,1028,30,23,0,0,2381
"51690000300",1048,329,637,197,50,17,29,0,2307
"51690000400",716,364,481,360,328,142,306,8,2705
"51690000500",2390,107,331,202,41,0,0,0,3071
"51700030100",387,153,1232,1735,113,22,42,156,3840
"51700030300",240,74,3814,1391,23,164,29,92,5827
"51700030400",66,9,1793,1759,39,19,16,86,3787
"51700030500",0,18,1161,490,9,29,9,0,1716
"51700030600",51,33,1329,887,44,0,21,0,2365
"51700030800",0,0,1200,638,55,0,20,3,1916
"51700030900",558,69,834,481,100,0,67,35,2144
"51700031100",966,137,1303,176,107,0,12,0,2701
"51700031200",519,103,1015,336,118,13,58,15,2177
"51700031300",933,86,2094,533,132,69,35,0,3882
"51700031400",2596,424,2172,584,196,0,214,41,6227
"51700031500",4415,188,627,156,314,68,196,5,5969
"51700031601",2815,346,2442,146,575,238,420,214,7196
"51700031602",2577,352,964,26,445,7,189,37,4597
"51700031701",1440,199,294,224,66,51,49,7,2330
"51700031702",2540,104,711,183,106,0,105,24,3773
"51700031800",3527,305,169,0,210,0,67,0,4278
"51700031901",3326,75,180,42,206,32,0,0,3861
"51700031902",2460,98,838,278,322,37,159,0,4192
"51700032001",2526,30,340,10,288,12,67,0,3273
"51700032002",4033,70,1384,1,532,37,255,48,6360
"51700032005",2029,62,415,85,169,0,85,0,2845
"51700032006",702,223,1342,1073,351,88,132,157,4068
"51700032007",2238,145,1050,60,237,19,284,16,4049
"51700032113",1148,216,553,15,358,42,230,110,2672
"51700032114",1022,51,265,14,258,0,115,1,1726
"51700032117",2348,242,978,518,196,10,304,0,4596
"51700032123",2067,65,2403,556,570,128,669,42,6500
"51700032124",993,154,2206,177,641,47,285,32,4535
"51700032126",2080,441,673,110,266,97,886,413,4966
"51700032127",1812,351,1323,147,242,74,267,0,4216
"51700032128",1818,175,698,354,462,19,905,116,4547
"51700032129",1329,92,1165,295,221,60,141,21,3324
"51700032130",3521,164,953,0,732,0,420,73,5863
"51700032131",2460,253,1511,111,352,31,251,100,5069
"51700032132",3268,386,1063,394,358,244,737,142,6592
"51700032211",4062,51,1306,0,669,71,174,0,6333
"51700032212",386,106,2008,771,401,148,417,210,4447
"51700032223",1209,101,1137,246,553,71,502,29,3848
"51700032224",2187,237,3182,809,916,12,427,170,7940
"51700032225",682,495,2119,427,176,18,273,117,4307
"51700032226",1723,329,1112,61,423,87,463,241,4439
"51700032300",1432,289,608,18,452,175,392,177,3543
"51700032400",1662,122,885,93,335,40,286,91,3514
"51710000100",1395,208,803,23,115,0,99,23,2666
"51710000201",1358,294,363,135,369,15,191,80,2805
"51710000202",2034,549,460,183,446,163,70,109,4014
"51710000300",1573,173,548,379,465,56,393,12,3599
"51710000400",2100,248,916,111,194,53,312,21,3955
"51710000500",2031,581,197,38,214,38,175,124,3398
"51710000600",2119,148,1503,244,377,80,319,80,4870
"51710000700",1788,171,454,42,87,0,69,55,2666
"51710000800",1334,105,332,111,276,139,256,28,2581
"51710000901",2239,350,834,98,413,98,418,167,4617
"51710000902",673,37,467,0,319,0,141,0,1637
"51710001100",1140,82,490,257,592,259,211,0,3031
"51710001200",2463,340,763,191,288,12,379,8,4444
"51710001300",970,90,718,329,318,0,204,21,2650
"51710001400",1577,216,347,168,392,18,265,0,2983
"51710001500",1066,74,659,119,127,44,111,0,2200
"51710001600",182,55,1189,335,148,17,56,0,1982
"51710001700",1287,86,607,294,150,29,157,29,2639
"51710002000",1042,52,129,8,22,0,69,0,1322
"51710002100",1096,147,128,18,64,8,13,38,1512
"51710002200",1530,71,192,0,101,0,21,0,1915
"51710002300",1743,231,6,0,172,41,40,0,2233
"51710002400",2958,256,57,57,158,10,134,0,3630
"51710002500",251,756,761,402,71,75,55,65,2436
"51710002600",694,936,286,576,279,226,34,168,3199
"51710002700",223,48,1612,915,203,19,63,11,3094
"51710002800",2481,278,934,110,396,36,455,48,4738
"51710002900",317,223,2338,603,155,88,73,21,3818
"51710003000",1124,153,444,141,80,12,94,11,2059
"51710003100",719,32,1228,582,367,82,126,91,3227
"51710003200",423,114,1593,395,151,39,89,19,2823
"51710003300",370,17,2015,274,0,0,42,4,2722
"51710003400",186,44,1258,914,7,33,65,8,2515
"51710003501",83,20,1791,876,156,96,0,69,3091
"51710003600",1004,65,137,37,108,13,53,5,1422
"51710003700",1362,284,157,71,183,61,31,0,2149
"51710003800",2072,269,82,27,120,0,58,0,2628
"51710004001",1054,27,54,0,79,19,25,5,1263
"51710004002",2439,371,42,83,252,195,68,10,3460
"51710004100",0,63,518,1253,0,49,0,91,1974
"51710004200",0,0,513,1049,0,0,0,0,1562
"51710004300",59,24,1300,1449,133,72,32,17,3086
"51710004400",111,0,1112,230,66,0,35,43,1597
"51710004500",8,0,1473,179,78,20,19,8,1785
"51710004600",112,48,1059,768,104,0,1,0,2092
"51710004700",29,6,394,73,6,10,24,0,542
"51710004800",0,1,147,1156,0,0,0,46,1350
"51710004900",2340,286,189,189,232,17,132,0,3385
"51710005000",28,0,2203,983,0,60,17,22,3313
"51710005100",178,95,2355,1657,521,90,132,70,5098
"51710005500",1446,331,1090,291,334,360,572,448,4872
"51710005601",3228,143,291,354,258,85,159,30,4548
"51710005602",1959,177,689,184,98,99,116,24,3346
"51710005701",1132,373,2191,961,597,9,763,9,6035
"51710005702",522,33,1670,189,64,31,92,11,2612
"51710005800",575,103,3026,895,158,80,332,70,5239
"51710005901",1148,82,2502,717,709,96,728,64,6046
"51710005902",1306,122,1174,360,620,53,127,0,3762
"51710005903",639,22,656,159,295,11,91,0,1873
"51710006000",1563,631,1037,216,267,11,303,9,4037
"51710006100",2751,871,3092,514,342,118,551,149,8388
"51710006200",1334,127,872,194,233,21,69,30,2880
"51710006400",760,42,2197,636,193,72,155,0,4055
"51710006501",1337,525,594,446,239,67,190,72,3470
"51710006502",1905,263,290,412,167,57,106,0,3200
"51710006601",434,11,403,186,32,0,8,0,1074
"51710006602",2081,150,31,4,210,0,101,0,2577
"51710006603",1756,170,283,83,269,21,161,12,2755
"51710006604",960,159,393,204,339,152,166,98,2471
"51710006605",1372,90,823,0,304,128,213,0,2930
"51710006606",1923,318,1138,292,356,20,119,79,4245
"51710006607",1391,135,796,17,511,49,124,11,3034
"51710006800",886,150,463,92,286,6,167,66,2116
"51710006901",698,369,1845,201,509,132,275,202,4231
"51710006902",1176,216,311,268,287,49,126,32,2465
"51710007001",331,141,1063,71,184,3,14,14,1821
"51710007002",1061,102,2032,178,237,237,170,63,4080
"51710980100",0,0,0,0,0,0,0,0,0
"51710980200",0,0,0,0,0,0,0,0,0
"51710980300",0,0,0,0,0,0,0,0,0
"51710990000",0,0,0,0,0,0,0,0,0
"51720960100",3016,555,279,0,80,32,80,0,4042
"51730810100",77,86,1332,1256,62,55,5,18,2891
"51730810300",509,6,1197,702,210,36,123,36,2819
"51730810400",15,29,784,305,73,14,11,14,1245
"51730810500",311,98,2441,1654,28,58,73,14,4677
"51730810600",8,18,940,474,61,51,0,19,1571
"51730810700",105,130,1292,624,11,13,82,32,2289
"51730810900",503,143,2173,463,133,26,44,86,3571
"51730811000",1235,53,1960,697,85,0,181,0,4211
"51730811100",730,69,1822,66,109,0,50,0,2846
"51730811200",809,131,2163,667,261,82,336,68,4517
"51730811300",390,103,1079,605,61,0,79,0,2317
"51735340100",3247,121,54,0,168,0,92,0,3682
"51735340200",4648,410,28,0,118,105,103,0,5412
"51735340300",2855,117,0,0,181,0,62,0,3215
"51735990100",0,0,0,0,0,0,0,0,0
"51740210200",1311,170,342,188,81,15,8,5,2120
"51740210300",1245,162,994,0,103,0,124,0,2628
"51740210400",1137,53,160,117,30,18,74,0,1589
"51740210500",80,6,943,868,49,8,62,5,2021
"51740210600",943,67,340,127,106,23,176,0,1782
"51740210900",1539,218,577,211,82,5,88,34,2754
"51740211100",5,72,1082,453,0,114,0,0,1726
"51740211400",4,0,1217,335,80,0,4,0,1640
"51740211500",669,104,615,315,40,51,0,50,1844
"51740211600",2856,263,526,100,278,0,294,0,4317
"51740211700",207,42,2311,239,5,100,32,23,2959
"51740211800",67,19,1082,2447,58,22,0,22,3717
"51740211900",43,0,1310,391,68,0,0,0,1812
"51740212000",10,1,1209,779,57,8,0,8,2072
"51740212100",14,9,631,556,11,0,0,0,1221
"51740212300",1957,330,1590,925,185,72,82,46,5187
"51740212400",1350,20,1390,860,223,46,118,46,4053
"51740212500",1355,101,339,126,171,147,104,106,2449
"51740212600",567,26,347,37,45,11,0,0,1033
"51740212701",28,0,4259,690,109,8,97,0,5191
"51740212702",99,13,2294,682,0,140,0,36,3264
"51740212801",1983,357,1323,208,101,69,94,0,4135
"51740212802",2020,138,383,21,85,0,47,11,2705
"51740212900",3962,415,328,0,195,31,38,0,4969
"51740213001",3371,73,1732,16,686,5,530,0,6413
"51740213002",3322,163,700,75,205,0,118,0,4583
"51740213101",689,91,3162,865,454,64,102,64,5491
"51740213103",2762,239,2269,237,629,10,278,75,6499
"51740213104",821,24,2307,630,249,21,38,0,4090
"51740213200",539,20,769,177,81,27,40,23,1676
"51740980100",0,0,0,0,0,0,0,0,0
"51750010101",1890,2192,119,228,91,57,58,17,4652
"51750010102",848,1646,0,52,31,120,1,87,2785
"51750010200",4619,1102,537,128,332,28,160,0,6906
"51760010200",2827,222,622,140,259,10,36,0,4116
"51760010300",35,51,1068,434,7,0,15,0,1610
"51760010401",1772,100,861,421,144,2,5,0,3305
"51760010402",1641,165,706,231,97,4,68,0,2912
"51760010500",253,4,1030,88,71,9,22,0,1477
"51760010600",278,44,1255,212,92,3,0,0,1884
"51760010700",89,0,1874,515,6,5,19,0,2508
"51760010800",187,143,2783,971,106,11,7,0,4208
"51760010900",169,92,1765,619,113,21,0,0,2779
"51760011000",84,29,1237,516,10,77,0,0,1953
"51760011100",228,235,1264,537,127,27,9,41,2468
"51760020100",4,31,610,973,0,0,0,0,1618
"51760020200",0,236,1391,2668,3,27,0,108,4433
"51760020300",84,23,922,723,0,3,0,3,1758
"51760020400",0,0,1605,1948,0,35,17,0,3605
"51760020500",1942,464,611,170,308,258,64,41,3858
"51760020600",794,61,466,54,67,13,23,0,1478
"51760020700",218,73,430,403,0,49,0,3,1176
"51760020800",816,72,266,85,125,10,36,0,1410
"51760020900",351,203,2423,209,20,56,5,21,3288
"51760021000",382,55,649,483,15,0,28,0,1612
"51760021100",171,37,790,405,45,0,62,0,1510
"51760021200",139,66,1176,262,20,0,0,0,1663
"51760030100",0,40,819,1794,48,180,0,58,2939
"51760030200",643,524,376,148,102,47,3,9,1852
"51760030500",861,547,439,259,333,342,0,50,2831
"51760040200",1088,753,613,416,148,166,95,138,3417
"51760040300",281,217,48,40,30,140,12,92,860
"51760040400",1339,1197,226,353,32,106,0,124,3377
"51760040500",2380,429,185,105,115,9,104,40,3367
"51760040600",1128,282,97,82,80,41,14,0,1724
"51760040700",2112,226,190,80,160,62,139,34,3003
"51760040800",1280,281,70,24,25,4,77,40,1801
"51760040900",2001,311,230,45,237,28,43,0,2895
"51760041000",2399,273,21,35,165,0,55,8,2956
"51760041100",2378,970,392,253,97,83,126,16,4315
"51760041200",820,266,26,27,52,113,27,25,1356
"51760041300",454,223,1502,747,102,159,0,0,3187
"51760041400",681,84,883,182,57,26,29,0,1942
"51760041600",723,61,607,50,25,8,14,2,1490
"51760050100",2342,251,247,49,26,0,42,14,2971
"51760050200",2660,144,7,0,135,0,32,0,2978
"51760050300",1242,71,4,0,130,0,4,9,1460
"51760050400",2476,104,143,0,96,13,68,46,2946
"51760050500",2363,151,0,0,89,0,22,0,2625
"51760050600",2421,59,15,0,101,8,12,8,2624
"51760060200",121,132,1345,605,21,0,38,132,2394
"51760060400",553,267,2691,1499,112,298,104,0,5524
"51760060500",2908,208,1632,891,462,2,64,44,6211
"51760060600",2043,70,268,102,32,28,79,0,2622
"51760060700",227,156,2499,2449,207,45,146,60,5789
"51760060800",620,71,1332,914,284,20,536,91,3868
"51760060900",448,265,447,182,186,43,441,164,2176
"51760061000",898,155,1490,946,168,23,105,0,3785
"51760070100",3435,178,965,23,300,0,76,0,4977
"51760070300",1739,162,912,144,101,91,327,208,3684
"51760070400",2865,164,654,34,83,18,67,1,3886
"51760070601",1287,1524,1672,488,715,683,1603,1904,9876
"51760070602",378,98,1151,457,429,5,556,67,3141
"51760070700",1163,250,2595,506,209,197,832,363,6115
"51760070801",963,520,3898,1915,401,248,608,294,8847
"51760070802",854,58,1145,598,337,25,385,0,3402
"51760070900",1196,471,3873,1067,297,178,307,267,7656
"51760071001",632,182,2655,768,711,84,168,89,5289
"51760071002",763,74,1872,397,212,170,280,112,3880
"51760071100",2416,92,1812,257,305,17,33,0,4932
"51770000100",765,115,1960,599,272,36,162,13,3922
"51770000300",2911,484,928,106,311,19,606,196,5561
"51770000400",3602,503,345,75,60,16,249,192,5042
"51770000500",2507,444,917,282,223,376,446,21,5216
"51770000601",3629,753,299,82,289,0,242,0,5294
"51770000602",2813,161,170,41,726,18,775,24,4728
"51770000900",896,564,2611,1730,28,33,0,54,5916
"51770001000",393,295,719,594,175,68,186,23,2453
"51770001100",694,59,34,6,41,7,19,13,873
"51770001200",1899,555,149,234,131,110,135,0,3213
"51770001800",2961,448,212,141,159,85,7,22,4035
"51770001900",3258,521,406,164,243,348,87,317,5344
"51770002100",2585,349,110,65,54,28,17,0,3208
"51770002200",1488,119,845,31,223,7,32,7,2752
"51770002300",2043,684,2579,1055,637,366,121,503,7988
"51770002400",189,53,1921,1004,30,199,10,2,3408
"51770002500",309,599,2615,1506,283,164,180,89,5745
"51770002600",926,718,143,483,81,83,10,42,2486
"51770002700",3274,1203,178,129,69,74,73,74,5074
"51770002800",4101,753,89,159,353,66,104,15,5640
"51770002900",4763,438,123,20,48,0,72,0,5464
"51770003000",2999,181,414,59,76,105,35,0,3869
"51770003100",3343,279,283,0,209,6,322,31,4473
"51775010100",4147,497,707,343,0,32,62,0,5788
"51775010200",4413,419,55,35,110,11,18,0,5061
"51775010300",2587,597,363,147,61,28,56,0,3839
"51775010501",2880,250,96,8,461,11,382,67,4155
"51775010502",4235,313,86,0,246,0,51,18,4949
"51790000100",934,180,78,17,58,28,163,7,1465
"51790000200",2064,817,489,126,82,42,104,0,3724
"51790000300",3691,872,253,263,105,108,72,0,5364
"51790000400",5221,652,462,120,488,0,80,42,7065
"51790000500",1530,286,100,10,9,0,8,0,1943
"51790000600",2839,422,298,219,23,11,15,13,3840
"51800065100",195,36,1161,797,76,41,0,0,2306
"51800065200",1413,174,529,71,129,38,122,10,2486
"51800065300",1328,52,1337,568,87,0,140,23,3535
"51800065400",204,33,2262,1115,87,173,31,0,3905
"51800065500",49,19,1659,957,57,0,17,0,2758
"51800075101",2804,20,3567,116,636,86,358,41,7628
"51800075102",2919,57,772,0,175,0,112,0,4035
"51800075201",3678,90,777,0,201,0,91,0,4837
"51800075202",777,0,413,0,20,0,0,0,1210
"51800075203",2180,0,1069,0,274,133,348,133,4137
"51800075204",1647,124,2547,145,457,56,208,16,5200
"51800075301",1699,88,168,15,112,13,110,13,2218
"51800075302",1525,105,244,219,60,112,21,12,2298
"51800075401",1112,58,338,70,131,0,149,22,1880
"51800075402",2106,103,1535,113,260,0,279,0,4396
"51800075403",1837,98,1866,113,303,37,189,0,4443
"51800075404",868,13,90,0,0,0,0,0,971
"51800075405",1996,31,145,7,13,0,11,0,2203
"51800075501",2002,186,1526,754,240,27,58,0,4793
"51800075502",2217,48,1592,177,256,80,101,0,4471
"51800075601",429,19,2183,718,32,127,26,0,3534
"51800075602",1241,45,113,26,89,51,23,0,1588
"51800075701",780,26,513,217,28,0,4,0,1568
"51800075702",2392,251,783,14,36,0,79,7,3562
"51800075703",886,59,392,7,0,0,0,0,1344
"51800075801",2233,71,430,64,74,0,16,0,2888
"51800075802",807,90,713,26,25,16,0,0,1677
"51800075803",897,122,191,84,49,0,35,0,1378
"51810040000",765,99,295,11,212,27,127,19,1555
"51810040200",1085,404,2024,519,258,193,445,352,5280
"51810040402",2206,262,3484,755,544,95,276,61,7683
"51810040403",2159,189,696,82,346,122,485,54,4133
"51810040404",4373,180,1332,0,736,141,441,0,7203
"51810040600",1666,372,2248,963,665,194,592,134,6834
"51810040801",2861,131,840,74,285,53,314,11,4569
"51810040802",2344,253,923,275,621,41,277,81,4815
"51810041002",1320,178,178,9,198,147,236,99,2365
"51810041003",2277,181,481,13,381,24,305,0,3662
"51810041004",2644,281,539,164,574,23,409,79,4713
"51810041200",5180,115,282,0,382,0,192,27,6178
"51810041400",3951,164,463,26,549,17,246,93,5509
"51810041600",2354,78,482,2,462,26,170,9,3583
"51810041801",3098,468,575,279,462,151,223,123,5379
"51810041802",4904,166,113,0,263,12,290,0,5748
"51810042000",3186,64,68,0,120,0,62,0,3500
"51810042201",3165,120,79,0,167,12,94,0,3637
"51810042202",4039,177,124,2,325,0,22,0,4689
"51810042400",3536,386,627,25,200,44,105,12,4935
"51810042600",1835,107,300,99,122,0,47,0,2510
"51810042801",4282,310,991,32,536,8,636,8,6803
"51810042802",2285,292,1295,103,583,72,481,46,5157
"51810043002",3834,61,69,0,203,10,218,38,4433
"51810043003",3943,155,236,0,111,0,15,0,4460
"51810043004",3720,219,31,0,37,12,54,0,4073
"51810043200",684,49,227,29,114,18,94,46,1261
"51810043400",1781,19,0,0,50,0,0,0,1850
"51810043600",1568,64,0,0,31,0,14,0,1677
"51810043800",3287,224,103,20,153,0,43,0,3830
"51810044001",4398,213,1012,86,309,0,310,11,6339
"51810044003",4671,341,148,0,286,0,47,14,5507
"51810044004",1464,203,261,21,342,0,84,0,2375
"51810044200",2819,760,1137,926,555,191,359,330,7077
"51810044401",3234,34,0,0,191,0,185,0,3644
"51810044402",4589,177,392,0,314,70,205,0,5747
"51810044600",5415,129,0,0,85,0,326,0,5955
"51810044805",2217,188,528,148,381,15,519,39,4035
"51810044806",1126,441,1011,184,276,305,253,72,3668
"51810044807",2998,525,758,798,587,0,195,194,6055
"51810044808",2737,191,274,233,449,59,439,36,4418
"51810045000",47,40,23,0,0,0,0,0,110
"51810045200",1846,101,380,50,101,33,220,0,2731
"51810045405",2271,128,947,254,1099,46,578,11,5334
"51810045406",3504,301,2636,84,2304,293,883,203,10208
"51810045407",2870,187,856,37,563,115,133,115,4876
"51810045408",4116,523,1115,0,923,38,613,93,7421
"51810045412",1483,64,11,6,196,0,10,0,1770
"51810045414",2656,251,1060,665,516,213,378,321,6060
"51810045415",1421,96,364,7,95,0,15,0,1998
"51810045417",7026,115,534,0,1105,177,311,0,9268
"51810045420",4216,266,210,0,356,0,115,0,5163
"51810045421",2456,67,510,0,376,5,257,0,3671
"51810045422",3301,68,966,38,711,0,749,36,5869
"51810045423",5288,312,970,3,1004,12,281,11,7881
"51810045424",3839,62,246,8,654,0,147,0,4956
"51810045425",2545,148,122,1,159,3,289,24,3291
"51810045426",5100,314,550,0,561,0,354,0,6879
"51810045427",4520,414,859,282,375,255,138,306,7149
"51810045428",1214,112,0,21,73,0,67,0,1487
"51810045601",2373,24,166,28,211,0,105,0,2907
"51810045603",1182,50,359,4,104,11,168,11,1889
"51810045604",3568,299,978,574,994,63,668,36,7180
"51810045801",2674,131,619,66,805,54,476,0,4825
"51810045803",1960,68,740,0,297,0,162,0,3227
"51810045805",857,187,183,0,139,2,136,24,1528
"51810045806",2357,191,747,230,516,57,525,29,4652
"51810045807",885,125,352,4,133,16,177,70,1762
"51810045808",1444,102,523,94,433,0,95,63,2754
"51810045809",3115,188,1451,298,1398,273,512,193,7428
"51810045810",628,115,570,711,182,58,149,34,2447
"51810046002",3551,207,499,0,355,135,117,8,4872
"51810046005",3895,383,1281,333,852,0,365,24,7133
"51810046006",3671,100,341,79,435,30,48,72,4776
"51810046009",3752,18,704,100,329,17,357,47,5324
"51810046010",1690,17,497,134,437,21,187,64,3047
"51810046011",967,52,182,68,204,5,110,0,1588
"51810046012",3880,376,2704,84,875,63,676,70,8728
"51810046013",1641,172,1233,161,1009,293,376,72,4957
"51810046014",2022,233,1290,237,1283,27,426,122,5640
"51810046015",3334,106,1172,102,769,48,394,0,5925
"51810046016",2318,0,489,66,815,0,164,41,3893
"51810046204",3983,72,257,0,236,0,154,9,4711
"51810046206",3217,107,768,84,1041,157,161,1,5536
"51810046207",3394,520,1237,107,717,31,470,76,6552
"51810046211",2279,179,363,10,378,25,314,0,3548
"51810046212",2857,121,396,68,618,0,88,15,4163
"51810046213",3227,345,1442,50,934,228,537,0,6763
"51810046214",2641,160,1311,1,962,8,250,0,5333
"51810046216",3200,77,1397,14,1411,177,346,28,6650
"51810046217",2367,224,1136,44,1369,0,424,22,5586
"51810046219",1598,29,970,14,1404,66,252,66,4399
"51810046220",1895,342,1775,407,549,90,275,73,5406
"51810046221",1195,70,1938,311,370,43,368,0,4295
"51810046222",3276,158,635,23,762,78,243,0,5175
"51810046223",1975,13,346,14,378,5,70,0,2801
"51810046224",1996,279,1187,27,1142,7,316,34,4988
"51810046225",2569,115,886,1,675,113,261,77,4697
"51810046400",4505,223,208,7,116,0,145,0,5204
"51810990100",0,0,0,0,0,0,0,0,0
"51820003100",607,329,82,147,76,0,47,34,1322
"51820003200",2899,773,581,129,329,48,155,1,4915
"51820003300",2496,952,660,506,167,232,95,380,5488
"51820003400",4219,546,90,75,406,0,345,1,5682
"51820003500",3584,366,248,37,91,189,147,188,4850
"51830370100",2657,697,153,64,149,45,171,74,4010
"51830370200",1628,251,541,382,190,99,325,110,3526
"51830370300",1961,424,599,91,182,27,41,0,3325
"51840000100",4067,1174,755,335,516,206,1611,556,9220
"51840000201",3100,245,82,78,202,29,349,23,4108
"51840000202",4081,474,439,0,434,35,308,12,5783
"51840000301",2712,582,446,83,301,56,315,333,4828
"51840000302",3799,687,431,23,537,41,593,55,6166
"53001950100",2099,266,0,0,51,37,52,51,2556
"53001950200",1279,299,0,0,69,73,71,98,1889
"53001950300",2776,1095,0,0,2582,421,3993,1315,12182
"53001950400",1585,415,0,0,460,398,1367,710,4935
"53001950500",1958,834,11,0,1458,510,2511,1289,8571
"53003960100",3338,360,0,0,334,116,42,16,4206
"53003960200",4136,300,17,0,163,0,72,0,4688
"53003960300",2362,527,7,28,146,17,26,17,3130
"53003960400",1800,394,28,0,43,77,3,137,2482
"53003960500",2753,817,0,0,79,161,98,187,4095
"53003960600",3028,491,0,0,68,22,77,25,3711
"53005010100",3602,301,0,0,379,2,73,43,4400
"53005010201",3948,275,165,0,440,40,276,48,5192
"53005010202",3734,1030,9,0,1180,285,664,505,7407
"53005010300",4626,220,9,59,587,184,420,127,6232
"53005010400",2437,369,74,0,398,192,254,56,3780
"53005010500",2506,304,0,40,440,70,229,83,3672
"53005010600",2849,453,5,0,626,25,456,17,4431
"53005010701",1827,67,16,0,135,0,146,0,2191
"53005010703",2276,497,10,0,282,209,309,123,3706
"53005010705",4900,164,28,0,144,0,398,0,5634
"53005010707",2534,77,8,0,181,0,111,0,2911
"53005010708",1916,110,14,0,221,98,278,81,2718
"53005010803",6116,155,78,0,820,171,661,158,8159
"53005010805",4396,447,262,0,646,83,248,28,6110
"53005010807",1078,131,0,0,33,0,116,8,1366
"53005010809",5339,452,18,0,589,215,613,361,7587
"53005010810",4747,202,20,0,257,29,181,0,5436
"53005010811",2859,61,0,0,297,0,53,0,3270
"53005010813",8537,344,130,0,1240,2,896,12,11161
"53005010814",2721,31,0,0,114,97,154,0,3117
"53005010901",3002,1283,205,28,752,755,430,1110,7565
"53005010902",2626,472,44,45,1297,329,1337,340,6490
"53005011001",2654,882,51,0,824,553,695,695,6354
"53005011002",2569,853,16,0,622,297,625,412,5394
"53005011100",5220,406,89,0,1661,217,1748,298,9639
"53005011200",2488,2135,154,80,1788,1263,2278,1789,11975
"53005011300",2565,754,110,160,1117,448,1761,534,7449
"53005011401",1992,485,11,136,425,203,585,371,4208
"53005011402",4439,144,7,0,718,72,524,62,5966
"53005011501",4779,501,46,0,1423,0,1715,86,8550
"53005011503",7196,310,344,0,978,301,536,345,10010
"53005011504",2496,202,156,0,203,114,339,114,3624
"53005011600",456,19,0,0,300,51,345,51,1222
"53005011700",5060,385,0,0,1488,338,2242,407,9920
"53005011800",4747,870,45,2,765,933,2053,1285,10700
"53005011900",3408,671,27,0,1112,484,1146,584,7432
"53005012000",23,0,0,0,0,0,0,0,23
"53007960100",1845,307,0,0,68,44,165,112,2541
"53007960200",4942,986,0,0,228,151,413,192,6912
"53007960300",4846,1244,0,0,398,575,1583,1043,9689
"53007960400",2750,431,42,10,112,123,1268,134,4870
"53007960500",4922,1014,31,0,529,0,1363,81,7940
"53007960600",3448,496,12,0,321,17,1088,234,5616
"53007960700",3242,91,13,11,67,78,129,64,3695
"53007960801",2529,213,8,0,41,2,110,143,3046
"53007960802",5159,1472,0,0,549,42,1069,458,8749
"53007961000",4814,600,0,0,376,122,2067,296,8275
"53007961100",7109,1608,0,10,1215,245,4157,1092,15436
"53007961200",3597,348,18,0,205,0,855,87,5110
"53007961301",878,25,72,0,215,2,166,0,1358
"53007961302",6334,503,7,0,1147,25,1090,153,9259
"53009000200",556,202,0,15,17,54,13,101,958
"53009000300",3206,663,54,1,391,232,474,236,5257
"53009000400",848,126,0,0,374,136,84,16,1584
"53009000600",2454,420,0,0,223,135,132,29,3393
"53009000700",2704,1081,32,0,121,81,242,40,4301
"53009000800",3108,535,18,52,256,91,140,36,4236
"53009000900",2134,275,0,8,70,193,189,33,2902
"53009001000",1680,414,0,0,174,24,45,23,2360
"53009001100",2282,251,52,161,103,132,40,37,3058
"53009001200",2717,454,10,0,229,53,70,15,3548
"53009001300",2895,350,0,8,93,14,94,0,3454
"53009001400",3586,413,0,0,397,137,57,54,4644
"53009001500",1340,273,0,0,433,294,53,6,2399
"53009001600",2844,321,0,0,125,14,104,14,3422
"53009001700",3836,435,0,0,179,15,52,26,4543
"53009001800",2024,357,0,0,106,112,27,99,2725
"53009001900",5017,258,0,0,326,49,208,0,5858
"53009002000",4659,436,65,0,402,0,169,0,5731
"53009002100",2501,536,0,16,289,64,533,40,3979
"53009002300",3451,446,55,1,165,35,141,21,4315
"53009940000",189,13,0,0,1128,265,123,17,1735
"53009990100",0,0,0,0,0,0,0,0,0
"53011040101",4253,505,15,0,120,49,65,12,5019
"53011040102",3257,211,12,0,0,20,55,10,3565
"53011040201",4634,321,35,0,444,20,237,7,5698
"53011040202",3403,222,50,5,258,22,29,2,3991
"53011040203",4593,252,0,0,357,0,118,9,5329
"53011040301",1365,18,0,0,79,57,86,0,1605
"53011040302",5722,349,41,0,440,0,449,1,7002
"53011040403",3150,141,0,0,205,35,10,48,3589
"53011040407",3918,842,25,0,255,31,382,27,5480
"53011040408",3063,214,0,13,121,7,124,17,3559
"53011040409",1614,75,22,0,10,0,97,0,1818
"53011040411",1552,151,0,0,97,18,15,72,1905
"53011040412",3519,369,84,0,456,9,139,88,4664
"53011040413",2585,182,8,0,107,61,38,37,3018
"53011040414",5295,410,113,0,424,14,214,0,6470
"53011040415",3255,589,31,0,154,0,162,240,4431
"53011040416",2912,332,0,0,182,0,107,0,3533
"53011040504",4375,585,45,16,126,0,27,0,5174
"53011040505",5430,240,0,7,244,32,134,0,6087
"53011040507",1818,253,0,0,125,144,112,133,2585
"53011040508",5870,213,72,26,335,0,128,0,6644
"53011040509",2151,730,0,0,197,106,103,88,3375
"53011040510",4419,276,0,0,192,33,60,15,4995
"53011040511",1947,189,0,0,210,0,24,54,2424
"53011040603",4054,288,69,0,238,27,263,10,4949
"53011040604",4384,696,113,2,571,178,539,113,6596
"53011040605",4279,135,179,0,286,14,164,0,5057
"53011040608",3344,46,183,0,517,47,204,0,4341
"53011040609",3752,110,0,0,986,11,257,0,5116
"53011040610",2970,63,108,0,358,0,45,0,3544
"53011040703",5251,731,218,0,768,0,381,155,7504
"53011040706",2727,401,0,50,205,188,144,83,3798
"53011040707",2955,159,0,0,140,0,133,5,3392
"53011040709",3590,165,176,28,369,39,306,0,4673
"53011040710",4744,155,48,0,386,45,605,45,6028
"53011040711",2582,312,138,103,384,150,198,267,4134
"53011040712",4024,263,38,31,1233,123,110,121,5943
"53011040803",3995,183,13,0,815,566,395,650,6617
"53011040805",4523,753,53,0,539,18,406,244,6536
"53011040806",4180,313,24,21,617,33,193,10,5391
"53011040808",1378,224,15,0,53,38,66,76,1850
"53011040809",4245,378,64,0,834,297,956,232,7006
"53011040810",1995,196,45,0,261,0,106,0,2603
"53011040904",4419,1023,0,0,283,442,265,289,6721
"53011040905",2667,103,15,0,44,58,77,41,3005
"53011040907",3999,141,81,0,478,10,95,0,4804
"53011040908",5657,215,31,0,380,50,471,0,6804
"53011040909",4538,321,79,0,440,35,464,0,5877
"53011040910",3689,151,0,0,280,96,4,11,4231
"53011041003",3290,340,18,3,203,119,88,57,4118
"53011041005",1051,507,81,0,357,669,326,702,3693
"53011041007",2573,228,36,150,70,380,56,417,3910
"53011041008",3178,171,43,1,387,10,59,0,3849
"53011041009",3104,331,11,11,201,45,342,25,4070
"53011041010",2661,492,25,133,300,109,390,82,4192
"53011041011",2601,83,0,0,385,34,157,0,3260
"53011041104",2418,1033,63,101,393,166,129,137,4440
"53011041105",3812,341,161,0,775,30,320,2,5441
"53011041107",2105,61,2,0,314,44,120,0,2646
"53011041108",4893,528,146,0,727,115,224,55,6688
"53011041110",4067,511,0,0,993,44,629,0,6244
"53011041111",1479,862,106,20,738,111,585,606,4507
"53011041112",3604,649,71,146,725,32,409,20,5656
"53011041201",4242,674,360,0,900,121,521,18,6836
"53011041203",3140,364,388,48,912,127,511,79,5569
"53011041205",2858,534,17,0,930,314,569,29,5251
"53011041206",3706,158,139,130,511,71,316,0,5031
"53011041309",3892,369,41,20,702,290,619,226,6159
"53011041310",3779,298,112,0,519,90,246,0,5044
"53011041312",2529,438,78,158,622,251,342,260,4678
"53011041313",1276,522,62,15,462,144,325,119,2925
"53011041317",2865,334,135,37,550,7,322,14,4264
"53011041318",3446,614,0,76,776,36,407,0,5355
"53011041319",3997,453,96,61,727,310,224,233,6101
"53011041320",4710,476,259,0,1265,36,325,21,7092
"53011041321",2464,84,19,0,361,82,234,0,3244
"53011041322",3050,624,125,21,520,98,671,118,5227
"53011041323",3645,548,44,209,558,137,327,96,5564
"53011041325",3650,107,117,0,1069,85,284,14,5326
"53011041326",1768,221,26,98,331,124,284,111,2963
"53011041327",5543,884,240,0,1508,417,358,204,9154
"53011041328",4196,199,0,0,1056,85,260,15,5811
"53011041329",3110,213,31,0,820,53,531,0,4758
"53011041330",3421,343,37,0,628,48,413,59,4949
"53011041331",1909,294,64,71,689,13,418,34,3492
"53011041332",2231,461,54,0,987,173,590,310,4806
"53011041333",2395,164,67,0,392,13,67,0,3098
"53011041400",4247,563,7,0,444,8,212,0,5481
"53011041500",2149,328,0,0,55,28,90,0,2650
"53011041600",1786,809,44,37,445,113,276,75,3585
"53011041700",1884,831,58,27,404,228,167,154,3753
"53011041800",2144,644,40,7,661,65,288,77,3926
"53011041900",1374,108,151,105,162,43,58,36,2037
"53011042000",1413,166,23,0,99,12,122,0,1835
"53011042100",2270,181,30,8,326,69,270,18,3172
"53011042300",1779,927,34,27,107,114,86,40,3114
"53011042400",922,311,0,22,54,28,32,6,1375
"53011042500",799,105,14,121,92,23,27,0,1181
"53011042600",3320,929,121,0,422,340,168,230,5530
"53011042700",1933,1343,50,19,974,493,731,631,6174
"53011042800",2396,357,116,21,215,10,328,65,3508
"53011042900",743,316,51,0,268,49,138,55,1620
"53011043000",1233,199,56,10,262,6,235,6,2007
"53011043100",3062,352,41,11,371,74,190,154,4255
"53013960200",3097,564,0,0,166,126,164,82,4199
"53015000300",191,225,21,0,9,54,100,38,638
"53015000400",2837,249,15,0,187,55,365,25,3733
"53015000501",2065,439,0,0,265,121,79,37,3006
"53015000502",2332,1963,8,35,371,356,597,398,6060
"53015000601",2118,1002,17,0,357,87,77,184,3842
"53015000602",2452,355,11,0,273,25,183,0,3299
"53015000702",2657,183,0,0,145,23,52,6,3066
"53015000703",930,366,0,0,115,38,71,120,1640
"53015000704",5089,1295,10,0,475,98,281,255,7503
"53015000800",5805,471,0,0,406,8,91,8,6789
"53015000900",5697,562,14,24,549,246,463,10,7565
"53015001000",639,487,0,0,42,43,160,151,1522
"53015001100",2956,2160,176,0,280,134,285,657,6648
"53015001200",3327,438,22,0,165,49,220,44,4265
"53015001300",2371,726,39,0,399,174,471,81,4261
"53015001501",2592,248,0,0,16,15,39,41,2951
"53015001502",5168,1313,0,9,374,273,560,579,8276
"53015001600",5839,682,0,0,297,0,320,0,7138
"53015001700",4377,432,0,0,225,29,245,8,5316
"53015001800",1667,141,0,0,103,41,41,0,1993
"53015001900",4337,616,41,39,11,50,172,0,5266
"53015002001",3170,268,0,0,223,26,57,8,3752
"53015002002",5209,432,0,7,461,46,113,78,6346
"53015002100",1775,899,0,60,409,394,192,215,3944
"53017950100",2814,451,0,41,2134,718,2479,946,9583
"53017950200",2092,442,0,17,169,171,41,54,2986
"53017950300",3637,375,0,0,950,803,1303,965,8033
"53017950400",5354,354,36,1,728,298,1002,331,8104
"53017950500",2149,243,0,0,498,135,628,51,3704
"53017950600",3454,129,19,0,895,28,795,15,5335
"53017950700",2834,650,0,0,854,447,901,555,6241
"53017950800",3250,410,8,15,951,369,1059,412,6474
"53019940000",286,100,0,0,855,368,33,23,1665
"53019970100",1751,459,1,10,110,195,81,86,2693
"53019970200",2629,517,8,0,183,71,32,7,3447
"53021020100",3795,938,11,80,4107,1092,6638,2007,18668
"53021020200",2258,1240,0,40,1790,903,3047,1887,11165
"53021020300",2086,710,106,10,1932,739,3154,1254,9991
"53021020400",3064,1553,152,134,2149,2064,3879,3088,16083
"53021020501",3921,319,90,0,361,0,719,178,5588
"53021020502",6776,645,190,0,1273,30,1592,260,10766
"53021020601",6802,675,29,0,1366,196,2447,318,11833
"53021020603",1872,196,24,151,539,1304,664,1301,6051
"53021020605",6907,299,62,0,863,95,3021,99,11346
"53021020606",4868,147,132,96,1632,632,2121,511,10139
"53021020700",1080,82,5,0,246,0,285,0,1698
"53021020800",4055,532,70,0,1669,1262,2849,1526,11963
"53021980100",0,0,0,0,0,0,0,0,0
"53023970300",1876,225,0,0,51,49,29,87,2317
"53025010100",2982,471,0,17,389,106,150,11,4126
"53025010200",2090,261,4,0,196,14,191,79,2835
"53025010300",2743,645,13,1,367,207,303,186,4465
"53025010400",5193,1085,0,0,1012,435,1104,356,9185
"53025010500",1807,103,18,8,949,600,1074,613,5172
"53025010600",2654,822,8,0,2397,1112,3624,1811,12428
"53025010700",1640,150,0,1,885,290,928,336,4230
"53025010800",2106,975,63,105,769,607,721,797,6143
"53025010901",1070,126,0,0,241,22,249,22,1730
"53025010902",6904,1177,171,100,1640,378,2310,249,12929
"53025011000",7907,1076,30,0,1880,211,2352,767,14223
"53025011100",4656,1122,212,0,556,375,1134,694,8749
"53025011200",4242,178,0,0,388,420,507,441,6176
"53025011300",1904,383,42,18,1163,421,1848,623,6402
"53025011401",1325,88,0,0,657,158,1009,158,3395
"53025011402",4743,1027,0,3,4887,2250,7909,3081,23900
"53027000200",6092,559,58,0,577,124,175,0,7585
"53027000300",2672,354,0,1,256,94,112,88,3577
"53027000400",5747,354,0,0,383,18,346,0,6848
"53027000500",4962,956,12,3,371,158,112,194,6768
"53027000600",2784,580,10,0,145,44,80,34,3677
"53027000700",3282,753,48,0,519,172,103,62,4939
"53027000800",3127,855,13,0,136,55,243,181,4610
"53027000900",3850,907,26,31,730,230,342,184,6300
"53027001000",1771,823,0,14,266,384,292,650,4200
"53027001100",3303,496,6,5,229,67,70,0,4176
"53027001200",3060,656,26,35,500,376,1055,424,6132
"53027001300",2341,705,0,0,190,165,101,374,3876
"53027001400",1217,319,31,39,302,195,98,117,2318
"53027001500",2637,910,0,1,266,149,368,89,4420
"53027001600",2851,837,0,0,193,49,123,154,4207
"53027940000",172,51,0,6,511,332,57,20,1149
"53027990000",0,0,0,0,0,0,0,0,0
"53029970100",2023,255,111,0,178,27,83,40,2717
"53029970200",316,57,29,0,74,16,86,0,578
"53029970300",3745,181,52,0,385,32,25,8,4428
"53029970400",3451,609,221,73,1477,225,429,148,6633
"53029970500",4403,281,35,0,483,219,335,0,5756
"53029970601",2037,293,215,0,857,71,366,33,3872
"53029970602",2282,255,93,17,653,224,454,5,3983
"53029970700",928,224,137,38,454,40,225,34,2080
"53029970800",1876,210,101,24,282,14,153,39,2699
"53029970900",3031,293,333,112,915,133,531,162,5510
"53029971000",3892,506,0,23,516,2,317,79,5335
"53029971100",2648,209,32,0,88,18,130,6,3131
"53029971300",4077,366,0,0,84,167,13,0,4707
"53029971400",3413,233,23,15,200,26,45,1,3956
"53029971500",2884,217,0,0,70,7,84,0,3262
"53029971600",3349,252,5,0,498,5,237,0,4346
"53029971700",3506,167,0,0,271,37,256,48,4285
"53029971800",2206,80,0,0,52,0,53,0,2391
"53029971900",3136,484,51,0,287,47,45,0,4050
"53029972000",3405,522,12,0,146,55,201,0,4341
"53029972100",3167,163,23,0,211,15,125,0,3704
"53029992201",0,0,0,0,0,0,0,0,0
"53031950202",1302,192,0,4,89,9,39,2,1637
"53031950300",5059,366,19,0,339,43,28,0,5854
"53031950400",3347,649,0,0,167,43,107,22,4335
"53031950500",4943,732,0,0,653,20,476,0,6824
"53031950601",4803,672,13,0,594,31,132,0,6245
"53031950602",2653,342,1,81,82,32,21,13,3225
"53031950702",1049,256,0,0,233,194,27,22,1781
"53031990000",0,0,0,0,0,0,0,0,0
"53033000100",3229,701,395,214,1067,739,332,486,7163
"53033000200",4393,478,390,226,1943,364,297,0,8091
"53033000300",1779,265,35,44,435,55,130,95,2838
"53033000401",2840,992,483,284,993,496,224,113,6425
"53033000402",3447,130,327,116,496,100,295,19,4930
"53033000500",2381,133,19,0,411,59,93,0,3096
"53033000600",4615,544,267,166,1538,156,366,257,7909
"53033000700",2595,240,328,0,898,204,285,150,4700
"53033000800",1946,126,2,0,270,89,35,0,2468
"53033000900",1506,54,10,8,297,70,45,0,1990
"53033001000",1042,43,199,239,295,122,92,48,2080
"53033001100",1592,132,107,30,657,167,166,0,2851
"53033001200",2796,1007,179,131,1786,420,454,101,6874
"53033001300",2537,391,137,83,989,193,349,37,4716
"53033001400",4205,211,0,0,543,204,340,95,5598
"53033001500",2272,51,0,0,109,20,110,0,2562
"53033001600",3306,176,6,8,433,118,156,24,4227
"53033001701",2536,198,139,34,1151,56,306,36,4456
"53033001702",3120,332,41,26,709,105,192,94,4619
"53033001800",3318,275,0,20,1018,417,311,348,5707
"53033001900",2858,421,87,54,798,260,163,5,4646
"53033002000",2720,320,2,0,412,18,57,11,3540
"53033002100",2921,182,87,0,756,61,122,19,4148
"53033002200",4504,148,0,9,901,32,245,19,5858
"53033002400",2333,99,23,0,491,23,106,0,3075
"53033002500",2378,132,107,0,286,0,33,9,2945
"53033002600",3831,324,90,26,534,81,93,28,5007
"53033002700",4298,304,102,0,750,134,164,107,5859
"53033002800",3631,335,205,3,257,118,118,12,4679
"53033002900",3580,149,0,2,412,21,188,0,4352
"53033003000",4996,201,33,0,443,138,243,67,6121
"53033003100",5446,387,43,0,455,0,186,16,6533
"53033003200",6638,544,0,13,627,188,268,193,8471
"53033003300",5220,335,72,0,492,93,237,14,6463
"53033003400",3224,123,22,0,370,8,136,0,3883
"53033003500",3133,233,44,2,537,56,241,26,4272
"53033003600",4252,431,58,26,803,382,305,54,6311
"53033003800",1536,153,47,4,310,21,95,0,2166
"53033003900",2408,172,0,0,432,10,93,10,3125
"53033004000",1957,299,42,167,443,117,61,25,3111
"53033004100",6189,492,0,0,1269,117,133,0,8200
"53033004200",6442,434,80,2,1113,279,274,0,8624
"53033004301",2052,367,11,26,719,285,89,17,3566
"53033004302",782,986,46,53,192,588,28,83,2758
"53033004400",2887,1826,112,0,679,468,161,70,6203
"53033004500",1879,495,17,0,371,113,121,0,2996
"53033004600",2656,204,18,0,388,50,118,15,3449
"53033004700",6263,327,117,0,973,193,353,91,8317
"53033004800",3965,279,40,0,280,49,168,0,4781
"53033004900",5385,444,23,32,744,102,222,70,7022
"53033005000",3014,141,43,134,337,62,61,0,3792
"53033005100",2940,170,11,0,546,13,198,11,3889
"53033005200",3243,1092,52,89,823,1401,200,86,6986
"53033005301",907,1070,51,12,648,1661,88,234,4671
"53033005302",42,34,0,0,25,55,0,0,156
"53033005400",3740,336,23,0,641,64,259,76,5139
"53033005600",5531,107,43,0,497,49,76,0,6303
"53033005700",5409,184,0,9,986,36,292,29,6945
"53033005801",3833,246,423,89,505,48,306,0,5450
"53033005802",3827,175,109,0,637,83,208,0,5039
"53033005900",4670,682,30,60,590,111,151,15,6309
"53033006000",3940,471,41,3,681,34,280,0,5450
"53033006100",4319,227,93,2,655,23,175,43,5537
"53033006200",3285,159,64,10,393,46,194,0,4151
"53033006300",4388,168,19,0,426,49,209,31,5290
"53033006400",2776,99,37,6,295,12,118,3,3346
"53033006500",3671,227,19,2,322,16,141,15,4413
"53033006600",2304,160,47,0,753,86,155,23,3528
"53033006700",4981,244,309,44,1060,239,196,26,7099
"53033006800",2490,177,29,0,338,20,46,19,3119
"53033006900",3827,121,31,0,413,50,31,17,4490
"53033007000",5698,300,167,29,968,56,485,0,7703
"53033007100",2249,295,75,54,585,111,121,84,3574
"53033007200",3324,457,171,31,1279,520,252,86,6120
"53033007300",3263,441,125,198,921,263,368,56,5635
"53033007401",3243,465,170,20,857,0,199,43,4997
"53033007402",3102,580,181,202,906,172,202,150,5495
"53033007500",4959,674,228,340,843,342,613,75,8074
"53033007600",2493,268,411,58,498,51,207,49,4035
"53033007700",2840,337,453,271,617,122,79,2,4721
"53033007800",3742,212,444,97,886,152,201,128,5862
"53033007900",3906,604,690,147,578,210,264,39,6438
"53033008001",3657,306,408,269,994,115,180,0,5929
"53033008002",1676,636,121,61,396,105,120,176,3291
"53033008100",2153,635,119,178,624,310,95,89,4203
"53033008200",2293,344,195,18,662,216,244,23,3995
"53033008300",1971,246,46,37,345,74,80,11,2810
"53033008400",2649,384,177,143,738,174,202,15,4482
"53033008500",1205,309,113,265,416,403,244,8,2963
"53033008600",1339,572,143,165,590,439,237,96,3581
"53033008700",1890,309,773,139,1056,190,404,42,4803
"53033008800",2277,176,517,77,478,189,230,24,3968
"53033008900",2202,68,865,160,919,30,218,0,4462
"53033009000",1136,261,458,316,936,282,101,0,3490
"53033009100",355,70,150,465,1183,303,17,11,2554
"53033009200",946,405,116,181,461,446,131,58,2744
"53033009300",948,286,177,147,777,152,216,21,2724
"53033009400",1890,276,191,171,2414,815,365,132,6254
"53033009500",3318,434,1090,133,711,377,210,53,6326
"53033009600",4431,220,67,156,534,59,165,13,5645
"53033009701",4784,305,90,0,698,18,229,0,6124
"53033009702",4749,141,25,49,468,88,191,15,5726
"53033009800",5729,215,30,76,533,108,311,31,7033
"53033009900",3244,315,312,18,970,91,371,1,5322
"53033010001",1236,55,945,163,1449,255,204,0,4307
"53033010002",1920,261,133,30,2094,136,799,134,5507
"53033010100",2586,198,1464,303,1278,449,239,117,6634
"53033010200",2786,196,540,60,802,74,112,21,4591
"53033010300",1749,313,811,730,1780,555,345,123,6406
"53033010401",721,204,593,99,2726,534,42,58,4977
"53033010402",1114,94,561,0,2937,288,426,114,5534
"53033010500",4404,569,78,24,855,133,294,85,6442
"53033010600",6091,429,194,77,867,109,401,25,8193
"53033010701",1316,307,471,571,558,222,133,50,3628
"53033010702",1266,224,600,1076,535,347,234,34,4316
"53033010800",2337,259,205,264,1424,297,124,53,4963
"53033010900",686,168,19,0,188,18,209,18,1306
"53033011001",526,298,696,891,1605,799,120,33,4968
"53033011002",239,52,400,1158,2453,233,87,18,4640
"53033011101",1095,146,903,224,2063,477,314,57,5279
"53033011102",1595,285,305,283,1345,327,221,475,4836
"53033011200",1689,941,80,92,924,396,877,964,5963
"53033011300",3496,383,199,23,2645,154,758,19,7677
"53033011401",2106,359,489,88,785,209,720,249,5005
"53033011402",2406,290,205,302,758,447,783,220,5411
"53033011500",3044,197,112,68,645,72,229,60,4427
"53033011600",5490,256,61,4,728,40,265,0,6844
"53033011700",898,36,1185,539,3262,333,397,45,6695
"53033011800",1947,653,1440,1036,1725,895,800,725,9221
"53033011900",1535,193,1601,232,2948,864,632,0,8005
"53033012000",2670,155,0,0,563,22,134,0,3544
"53033012100",2214,19,47,1,467,51,230,14,3043
"53033020100",2492,189,5,4,391,11,71,0,3163
"53033020200",3861,338,143,54,906,118,272,44,5736
"53033020300",3792,556,289,0,1821,146,659,63,7326
"53033020401",2358,316,230,0,562,51,275,0,3792
"53033020402",4272,241,80,0,630,79,469,5,5776
"53033020500",4020,188,132,105,1397,201,511,40,6594
"53033020600",1918,177,219,0,952,236,211,105,3818
"53033020700",2042,442,83,92,788,235,208,194,4084
"53033020800",3260,261,92,12,536,13,71,31,4276
"53033020900",2621,239,139,24,494,50,307,0,3874
"53033021000",2897,288,816,11,1474,181,343,0,6010
"53033021100",2054,238,241,308,1394,131,498,10,4874
"53033021300",2553,238,159,30,879,92,229,12,4192
"53033021400",3088,300,74,31,416,88,130,0,4127
"53033021500",3595,89,55,63,442,62,99,0,4405
"53033021600",3443,491,143,27,933,19,144,81,5281
"53033021700",5737,458,168,20,1736,276,886,326,9607
"53033021802",3556,463,102,0,1306,100,253,0,5780
"53033021803",3327,391,33,94,494,120,311,81,4851
"53033021804",3486,176,41,9,510,185,309,208,4924
"53033021903",3872,386,65,0,904,74,391,0,5692
"53033021904",3113,131,20,0,1540,287,373,9,5473
"53033021905",3893,203,53,0,954,0,624,0,5727
"53033021906",2991,204,81,0,804,23,157,37,4297
"53033022001",3978,341,0,0,779,14,203,73,5388
"53033022003",3750,302,77,26,805,26,543,31,5560
"53033022005",2569,174,265,0,1684,59,467,77,5295
"53033022006",2761,79,15,14,631,151,301,0,3952
"53033022101",3494,408,11,22,561,122,141,85,4844
"53033022102",4487,266,14,9,1491,61,513,74,6915
"53033022201",3548,332,8,0,430,37,81,6,4442
"53033022202",5677,424,122,46,1390,57,582,113,8411
"53033022203",4136,114,11,0,810,12,123,0,5206
"53033022300",2109,72,24,0,344,1,124,1,2675
"53033022400",7110,294,87,1,1089,202,314,27,9124
"53033022500",6163,221,0,0,919,32,354,0,7689
"53033022603",3350,191,66,0,1399,0,203,19,5228
"53033022604",3163,88,117,0,792,94,113,0,4367
"53033022605",3474,506,101,0,1864,225,1067,206,7443
"53033022606",4480,113,119,0,964,234,731,15,6656
"53033022701",1999,107,13,0,425,43,115,0,2702
"53033022702",2547,311,19,0,454,79,106,43,3559
"53033022703",1781,149,75,0,392,0,61,51,2509
"53033022801",3375,281,146,31,4098,272,440,73,8716
"53033022802",3017,207,50,1,1548,86,189,0,5098
"53033022803",2135,396,61,0,2771,79,125,29,5596
"53033022901",1940,176,36,26,752,0,107,107,3144
"53033022902",4053,195,128,0,1737,227,209,12,6561
"53033023000",3653,108,82,0,1044,57,169,9,5122
"53033023100",2705,142,72,13,1016,36,142,23,4149
"53033023201",1921,310,52,33,3664,177,511,76,6744
"53033023202",1629,609,364,99,1515,337,489,402,5444
"53033023300",4621,265,2,0,1043,32,379,0,6342
"53033023401",1775,258,16,72,1253,154,211,40,3779
"53033023403",2876,145,76,21,1054,91,143,45,4451
"53033023404",2766,29,33,8,429,0,15,0,3280
"53033023500",2219,128,58,21,999,73,156,23,3677
"53033023601",1911,182,61,68,1192,194,201,82,3891
"53033023603",2530,296,233,242,2679,386,570,172,7108
"53033023604",2968,203,331,98,2150,565,629,358,7302
"53033023700",2882,150,39,0,996,35,151,2,4255
"53033023801",1411,123,59,0,613,91,65,9,2371
"53033023803",2557,85,136,0,1222,473,118,0,4591
"53033023804",2952,257,118,1,1946,298,215,1,5788
"53033023900",5212,676,114,0,1010,115,173,158,7458
"53033024000",4992,171,29,1,2476,53,182,0,7904
"53033024100",3808,92,2,0,725,34,71,15,4747
"53033024200",2307,110,8,0,649,0,0,0,3074
"53033024300",5055,406,171,0,1685,268,122,20,7727
"53033024400",2229,87,34,38,307,8,187,18,2908
"53033024500",3548,85,137,0,1085,0,112,0,4967
"53033024601",3624,59,0,0,911,2,134,1,4731
"53033024602",3147,50,32,0,577,0,165,0,3971
"53033024701",2213,75,143,18,1240,113,175,42,4019
"53033024702",5080,265,132,42,1836,310,341,61,8067
"53033024800",2871,177,201,0,1762,298,537,53,5899
"53033024901",2554,98,72,2,2122,95,114,0,5057
"53033024902",2564,112,80,0,1183,42,292,0,4273
"53033024903",3909,16,0,2,2861,104,42,0,6934
"53033025001",3191,67,103,0,1297,26,70,0,4754
"53033025003",4321,283,51,0,2188,72,507,86,7508
"53033025005",2637,111,103,29,1829,15,193,10,4927
"53033025006",3898,30,49,317,1218,170,284,296,6262
"53033025101",2966,312,439,65,1394,572,468,606,6822
"53033025102",3842,82,348,6,3264,314,540,0,8396
"53033025200",4833,256,406,157,2317,258,1213,54,9494
"53033025301",3695,191,238,28,961,116,68,26,5323
"53033025302",2412,447,335,657,1027,325,560,112,5875
"53033025400",2759,584,341,231,2978,423,1698,192,9206
"53033025500",2453,456,236,60,1711,242,1045,454,6657
"53033025601",1985,292,240,44,1812,334,543,164,5414
"53033025602",3505,157,81,0,2500,118,206,58,6625
"53033025701",2765,642,627,112,866,111,370,52,5545
"53033025702",1745,110,334,29,1108,130,245,23,3724
"53033025803",2401,194,514,350,1003,314,851,267,5894
"53033025804",2142,216,215,88,901,101,354,20,4037
"53033025805",2185,242,420,135,1765,127,592,136,5602
"53033025806",1311,90,622,2,2427,205,200,0,4857
"53033026001",1833,146,1260,122,2247,22,308,48,5986
"53033026002",2495,157,1523,968,2450,573,919,291,9376
"53033026100",1597,215,1589,364,1924,420,145,154,6408
"53033026200",2352,205,1064,71,1357,467,473,125,6114
"53033026300",501,34,301,0,665,102,17,6,1626
"53033026400",2672,453,706,257,834,938,869,814,7543
"53033026500",1283,261,644,365,849,665,571,285,4923
"53033026600",1197,244,258,28,886,274,409,165,3461
"53033026700",2950,410,207,157,1165,321,418,402,6030
"53033026801",1899,479,230,199,2074,406,1352,529,7168
"53033026802",2329,466,82,160,1515,172,1275,296,6295
"53033027000",1986,124,111,19,739,449,486,256,4170
"53033027100",1490,225,385,103,982,520,800,187,4692
"53033027200",796,201,185,334,747,358,240,193,3054
"53033027300",2805,700,675,16,1189,1039,1134,459,8017
"53033027400",2526,605,225,162,1384,113,567,407,5989
"53033027500",2684,336,80,65,921,205,566,65,4922
"53033027600",2813,578,243,103,590,540,1292,815,6974
"53033027701",4932,295,0,2,197,179,68,24,5697
"53033027702",4310,179,12,0,207,0,286,0,4994
"53033027800",2835,114,30,0,169,1,144,13,3306
"53033027900",5204,757,143,30,659,315,938,563,8609
"53033028000",2067,623,407,264,344,183,877,401,5166
"53033028100",720,118,299,255,704,255,350,58,2759
"53033028200",1240,494,718,526,1258,185,383,335,5139
"53033028300",2595,101,431,61,1525,64,551,28,5356
"53033028402",1557,162,913,448,1133,474,369,53,5109
"53033028403",2016,344,959,351,957,407,333,289,5656
"53033028500",1900,215,323,71,978,213,602,117,4419
"53033028600",5331,157,14,14,711,236,518,0,6981
"53033028700",3682,276,175,0,802,125,431,64,5555
"53033028801",1413,182,56,1,356,51,437,54,2550
"53033028802",2618,665,896,1414,1153,524,1399,392,9061
"53033028901",2413,103,10,48,584,67,261,0,3486
"53033028902",2357,450,447,701,1638,836,1517,199,8145
"53033029001",3064,299,80,10,908,104,516,133,5114
"53033029003",2811,460,770,94,1777,369,1272,122,7675
"53033029004",1316,541,529,250,806,603,955,738,5738
"53033029101",1463,67,437,120,954,158,204,0,3403
"53033029102",1946,308,470,38,1160,148,471,126,4667
"53033029203",1251,295,359,118,433,558,516,325,3855
"53033029204",3642,582,424,456,2151,83,769,325,8432
"53033029205",2584,500,306,34,1493,174,1144,134,6369
"53033029206",1395,676,258,83,1079,391,703,493,5078
"53033029303",2992,303,792,42,2814,383,233,368,7927
"53033029304",2951,351,191,20,1408,67,160,175,5323
"53033029305",2163,215,85,188,1083,206,210,39,4189
"53033029306",1466,266,226,37,1240,25,60,0,3320
"53033029307",2789,98,108,1,849,149,106,115,4215
"53033029403",2451,160,470,62,2249,250,688,58,6388
"53033029405",3133,238,308,58,1975,148,333,72,6265
"53033029406",2478,83,479,326,1873,159,244,0,5642
"53033029407",1786,356,384,102,1032,602,444,408,5114
"53033029408",2124,461,297,56,1179,137,708,133,5095
"53033029502",3737,469,512,60,1572,261,240,249,7100
"53033029503",2424,2323,486,174,2080,1006,1099,1488,11080
"53033029504",2738,600,626,517,1535,287,368,327,6998
"53033029601",2920,550,523,212,1827,462,562,144,7200
"53033029602",3264,705,149,30,1590,26,236,0,6000
"53033029700",5084,806,260,248,701,331,1006,543,8979
"53033029801",4236,727,514,16,1629,822,753,657,9354
"53033029802",4995,820,316,202,2004,192,852,442,9823
"53033029901",3433,230,329,1,840,14,516,1,5364
"53033029902",2793,108,291,0,915,0,148,10,4265
"53033030003",3062,260,483,55,1857,261,995,176,7149
"53033030004",3718,798,644,453,1700,753,1249,865,10180
"53033030005",2935,655,341,14,1247,193,1262,455,7102
"53033030006",1304,295,451,134,1012,630,586,533,4945
"53033030100",5185,672,472,0,1143,122,428,66,8088
"53033030201",3235,179,122,23,1504,274,1055,18,6410
"53033030202",2684,413,712,96,1281,490,365,142,6183
"53033030304",2149,97,71,30,773,75,265,56,3516
"53033030305",3109,315,407,376,778,225,207,237,5654
"53033030306",3701,354,348,195,1161,245,622,279,6905
"53033030308",3428,448,433,313,1398,307,1025,261,7613
"53033030309",2962,207,655,88,1343,350,520,344,6469
"53033030310",3070,223,428,0,1760,146,480,115,6222
"53033030311",2597,1086,347,17,1239,364,1107,967,7724
"53033030312",2790,328,316,75,1125,104,397,0,5135
"53033030313",1662,425,144,305,699,378,246,280,4139
"53033030314",2153,593,554,54,937,232,569,155,5247
"53033030401",5428,396,191,0,2087,498,491,56,9147
"53033030403",2799,236,331,0,1138,23,525,0,5052
"53033030404",3888,136,0,0,458,186,230,179,5077
"53033030501",853,389,8,35,131,191,34,48,1689
"53033030503",2603,408,362,75,1352,540,817,342,6499
"53033030504",2359,729,151,103,657,506,541,550,5596
"53033030600",3584,1000,166,26,516,262,297,648,6499
"53033030700",2328,552,131,180,463,225,425,177,4481
"53033030801",3014,1758,75,402,1429,807,1727,1711,10923
"53033030802",2297,533,35,43,894,107,418,221,4548
"53033030901",2239,218,24,16,774,183,610,138,4202
"53033030902",3292,742,113,8,1405,286,858,213,6917
"53033031000",2884,7,90,0,503,19,78,0,3581
"53033031100",3575,703,301,63,1689,250,628,141,7350
"53033031202",4156,223,44,19,945,619,236,120,6362
"53033031204",4906,215,50,0,459,0,189,0,5819
"53033031205",4356,448,241,134,1284,420,202,0,7085
"53033031206",3091,258,254,21,1056,262,902,85,5929
"53033031301",2181,246,6,11,144,31,182,201,3002
"53033031302",3287,323,0,0,461,21,281,21,4394
"53033031400",4413,606,170,0,327,255,188,390,6349
"53033031501",3326,337,28,0,258,0,167,50,4166
"53033031502",3655,467,0,0,188,79,88,13,4490
"53033031601",4468,151,45,0,419,182,207,87,5559
"53033031603",4406,352,114,12,618,38,368,25,5933
"53033031604",3938,224,141,0,908,66,308,23,5608
"53033031605",2854,261,95,0,217,24,323,0,3774
"53033031703",4312,521,309,1,1448,17,402,273,7283
"53033031704",3159,195,244,23,1551,32,319,20,5543
"53033031705",3294,62,91,0,731,0,499,0,4677
"53033031706",4203,334,693,196,1110,175,269,12,6992
"53033031800",3636,179,142,16,840,53,338,11,5215
"53033031903",4895,79,202,3,1257,74,392,70,6972
"53033031904",2899,200,61,0,530,41,363,58,4152
"53033031906",2313,74,138,1,985,59,203,0,3773
"53033031907",4245,148,354,0,2511,119,232,119,7728
"53033031908",2392,204,707,11,1241,112,477,87,5231
"53033031909",1938,75,389,0,698,75,120,14,3309
"53033032002",2677,113,44,8,246,26,151,11,3276
"53033032003",4732,329,62,6,159,0,99,12,5399
"53033032005",5171,639,139,245,767,128,575,163,7827
"53033032006",3751,141,41,0,360,0,30,0,4323
"53033032007",2920,264,177,0,228,56,171,28,3844
"53033032008",3710,90,18,0,406,0,218,0,4442
"53033032010",4233,227,118,0,758,59,328,0,5723
"53033032011",3638,72,164,0,426,9,247,9,4565
"53033032102",4423,201,0,0,97,49,74,16,4860
"53033032103",3248,208,15,0,573,47,244,0,4335
"53033032104",4791,193,234,120,539,83,304,0,6264
"53033032203",5140,52,48,0,1738,151,156,0,7285
"53033032207",2641,26,10,0,465,11,113,0,3266
"53033032208",6264,287,271,0,1450,85,228,38,8623
"53033032210",8008,130,44,168,3336,25,593,0,12304
"53033032211",3084,141,83,0,1600,0,30,57,4995
"53033032212",5737,99,274,0,2321,141,574,18,9164
"53033032213",3640,59,1,0,848,31,74,0,4653
"53033032214",3869,51,47,2,2431,37,228,0,6665
"53033032215",3308,0,19,0,1696,56,122,0,5201
"53033032307",5773,109,66,63,594,34,154,17,6810
"53033032309",3229,236,102,0,2014,423,463,25,6492
"53033032311",5108,235,25,0,380,12,352,0,6112
"53033032313",3124,295,101,0,2958,222,1184,224,8108
"53033032315",4604,146,0,19,462,19,146,0,5396
"53033032316",4583,75,20,0,1068,36,256,10,6048
"53033032317",4975,415,19,0,777,156,289,171,6802
"53033032318",3810,73,60,0,1630,106,423,9,6111
"53033032319",3801,442,46,0,685,26,386,15,5401
"53033032320",3899,83,1,0,338,4,242,0,4567
"53033032321",3201,109,50,9,1718,42,125,0,5254
"53033032322",2939,94,0,0,524,17,39,0,3613
"53033032323",3742,128,57,0,1523,3,303,0,5756
"53033032324",3422,339,42,0,1115,165,511,102,5696
"53033032325",3123,269,22,131,1351,119,234,44,5293
"53033032326",3331,280,21,0,483,0,336,72,4523
"53033032327",3536,105,0,0,298,0,20,0,3959
"53033032328",3050,52,12,52,236,0,126,43,3571
"53033032329",4419,111,41,16,3781,18,244,18,8648
"53033032401",4847,528,0,0,272,0,25,157,5829
"53033032402",5170,332,223,0,390,49,303,18,6485
"53033032500",4355,268,42,1,488,113,182,100,5549
"53033032601",2368,155,0,0,203,0,202,0,2928
"53033032602",9652,327,0,0,1850,0,154,57,12040
"53033032702",5972,201,19,106,340,134,237,193,7202
"53033032703",1884,31,8,0,84,5,49,0,2061
"53033032704",5028,749,42,4,305,236,135,365,6864
"53033032800",2223,99,0,5,40,4,72,1,2444
"53033990100",0,0,0,0,0,0,0,0,0
"53035080101",1679,232,97,0,657,28,175,12,2880
"53035080102",2508,534,182,44,1354,470,586,439,6117
"53035080200",2304,251,40,165,472,325,405,79,4041
"53035080300",2358,376,49,27,398,171,272,29,3680
"53035080400",2384,245,74,28,284,202,77,130,3424
"53035080500",1093,723,46,181,196,107,145,64,2555
"53035080600",3124,931,336,18,718,154,429,30,5740
"53035080700",2836,252,16,10,265,15,202,17,3613
"53035080800",967,181,123,0,368,147,357,9,2152
"53035080900",3419,497,24,10,294,211,165,0,4620
"53035081000",2446,786,99,20,530,81,616,0,4578
"53035081100",1547,403,110,6,646,401,184,342,3639
"53035081200",2100,636,8,28,187,123,146,10,3238
"53035081400",137,0,0,0,16,0,35,0,188
"53035090101",4679,304,18,0,868,143,306,49,6367
"53035090102",5243,136,0,0,783,60,236,15,6473
"53035090201",3772,335,43,19,128,0,145,0,4442
"53035090202",4544,126,0,2,556,2,380,14,5624
"53035090300",3371,347,101,0,531,50,860,196,5456
"53035090400",3722,522,20,0,309,76,43,65,4757
"53035090501",2858,298,28,0,332,0,269,23,3808
"53035090502",3727,348,45,23,747,14,550,12,5466
"53035090700",4417,198,29,0,365,26,206,0,5241
"53035090800",3607,117,0,0,218,9,67,0,4018
"53035090900",5949,425,11,37,628,102,318,9,7479
"53035091000",5621,312,176,56,708,15,442,0,7330
"53035091100",3796,254,11,0,385,76,175,0,4697
"53035091201",2743,309,52,33,577,205,310,22,4251
"53035091203",4525,327,640,18,1870,178,699,39,8296
"53035091204",2660,258,59,50,539,70,131,29,3796
"53035091301",3689,81,109,0,390,8,140,9,4426
"53035091302",4224,414,57,4,854,39,402,15,6009
"53035091400",2387,160,27,0,637,143,33,143,3530
"53035091500",2677,195,260,41,760,25,124,51,4133
"53035091600",4046,401,277,0,1214,115,215,113,6381
"53035091700",5248,463,201,258,1791,162,561,0,8684
"53035091800",2121,222,113,0,357,0,232,0,3045
"53035091900",3041,141,97,114,995,92,118,0,4598
"53035092000",5087,126,58,0,733,17,95,0,6116
"53035092100",5436,516,55,0,677,217,179,48,7128
"53035092200",3561,1040,45,36,854,367,374,353,6630
"53035092300",4002,765,110,0,925,100,640,10,6552
"53035092400",4282,558,410,0,812,47,273,127,6509
"53035092500",4000,467,201,10,359,37,107,0,5181
"53035092600",4463,508,28,18,547,148,82,60,5854
"53035092701",3331,243,0,0,386,123,108,0,4191
"53035092704",2579,228,0,0,167,19,56,52,3101
"53035092801",3158,408,142,10,400,91,248,75,4532
"53035092802",3269,260,0,0,417,34,203,0,4183
"53035092803",2137,388,8,0,68,43,41,21,2706
"53035092901",4545,420,38,3,355,0,182,0,5543
"53035092902",4424,466,22,0,417,179,285,0,5793
"53035940000",2699,345,9,3,330,48,93,14,3541
"53035940100",4499,421,32,0,960,172,233,17,6334
"53035990100",0,0,0,0,0,0,0,0,0
"53037975100",5372,699,0,6,388,74,233,55,6827
"53037975200",4470,424,4,0,345,6,138,0,5387
"53037975300",3911,469,18,0,177,0,112,0,4687
"53037975401",2271,2306,212,41,382,498,532,364,6606
"53037975402",3858,888,0,0,244,104,359,0,5453
"53037975500",3160,1544,0,0,410,480,179,243,6016
"53037975600",1190,665,10,0,97,41,271,86,2360
"53037975700",3456,422,0,7,621,17,616,48,5187
"53039950100",6603,1165,2,80,596,517,426,418,9807
"53039950200",3492,555,0,9,157,45,87,53,4398
"53039950300",5900,773,0,27,552,16,1035,297,8600
"53041970100",2931,471,4,0,120,45,38,0,3609
"53041970200",2263,838,0,0,174,0,69,220,3564
"53041970300",2737,881,46,97,141,510,116,403,4931
"53041970400",4099,725,0,1,444,47,1024,253,6593
"53041970500",1506,172,10,0,161,53,142,0,2044
"53041970600",1369,428,1,0,129,81,323,98,2429
"53041970700",3147,987,15,1,118,235,726,383,5612
"53041970800",3011,536,33,0,258,23,397,66,4324
"53041970900",1436,239,134,0,27,68,134,16,2054
"53041971000",2210,515,0,1,101,73,291,55,3246
"53041971100",2966,445,23,0,227,21,130,0,3812
"53041971200",2349,246,0,0,149,25,72,18,2859
"53041971300",4984,864,1,0,399,6,412,0,6666
"53041971400",2143,68,0,0,483,121,81,8,2904
"53041971500",5966,855,3,0,459,157,449,78,7967
"53041971600",2839,618,55,0,145,42,181,31,3911
"53041971700",3730,523,0,0,321,93,223,77,4967
"53041971800",3404,545,0,0,92,0,74,0,4115
"53041971900",1922,550,0,0,68,16,90,0,2646
"53041972000",2248,226,4,0,182,24,47,0,2731
"53043960100",1278,277,0,0,24,4,27,0,1610
"53043960200",2778,420,8,0,68,13,26,21,3334
"53043960300",2044,249,13,0,187,11,120,0,2624
"53043960400",2293,385,3,0,217,19,60,20,2997
"53045940000",129,63,22,8,344,184,23,19,792
"53045960100",693,84,0,0,22,22,2,0,823
"53045960200",3697,1064,0,0,591,415,16,222,6005
"53045960300",4802,810,0,198,300,15,76,213,6414
"53045960400",6792,1177,64,204,395,56,420,438,9546
"53045960500",4406,193,0,53,97,78,49,0,4876
"53045960600",2381,477,5,0,681,128,435,0,4107
"53045960700",1023,134,0,0,177,174,125,180,1813
"53045960800",2061,702,0,12,347,127,299,200,3748
"53045960900",3136,779,25,0,446,560,600,610,6156
"53045961000",3995,538,143,0,607,95,359,44,5781
"53045961100",4531,653,18,49,222,19,16,129,5637
"53045961200",3423,188,64,0,329,0,38,0,4042
"53045961300",2422,589,7,3,620,229,159,225,4254
"53047940100",791,191,8,4,1118,707,35,80,2934
"53047940200",1080,441,6,0,1033,632,282,210,3684
"53047970300",5252,949,0,0,1010,415,683,354,8663
"53047970400",2405,551,11,0,417,332,501,256,4473
"53047970500",2088,299,0,0,213,23,93,19,2735
"53047970600",4138,453,24,26,836,521,336,394,6728
"53047970700",2444,628,8,62,222,369,433,425,4591
"53047970800",2844,654,0,4,1039,577,2009,884,8011
"53047970900",1740,225,0,0,62,6,40,2,2075
"53047971000",2771,664,2,5,212,64,283,198,4199
"53049950200",3189,621,10,19,437,277,450,80,5083
"53049950300",2080,638,0,0,484,236,232,275,3945
"53049950400",3176,305,0,12,103,56,120,28,3800
"53049950500",2286,350,5,4,103,45,211,84,3088
"53049950600",819,298,2,0,110,6,147,11,1393
"53049950700",2181,322,0,0,83,39,42,0,2667
"53049950800",1723,235,19,0,130,24,14,9,2154
"53049990100",0,0,0,0,0,0,0,0,0
"53051970100",1705,299,0,0,100,10,58,37,2209
"53051970200",1876,316,0,0,281,106,29,0,2608
"53051970300",2147,959,5,0,201,35,104,30,3481
"53051970400",1955,414,15,0,142,18,50,0,2594
"53051970500",1409,597,0,0,176,57,118,11,2368
"53053060200",496,73,26,0,69,0,0,0,664
"53053060300",3315,196,164,41,342,21,71,0,4150
"53053060400",3396,241,12,0,263,73,238,22,4245
"53053060500",3325,282,63,0,327,0,218,14,4229
"53053060600",4404,467,151,16,469,59,207,0,5773
"53053060700",3457,854,117,51,456,89,259,0,5283
"53053060800",4577,306,0,13,218,0,216,0,5330
"53053060903",2293,490,173,106,264,0,145,170,3641
"53053060904",3408,733,178,53,458,236,340,158,5564
"53053060905",4223,800,422,104,609,72,319,127,6676
"53053060906",1630,55,89,30,317,59,139,30,2349
"53053061001",2903,246,50,9,384,10,195,24,3821
"53053061002",2965,227,397,192,296,46,339,0,4462
"53053061100",5149,250,405,24,811,125,210,0,6974
"53053061200",3584,479,611,0,795,73,660,166,6368
"53053061300",2372,698,790,267,486,316,440,163,5532
"53053061400",814,676,273,251,487,150,120,114,2885
"53053061500",3051,975,257,120,347,127,376,245,5498
"53053061601",704,462,93,113,262,241,59,90,2024
"53053061602",485,120,59,13,119,45,50,0,891
"53053061700",1522,463,715,197,678,522,484,58,4639
"53053061800",1049,408,183,67,336,395,107,137,2682
"53053061900",810,188,30,105,211,367,99,212,2022
"53053062000",2008,413,259,64,1176,392,468,172,4952
"53053062300",1754,688,372,115,1672,767,643,538,6549
"53053062400",3622,242,265,262,559,476,251,105,5782
"53053062500",4393,647,611,479,1799,133,605,0,8667
"53053062600",1407,331,504,45,499,191,138,80,3195
"53053062801",2624,1008,1217,367,846,115,479,520,7176
"53053062802",2063,296,676,46,867,243,314,56,4561
"53053062900",3560,1004,1008,162,1331,189,732,546,8532
"53053063000",1617,228,379,31,678,178,401,77,3589
"53053063100",1849,397,328,0,1326,370,297,206,4773
"53053063200",2839,393,267,92,1105,500,358,142,5696
"53053063300",2369,496,522,741,3232,819,1732,801,10712
"53053063400",3186,879,354,471,2034,412,328,451,8115
"53053063501",1744,380,469,135,1323,299,753,180,5283
"53053063502",1775,182,471,32,1891,593,479,8,5431
"53053070100",2831,337,10,0,122,30,147,25,3502
"53053070203",4845,75,48,167,420,0,331,10,5896
"53053070204",2804,563,0,0,224,51,410,96,4148
"53053070205",2679,284,0,0,222,8,193,0,3386
"53053070206",3406,272,21,7,64,17,84,7,3878
"53053070207",3620,625,11,9,540,36,41,0,4882
"53053070307",4531,328,0,0,254,0,92,31,5236
"53053070308",3059,200,17,0,84,1,20,0,3381
"53053070309",4312,295,55,33,378,154,180,13,5420
"53053070310",4293,176,43,0,556,152,112,99,5431
"53053070311",3883,353,62,0,336,350,386,344,5714
"53053070312",4361,467,56,1,529,16,138,12,5580
"53053070313",4670,235,0,0,421,25,110,45,5506
"53053070314",2711,209,0,0,243,0,36,0,3199
"53053070315",3876,258,73,0,966,0,214,25,5412
"53053070316",3252,20,414,0,1342,0,226,0,5254
"53053070401",1746,149,4,0,139,175,115,175,2503
"53053070403",2785,304,0,0,390,15,209,0,3703
"53053070404",3815,576,49,0,338,0,244,51,5073
"53053070703",4855,329,80,45,819,0,278,0,6406
"53053071100",1761,159,0,0,162,182,13,0,2277
"53053071205",3605,344,98,0,604,56,135,13,4855
"53053071206",5122,554,319,17,799,69,472,74,7426
"53053071207",4351,589,86,77,1238,88,746,85,7260
"53053071208",5415,446,223,0,1189,130,604,0,8007
"53053071209",3273,181,77,62,459,16,188,0,4256
"53053071210",3694,104,4,5,412,0,201,0,4420
"53053071304",3512,438,444,29,1075,132,518,0,6148
"53053071305",2788,198,203,30,364,175,251,111,4120
"53053071306",4525,141,361,69,1179,135,111,59,6580
"53053071307",3294,374,394,29,372,143,193,0,4799
"53053071309",2554,434,179,19,839,192,208,0,4425
"53053071310",3515,338,134,4,1030,9,579,0,5609
"53053071403",2730,190,221,9,636,53,261,62,4162
"53053071406",4042,450,652,0,1875,177,567,133,7896
"53053071407",4618,466,653,0,946,16,1174,15,7888
"53053071408",2419,255,303,88,630,210,271,137,4313
"53053071409",2316,588,436,0,1014,170,587,194,5305
"53053071410",4111,764,799,0,639,374,644,451,7782
"53053071411",3061,558,688,63,669,49,545,17,5650
"53053071503",3154,261,822,42,1010,80,672,0,6041
"53053071504",2039,975,295,180,485,225,200,120,4519
"53053071505",3322,289,640,48,753,70,334,47,5503
"53053071506",2829,287,372,96,1366,51,285,24,5310
"53053071601",1899,380,615,77,1323,462,825,438,6019
"53053071602",3243,518,720,12,1594,403,305,183,6978
"53053071703",1216,496,470,111,842,251,512,203,4101
"53053071704",1682,539,552,151,1110,990,1364,718,7106
"53053071705",1844,615,219,0,975,387,277,455,4772
"53053071706",860,178,318,18,404,43,235,35,2091
"53053071707",1707,376,139,29,398,152,294,154,3249
"53053071803",2781,755,689,108,879,192,1041,338,6783
"53053071805",726,450,441,145,1844,418,374,272,4670
"53053071806",1204,601,425,367,732,769,736,726,5560
"53053071807",1592,278,481,74,949,146,302,130,3952
"53053071808",1466,794,248,77,727,389,564,625,4890
"53053071901",2520,585,226,71,1028,292,384,467,5573
"53053071902",3707,473,123,56,521,59,303,45,5287
"53053072000",1832,858,358,175,820,574,423,893,5933
"53053072105",3079,325,216,47,1120,173,303,47,5310
"53053072106",3730,507,465,180,1276,182,657,170,7167
"53053072107",2928,65,336,24,731,128,320,12,4544
"53053072108",3238,643,611,23,1045,46,293,119,6018
"53053072109",2586,105,158,0,601,59,303,13,3825
"53053072111",1701,228,75,9,389,33,75,9,2519
"53053072112",2360,181,404,81,1116,138,595,0,4875
"53053072305",4311,176,362,0,928,187,176,0,6140
"53053072307",2798,206,571,84,603,9,299,13,4583
"53053072308",4951,303,310,0,1809,371,529,281,8554
"53053072309",3870,532,183,0,896,92,366,0,5939
"53053072310",2702,190,134,30,555,29,117,58,3815
"53053072311",2346,184,521,39,779,430,400,64,4763
"53053072312",2799,897,434,52,1198,130,287,195,5992
"53053072313",2468,147,184,42,662,10,137,23,3673
"53053072405",3823,222,0,0,298,0,86,28,4457
"53053072406",5554,273,38,0,297,1,157,112,6432
"53053072407",3315,368,120,3,764,0,385,60,5015
"53053072408",5101,266,107,0,255,60,127,48,5964
"53053072409",2305,125,24,0,47,25,85,79,2690
"53053072410",2987,236,6,15,312,0,31,0,3587
"53053072503",3634,280,8,3,440,24,82,3,4474
"53053072504",3359,165,89,0,241,112,8,0,3974
"53053072505",5979,87,58,9,975,125,411,64,7708
"53053072506",2756,201,52,0,328,57,47,27,3468
"53053072507",2210,178,12,0,139,0,165,10,2714
"53053072601",3980,545,105,6,604,78,308,1,5627
"53053072602",3735,284,0,0,297,9,211,10,4546
"53053072603",3563,615,31,43,173,16,18,0,4459
"53053072800",6275,239,786,138,1506,62,835,0,9841
"53053072901",1872,100,456,9,255,42,594,37,3365
"53053072903",1156,73,312,27,312,43,243,4,2170
"53053072905",3711,414,1064,0,332,116,1037,127,6801
"53053072906",43,0,0,0,17,0,17,0,77
"53053072907",3512,695,527,0,821,39,835,154,6583
"53053073001",4377,997,20,0,381,38,229,0,6042
"53053073005",4177,847,0,0,344,66,0,66,5500
"53053073006",2960,302,0,0,165,19,97,0,3543
"53053073108",5083,574,520,0,1573,273,704,713,9440
"53053073110",3380,79,52,0,221,70,253,21,4076
"53053073111",3181,349,68,0,525,0,335,21,4479
"53053073113",5294,349,227,47,963,0,507,0,7387
"53053073114",4137,361,425,8,297,227,259,171,5885
"53053073115",3152,222,41,0,555,104,292,82,4448
"53053073116",2351,416,159,0,281,5,93,3,3308
"53053073117",3213,304,91,0,86,140,180,0,4014
"53053073118",3779,189,7,0,285,0,241,10,4511
"53053073119",2737,196,19,0,109,27,29,2,3119
"53053073120",2586,465,223,210,880,0,452,0,4816
"53053073121",3910,83,108,0,959,8,372,91,5531
"53053073122",3136,281,132,0,635,100,482,0,4766
"53053073123",3430,177,245,0,1017,0,195,0,5064
"53053073124",3166,138,0,0,184,2,118,2,3610
"53053073125",6713,736,759,89,1084,240,598,353,10572
"53053073126",2368,373,387,0,1025,20,400,270,4843
"53053073200",4650,585,5,1,217,60,295,116,5929
"53053073301",3816,697,77,0,874,256,803,105,6628
"53053073302",3123,136,8,0,426,34,135,14,3876
"53053073404",4583,547,64,5,332,102,278,10,5921
"53053073405",2291,243,170,2,493,60,290,13,3562
"53053073406",3910,366,105,18,545,0,514,21,5479
"53053073407",2801,411,32,0,376,44,245,0,3909
"53053073408",3276,372,36,0,199,54,267,190,4394
"53053073500",5964,458,24,0,687,37,411,0,7581
"53053940001",2182,86,55,0,321,37,153,0,2834
"53053940002",2287,322,170,55,647,257,230,66,4034
"53053940003",3884,433,710,113,1767,263,1005,267,8442
"53053940004",5115,328,315,6,524,48,247,0,6583
"53053940005",3592,292,424,39,1262,224,604,60,6497
"53053940006",431,247,226,625,577,771,51,185,3113
"53053940007",1050,312,236,0,1034,487,450,90,3659
"53053940008",3691,399,476,17,1402,73,274,148,6480
"53053940009",2403,116,73,0,207,6,335,2,3142
"53053940010",3020,576,93,2,325,28,378,156,4578
"53053940011",3124,84,87,16,917,34,122,6,4390
"53055960100",4257,543,19,0,266,82,140,92,5399
"53055960300",4151,354,39,17,197,14,129,42,4943
"53055960400",2284,269,8,0,251,33,229,109,3183
"53055960500",2256,395,21,1,117,75,46,105,3016
"53055990100",0,0,0,0,0,0,0,0,0
"53057940200",1906,87,0,0,172,12,71,0,2248
"53057940300",4224,291,23,1,209,15,161,9,4933
"53057940400",6179,358,22,0,441,37,351,10,7398
"53057940500",1652,529,12,8,225,53,204,97,2780
"53057940600",1200,213,3,20,48,11,44,6,1545
"53057940700",1183,155,11,0,107,21,33,2,1512
"53057940800",2020,139,9,9,577,315,126,9,3204
"53057950100",595,147,2,0,40,10,17,6,817
"53057950800",5318,192,0,0,286,0,818,18,6632
"53057950900",3160,590,5,100,266,190,162,126,4599
"53057951000",2142,314,5,0,210,41,140,39,2891
"53057951100",3277,797,12,2,346,124,264,85,4907
"53057951200",2840,101,1,0,127,14,160,0,3243
"53057951300",1437,136,0,0,76,0,57,17,1723
"53057951400",2794,738,44,0,237,123,233,420,4589
"53057951500",6896,1334,62,0,910,88,1087,53,10430
"53057951600",3542,511,18,0,173,321,655,550,5770
"53057951700",2687,240,0,0,464,27,238,51,3707
"53057951800",2206,833,59,32,1105,212,1043,570,6060
"53057951900",3023,57,11,1,373,8,138,0,3611
"53057952100",2952,468,0,1,139,11,501,117,4189
"53057952200",1982,1515,0,25,676,191,524,1027,5940
"53057952301",2387,1053,48,78,811,694,1392,1438,7901
"53057952302",6674,643,33,0,1013,473,1754,878,11468
"53057952401",1977,570,0,0,432,56,675,95,3805
"53057952402",5442,916,12,1,1007,201,1620,705,9904
"53057952500",1647,377,0,14,338,42,356,71,2845
"53057952600",3257,193,40,1,213,17,497,76,4294
"53057952700",2961,225,0,4,317,26,329,4,3866
"53057990100",0,0,0,0,0,0,0,0,0
"53059950100",159,0,0,0,0,0,0,0,159
"53059950200",4193,500,15,14,187,28,26,0,4963
"53059950300",1276,329,0,23,48,29,56,2,1763
"53059950400",1741,282,11,0,36,22,260,0,2352
"53059950500",1703,271,0,0,220,16,258,0,2468
"53061040100",3163,231,43,0,209,14,111,5,3776
"53061040200",2991,1152,165,127,1085,668,463,586,7237
"53061040300",1958,489,13,0,400,41,303,166,3370
"53061040400",2541,381,139,17,360,161,277,121,3997
"53061040500",1495,252,32,25,324,263,87,221,2699
"53061040700",2102,922,84,83,262,103,125,100,3781
"53061040800",1697,323,19,73,106,113,202,0,2533
"53061040900",2192,144,22,0,198,39,166,10,2771
"53061041000",3788,1180,104,0,495,38,540,175,6320
"53061041100",2929,378,84,0,1025,285,688,90,5479
"53061041201",2241,211,158,0,652,97,352,95,3806
"53061041202",3565,1538,207,57,953,130,895,741,8086
"53061041301",4009,397,45,0,770,0,39,0,5260
"53061041303",2910,303,91,0,733,59,543,45,4684
"53061041304",2426,4,38,0,515,17,217,0,3217
"53061041400",3785,739,27,0,740,188,471,346,6296
"53061041500",891,186,160,5,100,44,122,21,1529
"53061041601",3714,250,158,4,1074,184,573,66,6023
"53061041605",4971,375,189,1,972,1,437,107,7053
"53061041606",3560,220,103,35,1293,141,353,0,5705
"53061041607",2943,145,127,0,688,13,159,70,4145
"53061041608",4862,142,137,0,1170,0,192,0,6503
"53061041701",2450,288,162,432,1027,233,535,354,5481
"53061041703",3687,436,225,338,1143,0,591,239,6659
"53061041704",3451,329,59,0,1231,161,262,145,5638
"53061041805",3114,189,372,57,1267,97,661,37,5794
"53061041806",4699,856,197,57,1608,715,1193,690,10015
"53061041808",2636,312,127,31,589,96,682,67,4540
"53061041809",2702,684,589,33,1189,179,911,359,6646
"53061041810",2332,653,296,72,800,472,516,746,5887
"53061041811",3514,946,630,0,1667,231,820,712,8520
"53061041812",2734,803,205,0,1740,466,1296,230,7474
"53061041901",2649,411,297,8,990,37,374,303,5069
"53061041903",4037,1238,309,298,1297,239,839,734,8991
"53061041904",2821,1010,315,99,904,318,1187,567,7221
"53061041905",3318,720,382,35,1042,400,1165,0,7062
"53061042001",4492,160,30,15,686,49,60,2,5494
"53061042003",2809,31,16,0,469,0,205,0,3530
"53061042004",2895,171,96,0,1089,125,101,9,4486
"53061042005",3509,77,49,50,1323,144,163,0,5315
"53061042006",3164,140,16,0,1580,271,316,14,5501
"53061050101",2111,72,45,84,245,36,54,0,2647
"53061050102",3414,528,134,73,1243,285,225,0,5902
"53061050200",3331,296,0,1,561,30,169,0,4388
"53061050300",4325,355,0,0,594,107,37,0,5418
"53061050401",5787,280,164,0,773,52,534,0,7590
"53061050402",3765,405,73,47,822,16,96,0,5224
"53061050500",5875,496,0,0,527,173,316,63,7450
"53061050600",1003,13,58,0,169,13,40,6,1302
"53061050700",4412,198,192,106,705,633,64,198,6508
"53061050800",4659,133,199,0,1005,130,273,29,6428
"53061050900",2122,268,248,50,450,21,248,71,3478
"53061051000",3257,371,126,0,584,129,418,61,4946
"53061051100",3167,159,42,0,629,60,509,0,4566
"53061051200",2833,350,12,17,985,228,451,179,5055
"53061051300",4435,425,274,2,1601,50,395,34,7216
"53061051400",3806,650,518,90,1341,822,771,436,8434
"53061051500",3135,614,285,0,913,514,621,188,6270
"53061051601",2748,690,267,26,782,151,543,150,5357
"53061051602",2713,266,132,0,975,243,314,99,4742
"53061051701",3051,437,297,4,1905,267,328,193,6482
"53061051702",2486,284,115,1,961,122,251,96,4316
"53061051802",2583,298,452,11,2041,105,773,126,6389
"53061051803",2554,457,341,83,1864,632,591,213,6735
"53061051804",2431,103,312,2,1410,27,365,0,4650
"53061051905",4482,537,482,82,1999,318,539,89,8528
"53061051912",2049,79,0,0,274,0,44,0,2446
"53061051913",3390,90,26,5,712,52,141,0,4416
"53061051914",3409,271,9,0,425,62,240,38,4454
"53061051915",5930,184,256,5,1500,83,257,55,8270
"53061051916",2944,156,48,0,482,110,319,30,4089
"53061051917",3282,141,0,0,566,1,217,1,4208
"53061051918",4037,90,1,0,778,103,85,73,5167
"53061051921",3361,172,53,0,706,69,758,45,5164
"53061051922",3197,137,258,36,913,73,269,0,4883
"53061051923",3565,384,58,0,1224,89,239,1,5560
"53061051924",4433,263,26,26,1655,0,736,34,7173
"53061051925",4474,165,296,1,2397,73,208,0,7614
"53061051926",3619,109,0,0,1091,0,188,0,5007
"53061051927",3112,108,24,0,1251,56,45,6,4602
"53061051928",2709,136,47,219,1553,345,705,121,5835
"53061052003",4678,408,207,0,3104,61,258,0,8716
"53061052004",4091,399,176,0,1537,0,218,14,6435
"53061052005",4039,241,81,0,955,0,194,0,5510
"53061052006",2768,176,33,0,1160,69,296,5,4507
"53061052007",3321,291,44,0,1390,58,560,0,5664
"53061052104",2629,80,207,2,732,1,234,0,3885
"53061052105",1514,69,10,0,95,92,9,92,1881
"53061052107",3221,180,0,0,915,147,184,0,4647
"53061052108",5322,509,0,0,203,14,166,0,6214
"53061052112",2327,138,0,0,307,8,65,0,2845
"53061052113",2868,99,36,0,172,0,214,0,3389
"53061052114",4166,58,8,1,611,1,177,0,5022
"53061052115",6287,179,119,0,743,4,675,45,8052
"53061052118",5723,290,32,0,948,81,400,50,7524
"53061052203",4716,100,11,17,506,59,340,48,5797
"53061052204",4886,140,86,14,564,28,883,29,6630
"53061052206",3788,158,0,0,160,0,251,0,4357
"53061052207",5210,308,0,0,324,104,268,199,6413
"53061052208",2303,664,126,0,513,122,548,360,4636
"53061052209",1852,727,8,0,145,28,522,268,3550
"53061052301",3732,294,7,1,220,9,162,141,4566
"53061052302",3522,51,10,0,327,20,65,26,4021
"53061052401",3152,214,11,7,294,215,198,199,4290
"53061052402",2829,596,8,10,246,48,90,0,3827
"53061052502",4062,349,0,0,241,16,34,0,4702
"53061052503",5324,581,0,0,565,16,358,13,6857
"53061052504",1801,179,82,0,95,29,69,11,2266
"53061052603",1958,182,11,0,252,0,161,0,2564
"53061052604",3539,593,4,10,188,131,308,314,5087
"53061052605",5187,503,0,0,399,54,125,0,6268
"53061052606",4604,412,0,12,332,104,585,29,6078
"53061052607",5067,193,37,0,625,26,589,11,6548
"53061052701",1424,42,0,0,68,0,78,0,1612
"53061052705",5736,223,122,0,1115,235,527,243,8201
"53061052706",4626,211,0,0,981,66,601,0,6485
"53061052707",3240,145,27,0,587,0,285,35,4319
"53061052708",4366,218,38,0,713,16,465,0,5816
"53061052709",2859,238,33,0,103,18,211,0,3462
"53061052803",3783,430,165,2,651,7,174,69,5281
"53061052804",5672,352,0,0,1392,153,545,0,8114
"53061052805",3272,333,0,50,401,263,93,29,4441
"53061052806",5148,294,48,72,1056,227,887,36,7768
"53061052903",2508,819,12,0,450,61,281,234,4365
"53061052904",4193,476,52,54,435,231,183,362,5986
"53061052905",2983,543,1,0,638,144,699,150,5158
"53061052906",3930,489,29,19,320,26,298,0,5111
"53061053101",3094,341,0,1,334,70,248,41,4129
"53061053102",3986,255,0,0,242,27,51,18,4579
"53061053201",3175,413,49,0,254,0,56,26,3973
"53061053202",3522,325,7,0,307,70,183,22,4436
"53061053301",4939,830,0,0,294,171,218,124,6576
"53061053302",4974,270,78,0,209,0,314,0,5845
"53061053400",4566,509,75,27,172,17,93,34,5493
"53061053504",5352,632,0,0,266,343,380,236,7209
"53061053505",4552,269,0,0,328,17,384,18,5568
"53061053506",4829,398,0,2,425,56,84,0,5794
"53061053507",4361,246,133,12,327,9,351,0,5439
"53061053508",2464,578,0,1,414,27,336,65,3885
"53061053509",2748,412,16,0,406,86,467,57,4192
"53061053602",5003,412,0,0,425,25,390,0,6255
"53061053603",3273,204,0,0,143,20,20,0,3660
"53061053604",4084,90,136,0,192,0,299,0,4801
"53061053700",2445,520,11,0,135,23,8,7,3149
"53061053801",2795,474,10,0,115,38,173,25,3630
"53061053802",4420,544,0,0,487,0,611,14,6076
"53061053803",4553,576,21,0,258,54,260,103,5825
"53061940001",4110,442,38,10,1351,391,396,87,6825
"53061940002",1942,246,79,7,1032,301,149,5,3761
"53061990002",0,0,0,0,0,0,0,0,0
"53061990100",0,0,0,0,0,0,0,0,0
"53063000200",2926,1132,139,244,270,131,155,70,5067
"53063000300",3170,1017,33,75,552,222,514,15,5598
"53063000400",2446,1063,237,132,514,19,374,54,4839
"53063000500",2432,368,32,23,230,11,199,27,3322
"53063000600",2654,165,33,0,151,115,57,0,3175
"53063000700",3455,651,23,0,384,62,162,15,4752
"53063000800",3948,425,38,0,180,62,77,0,4730
"53063000900",5060,664,15,3,397,14,247,111,6511
"53063001000",4595,665,20,0,267,29,146,7,5729
"53063001100",2766,218,30,0,163,67,69,68,3381
"53063001200",1656,239,43,10,76,39,23,5,2091
"53063001300",2221,688,159,113,220,97,163,55,3716
"53063001400",4101,1029,84,62,618,322,536,102,6854
"53063001500",3504,985,82,0,419,106,241,45,5382
"53063001600",2139,745,0,122,479,279,255,79,4098
"53063001800",1979,375,61,19,173,77,74,18,2776
"53063001900",2216,418,82,12,303,168,49,39,3287
"53063002000",2057,1010,32,0,257,372,125,34,3887
"53063002100",1459,456,33,212,154,147,76,45,2582
"53063002300",3216,1839,132,52,211,374,107,518,6449
"53063002400",847,795,0,0,55,257,48,126,2128
"53063002500",2628,1860,60,108,247,487,246,415,6051
"53063002600",2876,1056,128,87,593,267,201,71,5279
"53063002900",2246,225,26,0,559,77,162,74,3369
"53063003000",1186,623,153,257,294,350,216,280,3359
"53063003100",3693,592,95,61,117,440,76,114,5188
"53063003200",1506,417,31,0,253,41,52,19,2319
"53063003500",1030,990,47,13,38,77,25,75,2295
"53063003600",2607,1268,12,16,175,143,106,118,4445
"53063003800",1102,427,0,0,120,28,56,2,1735
"53063003900",2023,170,0,0,50,0,63,0,2306
"53063004000",2965,1152,181,22,320,46,167,104,4957
"53063004100",1962,171,0,0,129,58,75,0,2395
"53063004200",4323,223,0,0,172,22,160,1,4901
"53063004300",3011,140,43,8,93,25,72,0,3392
"53063004400",3287,309,304,44,374,80,206,0,4604
"53063004500",2935,248,109,0,198,73,62,0,3625
"53063004601",2600,419,9,0,370,129,172,0,3699
"53063004602",2452,178,18,2,307,46,163,23,3189
"53063004700",5289,556,171,22,328,277,395,41,7079
"53063004800",3265,245,200,30,140,0,60,0,3940
"53063004900",4796,371,26,33,345,39,10,0,5620
"53063005000",3095,333,0,0,194,74,70,0,3766
"53063010100",5343,866,0,0,115,0,138,0,6462
"53063010201",3276,359,0,0,73,44,38,0,3790
"53063010202",6611,342,0,0,280,0,276,0,7509
"53063010301",3045,967,0,0,153,74,272,34,4545
"53063010303",2628,354,0,0,117,70,27,66,3262
"53063010304",4186,673,0,0,232,16,166,21,5294
"53063010305",5231,81,0,0,300,0,100,0,5712
"53063010401",2151,557,58,60,582,289,270,226,4193
"53063010402",6560,419,0,0,262,21,186,5,7453
"53063010501",6899,904,81,54,330,0,253,139,8660
"53063010503",6347,211,33,0,467,1,204,0,7263
"53063010504",3283,197,0,0,70,0,81,0,3631
"53063010601",3314,162,74,19,145,0,256,14,3984
"53063010602",6525,250,49,0,518,8,231,0,7581
"53063010700",5374,95,24,0,855,12,487,0,6847
"53063010800",1411,459,0,2,79,100,18,14,2083
"53063010900",2853,454,21,0,254,50,113,15,3760
"53063011000",3235,176,57,23,162,169,82,23,3927
"53063011101",2847,1242,270,55,357,504,221,325,5821
"53063011102",2674,661,8,18,401,158,88,82,4090
"53063011201",6005,768,139,35,295,198,194,0,7634
"53063011202",3291,398,7,0,237,27,144,7,4111
"53063011300",6138,670,21,17,672,35,173,34,7760
"53063011400",4760,331,77,0,281,219,74,216,5958
"53063011500",1146,130,0,3,118,8,25,0,1430
"53063011600",1404,186,19,56,89,6,25,9,1794
"53063011701",1835,224,17,0,20,86,0,0,2182
"53063011702",3517,1529,177,31,388,215,114,274,6245
"53063011800",2712,1001,0,52,330,22,102,93,4312
"53063011900",3071,904,217,0,216,46,334,82,4870
"53063012000",3555,401,0,0,94,116,51,208,4425
"53063012100",1825,451,23,0,73,193,47,60,2672
"53063012200",1853,274,63,7,133,10,136,0,2476
"53063012300",3287,1247,150,0,610,95,81,6,5476
"53063012401",3649,191,8,0,206,0,25,11,4090
"53063012402",5239,273,15,0,426,44,295,0,6292
"53063012500",2529,518,17,0,233,41,109,0,3447
"53063012600",3059,418,29,0,629,116,121,85,4457
"53063012701",2975,478,40,0,171,14,5,0,3683
"53063012702",2019,116,0,0,21,29,52,0,2237
"53063012801",3291,278,23,38,276,9,133,0,4048
"53063012802",3050,158,0,0,264,20,139,13,3644
"53063012901",2249,721,0,0,164,13,182,117,3446
"53063012902",5324,741,27,0,519,82,455,36,7184
"53063013000",6309,786,62,0,517,107,469,52,8302
"53063013100",8440,1206,0,54,572,59,222,34,10587
"53063013201",6407,723,0,0,428,28,129,33,7748
"53063013202",7695,300,0,86,733,49,321,83,9267
"53063013300",2782,154,31,0,93,0,46,0,3106
"53063013401",4170,159,21,0,468,0,193,0,5011
"53063013500",7273,198,79,1,451,150,401,49,8602
"53063013600",3051,645,63,60,508,62,325,11,4725
"53063013700",2350,270,168,0,298,52,194,24,3356
"53063013800",2074,88,97,0,149,43,155,0,2606
"53063013900",4219,351,36,110,207,44,87,9,5063
"53063014001",1874,1245,88,34,275,416,156,205,4293
"53063014002",2910,1619,44,148,193,0,107,222,5243
"53063014100",4550,406,36,173,359,106,98,0,5728
"53063014200",2322,551,0,0,80,123,19,15,3110
"53063014300",2411,316,5,0,152,26,83,33,3026
"53063014400",3585,385,22,101,590,61,223,21,4988
"53063014500",890,685,20,20,165,47,140,59,2026
"53065941000",202,86,0,12,1162,590,37,35,2124
"53065950100",6170,1101,10,5,261,81,82,30,7740
"53065950200",2751,555,0,0,52,183,107,2,3650
"53065950300",1868,499,0,1,86,142,23,122,2741
"53065950500",1592,438,0,21,55,47,18,66,2237
"53065950600",1995,384,0,0,87,20,12,10,2508
"53065950700",1846,376,0,61,177,24,45,15,2544
"53065950800",2447,349,0,0,137,8,78,0,3019
"53065950900",1263,246,0,0,91,10,19,3,1632
"53065951100",2304,776,64,0,192,90,39,23,3488
"53065951300",3517,425,15,0,127,25,145,124,4378
"53065951400",6469,909,23,0,497,99,130,86,8213
"53067010100",2420,535,36,0,167,17,100,27,3302
"53067010200",4161,589,21,31,457,202,253,59,5773
"53067010300",3327,882,48,53,315,270,263,304,5462
"53067010400",3224,185,9,29,287,0,130,0,3864
"53067010510",777,256,9,4,148,41,29,15,1279
"53067010520",3426,917,87,18,416,109,314,80,5367
"53067010600",3901,1384,15,0,379,464,211,206,6560
"53067010700",4882,455,24,0,937,0,547,0,6845
"53067010800",5527,591,30,0,718,33,377,169,7445
"53067010910",4768,484,254,67,1228,218,404,26,7449
"53067010920",3008,465,94,47,216,164,100,198,4292
"53067011000",3954,596,0,0,271,59,227,13,5120
"53067011100",2632,366,95,6,734,56,314,34,4237
"53067011200",2933,665,163,0,482,150,338,108,4839
"53067011300",3020,211,170,7,603,98,256,33,4398
"53067011410",3458,417,70,6,752,202,108,253,5266
"53067011420",5432,325,183,13,951,205,550,89,7748
"53067011500",3904,947,91,0,575,345,581,279,6722
"53067011610",4849,674,440,43,1223,147,581,141,8098
"53067011621",3998,815,549,169,1367,271,583,133,7885
"53067011622",2820,357,220,116,965,69,424,14,4985
"53067011623",3818,247,253,38,1170,29,339,22,5916
"53067011624",2921,298,100,0,493,142,149,106,4209
"53067011710",6376,260,141,0,918,15,231,1,7942
"53067011720",3973,170,48,0,478,58,134,23,4884
"53067011810",3192,153,0,0,172,34,52,15,3618
"53067011821",3506,248,50,0,110,90,232,27,4263
"53067011822",3389,424,0,0,398,90,105,109,4515
"53067011900",6186,473,0,22,364,10,20,32,7107
"53067012000",5264,603,0,0,807,154,319,94,7241
"53067012100",3677,217,0,0,116,0,91,0,4101
"53067012211",1890,207,67,4,271,37,147,95,2718
"53067012212",4585,602,229,23,1573,22,358,0,7392
"53067012221",3874,82,327,159,793,96,295,9,5635
"53067012222",5648,162,278,209,1077,139,461,4,7978
"53067012310",6203,349,1014,50,2461,71,1221,63,11432
"53067012320",1602,236,88,0,657,510,376,19,3488
"53067012330",2747,427,343,14,1125,104,645,251,5656
"53067012411",4962,1537,163,14,535,202,546,327,8286
"53067012412",3208,477,38,0,518,426,255,144,5066
"53067012420",3529,221,9,0,358,252,380,0,4749
"53067012510",2426,407,54,11,251,27,293,9,3478
"53067012520",6119,405,95,0,389,68,218,87,7381
"53067012530",3534,206,53,8,250,101,197,73,4422
"53067012610",5051,244,137,0,370,1,199,0,6002
"53067012620",3198,1037,4,2,310,29,149,273,5002
"53067012710",1697,270,0,0,246,35,193,28,2469
"53067012720",4775,924,9,0,869,83,1102,451,8213
"53067012730",4917,209,0,0,381,1,39,1,5548
"53067990100",0,0,0,0,0,0,0,0,0
"53069950100",2861,808,0,0,187,45,87,23,4011
"53071920000",4207,485,4,8,255,83,1245,239,6526
"53071920100",3822,520,36,0,208,42,410,48,5086
"53071920200",2911,737,0,4,571,43,1007,467,5740
"53071920300",5544,1173,39,6,837,111,1161,270,9141
"53071920400",0,0,0,0,0,0,0,0,0
"53071920500",1354,903,13,22,662,51,1266,477,4748
"53071920600",3629,1082,20,13,428,181,1463,421,7237
"53071920701",2913,651,9,0,238,168,408,270,4657
"53071920702",3638,434,0,0,241,139,393,110,4955
"53071920801",3560,935,35,0,672,36,658,31,5927
"53071920802",1330,600,0,0,242,145,194,193,2704
"53071920900",7338,431,23,19,448,47,498,12,8816
"53073000100",6620,1036,124,19,1525,76,289,182,9871
"53073000200",7273,1267,87,0,622,252,780,274,10555
"53073000300",4462,1160,40,95,844,974,370,751,8696
"53073000400",5438,473,0,0,241,132,231,150,6665
"53073000501",3261,974,20,1,178,16,105,169,4724
"53073000502",1715,493,0,0,306,41,191,39,2785
"53073000600",517,386,17,0,141,89,62,56,1268
"53073000700",4045,1133,94,0,1083,766,1130,415,8666
"53073000803",4284,587,49,1,626,405,178,198,6328
"53073000804",5794,469,103,0,394,76,293,86,7215
"53073000805",3905,678,0,1,442,22,163,166,5377
"53073000806",6957,620,0,38,528,198,423,166,8930
"53073000901",4494,1556,0,16,634,136,599,178,7613
"53073000902",4788,608,153,0,507,30,213,76,6375
"53073001000",1207,1468,16,21,341,178,177,129,3537
"53073001100",5436,698,11,34,422,142,95,91,6929
"53073001201",2885,3007,0,103,202,562,91,280,7130
"53073001202",2977,352,12,0,145,26,12,11,3535
"53073010100",6945,1577,2,0,492,173,505,36,9730
"53073010200",6749,891,3,17,641,127,797,311,9536
"53073010301",5999,271,39,0,166,26,779,0,7280
"53073010302",4102,452,21,2,244,12,666,62,5561
"53073010303",4161,337,16,0,859,128,497,0,5998
"53073010401",6611,649,45,0,831,177,282,96,8691
"53073010403",3473,340,13,38,801,29,20,0,4714
"53073010404",5196,848,97,0,497,181,168,171,7158
"53073010501",5602,575,157,0,649,291,297,194,7765
"53073010502",5276,926,73,0,852,270,849,304,8550
"53073010600",5229,327,35,0,821,18,668,1,7099
"53073010701",4707,275,67,1,115,12,411,24,5612
"53073010702",2880,334,0,0,792,218,618,96,4938
"53073010900",884,53,7,0,127,8,5,0,1084
"53073011000",1023,196,16,0,58,30,13,0,1336
"53073940000",1659,307,29,0,2031,870,203,46,5145
"53075000100",516,2238,0,43,155,459,8,189,3608
"53075000200",4109,1157,0,0,722,398,199,132,6717
"53075000300",3793,608,62,10,432,95,268,46,5314
"53075000400",2823,778,103,31,195,93,63,84,4170
"53075000500",130,365,0,0,70,361,22,25,973
"53075000600",1131,3335,126,264,841,1098,127,379,7301
"53075000700",3005,417,9,1,82,10,65,8,3597
"53075000800",2866,526,32,0,64,61,38,29,3616
"53075000900",3153,349,20,13,196,35,154,32,3952
"53075001000",1947,180,0,0,27,23,16,11,2204
"53077000100",869,646,33,24,238,450,601,777,3638
"53077000200",1648,1445,77,67,1451,980,2491,1634,9793
"53077000300",1971,861,0,0,760,453,882,847,5774
"53077000400",6013,426,43,4,891,11,980,125,8493
"53077000500",3692,285,0,16,725,161,996,23,5898
"53077000600",2131,2006,22,17,2207,1315,3711,2545,13954
"53077000700",3319,869,151,0,2172,655,2887,1001,11054
"53077000800",3346,189,51,0,740,16,736,6,5084
"53077000901",5620,216,210,0,1254,30,872,0,8202
"53077000902",2635,414,0,0,1156,79,1148,0,5432
"53077001000",4346,775,0,0,559,139,1478,97,7394
"53077001100",4556,610,10,148,1175,574,1477,583,9133
"53077001201",1583,398,60,0,744,710,1377,871,5743
"53077001202",3561,698,58,18,1158,742,2682,1083,10000
"53077001300",1350,296,0,0,491,248,911,328,3624
"53077001400",1472,663,27,53,812,431,1198,560,5216
"53077001501",2416,2146,33,7,1027,996,2999,2339,11963
"53077001502",1072,473,21,2,874,391,1515,690,5038
"53077001601",1762,287,0,0,205,48,297,42,2641
"53077001602",5242,412,10,0,954,37,1045,88,7788
"53077001701",2194,208,0,10,87,189,313,234,3235
"53077001702",4373,354,13,21,903,194,1986,407,8251
"53077001800",5410,513,0,0,1044,194,3429,440,11030
"53077001901",1862,1400,57,0,514,331,1472,1389,7025
"53077001902",3852,1288,45,40,851,325,3619,1552,11572
"53077002001",4107,2115,11,0,1073,888,4420,2920,15534
"53077002002",6324,2044,0,0,969,11,5495,1910,16753
"53077002101",1435,387,0,0,201,4,685,353,3065
"53077002102",5058,2200,6,0,823,214,3909,2337,14547
"53077002200",5583,1577,0,0,577,738,2380,1986,12841
"53077002701",1918,719,0,0,454,58,2002,729,5880
"53077002801",4678,218,0,0,369,8,534,85,5892
"53077002802",6990,513,21,0,825,232,1464,351,10396
"53077002900",4284,425,0,0,832,705,1709,977,8932
"53077003001",3460,479,0,2,203,210,148,210,4712
"53077003002",2509,631,0,42,127,202,138,383,4032
"53077003100",4217,396,0,0,368,104,347,300,5732
"53077003200",5027,640,36,0,887,125,973,254,7942
"53077003400",3573,491,146,0,261,40,398,8,4917
"53077940001",2846,792,3,77,1734,682,1893,579,8606
"53077940002",1904,653,33,12,1471,412,1179,483,6147
"53077940003",1204,135,3,0,1183,867,266,107,3765
"53077940004",2818,1593,0,69,1335,1125,3368,1835,12143
"53077940005",2209,1606,0,54,558,216,1892,1462,7997
"53077940006",2039,1301,10,0,936,458,2383,1639,8766
"54001965500",3693,269,89,0,0,0,24,0,4075
"54001965600",2272,884,14,0,23,83,0,13,3289
"54001965700",3745,1248,0,0,135,0,58,0,5186
"54001965800",3000,642,0,0,45,87,10,2,3786
"54003971101",3819,751,367,0,251,92,83,117,5480
"54003971102",7014,1001,187,0,218,23,189,128,8760
"54003971201",7505,953,962,0,240,0,215,0,9875
"54003971202",4567,407,0,0,82,0,27,66,5149
"54003971300",6274,1294,531,353,710,78,605,44,9889
"54003971400",7935,778,550,12,408,0,295,11,9989
"54003971500",2541,593,307,153,236,292,17,184,4323
"54003971600",2707,787,265,208,93,84,146,3,4293
"54003971700",3422,1400,170,396,185,195,111,250,6129
"54003971800",7446,554,12,0,159,0,315,0,8486
"54003971900",7027,1515,692,13,539,10,355,17,10168
"54003972000",8028,1466,958,258,498,346,266,26,11846
"54003972101",4074,474,390,13,137,0,77,0,5165
"54003972102",7748,809,617,109,406,46,382,20,10137
"54005958200",3299,1209,0,0,0,0,9,0,4517
"54005958300",3076,809,0,0,25,0,1,0,3911
"54005958400",1553,496,50,0,6,0,0,0,2105
"54005958501",2399,387,23,0,1,0,22,0,2832
"54005958502",2537,690,105,0,25,13,0,13,3383
"54005958600",1798,435,0,0,24,0,15,0,2272
"54005958700",1654,439,0,0,14,0,6,0,2113
"54005958800",2265,599,12,0,80,0,40,6,3002
"54007967900",3723,912,0,0,58,0,9,13,4715
"54007968000",3344,944,23,0,28,13,6,0,4358
"54007968100",3744,1007,10,28,12,56,40,12,4909
"54009031101",4102,728,160,0,16,117,34,12,5169
"54009031102",4195,242,9,0,0,0,27,0,4473
"54009031200",2687,431,24,51,6,40,3,6,3248
"54009031400",3216,610,41,0,4,0,0,0,3871
"54009031600",2854,372,0,0,104,1,25,0,3356
"54009031700",2210,481,0,4,28,19,10,28,2780
"54011000101",1049,780,17,27,43,0,73,0,1989
"54011000102",1435,455,39,53,7,8,0,8,2005
"54011000200",1854,855,0,37,46,80,38,0,2910
"54011000300",1663,701,31,0,8,103,24,0,2530
"54011000400",1187,1642,32,60,132,38,0,17,3108
"54011000500",189,364,0,197,0,114,0,12,876
"54011000600",310,583,10,54,31,104,3,0,1095
"54011000900",623,649,14,120,2,60,13,1,1482
"54011001000",1272,629,0,0,132,110,16,16,2175
"54011001100",1076,516,25,13,43,13,0,7,1693
"54011001200",2310,307,249,62,70,0,20,0,3018
"54011001300",1976,655,122,39,29,0,46,0,2867
"54011001400",1005,458,511,360,36,28,81,61,2540
"54011001500",509,397,490,302,126,185,0,0,2009
"54011001600",592,325,92,9,53,59,0,0,1130
"54011001800",1630,1266,162,327,112,93,0,0,3590
"54011001900",1863,265,0,0,71,74,14,52,2339
"54011002000",2767,143,158,15,180,89,53,16,3421
"54011002100",2839,344,10,0,67,12,32,0,3304
"54011010102",5204,891,0,0,55,0,54,20,6224
"54011010201",4290,541,94,0,315,74,86,0,5400
"54011010202",3297,357,14,18,58,27,0,27,3798
"54011010300",2527,215,39,0,108,9,0,0,2898
"54011010400",5494,638,87,6,140,103,109,0,6577
"54011010500",4620,905,0,0,107,114,45,114,5905
"54011010600",3115,592,0,0,37,88,0,0,3832
"54011010700",6725,667,15,9,120,17,37,0,7590
"54011010800",5386,618,13,7,56,0,0,0,6080
"54011010900",676,774,91,68,49,56,42,0,1756
"54013962600",2558,894,1,0,41,48,21,2,3565
"54013962700",3137,704,7,0,17,61,0,0,3926
"54015957900",2468,1056,0,0,51,0,10,0,3585
"54015958000",2659,834,0,0,8,0,0,0,3501
"54015958100",1581,425,0,0,18,4,0,0,2028
"54017965000",3332,376,2,0,24,39,26,0,3799
"54017965100",3107,763,11,0,65,0,58,0,4004
"54019020100",4065,917,18,0,201,0,21,0,5222
"54019020201",2591,1092,523,92,30,0,17,0,4345
"54019020202",2957,1030,206,27,24,66,48,0,4358
"54019020300",2308,654,7,0,12,6,0,31,3018
"54019020400",2672,891,329,165,31,38,46,0,4172
"54019020500",1261,762,92,161,29,8,12,0,2325
"54019020600",1729,304,0,4,14,0,22,13,2086
"54019020700",2842,775,231,2,78,16,32,4,3980
"54019020800",3642,595,101,98,58,37,7,2,4540
"54019020900",3836,557,18,0,0,0,33,22,4466
"54019021000",2212,447,0,0,6,8,50,0,2723
"54019021100",2337,492,0,0,3,0,0,5,2837
"54021967700",3254,1130,0,0,27,82,0,0,4493
"54021967800",1202,627,20,72,100,63,11,0,2095
"54023969400",2663,454,0,1,14,0,21,0,3153
"54023969500",3190,740,0,0,0,0,32,0,3962
"54023969600",3568,788,33,63,164,0,31,4,4651
"54025950100",3657,971,175,134,57,54,12,12,5072
"54025950200",3188,746,59,0,37,52,4,42,4128
"54025950300",2926,702,20,0,40,31,27,7,3753
"54025950400",5578,1271,80,0,371,47,232,0,7579
"54025950500",2604,533,18,22,52,15,9,6,3259
"54025950600",4414,660,120,25,110,50,0,46,5425
"54025950700",4456,1219,70,41,46,202,16,26,6076
"54027968200",3865,654,50,0,14,0,40,28,4651
"54027968300",4197,1331,28,0,159,74,56,0,5845
"54027968400",3247,1123,44,0,28,28,58,5,4533
"54027968500",2552,598,0,23,9,0,38,0,3220
"54027968600",4043,922,53,40,0,0,33,0,5091
"54029020600",3569,280,142,0,89,5,74,0,4159
"54029020700",3596,463,50,20,65,82,36,6,4318
"54029020900",2334,496,105,0,61,0,15,12,3023
"54029021100",3096,491,113,0,13,3,41,3,3760
"54029021200",2758,696,0,0,30,1,2,0,3487
"54029021300",2001,1011,117,37,3,94,3,99,3365
"54029021400",2853,534,167,16,36,6,36,4,3652
"54029021500",3794,657,0,0,16,0,0,0,4467
"54031970100",4293,679,59,2,15,3,53,56,5160
"54031970200",3700,553,398,55,100,16,92,59,4973
"54031970300",3200,634,0,10,5,132,72,152,4205
"54033030100",1553,903,109,40,87,61,37,0,2790
"54033030200",1928,756,0,0,13,32,39,32,2800
"54033030300",2013,626,82,7,18,3,0,0,2749
"54033030400",2387,265,249,58,142,0,34,0,3135
"54033030500",3750,526,16,41,57,19,19,0,4428
"54033030601",2299,228,50,0,27,22,0,22,2648
"54033030602",5036,902,30,0,164,57,99,0,6288
"54033030700",2095,301,9,0,33,8,0,0,2446
"54033030800",3356,880,0,0,37,15,63,66,4417
"54033031000",2838,581,26,10,58,14,41,9,3577
"54033031100",1681,401,4,95,120,0,47,88,2436
"54033031200",2143,131,17,0,55,4,92,11,2453
"54033031300",2211,322,19,0,24,0,26,0,2602
"54033031400",2309,387,0,0,96,55,9,0,2856
"54033031500",1404,160,0,0,0,0,0,0,1564
"54033031600",1676,366,63,4,37,15,27,8,2196
"54033031700",1452,652,0,0,0,0,8,0,2112
"54033031800",1796,445,0,0,54,0,13,0,2308
"54033031900",1950,448,0,0,20,58,4,0,2480
"54033032000",1970,386,1,2,0,0,42,0,2401
"54033032101",3418,479,25,42,0,0,0,0,3964
"54033032102",5679,83,102,19,289,0,111,0,6283
"54035963200",3891,891,56,0,120,57,8,0,5023
"54035963300",3185,859,0,0,79,74,0,0,4197
"54035963400",3771,605,0,0,0,0,0,0,4376
"54035963500",2689,281,0,0,28,0,0,0,2998
"54035963600",3142,1080,0,0,27,8,0,0,4257
"54035963700",6430,1357,0,156,0,96,0,0,8039
"54037972201",3091,219,161,73,125,40,75,19,3803
"54037972203",1758,180,44,3,68,0,63,3,2119
"54037972204",1834,276,34,0,72,0,35,9,2260
"54037972300",3934,523,340,6,303,39,221,45,5411
"54037972401",1345,315,385,0,511,146,476,108,3286
"54037972402",3341,328,314,226,243,48,207,28,4735
"54037972501",4000,218,364,32,145,35,355,0,5149
"54037972503",2278,324,350,8,14,179,156,11,3320
"54037972505",1675,344,266,164,18,32,64,34,2597
"54037972506",2004,241,333,25,300,0,392,18,3313
"54037972601",1763,227,50,0,44,27,16,0,2127
"54037972602",4032,109,64,0,36,0,74,0,4315
"54037972701",2368,259,0,0,86,0,15,0,2728
"54037972702",3274,413,41,19,196,0,166,12,4121
"54037972800",4899,1371,76,32,39,148,61,28,6654
"54039000100",510,315,112,124,90,135,3,21,1310
"54039000200",1202,327,227,167,131,68,3,0,2125
"54039000300",2581,235,71,27,77,63,5,0,3059
"54039000500",1648,292,65,27,79,35,29,0,2175
"54039000600",2842,649,229,226,348,9,43,10,4356
"54039000700",495,385,480,183,286,147,16,0,1992
"54039000800",587,292,157,152,205,122,7,0,1522
"54039000900",365,148,76,45,51,14,20,0,719
"54039001100",3192,914,246,358,349,65,0,16,5140
"54039001200",613,325,190,106,121,254,54,55,1718
"54039001300",1249,298,127,47,286,128,47,55,2237
"54039001500",3658,161,61,32,186,13,20,0,4131
"54039001700",1341,408,20,0,56,14,0,0,1839
"54039001800",1742,289,30,4,414,26,171,0,2676
"54039001901",3497,72,53,0,379,34,58,0,4093
"54039001902",3230,347,15,0,250,0,0,0,3842
"54039002000",3085,90,142,0,45,0,13,0,3375
"54039002100",3730,980,135,118,337,13,52,0,5365
"54039010100",2957,361,181,30,157,61,25,55,3827
"54039010200",1643,332,59,97,35,0,0,0,2166
"54039010300",1745,303,181,16,48,14,47,0,2354
"54039010400",242,131,436,138,90,27,6,0,1070
"54039010500",4203,622,141,32,194,0,179,0,5371
"54039010600",4716,447,15,0,71,54,0,0,5303
"54039010701",4669,364,153,24,18,235,45,0,5508
"54039010702",4354,525,154,0,41,0,0,0,5074
"54039010801",5828,520,0,0,390,222,0,0,6960
"54039010802",3135,463,0,0,210,45,0,0,3853
"54039010900",2547,252,0,0,75,61,154,45,3134
"54039011000",4381,256,23,0,221,0,0,0,4881
"54039011100",4080,731,4,0,266,117,0,0,5198
"54039011200",2821,492,6,0,248,23,8,0,3598
"54039011301",2172,466,0,0,135,21,57,12,2863
"54039011302",4532,509,0,0,514,20,12,0,5587
"54039011401",1438,333,0,0,223,93,5,4,2096
"54039011402",3240,299,38,0,140,90,10,0,3817
"54039011500",2906,461,254,27,195,107,0,17,3967
"54039011800",3555,779,60,0,653,219,0,0,5266
"54039012100",2517,496,36,78,631,55,62,0,3875
"54039012200",3243,799,57,29,302,179,53,0,4662
"54039012300",5504,1117,10,0,277,17,26,4,6955
"54039012800",3848,219,103,12,148,35,17,0,4382
"54039012900",1090,146,51,0,34,53,8,0,1382
"54039013000",3439,569,123,66,327,0,0,0,4524
"54039013100",2967,582,198,118,100,126,26,20,4137
"54039013200",2566,542,39,11,92,0,12,0,3262
"54039013300",2360,48,22,0,42,0,19,0,2491
"54039013400",1459,402,95,44,119,149,42,9,2319
"54039013500",2469,81,39,19,91,30,0,0,2729
"54039013600",3415,786,150,25,108,19,50,11,4564
"54039013701",1923,147,19,0,73,0,0,0,2162
"54039013702",5509,938,10,0,21,0,79,0,6557
"54039013800",2036,666,16,0,22,44,0,21,2805
"54041967200",2635,754,1,0,114,23,0,0,3527
"54041967300",3315,365,0,0,46,0,0,0,3726
"54041967400",2081,495,0,0,9,11,20,0,2616
"54041967500",1746,985,98,23,8,0,7,0,2867
"54041967600",2892,517,0,0,61,20,0,0,3490
"54043955400",5097,1665,33,27,32,0,0,0,6854
"54043955500",3007,646,0,0,0,5,0,0,3658
"54043955600",2600,1410,0,0,29,40,3,26,4108
"54043955700",2629,515,26,0,0,59,0,0,3229
"54043955800",2310,1333,11,0,56,10,0,0,3720
"54045956101",5890,1053,14,1,51,18,79,13,7119
"54045956102",2695,691,0,0,10,0,13,0,3409
"54045956200",2180,632,169,24,89,15,22,0,3131
"54045956400",2966,617,42,19,42,42,0,0,3728
"54045956500",1528,554,0,41,0,14,9,0,2146
"54045956600",4037,559,146,0,35,0,65,0,4842
"54045956700",3072,874,39,127,11,0,71,0,4194
"54045956800",3638,985,0,56,0,0,0,0,4679
"54045956900",1682,572,38,55,122,12,5,12,2498
"54047953600",495,374,222,89,0,12,0,0,1192
"54047953800",2338,893,63,14,15,41,0,0,3364
"54047953900",1343,897,0,1,0,0,0,0,2241
"54047954000",1177,587,0,0,0,2,0,0,1766
"54047954200",1228,961,25,0,0,0,2,0,2216
"54047954501",905,453,289,42,22,0,0,0,1711
"54047954503",1864,690,442,308,24,23,7,0,3358
"54047954504",2574,1727,89,0,34,31,0,0,4455
"54049020100",431,579,88,199,11,84,0,22,1414
"54049020200",1167,806,26,154,38,21,0,21,2233
"54049020300",3294,274,12,0,145,0,21,0,3746
"54049020400",1025,154,29,38,47,0,14,4,1311
"54049020500",634,605,586,175,86,22,0,8,2116
"54049020600",1349,221,35,0,15,0,6,0,1626
"54049020700",2913,930,0,0,16,0,0,0,3859
"54049020800",2262,459,9,17,0,8,37,0,2792
"54049020900",3258,732,0,0,50,0,31,0,4071
"54049021000",4475,323,44,0,0,0,82,0,4924
"54049021100",2474,173,75,1,53,0,116,0,2892
"54049021200",5315,440,63,2,379,5,165,3,6372
"54049021300",2801,531,19,1,14,4,0,0,3370
"54049021400",1615,155,29,27,36,0,3,0,1865
"54049021500",3109,385,99,90,0,0,9,0,3692
"54049021600",3685,747,0,4,91,30,8,0,4565
"54049021700",1738,191,0,0,29,15,0,0,1973
"54049021800",2424,616,43,0,10,10,31,0,3134
"54051020200",1531,365,0,0,26,16,30,26,1994
"54051020500",667,206,9,51,10,4,3,6,956
"54051020601",1724,327,0,0,22,0,0,4,2077
"54051020702",1119,237,2,27,5,6,5,0,1401
"54051020800",4304,605,0,0,20,23,62,23,5037
"54051020900",4569,600,46,0,28,0,0,0,5243
"54051021000",5104,936,20,44,50,14,52,11,6231
"54051021100",3881,729,0,53,76,16,14,16,4785
"54051021300",3682,545,8,0,125,0,7,41,4408
"54053954801",2094,482,35,0,86,55,0,0,2752
"54053954802",3481,710,6,0,74,0,0,0,4271
"54053954900",5097,1211,0,0,124,0,0,0,6432
"54053955000",4195,637,149,0,26,73,0,69,5149
"54053955101",2451,590,0,0,0,0,63,0,3104
"54053955102",3831,999,0,0,34,0,11,0,4875
"54055000900",2051,815,0,50,73,25,0,22,3036
"54055001000",3885,1165,0,0,37,0,26,6,5119
"54055001100",4561,446,3,30,222,36,24,0,5322
"54055001200",2699,435,8,0,29,122,6,4,3303
"54055001300",2832,1157,26,106,57,123,48,44,4393
"54055001400",1474,284,182,77,42,110,19,50,2238
"54055001500",4367,988,72,36,174,115,0,0,5752
"54055001600",1048,301,12,10,15,9,0,0,1395
"54055001700",3429,1408,9,90,50,0,22,0,5008
"54055001800",4055,1201,26,145,27,53,0,8,5515
"54055001900",636,217,464,264,2,5,0,9,1597
"54055002000",1384,410,440,322,52,11,15,0,2634
"54055002100",2496,323,226,59,19,53,15,11,3202
"54055002200",3175,612,433,120,120,31,125,0,4616
"54055002300",4094,823,76,32,93,63,63,0,5244
"54055002400",2370,527,14,35,28,0,8,0,2982
"54057010100",1853,410,0,0,16,0,0,1,2280
"54057010200",2763,548,4,0,9,0,0,0,3324
"54057010300",3961,684,0,39,7,0,27,0,4718
"54057010400",3909,606,0,0,21,0,0,0,4536
"54057010500",3925,424,75,64,55,0,0,0,4543
"54057010600",3508,1403,158,215,145,225,168,11,5833
"54057010700",1450,390,158,54,21,22,17,3,2115
"54059957100",3524,665,0,0,0,0,13,0,4202
"54059957200",2642,796,0,0,0,7,0,0,3445
"54059957300",3310,636,0,17,49,9,35,6,4062
"54059957400",2374,738,163,136,137,202,0,0,3750
"54059957500",2327,949,32,18,84,13,38,11,3472
"54059957600",2392,915,8,39,8,16,0,0,3378
"54059957700",2972,836,0,0,7,0,0,0,3815
"54061010101",114,341,4,3,8,22,5,13,510
"54061010102",869,1701,34,24,85,276,50,43,3082
"54061010201",2180,1987,105,40,260,126,86,27,4811
"54061010202",1675,2115,33,13,257,66,11,29,4199
"54061010400",3075,274,120,215,165,89,4,0,3942
"54061010600",2518,1991,218,132,352,245,113,8,5577
"54061010700",1766,827,226,250,158,115,26,15,3383
"54061010800",3315,677,20,142,160,81,5,0,4400
"54061010901",1997,1081,20,224,89,50,29,0,3490
"54061010902",2932,337,128,24,112,41,53,0,3627
"54061011000",2390,1090,22,43,42,127,38,78,3830
"54061011100",1757,578,63,16,26,0,0,6,2446
"54061011200",2953,519,46,27,52,128,4,0,3729
"54061011300",3503,454,0,0,75,0,98,0,4130
"54061011400",3301,469,0,0,82,0,0,0,3852
"54061011500",4495,495,0,0,27,0,33,0,5050
"54061011600",3545,911,110,0,611,121,84,153,5535
"54061011700",3458,259,157,86,125,0,0,0,4085
"54061011803",2694,452,109,0,12,14,38,0,3319
"54061011804",3288,113,0,0,8,6,69,0,3484
"54061011805",4628,400,0,0,112,120,107,120,5487
"54061011806",4385,305,97,0,146,10,53,66,5062
"54061011900",3643,369,47,0,80,0,15,0,4154
"54061012000",2510,501,106,24,374,101,50,0,3666
"54063950100",2847,650,0,2,95,14,0,0,3608
"54063950200",3525,740,12,64,45,67,19,0,4472
"54063950300",4671,658,0,0,0,12,80,0,5421
"54065970700",5237,592,0,0,10,58,20,0,5917
"54065970800",3150,694,18,11,130,0,20,19,4042
"54065970900",2101,534,5,18,78,10,45,0,2791
"54065971000",4121,358,54,28,42,0,34,39,4676
"54067950100",2689,381,0,0,40,0,0,0,3110
"54067950200",5023,1261,0,4,0,0,0,0,6288
"54067950300",1061,253,0,0,0,0,0,0,1314
"54067950400",3325,1100,0,0,0,0,0,0,4425
"54067950500",923,427,0,0,49,0,17,0,1416
"54067950600",4743,702,0,0,295,32,0,0,5772
"54067950700",2658,624,0,0,31,195,0,0,3508
"54069000200",2493,570,11,50,36,0,72,6,3238
"54069000300",1509,171,60,33,51,130,15,0,1969
"54069000400",601,470,36,32,13,7,8,0,1167
"54069000500",1041,280,72,36,58,27,38,0,1552
"54069000600",681,405,16,156,25,0,0,0,1283
"54069000700",444,124,136,112,13,8,7,1,845
"54069001300",1170,282,0,4,129,0,0,0,1585
"54069001400",2271,248,7,32,124,0,15,0,2697
"54069001500",2045,207,0,2,83,0,108,25,2470
"54069001600",1729,218,0,0,75,0,0,0,2022
"54069001700",1427,43,0,0,117,1,0,0,1588
"54069001800",4290,771,130,287,27,50,22,15,5592
"54069001901",2303,184,0,0,57,8,5,0,2557
"54069002000",4890,204,16,8,8,0,14,12,5152
"54069002100",2351,497,2,9,35,0,7,0,2901
"54069002200",2204,253,32,0,19,0,0,0,2508
"54069002600",1345,610,0,28,7,7,0,0,1997
"54069002700",236,396,150,18,6,0,6,0,812
"54071970400",1266,383,0,0,7,10,6,0,1672
"54071970500",2794,693,70,10,17,0,72,0,3656
"54071970600",1613,357,107,4,57,0,0,0,2138
"54073962100",2321,563,0,0,23,0,28,0,2935
"54073962200",3401,536,0,33,71,33,10,34,4118
"54075960101",1032,153,0,0,0,1,9,1,1196
"54075960102",916,175,63,2,16,0,0,0,1172
"54075960200",2780,781,6,32,78,43,5,12,3737
"54075960300",2042,192,0,0,0,20,5,4,2263
"54077963800",3658,568,0,0,28,0,19,0,4273
"54077963900",3180,500,0,0,53,0,0,0,3733
"54077964000",3086,672,83,0,14,86,15,0,3956
"54077964100",3840,708,20,0,42,0,23,0,4633
"54077964200",3365,571,0,0,35,0,9,0,3980
"54077964300",3915,606,0,0,6,6,11,0,4544
"54077964400",2717,441,0,0,63,0,10,2,3233
"54077964500",2722,254,2,2,33,0,0,0,3013
"54079020100",4110,885,0,0,0,0,20,0,5015
"54079020200",4595,660,0,0,83,0,91,0,5429
"54079020300",4249,207,48,0,33,0,26,0,4563
"54079020400",5963,508,5,0,94,173,11,0,6754
"54079020500",5377,718,7,0,14,0,90,0,6206
"54079020601",5065,216,158,0,108,0,15,0,5562
"54079020603",6247,832,0,0,209,0,184,22,7494
"54079020604",2109,258,184,232,148,0,0,0,2931
"54079020605",6864,609,0,0,234,0,61,0,7768
"54079020700",4155,353,24,14,81,0,12,0,4639
"54081000200",1308,306,782,579,188,243,23,0,3429
"54081000300",2423,356,967,327,127,134,17,0,4351
"54081000400",1656,543,615,423,34,2,0,13,3286
"54081000500",3266,378,186,20,61,38,99,36,4084
"54081000600",2689,634,263,561,345,154,0,0,4646
"54081000700",2545,393,133,45,17,27,22,0,3182
"54081000802",3554,361,11,64,54,0,25,0,4069
"54081000803",4084,488,0,0,120,87,14,78,4871
"54081000804",5055,355,21,0,0,2,0,0,5433
"54081000900",4451,1022,0,3,28,54,81,0,5639
"54081001001",4293,722,0,0,4,0,29,0,5048
"54081001002",2506,543,21,0,0,117,0,72,3259
"54081001100",4983,787,34,10,169,0,8,0,5991
"54081001200",3779,1001,0,0,0,0,0,0,4780
"54081001300",3827,811,82,25,30,61,96,0,4932
"54081001400",3983,468,35,3,89,109,54,58,4799
"54081001500",3078,565,175,7,135,11,34,0,4005
"54083965900",3097,566,73,0,0,41,0,34,3811
"54083966000",3350,542,0,5,94,0,27,19,4037
"54083966100",2346,708,138,0,93,109,13,98,3505
"54083966200",3544,482,0,0,10,3,0,0,4039
"54083966300",2588,452,0,0,33,0,0,0,3073
"54083966400",4759,653,6,7,31,20,13,0,5489
"54083966500",2751,764,0,0,0,0,0,0,3515
"54085962300",3344,904,12,0,52,2,32,21,4367
"54085962400",2331,218,0,0,60,0,0,0,2609
"54085962500",2369,746,24,0,13,9,4,5,3170
"54087962800",1816,394,0,0,29,1,5,0,2245
"54087962900",3388,644,0,0,49,17,21,0,4119
"54087963000",2279,1281,2,2,68,14,33,65,3744
"54087963100",3281,1176,0,0,74,31,0,0,4562
"54089000500",1732,593,85,0,22,63,70,0,2565
"54089000600",3965,579,33,25,0,8,78,0,4688
"54089000700",1025,408,80,68,9,0,0,0,1590
"54089000800",3318,399,33,1,91,0,85,0,3927
"54091964600",3474,1190,0,12,119,10,65,0,4870
"54091964700",3970,606,34,34,24,18,37,0,4723
"54091964800",3605,1095,28,0,97,5,55,0,4885
"54091964900",1642,348,40,0,0,0,0,0,2030
"54093965200",1460,223,0,6,0,26,5,5,1725
"54093965300",1785,213,0,0,0,0,8,21,2027
"54093965400",2476,563,0,0,72,8,0,0,3119
"54095961800",2762,746,0,10,41,18,45,2,3624
"54095961900",2766,484,0,0,6,2,2,4,3264
"54095962000",1784,363,0,0,14,0,1,0,2162
"54097966600",3574,955,0,0,91,14,0,0,4634
"54097966700",1604,737,5,16,36,0,0,122,2520
"54097966800",2599,970,6,0,0,0,31,103,3709
"54097966900",2726,574,0,0,47,0,0,0,3347
"54097967000",3842,703,32,72,23,48,0,0,4720
"54097967100",3607,708,0,0,24,22,0,0,4361
"54099005100",1529,398,3,0,0,7,0,0,1937
"54099005200",1810,121,0,4,30,0,0,0,1965
"54099020100",1975,241,1,0,77,17,16,12,2339
"54099020300",3829,595,0,0,11,36,19,0,4490
"54099020400",5526,768,0,22,74,0,100,0,6490
"54099020500",3373,1014,0,0,86,38,0,38,4549
"54099020600",4487,1142,35,0,145,0,42,0,5851
"54099020700",3109,413,0,0,0,0,0,0,3522
"54099020800",3055,1278,2,0,50,0,0,18,4403
"54099020900",2280,1192,0,0,32,0,0,0,3504
"54099021000",1645,790,0,0,92,17,0,0,2544
"54101970100",3550,969,0,0,61,0,29,0,4609
"54101970200",1571,579,0,0,29,51,15,0,2245
"54101970300",1696,415,0,0,0,0,0,0,2111
"54103004900",2744,773,0,0,34,0,17,27,3595
"54103030400",2198,723,0,0,15,0,13,3,2952
"54103030500",3191,967,0,0,33,27,0,0,4218
"54103030700",3335,669,7,0,69,0,23,9,4112
"54103030800",1256,80,8,0,0,33,8,0,1385
"54105030101",2509,601,21,0,52,18,0,0,3201
"54105030102",2054,472,0,0,15,8,0,0,2549
"54107000100",2554,818,11,0,84,0,10,0,3477
"54107000300",2068,431,22,43,74,13,15,0,2666
"54107000400",1994,90,24,0,24,0,16,0,2148
"54107000500",2477,1204,98,15,107,122,0,31,4054
"54107000701",1456,1012,48,66,19,64,36,0,2701
"54107000702",1142,330,6,0,32,15,5,15,1545
"54107000801",936,554,5,1,9,14,0,0,1519
"54107000802",2776,699,56,20,91,0,77,0,3719
"54107000901",1096,262,0,0,39,19,64,0,1480
"54107000902",996,294,11,5,42,17,0,0,1365
"54107000903",3246,940,4,6,10,79,0,0,4285
"54107010101",1753,245,0,0,7,0,7,0,2012
"54107010102",1602,236,16,0,13,0,0,0,1867
"54107010200",2736,198,15,0,14,0,33,0,2996
"54107010300",4094,262,31,0,164,31,104,31,4717
"54107010400",1585,223,12,21,48,2,0,0,1891
"54107010501",1143,382,0,0,33,41,21,41,1661
"54107010502",3177,589,47,28,143,9,0,0,3993
"54107010601",4040,418,32,0,198,71,52,34,4845
"54107010602",4063,565,0,0,68,0,43,0,4739
"54107010701",4381,1054,122,0,85,15,132,28,5817
"54107010702",6997,938,42,21,95,0,0,0,8093
"54107010800",2255,548,0,0,11,0,0,0,2814
"54107010901",4255,305,0,0,99,49,0,0,4708
"54107010902",3110,490,24,0,62,7,0,0,3693
"54107011000",2551,395,0,15,104,5,0,0,3070
"54109002800",2304,389,0,0,101,0,0,0,2794
"54109002901",3543,834,0,0,42,24,0,24,4467
"54109002902",2735,613,0,0,29,28,23,0,3428
"54109003000",1566,570,0,0,0,0,0,0,2136
"54109003100",3660,1296,0,28,0,3,0,0,4987
"54109003200",3928,1009,126,0,119,7,0,10,5199
"55001950100",2803,185,0,0,17,0,9,0,3014
"55001950201",1187,152,0,0,20,0,23,2,1384
"55001950202",2207,422,5,1,19,7,65,8,2734
"55001950400",3573,571,5,3,167,95,130,7,4551
"55001950501",1179,300,4,1,22,0,49,10,1565
"55001950502",2362,317,0,3,74,6,32,18,2812
"55001950700",3061,335,4,3,102,45,53,58,3661
"55003940000",594,115,9,0,667,425,55,9,1874
"55003950300",1756,173,0,12,181,147,32,51,2352
"55003950400",1592,487,0,0,96,54,15,65,2309
"55003950500",1815,286,0,0,79,9,10,4,2203
"55003950600",1166,176,9,4,25,10,0,4,1394
"55003950700",1795,354,0,0,47,12,27,5,2240
"55003950800",2455,274,0,0,466,80,29,0,3304
"55003990000",0,0,0,0,0,0,0,0,0
"55005000100",3489,300,0,1,59,11,27,2,3889
"55005000200",3091,523,0,0,146,61,126,46,3993
"55005000300",3307,451,32,21,238,47,156,15,4267
"55005000400",4082,534,423,0,76,0,53,0,5168
"55005000500",3799,604,0,0,104,45,66,0,4618
"55005000600",4470,1271,0,9,17,37,143,40,5987
"55005000800",4650,521,0,0,142,24,22,7,5366
"55005000900",4295,449,14,1,121,10,93,3,4986
"55005001001",1580,284,0,0,55,3,0,19,1941
"55005001002",4711,768,18,0,19,27,131,12,5686
"55007960100",1276,124,30,2,808,466,14,3,2723
"55007960200",1417,194,0,0,43,6,30,0,1690
"55007960300",2863,398,0,0,194,52,32,7,3546
"55007960400",4184,435,13,0,235,16,85,0,4968
"55007960600",1871,160,11,15,9,46,21,6,2139
"55007990000",0,0,0,0,0,0,0,0,0
"55009000100",1484,445,40,146,317,157,110,118,2817
"55009000200",4805,608,74,253,403,144,377,90,6754
"55009000302",3281,457,0,10,509,90,136,155,4638
"55009000303",1490,366,84,106,370,179,196,83,2874
"55009000401",3077,464,358,30,500,184,78,76,4767
"55009000402",1991,209,0,0,80,20,0,104,2404
"55009000500",2007,703,34,297,407,5,125,140,3718
"55009000600",3329,239,133,29,289,57,326,8,4410
"55009000700",3723,431,60,7,449,317,113,108,5208
"55009000800",935,448,74,60,213,83,483,44,2340
"55009000900",2494,550,35,0,534,304,1329,237,5483
"55009001000",564,287,48,12,120,48,38,10,1127
"55009001100",1149,631,3,30,78,119,389,435,2834
"55009001200",927,485,109,88,259,132,407,147,2554
"55009001300",1864,567,33,96,208,189,241,98,3296
"55009001400",2784,281,13,46,405,253,669,115,4566
"55009001600",3100,501,34,289,1306,384,1549,285,7448
"55009001701",1472,533,8,110,781,271,568,228,3971
"55009001702",2025,804,47,8,538,193,758,334,4707
"55009001801",3518,477,42,0,487,47,487,27,5085
"55009001802",3662,369,9,12,172,99,22,9,4354
"55009002001",6137,750,55,96,556,503,257,643,8997
"55009002002",4030,337,62,75,484,237,313,203,5741
"55009002003",2911,184,0,240,132,0,75,0,3542
"55009010100",5162,339,136,0,214,11,335,0,6197
"55009010201",2368,323,0,3,273,124,228,16,3335
"55009010202",4335,308,114,59,107,32,13,42,5010
"55009010300",5737,297,246,24,215,141,380,0,7040
"55009020100",5237,292,0,0,68,4,49,18,5668
"55009020203",5993,215,11,1,101,1,17,15,6354
"55009020204",5084,85,17,0,69,10,7,0,5272
"55009020502",3970,591,52,18,641,124,313,185,5894
"55009020503",7176,445,0,0,311,49,542,0,8523
"55009020504",4607,184,30,0,56,0,63,0,4940
"55009020600",4742,312,8,0,98,31,63,6,5260
"55009020702",5523,452,116,0,311,169,23,36,6630
"55009020703",6365,227,0,0,113,140,83,75,7003
"55009020704",5454,1308,43,0,1148,138,747,631,9469
"55009020800",1905,130,39,0,304,23,212,0,2613
"55009020900",2129,52,25,0,409,60,193,0,2868
"55009021000",2296,206,2,32,81,0,42,21,2680
"55009021100",0,0,0,0,0,0,0,0,0
"55009021200",4402,141,26,14,300,6,270,0,5159
"55009021301",2957,133,66,0,159,31,304,0,3650
"55009021302",5396,281,32,0,394,83,74,0,6260
"55009021303",2456,634,136,17,366,109,63,0,3781
"55009021304",1795,130,93,0,149,66,7,0,2240
"55009021400",6816,322,16,17,297,50,421,52,7991
"55009021500",2901,88,11,3,70,6,90,8,3177
"55009021600",5545,352,17,0,47,0,49,0,6010
"55009940001",13087,659,0,0,1695,178,129,0,15748
"55009940002",3918,339,50,0,688,28,192,0,5215
"55009940003",2554,191,33,38,396,318,52,54,3636
"55009940004",1958,110,0,45,359,152,71,21,2716
"55011960100",2277,282,18,0,24,0,14,1,2616
"55011960200",2172,491,0,0,61,38,6,0,2768
"55011960300",1724,230,0,0,46,28,75,28,2131
"55011960400",2223,216,0,12,55,0,72,1,2579
"55011960500",2944,309,6,0,40,0,48,0,3347
"55013970400",3230,413,24,4,149,126,41,11,3998
"55013970600",1398,157,3,19,255,100,37,4,1973
"55013970700",2087,156,0,0,156,32,8,0,2439
"55013970800",1652,475,0,10,30,73,7,5,2252
"55013970900",2101,518,0,3,102,116,55,3,2898
"55013971000",1513,255,5,0,23,4,15,2,1817
"55015020100",4346,205,37,0,44,0,184,0,4816
"55015020200",3353,236,14,14,87,8,132,8,3852
"55015020303",2947,192,107,3,670,0,241,0,4160
"55015020304",3047,343,0,9,228,14,181,0,3822
"55015020306",5802,62,0,0,505,0,122,0,6491
"55015020308",3363,108,40,0,15,0,147,20,3693
"55015020400",3138,189,0,0,49,18,68,0,3462
"55015020500",4436,594,0,5,4,0,48,88,5175
"55015020600",4553,526,34,0,41,22,43,0,5219
"55015020700",3976,41,0,0,164,14,81,14,4290
"55015020800",5017,183,39,0,157,226,134,313,6069
"55017010100",2405,181,0,0,194,171,0,0,2951
"55017010200",5794,301,146,0,289,52,23,27,6632
"55017010300",4618,1127,63,0,43,0,100,0,5951
"55017010400",4266,325,0,1,218,3,76,0,4889
"55017010500",3439,866,0,0,79,131,0,0,4515
"55017010700",7189,254,22,0,29,0,19,15,7528
"55017010800",4765,753,14,0,124,3,11,0,5670
"55017010900",4224,829,0,0,85,40,133,12,5323
"55017011000",6064,667,32,0,106,14,57,0,6940
"55017011100",3703,408,0,0,42,16,12,37,4218
"55017011200",6022,356,0,0,59,36,214,0,6687
"55019950100",3925,570,0,0,140,42,483,124,5284
"55019950200",3523,591,18,4,130,22,203,90,4581
"55019950300",3642,615,6,0,101,16,69,5,4454
"55019950400",2940,813,0,4,14,12,20,21,3824
"55019950500",4392,793,6,0,31,7,67,32,5328
"55019950600",3788,1045,30,24,91,14,94,2,5088
"55019950700",2826,550,29,0,70,29,30,21,3555
"55019950800",2697,384,0,2,40,10,78,5,3216
"55021970100",3712,451,13,8,142,33,149,87,4595
"55021970200",5233,457,12,0,146,13,117,0,5978
"55021970300",3188,323,4,0,113,4,183,8,3823
"55021970400",4679,778,0,94,120,0,25,12,5708
"55021970500",3491,669,72,0,153,53,276,143,4857
"55021970600",4314,142,0,3,101,0,69,0,4629
"55021970700",3428,324,0,40,114,6,23,59,3994
"55021970800",5271,207,22,0,64,18,53,18,5653
"55021970900",4395,194,0,0,94,0,36,0,4719
"55021971000",3506,310,3,9,53,28,25,20,3954
"55021971100",2972,246,51,9,77,0,35,16,3406
"55021971200",4244,640,45,0,140,0,74,0,5143
"55023960100",2312,392,4,0,28,0,12,11,2759
"55023960200",2071,246,4,0,11,6,13,9,2360
"55023960300",2213,229,3,1,14,1,16,2,2479
"55023960400",2805,282,2,1,36,0,29,0,3155
"55023960500",1786,210,0,0,0,0,30,0,2026
"55023960600",2538,571,0,0,13,0,0,0,3122
"55025000100",2110,147,38,0,187,15,56,0,2553
"55025000201",1711,85,0,0,226,38,28,8,2096
"55025000202",2501,176,97,0,320,60,111,0,3265
"55025000204",3153,99,214,532,971,158,59,0,5186
"55025000205",4320,270,162,16,420,27,38,0,5253
"55025000300",3181,270,93,16,1304,226,219,14,5323
"55025000401",2906,148,38,14,334,0,122,0,3562
"55025000402",2193,64,35,18,110,40,17,26,2503
"55025000405",4436,510,289,42,838,72,566,307,7060
"55025000406",2207,170,61,1,424,31,111,0,3005
"55025000407",2993,264,565,701,681,257,310,115,5886
"55025000408",1391,134,39,10,39,0,9,0,1622
"55025000501",3135,442,641,173,110,27,194,114,4836
"55025000503",4782,451,353,352,862,410,805,428,8443
"55025000504",4949,270,181,213,1016,515,33,16,7193
"55025000600",2037,363,250,1137,1312,922,1787,830,8638
"55025000700",2776,97,25,0,93,39,126,0,3156
"55025000800",2911,431,44,2,272,70,65,11,3806
"55025000901",1937,23,32,0,108,0,42,0,2142
"55025000902",3143,2380,72,34,141,273,71,43,6157
"55025001000",1787,38,48,0,58,7,43,0,1981
"55025001101",580,3302,61,101,96,484,14,160,4798
"55025001102",41,193,0,26,25,125,6,49,465
"55025001200",3121,1732,173,95,555,563,447,103,6789
"55025001300",1678,201,193,34,220,51,111,7,2495
"55025001401",1693,970,840,311,1760,1183,1264,819,8840
"55025001402",3108,596,759,579,547,215,1123,339,7266
"55025001403",5023,371,599,384,1101,236,914,253,8881
"55025001501",1366,354,152,38,123,45,84,183,2345
"55025001502",2611,1147,321,194,1245,160,891,736,7305
"55025001603",281,2008,0,34,104,678,32,67,3204
"55025001604",904,2296,0,108,213,668,113,90,4392
"55025001605",1458,1402,15,25,160,110,59,0,3229
"55025001606",622,1322,11,74,64,116,127,72,2408
"55025001704",1598,386,43,11,213,110,50,23,2434
"55025001705",2688,789,79,19,312,236,121,40,4284
"55025001802",2306,487,25,57,54,9,68,11,3017
"55025001804",2378,545,158,32,266,140,231,96,3846
"55025001900",4986,768,71,77,233,61,126,113,6435
"55025002000",4546,364,253,374,241,26,177,20,6001
"55025002100",3257,798,201,118,252,158,179,41,5004
"55025002200",2345,289,479,340,344,71,139,45,4052
"55025002301",1591,312,415,182,297,201,237,196,3431
"55025002302",1080,144,82,42,93,10,16,18,1485
"55025002401",2761,96,299,0,271,0,215,0,3642
"55025002402",1958,297,160,223,59,624,59,58,3438
"55025002500",925,248,45,77,186,196,157,80,1914
"55025002601",1204,121,170,47,237,20,82,28,1909
"55025002602",4120,409,271,0,727,111,482,261,6381
"55025002603",3257,309,552,294,697,17,491,44,5661
"55025002700",2907,243,21,8,80,18,149,5,3431
"55025002800",1754,156,33,18,113,10,94,26,2204
"55025002900",2373,255,163,112,238,27,264,0,3432
"55025003001",4224,277,187,34,146,96,223,270,5457
"55025003002",2276,453,326,119,297,175,467,227,4340
"55025003100",5423,138,253,144,294,0,142,5,6399
"55025003200",831,211,27,17,1439,234,157,45,2961
"55025010100",1496,54,53,2,125,0,51,0,1781
"55025010200",1393,17,5,0,10,0,19,5,1449
"55025010300",3247,164,0,1,83,0,182,61,3738
"55025010400",2874,241,119,23,79,31,115,30,3512
"55025010501",2438,40,35,333,296,185,53,0,3380
"55025010502",7339,209,16,0,204,39,99,0,7906
"55025010600",4824,229,37,1,103,0,62,0,5256
"55025010701",5072,104,99,0,525,81,176,72,6129
"55025010702",5061,124,150,12,517,0,349,11,6224
"55025010800",8788,260,82,541,646,129,137,129,10712
"55025010901",4624,127,160,2,828,83,127,0,5951
"55025010903",2454,136,192,0,331,10,146,0,3269
"55025010904",7718,134,32,0,488,0,422,0,8794
"55025011000",3394,144,214,173,533,21,136,0,4615
"55025011101",3465,274,233,198,386,42,319,154,5071
"55025011102",7226,333,210,0,574,69,249,0,8661
"55025011200",8376,283,50,1,498,1,212,1,9422
"55025011301",5580,244,44,0,294,0,314,67,6543
"55025011302",2556,91,47,0,93,0,141,0,2928
"55025011401",6098,364,310,9,123,0,315,23,7242
"55025011402",6997,356,393,0,1150,47,397,0,9340
"55025011503",7475,373,172,74,618,0,133,0,8845
"55025011504",3033,233,109,119,50,98,54,22,3718
"55025011505",2733,489,232,226,298,123,250,48,4399
"55025011506",4075,268,287,102,214,0,57,0,5003
"55025011600",5863,467,18,0,270,19,248,26,6911
"55025011700",3517,580,33,28,172,66,208,277,4881
"55025011800",4630,721,4,211,241,2,285,235,6329
"55025011900",5957,386,125,12,130,44,54,67,6775
"55025012001",7120,319,46,0,533,424,329,440,9211
"55025012002",4696,77,32,8,168,12,19,6,5018
"55025012100",2286,185,0,0,26,8,17,4,2526
"55025012201",1847,77,1,7,23,0,26,0,1981
"55025012202",5752,493,1,1,203,80,50,0,6580
"55025012300",4730,287,80,209,185,10,186,0,5687
"55025012400",4623,234,0,0,57,0,48,0,4962
"55025012501",6136,423,50,9,95,48,30,56,6847
"55025012502",3861,106,19,0,264,0,88,0,4338
"55025012600",4371,167,20,0,106,0,20,0,4684
"55025012700",3678,224,12,0,93,10,34,0,4051
"55025012800",7187,434,15,0,84,2,3,51,7776
"55025012900",3767,121,10,0,67,0,63,3,4031
"55025013000",4061,149,0,11,70,5,51,0,4347
"55025013100",4100,297,6,12,85,17,83,47,4647
"55025013200",7858,326,36,0,237,107,508,35,9107
"55025013301",4129,230,12,0,435,0,98,0,4904
"55025013302",5416,120,12,0,155,0,158,0,5861
"55025013700",5345,240,141,11,210,14,0,0,5961
"55025991702",0,0,0,0,0,0,0,0,0
"55025991703",0,0,0,0,0,0,0,0,0
"55027960100",5318,421,148,0,120,4,289,39,6339
"55027960200",2722,236,5,0,32,0,29,12,3036
"55027960300",4885,718,0,7,15,0,163,4,5792
"55027960400",4268,216,0,0,82,0,142,0,4708
"55027960500",2275,246,34,14,59,10,53,21,2712
"55027960600",3441,287,0,1,46,5,62,0,3842
"55027960700",3914,294,97,103,177,62,380,0,5027
"55027960800",2928,252,0,37,102,82,225,8,3634
"55027960900",3266,639,0,0,173,11,160,186,4435
"55027961000",3727,471,0,15,37,30,386,15,4681
"55027961100",3435,302,0,0,101,59,166,47,4110
"55027961200",3020,275,47,0,66,10,159,0,3577
"55027961300",4543,453,30,0,167,0,127,36,5356
"55027961400",3528,315,0,0,34,6,42,19,3944
"55027961500",4773,413,26,20,40,0,78,0,5350
"55027961600",4002,465,0,0,46,20,91,35,4659
"55027961700",2562,164,14,1,53,14,36,8,2852
"55027961800",3771,390,4,0,80,22,117,11,4395
"55027961900",5260,190,22,6,191,0,166,0,5835
"55027962000",1740,360,48,0,109,18,10,0,2285
"55029100100",1891,302,2,12,18,64,8,0,2297
"55029100300",1834,199,0,2,41,60,28,67,2231
"55029100400",2537,272,9,0,94,79,179,140,3310
"55029100500",3115,183,3,6,8,0,24,0,3339
"55029100600",2744,241,24,4,41,44,52,5,3155
"55029100700",3752,536,16,15,106,31,0,44,4500
"55029100800",4427,680,0,0,64,60,56,33,5320
"55029100900",1354,258,0,0,43,0,23,0,1678
"55029101000",1993,143,3,2,41,0,60,0,2242
"55029990000",0,0,0,0,0,0,0,0,0
"55031020300",1649,738,0,40,168,98,42,96,2831
"55031020400",2636,190,29,5,177,81,0,0,3118
"55031020500",1789,354,89,20,47,22,6,0,2327
"55031020600",2995,1324,14,0,139,80,0,0,4552
"55031020700",3573,372,29,0,77,22,19,0,4092
"55031020800",2519,412,0,27,207,86,5,19,3275
"55031020900",1845,221,42,1,100,20,0,20,2249
"55031021000",1359,270,41,0,79,25,0,0,1774
"55031021100",1295,756,23,15,88,78,43,0,2298
"55031030100",5423,426,7,4,290,53,49,0,6252
"55031030200",4338,404,2,0,216,8,134,8,5110
"55031030300",4349,391,11,1,186,49,45,31,5063
"55031990000",0,0,0,0,0,0,0,0,0
"55033970100",3438,300,0,0,72,21,39,0,3870
"55033970200",4176,514,0,0,32,24,9,17,4772
"55033970300",5298,601,9,0,75,10,33,14,6040
"55033970400",5405,450,16,6,198,20,82,18,6195
"55033970500",4484,658,85,20,286,22,111,0,5666
"55033970600",3709,344,0,0,24,91,25,0,4193
"55033970700",3649,1367,11,0,644,43,59,177,5950
"55033970800",2561,1519,8,40,214,73,0,0,4415
"55035000100",3659,1071,20,8,136,23,100,88,5105
"55035000200",4327,287,17,0,59,22,34,4,4750
"55035000301",3250,367,0,0,31,8,0,0,3656
"55035000302",6276,619,0,0,429,11,151,0,7486
"55035000400",6408,515,9,9,440,45,21,0,7447
"55035000501",4103,459,11,0,209,57,0,0,4839
"55035000502",3914,235,57,0,218,40,0,0,4464
"55035000600",3363,904,16,0,444,248,33,47,5055
"55035000700",4319,530,23,2,160,121,516,0,5671
"55035000801",3248,107,14,0,280,0,0,0,3649
"55035000802",3421,520,23,16,114,34,26,159,4313
"55035000803",4362,680,78,0,492,49,129,0,5790
"55035000900",3723,774,0,46,373,209,136,0,5261
"55035001101",767,885,5,36,23,86,7,49,1858
"55035001200",1842,2764,0,80,34,183,24,130,5057
"55035001300",4196,526,0,0,227,134,11,0,5094
"55035001400",5928,650,0,59,132,108,63,57,6997
"55035001500",3039,231,85,3,165,0,38,0,3561
"55035001600",5058,169,5,0,232,45,85,0,5594
"55035001700",1378,738,17,1,120,39,93,18,2404
"55037190100",2467,209,0,0,60,88,25,0,2849
"55037190200",1406,162,3,0,16,0,9,6,1602
"55039040100",3675,187,0,0,160,94,122,94,4332
"55039040200",2239,294,26,0,68,10,39,16,2692
"55039040300",3526,1103,137,60,964,525,634,485,7434
"55039040400",2474,233,0,10,66,23,35,12,2853
"55039040500",2100,982,51,106,142,159,220,70,3830
"55039040700",3456,300,38,120,207,1,207,0,4329
"55039040800",3888,511,56,0,132,28,354,0,4969
"55039040900",2811,287,39,0,77,8,153,9,3384
"55039041000",2492,406,0,62,92,0,132,14,3198
"55039041100",7807,444,93,0,379,59,164,0,8946
"55039041300",5584,451,32,0,387,44,224,129,6851
"55039041400",5502,98,10,0,78,60,53,48,5849
"55039041500",2703,221,0,0,45,0,215,0,3184
"55039041600",4448,676,30,17,26,123,40,111,5471
"55039041700",3673,228,22,3,99,9,191,17,4242
"55039041800",4300,244,0,0,231,0,227,0,5002
"55039041900",6462,486,16,2,85,7,147,41,7246
"55039042000",7521,291,0,24,266,0,151,42,8295
"55039042100",4347,226,0,0,75,5,33,0,4686
"55039042200",5395,569,1,0,147,5,62,8,6187
"55041950100",1041,194,0,5,19,18,0,10,1287
"55041950200",1745,283,5,48,243,113,32,0,2469
"55041950300",1880,246,4,8,332,76,31,58,2635
"55041950400",1697,296,0,0,375,311,20,6,2705
"55043960100",3086,516,17,1,68,0,38,12,3738
"55043960200",3268,528,2,1,61,34,23,3,3920
"55043960300",3538,601,0,0,26,0,28,0,4193
"55043960400",3040,570,1,0,34,62,42,85,3834
"55043960500",3116,547,0,0,60,1,15,0,3739
"55043960600",3122,490,20,3,68,6,11,28,3748
"55043960700",3591,259,9,15,2,24,19,39,3958
"55043960800",2643,314,0,0,38,10,12,1,3018
"55043960900",2564,1525,39,75,24,0,33,0,4260
"55043961000",3372,1486,50,0,154,28,93,51,5234
"55043961100",3798,324,0,10,46,16,43,0,4237
"55043961200",3472,399,8,0,78,6,33,0,3996
"55045960100",6029,277,20,1,99,19,164,5,6614
"55045960200",5365,306,6,5,68,7,93,54,5904
"55045960300",4275,333,5,4,109,19,32,9,4786
"55045960400",2993,844,0,0,173,0,57,91,4158
"55045960500",3383,480,14,10,22,139,257,37,4342
"55045960600",3048,236,0,0,0,0,56,0,3340
"55045960700",3637,237,0,4,31,15,43,65,4032
"55045960800",3697,542,0,0,84,22,73,0,4418
"55047100100",2351,733,4,0,215,0,216,121,3640
"55047100200",2421,185,0,0,181,0,139,19,2945
"55047100300",2645,275,10,6,46,16,12,16,3026
"55047100400",2324,161,17,24,70,2,77,0,2675
"55047100500",2545,427,0,0,26,8,20,0,3026
"55047100600",3534,389,3,5,45,51,108,86,4221
"55049950100",3313,314,6,0,85,3,11,5,3737
"55049950200",2576,376,8,4,53,26,38,2,3083
"55049950300",2729,267,0,0,152,3,96,0,3247
"55049950400",4583,480,10,16,132,0,42,0,5263
"55049950500",4197,362,16,14,101,6,88,7,4791
"55049950600",3139,476,5,0,37,0,41,24,3722
"55051180100",1884,383,0,18,30,27,13,20,2375
"55051180200",1274,179,0,0,37,2,5,3,1500
"55051180300",1667,243,0,0,25,0,0,0,1935
"55051990000",0,0,0,0,0,0,0,0,0
"55053960100",1956,249,7,2,593,223,60,51,3141
"55053960200",2607,486,2,0,181,28,67,26,3397
"55053960300",3342,641,1,1,45,160,54,70,4314
"55053960400",3300,620,1,0,144,81,56,32,4234
"55053960500",3385,791,1,17,288,28,32,41,4583
"55055100100",4639,882,0,0,155,10,64,0,5750
"55055100200",2752,479,13,7,246,24,313,58,3892
"55055100300",4852,577,10,17,176,182,200,141,6155
"55055100400",5212,412,12,0,133,0,290,98,6157
"55055100500",5515,706,29,12,205,6,182,20,6675
"55055100601",1363,49,8,0,16,0,5,0,1441
"55055100602",2842,371,0,1,63,0,20,7,3304
"55055100700",3982,462,35,6,93,43,129,49,4799
"55055100800",3883,227,5,4,40,11,41,20,4231
"55055100900",3512,166,0,0,25,26,103,0,3832
"55055101000",3168,366,0,0,221,48,433,151,4387
"55055101100",3503,474,62,8,134,16,484,126,4807
"55055101201",2109,140,10,0,17,7,11,0,2294
"55055101202",1621,58,0,0,33,0,27,0,1739
"55055101300",4794,327,0,46,308,96,253,21,5845
"55055101400",2397,405,13,12,128,226,101,261,3543
"55055101500",3022,640,0,0,340,71,399,309,4781
"55055101600",3972,922,34,27,317,57,675,160,6164
"55055101701",1364,102,0,0,14,0,26,5,1511
"55055101702",4258,300,27,36,58,0,160,0,4839
"55057100100",2331,374,30,0,86,0,136,0,2957
"55057100200",3082,362,11,8,68,42,13,7,3593
"55057100300",2597,554,19,0,60,8,59,0,3297
"55057100400",3588,583,7,9,114,34,94,52,4481
"55057100500",3296,583,61,41,43,26,114,15,4179
"55057100600",2847,361,14,34,31,0,43,0,3330
"55057100700",3310,435,8,2,214,56,71,12,4108
"55059000100",4022,690,144,125,484,1,424,18,5908
"55059000300",2206,776,159,118,86,174,328,302,4149
"55059000400",2775,461,52,62,51,44,189,161,3795
"55059000500",3813,794,214,99,33,74,377,97,5501
"55059000601",4493,260,131,119,132,0,502,51,5688
"55059000602",5019,845,764,112,348,0,464,287,7839
"55059000700",3313,986,535,581,172,64,768,749,7168
"55059000800",1584,695,547,197,46,180,650,608,4507
"55059000900",1955,779,163,228,157,121,760,315,4478
"55059001000",1220,414,62,112,101,10,200,115,2234
"55059001100",892,1026,498,407,231,50,391,477,3972
"55059001200",2830,469,173,156,216,81,836,201,4962
"55059001300",2611,286,282,483,569,183,716,152,5282
"55059001400",5552,833,124,31,322,14,471,85,7432
"55059001500",2666,412,324,289,143,59,436,134,4463
"55059001600",1834,610,256,114,190,255,789,375,4423
"55059001700",1724,225,275,433,137,64,408,86,3352
"55059001800",1497,329,166,126,42,52,317,71,2600
"55059001900",2151,90,36,38,198,0,184,0,2697
"55059002000",4850,291,0,0,487,22,239,9,5898
"55059002100",2982,1615,110,214,73,125,272,1017,6408
"55059002200",3087,365,37,59,93,16,262,116,4035
"55059002300",4947,566,33,230,202,10,299,0,6287
"55059002400",4067,410,163,0,205,0,185,268,5298
"55059002500",3161,166,72,62,90,19,196,46,3812
"55059002601",7272,611,801,0,895,0,953,343,10875
"55059002602",7213,277,606,0,247,161,576,36,9116
"55059002700",5097,192,57,0,190,1,334,1,5872
"55059002800",5646,531,0,64,73,198,290,0,6802
"55059002903",2771,214,0,21,56,53,74,9,3198
"55059002904",4853,632,0,0,17,51,334,111,5998
"55059002905",3200,330,0,1,114,0,135,0,3780
"55059002906",4584,180,32,12,122,0,156,7,5093
"55059003001",3652,536,8,4,47,0,68,0,4315
"55059003002",4492,374,6,0,92,12,110,0,5086
"55059990000",0,0,0,0,0,0,0,0,0
"55061960100",2546,440,0,37,0,40,32,48,3143
"55061960200",2364,259,0,6,15,10,49,0,2703
"55061960400",7774,520,21,0,151,70,166,64,8766
"55061960500",5232,609,0,0,179,50,64,50,6184
"55061990000",0,0,0,0,0,0,0,0,0
"55063000100",3902,190,0,0,236,90,195,14,4627
"55063000200",2764,1148,179,27,586,309,96,29,5138
"55063000300",1225,430,79,105,120,16,0,16,1991
"55063000400",1522,3262,0,47,192,88,20,41,5172
"55063000500",486,1256,0,12,134,99,0,4,1991
"55063000600",1655,353,0,0,132,23,10,13,2186
"55063000700",4209,203,0,11,99,12,6,0,4540
"55063000800",2316,779,0,0,99,43,74,43,3354
"55063000900",2082,680,225,46,318,159,54,43,3607
"55063001000",2774,505,32,90,314,16,56,0,3787
"55063001101",2007,189,0,0,28,0,18,0,2242
"55063001102",3039,320,10,1,111,236,71,119,3907
"55063001200",3726,311,99,0,192,34,10,0,4372
"55063010101",5148,497,15,0,40,14,51,11,5776
"55063010102",4066,312,0,10,33,0,25,0,4446
"55063010201",8337,660,5,4,709,80,82,0,9877
"55063010202",6102,388,8,0,542,0,40,0,7080
"55063010203",1601,105,10,9,18,4,6,0,1753
"55063010300",4068,479,0,0,63,7,0,0,4617
"55063010401",4749,143,44,0,412,0,15,0,5363
"55063010402",7366,477,70,119,1160,227,200,13,9632
"55063010500",4496,317,182,0,531,81,58,0,5665
"55063010600",3009,143,32,6,78,0,69,0,3337
"55063010700",4859,206,0,21,31,0,94,0,5211
"55063010800",2859,261,0,0,67,0,87,26,3300
"55065970100",2823,261,3,1,8,3,53,0,3152
"55065970200",3085,567,2,1,211,0,175,112,4153
"55065970300",2917,301,6,14,185,4,156,44,3627
"55065970400",2661,348,17,0,32,0,12,7,3077
"55065970500",2807,358,1,1,45,3,7,7,3229
"55067960100",2372,306,1,2,31,20,0,7,2739
"55067960300",2314,238,0,0,93,63,2,45,2755
"55067960400",3458,244,9,0,104,3,16,27,3861
"55067960500",1490,263,0,5,7,18,4,5,1792
"55067960600",3160,1030,17,46,90,150,78,107,4678
"55067960700",3020,681,0,0,94,0,59,0,3854
"55069960100",2005,178,0,1,22,0,12,14,2232
"55069960200",1810,427,0,0,39,20,14,0,2310
"55069960300",1700,62,0,1,19,0,20,0,1802
"55069960400",1726,130,3,0,30,0,7,0,1896
"55069960500",1688,180,0,0,56,8,7,41,1980
"55069960600",4019,377,20,2,135,0,23,0,4576
"55069960700",3534,162,0,14,6,0,10,3,3729
"55069960800",2824,431,0,0,87,73,84,8,3507
"55069960900",2298,363,0,0,80,3,71,4,2819
"55069961000",2681,526,0,29,16,45,20,27,3344
"55071000100",4111,735,0,0,98,28,0,0,4972
"55071000200",2195,114,0,0,92,76,96,11,2584
"55071000300",5021,186,0,0,222,0,29,3,5461
"55071000400",3275,462,93,0,337,69,230,147,4613
"55071000500",2405,177,14,0,86,78,437,6,3203
"55071000600",3910,465,0,0,703,0,62,12,5152
"55071000700",4174,719,0,0,215,486,298,134,6026
"55071000800",3017,441,0,0,125,234,118,55,3990
"55071005100",2138,173,0,46,123,6,0,0,2486
"55071005200",3824,336,33,1,46,1,33,0,4274
"55071005300",1531,264,0,157,147,8,43,38,2188
"55071005400",2618,300,0,0,42,80,79,80,3199
"55071010100",4282,238,16,0,82,0,15,0,4633
"55071010200",5278,283,6,0,70,0,14,59,5710
"55071010300",3911,409,0,0,43,5,64,40,4472
"55071010400",5530,484,0,0,97,19,175,43,6348
"55071010500",3080,288,0,5,74,12,9,0,3468
"55071010600",4746,283,33,0,128,0,175,10,5375
"55071010700",3758,196,1,14,105,0,102,0,4176
"55071990000",0,0,0,0,0,0,0,0,0
"55073000100",1111,920,29,48,312,115,85,147,2767
"55073000200",1728,362,0,0,315,392,25,7,2829
"55073000300",4006,332,1,2,273,101,0,8,4723
"55073000400",4301,696,91,0,610,107,232,111,6148
"55073000500",1693,231,3,34,651,484,14,189,3299
"55073000601",1410,116,0,0,312,194,8,0,2040
"55073000602",1995,675,24,0,900,339,83,101,4117
"55073000700",3149,895,0,252,834,397,93,8,5628
"55073000800",2774,187,67,3,150,152,30,0,3363
"55073000900",2004,130,0,0,151,45,54,8,2392
"55073001000",2983,136,0,0,108,0,8,0,3235
"55073001102",7553,320,4,0,193,248,275,5,8598
"55073001103",4321,368,31,0,85,544,31,0,5380
"55073001104",4540,1002,0,0,67,44,230,0,5883
"55073001201",7860,410,14,0,305,10,16,0,8615
"55073001202",4387,406,15,11,130,27,6,31,5013
"55073001300",6322,233,27,0,271,0,62,0,6915
"55073001400",5714,765,107,0,321,25,32,311,7275
"55073001500",3872,165,1,0,45,0,0,0,4083
"55073001600",5696,257,3,0,191,3,71,8,6229
"55073001700",3256,281,0,0,40,35,49,0,3661
"55073001800",5040,213,4,0,35,36,109,8,5445
"55073001900",5313,567,0,0,98,27,45,20,6070
"55073002000",3682,239,24,5,62,4,38,4,4058
"55073002100",6271,489,24,1,157,9,45,0,6996
"55073002200",2857,367,4,3,86,17,265,61,3660
"55073002300",6613,630,0,0,99,65,196,47,7650
"55075960100",2385,460,0,0,56,16,36,0,2953
"55075960200",3365,572,0,0,67,36,7,4,4051
"55075960600",1910,340,3,0,39,35,0,0,2327
"55075960700",2608,330,0,0,27,0,0,3,2968
"55075960800",2074,369,0,0,31,3,3,17,2497
"55075960900",2420,161,10,0,5,0,18,0,2614
"55075961000",3561,363,1,0,120,22,105,10,4182
"55075961100",4356,606,0,0,187,3,52,35,5239
"55075961200",2356,181,0,0,36,0,7,0,2580
"55075961300",2459,438,4,0,174,55,126,0,3256
"55075961400",3478,607,11,10,58,42,18,0,4224
"55075961500",3193,523,7,30,121,40,75,56,4045
"55075990000",0,0,0,0,0,0,0,0,0
"55077960100",2249,246,10,26,77,6,7,0,2621
"55077960200",2057,413,0,2,15,0,4,0,2491
"55077960300",3093,522,0,0,77,24,40,4,3760
"55077960400",2214,190,3,0,55,13,78,19,2572
"55077960500",3026,524,0,0,138,0,147,92,3927
"55078940101",48,2,0,0,726,588,68,0,1432
"55078940102",431,71,0,4,1846,598,56,100,3106
"55079000101",1034,182,1840,1319,301,41,232,0,4949
"55079000102",914,129,1563,730,201,100,70,64,3771
"55079000201",1100,219,1488,1995,350,343,316,305,6116
"55079000202",2844,140,1685,1019,474,142,205,22,6531
"55079000301",1061,41,173,2,95,0,0,0,1372
"55079000302",483,72,1624,757,178,94,101,45,3354
"55079000303",780,56,702,34,88,79,29,7,1775
"55079000304",1414,17,989,170,369,157,46,0,3162
"55079000400",617,99,1150,327,310,53,127,0,2683
"55079000501",1558,224,1028,486,270,115,137,84,3902
"55079000502",566,121,1937,1365,494,26,48,9,4566
"55079000600",1378,117,2419,1459,925,315,107,0,6720
"55079000700",1238,36,1568,299,86,16,104,16,3363
"55079000800",1104,195,2464,799,579,45,297,102,5585
"55079000900",705,29,1664,1139,146,73,153,32,3941
"55079001000",375,52,1856,732,370,65,136,19,3605
"55079001100",231,93,1506,504,34,14,0,20,2402
"55079001200",150,26,889,907,795,472,90,90,3419
"55079001300",251,18,2180,1119,882,0,69,0,4519
"55079001400",287,43,858,574,460,187,67,26,2502
"55079001500",524,107,1020,699,619,142,0,0,3111
"55079001600",471,52,1213,1059,165,18,26,23,3027
"55079001700",1316,24,2143,893,215,0,122,0,4713
"55079001800",293,177,1288,1056,197,146,19,37,3213
"55079001900",429,86,1349,880,239,37,25,44,3089
"55079002000",272,44,1105,813,60,39,65,0,2398
"55079002100",142,11,1171,728,70,11,30,11,2174
"55079002200",758,33,511,339,94,0,171,0,1906
"55079002300",166,27,2658,1094,80,55,63,22,4165
"55079002400",29,14,956,657,0,198,0,0,1854
"55079002500",183,30,928,588,201,76,145,41,2192
"55079002600",262,40,1615,852,18,17,33,17,2854
"55079002700",142,57,1236,262,45,0,0,0,1742
"55079002800",167,22,1118,935,235,11,59,4,2551
"55079002900",126,26,975,932,135,23,94,21,2332
"55079003000",538,137,1761,1077,467,118,131,29,4258
"55079003100",370,54,2314,438,618,78,87,52,4011
"55079003200",539,30,1572,368,528,89,105,62,3293
"55079003300",835,129,2422,797,679,88,289,52,5291
"55079003400",1614,109,1864,1487,409,411,155,191,6240
"55079003500",576,34,2368,377,274,31,72,0,3732
"55079003600",241,42,1210,552,118,0,30,0,2193
"55079003700",199,22,1021,698,81,0,4,0,2025
"55079003800",153,35,1413,737,103,28,58,12,2539
"55079003900",72,0,1901,611,56,0,21,0,2661
"55079004000",74,4,1512,1029,27,8,0,2,2656
"55079004100",126,27,1437,602,43,167,29,13,2444
"55079004200",87,9,1474,1758,9,0,62,0,3399
"55079004300",347,4,2502,1641,11,40,247,0,4792
"55079004400",805,144,1664,1031,151,52,170,29,4046
"55079004500",35,52,1204,861,69,102,40,91,2454
"55079004600",36,1,1638,1274,107,13,29,0,3098
"55079004700",37,0,2422,1083,25,6,42,0,3615
"55079004800",97,111,2010,1749,78,106,11,50,4212
"55079004900",990,45,2342,774,253,18,51,9,4482
"55079005000",1058,161,2260,1254,446,111,96,65,5451
"55079005100",477,101,2052,700,68,26,44,59,3527
"55079005200",1014,55,399,101,93,9,91,0,1762
"55079005300",1208,46,352,98,173,18,253,0,2148
"55079005400",2828,364,379,31,161,39,128,12,3942
"55079005500",2690,73,330,7,183,0,228,0,3511
"55079005600",1746,54,114,3,57,0,46,0,2020
"55079005700",1828,126,267,56,29,0,22,0,2328
"55079005800",2274,65,387,340,76,0,238,0,3380
"55079005900",678,138,1776,473,338,42,313,36,3794
"55079006000",160,59,1190,1263,47,15,53,9,2796
"55079006100",262,20,1042,518,121,86,9,80,2138
"55079006200",34,25,1330,820,38,28,1,32,2308
"55079006300",17,13,1262,1016,5,73,49,29,2464
"55079006400",0,0,1243,1096,43,240,0,0,2622
"55079006500",98,22,717,1445,80,19,65,7,2453
"55079006600",100,241,1015,1881,104,39,85,251,3716
"55079006700",13,13,637,639,4,17,12,38,1373
"55079006800",0,22,1296,1081,92,0,120,0,2611
"55079006900",94,131,862,1572,87,323,161,308,3538
"55079007000",177,5,1327,852,97,16,169,14,2657
"55079007100",1076,509,110,193,181,43,153,23,2288
"55079007200",1760,239,374,243,200,46,289,33,3184
"55079007300",1381,740,99,0,44,76,127,22,2489
"55079007400",951,457,80,0,68,0,20,19,1595
"55079007500",1824,495,27,32,44,0,24,0,2446
"55079007600",2205,598,86,41,153,148,126,25,3382
"55079007700",2151,1243,154,8,186,84,36,52,3914
"55079007800",1456,1685,70,0,161,147,58,90,3667
"55079007900",1031,244,158,27,193,59,65,51,1828
"55079008000",861,422,153,354,201,45,217,0,2253
"55079008100",252,80,371,481,31,97,124,184,1620
"55079008400",15,47,618,577,102,14,49,47,1469
"55079008500",4,20,534,838,72,37,72,23,1600
"55079008600",4,19,716,296,5,0,0,16,1056
"55079008700",7,0,608,662,0,18,0,72,1367
"55079008800",0,11,1121,837,33,0,25,12,2039
"55079008900",43,42,440,462,0,16,30,0,1033
"55079009000",73,18,1077,1372,31,75,5,8,2659
"55079009100",255,42,755,755,152,25,46,25,2055
"55079009200",351,71,673,593,161,29,65,4,1947
"55079009300",1299,37,632,311,200,8,160,0,2647
"55079009400",1797,47,410,139,359,14,317,22,3105
"55079009500",1457,82,312,54,173,37,72,6,2193
"55079009600",122,86,825,862,162,102,64,115,2338
"55079009700",62,42,670,223,425,244,5,32,1703
"55079009800",45,0,450,559,106,106,0,17,1283
"55079009900",11,9,710,317,36,52,32,51,1218
"55079010600",328,105,248,235,111,79,55,105,1266
"55079010700",1197,347,177,111,339,114,229,47,2561
"55079010800",1469,444,73,1,69,7,61,5,2129
"55079011000",2124,590,269,72,200,42,41,0,3338
"55079011100",1107,268,41,10,130,24,75,13,1668
"55079011200",1558,332,158,125,77,74,45,25,2394
"55079011300",1039,191,98,60,38,46,40,63,1575
"55079011400",894,95,190,30,26,0,26,0,1261
"55079012200",242,105,661,711,408,536,30,21,2714
"55079012300",169,9,432,300,90,4,27,4,1035
"55079012400",1151,118,649,303,470,87,138,0,2916
"55079012500",1756,115,104,2,52,18,30,0,2077
"55079012600",1725,297,47,73,249,48,332,10,2781
"55079012700",1006,106,20,0,58,0,155,15,1360
"55079012800",1703,257,72,40,247,69,507,21,2916
"55079012900",2215,366,87,61,204,200,350,95,3578
"55079013000",1183,317,111,31,153,39,109,101,2044
"55079013300",398,116,138,125,205,85,133,0,1200
"55079013400",351,14,661,634,419,265,318,154,2816
"55079013500",310,252,466,781,95,64,113,107,2188
"55079013600",169,108,987,730,56,396,129,199,2774
"55079013700",167,101,447,580,134,277,150,49,1905
"55079014100",136,163,692,572,27,0,64,40,1694
"55079014300",1793,337,110,37,216,22,226,14,2755
"55079014400",1616,184,111,35,347,0,97,8,2398
"55079014600",209,562,91,564,173,158,14,24,1795
"55079014700",258,1032,108,667,53,244,36,231,2629
"55079014800",350,243,320,516,76,128,18,91,1742
"55079014900",248,429,139,408,40,49,53,126,1492
"55079015700",676,651,85,186,588,674,1034,1065,4959
"55079015800",641,469,254,142,846,695,1269,798,5114
"55079015900",1127,844,131,186,810,625,1391,905,6019
"55079016000",1157,1227,86,158,560,449,1251,1215,6103
"55079016100",1704,530,0,72,728,289,1740,640,5703
"55079016200",1210,419,9,306,943,299,1635,524,5345
"55079016300",959,627,145,489,1724,1100,2247,1210,8501
"55079016400",927,383,72,321,1200,1247,1756,1469,7375
"55079016500",472,270,71,52,902,551,1195,745,4258
"55079016600",520,391,69,383,409,339,621,470,3202
"55079016700",763,250,278,132,1132,1089,1742,1211,6597
"55079016800",733,361,108,407,1037,717,1357,873,5593
"55079016900",904,897,72,298,1085,775,1763,1339,7133
"55079017000",2290,870,63,148,1165,1059,2428,1502,9525
"55079017100",1463,438,92,105,718,132,1620,291,4859
"55079017200",1436,331,102,1,461,108,1422,404,4265
"55079017300",2111,876,110,187,439,459,1975,1278,7435
"55079017400",1062,759,73,191,537,354,1237,979,5192
"55079017500",1436,987,89,540,457,505,1545,1087,6646
"55079017600",1211,591,107,306,697,416,1380,941,5649
"55079017900",2324,504,28,41,288,39,461,132,3817
"55079018000",2497,413,28,17,73,26,452,42,3548
"55079018100",1393,72,6,94,103,0,74,8,1750
"55079018200",1592,52,0,0,46,0,59,0,1749
"55079018300",1910,312,10,0,62,56,147,146,2643
"55079018400",1269,76,0,0,26,0,56,0,1427
"55079018500",1669,160,0,0,63,32,424,115,2463
"55079018600",1530,530,65,261,434,331,1512,611,5274
"55079018700",1553,880,49,189,568,392,1372,1156,6159
"55079018800",1068,639,4,250,324,106,1166,837,4394
"55079018900",1025,471,27,21,177,0,575,404,2700
"55079019000",3698,804,264,26,157,56,791,452,6248
"55079019100",2345,463,189,17,378,22,843,46,4303
"55079019200",2585,141,98,59,276,139,559,82,3939
"55079019300",2441,78,84,3,230,8,379,0,3223
"55079019400",3176,444,55,55,131,46,440,138,4485
"55079019500",3091,338,0,0,121,42,241,149,3982
"55079019600",2830,222,351,39,72,0,182,42,3738
"55079019700",3849,500,43,101,648,107,464,462,6174
"55079019800",3670,632,134,4,383,123,498,432,5876
"55079019900",2974,274,220,197,198,76,704,171,4814
"55079020000",1851,587,224,208,435,258,935,240,4738
"55079020100",1980,605,213,98,210,76,962,425,4569
"55079020200",1848,394,58,104,212,114,586,285,3601
"55079020300",2869,401,250,29,580,31,1392,387,5939
"55079020400",2382,492,67,41,241,267,1674,647,5811
"55079020500",2205,673,14,4,357,38,1558,521,5370
"55079020600",2897,363,41,0,261,0,515,27,4104
"55079020700",3649,331,0,1,288,79,333,37,4718
"55079020800",2439,221,61,1,259,37,146,0,3164
"55079020900",2179,172,79,0,68,71,417,62,3048
"55079021000",1962,100,16,29,189,6,419,13,2734
"55079021100",1188,151,5,0,53,0,233,107,1737
"55079021200",1547,391,36,0,100,9,102,159,2344
"55079021300",1257,131,72,155,58,100,252,93,2118
"55079021400",1986,794,128,92,396,298,686,504,4884
"55079021500",2154,195,8,1,345,189,253,177,3322
"55079021600",2835,798,0,149,474,152,659,212,5279
"55079021700",5436,591,72,6,367,263,1730,145,8610
"55079021800",1680,286,11,33,212,89,274,139,2724
"55079030100",3981,85,140,1,227,0,82,0,4516
"55079035100",2122,71,0,0,45,0,13,6,2257
"55079035200",3609,186,179,0,314,0,110,0,4398
"55079040100",1241,25,29,0,201,5,56,11,1568
"55079050101",3665,143,1519,58,525,66,293,0,6269
"55079050102",2833,321,1821,565,541,6,168,5,6260
"55079060101",2618,297,317,72,262,13,84,8,3671
"55079060102",2438,55,402,1,338,12,335,0,3581
"55079060200",4133,545,658,101,167,111,198,188,6101
"55079070100",4151,103,0,0,328,0,196,0,4778
"55079070200",4643,120,35,126,121,16,109,0,5170
"55079070300",3678,60,121,0,561,68,117,0,4605
"55079080100",1913,136,67,23,246,11,23,0,2419
"55079080200",2981,183,77,8,222,11,125,17,3624
"55079080300",3575,109,48,39,176,91,106,13,4157
"55079080400",2203,685,38,58,194,151,61,23,3413
"55079090100",3535,358,335,52,97,1,136,10,4524
"55079090200",1751,11,81,12,79,36,49,0,2019
"55079090300",2472,129,154,40,546,38,192,0,3571
"55079090600",4133,162,62,0,165,247,147,36,4952
"55079090700",3152,38,0,0,80,0,76,0,3346
"55079090800",2249,21,87,0,37,0,65,0,2459
"55079090900",2859,71,311,0,207,48,44,0,3540
"55079091000",3887,250,287,7,285,0,146,58,4920
"55079091100",3725,122,96,7,227,25,107,0,4309
"55079091200",3413,405,296,0,173,44,125,41,4497
"55079091300",3254,253,20,35,79,14,14,0,3669
"55079091400",1972,119,20,0,87,11,74,0,2283
"55079100100",2141,289,572,192,223,79,265,40,3801
"55079100200",2660,390,101,0,555,274,837,84,4901
"55079100300",2112,518,9,0,170,98,159,0,3066
"55079100400",2025,295,57,31,111,57,228,91,2895
"55079100500",2444,491,74,167,88,39,248,57,3608
"55079100600",1879,280,52,24,68,6,100,102,2511
"55079100700",2080,238,53,1,217,1,209,0,2799
"55079100800",2595,109,7,28,266,27,98,27,3157
"55079100900",2536,389,103,26,368,95,164,138,3819
"55079101000",4270,410,91,16,178,71,270,109,5415
"55079101100",1484,152,80,16,50,0,116,10,1908
"55079101200",2603,197,8,0,63,17,155,22,3065
"55079101300",2767,163,8,37,255,0,184,7,3421
"55079101400",2753,290,71,6,234,90,522,0,3966
"55079101500",3464,1073,49,196,122,78,514,409,5905
"55079101600",3623,349,154,40,371,96,495,203,5331
"55079101700",2647,414,73,66,160,88,275,110,3833
"55079101800",2140,233,11,0,237,87,39,0,2747
"55079110100",2354,552,290,179,664,161,915,318,5433
"55079120101",3163,138,0,0,388,0,56,0,3745
"55079120102",3141,314,30,0,70,0,93,56,3704
"55079120201",2958,192,31,27,165,9,88,0,3470
"55079120202",2634,285,131,0,87,131,495,71,3834
"55079120203",3128,240,36,34,142,10,361,123,4074
"55079120300",1486,119,27,31,130,103,161,63,2120
"55079120400",5804,564,85,0,310,68,914,69,7814
"55079120501",3131,319,96,197,539,0,350,174,4806
"55079120502",3783,522,21,143,678,145,244,15,5551
"55079130100",4319,347,0,0,154,0,314,0,5134
"55079130200",2619,132,29,0,39,19,84,25,2947
"55079140100",2680,147,14,0,75,51,39,9,3015
"55079140201",4283,204,104,0,475,42,372,15,5495
"55079140202",4985,591,64,0,313,10,124,0,6087
"55079150100",6846,646,102,14,1225,80,445,120,9478
"55079150301",5065,216,31,0,505,0,123,0,5940
"55079150303",4314,172,63,0,299,0,138,13,4999
"55079150304",2919,578,121,0,229,60,62,38,4007
"55079160100",5469,813,85,15,129,8,326,252,7097
"55079160202",5853,603,76,0,631,79,581,95,7918
"55079160203",4678,410,189,0,608,14,400,89,6388
"55079160204",3827,251,119,0,714,31,478,9,5429
"55079160300",8848,334,258,0,640,5,547,172,10804
"55079170100",2147,201,0,0,100,58,140,8,2654
"55079170200",3126,352,41,15,238,18,325,122,4237
"55079170300",2139,328,48,0,84,39,88,21,2747
"55079170400",2963,119,29,39,91,0,125,0,3366
"55079170500",1744,250,23,31,26,22,143,0,2239
"55079170600",2484,672,35,8,252,78,404,67,4000
"55079170700",2782,154,9,40,140,17,305,46,3493
"55079180100",2498,382,18,0,78,29,123,93,3221
"55079180200",2937,968,29,10,380,377,374,381,5456
"55079180300",2299,492,240,51,342,0,491,125,4040
"55079180400",2170,262,79,0,122,35,219,25,2912
"55079180500",3694,240,80,42,335,82,206,139,4818
"55079185100",3515,404,83,31,143,263,495,47,4981
"55079185200",3932,369,123,1,431,36,374,75,5341
"55079185300",3167,180,25,22,101,0,11,0,3506
"55079185400",29,15,796,602,148,119,16,0,1725
"55079185500",14,4,935,974,10,4,0,0,1941
"55079185600",381,19,726,519,37,0,0,0,1682
"55079185700",57,13,796,1187,0,99,42,1,2195
"55079185800",84,21,1018,294,97,124,95,0,1733
"55079185900",115,21,518,295,141,199,31,0,1320
"55079186000",118,66,673,549,62,6,0,0,1474
"55079186100",91,37,680,923,349,140,29,49,2298
"55079186200",119,28,470,551,112,62,167,51,1560
"55079186300",894,223,122,39,84,27,63,9,1461
"55079186400",145,219,39,20,8,29,0,18,478
"55079186500",677,183,56,23,225,295,343,391,2193
"55079186600",956,627,36,220,244,14,777,530,3404
"55079186800",152,273,156,304,204,199,191,311,1790
"55079186900",1578,110,172,0,268,0,94,0,2222
"55079187000",2161,464,53,25,333,63,97,0,3196
"55079187200",3065,42,51,0,252,0,137,0,3547
"55079187300",5743,124,22,0,755,116,105,16,6881
"55079187400",2185,127,66,46,140,6,139,0,2709
"55079980000",0,0,0,0,0,0,0,0,0
"55079990000",0,0,0,0,0,0,0,0,0
"55081950100",3897,325,39,3,360,144,60,56,4884
"55081950200",4126,316,0,0,84,50,69,0,4645
"55081950300",4857,943,143,0,208,138,429,276,6994
"55081950400",3184,835,8,7,19,38,139,22,4252
"55081950500",5065,711,136,2,223,2,158,0,6297
"55081950600",2910,713,99,29,92,68,32,0,3943
"55081950700",3782,991,0,6,91,20,24,0,4914
"55081950800",3264,854,0,0,237,76,199,120,4750
"55081950900",4363,525,32,3,97,3,67,30,5120
"55083100300",2504,206,0,0,32,36,2,0,2780
"55083100500",1855,285,14,3,40,18,2,7,2224
"55083100600",1984,320,0,0,130,71,27,0,2532
"55083100700",2407,303,0,0,122,68,64,77,3041
"55083100800",2095,230,0,0,44,42,30,32,2473
"55083100900",2396,337,23,0,90,58,19,5,2928
"55083101000",3558,290,0,6,50,9,45,41,3999
"55083101100",4350,351,3,0,66,9,70,3,4852
"55083101200",3250,456,0,0,122,54,88,0,3970
"55083101300",7967,615,6,0,152,6,71,0,8817
"55083990000",0,0,0,0,0,0,0,0,0
"55085970101",1321,138,0,0,23,0,2,0,1484
"55085970102",3181,258,2,0,75,14,22,2,3554
"55085970400",2374,222,0,2,55,11,0,0,2664
"55085970500",1666,170,0,2,19,6,11,2,1876
"55085970601",1737,95,0,0,21,2,25,2,1882
"55085970602",3142,370,0,16,105,17,14,6,3670
"55085970800",1777,257,0,8,47,47,20,15,2171
"55085970900",1947,204,0,0,3,4,12,3,2173
"55085971001",1161,110,0,0,18,5,13,4,1311
"55085971002",2138,144,21,0,89,0,36,0,2428
"55085971100",1848,155,0,1,48,0,28,0,2080
"55085971300",1523,226,0,0,104,1,6,0,1860
"55085971400",2900,484,0,62,153,25,33,86,3743
"55085971500",3555,828,0,37,33,22,6,21,4502
"55087010100",1523,484,0,104,51,53,6,5,2226
"55087010200",3111,385,0,14,383,113,413,15,4434
"55087010300",1441,474,5,3,279,46,80,0,2328
"55087010500",2354,447,67,82,346,48,111,0,3455
"55087010601",2511,428,59,0,550,290,83,149,4070
"55087010602",3269,155,0,1,577,0,143,0,4145
"55087010700",3269,436,215,42,368,88,312,35,4765
"55087010800",1374,68,8,0,40,0,8,0,1498
"55087010900",1775,59,21,0,158,81,87,25,2206
"55087011000",4108,616,26,1,331,465,302,346,6195
"55087011101",3870,361,28,0,727,52,400,0,5438
"55087011102",5391,561,47,20,914,107,578,42,7660
"55087011200",1969,120,0,0,510,89,271,17,2976
"55087011300",2434,241,19,14,60,75,114,15,2972
"55087011400",4223,524,0,0,278,141,108,288,5562
"55087011501",2842,191,21,2,369,27,38,0,3490
"55087011502",3229,573,0,97,407,0,82,97,4485
"55087011600",6284,256,43,18,215,0,105,10,6931
"55087011700",2431,169,53,27,36,0,33,9,2758
"55087011800",1578,122,11,0,14,28,4,0,1757
"55087011900",6962,552,0,1,232,103,98,52,8000
"55087012000",5869,220,95,0,171,0,89,0,6444
"55087012100",6863,473,0,19,42,92,88,56,7633
"55087012200",1508,363,0,0,164,6,89,17,2147
"55087012300",1418,106,0,5,31,0,34,0,1594
"55087012400",2479,187,36,0,80,44,188,33,3047
"55087012503",3303,193,0,0,113,0,20,0,3629
"55087012504",3130,72,7,22,34,0,53,0,3318
"55087012505",3146,112,13,0,437,94,112,0,3914
"55087012506",3507,201,41,20,480,0,50,0,4299
"55087012601",8098,377,325,0,223,11,40,128,9202
"55087012602",4342,76,0,0,43,0,16,0,4477
"55087012700",5493,458,0,0,146,34,297,107,6535
"55087012800",6593,445,38,0,193,32,131,5,7437
"55087012901",5766,251,0,0,32,0,41,5,6095
"55087012902",3446,46,0,0,0,0,0,0,3492
"55087013100",4956,628,0,0,241,9,160,0,5994
"55087013200",3298,399,0,0,72,86,129,113,4097
"55087013300",6613,259,15,0,207,23,59,64,7240
"55087940000",2113,259,1,0,1677,502,107,81,4740
"55089610101",3863,216,16,0,89,24,103,0,4311
"55089610102",3220,107,3,0,177,9,259,11,3786
"55089620100",5489,320,33,10,157,0,116,0,6125
"55089630100",2434,278,11,0,18,8,137,51,2937
"55089630201",4243,144,13,11,126,12,107,3,4659
"55089630202",4930,174,7,0,83,9,134,0,5337
"55089640100",4993,635,25,54,133,0,35,0,5875
"55089640200",7132,287,128,0,577,0,100,0,8224
"55089650101",6044,183,0,0,365,0,241,37,6870
"55089650102",2457,294,0,1,61,0,37,0,2850
"55089650200",4327,309,31,0,163,11,90,22,4953
"55089650300",4814,108,77,0,129,0,128,0,5256
"55089660100",2802,239,35,6,108,0,14,0,3204
"55089660201",3351,100,202,62,223,0,42,0,3980
"55089660202",4224,331,180,6,108,17,90,19,4975
"55089660301",5781,158,47,0,135,0,216,0,6337
"55089660303",4511,115,26,0,306,0,43,0,5001
"55089660304",2926,45,58,0,240,0,54,0,3323
"55089990000",0,0,0,0,0,0,0,0,0
"55091950100",3316,542,4,6,32,11,13,37,3961
"55091950200",2847,402,2,7,61,2,33,0,3354
"55093960100",2483,281,2,4,48,13,63,11,2905
"55093960200",5165,575,20,1,132,65,109,10,6077
"55093960300",2176,783,21,39,88,34,0,0,3141
"55093960400",3736,1343,17,20,110,122,0,0,5348
"55093960500",7244,334,18,0,154,18,159,18,7945
"55093960600",4537,226,30,0,61,25,52,5,4936
"55093960700",3997,567,0,15,38,33,10,40,4700
"55093960800",3171,356,1,0,49,25,35,81,3718
"55095960100",2776,550,0,0,103,48,58,0,3535
"55095960200",3066,444,4,6,91,0,69,3,3683
"55095960300",4522,654,0,0,240,100,12,29,5557
"55095960500",2381,291,6,0,66,3,31,0,2778
"55095960600",1720,220,0,0,22,10,11,2,1985
"55095960700",4829,566,15,16,153,35,84,3,5701
"55095960800",5734,465,9,2,182,24,110,31,6557
"55095960900",4518,524,0,0,53,0,67,4,5166
"55095961000",4178,369,50,1,93,82,39,60,4872
"55095961100",3371,385,0,18,33,43,56,23,3929
"55097960100",4071,317,0,0,31,42,57,0,4518
"55097960200",4205,278,7,0,93,0,28,46,4657
"55097960300",2141,1198,41,0,313,199,13,21,3926
"55097960400",2366,1635,0,2,155,201,60,40,4459
"55097960500",6234,209,122,0,164,22,129,22,6902
"55097960600",4764,418,29,5,94,6,41,14,5371
"55097960701",4815,403,0,15,94,27,38,180,5572
"55097960702",2650,271,0,0,101,14,84,0,3120
"55097960800",4192,530,61,0,489,71,240,103,5686
"55097960900",2508,579,23,0,38,44,10,57,3259
"55097961000",1900,992,56,16,0,36,45,37,3082
"55097961100",4849,568,0,0,542,168,31,0,6158
"55097961200",4963,919,44,0,245,41,50,90,6352
"55097961300",4567,510,0,0,54,125,214,251,5721
"55099970100",2307,249,3,0,75,7,16,0,2657
"55099970200",2092,385,0,0,12,9,20,0,2518
"55099970400",1703,71,0,0,45,6,5,1,1831
"55099970500",1606,352,0,0,52,53,19,0,2082
"55099970600",1893,259,0,2,20,58,7,0,2239
"55099970700",1901,418,1,0,46,10,40,65,2481
"55101000100",354,204,111,165,35,10,22,24,925
"55101000200",2588,349,1061,467,580,43,860,90,6038
"55101000300",896,581,771,462,485,165,835,646,4841
"55101000400",1096,834,429,682,461,230,1010,684,5426
"55101000500",1212,684,1143,1029,629,495,1375,1028,7595
"55101000600",3711,603,414,389,616,257,1112,391,7493
"55101000700",3573,391,972,51,513,244,874,328,6946
"55101000800",2952,471,622,165,185,46,1035,207,5683
"55101000901",2464,263,289,44,339,139,522,43,4103
"55101000903",3532,53,437,21,174,15,248,0,4480
"55101000904",3479,683,356,0,280,120,88,225,5231
"55101001001",1049,272,306,425,282,129,256,287,3006
"55101001002",1736,132,356,8,117,42,300,15,2706
"55101001003",2498,284,351,221,144,149,508,29,4184
"55101001100",4894,251,394,82,601,54,596,27,6899
"55101001201",2114,445,309,254,214,205,185,274,4000
"55101001202",3220,763,577,241,562,495,881,354,7093
"55101001301",2346,360,418,0,354,103,365,103,4049
"55101001302",1786,870,677,440,557,153,755,431,5669
"55101001400",5057,502,751,0,334,0,453,0,7097
"55101001501",2901,297,84,0,144,1,154,0,3581
"55101001502",5520,475,256,24,378,62,292,60,7067
"55101001504",2086,130,214,55,428,19,174,28,3134
"55101001505",3395,299,73,344,121,144,364,111,4851
"55101001601",5303,229,141,61,152,92,216,0,6194
"55101001602",2642,303,245,0,208,0,103,0,3501
"55101001701",2101,255,526,147,414,29,163,12,3647
"55101001702",4234,201,19,144,249,51,384,9,5291
"55101001703",3719,207,30,0,422,0,402,84,4864
"55101001705",4580,178,245,0,201,0,406,53,5663
"55101001706",3291,103,189,99,143,0,162,0,3987
"55101001801",4326,430,0,0,288,4,227,0,5275
"55101001802",2730,99,0,3,41,0,60,12,2945
"55101001900",3676,127,15,1,47,0,171,0,4037
"55101002001",2748,81,1,0,38,0,0,0,2868
"55101002002",4807,198,5,4,117,0,132,0,5263
"55101002100",3102,102,0,16,58,0,77,0,3355
"55101002401",4928,654,63,2,296,0,265,0,6208
"55101002402",3487,689,23,372,46,168,233,179,5197
"55101002600",5539,302,13,0,17,15,50,15,5951
"55101002701",3532,86,135,0,202,0,80,25,4060
"55101002702",5211,376,15,0,84,0,398,0,6084
"55101002800",5449,170,40,0,224,57,200,35,6175
"55101980000",45,30,0,4,2,0,0,0,81
"55101990000",0,0,0,0,0,0,0,0,0
"55103970100",2367,317,4,0,39,34,3,4,2768
"55103970200",4031,649,0,0,63,16,31,5,4795
"55103970300",2117,261,77,0,20,0,104,0,2579
"55103970400",2756,587,11,0,97,38,53,16,3558
"55103970500",3367,453,24,8,60,140,30,128,4210
"55105000100",725,249,25,11,39,12,15,33,1109
"55105000200",2414,253,0,11,116,30,88,60,2972
"55105000300",976,763,6,219,369,193,174,219,2919
"55105000400",2278,569,13,42,260,210,163,48,3583
"55105000500",3460,605,29,3,44,33,132,107,4413
"55105000600",2523,578,16,92,113,55,94,46,3517
"55105000700",2780,616,82,84,43,127,164,93,3989
"55105000800",3355,274,11,2,76,41,119,18,3896
"55105000900",2675,65,34,0,17,26,134,15,2966
"55105001000",2020,972,23,30,227,89,242,379,3982
"55105001100",4013,564,85,58,73,62,74,0,4929
"55105001201",4667,214,52,0,109,17,66,8,5133
"55105001202",4563,181,0,0,140,107,220,0,5211
"55105001302",6251,372,37,11,207,134,65,0,7077
"55105001303",3880,297,14,0,264,3,84,6,4548
"55105001304",6861,935,17,11,187,53,122,144,8330
"55105001400",5414,512,23,57,215,331,410,175,7137
"55105001500",736,297,27,64,0,147,16,226,1513
"55105001600",2403,1213,284,372,324,132,1049,251,6028
"55105001700",2863,950,348,288,580,388,778,691,6886
"55105001800",1445,882,510,446,292,126,829,647,5177
"55105001900",1668,294,56,118,70,82,155,30,2473
"55105002000",2945,507,36,74,162,136,415,9,4284
"55105002100",2857,480,268,69,369,31,457,18,4549
"55105002200",2013,217,14,36,103,0,27,81,2491
"55105002300",1141,175,129,106,148,39,140,68,1946
"55105002400",3240,499,20,14,114,0,0,0,3887
"55105002500",1732,381,222,77,214,29,260,219,3134
"55105002601",3833,346,232,124,454,168,423,112,5692
"55105002602",3186,318,93,24,225,69,168,148,4231
"55105002700",2408,202,0,0,70,4,35,0,2719
"55105002800",4481,554,15,7,99,9,49,23,5237
"55105002900",7448,485,7,19,223,45,321,20,8568
"55105003001",4161,691,0,0,53,33,289,0,5227
"55105003002",4550,260,0,12,158,0,91,0,5071
"55105003100",6986,414,17,42,72,117,120,0,7768
"55105003200",2277,244,0,2,92,6,211,87,2919
"55105003300",2870,235,43,0,143,17,267,40,3615
"55107960100",3123,494,11,0,52,20,30,2,3732
"55107960200",1731,304,5,0,6,19,12,27,2104
"55107960300",1815,385,0,0,4,20,23,12,2259
"55107960400",2244,533,30,0,28,2,9,1,2847
"55107960500",2540,650,18,32,70,83,59,22,3474
"55109120100",2057,142,20,0,130,0,71,0,2420
"55109120201",5295,316,106,0,213,1,93,0,6024
"55109120202",5314,25,0,0,172,0,100,0,5611
"55109120300",5079,219,16,0,138,80,152,49,5733
"55109120400",9292,840,50,28,190,199,147,363,11109
"55109120501",4293,515,21,29,60,138,49,0,5105
"55109120502",4705,430,15,0,72,43,12,0,5277
"55109120600",7512,437,25,20,133,27,45,17,8216
"55109120700",4087,223,1,3,96,23,63,0,4496
"55109120800",7198,624,3,8,245,3,105,2,8188
"55109120901",3794,156,3,0,34,23,213,15,4238
"55109120903",7317,641,163,1,444,20,190,0,8776
"55109120904",3766,155,0,0,15,16,11,0,3963
"55109121000",6514,335,20,16,141,48,65,29,7168
"55111000100",4850,815,34,0,466,393,215,350,7123
"55111000200",4111,378,4,0,113,32,97,41,4776
"55111000300",5193,1145,39,35,165,53,113,53,6796
"55111000401",4830,322,0,14,110,52,310,25,5663
"55111000402",2669,428,35,1,16,7,0,0,3156
"55111000500",2587,393,6,17,229,232,238,232,3934
"55111000600",5666,472,19,0,329,3,233,101,6823
"55111000700",2531,325,0,0,56,0,0,0,2912
"55111000800",3263,331,0,3,121,12,42,0,3772
"55111000900",4343,452,35,0,125,15,110,78,5158
"55111001001",5839,578,0,0,327,0,180,21,6945
"55111001002",2324,469,0,1,8,196,188,142,3328
"55111001100",3695,377,1,0,29,8,28,10,4148
"55113100300",3153,606,15,37,340,35,9,29,4224
"55113100400",2054,243,3,0,78,66,16,0,2460
"55113100500",2909,195,0,0,130,2,15,0,3251
"55113100700",1133,209,12,2,103,65,9,6,1539
"55113100800",1157,282,0,0,70,15,12,28,1564
"55113940000",712,58,12,6,1324,1040,81,46,3279
"55115100100",2646,117,0,0,84,9,59,0,2915
"55115100200",1687,116,0,0,54,4,0,0,1861
"55115100300",3147,218,0,7,314,30,79,12,3807
"55115100400",3254,587,7,0,625,32,29,144,4678
"55115100500",3496,517,47,0,377,69,17,27,4550
"55115100600",2179,331,12,1,1308,461,68,28,4388
"55115100700",2740,429,0,0,96,134,138,119,3656
"55115100800",3747,595,7,13,222,51,91,5,4731
"55115100900",3139,358,0,0,95,34,63,2,3691
"55115101000",3121,396,0,0,75,0,17,47,3656
"55115101100",3462,186,0,0,51,11,4,0,3714
"55117000100",2785,429,0,0,546,0,155,62,3977
"55117000201",1743,310,18,77,263,378,262,131,3182
"55117000202",2785,446,29,107,295,4,109,43,3818
"55117000300",5474,326,53,0,864,132,293,18,7160
"55117000400",3273,516,0,0,323,39,437,151,4739
"55117000500",2072,949,118,45,721,180,209,348,4642
"55117000800",3226,930,70,64,728,599,863,781,7261
"55117000900",3923,124,21,1,385,85,282,16,4837
"55117001000",5587,571,148,0,801,255,595,39,7996
"55117001100",3213,261,43,0,175,82,135,27,3936
"55117010100",1390,53,0,5,18,5,6,22,1499
"55117010200",3819,172,0,0,101,0,66,6,4164
"55117010300",2771,198,0,2,30,1,36,1,3039
"55117010400",2358,58,0,6,21,4,1,0,2448
"55117010501",6401,643,120,0,156,0,102,0,7422
"55117010502",3290,330,32,0,151,9,2,8,3822
"55117010601",5170,169,0,0,200,9,12,0,5560
"55117010602",3712,228,0,0,83,0,248,28,4299
"55117010700",8076,98,4,0,381,19,124,0,8702
"55117010800",3205,51,0,0,121,0,92,0,3469
"55117010900",2863,188,0,0,121,23,47,0,3242
"55117011000",2192,201,1,0,140,21,14,10,2579
"55117011100",2679,142,0,0,83,3,36,3,2946
"55117011200",3024,234,0,0,74,0,30,0,3362
"55117011300",6862,267,12,9,44,23,120,9,7346
"55117011400",1705,219,0,67,120,63,222,74,2470
"55117990000",0,0,0,0,0,0,0,0,0
"55119960100",3650,540,41,7,45,22,100,35,4440
"55119960200",2052,186,10,0,20,0,19,0,2287
"55119960300",2306,491,12,0,19,21,16,23,2888
"55119960400",4287,462,0,0,52,8,18,0,4827
"55119960500",2347,292,0,0,0,0,58,0,2697
"55119960600",2741,584,0,0,44,13,30,38,3450
"55121100100",2801,267,0,0,96,38,54,0,3256
"55121100200",2871,207,0,23,71,6,68,0,3246
"55121100300",2033,205,0,34,112,161,195,163,2903
"55121100400",3079,601,0,0,98,0,60,3,3841
"55121100500",2629,396,0,0,35,4,38,4,3106
"55121100600",2997,351,38,0,331,351,677,435,5180
"55121100700",4773,352,8,3,39,25,27,25,5252
"55121100800",3204,418,1,0,36,27,41,6,3733
"55123960100",3231,877,7,5,72,17,61,10,4280
"55123960200",3335,1116,2,14,20,109,32,109,4737
"55123960300",3730,416,45,0,15,32,23,5,4266
"55123960400",3932,521,0,0,50,88,4,0,4595
"55123960500",2793,664,1,0,75,11,29,36,3609
"55123960600",4035,451,4,4,73,5,58,3,4633
"55123960700",3450,382,5,2,62,7,59,4,3971
"55125940000",1112,147,1,0,1205,978,82,19,3544
"55125950200",3502,387,1,0,124,14,38,0,4066
"55125950500",4670,876,4,2,185,0,74,30,5841
"55125950600",3472,324,0,0,23,17,11,1,3848
"55125950700",3638,258,34,30,130,0,71,6,4167
"55127000101",4555,866,95,2,131,18,108,0,5775
"55127000102",2371,267,18,0,27,0,31,0,2714
"55127000200",5942,400,28,0,307,28,319,56,7080
"55127000301",2743,220,3,8,58,5,109,0,3146
"55127000302",5788,324,18,4,192,20,399,24,6769
"55127000400",2668,1026,11,31,376,136,418,88,4754
"55127000501",831,1258,0,86,10,25,76,21,2307
"55127000502",2231,930,96,0,192,133,156,134,3872
"55127000600",4585,610,59,37,358,43,762,110,6564
"55127000701",3460,235,0,4,23,238,838,244,5042
"55127000702",3370,800,4,0,333,124,961,362,5954
"55127000800",4069,251,37,0,342,28,458,21,5206
"55127000901",5524,355,72,1,116,27,510,44,6649
"55127000902",2621,382,44,0,110,75,261,307,3800
"55127001000",3971,511,38,0,114,3,49,7,4693
"55127001501",2634,399,0,0,211,0,313,115,3672
"55127001502",4344,482,0,1,154,54,624,120,5779
"55127001602",4453,1173,0,8,174,106,476,517,6907
"55127001603",2081,296,0,10,207,4,306,44,2948
"55127001604",4190,503,20,0,128,0,336,127,5304
"55127001701",4936,406,66,19,386,16,330,126,6285
"55127001702",4235,501,2,6,201,75,312,126,5458
"55129950100",1546,210,2,0,28,2,8,9,1805
"55129950200",1528,173,0,0,49,7,10,4,1771
"55129950300",2234,312,1,0,157,14,19,5,2742
"55129950500",4037,689,21,20,121,75,22,70,5055
"55129950600",3660,495,5,4,97,19,43,2,4325
"55131400102",3556,167,35,0,24,0,54,0,3836
"55131400103",3602,235,0,0,113,0,11,0,3961
"55131400104",5348,436,0,0,245,0,122,4,6155
"55131410100",4308,466,137,34,37,0,51,0,5033
"55131420103",5509,127,0,1,342,0,53,0,6032
"55131420104",4455,221,8,0,41,17,43,0,4785
"55131420105",3711,514,0,94,219,118,215,330,5201
"55131420106",3138,293,2,0,52,88,84,80,3737
"55131420200",5142,232,22,0,157,21,114,0,5688
"55131420300",4557,520,158,0,119,86,106,0,5546
"55131420401",1641,207,9,8,47,10,25,10,1957
"55131420402",1886,173,0,0,12,0,0,0,2071
"55131430100",5668,175,14,0,16,0,57,4,5934
"55131440103",4344,302,32,6,125,17,104,0,4930
"55131440104",4931,330,38,0,135,0,311,55,5800
"55131440105",3081,211,26,0,102,0,31,47,3498
"55131440106",3513,144,0,11,92,2,97,11,3870
"55131440200",3351,413,0,31,235,0,160,175,4365
"55131450103",4621,551,0,0,15,0,40,163,5390
"55131450104",5719,59,74,0,237,18,58,28,6193
"55131450105",2707,135,0,0,5,1,19,0,2867
"55131450106",5466,324,8,0,63,0,108,0,5969
"55131460101",5885,147,49,0,186,0,100,0,6367
"55131460102",4837,126,76,0,59,0,86,25,5209
"55131470100",4173,227,147,0,168,0,242,12,4969
"55131470202",5865,211,33,0,150,0,131,0,6390
"55131470203",3724,338,67,14,76,87,149,14,4469
"55131470204",3999,58,165,0,314,87,23,87,4733
"55133200101",3876,215,42,139,323,1,233,0,4829
"55133200102",4890,213,12,0,194,0,304,0,5613
"55133200103",2708,121,21,0,217,13,56,5,3141
"55133200201",3119,211,133,0,59,0,7,0,3529
"55133200202",3627,150,64,0,261,0,0,0,4102
"55133200300",3568,176,30,0,223,38,123,38,4196
"55133200400",5539,124,212,1,675,0,85,0,6636
"55133200500",4606,164,225,0,422,46,82,0,5545
"55133200600",1390,148,25,8,79,88,47,82,1867
"55133200700",3290,189,31,0,170,0,51,13,3744
"55133200801",4614,62,11,0,104,0,75,0,4866
"55133200803",3967,274,15,1,117,0,114,0,4488
"55133200804",3075,199,33,0,344,6,41,53,3751
"55133200901",3513,164,141,0,47,15,27,0,3907
"55133200902",3686,78,0,0,186,8,31,0,3989
"55133201000",5642,110,12,0,293,0,34,0,6091
"55133201101",4374,85,14,0,381,80,137,12,5083
"55133201102",2571,156,42,0,171,20,120,60,3140
"55133201201",1824,81,1,0,64,0,59,0,2029
"55133201202",4856,186,217,0,603,14,252,0,6128
"55133201203",2652,55,11,0,456,0,60,0,3234
"55133201300",4340,220,40,0,380,43,31,43,5097
"55133201402",3850,302,0,0,357,16,89,0,4614
"55133201403",3430,242,125,0,193,23,124,0,4137
"55133201404",3533,136,93,4,84,28,26,0,3904
"55133201503",6029,100,14,0,611,1,216,0,6971
"55133201504",5561,170,0,0,341,0,287,0,6359
"55133201505",2705,46,0,0,124,0,46,0,2921
"55133201506",4501,164,36,10,134,0,198,0,5043
"55133201600",4611,204,0,0,323,33,119,0,5290
"55133201701",4067,363,0,0,56,0,18,0,4504
"55133201703",5850,107,0,0,126,0,134,0,6217
"55133201704",4997,61,0,0,89,0,212,0,5359
"55133201800",1500,59,0,0,41,0,33,0,1633
"55133201900",4928,241,0,0,261,0,167,0,5597
"55133202001",4648,135,42,0,215,0,87,0,5127
"55133202002",3790,123,0,0,68,27,19,0,4027
"55133202101",3747,105,0,0,380,70,206,0,4508
"55133202102",4366,224,22,0,179,0,279,0,5070
"55133202103",3233,87,177,0,88,0,91,0,3676
"55133202201",3873,82,0,4,140,0,108,0,4207
"55133202202",4214,470,13,281,686,116,812,23,6615
"55133202301",4069,245,72,0,168,21,261,99,4935
"55133202302",4569,1149,277,452,305,183,954,640,8529
"55133202400",3833,226,0,0,350,157,409,0,4975
"55133202500",3229,476,0,136,219,119,529,186,4894
"55133202600",1732,398,0,0,63,184,333,289,2999
"55133202700",1131,249,28,26,219,0,200,0,1853
"55133202800",2767,569,41,13,224,104,652,496,4866
"55133202901",3124,175,56,173,658,227,215,178,4806
"55133202902",2836,299,77,19,283,4,162,0,3680
"55133203000",1554,122,18,18,97,127,244,105,2285
"55133203101",5326,321,55,54,577,150,369,42,6894
"55133203102",6140,288,0,0,325,0,560,140,7453
"55133203103",3782,486,40,0,134,44,369,103,4958
"55133203200",3812,177,0,0,155,15,190,0,4349
"55133203303",3727,84,0,0,45,0,9,0,3865
"55133203304",3882,89,31,38,434,0,27,8,4509
"55133203305",3635,209,39,0,124,0,71,0,4078
"55133203306",5514,325,3,0,353,0,216,0,6411
"55133203402",3283,159,61,0,274,0,48,0,3825
"55133203403",5354,36,32,0,97,1,105,0,5625
"55133203404",2612,405,17,44,46,10,41,10,3185
"55133203405",4240,75,51,0,48,0,55,0,4469
"55133203406",5901,205,17,2,298,0,100,0,6523
"55133203500",6387,72,5,0,127,0,95,0,6686
"55133203601",3512,287,46,0,182,14,37,13,4091
"55133203602",5128,291,13,13,303,25,161,25,5959
"55133203702",4497,137,0,0,331,0,273,0,5238
"55133203703",3148,138,9,0,195,4,6,0,3500
"55133203704",4417,232,27,0,217,18,75,0,4986
"55133203802",6170,197,0,0,299,0,15,0,6681
"55133203803",3859,51,48,1,118,0,159,0,4236
"55133203804",6066,233,102,0,124,0,196,0,6721
"55133203901",4092,329,0,1,20,0,147,37,4626
"55133203902",3509,254,0,0,90,87,56,29,4025
"55133204002",4992,290,91,0,129,0,48,0,5550
"55133204003",3615,128,0,3,90,0,131,0,3967
"55133204004",3872,95,0,1,193,0,41,2,4204
"55133204100",4799,105,32,0,54,18,137,10,5155
"55133204200",6230,325,54,0,677,16,706,10,8018
"55133204301",4484,165,0,14,154,10,95,0,4922
"55133204302",3186,313,84,0,69,0,177,10,3839
"55133204400",1914,116,3,0,27,0,44,23,2127
"55133204501",2257,51,0,0,19,0,47,0,2374
"55133204502",5590,632,64,0,37,0,53,29,6405
"55135100100",3300,428,0,0,75,30,55,11,3899
"55135100200",2486,356,3,0,95,29,14,27,3010
"55135100300",3245,389,0,0,48,8,14,13,3717
"55135100400",3914,432,6,0,63,5,59,4,4483
"55135100500",2388,234,29,14,42,0,65,16,2788
"55135100600",4534,286,0,0,52,14,183,10,5079
"55135100700",2581,460,10,0,45,78,181,93,3448
"55135100800",4295,241,24,14,15,0,23,0,4612
"55135100900",4973,642,185,0,124,12,244,12,6192
"55135101000",4606,640,0,0,139,97,73,0,5555
"55135101100",4333,564,0,0,29,0,242,0,5168
"55135101200",3409,277,18,1,124,8,49,6,3892
"55137960100",2506,242,11,5,48,0,48,5,2865
"55137960200",3421,467,12,10,46,29,46,13,4044
"55137960300",2690,303,3,4,128,107,245,85,3565
"55137960400",2888,390,5,5,75,10,148,31,3552
"55137960600",1921,108,0,0,7,0,0,0,2036
"55137960700",2829,424,19,5,118,24,61,22,3502
"55137960800",3662,406,3,23,153,37,610,53,4947
"55139000100",2473,532,0,0,68,0,63,0,3136
"55139000200",1852,466,156,47,40,52,21,159,2793
"55139000300",3369,580,11,56,82,128,10,152,4388
"55139000400",2046,732,0,0,88,0,91,5,2962
"55139000500",3446,2589,127,23,328,30,72,70,6685
"55139000700",531,1500,5,8,56,44,0,12,2156
"55139000800",2541,296,99,10,56,0,119,0,3121
"55139000900",2555,378,21,5,122,0,9,22,3112
"55139001000",2195,347,7,6,51,40,52,0,2698
"55139001100",3224,379,53,0,76,79,54,24,3889
"55139001200",1709,249,27,2,190,12,111,23,2323
"55139001300",2168,126,0,8,131,110,13,0,2556
"55139001400",3384,365,7,0,270,10,62,30,4128
"55139001500",2571,246,14,59,23,347,57,0,3317
"55139001600",2163,374,43,4,33,11,108,14,2750
"55139001700",2414,118,10,21,52,88,21,0,2724
"55139001801",4845,345,0,0,169,0,114,0,5473
"55139001803",5236,342,18,0,372,0,267,0,6235
"55139001804",3681,222,0,0,85,0,22,0,4010
"55139001900",4513,284,13,4,134,10,89,28,5075
"55139002000",6297,769,0,0,321,38,653,123,8201
"55139002100",3298,221,0,0,37,0,28,0,3584
"55139002201",4202,197,0,0,51,26,4,7,4487
"55139002202",2574,226,0,0,47,0,32,3,2882
"55139002300",5024,149,13,0,283,30,64,0,5563
"55139002400",8804,557,81,76,433,131,266,231,10579
"55139002500",3753,650,0,13,190,0,306,105,5017
"55139002601",3162,293,10,29,278,98,70,60,4000
"55139002602",3840,216,30,69,363,79,107,0,4704
"55139002700",1833,210,7,0,89,59,36,0,2234
"55139002800",3733,516,164,0,459,0,14,82,4968
"55139002900",1607,400,8,11,98,225,85,116,2550
"55139003000",1300,219,41,0,43,0,20,42,1665
"55139003100",1665,104,0,0,250,0,124,0,2143
"55139003200",1899,125,13,0,138,42,51,0,2268
"55139003300",1984,383,6,10,214,62,23,0,2682
"55139003400",3275,344,0,0,146,25,86,20,3896
"55139003500",2109,330,67,0,224,0,369,0,3099
"55139003600",3608,162,0,0,151,0,50,0,3971
"55139003701",2970,460,12,172,226,144,231,250,4465
"55139003702",7782,369,28,0,275,38,134,10,8636
"55141010100",4030,577,0,0,56,6,45,5,4719
"55141010200",4158,403,0,0,52,9,30,0,4652
"55141010300",2472,650,26,4,177,1,245,66,3641
"55141010400",2765,342,0,0,105,0,76,0,3288
"55141010500",2620,269,0,0,116,11,34,61,3111
"55141010600",3860,637,5,3,85,13,53,10,4666
"55141010700",4695,204,5,0,169,9,54,4,5140
"55141010800",2575,242,0,0,22,0,45,0,2884
"55141010900",3457,254,3,0,190,88,131,0,4123
"55141011000",4137,578,86,0,366,96,216,72,5551
"55141011100",2958,513,0,59,114,22,47,24,3737
"55141011200",2993,826,0,18,175,167,100,87,4366
"55141011300",3396,566,0,21,195,0,21,0,4199
"55141011400",4409,404,0,0,368,76,124,53,5434
"55141011500",5499,196,0,0,181,0,128,0,6004
"55141011600",4780,260,0,0,35,0,36,0,5111
"55141011700",3472,596,81,4,70,92,46,24,4385
"56001962700",2674,447,0,2,133,193,122,173,3744
"56001962800",2709,660,0,0,160,54,167,141,3891
"56001962900",1321,355,0,0,170,138,393,146,2523
"56001963000",1273,469,47,108,113,131,229,42,2412
"56001963100",4523,1859,83,0,521,67,330,252,7635
"56001963400",1967,1262,0,0,202,333,105,6,3875
"56001963500",85,484,0,26,54,41,0,7,697
"56001963600",3283,925,0,0,105,28,60,92,4493
"56001963700",3512,1663,64,119,303,176,638,155,6630
"56001963900",1782,83,6,0,143,0,67,0,2081
"56003962600",2066,77,0,0,120,4,89,9,2365
"56003962700",3088,367,0,0,139,161,344,194,4293
"56003962800",4713,571,0,0,212,78,338,40,5952
"56005000100",7981,447,157,10,627,6,526,60,9814
"56005000200",6307,141,0,0,168,0,353,0,6969
"56005000300",4314,748,16,35,609,67,531,112,6432
"56005000400",3443,448,0,6,344,23,507,147,4918
"56005000500",6285,72,7,0,166,270,254,238,7292
"56005000600",5092,216,34,0,195,21,569,25,6152
"56005000700",7539,668,90,12,305,1,365,75,9055
"56007967600",1188,202,15,0,35,1,107,34,1582
"56007967700",3241,803,0,42,331,190,728,414,5749
"56007967800",3334,243,29,22,217,9,946,134,4934
"56007968000",2983,446,0,0,120,10,92,29,3680
"56007968100",1100,214,0,14,47,33,81,10,1499
"56009956400",4391,262,1,0,177,1,301,22,5155
"56009956500",2345,259,0,0,125,147,187,65,3128
"56009956600",3043,272,0,0,41,21,164,21,3562
"56009956700",2311,246,13,26,142,35,214,0,2987
"56011950200",4398,204,4,0,28,15,112,7,4768
"56011950300",2315,133,0,0,5,0,56,0,2509
"56013000100",2425,761,9,0,437,408,101,221,4362
"56013000200",3010,210,0,0,178,9,26,27,3460
"56013000300",3804,140,12,0,279,30,244,25,4534
"56013000400",1422,39,26,0,36,9,14,0,1546
"56013940100",525,56,27,0,2687,627,157,32,4111
"56013940201",3453,326,0,0,286,21,141,10,4237
"56013940202",1875,55,5,5,2277,662,282,33,5194
"56013940300",3485,832,0,39,668,162,301,18,5505
"56013940400",4260,613,0,0,674,264,365,113,6289
"56013940500",1948,222,43,0,323,68,278,59,2941
"56015957700",1575,396,0,0,3,5,13,0,1992
"56015957800",2076,663,9,0,285,43,409,183,3668
"56015957900",4024,415,4,0,180,89,291,75,5078
"56015958000",2138,535,22,0,142,57,219,113,3226
"56017967800",2464,326,0,0,26,33,40,47,2936
"56017967900",1661,104,11,0,79,5,54,0,1914
"56019955100",2524,153,1,0,41,0,50,0,2769
"56019955200",4841,519,0,0,386,19,190,108,6063
"56021000200",2644,986,359,0,259,295,904,272,5719
"56021000300",2609,183,212,13,510,100,791,148,4566
"56021000401",3565,588,25,0,413,78,662,121,5452
"56021000402",3884,819,154,0,319,355,795,489,6815
"56021000501",6354,668,131,0,720,290,965,188,9316
"56021000600",4380,576,248,23,542,0,893,84,6746
"56021000700",2696,493,39,17,644,87,640,97,4713
"56021000800",1410,121,25,0,186,46,169,29,1986
"56021000900",2097,94,7,0,269,0,253,0,2720
"56021001000",2138,512,201,0,346,159,428,152,3936
"56021001100",1531,26,210,0,411,13,318,0,2509
"56021001200",4371,86,38,0,129,0,509,0,5133
"56021001300",6634,290,254,0,316,70,940,70,8574
"56021001401",3447,201,48,61,334,57,304,0,4452
"56021001402",2054,89,6,70,83,7,138,11,2458
"56021001501",3672,365,212,0,745,1,574,7,5576
"56021001502",3522,767,0,139,389,193,450,118,5578
"56021001901",5186,190,0,0,200,16,404,0,5996
"56021001902",4090,185,18,0,37,0,175,0,4505
"56021002000",7109,311,37,0,158,88,498,126,8327
"56021980801",0,0,0,0,0,0,0,0,0
"56023978000",5725,438,6,3,215,4,251,49,6691
"56023978100",5418,687,7,0,167,5,193,10,6487
"56023978200",1708,138,0,0,114,0,24,0,1984
"56023978400",3157,135,6,0,94,9,245,11,3657
"56025000200",2581,659,493,18,651,157,579,124,5262
"56025000300",3226,530,0,0,524,93,563,50,4986
"56025000400",3554,313,23,0,235,111,183,124,4543
"56025000501",4751,424,80,0,336,0,392,34,6017
"56025000502",2163,551,18,0,359,45,376,136,3648
"56025000600",6354,652,0,0,299,0,317,0,7622
"56025000700",2228,227,0,0,84,1,209,1,2750
"56025000800",3375,303,0,0,223,7,186,39,4133
"56025000901",3999,416,0,12,238,204,222,222,5313
"56025000902",3227,28,0,0,35,0,114,18,3422
"56025001000",3913,314,0,0,137,52,137,45,4598
"56025001100",1999,521,0,22,50,24,184,34,2834
"56025001200",1246,276,3,0,70,53,104,50,1802
"56025001401",5003,787,15,0,203,35,322,161,6526
"56025001602",5459,321,45,0,156,114,334,74,6503
"56025001603",3335,146,0,0,138,7,121,51,3798
"56025001700",4363,253,0,0,142,0,274,0,5032
"56025001800",3666,239,9,0,82,0,27,0,4023
"56027957200",1725,365,6,0,80,23,18,0,2217
"56029965100",4943,217,4,0,73,43,294,12,5586
"56029965200",4490,586,0,0,226,238,245,248,6033
"56029965300",6336,232,27,2,173,0,133,0,6903
"56029965400",5154,572,69,0,218,56,411,84,6564
"56029965500",3722,307,0,76,219,21,58,22,4425
"56031959100",1922,387,0,0,86,7,102,104,2608
"56031959400",5132,731,0,0,154,179,177,250,6623
"56033000100",3933,308,0,0,104,104,103,92,4644
"56033000200",2838,145,148,0,149,21,144,0,3445
"56033000300",3169,329,9,0,243,27,74,0,3851
"56033000400",4419,798,13,0,390,66,452,24,6162
"56033000500",6509,226,4,0,108,3,74,3,6927
"56033000600",3893,228,10,6,255,131,191,0,4714
"56035000101",3308,461,0,0,128,0,170,0,4067
"56035000102",5349,328,0,0,581,0,599,7,6864
"56037970500",2310,300,51,0,185,0,129,28,3003
"56037970601",3684,612,0,0,125,38,734,120,5313
"56037970602",3099,318,0,0,225,0,452,0,4094
"56037970700",3035,296,35,0,179,165,294,228,4232
"56037970800",3867,869,114,60,439,302,612,600,6863
"56037970901",6166,359,24,0,438,41,698,173,7899
"56037970902",3560,422,0,0,325,114,318,256,4995
"56037970903",2047,475,6,0,77,33,468,363,3469
"56037971000",1915,106,0,0,47,45,161,73,2347
"56037971100",2384,385,0,0,189,23,829,39,3849
"56037971200",2199,178,10,63,38,5,84,0,2577
"56037971600",1671,99,0,15,42,2,173,12,2014
"56039967600",4271,201,26,6,26,36,157,10,4733
"56039967701",2269,99,0,2,17,78,372,78,2915
"56039967702",5785,787,0,0,299,251,1011,412,8545
"56039967800",6844,398,29,0,427,0,1055,230,8983
"56041975200",5681,727,10,0,218,18,268,96,7018
"56041975300",6146,605,10,0,324,91,468,16,7660
"56041975400",5164,1169,0,0,287,336,474,524,7954
"56043000200",2514,279,63,0,150,209,134,267,3616
"56043000301",2228,358,0,0,39,25,129,41,2820
"56043000302",1885,305,0,0,226,1,465,105,2987
"56045951100",2775,287,0,0,54,0,9,0,3125
"56045951300",2923,382,0,0,192,169,184,17,3867
"72001956300",1360,2524,8,7,0,32,1368,2550,7849
"72001956400",951,1771,0,0,0,67,951,1828,5568
"72001956500",988,2068,0,69,0,28,988,2154,6295
"72001956600",658,1304,45,0,35,189,738,1493,4462
"72001956700",793,930,42,0,0,30,835,959,3589
"72001956800",2261,2688,0,0,71,95,2332,2783,10230
"72003430100",1579,1752,144,285,966,633,2613,2464,10436
"72003430200",1524,1832,50,0,657,1333,2177,3031,10604
"72003430300",431,794,64,44,393,745,837,1503,4811
"72003430401",1062,1603,40,0,951,1199,1908,2556,9319
"72003430402",1091,1801,58,102,601,902,1706,2727,8988
"72003430501",1571,1440,35,20,1435,1284,2709,2403,10897
"72003430502",984,1454,22,125,1393,887,2192,2324,9381
"72003430601",1172,1860,60,0,512,572,1646,2287,8109
"72003430602",1336,757,39,9,1044,477,2109,1155,6926
"72003990000",0,0,0,0,0,0,0,0,0
"72005400100",1956,1550,164,46,550,573,2487,2092,9418
"72005400300",1810,736,133,46,300,100,1898,869,5892
"72005400400",1552,1443,8,50,385,173,1935,1649,7195
"72005400501",1613,1370,64,39,170,344,1793,1753,7146
"72005400502",2825,1817,57,24,675,822,3491,2592,12303
"72005400600",804,1416,44,49,105,379,935,1789,5521
"72005400700",1555,934,57,70,131,82,1699,1086,5614
"72005400800",305,922,0,22,128,184,417,1098,3076
"72005400900",529,1220,25,50,52,473,606,1693,4648
"72005401000",228,792,8,14,117,144,353,938,2594
"72005401100",389,784,111,20,12,331,512,1135,3294
"72005401200",907,1377,89,28,717,732,1607,2048,7505
"72005401301",1199,2139,30,123,714,832,1766,2971,9774
"72005401302",2221,1948,58,167,1907,791,4035,2812,13939
"72005401401",1796,916,39,53,559,490,2171,1283,7307
"72005401402",1130,1040,264,82,683,755,2045,1831,7830
"72005990000",0,0,0,0,0,0,0,0,0
"72007230100",1742,2551,19,16,166,202,1927,2716,9339
"72007230200",2622,2337,21,129,245,492,2729,2958,11533
"72007230300",1207,1489,22,103,183,111,1404,1703,6222
"72007230400",1383,2605,122,147,304,379,1809,3130,9879
"72007230501",1426,1520,53,175,706,650,2185,2345,9060
"72007230502",2092,1797,103,48,445,384,2640,2199,9708
"72009250100",2366,1532,411,130,487,36,3264,1698,9924
"72009250200",2648,2085,87,145,132,301,2867,2531,10796
"72009250300",1237,1698,315,105,91,58,1628,1861,6993
"72009250400",921,1140,27,74,0,244,948,1448,4802
"72009250500",2436,1691,84,251,155,497,2675,2439,10228
"72009250600",1278,1840,101,115,202,300,1559,2245,7640
"72011810100",906,1252,17,103,279,463,1202,1818,6040
"72011810200",3179,2571,16,302,1118,1017,4270,3876,16349
"72011810300",936,751,34,97,244,313,1214,1142,4731
"72011810400",270,434,26,14,189,74,485,521,2013
"72011810500",1864,1405,68,0,1353,631,3214,2036,10571
"72011810600",1813,1337,43,27,487,775,2310,2126,8918
"72011810700",1243,1422,40,218,587,878,1854,2475,8717
"72011990000",0,0,0,0,0,0,0,0,0
"72013300101",2043,1983,301,127,415,182,2743,2282,10076
"72013300102",2522,1919,31,22,90,184,2643,2125,9536
"72013300200",1561,1174,182,136,552,308,2295,1618,7826
"72013300301",1594,1369,10,127,169,46,1773,1542,6630
"72013300302",3123,1426,212,41,195,276,3529,1743,10545
"72013300400",348,728,196,79,171,240,701,1025,3488
"72013300500",267,776,40,45,79,42,386,863,2498
"72013300700",493,707,15,18,63,94,571,819,2780
"72013300800",2401,1954,132,77,147,535,2664,2531,10441
"72013301000",3509,1663,39,0,295,191,3843,1854,11394
"72013301100",4191,2229,319,89,559,463,5038,2726,15614
"72013301200",1997,1672,56,98,184,189,2223,1935,8354
"72013301300",477,2616,9,89,62,490,538,3195,7476
"72013301400",437,477,93,59,46,149,576,685,2522
"72013301500",2215,1881,321,109,504,314,3021,2304,10669
"72013301600",1828,1382,28,133,304,301,2142,1816,7934
"72013301700",2130,2078,73,36,109,159,2312,2273,9170
"72013301800",659,970,6,0,36,33,689,1003,3396
"72013301900",1261,2495,0,59,0,195,1261,2749,8020
"72013302000",1504,1032,30,14,112,67,1630,1113,5502
"72013302100",2222,2989,71,0,40,51,2333,3037,10743
"72013302201",805,1561,0,15,103,30,889,1599,5002
"72013302202",2182,2437,32,0,156,42,2343,2425,9617
"72013302300",1117,1428,52,0,53,31,1222,1425,5328
"72013992900",0,0,0,0,0,0,0,0,0
"72015280101",292,719,317,479,77,657,686,1855,5082
"72015280102",2397,2253,713,691,790,717,3900,3661,15122
"72015280201",1050,1019,736,576,441,487,2227,2063,8599
"72015280202",1283,1029,605,830,592,494,2470,2332,9635
"72015991500",0,0,0,0,0,0,0,0,0
"72017590100",3462,3375,51,47,0,86,3513,3508,14042
"72017590200",1004,2641,107,23,32,156,1130,2805,7898
"72017590300",3231,4253,27,108,36,62,3217,4423,15357
"72017590400",3449,2552,0,53,0,123,3449,2651,12277
"72017990000",0,0,0,0,0,0,0,0,0
"72019952201",943,1043,69,53,1009,1295,2021,2391,8824
"72019952202",988,1725,185,87,889,1815,2062,3627,11378
"72019952301",984,818,0,8,705,1245,1689,2071,7520
"72019952302",801,2034,31,57,1570,1722,2350,3813,12378
"72019952400",469,795,0,121,257,667,726,1583,4618
"72019952500",1388,1918,149,178,1670,2044,3207,4140,14694
"72021030101",959,410,206,8,718,442,1821,850,5414
"72021030103",1017,1230,175,269,846,881,2038,2354,8810
"72021030104",2779,318,118,38,1113,44,3886,400,8696
"72021030105",1025,407,149,11,447,209,1435,627,4310
"72021030200",1885,433,171,75,568,155,2596,642,6525
"72021030300",961,899,153,43,1425,523,2539,1465,8008
"72021030700",203,466,59,101,163,446,425,1009,2872
"72021030800",684,120,10,45,97,185,786,350,2277
"72021030901",952,337,87,48,347,77,1346,462,3656
"72021030902",1279,295,72,22,375,324,1726,641,4734
"72021030903",788,376,95,7,306,106,1168,489,3335
"72021030904",968,660,64,32,324,322,1356,1008,4734
"72021031004",1286,292,177,24,775,247,2167,544,5512
"72021031005",1012,759,101,38,473,645,1519,1442,5989
"72021031011",2141,231,243,18,945,174,3274,423,7449
"72021031013",2300,1281,573,274,2234,1038,5089,2542,15331
"72021031021",1329,653,179,130,476,544,1974,1309,6594
"72021031023",1272,297,103,10,644,474,2019,781,5600
"72021031031",1926,417,213,193,973,699,2977,1309,8707
"72021031032",908,131,163,170,671,166,1661,467,4337
"72021031033",1241,518,203,117,1084,783,2502,1389,7837
"72021031101",1223,477,154,36,454,416,1788,899,5447
"72021031113",2085,1150,216,175,683,420,2948,1692,9369
"72021031114",965,1050,175,94,357,526,1497,1670,6334
"72021031121",1342,760,311,105,132,694,1771,1537,6652
"72021031122",1563,577,135,137,425,312,2123,1026,6298
"72021031123",1129,691,89,83,703,416,1905,1190,6206
"72021031124",543,235,54,31,321,650,918,916,3668
"72021031125",1033,318,62,25,474,525,1569,854,4860
"72021031201",481,864,70,69,285,1276,836,2209,6090
"72021031202",804,453,103,44,369,372,1276,852,4273
"72021031203",894,333,139,55,319,114,1345,502,3701
"72021031301",2671,753,144,219,1154,454,3959,1426,10780
"72021031304",749,242,17,0,739,628,1495,870,4740
"72021031305",2053,809,210,43,953,640,3206,1492,9406
"72021031306",1581,319,110,98,1024,549,2715,966,7362
"72021031307",1204,190,109,34,703,287,1994,511,5032
"72021031401",1368,557,165,154,653,213,2167,904,6181
"72021031402",947,385,88,422,536,398,1571,1172,5519
"72021031403",1258,728,154,126,246,307,1650,1161,5630
"72021031501",980,555,212,114,717,275,1882,944,5679
"72021031502",800,418,134,113,275,324,1209,855,4128
"72021031503",667,510,166,61,266,285,1094,856,3905
"72021031611",1265,546,115,217,169,197,1549,941,4999
"72021031612",1885,1519,275,496,527,751,2677,2766,10896
"72021031621",1131,298,164,82,314,345,1609,707,4650
"72021031622",1393,540,230,114,498,502,2113,1156,6546
"72021031631",1058,488,119,41,582,357,1727,858,5230
"72021031632",1038,562,149,77,362,314,1543,953,4998
"72021031641",920,613,181,157,378,144,1479,914,4786
"72021031651",1262,852,127,108,440,366,1795,1318,6268
"72021031701",1821,881,249,147,347,382,2401,1410,7638
"72021031702",1565,1223,193,95,599,598,2357,1913,8543
"72021031703",1968,578,230,39,565,213,2763,830,7186
"72021031704",2474,1128,438,87,707,235,3619,1450,10138
"72021031800",2676,775,296,55,1015,977,3987,1803,11584
"72021031900",2751,1667,60,37,1076,406,3887,2030,11914
"72021032000",356,353,33,0,221,379,610,732,2684
"72021032100",576,441,33,4,522,799,1131,1244,4750
"72021032200",603,732,84,155,332,532,1019,1419,4876
"72021032301",1687,183,93,24,805,177,2585,384,5938
"72021032302",598,710,105,29,548,216,1251,955,4412
"72023830101",2184,2174,30,16,376,183,2571,2373,9907
"72023830102",2093,2160,321,80,212,361,2626,2601,10454
"72023830200",3129,2054,364,58,343,51,3836,2146,11981
"72023830300",3442,1676,72,16,465,90,3928,1782,11471
"72023830400",1952,3426,25,120,34,189,2011,3735,11492
"72023830502",1608,2222,14,0,200,254,1793,2476,8567
"72023830503",2817,2765,10,164,276,24,3103,2953,12112
"72023830504",991,1941,114,0,56,413,1161,2354,7030
"72023830603",1896,2883,0,94,252,230,2087,3196,10638
"72023830604",1430,1860,0,0,146,250,1576,2110,7372
"72023980000",0,0,0,0,0,0,0,0,0
"72023990000",0,0,0,0,0,0,0,0,0
"72025200100",4234,1704,508,101,943,841,5652,2561,16544
"72025200200",1526,1687,109,56,1405,423,2993,2148,10347
"72025200302",4215,400,236,23,632,340,5083,763,11692
"72025200303",5103,934,486,33,2002,603,7494,1570,18225
"72025200304",2871,1335,259,74,886,460,3956,1863,11704
"72025200400",1449,570,120,157,494,117,2063,844,5814
"72025200500",2421,1775,303,243,448,205,3134,2195,10724
"72025200600",1479,1422,231,141,460,195,2170,1758,7856
"72025200700",2232,785,154,64,237,84,2581,913,7050
"72025200800",1711,813,289,104,156,73,2156,990,6292
"72025200900",331,755,81,283,68,88,480,1104,3190
"72025201000",511,1143,91,153,134,198,736,1472,4438
"72025201200",1164,1264,96,33,146,274,1406,1571,5954
"72025201300",1721,854,62,0,124,99,1907,953,5720
"72025201400",929,981,98,194,139,205,1159,1380,5085
"72025201500",1222,1116,50,168,203,159,1475,1443,5836
"72025201600",495,1879,28,243,80,601,595,2723,6644
"72025201700",777,789,79,188,100,109,949,1086,4077
"72025201800",1146,1262,54,106,160,295,1335,1630,5988
"72025201900",719,857,63,67,80,234,862,1158,4040
"72025202000",1674,1976,85,123,297,144,2024,2243,8566
"72025202100",1689,937,119,83,140,106,1948,1126,6148
"72025202200",931,566,78,129,101,100,1110,795,3810
"72025202300",1843,781,197,17,71,96,2111,873,5989
"72025202402",4375,1817,432,219,712,218,5272,2220,15265
"72025202403",1680,1341,65,0,353,191,2098,1532,7260
"72025202404",2254,1036,240,136,665,168,3159,1340,8998
"72025202500",2101,1352,117,70,353,246,2550,1668,8457
"72025202601",3385,2072,421,222,542,96,4282,2317,13337
"72025202602",4087,1587,564,251,466,118,5117,1956,14146
"72025202701",2002,954,299,174,776,628,3062,1756,9651
"72025202702",1905,1610,133,113,1210,204,3248,1913,10336
"72025202800",1275,1499,266,161,851,381,2392,2041,8866
"72027320100",925,1571,35,0,35,138,995,1665,5364
"72027320200",3074,2518,24,36,113,381,3165,2910,12221
"72027320300",4157,2384,2,30,486,412,4645,2826,14942
"72027320401",2915,1110,56,15,350,131,3321,1256,9154
"72027320402",1839,1660,43,16,276,166,2158,1820,7978
"72027320500",1903,2224,215,10,54,154,2150,2388,9098
"72027320600",2594,1650,16,1,95,571,2705,2165,9797
"72027990000",0,0,0,0,0,0,0,0,0
"72029100101",536,820,608,552,726,999,1870,2348,8459
"72029100103",644,437,598,224,464,995,1681,1656,6699
"72029100104",342,1459,92,575,540,2118,974,4140,10240
"72029100200",558,704,225,168,329,325,1112,1197,4618
"72029100400",1247,2055,411,287,1814,1211,3460,3553,14038
"72029100502",1467,593,483,123,723,331,2665,1047,7432
"72029100503",2987,790,426,96,972,373,4385,1259,11288
"72029100504",2025,282,474,31,543,83,3042,396,6876
"72029100601",1104,674,236,51,859,335,2199,1060,6518
"72029100602",658,883,336,244,599,591,1593,1718,6622
"72029100700",1428,1016,116,62,1193,699,2737,1777,9028
"72029100800",533,496,45,16,201,248,779,760,3078
"72031050103",3701,651,257,27,144,149,3922,777,9628
"72031050105",1507,616,479,388,112,50,2088,1037,6277
"72031050106",1127,143,69,0,264,23,1152,143,2921
"72031050107",1305,130,113,0,56,0,1370,110,3084
"72031050110",1790,470,421,254,345,235,2490,930,6935
"72031050111",984,161,75,0,51,0,1041,141,2453
"72031050211",1924,540,528,184,420,93,2863,817,7369
"72031050212",3262,1071,459,415,832,445,4543,1916,12943
"72031050221",2211,724,1116,321,290,243,3567,1274,9746
"72031050222",979,1095,891,922,328,658,2143,2675,9691
"72031050231",1120,530,664,257,690,281,2419,1050,7011
"72031050232",2491,477,761,117,1288,305,4516,899,10854
"72031050241",2303,778,1026,220,640,208,3942,1206,10323
"72031050242",1909,937,760,227,982,247,3593,1374,10029
"72031050302",1339,444,784,377,252,127,2360,948,6631
"72031050311",1280,574,191,83,197,76,1668,733,4802
"72031050321",1726,624,641,364,509,386,2849,1352,8451
"72031050331",862,345,193,46,256,152,1282,543,3679
"72031050341",1242,751,687,884,194,496,2088,2131,8473
"72031050401",1510,393,331,69,319,134,2142,596,5494
"72031050402",3829,1949,1055,1045,1479,893,6238,3887,20375
"72031050501",3669,1008,1272,141,854,61,5715,1210,13930
"72031050503",1873,696,999,436,554,233,3426,1365,9582
"72031050504",3543,1969,1632,415,407,246,5567,2611,16390
"72031050600",1918,1158,957,636,494,242,3318,2036,10759
"72031050700",322,163,160,155,243,290,725,591,2649
"72031050803",1687,660,820,286,472,308,2979,1254,8466
"72031050811",2197,448,677,146,580,239,3422,833,8542
"72031050812",1875,925,465,349,298,123,2608,1397,8040
"72031050821",1781,644,778,227,683,299,3183,1119,8714
"72031050822",1432,513,608,379,462,157,2493,1033,7077
"72031050831",1459,902,763,262,905,281,3127,1438,9137
"72031050841",760,621,485,528,356,436,1601,1585,6372
"72031050901",2144,623,614,403,1041,539,3799,1533,10696
"72031050902",2227,602,408,449,819,535,3454,1550,10044
"72031051001",1983,926,238,167,709,477,2906,1570,8976
"72031051002",924,774,312,372,466,319,1702,1446,6315
"72031051102",902,686,640,430,705,1101,2247,2179,8890
"72031051103",2463,500,540,147,1006,190,3957,837,9640
"72031051104",2035,418,556,232,566,26,3113,663,7609
"72031980003",0,0,0,0,0,0,0,0,0
"72031990000",0,0,0,0,0,0,0,0,0
"72033020200",869,1121,143,237,479,811,1463,2139,7262
"72033020302",415,960,23,57,299,388,737,1405,4284
"72033020403",2012,1297,332,121,415,562,2759,1980,9478
"72033020422",745,987,32,203,224,471,1001,1661,5324
"72033020423",2209,790,165,31,527,182,2851,1003,7758
"72033020425",662,954,175,82,82,674,919,1710,5258
"72033020426",144,1205,0,171,48,716,186,2086,4556
"72033020427",138,408,0,43,107,224,245,643,1808
"72033020500",3006,515,127,29,304,79,3391,611,8062
"72033980001",0,0,0,0,0,0,0,0,0
"72033980002",0,0,0,0,0,0,0,0,0
"72033980003",10,137,0,0,0,37,10,174,368
"72033980004",0,0,0,0,0,0,0,0,0
"72033980005",0,0,0,0,0,0,0,0,0
"72033980006",0,0,0,0,0,0,0,0,0
"72033980007",0,0,0,0,0,0,0,0,0
"72033980008",0,0,0,0,0,0,0,0,0
"72033990201",0,0,0,0,0,0,0,0,0
"72035260100",4440,2346,208,58,1519,817,6167,3172,18727
"72035260201",2384,480,101,48,444,107,2916,635,7115
"72035260202",1949,911,95,59,745,201,2750,1171,7881
"72035260300",1728,1275,51,32,556,308,2335,1615,7900
"72035260400",1684,1425,40,78,366,913,2090,2416,9012
"72035260500",1693,1230,36,72,455,946,2161,2248,8841
"72035260600",914,1702,0,89,165,506,1079,2297,6752
"72035260700",884,1207,69,33,167,416,1120,1646,5542
"72035260800",1534,1108,152,104,328,229,2014,1410,6879
"72035260901",2300,691,123,0,439,77,2788,768,7186
"72035260902",1427,1594,55,66,668,368,2131,2028,8337
"72037160100",0,0,0,0,0,0,0,0,0
"72037160201",1852,1016,247,135,1087,665,3178,1816,9996
"72037160202",1131,1216,64,47,652,569,1788,1832,7299
"72037160300",1434,1149,162,97,710,834,2306,2069,8761
"72037990000",0,0,0,0,0,0,0,0,0
"72039955600",2177,2893,26,0,65,69,2262,2962,10454
"72039955700",1053,1886,0,1,89,41,1142,1928,6140
"72039955800",2363,2574,55,0,118,28,2513,2602,10253
"72039955900",1309,3263,0,54,71,35,1348,3339,9419
"72041240101",2720,1031,89,65,767,310,3543,1406,9931
"72041240102",2310,1226,43,0,594,257,2927,1483,8840
"72041240201",1739,1356,70,2,939,351,2729,1708,8894
"72041240202",1772,1261,82,100,431,453,2285,1814,8198
"72041240300",1235,513,39,25,188,99,1450,637,4186
"72041240401",2313,996,245,9,721,359,3254,1364,9261
"72041240402",1767,1095,89,106,333,462,2189,1663,7704
"72041240500",1746,1850,61,45,355,428,2162,2323,8970
"72041240601",1842,1505,77,179,720,796,2639,2480,10238
"72041240602",2134,1323,25,94,630,324,2770,1728,9028
"72043953900",888,853,90,82,300,337,1278,1272,5100
"72043954000",1244,1314,78,101,351,582,1648,1997,7315
"72043954100",404,1067,104,206,194,347,702,1620,4644
"72043954200",2561,1808,47,537,874,625,3482,2970,12904
"72043954300",481,841,78,190,58,202,617,1233,3700
"72043954400",848,879,47,65,238,231,1133,1175,4616
"72043954500",2185,3344,325,188,996,1110,3506,4642,16296
"72043954600",1663,1161,255,260,882,985,2794,2406,10406
"72043954700",3663,1915,291,173,1026,793,4980,2824,15665
"72045951700",1594,1625,54,133,279,903,1927,2661,9176
"72045951800",1549,1520,94,1,967,1932,2610,3453,12126
"72045951900",654,1083,38,0,111,903,803,1970,5562
"72045952000",587,968,18,75,484,502,1089,1545,5268
"72045952100",1557,886,136,70,611,1135,2304,2091,8790
"72047530100",935,561,74,34,831,836,1840,1423,6534
"72047530200",1867,1116,51,38,1354,1934,3255,3078,12693
"72047530300",1027,1072,21,0,610,1442,1658,2514,8344
"72047530400",1797,1117,40,30,1806,1922,3643,3069,13424
"72047530500",2303,2349,51,169,1888,2404,4242,4885,18291
"72047530600",1189,1989,0,0,1340,2144,2529,4133,13324
"72049950500",512,437,42,7,335,252,860,654,3099
"72049990501",0,0,0,0,0,0,0,0,0
"72051540100",1153,870,177,184,332,226,1662,1280,5884
"72051540200",2543,915,420,43,159,212,2982,1062,8336
"72051540300",943,724,214,267,126,206,1283,1197,4960
"72051540400",6005,1152,517,314,655,353,6908,1803,17707
"72051540500",3733,1787,755,649,576,479,4830,2897,15706
"72051540600",2021,1393,396,612,171,379,2526,2362,9860
"72051540700",2929,2273,279,509,287,238,3477,2991,12983
"72051990021",0,0,0,0,0,0,0,0,0
"72053150102",993,507,166,82,456,269,1615,853,4941
"72053150104",1743,987,192,194,598,375,2359,1556,8004
"72053150200",2112,1509,378,212,731,200,3213,1875,10230
"72053150301",1012,1019,223,270,386,1186,1621,2457,8174
"72053150302",630,565,156,61,229,284,1015,901,3841
"72053150400",1474,792,226,208,601,682,2271,1682,7936
"72053150500",1406,1297,152,274,666,1154,2224,2725,9898
"72053150601",794,906,110,61,591,521,1495,1488,5966
"72053150602",2158,1075,273,107,1178,846,3587,2028,11252
"72053990103",0,0,0,0,0,0,0,0,0
"72054580100",2329,3099,0,0,52,15,2381,3104,10980
"72054580200",3268,3594,0,30,48,119,3316,3734,14109
"72055960900",1572,2478,8,96,31,396,1611,2949,9141
"72055961000",794,1176,27,50,23,556,844,1782,5252
"72055961100",744,2325,46,67,161,129,951,2497,6920
"72055961200",473,1009,46,74,22,136,541,1219,3520
"72055961300",822,1353,25,74,18,232,836,1645,5005
"72055961400",788,594,25,0,8,33,821,627,2896
"72055961500",954,1083,7,80,31,24,992,1180,4351
"72055990000",0,0,0,0,0,0,0,0,0
"72057270100",1952,1727,85,303,458,541,2483,2571,10120
"72057270201",1866,1584,386,392,818,964,3070,2860,11940
"72057270202",556,1079,158,146,36,281,750,1506,4512
"72057270300",2412,1540,483,425,812,347,3707,2312,12038
"72057270400",714,1835,71,262,87,124,872,2221,6186
"72057270500",2492,1374,731,179,438,299,3661,1852,11026
"72057270600",844,1324,214,250,117,493,1175,2067,6484
"72057270700",872,770,250,428,257,458,1379,1656,6070
"72057270800",2831,2812,527,267,659,907,4017,3986,16006
"72057992600",0,0,0,0,0,0,0,0,0
"72059740101",1372,1574,0,26,142,59,1492,1659,6324
"72059740102",1402,1367,14,27,227,133,1643,1509,6322
"72059740200",2259,2670,99,64,287,396,2636,3130,11541
"72059740300",1297,1497,84,64,166,70,1547,1631,6356
"72059740400",1819,3269,153,44,185,30,2157,3343,11000
"72059990001",0,0,0,0,0,0,0,0,0
"72061040101",828,822,105,8,385,254,1317,1084,4803
"72061040102",585,701,187,331,241,235,994,1234,4508
"72061040103",702,649,198,71,97,625,997,1343,4682
"72061040200",2776,384,80,100,195,259,2974,727,7495
"72061040301",1333,127,29,0,75,9,1400,136,3109
"72061040302",1859,199,53,0,126,114,1951,312,4614
"72061040303",1144,157,65,0,204,54,1413,211,3248
"72061040304",4149,391,85,116,197,149,4326,642,10055
"72061040403",4019,907,286,251,589,412,4879,1570,12913
"72061040411",3340,903,38,134,214,442,3502,1479,10052
"72061040412",1468,108,77,9,106,0,1616,117,3501
"72061040421",5677,1039,494,124,842,535,6859,1698,17268
"72061040422",1733,491,226,36,184,229,2102,734,5735
"72061040432",1703,603,112,16,258,102,2049,694,5537
"72061040442",2598,261,36,27,584,226,3209,442,7383
"72061040500",2417,989,156,34,395,258,2947,1281,8477
"72061040601",2113,1139,93,65,738,680,2944,1884,9656
"72061040602",7208,701,440,58,1072,163,8380,922,18944
"72061040700",3813,2427,353,169,1030,1127,5173,3723,17815
"72061040800",1443,1285,101,184,511,258,2016,1727,7525
"72061040900",1729,1084,74,77,284,512,2072,1673,7505
"72061041000",1246,461,105,102,540,368,1869,931,5622
"72061041100",1695,1262,22,13,839,292,2483,1552,8158
"72063210100",1597,1197,304,70,430,509,2322,1776,8205
"72063210201",918,1102,146,57,578,532,1642,1691,6666
"72063210202",3317,2133,819,440,2186,1234,6322,3733,20184
"72063210300",270,841,227,143,329,484,816,1454,4564
"72063210400",1282,1326,242,323,618,350,2142,1985,8268
"72063210502",7673,935,301,266,2971,520,10945,1697,25308
"72063210503",1222,320,184,26,432,344,1838,690,5056
"72063210504",2376,1446,785,666,961,795,4078,2869,13976
"72065310100",4057,3307,99,0,141,342,4277,3622,15845
"72065310200",2119,2645,11,44,275,122,2289,2811,10316
"72065310300",3712,2797,50,16,40,111,3802,2849,13377
"72065310400",4726,3464,30,47,195,140,4893,3651,17146
"72065310500",4543,2964,30,33,38,70,4572,3067,15317
"72065310600",2335,3138,0,0,111,30,2446,3168,11228
"72065990016",0,0,0,0,0,0,0,0,0
"72067820100",1709,928,173,14,2883,2042,4681,2958,15388
"72067820300",1464,541,152,52,1609,797,3181,1390,9186
"72067820400",492,673,0,54,378,360,870,1087,3914
"72067820500",1097,341,72,25,791,212,1960,578,5076
"72069180100",1300,1203,590,310,1034,893,2915,2396,10641
"72069180201",993,505,77,13,476,280,1537,798,4679
"72069180202",1781,1161,525,125,1129,1144,3194,2417,11476
"72069180301",1237,707,243,71,776,450,2256,1228,6968
"72069180302",1355,1212,224,120,662,854,2205,2186,8818
"72069180400",1725,1219,315,151,702,784,2742,2154,9792
"72069180500",2718,849,128,97,1318,397,4164,1343,11014
"72069180600",1190,1537,160,376,389,1234,1720,3136,9742
"72069180700",1729,1681,217,121,743,936,2680,2738,10845
"72069180800",2078,1848,191,135,990,823,3184,2792,12041
"72069180901",1131,669,31,339,500,1209,1662,2206,7747
"72069180902",2560,602,128,22,710,454,3305,1068,8849
"72069991800",0,0,0,0,0,0,0,0,0
"72071410100",2335,1623,34,37,707,1111,3021,2771,11639
"72071410200",676,1220,141,93,308,376,1125,1681,5620
"72071410300",1184,1017,43,129,191,452,1363,1598,5977
"72071410401",903,1279,118,12,365,556,1364,1847,6444
"72071410402",2530,2898,181,145,818,1188,3519,4186,15465
"72071410500",2891,1837,206,85,702,599,3768,2470,12558
"72071410600",934,2109,26,147,549,1076,1475,3304,9620
"72071410701",1108,921,48,255,352,651,1508,1804,6647
"72071410702",1364,2875,204,427,1002,1600,2527,4811,14810
"72071990000",0,0,0,0,0,0,0,0,0
"72073956000",1986,2918,73,85,565,181,2624,3172,11604
"72073956100",961,1200,20,101,168,152,1140,1444,5186
"72073956200",2792,3886,0,99,432,527,3224,4512,15472
"72075710102",1331,2046,153,176,637,1216,2104,3425,11088
"72075710200",1301,1322,217,339,1293,979,2797,2640,10888
"72075710301",2156,884,325,137,424,327,2826,1336,8415
"72075710302",1885,942,167,172,852,406,2885,1520,8829
"72075710400",432,1022,23,154,447,289,902,1465,4734
"72075710500",341,520,167,38,140,252,648,810,2916
"72075710600",958,487,99,66,146,222,1197,775,3950
"72075710700",672,675,16,52,270,288,958,1015,3946
"72075710800",2149,2121,217,396,1030,711,3396,3184,13204
"72075710901",1713,1351,288,396,517,939,2518,2686,10408
"72075710902",1648,1682,331,504,578,1241,2557,3427,11968
"72075711002",645,1292,254,371,545,977,1415,2640,8139
"72075990001",0,0,0,0,0,0,0,0,0
"72077500100",2787,2830,158,63,532,957,3477,3806,14610
"72077500200",3344,2136,337,227,482,362,4163,2689,13740
"72077500301",4108,2145,313,62,509,1011,4930,3165,16243
"72077500302",2541,2582,138,39,487,847,3166,3468,13268
"72077500401",2103,2230,208,82,646,660,2944,2953,11826
"72077500402",2554,1610,66,50,401,614,3021,2274,10590
"72079850101",880,1703,38,14,55,162,973,1879,5704
"72079850102",2461,3238,68,14,326,298,2855,3550,12810
"72079850200",1914,2222,77,69,282,49,2273,2340,9226
"72079850300",1428,3605,91,27,375,455,1894,4004,11879
"72079850400",1356,3122,240,0,209,288,1805,3410,10430
"72079991100",0,0,0,0,0,0,0,0,0
"72081957700",1858,2588,40,8,54,151,1952,2747,9398
"72081957800",2362,3544,43,0,330,162,2710,3681,12832
"72081957900",1900,2718,0,0,15,61,1915,2779,9388
"72081958000",1116,2046,9,0,0,12,1125,2058,6366
"72081958100",788,1067,0,8,73,37,861,1112,3946
"72081958200",1600,1778,8,71,36,32,1636,1881,7042
"72081958300",533,1808,0,0,0,73,533,1881,4828
"72081958400",795,1150,21,6,139,10,945,1166,4232
"72083959700",859,1831,22,7,75,35,911,1857,5597
"72083959800",596,532,0,1,1,125,597,657,2509
"72083959900",2497,2539,0,36,33,250,2530,2793,10678
"72085190101",2484,3098,217,280,827,1158,3513,4514,16091
"72085190102",4659,2583,178,89,1322,550,6143,3222,18746
"72085190201",1301,1818,115,150,546,282,1949,2250,8411
"72085190202",1118,1383,95,199,229,60,1442,1633,6159
"72085190301",2877,2984,272,226,1261,755,4410,3948,16733
"72085190302",2197,2175,138,109,382,472,2717,2756,10946
"72087110101",244,183,483,855,410,830,1137,1863,6005
"72087110102",111,96,393,418,494,626,998,1140,4276
"72087110200",139,76,187,495,385,633,711,1204,3830
"72087110301",338,447,692,464,901,1450,1931,2361,8584
"72087110302",318,217,1246,301,1131,1035,2695,1553,8496
"72087110303",1208,475,345,198,781,207,2334,880,6428
"72087110304",1436,568,667,334,811,285,2914,1181,8196
"72087110400",114,259,269,685,90,816,473,1760,4466
"72087110500",51,138,314,350,126,258,491,746,2474
"72087110600",144,104,1009,708,261,388,1414,1200,5228
"72087990000",0,0,0,0,0,0,0,0,0
"72089140101",1276,771,249,176,632,599,2140,1531,7374
"72089140102",1094,1056,148,11,697,693,1912,1760,7371
"72089140201",591,780,59,374,180,564,704,1634,4886
"72089140202",2266,884,302,173,638,713,3145,1770,9891
"72089140300",1328,725,219,307,1209,967,2670,1968,9393
"72089990001",0,0,0,0,0,0,0,0,0
"72091570100",3238,2409,202,96,491,267,3884,2743,13330
"72091570201",3698,1621,53,23,316,217,4052,1850,11830
"72091570202",1741,1028,178,13,231,92,2121,1101,6505
"72091570300",1197,1942,71,64,35,197,1293,2203,7002
"72091570400",1408,1765,50,226,68,256,1515,2218,7506
"72091570500",2785,1460,225,40,277,282,3222,1738,10029
"72091570600",1368,1613,38,107,114,179,1520,1851,6790
"72091570700",1574,2206,57,14,126,206,1757,2400,8340
"72091570800",3346,2453,186,92,113,344,3570,2870,12974
"72091990025",0,0,0,0,0,0,0,0,0
"72093960100",1717,1926,14,28,109,356,1840,2303,8293
"72093960200",683,1264,30,82,68,107,781,1453,4468
"72095951400",1807,2081,817,861,535,896,3159,3838,13994
"72095951500",309,927,587,793,189,502,1085,2222,6614
"72095951600",463,388,213,183,267,51,938,613,3116
"72095990000",0,0,0,0,0,0,0,0,0
"72097080100",97,232,17,48,192,378,306,658,1928
"72097080200",329,322,35,14,155,844,519,1179,3397
"72097080300",321,393,69,13,315,1190,705,1596,4602
"72097080400",145,129,27,17,197,463,369,609,1956
"72097080500",196,275,74,22,214,510,469,807,2567
"72097080600",152,215,0,17,200,1471,345,1679,4079
"72097080800",718,374,234,46,518,614,1452,1034,4990
"72097080900",273,222,42,90,159,705,469,1017,2977
"72097081000",153,325,0,30,237,450,390,805,2390
"72097081100",198,240,8,33,202,245,408,518,1852
"72097081200",170,1343,0,171,266,3813,436,5314,11513
"72097081300",1216,391,29,9,596,513,1827,913,5494
"72097081501",804,430,9,0,980,1785,1784,2215,8007
"72097081512",1495,2260,456,374,294,545,2174,3134,10732
"72097081522",1486,147,89,0,1748,642,3141,789,8042
"72097081601",932,372,0,0,2635,1258,3513,1628,10338
"72097081602",498,379,25,22,1532,1481,2036,1844,7817
"72097081700",499,433,193,10,1090,1376,1775,1797,7173
"72097081800",1139,512,41,7,589,261,1733,765,5047
"72097081900",2851,1542,29,38,554,850,3367,2412,11643
"72097082001",2056,1968,290,24,838,375,3184,2342,11077
"72097082012",2097,1313,116,49,762,191,2955,1553,9036
"72097082022",1989,1251,23,17,384,312,2321,1580,7877
"72097082102",1444,1297,63,137,345,332,1852,1678,7148
"72097082103",1676,1789,148,112,408,523,2187,2401,9244
"72097082104",1055,1493,16,41,363,214,1414,1712,6308
"72097990000",0,0,0,0,0,0,0,0,0
"72099420100",1629,3521,237,226,1045,527,2891,4175,14251
"72099420200",3100,3159,15,69,445,317,3511,3527,14143
"72099420301",1895,2371,100,186,243,659,2238,3184,10876
"72099420302",1886,1728,15,10,237,451,2132,2172,8631
"72099420401",1242,1442,9,0,242,172,1493,1613,6213
"72099420402",1855,2302,16,0,406,746,2277,3048,10650
"72099420500",2966,2157,27,87,755,616,3729,2825,13162
"72101955201",1671,2781,30,47,139,386,1840,3214,10108
"72101955202",2266,2919,54,0,348,232,2668,3151,11638
"72101955300",2722,3846,31,122,477,710,3230,4653,15791
"72101955401",3883,2440,11,12,418,690,4312,3083,14849
"72101955402",1314,1793,0,27,195,200,1509,2020,7058
"72101955500",773,1519,35,33,98,169,906,1721,5254
"72103170100",1554,1872,161,166,875,1279,2558,3294,11759
"72103170200",2319,2466,21,0,836,1363,3164,3814,13983
"72103170300",1566,1800,55,193,931,1124,2552,3087,11308
"72103170400",2718,2658,209,209,1216,1201,4143,4068,16422
"72103990013",0,0,0,0,0,0,0,0,0
"72105520100",1459,1099,81,145,1528,1012,3068,2256,10648
"72105520200",1175,1821,80,8,1044,1277,2299,3089,10793
"72105520300",432,534,13,171,454,955,887,1660,5106
"72105520400",1798,1952,222,244,1887,2121,3887,4317,16428
"72105520500",2499,1522,150,113,2187,1885,4786,3520,16662
"72107954801",1551,1914,16,145,246,306,1813,2365,8356
"72107954802",598,950,0,0,43,447,641,1397,4076
"72107954901",1120,1921,0,92,220,568,1340,2579,7840
"72107954902",711,891,0,46,79,290,790,1227,4034
"72107955001",1759,2418,0,136,343,402,2102,2955,10115
"72107955002",895,983,0,125,128,282,1002,1390,4805
"72107955100",1314,1230,48,99,222,249,1584,1562,6308
"72109290100",1080,1237,333,592,317,494,1730,2323,8106
"72109290200",1399,2334,645,346,769,726,2813,3406,12438
"72109290300",1197,1499,525,493,359,690,2081,2670,9514
"72109290400",816,1429,176,277,542,475,1525,2167,7407
"72109990000",0,0,0,0,0,0,0,0,0
"72111730100",1987,3110,10,0,270,414,2250,3473,11514
"72111730200",1048,1038,13,0,100,81,1151,1104,4535
"72111730300",2261,3886,85,142,136,621,2469,4600,14200
"72111730400",668,1164,96,55,225,36,960,1228,4432
"72111730700",1319,2166,19,229,28,281,1366,2676,8084
"72111730800",583,808,10,15,209,75,802,898,3400
"72111990000",0,0,0,0,0,0,0,0,0
"72113070100",2500,1840,104,36,327,250,2900,2126,10083
"72113070201",798,1353,22,119,388,687,1163,2124,6654
"72113070202",402,880,0,154,158,225,551,1248,3618
"72113070300",869,1415,57,141,393,324,1319,1880,6398
"72113070400",317,1227,25,251,32,550,366,2028,4796
"72113070502",1775,1321,96,8,397,379,2261,1708,7945
"72113070503",2612,999,31,34,279,219,2915,1234,8323
"72113070513",813,1293,56,271,159,468,1028,2025,6113
"72113070514",1063,889,135,89,278,288,1476,1266,5484
"72113070522",1524,757,121,39,179,383,1807,1165,5975
"72113070800",358,951,27,93,41,293,426,1337,3526
"72113070900",308,1201,10,177,196,541,514,1919,4866
"72113071000",445,928,28,41,137,207,605,1176,3567
"72113071200",632,1074,110,231,196,461,920,1766,5390
"72113071300",326,2001,88,294,188,766,585,3061,7309
"72113071401",1152,796,26,8,188,177,1354,968,4669
"72113071402",2273,1367,57,60,289,128,2619,1555,8348
"72113071500",1413,1890,23,119,309,320,1745,2319,8138
"72113071601",1507,680,93,138,234,141,1819,950,5562
"72113071602",228,1932,41,342,245,1264,514,3538,8104
"72113071700",501,746,103,0,260,179,789,925,3503
"72113071800",369,719,89,19,90,490,548,1209,3533
"72113071900",790,2475,69,167,505,1278,1364,3911,10559
"72113072000",984,501,54,97,98,191,1125,789,3839
"72113072101",317,890,25,140,136,330,478,1360,3676
"72113072102",2401,1586,138,15,639,135,3148,1736,9798
"72113072201",1125,1070,93,180,403,699,1613,1940,7123
"72113072202",3016,739,242,104,617,290,3854,1133,9995
"72113072300",212,241,153,105,121,418,486,764,2500
"72113072400",3019,1518,126,321,1071,853,4216,2659,13783
"72113072500",3910,1993,283,97,1533,384,5704,2474,16378
"72113072600",901,1784,27,15,127,565,1055,2364,6838
"72113072701",1602,904,83,90,217,159,1902,1153,6110
"72113072703",2586,1732,60,60,205,182,2769,1974,9568
"72113072704",775,1720,16,109,128,336,919,2165,6168
"72113072900",4325,1833,178,61,370,124,4806,2018,13715
"72113073001",1056,1148,0,48,207,219,1263,1415,5356
"72113073002",1368,2734,0,46,388,435,1714,3198,9883
"72113073003",818,1171,15,30,50,31,820,1232,4167
"72113073004",1976,1642,46,24,368,228,2390,1868,8542
"72113073005",1874,915,157,64,257,17,2288,996,6568
"72113073006",1329,1442,8,13,194,500,1531,1949,6966
"72113073008",0,0,0,0,11,0,11,0,22
"72113073009",1032,3046,63,140,213,827,1308,4013,10642
"72113073010",2033,1517,147,29,241,141,2421,1687,8216
"72113993000",0,0,0,0,0,0,0,0,0
"72115330100",2881,3176,46,92,917,966,3844,4216,16138
"72115330200",1355,2516,60,275,433,832,1848,3607,10926
"72115330300",1738,2448,143,81,500,940,2321,3420,11591
"72115330400",2189,2218,152,50,493,916,2834,3146,11998
"72115990000",0,0,0,0,0,0,0,0,0
"72117959400",1693,1340,131,31,754,1058,2152,2169,9328
"72117959500",1034,785,15,134,559,743,1464,1559,6293
"72117959600",1984,1730,74,68,1177,1668,2997,3323,13021
"72117990400",0,0,0,0,0,0,0,0,0
"72119130101",1859,1501,425,376,600,698,2884,2547,10890
"72119130102",2959,805,548,59,1187,24,4641,888,11111
"72119130200",736,594,137,135,215,450,1088,1179,4534
"72119130300",1573,721,386,147,534,191,2487,1038,7077
"72119130401",1271,412,419,158,1062,529,2752,1099,7702
"72119130402",1465,1086,584,830,667,1061,2716,2977,11386
"72119130500",1894,1317,480,607,1216,1083,3590,3007,13194
"72119130601",1058,572,66,324,557,655,1667,1533,6432
"72119130602",1218,613,142,166,610,612,1921,1369,6651
"72119130701",2667,1722,438,7,1282,1488,4387,3217,15208
"72119130702",1300,1427,397,250,1233,778,2930,2455,10770
"72119992700",0,0,0,0,0,0,0,0,0
"72121960300",2182,2336,26,123,259,268,2467,2661,10322
"72121960400",2783,1484,135,87,444,215,3300,1743,10191
"72121960500",527,876,12,25,0,135,539,1021,3135
"72121960600",1772,1455,5,67,223,86,2000,1608,7216
"72121960700",1875,2221,101,145,263,344,2219,2675,9843
"72121960800",1294,2362,42,49,214,152,1550,2547,8210
"72123952600",969,1416,29,59,230,504,1228,1950,6385
"72123952700",385,768,87,115,241,509,713,1387,4205
"72123952800",1483,2155,186,274,1198,1609,2867,4038,13810
"72123952900",2449,2300,120,351,1256,1737,3825,4388,16426
"72123953000",749,668,79,292,361,769,1131,1694,5743
"72123953100",563,627,30,132,234,553,827,1295,4261
"72123953200",1252,1322,135,285,549,1128,1926,2720,9317
"72123992800",0,0,0,0,0,0,0,0,0
"72125840100",1803,2401,0,14,0,224,1803,2576,8821
"72125840200",2664,2675,0,34,22,354,2686,3063,11498
"72125840300",2748,1658,55,284,183,65,2977,2007,9977
"72125840400",2701,2431,242,93,52,466,2980,2990,11955
"72125840500",2206,1682,44,32,139,68,2353,1774,8298
"72125840600",2063,1904,39,91,245,56,2314,2051,8763
"72125840700",2194,1835,0,44,205,121,2386,2000,8785
"72127000400",440,249,54,153,68,124,542,512,2142
"72127000506",860,325,8,7,127,107,808,426,2668
"72127000600",608,534,40,127,95,124,711,765,3004
"72127000700",638,588,49,140,69,66,733,781,3064
"72127000900",1931,328,70,32,134,66,1907,404,4872
"72127001000",3695,758,106,134,138,23,3641,818,9313
"72127001100",954,249,18,11,176,67,1019,295,2789
"72127001200",1605,241,15,29,130,47,1597,287,3951
"72127001301",247,748,145,508,11,395,403,1651,4108
"72127001302",204,2215,150,1001,204,861,545,4036,9216
"72127001400",283,419,309,153,73,186,665,739,2827
"72127001500",795,400,168,174,115,308,1014,847,3821
"72127001600",1168,236,179,48,169,80,1482,364,3726
"72127001800",1349,217,166,143,154,307,1639,646,4621
"72127001900",2780,428,95,70,216,85,3003,583,7260
"72127002002",398,217,67,138,172,171,637,526,2326
"72127002100",411,397,88,337,245,185,703,862,3228
"72127002200",376,355,156,219,230,320,756,867,3279
"72127002300",175,259,247,149,235,273,631,670,2639
"72127002400",783,398,43,113,186,234,964,725,3446
"72127002500",468,407,377,122,195,167,1026,696,3458
"72127002600",557,291,261,367,399,690,1217,1348,5130
"72127002800",508,631,377,170,350,607,1214,1397,5254
"72127002900",368,412,180,250,149,291,692,953,3295
"72127003000",399,258,172,352,269,261,828,871,3410
"72127003100",481,408,445,599,395,405,1321,1374,5428
"72127003200",292,538,393,288,115,279,755,1105,3765
"72127003300",411,182,132,100,298,210,841,492,2666
"72127003400",478,1065,96,327,89,347,663,1719,4784
"72127003501",454,2465,99,583,127,1070,669,4069,9536
"72127003502",475,522,185,126,228,225,888,873,3522
"72127003600",253,203,45,111,75,158,373,472,1690
"72127003700",559,1337,326,852,543,718,1428,2907,8670
"72127003800",521,230,413,405,344,510,1213,1130,4766
"72127003902",1140,1429,364,207,535,446,2032,2049,8202
"72127004200",799,578,408,420,80,174,1239,1134,4832
"72127004306",145,1726,27,113,0,612,163,2451,5237
"72127004400",466,677,167,278,205,296,838,1234,4161
"72127004500",471,648,251,179,272,248,989,1075,4133
"72127004600",1418,1387,144,333,279,286,1812,2006,7665
"72127004700",1485,1567,299,71,384,313,2149,1951,8219
"72127004800",157,1571,45,324,24,827,226,2702,5876
"72127004900",556,1564,303,1026,35,357,859,2930,7630
"72127005000",1366,1615,637,335,353,1077,2335,2958,10676
"72127005101",727,498,249,116,157,256,1128,870,4001
"72127005102",689,634,147,195,186,319,997,1087,4254
"72127005103",463,1437,224,212,181,718,811,2350,6396
"72127005201",1282,581,424,164,358,129,2045,840,5823
"72127005202",1404,830,302,209,169,155,1855,1155,6079
"72127005204",966,439,170,38,199,134,1324,611,3881
"72127005214",1414,997,383,262,681,393,2431,1652,8213
"72127005215",708,907,346,122,218,586,1238,1518,5643
"72127005300",1209,858,496,202,293,411,1935,1400,6804
"72127005401",3663,1097,257,139,691,644,4566,1849,12906
"72127005402",143,826,68,220,96,503,307,1549,3712
"72127005403",2489,1620,381,545,494,745,3332,2875,12481
"72127005500",1820,714,446,351,494,659,2695,1698,8877
"72127005601",1717,627,463,150,440,198,2537,975,7107
"72127005602",1275,1245,610,653,356,371,2207,2145,8862
"72127005800",1171,456,366,22,259,188,1664,666,4792
"72127005900",435,662,64,59,102,137,601,858,2918
"72127006000",424,663,126,218,160,525,695,1363,4174
"72127006101",589,1760,151,329,160,610,877,2691,7167
"72127006102",623,380,139,29,145,179,898,588,2981
"72127006200",833,873,138,84,105,130,1059,1066,4288
"72127006300",2191,1418,387,11,292,178,2832,1574,8883
"72127006500",1195,322,33,23,158,6,1299,339,3375
"72127006600",489,752,95,13,140,156,724,875,3244
"72127006700",2631,773,151,34,307,55,3014,862,7827
"72127006800",2654,857,95,92,129,193,2878,1115,8013
"72127006900",1173,525,526,513,117,113,1798,1142,5907
"72127007004",1297,598,224,81,89,105,1579,784,4757
"72127007100",873,375,592,304,138,28,1586,675,4571
"72127007300",2453,662,321,111,276,60,3026,833,7742
"72127007400",938,378,283,144,53,188,1257,700,3941
"72127007500",584,599,352,440,171,129,1107,1168,4550
"72127007600",917,499,384,529,127,90,1394,1104,5044
"72127007700",1098,649,704,536,110,198,1912,1383,6590
"72127007800",1913,1531,628,1308,93,137,2603,2976,11189
"72127007900",2211,507,144,71,155,10,2378,567,6043
"72127008001",1798,828,345,637,107,81,2179,1532,7507
"72127008002",1458,1656,602,1202,43,373,2078,3211,10623
"72127008100",2084,354,76,48,73,97,2104,499,5335
"72127008201",205,1707,136,880,145,73,486,2593,6225
"72127008202",808,1037,203,274,205,93,1206,1404,5230
"72127008300",874,433,387,473,118,339,1379,1245,5248
"72127008400",2037,642,451,391,218,59,2669,1078,7545
"72127008500",2242,1079,459,153,53,138,2730,1314,8168
"72127008601",1433,156,139,10,49,40,1560,206,3593
"72127008602",2493,832,158,39,207,53,2740,887,7409
"72127008603",1179,253,109,71,45,45,1321,369,3392
"72127008700",510,758,114,163,289,259,871,1130,4094
"72127008900",393,631,408,219,223,876,982,1704,5436
"72127009000",703,597,169,481,102,421,974,1485,4932
"72127009111",1380,918,319,171,520,141,2078,1212,6739
"72127009112",1536,1120,139,290,438,217,1984,1588,7312
"72127009121",2142,952,239,62,321,371,2634,1322,8043
"72127009122",3161,905,371,242,909,467,4322,1551,11928
"72127009123",1660,221,217,0,346,68,2175,289,4976
"72127009300",613,961,268,309,515,667,1396,1891,6620
"72127009400",824,354,138,95,336,177,1286,626,3836
"72127009601",1036,322,55,0,125,11,1164,333,3046
"72127009602",1312,330,98,56,222,132,1632,512,4294
"72127009603",1570,270,50,55,228,161,1838,486,4658
"72127009614",1434,153,27,0,189,0,1614,153,3570
"72127009624",2372,1016,87,161,810,469,3269,1605,9789
"72127009800",4142,580,258,32,348,110,4644,699,10813
"72127009901",2712,382,161,126,304,231,3121,739,7776
"72127009902",1760,1447,427,102,621,582,2800,2106,9845
"72127009903",2849,372,138,22,665,119,3592,497,8254
"72127009904",1753,213,48,2,201,13,1996,228,4454
"72127010001",3518,680,162,114,1120,37,4752,831,11214
"72127010002",4548,198,65,23,676,43,5248,264,11065
"72127010012",2863,648,133,83,836,272,3822,1003,9660
"72127010022",1908,415,98,76,512,113,2482,604,6208
"72127010032",1571,1153,434,86,765,1095,2770,2334,10208
"72127010042",4169,1061,175,53,1801,860,6125,1974,16218
"72127010100",4524,1166,349,281,1197,888,6023,2335,16763
"72127010200",1946,1423,462,355,1520,642,3899,2420,12667
"72127010500",2174,503,63,44,380,178,2560,725,6627
"72127980000",0,0,0,0,0,0,0,0,0
"72127980101",0,0,0,0,0,0,0,0,0
"72127980102",0,0,0,0,0,0,0,0,0
"72127980103",20,1005,22,25,65,344,107,1374,2962
"72127980104",0,0,0,0,0,0,0,0,0
"72127980105",0,0,0,0,0,0,0,0,0
"72127980107",0,0,0,0,0,0,0,0,0
"72127980108",0,0,0,0,0,0,0,0,0
"72127980200",0,23,0,0,0,0,0,23,46
"72127980300",0,0,0,0,0,0,0,0,0
"72127990000",0,0,0,0,0,0,0,0,0
"72129220100",3294,1348,302,392,469,668,4050,2408,12931
"72129220200",827,2086,48,123,161,509,1036,2718,7508
"72129220300",528,934,0,0,65,45,581,979,3132
"72129220401",2845,1275,166,34,625,151,3628,1460,10184
"72129220402",2520,2405,178,164,313,288,2995,2857,11720
"72129220501",1634,1666,66,71,120,341,1820,2045,7763
"72129220502",2371,1510,63,30,337,599,2771,2139,9820
"72129220600",1160,1466,20,9,255,149,1420,1624,6103
"72129220700",1681,2865,49,269,219,353,1935,3487,10858
"72131009200",446,1796,25,7,15,158,472,1946,4865
"72131958500",1557,2391,34,48,51,274,1624,2713,8692
"72131958700",2308,2432,21,115,293,192,2622,2739,10722
"72131958800",3297,2735,56,32,249,477,3577,3162,13585
"72131958900",1107,1626,25,66,99,0,1214,1692,5829
"72131959000",2257,2106,33,23,145,112,2435,2233,9344
"72131959200",1958,3020,26,0,24,399,1970,3405,10802
"72131959300",1523,2460,9,16,142,307,1674,2731,8862
"72131959500",1891,2235,39,73,115,147,1986,2455,8941
"72133953300",1824,920,210,179,753,815,2769,1914,9384
"72133953500",1077,1661,68,248,724,964,1869,2873,9484
"72133953600",2257,1197,204,220,1217,1080,3678,2497,12350
"72133953700",668,609,162,155,296,222,1126,986,4224
"72133953800",1341,1773,70,217,493,1490,1904,3480,10768
"72133990000",0,0,0,0,0,0,0,0,0
"72135510101",4602,730,571,20,2402,551,7575,1290,17741
"72135510102",1338,1535,377,263,280,648,1967,2446,8854
"72135510200",3566,1459,485,598,1750,1006,5750,3033,17647
"72135510300",853,990,357,124,334,246,1544,1360,5808
"72135510400",1288,1829,81,165,717,831,2086,2825,9822
"72135510502",2517,1312,198,106,604,378,3319,1796,10230
"72135510503",4338,1385,612,104,1472,971,6422,2460,17764
"72135510504",2442,645,344,46,932,620,3616,1311,9956
"72135510505",3201,341,300,134,594,74,4054,549,9247
"72135510601",2292,727,13,111,1697,451,3970,1289,10550
"72135510602",2727,1202,13,357,1411,716,4151,2275,12852
"72135510701",1576,467,152,106,944,247,2672,820,6984
"72135510702",1403,1841,256,219,962,959,2621,3019,11280
"72137120200",1517,639,95,239,936,339,2522,1217,7504
"72137120300",1054,428,189,175,556,231,1792,818,5243
"72137120400",700,223,104,37,414,78,1182,338,3076
"72137120500",640,182,213,19,306,214,1130,415,3119
"72137120600",1565,464,315,100,622,232,2502,796,6596
"72137120700",318,179,108,22,453,67,860,268,2275
"72137120800",1530,597,477,80,946,430,2860,1073,7993
"72137120900",1728,421,271,80,980,474,2979,930,7863
"72137121001",1508,333,332,133,895,166,2707,632,6706
"72137121002",1797,318,310,350,1126,174,3233,842,8150
"72137121100",646,296,400,234,1294,792,2325,1309,7296
"72137121200",483,364,64,108,1090,1336,1637,1768,6850
"72137121300",352,164,153,46,713,461,1218,671,3778
"72137121400",2068,222,496,63,1616,333,4101,618,9517
"72137121701",637,418,182,71,984,861,1769,1350,6272
"72137121702",442,961,260,178,1748,2385,2450,3524,11948
"72137121801",1226,2002,244,308,765,1428,2219,3738,11930
"72137121802",1887,1397,267,117,835,327,2989,1818,9637
"72137121900",1379,721,306,151,322,252,1999,1124,6254
"72137122001",1681,1181,119,141,1230,435,3011,1732,9530
"72137122002",2215,468,169,15,1001,302,3385,785,8340
"72137122100",375,867,84,140,358,691,817,1698,5030
"72137122201",602,1410,48,107,681,912,1331,2429,7520
"72137122202",751,809,279,94,626,611,1656,1514,6340
"72137122400",365,500,94,307,380,318,839,1107,3910
"72137990000",0,0,0,0,0,0,0,0,0
"72139060102",1874,477,246,136,730,121,2850,734,7168
"72139060103",1186,526,268,126,316,469,1770,1109,5770
"72139060104",2957,939,431,0,1592,434,4963,1373,12689
"72139060211",2467,1284,298,405,666,792,3416,2470,11798
"72139060212",1666,927,203,345,743,1285,2603,2557,10329
"72139060213",1871,323,161,0,495,86,2504,409,5849
"72139060222",2352,954,523,192,1126,408,3961,1553,11069
"72139060223",1368,720,180,58,753,619,2284,1397,7379
"72139060301",3187,797,134,57,1822,379,5126,1233,12735
"72139060302",3817,1274,582,57,2096,783,6468,2114,17191
"72139060401",1184,906,134,54,770,345,2088,1305,6786
"72139060403",2427,432,182,17,794,237,3350,686,8125
"72139060404",2989,493,261,0,683,190,3888,683,9187
"72139060501",1621,1444,246,429,707,845,2574,2709,10575
"72139060502",1086,1086,113,84,846,801,2034,1971,8021
"72141956900",1403,2305,90,131,116,382,1609,2787,8823
"72141957000",2147,2141,43,164,295,418,2485,2723,10416
"72141957100",2071,2288,91,61,124,149,2240,2481,9505
"72141957200",2030,2003,25,69,252,256,2272,2328,9235
"72141957300",2068,1512,92,47,328,102,2488,1661,8298
"72141957400",687,1535,36,6,22,143,736,1684,4849
"72141957500",867,1636,14,42,44,129,925,1790,5447
"72141957600",1602,1620,0,0,287,181,1889,1801,7380
"72143550100",4047,3099,614,612,445,428,5053,4116,18414
"72143550200",1705,3042,69,28,156,91,1868,3141,10100
"72143550300",2361,2048,163,172,325,249,2791,2426,10535
"72143550400",1498,1883,123,228,123,450,1672,2502,8479
"72143550500",2531,1288,424,297,317,584,3203,2169,10813
"72143550601",1660,2589,164,127,382,369,2189,3051,10531
"72143550602",1385,1699,374,245,260,297,2019,2200,8479
"72143990000",0,0,0,0,0,0,0,0,0
"72145560100",1634,2225,81,108,22,0,1655,2273,7998
"72145560201",2921,1679,48,58,318,26,3252,1721,10023
"72145560204",1288,2105,0,0,24,39,1311,2021,6788
"72145560300",1976,2288,44,93,224,29,2213,2284,9151
"72145560401",1451,1041,0,0,59,8,1476,1030,5065
"72145560402",3351,1908,223,10,261,50,3693,1901,11397
"72145560500",878,640,18,23,9,6,863,659,3096
"72145560600",2743,3607,165,14,28,134,2796,3586,13073
"72145560701",3058,2961,34,39,447,176,3434,3005,13154
"72145560702",2854,2592,367,66,131,66,3332,2686,12094
"72145560801",875,1781,37,19,120,0,1008,1730,5570
"72145560802",1057,2409,84,35,92,5,1211,2419,7312
"72145560900",1357,2495,47,162,193,40,1597,2601,8492
"72145990000",0,0,0,0,0,0,0,0,0
"72147950500",1834,906,384,252,979,893,3166,2030,10444
"72147950600",865,255,91,484,1202,1017,2000,1746,7660
"72147990000",0,0,0,0,0,0,0,0,0
"72149720100",1341,1817,45,224,400,1185,1786,3226,10024
"72149720300",2103,1716,70,37,1188,1062,3361,2815,12352
"72149720400",552,816,45,32,296,289,893,1137,4060
"72149720502",1042,902,57,103,407,762,1506,1767,6546
"72149720503",1486,1675,31,76,589,1237,2092,2969,10155
"72149720504",1309,647,29,13,554,862,1892,1446,6752
"72151950600",2226,2238,415,568,674,913,3292,3719,14045
"72151950700",2012,1892,215,511,675,142,2892,2545,10884
"72151950800",1354,1431,299,240,425,198,2078,1869,7894
"72151950900",2047,2114,150,368,353,489,2550,2909,10980
"72151951000",943,890,244,88,253,61,1429,1039,4947
"72151951100",782,1059,80,110,180,357,1033,1521,5122
"72151951200",980,1918,144,550,458,418,1582,2869,8919
"72151951300",1880,1881,491,282,447,277,2805,2426,10489
"72151990000",0,0,0,0,0,0,0,0,0
"72153750101",565,1638,0,59,0,194,565,1891,4912
"72153750102",1515,1874,0,107,24,131,1539,2101,7291
"72153750201",1485,1411,20,0,87,264,1578,1675,6520
"72153750202",1037,2358,6,47,93,226,1136,2631,7534
"72153750300",2556,1674,80,10,134,144,2718,1814,9130
"72153750400",1130,1989,19,56,130,225,1279,2250,7078
"72153750501",2944,2450,107,18,198,54,3249,2502,11522
"72153750502",1256,672,0,4,162,84,1412,746,4336
"72153750503",1033,731,45,54,33,179,1098,964,4137
"72153750601",3160,1659,92,196,116,124,3309,1979,10635
"72153750602",903,1923,122,56,66,197,1049,2176,6492
